"Address A","Port A","Address B","Port B","Packets","Bytes","Packets A → B","Bytes A → B","Packets B → A","Bytes B → A","Rel Start","Duration","Bits/s A → B","Bits/s B → A"
"10.0.2.109",49158,"31.28.27.51",80,407,400580,93,5757,314,394823,135.131951,2.658325000000019,17325.19537678789,1188185.7936858651
"10.0.2.109",49159,"31.28.27.51",80,35,4790,14,1764,21,3026,144.053341,1622.907496,8.69550484841682,14.916438589177606
"10.0.2.109",49160,"194.247.12.49",495,2030,121548,875,47266,1155,74282,146.81382,87493.50589300001,4.321783612859574,6.792001234088666
"10.0.2.109",49161,"194.247.12.49",38925,18,2452,8,1779,10,673,147.132157,0.5363639999999918,26534.219298834778,10037.959296298935
"10.0.2.109",49162,"5.101.114.217",80,7,1824,4,343,3,1481,147.365653,0.3026529999999923,9066.488685062,39147.14210663797
"10.0.2.109",49163,"194.247.12.49",38925,9,510,5,290,4,220,747.744422,0.1215230000000247,19091.03626473613,14482.85509738603
"10.0.2.109",49164,"194.247.12.49",38925,15,1186,7,620,8,566,1128.005297,0.3291500000000269,15069.117423665788,13756.645906120704
"10.0.2.109",49165,"80.78.242.47",80,10,882,5,398,5,484,1128.228863,0.10548199999993813,30185.244875920704,36707.684723481456
"10.0.2.109",49166,"194.247.12.49",38925,18,1679,8,1004,10,675,1128.47141,0.45167399999991176,17782.737106854875,11955.525445345658
"10.0.2.109",49167,"217.23.10.139",80,7,1051,4,345,3,706,1128.692569,0.23037999999996828,11980.206615159215,24516.017015369292
"10.0.2.109",49168,"194.247.12.49",38925,19,2755,9,2077,10,678,1128.962438,0.5586319999999887,29744.089132023113,9709.43304357808
"10.0.2.109",49169,"37.187.78.159",80,9,2181,5,402,4,1779,1129.207666,0.3132180000000062,10267.60914123689,45438.001647414
"10.0.2.109",49170,"194.247.12.49",38925,9,510,5,290,4,220,1729.618102,0.12602800000013303,18408.607610987645,13965.150601438903
"10.0.2.109",49171,"31.28.27.51",80,11,948,6,482,5,466,1766.961244,1619.3407280000001,2.381215968527162,2.302171455049082
"10.0.2.109",49172,"194.247.12.49",38925,18,2452,8,1779,10,673,1767.278467,0.533820999999989,26660.622193582294,10085.777816908872
"10.0.2.109",49173,"5.101.114.217",80,7,1824,4,343,3,1481,1767.509978,0.3021139999998468,9082.664159891272,39216.98431719817
"10.0.2.109",49174,"194.247.12.49",38925,9,510,5,290,4,220,2367.888014,0.12561299999970288,18469.425935257397,14011.288640540095
"10.0.2.109",49175,"194.247.12.49",38925,9,510,5,290,4,220,2968.088765,0.12641500000017913,18352.252501654966,13922.398449531353
"10.0.2.109",49176,"31.28.27.51",80,11,948,6,482,5,466,3386.302199,1620.0224249999997,2.380213965248043,2.301202713289602
"10.0.2.109",49177,"194.247.12.49",38925,18,2452,8,1779,10,673,3386.560732,0.5307149999998728,26816.653005857024,10144.804650332646
"10.0.2.109",49178,"5.101.114.217",80,7,1824,4,343,3,1481,3386.788584,0.30251300000008996,9070.684565619276,39165.259013650575
"10.0.2.109",49179,"194.247.12.49",38925,9,510,5,290,4,220,3987.168398,0.12208700000019235,19002.842235425105,14415.949282046631
"10.0.2.109",49180,"194.247.12.49",38925,9,510,5,290,4,220,4587.368307,0.12310800000068411,18845.24157639721,14296.390161404779
"10.0.2.109",49181,"31.28.27.51",80,17,1932,8,821,9,1111,5006.324814,1620.5203570000003,4.053019125387018,5.484658036912275
"10.0.2.109",49182,"194.247.12.49",38925,18,2452,8,1779,10,673,5007.035334,0.5126319999999396,27762.605533797494,10502.660778103269
"10.0.2.109",49183,"5.101.114.217",80,7,1824,4,343,3,1481,5007.256099,0.2916829999994661,9407.473181519055,40619.43959717119
"10.0.2.109",49184,"194.247.12.49",38925,9,510,5,290,4,220,5607.624814,0.12704200000007404,18261.677240586956,13853.686182514242
"10.0.2.109",49185,"194.247.12.49",38925,9,510,5,290,4,220,6207.826973,0.1220419999999649,19009.849068358984,14421.26481047923
"10.0.2.109",49186,"194.247.12.49",38925,61,26626,31,22305,30,4321,6505.625007,115.37382700000035,1546.624608369795,299.6173473555653
"10.0.2.109",49187,"194.247.12.49",38925,21,6128,10,4846,11,1282,6505.684839,14.920001000000411,2598.3912467565474,687.3994177346045
"10.0.2.109",49188,"194.247.12.49",38925,21,6128,10,4846,11,1282,6505.779671,10.864110999999866,3568.4466036844137,944.0257007683488
"10.0.2.109",49189,"173.194.122.23",443,55,26055,23,3731,32,22324,6505.848075,115.15054400000008,259.20850187212295,1550.9436064843937
"10.0.2.109",49190,"173.194.122.7",443,15,5561,8,912,7,4649,6505.848358,14.75628499999948,494.4333888915982,2520.4175712248248
"10.0.2.109",49191,"194.247.12.49",38925,21,6157,10,4863,11,1294,6505.879459,15.654838000000382,2485.1103537448967,661.265226762471
"10.0.2.109",49192,"173.194.122.8",443,15,5561,8,912,7,4649,6505.937509,10.705995999999686,681.4872712450307,3473.941144756741
"10.0.2.109",49193,"194.247.12.49",38925,21,6128,10,4846,11,1282,6505.980007,20.66244000000006,1876.2546920886346,496.3595780556396
"10.0.2.109",49194,"173.194.122.7",443,15,5582,8,916,7,4666,6506.033724,15.500388000000385,472.7623592389957,2408.1977818877226
"10.0.2.109",49195,"173.194.122.15",443,15,5561,8,912,7,4649,6506.411441,20.23079400000006,360.6383417279608,1838.3855819005369
"10.0.2.109",49196,"194.247.12.49",38925,21,5769,10,4481,11,1288,6506.436041,15.10017500000049,2374.012221712585,682.3761976268265
"10.0.2.109",49197,"194.247.12.49",38925,21,5769,10,4481,11,1288,6506.593473,14.940504000000146,2399.3835817051186,689.6688358036582
"10.0.2.109",49198,"173.194.122.31",443,15,5198,8,914,7,4284,6506.595501,14.940536000000066,489.40680575315156,2293.893605958973
"10.0.2.109",49199,"194.247.12.49",38925,18,2158,8,698,10,1460,6506.654538,14.958494000000428,373.2996115785346,780.8272677717199
"10.0.2.109",49200,"194.247.12.49",38925,32,8946,15,6085,17,2861,6506.75114,114.24620400000003,426.0973082309149,200.3392602873702
"10.0.2.109",49201,"194.247.12.49",38925,21,5769,10,4481,11,1288,6506.85162,14.682955999999649,2441.4702325608587,701.7660476541812
"10.0.2.109",49202,"173.194.122.16",443,26,8381,13,2439,13,5942,6506.88054,114.11662299999989,170.98297765085476,416.5563153757191
"10.0.2.109",49203,"194.247.12.49",38925,30,7894,14,5645,16,2249,6506.951368,114.04806399999961,395.97340293299635,157.75804839615745
"10.0.2.109",49204,"173.194.122.23",443,15,5198,8,914,7,4284,6506.977036,14.557386999999835,502.28794494507036,2354.2686609898046
"10.0.2.109",49205,"173.194.122.31",443,15,5198,8,914,7,4284,6506.998091,14.535697999999684,503.03741863652914,2357.7815114211057
"10.0.2.109",49206,"194.247.12.49",38925,31,7299,15,5334,16,1965,6507.051631,113.94612599999982,374.4927668712499,137.95993380240083
"10.0.2.109",49207,"173.194.122.24",443,24,7325,12,1823,12,5502,6507.125715,113.87352600000031,128.07191023486845,386.53409221735944
"10.0.2.109",49208,"194.247.12.49",38925,22,5823,11,4535,11,1288,6507.151466,14.548836999999367,2493.6701126008616,708.235304306485
"10.0.2.109",49209,"173.194.122.23",443,15,5198,8,914,7,4284,6507.302488,14.397600999999668,507.8623862406083,2380.3965674559804
"10.0.2.109",49210,"173.194.122.15",443,23,6624,11,1487,12,5137,6507.491933,113.50564299999951,104.80536196777504,362.06129416843334
"10.0.2.109",49211,"173.194.122.23",443,12,1587,7,1086,5,501,6507.774411,13.838369999999486,627.8196059218191,289.62948670978943
"10.0.2.109",49212,"194.247.12.49",38925,312,281152,218,272685,94,8467,6510.93529,110.05998199999976,19820.82824618311,615.4462209524997
"10.0.2.109",49213,"194.247.12.49",38925,21,5721,10,4445,11,1276,6510.995943,10.701858999999786,3322.787190524629,953.8529707782736
"10.0.2.109",49214,"173.194.122.23",443,286,279509,67,6805,219,272704,6511.090453,109.90458200000012,495.3387657668353,19850.236999218083
"10.0.2.109",49215,"173.194.122.23",443,15,5158,8,910,7,4248,6511.125211,10.572450000000572,688.5821167278735,3214.392122923084
"10.0.2.109",49216,"194.247.12.49",38925,24,7345,11,4732,13,2613,6515.813678,5.72224499999993,6615.585316602219,3653.111672079797
"10.0.2.109",49217,"217.69.133.148",443,19,6830,10,2241,9,4589,6515.947739,5.587988999999652,3208.3098230868236,6569.8053450001935
"10.0.2.109",49218,"194.247.12.49",38925,13,2200,7,1051,6,1149,6517.373648,1.5099700000000666,5568.322549454379,6087.538163009593
"10.0.2.109",49219,"88.85.84.123",80,8,1880,5,1061,3,819,6517.524793,1.3583900000003268,6248.573679133355,4823.357062403598
"10.0.2.109",49220,"194.247.12.49",38925,22,12647,13,11358,9,1289,6520.65609,0.9565719999991416,94989.19056807176,10780.160824286362
"10.0.2.109",49221,"91.185.213.10",80,18,12397,7,1163,11,11234,6520.808874,0.17321799999990617,53712.66265633502,518837.53420573316
"10.0.2.109",49222,"194.247.12.49",38925,209,26244,99,16149,110,10095,6520.814867,1856.1819210000003,69.60093649139684,43.50866641158282
"10.0.2.109",49223,"74.125.136.189",443,209,26032,102,9431,107,16601,6520.9704,2049.9879220000003,36.80411927812324,64.7847719368173
"10.0.2.109",49224,"194.247.12.49",38925,14,3043,7,904,7,2139,6521.42531,3.5342239999999947,2046.2766366817755,4841.7983693167225
"10.0.2.109",49225,"194.247.12.49",38925,12,1666,6,543,6,1123,6521.486497,1.1443890000000465,3795.912054379956,7850.477416332764
"10.0.2.109",49226,"194.247.12.49",38925,63,50543,40,47895,23,2648,6521.546748,4.914694000000054,77962.12744882912,4310.339565393037
"10.0.2.109",49227,"173.194.122.26",80,9,2723,6,2051,3,672,6521.584689,3.3739209999994273,4863.18440769739,1593.3983042284963
"10.0.2.109",49228,"194.247.12.49",38925,13,2093,7,1045,6,1048,6521.64244,4.838022000000819,1727.9789136962552,1732.939618711651
"10.0.2.109",49229,"194.247.12.49",38925,44,23810,26,21614,18,2196,6521.716805,3.887576000000081,44478.101521358396,4519.011332511476
"10.0.2.109",49230,"194.247.12.49",38925,35,21369,21,20015,14,1354,6521.778174,3.1795389999997496,50359.50180199476,3406.78318460659
"10.0.2.109",49231,"194.247.12.49",38925,13,1752,7,657,6,1095,6521.872386,3.0876060000000507,1702.2897351540041,2837.1495585900066
"10.0.2.109",49232,"173.194.122.26",80,8,1402,5,1037,3,365,6521.920795,0.7097579999999653,11688.491006794437,4114.0783196528155
"10.0.2.109",49233,"194.247.12.49",38925,13,1759,7,888,6,871,6521.973255,97.84332499999982,72.60587270516423,71.21589541238518
"10.0.2.109",49234,"91.185.202.180",80,8,1786,5,973,3,813,6522.043911,4.435835000000225,1754.7992655271455,1466.2402907230928
"10.0.2.109",49235,"194.247.12.49",38925,13,2045,7,807,6,1238,6522.072774,4.409281999999621,1464.183964645617,2246.1706917363986
"10.0.2.109",49236,"88.85.84.123",80,11,1618,6,854,5,764,6522.117527,65.26883799999996,104.67476071812408,93.64346275017189
"10.0.2.109",49237,"194.247.12.49",38925,12,1523,6,652,6,871,6522.17326,0.7323680000008608,7122.102549529566,9514.342516319406
"10.0.2.109",49238,"104.28.16.59",80,30,21061,11,1170,19,19891,6522.216923,2.740375000000313,3415.590931897617,58067.965150748285
"10.0.2.109",49239,"173.194.113.110",80,8,1730,5,1155,3,575,6522.232615,4.249109999999746,2174.573028234278,1082.579646090658
"10.0.2.109",49240,"194.247.12.49",38925,12,1306,6,550,6,756,6522.273057,2.0413819999994303,2155.4025655174914,2962.6987991476794
"10.0.2.109",49241,"88.85.84.106",80,8,1448,5,1023,3,425,6522.290613,2.668525999999474,3066.8616307285793,1274.1116256692533
"10.0.2.109",49242,"194.247.12.49",38925,13,1578,7,846,6,732,6522.373703,4.106738999999834,1648.0229203755762,1425.9489098285128
"10.0.2.109",49243,"62.152.53.250",80,8,1061,5,689,3,372,6522.397564,1.9166080000004513,2875.9141149357106,1552.7431796169583
"10.0.2.109",49244,"194.247.12.49",38925,13,2090,7,918,6,1172,6522.473623,2.1077729999997246,3484.246168824138,4448.296851701405
"10.0.2.109",49245,"128.199.53.58",80,8,1273,5,659,3,614,6522.517882,3.961771000000226,1330.7180046498647,1239.8495521320438
"10.0.2.109",49246,"194.247.12.49",38925,12,2051,6,875,6,1176,6522.574016,1.6972700000005716,4124.270151477162,5543.019083585305
"10.0.2.109",49247,"62.161.94.220",80,10,1378,5,796,5,582,6522.589697,0.07558599999993021,84248.40578950969,61598.708755646534
"10.0.2.109",49248,"194.247.12.49",38925,13,2553,7,1211,6,1342,6522.673881,1.701799000000392,5692.799208365835,6308.618115298885
"10.0.2.109",49249,"173.194.122.13",80,48,49685,13,2076,35,47609,6522.704219,3.756953000000067,4420.603611490403,101377.898525745
"10.0.2.109",49250,"194.247.12.49",38925,13,2897,7,1699,6,1198,6522.773612,1.4088769999998476,9647.400021436555,6802.581062790461
"10.0.2.109",49251,"91.185.213.10",80,12,2465,6,1324,6,1141,6522.804189,1.325206999999864,7992.713591160542,6887.980519270527
"10.0.2.109",49252,"194.247.12.49",38925,14,4389,8,3191,6,1198,6522.874303,1.7191800000000512,14848.939610744215,5574.750753265926
"10.0.2.109",49253,"91.185.213.10",80,10,2701,5,1126,5,1575,6522.923043,0.726144000000204,12405.252952578923,17351.930195658795
"10.0.2.109",49254,"194.247.12.49",38925,16,4900,9,3648,7,1252,6522.974166,1.6808410000003278,17362.736868028747,5958.92175404934
"10.0.2.109",49255,"91.185.213.10",80,11,4193,5,1126,6,3067,6523.018726,0.322690999999395,27915.250192961343,76035.5882254107
"10.0.2.109",49256,"194.247.12.49",38925,23,13351,14,12245,9,1106,6523.074872,0.9595950000002631,102084.73366365304,9220.556588975114
"10.0.2.109",49257,"91.185.213.10",80,12,4650,6,1180,6,3470,6523.104413,1.0926970000000438,8639.17444634663,25405.02993968034
"10.0.2.109",49258,"104.31.92.48",80,35,23290,12,1854,23,21436,6523.151807,2.4520940000002156,6048.707757532417,69935.32874350858
"10.0.2.109",49259,"194.247.12.49",38925,13,2098,7,1296,6,802,6523.174261,3.207129999999779,3232.796924353149,2000.542541150637
"10.0.2.109",49260,"195.5.165.160",80,21,13204,8,1029,13,12175,6523.219519,0.21088199999940116,39036.048596008084,461869.6711918352
"10.0.2.109",49261,"91.185.213.10",80,10,1894,5,1100,5,794,6523.599805,0.736507999999958,11948.274832045954,8624.482015131352
"10.0.2.109",49262,"91.185.213.10",80,10,1909,5,1104,5,805,6523.969818,0.056576000000859494,156108.59728269628,113829.18551863272
"10.0.2.109",49263,"194.247.12.49",38925,31,15141,17,9578,14,5563,6524.435091,95.38589599999978,803.3053440101897,466.5679294976702
"10.0.2.109",49264,"194.247.12.49",38925,14,2841,7,658,7,2183,6524.495835,0.49638899999990826,10604.586322422481,35182.085018006495
"10.0.2.109",49265,"194.247.12.49",38925,21,5984,10,4666,11,1318,6524.556598,12.964665999999852,2879.2103090045225,813.2874383343251
"10.0.2.109",49266,"173.194.122.26",80,25,14769,13,5477,12,9292,6524.58184,95.23599300000024,460.0781555351651,780.5452293651184
"10.0.2.109",49267,"88.85.84.114",80,8,1797,5,733,3,1064,6524.591751,1.7893800000001647,3277.1127429609473,4756.954922933763
"10.0.2.109",49268,"91.185.213.10",80,12,2699,6,2111,6,588,6524.642166,0.09293800000068586,181712.5395411497,50614.38808630792
"10.0.2.109",49269,"194.247.12.49",38925,12,1608,6,666,6,942,6524.64704,0.6974689999997281,7639.049190719697,10804.781287774707
"10.0.2.109",49270,"195.5.165.160",80,10,1461,5,865,5,596,6524.79311,0.03429099999993923,201802.22215777502,139045.23052720685
"10.0.2.109",49271,"194.247.12.49",38925,22,11124,13,10184,9,940,6525.05925,5.8721099999993385,13874.399491836695,1280.6299609511482
"10.0.2.109",49272,"194.247.12.49",38925,19,8643,11,7757,8,886,6525.119591,5.812722000000576,10675.893325019473,1219.394287220221
"10.0.2.109",49273,"194.247.12.49",38925,14,2897,7,658,7,2239,6525.217215,0.46764299999995274,11256.449898748686,38302.7223758333
"10.0.2.109",49274,"194.247.12.49",38925,23,13428,14,12150,9,1278,6525.317757,1.1623790000003282,83621.60706617424,8795.754224738328
"10.0.2.109",49275,"91.185.213.10",80,12,2755,6,2167,6,588,6525.345871,0.09161799999947107,189220.45886288813,51343.62243256955
"10.0.2.109",49276,"194.247.12.49",38925,47,35067,29,31696,18,3371,6525.417564,94.38090399999965,2686.645171357979,285.7357670572863
"10.0.2.109",49277,"8.254.199.45",80,16,10761,7,809,9,9952,6525.457858,5.473095000000285,1182.5119059690473,14546.796647965339
"10.0.2.109",49278,"91.185.213.31",80,18,13124,7,1152,11,11972,6525.463194,1.016367000000173,9067.590742318898,94233.67740194604
"10.0.2.109",49279,"173.194.122.13",443,15,5393,8,924,7,4469,6525.506602,12.014427999999498,615.2602520902625,2975.755483324008
"10.0.2.109",49280,"194.247.12.49",38925,54,38368,33,34857,21,3511,6525.518144,5.5025970000006055,50677.16207455667,5104.49883936565
"10.0.2.109",49281,"194.247.12.49",38925,52,40467,32,37027,20,3440,6525.618061,94.19809900000018,3144.6069840538867,292.1502694019329
"10.0.2.109",49282,"194.247.12.49",38925,60,47381,37,43758,23,3623,6525.718942,5.214399999999841,67134.09021172342,5558.453513347822
"10.0.2.109",49283,"194.247.12.49",38925,92,76930,58,71087,34,5843,6525.818321,94.00089900000057,6049.899586598598,497.27183992144285
"10.0.2.109",49284,"91.185.213.31",80,47,35033,15,3191,32,31842,6525.819091,7.728482999999869,3303.106185263063,32960.67287720039
"10.0.2.109",49285,"91.185.213.31",80,58,47239,18,3335,40,43904,6525.863835,5.069026999999551,5263.337520199116,69289.82623293014
"10.0.2.109",49286,"194.247.12.49",38925,16,4074,8,712,8,3362,6525.918977,0.9858659999999873,5777.661467177156,27281.59810765393
"10.0.2.109",49287,"91.185.213.31",80,80,76248,20,5069,60,71179,6525.967228,6.179012999999941,6562.860443892963,92155.81841307106
"10.0.2.109",49288,"194.247.12.49",38925,13,1897,7,960,6,937,6526.018728,4.864327999999659,1578.8409005314893,1541.0145039562556
"10.0.2.109",49289,"91.185.213.10",80,14,3932,7,3290,7,642,6526.066869,0.5735349999995378,45890.83490985068,8954.989669338644
"10.0.2.109",49290,"8.254.199.45",80,15,8388,7,809,8,7579,6526.075808,4.856064000000515,1332.7666192206925,12485.832147186193
"10.0.2.109",49291,"194.247.12.49",38925,20,9359,11,8407,9,952,6526.118568,4.818981999999778,13956.474624724287,1580.4167768214015
"10.0.2.109",49292,"194.247.12.49",38925,17,6925,10,6082,7,843,6526.219114,1.844319999999243,26381.538995412928,3656.6322547078425
"10.0.2.109",49293,"178.79.215.59",80,19,9262,8,871,11,8391,6526.24242,3.4702360000001136,2007.9326017019512,19343.929346591358
"10.0.2.109",49294,"194.247.12.49",38925,13,1099,7,461,6,638,6526.319433,3.0386120000002848,1213.7120501069746,1679.7142906035788
"10.0.2.109",49295,"195.5.165.160",80,13,6671,6,767,7,5904,6526.366474,1.2556539999995948,4886.696494418033,37615.457761465535
"10.0.2.109",49296,"104.28.16.59",80,8,1589,5,861,3,728,6526.459449,4.4233460000004925,1557.1922250710736,1316.6503366454606
"10.0.2.109",49297,"194.247.12.49",38925,28,16310,16,12477,12,3833,6526.576942,93.24123500000042,1070.5134911608534,328.86737289569214
"10.0.2.109",49298,"194.247.12.49",38925,19,7318,10,4427,9,2891,6526.662189,4.185172000000421,8462.256748347843,5526.176701936664
"10.0.2.109",49299,"91.185.213.31",80,48,40217,15,3152,33,37065,6527.015158,5.130212000000029,4915.196487006748,57798.78102503334
"10.0.2.109",49300,"91.185.213.31",80,44,37794,14,3115,30,34679,6527.486902,3.533578000000489,7052.341847271109,78513.05390738838
"10.0.2.109",49301,"194.247.12.49",38925,48,37105,29,34487,19,2618,6527.674046,92.14285899999959,2994.220094690151,227.29922022497797
"10.0.2.109",49302,"174.129.254.219",80,12,6902,7,2761,5,4141,6527.864101,2.982788999999684,7405.150012287942,11106.383991627805
"10.0.2.109",49303,"88.85.84.106",80,24,16060,10,3707,14,12353,6527.995802,68.32127899999978,434.0668154060772,1446.4600406558595
"10.0.2.109",49304,"91.185.213.31",80,49,37125,15,2384,34,34741,6528.076406,4.069644000000153,4686.405002501271,68292.95142277544
"10.0.2.109",49305,"194.247.12.49",38925,13,2735,7,1807,6,928,6528.25495,2.5373970000000554,5697.177067679864,2925.8330485926476
"10.0.2.109",49306,"194.247.12.49",38925,17,5979,10,5136,7,843,6528.515972,91.28477199999998,450.10793256952,73.87869687618874
"10.0.2.109",49307,"195.5.165.160",80,10,2535,5,852,5,1683,6529.400039,1.1232989999998608,6067.8412426262685,11986.123018004706
"10.0.2.109",49308,"178.79.215.7",80,15,5828,7,816,8,5012,6529.936279,4.7738680000002205,1367.4445962895704,8399.059211523685
"10.0.2.109",49309,"194.247.12.49",38925,47,30405,25,21642,22,8763,6530.894352,88.9262319999998,1946.962061768235,788.3388109821201
"10.0.2.109",49310,"194.247.12.49",38925,32,15135,16,5976,16,9159,6531.114493,13.169162000000142,3630.2993311191317,5563.907559190115
"10.0.2.109",49311,"194.247.12.49",38925,21,10497,12,8517,9,1980,6531.17569,88.64574300000004,768.632510644081,178.68878373550316
"10.0.2.109",49312,"194.247.12.49",38925,19,5570,9,1250,10,4320,6531.266698,88.55084699999952,112.92946751825032,390.2842397430731
"10.0.2.109",49313,"194.247.12.49",38925,21,10241,11,6965,10,3276,6531.300386,88.492843,629.6554400450216,296.15954365936693
"10.0.2.109",49314,"54.192.46.143",80,37,29815,15,8351,22,21464,6531.395955,88.42114300000048,755.5658944603288,1941.9789676321993
"10.0.2.109",49315,"174.129.254.219",80,21,14503,12,8921,9,5582,6531.605724,12.67760300000009,5629.45534735545,3522.432434585598
"10.0.2.109",49316,"185.31.18.184",80,17,5427,10,4301,7,1126,6531.663519,11.066681000000244,3109.152599591444,813.974849369906
"10.0.2.109",49317,"194.247.12.49",38925,36,23209,20,17600,16,5609,6532.081984,26.518778999999995,5309.44505401248,1692.0839379520455
"10.0.2.109",49318,"194.247.12.49",38925,38,20381,21,14383,17,5998,6532.142442,13.478888999999981,8536.608618113863,3559.937321243618
"10.0.2.109",49319,"194.247.12.49",38925,69,60508,49,59013,20,1495,6532.237683,87.5780649999997,5390.664888519764,136.56387589746407
"10.0.2.109",49320,"173.194.122.26",80,15,10125,7,1840,8,8285,6532.299556,87.51887999999963,168.1922803399685,757.3223057699125
"10.0.2.109",49321,"54.192.46.144",80,28,22739,12,5371,16,17368,6532.304929,26.29555700000037,1634.0403057444037,5283.9344684730595
"10.0.2.109",49322,"194.247.12.49",38925,20,7992,11,5012,9,2980,6532.338048,2.1952989999999772,18264.482423578935,10859.568559909263
"10.0.2.109",49323,"54.230.46.30",80,27,19749,12,5706,15,14043,6532.368457,13.252604000000247,3444.4551425515433,8477.126457562446
"10.0.2.109",49324,"194.247.12.49",38925,30,16607,16,11115,14,5492,6532.437761,14.273924999999508,6229.540928651584,3078.060169154701
"10.0.2.109",49325,"88.85.84.123",80,17,8492,8,2196,9,6296,6532.443663,65.19539999999961,269.46686422661884,772.5698438846958
"10.0.2.109",49326,"54.230.46.30",80,13,7564,7,2838,6,4726,6532.522943,2.0099040000004607,11296.061901461362,18810.848677345453
"10.0.2.109",49327,"194.247.12.49",38925,30,15523,17,10156,13,5367,6532.537909,82.18732200000068,988.57096231946,522.416340564055
"10.0.2.109",49328,"194.247.12.49",38925,34,21456,19,16233,15,5223,6532.638462,87.15830000000005,1489.9785792058808,479.4035679906558
"10.0.2.109",49329,"5.149.255.156",80,64,60207,15,1210,49,58997,6532.65466,54.15968100000009,178.7307425241294,8714.52695594716
"10.0.2.109",49330,"194.247.12.49",38925,16,3460,8,765,8,2695,6532.738078,88.07976599999984,69.48247342074015,244.7781253188166
"10.0.2.109",49331,"54.230.46.30",80,23,16179,11,5296,12,10883,6532.918407,13.792957999999999,3071.7123912071656,6312.206562218199
"10.0.2.109",49332,"54.230.45.192",80,26,20974,11,4973,15,16001,6533.129123,86.66725600000063,459.04303235353046,1477.005340979055
"10.0.2.109",49333,"8.21.198.137",80,11,3156,6,2569,5,587,6533.220353,1.0020540000004985,20509.87272141998,4686.37418741671
"10.0.2.109",49334,"194.247.12.49",38925,16,3463,8,765,8,2698,6533.316541,87.50254700000005,69.94082126546553,246.66710558722352
"10.0.2.109",49335,"54.192.46.144",80,21,14987,10,5171,11,9816,6533.748809,80.97615399999995,510.8664459416043,969.7669760902703
"10.0.2.109",49336,"8.21.198.137",80,11,3159,6,2572,5,587,6534.507915,0.3444609999996828,59733.903112453794,13632.893128697659
"10.0.2.109",49337,"194.247.12.49",38925,19,5726,9,1518,10,4208,6542.854956,76.96497199999976,157.78606402923185,437.39377960145436
"10.0.2.109",49338,"173.194.122.26",80,14,5406,9,4120,5,1286,6542.983735,76.83153399999992,428.9905236045402,133.90335275617446
"10.0.2.109",49339,"194.247.12.49",38925,21,6159,10,4862,11,1297,6544.633617,21.221385999999256,1832.868032276561,488.9407317693747
"10.0.2.109",49340,"194.247.12.49",38925,21,6158,10,4861,11,1297,6544.694093,11.147703999999976,3488.431339762886,930.7746240840286
"10.0.2.109",49341,"194.247.12.49",38925,158,38443,66,20341,92,18102,6544.785977,76.21085700000003,2135.2338289543172,1900.2016996082323
"10.0.2.109",49342,"173.194.122.9",443,15,5582,8,917,7,4665,6544.795224,21.059625999999298,348.34426784218505,1772.1112426213667
"10.0.2.109",49343,"173.194.122.7",443,15,5581,8,917,7,4664,6544.847811,10.993585000000166,667.2982471141023,3393.97930702309
"10.0.2.109",49344,"173.194.122.9",443,169,38784,80,17236,89,21548,6544.931847,76.06484700000055,1812.7690442866335,2266.2768256143177
"10.0.2.109",49345,"194.247.12.49",38925,27,9465,12,5288,15,4177,6545.774875,75.21893,562.411616331155,444.24987167459045
"10.0.2.109",49346,"217.69.136.175",443,23,9004,12,3805,11,5199,6545.919934,75.07362499999999,405.4686316266199,554.01614082176
"10.0.2.109",49347,"194.247.12.49",38925,56,10562,25,6633,31,3929,6546.890663,74.14476399999967,715.681015587294,423.9274401089218
"10.0.2.109",49348,"216.58.218.195",443,52,10103,25,3397,27,6706,6547.050984,73.98425299999963,367.3214082461593,725.1272780979524
"10.0.2.109",49349,"194.247.12.49",38925,29,8245,13,5495,16,2750,6552.793681,68.20218999999997,644.5540825008701,322.57028696585854
"10.0.2.109",49350,"173.194.122.2",443,24,7724,12,2318,12,5406,6552.956737,68.0389499999992,272.5497674493833,635.6359114889414
"10.0.2.109",49351,"194.247.12.49",38925,32,10189,14,6273,18,3916,6554.895851,66.10391900000013,759.1683028656728,473.92046453403066
"10.0.2.109",49352,"173.194.122.8",443,26,9614,13,3430,13,6184,6555.056168,65.94340499999998,416.11439385030246,750.2190704286503
"10.0.2.109",49353,"194.247.12.49",38925,21,7450,10,5144,11,2306,6558.834268,1.1195690000004106,36757.00202487288,16477.769570248223
"10.0.2.109",49354,"194.247.12.49",38925,33,11375,15,6046,18,5329,6558.895354,62.10087099999964,778.861861695954,686.4960074392554
"10.0.2.109",49355,"217.69.139.58",443,20,7155,9,1992,11,5163,6558.970168,0.9836169999998674,16201.427994841639,41991.95418542539
"10.0.2.109",49356,"173.194.122.6",443,26,10742,13,4839,13,5903,6559.047211,61.94881600000008,624.9029844250769,762.3067404548933
"10.0.2.109",49357,"194.247.12.49",38925,21,7754,10,5144,11,2610,6592.717135,1.1204450000004726,36728.26421643422,18635.45287808968
"10.0.2.109",49358,"94.100.180.59",443,20,7459,9,2296,11,5163,6592.871806,0.9656269999995857,19021.837624681044,42774.2803380785
"10.0.2.109",49359,"88.85.84.123",80,8,1921,5,1210,3,711,6599.486968,20.305997999999818,476.70643915162833,280.1142795345519
"10.0.2.109",49360,"194.247.12.49",38925,500,407812,327,388384,173,19428,6608.133249,112.7427089999992,27558.961706339895,1378.5725159398212
"10.0.2.109",49361,"173.194.122.21",443,485,406759,141,17492,344,389267,6608.283938,112.59182600000076,1242.861093664109,27658.63305210077
"10.0.2.109",49362,"194.247.12.49",38925,12,2072,6,939,6,1133,6614.137375,5.682732999999644,1321.8991636595404,1595.0071910822783
"10.0.2.109",49363,"88.85.84.114",80,8,1806,5,1045,3,761,6614.288984,5.52646199999981,1512.7218824630093,1101.608949812775
"10.0.2.109",49364,"194.247.12.49",38925,11,1066,6,344,5,722,6614.91826,21.149281999999403,130.12262071119378,273.10619812058695
"10.0.2.109",49365,"62.210.86.40",80,3,194,3,194,0,0,6615.067534,9.002188000000388,172.40253147345214,0
"10.0.2.109",49366,"194.247.12.49",38925,22,12666,13,11358,9,1308,6620.007053,2.227962999999363,40783.44209487589,4696.666865653959
"10.0.2.109",49367,"91.185.213.10",80,18,12416,7,1182,11,11234,6620.405366,0.1309979999996358,72184.30815757714,686056.2756702382
"10.0.2.109",49368,"194.247.12.49",38925,14,3052,7,904,7,2148,6621.033349,9.683098999999856,746.8683321321105,1774.6384705970945
"10.0.2.109",49369,"194.247.12.49",38925,12,2039,6,991,6,1048,6621.153298,77.84061399999973,101.84914522899354,107.70726962662485
"10.0.2.109",49370,"173.194.122.26",80,9,2732,6,2060,3,672,6621.193417,9.522268999999142,1730.679946134843,564.5713222342789
"10.0.2.109",49371,"194.247.12.49",38925,34,22249,21,20957,13,1292,6621.214137,5.128558000000339,32690.670554956952,2015.3813216111266
"10.0.2.109",49372,"194.247.12.49",38925,13,1578,7,846,6,732,6621.478155,77.51540999999997,87.3116713179999,75.54626879997154
"10.0.2.109",49373,"194.247.12.49",38925,41,22797,24,20635,17,2162,6621.576218,4.75086199999987,34747.37847573862,3640.6024843492555
"10.0.2.109",49374,"91.185.202.180",80,11,1948,6,1027,5,921,6621.578205,14.1416049999998,580.9807302636523,521.0158252899939
"10.0.2.109",49375,"128.199.53.58",80,12,1501,7,779,5,722,6621.625124,18.034114999999474,345.56727624284207,320.28186578604874
"10.0.2.109",49376,"194.247.12.49",38925,12,1306,6,550,6,756,6621.676307,9.034352000000581,487.02994968534733,669.4448035674956
"10.0.2.109",49377,"194.247.12.49",38925,13,1759,7,888,6,871,6621.776826,77.21626299999934,92.00134432820273,90.24005733092858
"10.0.2.109",49378,"62.152.53.250",80,8,1061,5,689,3,372,6621.800328,8.910063999999693,618.6263084081315,334.00433487347595
"10.0.2.109",49379,"194.247.12.49",38925,29,14513,16,9670,13,4843,6621.876712,8.84022399999958,8750.909479217233,4382.6943751653625
"10.0.2.109",49380,"88.85.84.114",80,11,1618,6,854,5,764,6621.927341,66.70244900000034,102.42502490425748,91.63081853261443
"10.0.2.109",49381,"194.247.12.49",38925,12,1523,6,652,6,871,6621.976391,0.723957000000155,7204.847801732539,9624.881035750064
"10.0.2.109",49382,"104.28.16.59",80,34,22381,12,1870,22,20511,6621.992844,4.333950999999615,3451.815675812054,37861.064880524624
"10.0.2.109",49383,"194.247.12.49",38925,13,2023,7,809,6,1214,6622.076971,76.91741399999955,84.14219438006636,126.26529539851738
"10.0.2.109",49384,"194.247.12.49",38925,22,11440,12,8713,10,2727,6622.176675,4.177447000000029,16685.78919134091,5222.32837424385
"10.0.2.109",49385,"173.194.113.98",80,8,1708,5,1131,3,577,6622.232071,76.76198699999986,117.87084146219425,60.13393061333871
"10.0.2.109",49386,"88.85.84.106",80,22,14101,10,4663,12,9438,6622.278039,8.438043000000107,4420.930303389012,8948.046365727105
"10.0.2.109",49387,"194.247.12.49",38925,63,52577,44,48428,19,4149,6622.330834,7.661528999999973,50567.452005990104,4332.294506749256
"10.0.2.109",49388,"62.161.94.220",80,10,1378,5,796,5,582,6622.370036,0.07412099999964994,85913.57375143448,62816.20593383777
"10.0.2.109",49389,"173.194.122.13",80,53,51989,16,3955,37,48034,6622.45928,7.532264000000396,4200.596261628421,51016.79919875084
"10.0.2.109",49390,"194.247.12.49",38925,13,2900,7,1693,6,1207,6622.555377,1.7579640000003565,7704.367097390648,5492.717712079452
"10.0.2.109",49391,"173.194.122.26",80,18,11176,8,2587,10,8589,6622.57719,3.77667399999973,5479.954054811583,18193.786384529063
"10.0.2.109",49392,"194.247.12.49",38925,12,2508,6,1157,6,1351,6622.616275,1.5986979999997857,5789.711377634326,6760.501357980963
"10.0.2.109",49393,"104.31.93.48",80,30,21999,10,1112,20,20887,6622.647532,3.6948709999996936,2407.661864243904,45223.77100581153
"10.0.2.109",49394,"194.247.12.49",38925,12,2060,6,875,6,1185,6622.707883,1.4951979999996183,4681.654202320888,6340.29740542886
"10.0.2.109",49395,"194.247.12.49",38925,13,2099,7,918,6,1181,6622.807878,3.460431000000426,2122.2789877905657,2730.2957348373184
"10.0.2.109",49396,"194.247.12.49",38925,23,13351,14,12245,9,1106,6622.907616,1.2754399999994348,76804.86733993242,6937.21382425196
"10.0.2.109",49397,"91.185.213.10",80,11,1969,6,1175,5,794,6622.940326,3.0559690000000046,3075.9474327128273,2078.5551162331785
"10.0.2.109",49398,"91.185.213.10",80,10,2704,5,1135,5,1569,6622.95063,1.0974949999999808,8273.386211326848,11436.954154688832
"10.0.2.109",49399,"195.5.165.160",80,19,13096,7,975,12,12121,6623.328063,0.20387099999970815,38259.487617224455,475634.10195731034
"10.0.2.109",49400,"91.185.213.10",80,12,2474,6,1333,6,1141,6623.560575,0.10466299999916373,101888.91967634414,87213.24632461264
"10.0.2.109",49401,"194.247.12.49",38925,13,4344,7,3137,6,1207,6623.618147,1.9148880000002464,13105.727332354045,5042.592569381999
"10.0.2.109",49402,"91.185.213.10",80,10,1918,5,1113,5,805,6623.836598,0.052920000000085565,168253.96825369622,121693.12169292493
"10.0.2.109",49403,"194.247.12.49",38925,16,4910,9,3649,7,1261,6623.881001,1.9325010000002294,15105.813658050647,5220.1784112912765
"10.0.2.109",49404,"91.185.213.10",80,12,4660,6,1189,6,3471,6624.27983,1.0980779999999868,8662.408317077761,25287.821083748455
"10.0.2.109",49405,"194.247.12.49",38925,19,9802,11,8904,8,898,6624.322848,2.029262000000017,35102.41654355101,3540.2032857265053
"10.0.2.109",49406,"194.247.12.49",38925,76,46209,43,38285,33,7924,6624.384037,58.08039600000029,5273.380023097612,1091.4526133740494
"10.0.2.109",49407,"194.247.12.49",38925,13,1103,7,461,6,642,6624.452552,3.013966000000437,1223.6368957046845,1704.0670000919902
"10.0.2.109",49408,"194.247.12.49",38925,12,2043,6,1241,6,802,6624.512995,4.73102899999958,2098.48639693413,1356.153175133902
"10.0.2.109",49409,"194.247.12.49",38925,14,2891,7,658,7,2233,6624.573635,0.7465470000006462,7051.130069500572,23928.835023092368
"10.0.2.109",49410,"194.247.12.49",38925,13,2744,7,1816,6,928,6624.670275,0.672842999999375,21591.961274789952,11033.777567734072
"10.0.2.109",49411,"91.185.213.10",80,12,2749,6,2161,6,588,6624.718461,0.3312319999995452,52193.02482859064,14201.526422587367
"10.0.2.109",49412,"178.79.215.59",80,15,9543,7,817,8,8726,6624.742132,1.609704999999849,4060.371310271518,43366.95232977878
"10.0.2.109",49413,"195.5.165.160",80,10,2544,5,852,5,1692,6624.818615,0.27480500000001484,24803.04215716465,49256.7456923974
"10.0.2.109",49414,"91.185.213.10",80,11,4202,5,1135,6,3067,6625.016443,0.09604899999976624,94535.08105260959,255452.94589282258
"10.0.2.109",49415,"88.85.84.123",80,8,1796,5,733,3,1063,6625.659477,3.584251000000222,1636.046136277743,2372.60169558423
"10.0.2.109",49416,"194.247.12.49",38925,21,8021,12,6503,9,1518,6626.162965,4.549282999999377,11435.64821093942,2669.431644503466
"10.0.2.109",49417,"194.247.12.49",38925,21,11494,12,10555,9,939,6626.223978,4.427435999999943,19071.986585464158,1696.693074727697
"10.0.2.109",49418,"194.247.12.49",38925,23,5898,12,4586,11,1312,6626.323263,13.239188999999897,2771.1667232789173,792.7978065725991
"10.0.2.109",49419,"194.247.12.49",38925,39,17311,20,13373,19,3938,6626.423154,94.45369599999958,1132.660811917836,333.5390920012293
"10.0.2.109",49420,"194.247.12.49",38925,14,2906,7,658,7,2248,6626.475359,3.406818000000385,1545.1368403006575,5278.826165647231
"10.0.2.109",49421,"194.247.12.49",38925,15,4029,7,658,8,3371,6626.538441,1.932969000000412,2723.2718165676106,13951.59467119972
"10.0.2.109",49422,"173.194.122.13",443,32,16666,14,3436,18,13230,6626.577297,94.29935600000044,291.49721870847,1122.3830627220773
"10.0.2.109",49423,"173.194.122.11",443,15,5203,8,922,7,4281,6626.760054,12.802106999999523,576.1551594593199,2675.184639528577
"10.0.2.109",49424,"194.247.12.49",38925,16,3433,8,765,8,2668,6626.800031,4.541109000000688,1347.6884170802932,4700.173459830356
"10.0.2.109",49425,"31.28.27.51",80,11,948,6,482,5,466,6626.845256,1620.0111690000003,2.380230503213277,2.3012187022767367
"10.0.2.109",49426,"91.185.213.10",80,12,2764,6,2176,6,588,6626.875932,2.743003000000499,6346.329187389453,1714.9088061511943
"10.0.2.109",49427,"194.247.12.49",38925,27,11667,13,5353,14,6314,6626.893986,4.4614089999995485,9598.761288194903,11321.983705149003
"10.0.2.109",49428,"8.37.70.26",80,11,3129,6,2542,5,587,6626.990304,0.5333040000004985,38132.097265313954,8805.48430162836
"10.0.2.109",49429,"8.254.199.45",80,17,7766,8,1441,9,6325,6627.288135,3.423674000000574,3367.143016536641,14779.444538233347
"10.0.2.109",49430,"8.254.199.45",80,16,11185,7,808,9,10377,6627.348143,3.302966000000197,1957.0289249116142,25133.7737052077
"10.0.2.109",49431,"194.247.12.49",38925,18,2452,8,1779,10,673,6627.350568,1.3379649999997127,10637.049549130998,4024.0215551237557
"10.0.2.109",49432,"91.185.213.112",443,68,45522,24,7230,44,38292,6627.532593,54.931876999999986,1052.940535783986,5576.652696575435
"10.0.2.109",49433,"91.185.213.10",80,14,3941,7,3299,7,642,6627.659688,0.12130200000046898,217572.6698644537,42340.6044416427
"10.0.2.109",49434,"174.129.254.219",80,18,11143,10,6076,8,5067,6628.111337,3.243148999999903,14987.902190124923,12498.963199039332
"10.0.2.109",49435,"5.101.114.217",80,7,1824,4,343,3,1481,6628.11575,0.5726199999999153,4792.008661940564,20690.859557825002
"10.0.2.109",49436,"194.247.12.49",38925,18,8625,10,6348,8,2277,6628.675087,2.682952000000114,18928.40423533401,6789.536301804589
"10.0.2.109",49437,"194.247.12.49",38925,14,3019,7,398,7,2621,6628.78567,2.633582999999817,1208.9992986741718,7961.776788505036
"10.0.2.109",49438,"88.85.84.123",80,14,8375,7,2205,7,6170,6629.079428,2.277610000000095,7744.960726375131,21671.840218473724
"10.0.2.109",49439,"194.247.12.49",38925,26,7440,14,6226,12,1214,6629.432317,20.131013000000166,2474.1924313495592,482.4397063376751
"10.0.2.109",49440,"194.247.12.49",38925,24,8518,12,7232,12,1286,6629.493409,20.07984900000065,2881.2965675189157,512.3544504741877
"10.0.2.109",49441,"23.21.71.2",443,16,6653,8,786,8,5867,6629.585906,19.97722999999951,314.75835238419717,2349.47487714769
"10.0.2.109",49442,"194.247.12.49",38925,24,7332,12,6118,12,1214,6629.587842,19.97508900000048,2450.251911268021,486.2055933768188
"10.0.2.109",49443,"54.230.46.40",443,17,7869,8,834,9,7035,6629.65464,19.918415000000095,334.9664117350687,2825.526027045813
"10.0.2.109",49444,"194.247.12.49",38925,25,8572,13,7286,12,1286,6629.688025,19.884859999999208,2931.2753522027474,517.3785483025986
"10.0.2.109",49445,"174.129.254.219",443,16,6653,8,786,8,5867,6629.738532,19.82413599999927,317.1891072579522,2367.61894692418
"10.0.2.109",49446,"194.247.12.49",38925,25,8572,13,7286,12,1286,6629.788937,19.783707999999933,2946.2626520771637,520.0238499274269
"10.0.2.109",49447,"54.230.46.40",443,17,7869,8,834,9,7035,6629.836083,19.736582999999882,338.05243795240744,2851.557435246027
"10.0.2.109",49448,"194.247.12.49",38925,18,1940,9,662,9,1278,6629.887828,19.67464800000016,269.1788945855578,519.6535155292189
"10.0.2.109",49449,"194.247.12.49",38925,19,2216,9,752,10,1464,6630.211961,19.360295000000406,310.7390667342555,604.9494597060507
"10.0.2.109",49450,"8.37.70.23",80,13,3244,7,2603,6,641,6630.243693,1.5288479999999254,13620.713112095524,3354.159471706965
"10.0.2.109",49451,"194.247.12.49",38925,55,13947,23,4425,32,9522,6630.272142,90.60500300000058,390.7069016928323,840.7482752359658
"10.0.2.109",49452,"173.194.122.2",443,48,13318,24,8874,24,4444,6630.423147,90.45381899999938,784.8424840967796,393.0403424978689
"10.0.2.109",49453,"173.194.122.8",443,12,1587,7,1086,5,501,6630.631939,18.940090000000055,458.7095415069292,211.61462273938446
"10.0.2.109",49454,"54.230.46.40",443,17,7869,8,834,9,7035,6630.738296,18.834113999999317,354.25080255966606,2988.194719433154
"10.0.2.109",49455,"194.247.12.49",38925,24,15023,15,14122,9,901,6630.843163,0.5144220000001951,219617.35695587893,14011.842417309652
"10.0.2.109",49456,"194.247.12.49",38925,13,3551,6,344,7,3207,6630.918318,0.4727130000001125,5821.714232524481,54273.946347982586
"10.0.2.109",49457,"5.149.255.156",80,20,14776,8,832,12,13944,6630.992857,0.36398800000006304,18286.317131330834,306471.6419222081
"10.0.2.109",49458,"54.230.46.40",80,10,3339,6,3119,4,220,6631.358613,0.4643869999999879,53731.04759607967,3789.9424402492873
"10.0.2.109",49459,"194.247.12.49",38925,35,11421,17,8288,18,3133,6631.675832,89.20190900000034,743.3024779772342,280.9805337237783
"10.0.2.109",49460,"194.247.12.49",38925,37,13981,16,8001,21,5980,6631.785236,89.075871,718.5784352307933,537.0702465541987
"10.0.2.109",49461,"194.247.12.49",38925,45,11801,20,8335,25,3466,6631.84646,89.02990500000033,748.9618235580477,311.44591247176885
"10.0.2.109",49462,"5.10.88.212",443,42,11366,20,2958,22,8408,6632.247933,88.62824700000056,267.0029116112367,758.9453958172002
"10.0.2.109",49463,"194.247.12.49",38925,70,22161,30,3676,40,18485,6632.774067,88.101584,333.7964956452996,1678.5169265515135
"10.0.2.109",49464,"173.194.122.16",443,28,10802,13,2657,15,8145,6632.805394,88.07212199999958,241.34765368773674,739.8481894191252
"10.0.2.109",49465,"173.194.122.6",443,61,21420,32,17833,29,3587,6632.897816,87.97763399999985,1621.5939610287796,326.1738091297164
"10.0.2.109",49466,"91.185.202.180",443,35,13628,18,5608,17,8020,6632.906955,87.95370599999933,510.0865221074407,729.4746625002986
"10.0.2.109",49467,"174.129.254.219",443,10,1261,6,904,4,357,6632.966634,16.595556999999644,435.77928719115334,172.09425390181607
"10.0.2.109",49468,"194.247.12.49",38925,60,12456,26,6742,34,5714,6634.712878,86.16218599999956,625.9822609421757,530.5343576125173
"10.0.2.109",49469,"194.247.12.49",38925,22,6543,11,4603,11,1940,6634.773976,1.6050209999993967,22943.001991882873,9669.655412611943
"10.0.2.109",49470,"74.125.136.157",443,57,12035,27,5112,30,6923,6634.868918,86.00570599999992,475.50333462758897,643.9572741836461
"10.0.2.109",49471,"62.161.94.230",443,22,6298,10,1676,12,4622,6634.92346,1.4555730000001859,9211.49265615554,25403.054329803643
"10.0.2.109",49472,"194.247.12.49",38925,31,11338,14,5898,17,5440,6635.794405,85.06979300000057,554.6504621211395,511.5799447166835
"10.0.2.109",49473,"217.69.136.175",443,27,10877,14,5068,13,5809,6635.923641,84.94018499999947,477.3241310929597,547.1144193999611
"10.0.2.109",49474,"194.247.12.49",38925,19,2674,9,999,10,1675,6638.265277,1.2349999999996726,6471.25506073046,10850.202429152674
"10.0.2.109",49475,"62.161.94.230",443,17,2321,8,1357,9,964,6638.442373,1.057875999999851,10262.072303371595,7290.079366580852
"10.0.2.109",49476,"194.247.12.49",38925,15,2463,7,891,8,1572,6642.274922,1.3840220000001864,5150.207149885652,9086.560762761217
"10.0.2.109",49477,"194.247.12.49",38925,27,7774,13,5573,14,2201,6642.352065,78.51063299999987,567.8721250406944,224.27535388741586
"10.0.2.109",49478,"62.161.94.230",443,14,2164,7,1308,7,856,6642.399852,1.259145000000899,8310.40110550614,5438.611121034599
"10.0.2.109",49479,"173.194.122.9",443,20,7145,10,1769,10,5376,6642.509867,78.35248000000047,180.61968172545292,548.904131687979
"10.0.2.109",49480,"194.247.12.49",38925,20,7700,10,5144,10,2556,6652.792338,1.0765089999995325,38227.26981383144,18994.73204590847
"10.0.2.109",49481,"94.100.180.59",443,18,7351,8,2242,10,5109,6652.922928,0.9458940000004077,18961.955567951874,43209.915698780605
"10.0.2.109",49482,"194.247.12.49",38925,23,7910,11,5594,12,2316,6654.355402,66.49655699999948,672.9972500681554,278.6309673145956
"10.0.2.109",49483,"94.100.180.202",443,16,7305,8,1908,8,5397,6654.500252,66.35134999999991,230.04806985841313,650.7177321938447
"10.0.2.109",49484,"194.247.12.49",38925,68,62843,49,60936,19,1907,6671.495263,0.5052409999998417,964862.3132329971,30195.490864765092
"10.0.2.109",49485,"91.185.213.10",80,68,62809,16,1727,52,61082,6671.622043,0.19712099999924249,70088.93014977143,2478964.6968201147
"10.0.2.109",49486,"194.247.12.49",38925,24,15488,15,14160,9,1328,6672.192785,0.7891859999999724,143540.30608754331,13461.972209340222
"10.0.2.109",49487,"91.185.213.10",80,21,15292,8,1256,13,14036,6672.325815,0.15887500000008004,63244.6892210539,706769.4728556628
"10.0.2.109",49488,"194.247.12.49",38925,9,510,5,290,4,220,6672.932933,0.12828100000024278,18085.297121129468,13719.88057464994
"10.0.2.109",49489,"194.247.12.49",38925,9,510,5,290,4,220,6672.993474,0.1322390000004816,17543.9923168774,13309.23555073458
"10.0.2.109",49490,"194.247.12.49",38925,37,21287,20,17410,17,3877,6683.493702,37.327745000000505,3731.272810613074,830.9100911399705
"10.0.2.109",49491,"194.247.12.49",38925,20,3495,9,1164,11,2331,6683.612427,15.3813710000004,605.4076713967668,1212.3756718435252
"10.0.2.109",49492,"91.185.213.112",443,30,20666,12,3399,18,17267,6683.63924,37.181979999999385,731.3220006035302,3715.1329757049593
"10.0.2.109",49493,"91.185.213.112",443,14,2928,8,1961,6,967,6683.738493,15.255055999999968,1028.3803612389252,507.1105605905358
"10.0.2.109",49494,"194.247.12.49",38925,17,2581,8,945,9,1636,6685.462392,1.2056929999998829,6270.252875317958,10855.167940762094
"10.0.2.109",49495,"62.161.94.230",443,15,2228,7,1318,8,910,6685.613246,1.0547740000001795,9996.454216730983,6901.95245616479
"10.0.2.109",49496,"194.247.12.49",38925,50,22209,25,18788,25,3421,6697.485733,23.392290999999204,6425.364663940147,1169.9580857642773
"10.0.2.109",49497,"194.247.12.49",38925,24,6009,13,4697,11,1312,6697.552745,20.601150999999845,1823.9757574710404,509.4860961894837
"10.0.2.109",49498,"194.247.12.49",38925,22,5902,11,4590,11,1312,6697.645677,20.506476999999904,1790.653752958159,511.83828406995747
"10.0.2.109",49499,"173.194.122.10",443,15,5260,8,922,7,4338,6697.718057,20.435671999999613,360.9374822614172,1698.2069393167328
"10.0.2.109",49500,"194.247.12.49",38925,44,19318,24,16747,20,2571,6697.745143,23.130191000000195,5792.25653605709,889.2274171017363
"10.0.2.109",49501,"194.247.12.49",38925,51,19568,27,16174,24,3394,6697.845856,23.014468000000306,5622.202520605659,1179.7796064631882
"10.0.2.109",49502,"173.194.122.11",443,36,18623,15,2073,21,16550,6697.905535,22.969551000000138,721.9993111750377,5764.152725492945
"10.0.2.109",49503,"194.247.12.49",38925,14,1259,7,417,7,842,6697.945677,1.2086980000003678,2759.994638858495,5572.938815153124
"10.0.2.109",49504,"173.194.122.12",443,40,18711,16,2734,24,15977,6698.002279,22.857707999999548,956.876341232482,5591.811742454778
"10.0.2.109",49505,"194.247.12.49",38925,21,5846,10,4534,11,1312,6698.045938,5.744262999999592,6314.474110952541,1827.2143876421999
"10.0.2.109",49506,"173.194.122.12",443,15,5261,8,922,7,4339,6698.071585,20.08035700000073,367.32414667725936,1728.6545254149983
"10.0.2.109",49507,"173.194.122.11",443,6,564,4,452,2,112,6698.100723,1.053421000000526,3432.6257023528055,850.5621209369783
"10.0.2.109",49508,"194.247.12.49",38925,21,5848,10,4536,11,1312,6698.146387,21.436671999999817,1692.8000764297885,489.62824080156145
"10.0.2.109",49509,"173.194.122.11",443,41,21460,17,2761,24,18699,6698.189169,22.688638999999966,973.5268827715947,6593.255769991326
"10.0.2.109",49510,"194.247.12.49",38925,23,5954,12,4642,11,1312,6698.246317,5.525676999999632,6720.624459229606,1899.4957540950545
"10.0.2.109",49511,"173.194.122.12",443,15,5261,8,922,7,4339,6698.29743,21.28539400000045,346.5287041433127,1630.7896391299716
"10.0.2.109",49512,"194.247.12.49",38925,29,8093,13,5941,16,2152,6698.346262,22.51563199999964,2110.8890036931125,764.624328555391
"10.0.2.109",49513,"194.247.12.49",38925,23,5955,12,4643,11,1312,6698.446927,19.70488699999987,1885.0146159173732,532.6597407029062
"10.0.2.109",49514,"173.194.122.11",443,15,5259,8,922,7,4337,6698.4671,5.322775000000547,1385.743338765821,6518.404403717315
"10.0.2.109",49515,"173.194.122.11",443,24,7560,12,1708,12,5852,6698.500001,22.36140399999931,611.0528659113006,2093.6073602534725
"10.0.2.109",49516,"194.247.12.49",38925,21,5846,10,4534,11,1312,6698.546652,19.60490800000025,1850.1489524969736,535.3761415253704
"10.0.2.109",49517,"173.194.122.11",443,15,5259,8,922,7,4337,6698.642974,5.12868299999991,1438.185982639233,6765.089595126197
"10.0.2.109",49518,"194.247.12.49",38925,23,5955,12,4643,11,1312,6698.647161,19.49656899999991,1905.1557225273932,538.3511324479732
"10.0.2.109",49519,"173.194.122.12",443,15,5259,8,922,7,4337,6698.671512,19.479828000000452,378.6481071598696,1781.1245561305363
"10.0.2.109",49520,"173.194.122.11",443,15,5260,8,922,7,4338,6698.807615,19.335861000000477,381.4673678094716,1794.7998281534576
"10.0.2.109",49521,"173.194.122.12",443,15,5260,8,922,7,4338,6698.844772,19.306828999999198,382.0409866374383,1797.4986985175785
"10.0.2.109",49522,"194.247.12.49",38925,18,1948,9,674,9,1274,6699.170112,20.424558000000616,263.995920988833,499.0071266168743
"10.0.2.109",49523,"194.247.12.49",38925,17,1882,8,608,9,1274,6699.433427,20.158712000000378,241.28525671679364,505.58785700196563
"10.0.2.109",49524,"194.247.12.49",38925,18,1936,9,662,9,1274,6699.528398,20.06411499999922,263.9538300094575,507.97157013904655
"10.0.2.109",49525,"194.247.12.49",38925,16,1822,9,658,7,1164,6699.628221,15.11981999999989,348.1522928183033,615.8803477819225
"10.0.2.109",49526,"91.185.213.112",443,10,1261,6,904,4,357,6699.674329,19.917999999999665,363.08866352043987,143.3878903504392
"10.0.2.109",49527,"194.247.12.49",38925,15,1780,8,616,7,1164,6699.728898,15.01885399999992,328.12090722767704,620.0206753458053
"10.0.2.109",49528,"91.185.202.180",443,13,1415,7,954,6,461,6699.758093,14.989994999999908,509.1395961106089,246.03076918971772
"10.0.2.109",49529,"194.247.12.49",38925,18,1936,9,662,9,1274,6699.828635,19.764321000000564,267.9575989481171,515.6767085496997
"10.0.2.109",49530,"91.185.213.112",443,10,1261,6,904,4,357,6700.246171,19.346588000000338,373.8126846966438,147.62292968661708
"10.0.2.109",49531,"91.185.213.112",443,10,1261,6,904,4,357,6700.554998,19.036902000000737,379.8937453163188,150.0244104844312
"10.0.2.109",49532,"194.247.12.49",38925,19,2725,9,999,10,1726,6700.773484,2.2388209999999162,3569.7360351722173,6167.531928635884
"10.0.2.109",49533,"62.161.94.230",443,17,2372,8,1408,9,964,6701.916863,1.0954269999992903,10282.748188612566,7040.177026862581
"10.0.2.109",49534,"91.185.213.112",443,10,1261,6,904,4,357,6702.576291,17.018166999999266,424.9576349791556,167.82065894641434
"10.0.2.109",49535,"91.185.202.180",443,13,1415,7,954,6,461,6702.859928,11.887840000000324,642.0005652834991,310.2329775636196
"10.0.2.109",49536,"194.247.12.49",38925,15,1735,7,558,8,1177,6703.982067,0.7320390000004409,6098.035760386143,12862.702670205179
"10.0.2.109",49537,"194.247.12.49",38925,30,4856,13,1635,17,3221,6704.042693,16.82086099999924,777.6058550154235,1531.9073143759504
"10.0.2.109",49538,"173.194.122.8",443,7,1052,4,745,3,307,6704.10827,0.6054720000001907,9843.560065532547,4056.339516937573
"10.0.2.109",49539,"173.194.122.8",443,23,4227,11,2681,12,1546,6704.189787,16.67344199999934,1286.3570701239041,741.7784522236313
"10.0.2.109",49540,"194.247.12.49",38925,20,7700,10,5144,10,2556,6712.810981,1.0664090000000215,38589.32173303036,19174.631872011196
"10.0.2.109",49541,"217.69.139.59",443,18,7351,8,2242,10,5109,6712.937883,0.9394410000004427,19092.204832439234,43506.723679273884
"10.0.2.109",49542,"194.247.12.49",38925,19,9935,11,8534,8,1401,6717.5855,0.7074729999994815,96501.2092334973,15842.300695585858
"10.0.2.109",49543,"91.185.213.10",80,18,9837,7,1319,11,8518,6717.738611,0.08026700000027631,131461.2480840654,848966.5740561553
"10.0.2.109",49544,"194.247.12.49",38925,12,2044,6,696,6,1348,6718.374291,1.4469200000003184,3848.1740524692277,7453.072733805343
"10.0.2.109",49545,"194.247.12.49",38925,12,2037,6,696,6,1341,6718.435162,0.45487599999978556,12240.698564010027,23584.44938841587
"10.0.2.109",49546,"194.247.12.49",38925,12,2045,6,696,6,1349,6718.525125,0.4781029999994644,11646.026065526126,22572.54189999245
"10.0.2.109",49547,"91.185.213.10",80,10,1885,5,1259,5,626,6718.581391,0.05357800000001589,187987.60685350353,93471.20086599937
"10.0.2.109",49548,"194.247.12.49",38925,12,2014,6,714,6,1300,6718.625732,0.4744699999992008,12038.695807974416,21919.19404813269
"10.0.2.109",49549,"91.185.213.10",80,10,1893,5,1267,5,626,6718.673683,0.05266200000005483,192472.75074986607,95097.03391429846
"10.0.2.109",49550,"194.247.12.49",38925,22,10566,12,7594,10,2972,6718.725737,2.0958529999998063,28986.76577031195,11344.307067338308
"10.0.2.109",49551,"91.185.213.10",80,10,1862,5,1218,5,644,6718.753631,0.09513300000071467,102425.02601543943,54155.760881726594
"10.0.2.109",49552,"194.247.12.49",38925,12,2052,6,712,6,1340,6718.825618,0.45831600000019534,12428.106372017499,23389.975475426192
"10.0.2.109",49553,"173.194.122.16",80,17,10261,8,2845,9,7416,6718.851156,1.969625000000633,11555.499143234212,30121.469822926156
"10.0.2.109",49554,"194.247.12.49",38925,13,2097,7,766,6,1331,6718.925813,0.6689539999997578,9160.57008404497,15917.387443686495
"10.0.2.109",49555,"91.185.213.10",80,10,1900,5,1258,5,642,6718.976442,0.05377299999963725,187157.12346471075,95512.61785718943
"10.0.2.109",49556,"91.185.213.10",80,10,1891,5,1249,5,642,6719.054531,0.2907150000000911,34370.431522270505,17666.78705948572
"10.0.2.109",49557,"194.247.12.49",38925,12,2043,6,712,6,1331,6719.083007,0.4996339999997872,11400.345052583343,21311.600091275883
"10.0.2.109",49558,"91.185.213.10",80,10,1891,5,1249,5,642,6719.236485,0.056412999999338354,177122.29450866277,91042.84473543754
"10.0.2.109",49559,"194.247.12.49",38925,12,2035,6,712,6,1323,6719.345472,0.43630899999971007,13054.967924117507,24258.037308437444
"10.0.2.109",49560,"194.247.12.49",38925,13,2060,7,704,6,1356,6719.406546,1.4145120000002862,3981.5851685944413,7669.075978144975
"10.0.2.109",49561,"91.185.213.10",80,10,1883,5,1241,5,642,6719.473977,0.05305300000054558,187133.62109396083,96808.85152483711
"10.0.2.109",49562,"91.185.213.10",80,10,1892,5,1266,5,626,6719.517452,0.05244399999992311,193120.2806806279,95492.33468094238
"10.0.2.109",49563,"91.185.213.10",80,10,1854,5,1274,5,580,6719.532516,1.0506459999996878,9700.69842744657,4416.330524269239
"10.0.2.109",49564,"194.247.12.49",38925,12,2008,6,650,6,1358,6720.649057,0.4179070000000138,12442.95979727506,25996.21446876851
"10.0.2.109",49565,"194.247.12.49",38925,13,2153,7,1045,6,1108,6720.710008,6.23092699999961,1341.694422033916,1422.581262788114
"10.0.2.109",49566,"91.185.213.10",80,10,1856,5,1276,5,580,6720.774547,0.052775000000110595,193424.9171004947,87920.41686386123
"10.0.2.109",49567,"194.247.12.49",38925,13,1470,7,654,6,816,6720.80833,4.838268999999855,1081.378484743233,1349.2428800466025
"10.0.2.109",49568,"91.185.202.180",80,8,1846,5,1033,3,813,6720.837536,6.1030259999997725,1354.0823847056047,1065.7008506927943
"10.0.2.109",49569,"194.247.12.49",38925,40,23615,23,21469,17,2146,6721.013047,4.3924809999998615,39101.36435422382,3908.4972706769913
"10.0.2.109",49570,"194.247.12.49",38925,43,24565,25,21606,18,2959,6721.074284,5.857711999999992,29507.76685504515,4041.1682923298436
"10.0.2.109",49571,"194.247.12.49",38925,27,14146,14,9401,13,4745,6721.169187,10.042895999999928,7488.67657297263,3779.7862289921427
"10.0.2.109",49572,"194.247.12.49",38925,13,1763,7,888,6,875,6721.269787,5.6757449999995515,1251.6418549460134,1233.3182692317137
"10.0.2.109",49573,"88.85.84.123",80,23,13896,11,4619,12,9277,6721.294081,9.917410000000018,3725.9728094331012,7483.40544557499
"10.0.2.109",49574,"194.247.12.49",38925,13,2115,7,704,6,1411,6721.369301,1.44618200000059,3894.3922687446684,7805.379959089101
"10.0.2.109",49575,"88.85.84.114",80,8,1460,5,804,3,656,6721.415351,5.529876000000513,1163.1363885916073,949.0267051195204
"10.0.2.109",49576,"104.31.92.48",80,34,23257,12,1858,22,21399,6721.431652,3.9734989999997197,3740.78362672321,43083.438551264786
"10.0.2.109",49577,"194.247.12.49",38925,13,2130,7,705,6,1425,6721.470015,1.7467420000002676,3228.8683732337895,6526.43607355766
"10.0.2.109",49578,"91.185.213.10",80,10,1909,5,1329,5,580,6721.501962,1.0498529999995299,10127.132084210609,4419.666372341726
"10.0.2.109",49579,"194.247.12.49",38925,12,2067,6,650,6,1417,6721.570024,0.7121750000005704,7301.576157539699,15917.436023436543
"10.0.2.109",49580,"194.247.12.49",38925,12,2065,6,650,6,1415,6721.670031,0.711050000000796,7313.128471969874,15920.118135134418
"10.0.2.109",49581,"91.185.213.10",80,10,1915,5,1335,5,580,6721.717964,0.05333599999994476,200239.98800080735,86995.65021757923
"10.0.2.109",49582,"5.10.88.211",80,8,1149,5,727,3,422,6721.7591,3.8871509999999034,1496.2114926845252,868.502407032833
"10.0.2.109",49583,"194.247.12.49",38925,13,2138,7,704,6,1434,6721.771746,2.708031999999548,2079.7390872784886,4236.286720393967
"10.0.2.109",49585,"91.185.213.10",80,10,1924,5,1343,5,581,6721.870409,1.049699999999575,10235.30532533519,4427.931790037041
"10.0.2.109",49584,"194.247.12.49",38925,12,2085,6,650,6,1435,6721.870641,1.6906749999998283,3075.6946190134286,6790.187351206569
"10.0.2.109",49586,"194.247.12.49",38925,13,2043,7,809,6,1234,6722.05996,4.889227000000574,1323.7266340874007,2019.1330858638476
"10.0.2.109",49587,"91.185.213.10",80,10,1913,5,1333,5,580,6722.065096,0.05375999999978376,198363.09523889312,86309.52380987098
"10.0.2.109",49588,"194.247.12.49",38925,12,1571,6,652,6,919,6722.431544,0.4911240000001271,10620.53575064271,14969.742875522468
"10.0.2.109",49589,"104.28.16.59",80,39,24311,15,2775,24,21536,6722.489024,4.442473999999493,4997.215515499367,38781.99399704301
"10.0.2.109",49590,"173.194.113.105",80,8,1728,5,1151,3,577,6722.492385,4.456480000000738,2066.20471762433,1035.7950669585043
"10.0.2.109",49591,"194.247.12.49",38925,13,2126,7,704,6,1422,6722.576991,0.941197000000102,5983.869476846388,12086.73635806188
"10.0.2.109",49592,"62.161.94.220",80,10,1426,5,844,5,582,6722.582278,0.0748940000003131,90154.08443896404,62167.86391407236
"10.0.2.109",49593,"194.247.12.49",38925,13,2140,7,704,6,1436,6722.637261,1.6669160000001284,3378.6945472954644,6891.768991358362
"10.0.2.109",49594,"194.247.12.49",38925,34,4758,17,1636,17,3122,6722.731599,76.89004600000044,170.2170915595489,324.8274815702394
"10.0.2.109",49595,"91.185.213.10",80,10,1934,5,1354,5,580,6722.765983,1.2875859999994645,8412.641951686726,3603.6427858037673
"10.0.2.109",49596,"194.247.12.49",38925,32,9878,13,1741,19,8137,6722.784968,76.82789000000048,181.28833162019563,847.2964700709546
"10.0.2.109",49597,"91.185.213.10",80,10,1932,5,1352,5,580,6722.896784,1.0512150000004112,10289.04648430223,4413.940059833797
"10.0.2.109",49598,"91.185.213.10",80,10,1920,5,1340,5,580,6722.978974,0.2943390000000363,36420.589864063804,15764.135911311201
"10.0.2.109",49599,"194.247.12.49",38925,13,2137,7,704,6,1433,6723.046281,0.6867259999999078,8201.23309733541,16693.70316545688
"10.0.2.109",49600,"194.247.12.49",38925,12,2048,6,1242,6,806,6723.162061,2.5201850000003105,3942.567708322514,2558.5423292334513
"10.0.2.109",49601,"173.194.122.5",443,25,4019,13,2688,12,1331,6723.163767,76.45768500000031,281.25361106604146,139.26657601521623
"10.0.2.109",49602,"91.185.213.10",80,10,1931,5,1351,5,580,6723.191567,0.2902439999998023,37237.634541996944,15986.549248229629
"10.0.2.109",49603,"91.185.213.10",80,10,1933,5,1353,5,580,6723.267832,0.05301199999939854,204180.18562066712,87527.35229858606
"10.0.2.109",49604,"194.247.12.49",38925,13,2126,7,704,6,1422,6723.472181,2.2093439999998736,2549.172967179544,5149.039714956408
"10.0.2.109",49605,"194.247.12.49",38925,13,1390,7,604,6,786,6723.533088,7.439574999999422,649.499467375539,845.2095717834001
"10.0.2.109",49606,"88.85.84.123",80,8,1801,5,737,3,1064,6723.558864,2.122877000000699,2777.3629842888017,4009.652937969179
"10.0.2.109",49607,"194.247.12.49",38925,13,1608,7,846,6,762,6723.632972,3.3151269999998476,2041.5507460197787,1838.8435797483114
"10.0.2.109",49608,"194.247.12.49",38925,13,2110,7,704,6,1406,6723.714417,0.6472359999997934,8701.617338964144,17378.514174124415
"10.0.2.109",49609,"128.199.53.58",80,8,1303,5,689,3,614,6723.761931,3.1858890000003157,1730.129329678295,1541.798851121151
"10.0.2.109",49610,"194.247.12.49",38925,13,2116,7,704,6,1412,6723.815356,5.036396999999852,1118.2597400483253,2242.8732286196528
"10.0.2.109",49611,"91.185.213.10",80,10,1904,5,1324,5,580,6723.83889,0.2910650000003443,36390.49696798815,15941.456375704778
"10.0.2.109",49612,"91.185.213.10",80,10,1920,5,1340,5,580,6723.865812,1.2879339999999502,8323.407876490888,3602.66908086919
"10.0.2.109",49613,"194.247.12.49",38925,11,638,7,418,4,220,6724.199743,15.156058999999914,220.63783203800006,116.12517475684213
"10.0.2.109",49614,"173.194.122.9",443,24,9191,13,7593,11,1598,6724.211437,75.40120600000046,805.6104566815501,169.54635977572988
"10.0.2.109",49615,"194.247.12.49",38925,23,12238,14,11298,9,940,6724.260732,2.669253000000026,33861.15890850328,2817.2676025839164
"10.0.2.109",49616,"194.247.12.49",38925,22,11794,13,10854,9,940,6724.3537,2.5782250000002023,33678.98457271696,2916.7353508710103
"10.0.2.109",49617,"8.254.199.45",80,17,11875,7,809,10,11066,6724.384714,2.5449450000005527,2543.0804987921524,34785.820518707
"10.0.2.109",49618,"8.254.199.45",80,17,11485,7,809,10,10676,6724.498478,2.4329259999994974,2660.1713327907783,35105.05457215618
"10.0.2.109",49619,"194.247.12.49",38925,22,6183,11,4901,11,1282,6724.638958,2.3060250000007727,17002.41758002921,4447.479970944185
"10.0.2.109",49620,"62.152.53.250",80,9,1157,6,785,3,372,6724.660382,6.311987000000045,994.9323406401115,471.4838607874159
"10.0.2.109",49621,"194.247.12.49",38925,32,5238,15,1863,17,3375,6724.701104,74.91040500000054,198.95767483836048,360.4305703593487
"10.0.2.109",49622,"194.247.12.49",38925,22,6211,11,4917,11,1294,6724.79406,17.249025999999503,2280.476590388416,600.1498287497682
"10.0.2.109",49623,"173.194.122.1",443,15,5562,8,912,7,4650,6724.799048,2.1458199999997305,3400.0987967308147,17336.030049120927
"10.0.2.109",49624,"194.247.12.49",38925,22,6182,11,4900,11,1282,6724.894617,17.21804599999996,2276.6811053937304,595.6541177785228
"10.0.2.109",49625,"91.185.213.10",80,10,1910,5,1330,5,580,6724.940278,3.6532289999995555,2912.4919352171173,1270.1092649819009
"10.0.2.109",49626,"173.194.122.4",443,15,5582,8,916,7,4666,6724.955888,17.08677699999953,428.86964580858063,2184.613283125368
"10.0.2.109",49627,"194.247.12.49",38925,19,2208,9,752,10,1456,6724.99449,17.115671999999904,351.4907273287332,680.5458763173345
"10.0.2.109",49628,"194.247.12.49",38925,22,6181,11,4899,11,1282,6725.095186,21.088896000000204,1858.4187621770063,486.3222806921662
"10.0.2.109",49629,"173.194.122.23",443,23,4505,12,2893,11,1612,6725.103788,74.50747799999954,310.62653872139043,173.08329775972393
"10.0.2.109",49630,"173.194.122.24",443,12,1587,7,1086,5,501,6725.154114,16.95585200000005,512.3894688394292,236.37856711653228
"10.0.2.109",49631,"194.247.12.49",38925,13,1099,7,461,6,638,6725.194708,3.015755999999783,1222.9106068263698,1692.4446142195745
"10.0.2.109",49632,"194.247.12.49",38925,22,8840,12,6576,10,2264,6725.195767,6.016074999999546,8744.571834627057,3010.600765449461
"10.0.2.109",49633,"173.194.122.5",443,15,5561,8,912,7,4649,6725.334304,16.77818699999989,434.8503208362172,2216.6876552276026
"10.0.2.109",49634,"194.247.12.49",38925,19,2212,9,752,10,1460,6725.783942,20.396872999999687,294.947171559096,572.6367958461171
"10.0.2.109",49635,"194.247.12.49",38925,19,2224,9,764,10,1460,6725.876205,16.247402000000875,376.1832199387737,718.8841637573423
"10.0.2.109",49636,"194.247.12.49",38925,19,2212,9,752,10,1460,6725.88589,16.237106000000495,370.50937525442134,719.3400104673607
"10.0.2.109",49637,"173.194.122.15",443,13,1653,8,1152,5,501,6725.939616,20.240905999999995,455.31558715800577,198.0148517067369
"10.0.2.109",49638,"173.194.122.15",443,15,5560,8,912,7,4648,6726.079073,20.104796999999962,362.8984664704654,1849.5088510468456
"10.0.2.109",49639,"88.85.84.106",80,14,8374,7,2084,7,6290,6726.346862,4.864532999999938,3427.2560182036414,10344.26120657433
"10.0.2.109",49640,"194.247.12.49",38925,19,2212,9,752,10,1460,6726.732203,15.47723600000063,388.6998944772668,754.6567100223531
"10.0.2.109",49641,"194.247.12.49",38925,27,7507,14,5129,13,2378,6726.813137,4.8967469999997775,8379.440473441218,3885.028162574228
"10.0.2.109",49642,"194.247.12.49",38925,22,2394,12,934,10,1460,6726.87368,29.26729299999988,255.30205338771952,399.08029758679925
"10.0.2.109",49643,"194.247.12.49",38925,44,18685,24,14792,20,3893,6727.198104,72.43405999999959,1633.7065739515454,429.963472984949
"10.0.2.109",49644,"94.100.180.77",443,22,7004,10,2018,12,4986,6727.215151,4.494521999999961,3591.9281293984413,8874.803594242134
"10.0.2.109",49645,"179.60.192.3",443,33,17846,13,3305,20,14541,6727.598413,72.03357300000062,367.051069367332,1614.9136458911876
"10.0.2.109",49646,"194.247.12.49",38925,28,15244,16,12996,12,2248,6727.620761,3.3529319999997824,31008.08486423427,5363.663802308298
"10.0.2.109",49647,"173.194.122.31",443,12,1587,7,1086,5,501,6727.860437,14.26239600000008,609.1543103977726,281.01870120560227
"10.0.2.109",49648,"173.194.122.24",443,12,1587,7,1086,5,501,6727.884928,14.32423799999924,606.5244098848721,279.80545980876695
"10.0.2.109",49649,"194.247.12.49",38925,26,7388,13,5018,13,2370,6727.959288,3.671639000000141,10933.536766549885,5163.906364432688
"10.0.2.109",49650,"193.0.170.53",443,19,6765,10,1998,9,4767,6728.084198,3.546562000000449,4506.8999216700495,10752.948912212776
"10.0.2.109",49651,"194.247.12.49",38925,26,6107,13,4452,13,1655,6728.179228,13.92070799999965,2558.49055953195,951.1010503201658
"10.0.2.109",49652,"194.247.12.49",38925,66,61153,49,59790,17,1363,6728.441081,5.482592999999724,87243.390125808,1988.8399521906056
"10.0.2.109",49653,"5.149.255.156",80,62,60906,15,1240,47,59666,6728.591352,5.331763999999566,1860.5474660920488,89525.34283213563
"10.0.2.109",49654,"178.21.158.28",80,25,15055,9,2075,16,12980,6728.743499,1.543920000000071,10751.852427586427,67257.37084822738
"10.0.2.109",49655,"173.194.122.23",443,12,1587,7,1086,5,501,6729.032164,13.091228000000228,663.6504994031002,306.15920828817053
"10.0.2.109",49656,"217.20.147.94",443,19,5506,10,1305,9,4201,6729.303006,12.796650999999656,815.8384564836754,2626.312149952429
"10.0.2.109",49657,"194.247.12.49",38925,13,3042,7,1756,6,1286,6729.732802,0.6772739999996702,20741.974444621883,15190.307024933792
"10.0.2.109",49658,"194.247.12.49",38925,19,3644,10,885,9,2759,6729.794339,6.257800999999745,1131.3878469450033,3527.1175929053834
"10.0.2.109",49659,"91.185.213.10",80,10,2836,5,1204,5,1632,6729.857666,0.2920860000003813,32976.58908673276,44699.1639448072
"10.0.2.109",49660,"194.247.12.49",38925,16,3480,8,765,8,2715,6729.891962,6.172427000000425,991.5062583971553,3518.8751523506885
"10.0.2.109",49661,"194.247.12.49",38925,23,12690,14,11837,9,853,6730.061843,1.5576809999993202,60792.935138864326,4380.871308055358
"10.0.2.109",49662,"8.37.70.6",80,11,3176,6,2589,5,587,6730.083884,0.5489999999999782,37726.77595628565,8553.734061931124
"10.0.2.109",49663,"194.247.12.49",38925,21,5392,10,4175,11,1217,6730.16932,11.864480000000185,2815.1254837969705,820.6006500074043
"10.0.2.109",49664,"173.194.113.126",80,17,12321,7,716,10,11605,6730.220333,1.398878999999397,4094.7072620308613,66367.42706126836
"10.0.2.109",49665,"194.247.12.49",38925,22,5696,11,4279,11,1417,6730.230461,11.810827999999674,2898.357337859881,959.7972301349502
"10.0.2.109",49666,"194.247.12.49",38925,22,5665,11,4263,11,1402,6730.322213,11.725686999999198,2908.486300205893,956.5324402741406
"10.0.2.109",49667,"31.13.93.3",443,15,4807,8,829,7,3978,6730.568139,11.465275999999903,578.442245960765,2775.685469761065
"10.0.2.109",49668,"194.247.12.49",38925,18,4451,8,1472,10,2979,6730.972836,11.05783799999972,1064.9459686423602,2155.2133427891245
"10.0.2.109",49669,"194.247.12.49",38925,18,3834,9,1074,9,2760,6731.182488,5.13187199999993,1674.2428493929929,4302.523523579758
"10.0.2.109",49670,"92.122.206.73",443,15,5049,8,1021,7,4028,6731.215065,10.82591599999978,754.4858097919997,2976.5610595907688
"10.0.2.109",49671,"194.247.12.49",38925,12,2516,6,1548,6,968,6731.243464,2.610034000000269,4744.765776997052,2967.011157708751
"10.0.2.109",49672,"194.247.12.49",38925,13,1731,7,706,6,1025,6731.474689,1.080843000000641,5225.550796921153,7586.67077456683
"10.0.2.109",49673,"195.113.232.88",443,15,5028,8,1016,7,4012,6731.493383,10.554124000000229,770.1254978622408,3041.0861195111315
"10.0.2.109",49674,"194.247.12.49",38925,61,56756,46,55544,15,1212,6731.535809,2.3263740000002144,191006.2612460245,4167.859510121376
"10.0.2.109",49675,"74.125.136.157",80,13,3520,8,2678,5,842,6731.598683,4.715312000000267,4543.495743229459,1428.5374965643034
"10.0.2.109",49676,"194.247.12.49",38925,12,1381,6,607,6,774,6731.633849,1.756373000000167,2764.788572814282,3525.4470434238124
"10.0.2.109",49677,"194.247.12.49",38925,94,82301,66,79253,28,3048,6731.676205,66.04203000000052,9600.310590089295,369.21941981492404
"10.0.2.109",49678,"172.227.135.79",80,54,56337,13,1079,41,55258,6731.707726,2.154138000000785,4007.1713139997787,205216.19320574583
"10.0.2.109",49679,"194.247.12.49",38925,12,1335,6,559,6,776,6731.814938,2.0410439999996015,2191.0355680724538,3041.5806812597925
"10.0.2.109",49680,"195.113.232.72",443,95,82096,27,2770,68,79326,6731.851626,65.86647900000025,336.43820554002764,9634.764293382033
"10.0.2.109",49681,"194.247.12.49",38925,13,1487,7,713,6,774,6731.875807,2.045521000000008,2788.5316259280535,3027.101652830734
"10.0.2.109",49682,"62.161.94.220",80,10,1528,5,946,5,582,6731.894693,0.3096989999994548,24436.630405694956,15033.952321474064
"10.0.2.109",49683,"23.45.109.46",80,8,1080,5,699,3,381,6732.254457,1.6012259999997696,3492.324006730346,1903.5414113937936
"10.0.2.109",49684,"168.63.37.7",80,8,2265,5,895,3,1370,6732.658665,1.1945189999996728,5994.0444647610975,9175.241247734864
"10.0.2.109",49685,"54.231.244.8",80,8,1180,5,699,3,481,6732.999318,0.9215229999999792,6068.215334831714,4175.696103081624
"10.0.2.109",49686,"88.212.196.105",80,10,1236,5,699,5,537,6733.02627,0.10193799999979092,54856.87378613932,42143.26355244179
"10.0.2.109",49687,"194.247.12.49",38925,13,2100,7,1044,6,1056,6733.074552,8.957390999999916,932.414360386867,943.1317668280952
"10.0.2.109",49688,"89.184.80.21",80,8,1793,5,981,3,812,6733.203487,8.82757700000002,889.0321772327767,735.8757674954278
"10.0.2.109",49689,"194.247.12.49",38925,21,6123,10,4726,11,1397,6734.053209,8.056064000000333,4693.110680351899,1387.2779560837075
"10.0.2.109",49690,"194.247.12.49",38925,24,6285,13,4888,11,1397,6734.114277,7.997235000000728,4889.689999105496,1397.4830050634978
"10.0.2.109",49691,"194.247.12.49",38925,27,17994,17,16345,10,1649,6734.174626,2.137340000000222,61178.84847520114,6172.157915913533
"10.0.2.109",49692,"194.247.12.49",38925,34,22502,21,20589,13,1913,6734.26799,1.86568299999999,88285.09452034504,8202.894060781002
"10.0.2.109",49693,"104.28.16.59",80,30,22248,11,1783,19,20465,6734.420765,1.7125519999999597,8329.090153175108,95600.01681700985
"10.0.2.109",49694,"172.227.117.226",443,15,5538,8,1009,7,4529,6734.599915,7.509117999999944,1074.959802203143,4825.067338134821
"10.0.2.109",49695,"172.227.117.226",443,15,5538,8,1009,7,4529,6734.647671,7.463582000000315,1081.5182307904784,4854.5055175917505
"10.0.2.109",49696,"91.185.213.10",80,25,17842,9,1567,16,16275,6735.301276,0.35097899999982474,35717.23664380564,370962.3652699022
"10.0.2.109",49697,"8.21.198.146",80,11,3166,6,2579,5,587,6735.359517,0.344253000000208,59932.66580098804,13641.130215269477
"10.0.2.109",49698,"87.250.251.119",80,16,4310,9,2908,7,1402,6736.183368,5.846499000000222,3979.1334951052104,1918.413053692402
"10.0.2.109",49699,"194.247.12.49",38925,13,2180,7,750,6,1430,6736.554054,1.9984530000001541,3002.3222962959535,5724.427844937618
"10.0.2.109",49700,"194.247.12.49",38925,13,2171,7,750,6,1421,6736.615793,2.7344279999997525,2194.2431835837488,4157.359418496676
"10.0.2.109",49701,"194.247.12.49",38925,12,2092,6,714,6,1378,6736.711661,0.6505749999996624,8779.92545056752,16945.010183308183
"10.0.2.109",49702,"194.247.12.49",38925,12,2125,6,712,6,1413,6736.811441,0.5014289999999164,11359.534450542249,22543.570475584547
"10.0.2.109",49703,"91.185.213.10",80,10,1940,5,1296,5,644,6736.837192,0.09440699999959179,109822.36486748685,54572.224517485745
"10.0.2.109",49704,"194.247.12.49",38925,7,1233,4,236,3,997,6736.912225,0.4134910000002492,4566.000227329887,19289.416214609733
"10.0.2.109",49705,"91.185.213.10",80,10,1973,5,1331,5,642,6736.936079,0.053541000000222994,198875.62802255564,95926.48624378718
"10.0.2.109",49706,"91.185.213.10",80,10,1974,5,1348,5,626,6736.965675,1.0503639999997176,10266.916992588187,4767.870947596592
"10.0.2.109",49707,"194.247.12.49",38925,12,2125,6,712,6,1413,6737.012042,0.4294239999999263,13264.279593131678,26323.63351839194
"10.0.2.109",49708,"194.247.12.49",38925,12,2119,6,712,6,1407,6737.112506,0.4451049999997849,12796.980487756266,25288.415093080148
"10.0.2.109",49709,"91.185.213.10",80,10,1973,5,1331,5,642,6737.136568,0.05316800000036892,200270.83960137895,96599.45832012418
"10.0.2.109",49710,"91.185.213.10",80,10,1967,5,1325,5,642,6737.242541,0.05284100000062608,200601.80541387195,97197.25213260813
"10.0.2.109",49711,"194.247.12.49",38925,13,2191,7,766,6,1425,6737.512703,1.4471709999997984,4234.468490593616,7877.438118924155
"10.0.2.109",49712,"194.247.12.49",38925,13,2182,7,766,6,1416,6737.573124,0.9788680000001477,6260.292501133018,11572.551150919522
"10.0.2.109",49713,"91.185.213.10",80,10,1985,5,1343,5,642,6737.637558,1.05007999999998,10231.601401798154,4891.0559195490805
"10.0.2.109",49714,"194.247.12.49",38925,13,3376,7,1999,6,1377,6737.659797,0.9418980000000374,16978.483869802636,11695.533911314773
"10.0.2.109",49715,"194.247.12.49",38925,12,2126,6,712,6,1414,6737.752715,0.4876670000003287,11680.10138064737,23196.15639358902
"10.0.2.109",49716,"91.185.213.10",80,10,1974,5,1332,5,642,6737.881624,0.053171999999904074,200406.22884260936,96592.1913790955
"10.0.2.109",49717,"91.185.213.10",80,10,1976,5,1334,5,642,6737.988566,0.29289799999969546,36435.89235846983,17535.114613296573
"10.0.2.109",49718,"91.185.213.10",80,10,1965,5,1339,5,626,6738.027176,0.2904130000006262,36885.40113554456,17244.40710295063
"10.0.2.109",49719,"91.185.213.10",80,11,3224,5,1295,6,1929,6738.069696,0.05414400000063324,191341.60756277398,285017.7304931205
"10.0.2.109",49720,"194.247.12.49",38925,12,1414,6,600,6,814,6738.071832,3.9596369999999297,1212.2323334184637,1644.5951990043825
"10.0.2.109",49721,"194.247.12.49",38925,12,2133,6,712,6,1421,6738.754428,0.4587279999996099,12416.944245838153,24781.569906370805
"10.0.2.109",49722,"194.247.12.49",38925,13,2186,7,766,6,1420,6738.81536,0.9452810000002501,6482.728416204683,12017.590536567428
"10.0.2.109",49723,"91.185.213.10",80,10,1981,5,1339,5,642,6738.888066,0.05342899999959627,200490.3703996134,96127.5711699416
"10.0.2.109",49724,"91.185.213.10",80,10,1980,5,1338,5,642,6738.93964,0.2899360000001252,36918.492356918,17714.25418022523
"10.0.2.109",49725,"194.247.12.49",38925,13,2183,7,766,6,1417,6739.172162,2.3301430000001346,2629.8815137095216,4864.937473794245
"10.0.2.109",49726,"5.10.88.211",80,8,1147,5,725,3,422,6739.195012,2.835237999999663,2045.6836427843764,1190.728961731044
"10.0.2.109",49727,"194.247.12.49",38925,63,52043,42,49203,21,2840,6739.273376,2.618844999999965,150304.42809712118,8675.5802653461
"10.0.2.109",49728,"194.247.12.49",38925,13,2179,7,766,6,1413,6739.415918,2.2569650000004913,2715.150655858051,5008.495922620661
"10.0.2.109",49729,"178.21.158.28",80,68,52286,19,2721,49,49565,6739.423701,0.3966630000004443,54877.81819825801,999639.4924647771
"10.0.2.109",49730,"194.247.12.49",38925,12,2073,6,665,6,1408,6739.485971,0.7590559999998732,7008.705550052814,14839.484833796034
"10.0.2.109",49731,"194.247.12.49",38925,20,10792,12,9319,8,1473,6739.556262,2.333010000000286,31955.285232378286,5050.985636580451
"10.0.2.109",49732,"91.185.213.10",80,10,1921,5,1326,5,595,6739.628025,0.05327399999987392,199121.52269446832,89349.40120905629
"10.0.2.109",49733,"91.185.213.10",80,18,10640,7,1391,11,9249,6739.68234,1.050609999999324,10591.941824280333,70427.65631399627
"10.0.2.109",49734,"91.185.213.10",80,10,1973,5,1331,5,642,6739.834054,1.2890589999997246,8260.289094604883,3984.3017270746313
"10.0.2.109",49735,"194.247.12.49",38925,12,2126,6,712,6,1414,6739.986007,0.434954999999718,13095.607591598426,26007.288110281144
"10.0.2.109",49736,"194.247.12.49",38925,12,2075,6,650,6,1425,6740.046874,0.4772370000000592,10896.05374268834,23887.502435893668
"10.0.2.109",49737,"91.185.213.10",80,10,1974,5,1332,5,642,6740.113991,0.05313000000023749,200564.65273766927,96668.54884202979
"10.0.2.109",49738,"91.185.213.10",80,10,1977,5,1335,5,642,6740.152491,1.0523389999998471,10148.820864760834,4880.556550693974
"10.0.2.109",49739,"91.185.213.10",80,10,1923,5,1343,5,580,6740.18482,0.05303699999967648,202575.5604590293,87486.09461372822
"10.0.2.109",49740,"194.247.12.49",38925,13,2132,7,704,6,1428,6740.43514,0.6690160000007381,8418.333791708697,17075.82479340912
"10.0.2.109",49741,"91.185.213.10",80,10,1926,5,1346,5,580,6740.563936,0.29016000000046915,37110.55969114485,15991.177281474007
"10.0.2.109",49742,"194.247.12.49",38925,12,2102,6,650,6,1452,6740.773556,1.446063000000322,3595.9705766614884,8032.845042019202
"10.0.2.109",49743,"91.185.213.10",80,10,1950,5,1370,5,580,6741.896556,0.053394000000480446,205266.50934377234,86901.14994115909
"10.0.2.109",49744,"173.194.122.23",443,12,1587,7,1086,5,501,6742.034796,14.105924000000414,615.9114425967235,284.1359417504222
"10.0.2.109",49745,"194.247.12.49",38925,35,22407,22,20460,13,1947,6742.235685,31.24333900000056,5238.87667704137,498.53826442813045
"10.0.2.109",49746,"194.247.12.49",38925,38,23504,24,21523,14,1981,6742.296365,31.59704199999942,5449.370861994081,501.5659377229138
"10.0.2.109",49747,"104.28.16.59",80,29,22045,11,1817,18,20228,6742.382073,31.096434000000045,467.4490972180276,5203.940747675433
"10.0.2.109",49748,"194.247.12.49",38925,30,15171,16,9905,14,5266,6742.390007,57.22314800000004,1384.754295586813,736.2055649227822
"10.0.2.109",49749,"104.31.92.48",80,30,23038,11,1801,19,21237,6742.425811,31.467265999999654,457.8726350106221,5399.134452926475
"10.0.2.109",49750,"194.247.12.49",38925,12,1706,6,834,6,872,6742.489843,57.12513099999978,116.79623106684912,122.11788188284464
"10.0.2.109",49751,"88.85.84.123",80,25,14867,12,5140,13,9727,6742.518879,57.08672999999999,720.307504038154,1363.1188894511915
"10.0.2.109",49752,"194.247.12.49",38925,12,2085,6,650,6,1435,6742.59053,1.5115519999999378,3440.1727495979057,7594.842916419992
"10.0.2.109",49753,"88.85.84.114",80,8,1457,5,801,3,656,6742.619165,56.99245599999995,112.43593362602246,92.08236262006335
"10.0.2.109",49754,"194.247.12.49",38925,12,1980,6,755,6,1225,6742.690147,56.924103999999716,106.10619360824775,172.1590558544417
"10.0.2.109",49755,"194.247.12.49",38925,13,2145,7,704,6,1441,6742.791185,0.6988400000000183,8059.069314864421,16495.907503863113
"10.0.2.109",49756,"173.194.113.98",80,8,1719,5,1142,3,577,6742.836669,56.772492999999486,160.92300191925838,81.30698082960778
"10.0.2.109",49757,"194.247.12.49",38925,13,1689,7,706,6,983,6742.890527,4.56148900000062,1238.1921780364335,1723.998457520983
"10.0.2.109",49758,"91.185.213.10",80,10,1939,5,1359,5,580,6742.916021,0.2898219999997309,37512.680196845286,16009.826721243757
"10.0.2.109",49759,"194.247.12.49",38925,13,2165,7,704,6,1461,6742.990481,1.7009180000004562,3311.1531537666656,6871.583462575424
"10.0.2.109",49760,"91.185.213.10",80,10,1933,5,1353,5,580,6742.992625,0.053175000000010186,203554.3018335294,87259.05030557801
"10.0.2.109",49761,"194.247.12.49",38925,12,2302,6,755,6,1547,6743.090518,56.524639999999636,106.85605428004564,218.94876287580212
"10.0.2.109",49762,"194.247.12.49",38925,13,2146,7,704,6,1442,6743.191041,0.6710149999998976,8393.254994300962,17191.866053667596
"10.0.2.109",49763,"74.125.136.157",80,8,2042,5,1465,3,577,6743.248993,56.36272899999949,207.93883135076916,81.89809262074662
"10.0.2.109",49764,"194.247.12.49",38925,13,1818,7,706,6,1112,6743.291366,2.1719379999995,2600.4425540698217,4095.8811899796624
"10.0.2.109",49765,"62.161.94.220",80,10,1490,5,908,5,582,6743.295042,3.6179980000006253,2007.7401922275094,1286.8995505246812
"10.0.2.109",49766,"91.185.213.10",80,10,1940,5,1360,5,580,6743.317598,0.29197000000021944,37264.1024762538,15892.043703108238
"10.0.2.109",49767,"194.247.12.49",38925,16,3366,8,1283,8,2083,6743.39093,56.2231040000006,182.5584016136834,296.3906083876091
"10.0.2.109",49768,"91.185.213.10",80,10,1959,5,1379,5,580,6743.40228,1.0497719999993933,10508.948609799438,4420.007392083882
"10.0.2.109",49769,"194.247.12.49",38925,29,5184,12,1828,17,3356,6743.491863,56.11787899999945,260.5943107721542,478.4215027086156
"10.0.2.109",49770,"194.247.12.49",38925,36,9111,17,6619,19,2492,6743.591635,56.02063300000009,945.2231644722742,355.86888138161464
"10.0.2.109",49771,"173.194.122.9",443,22,4555,11,2816,11,1739,6743.616572,55.992793999999776,402.3374864987107,248.46054297629897
"10.0.2.109",49772,"194.247.12.49",38925,13,1475,7,661,6,814,6743.692035,0.7193200000001525,7351.3874214520365,9052.994494798726
"10.0.2.109",49773,"216.58.211.42",443,29,8482,14,2006,15,6476,6743.751014,55.86101199999939,287.284448051177,927.44470866372
"10.0.2.109",49774,"194.247.12.49",38925,12,1334,6,550,6,784,6743.793047,55.81728999999996,78.82862102405909,112.36661615065879
"10.0.2.109",49775,"88.212.201.197",80,10,1276,5,739,5,537,6743.82071,0.3525520000002871,16769.157457609617,12185.436474609425
"10.0.2.109",49776,"194.247.12.49",38925,19,2076,9,748,10,1328,6743.891913,12.248514999999315,488.5490200240874,867.3704526630855
"10.0.2.109",49777,"62.152.53.250",80,11,1251,6,771,5,480,6743.922171,10.11476599999969,609.8015515139143,379.642989269363
"10.0.2.109",49778,"194.247.12.49",38925,12,2094,6,990,6,1104,6743.991988,55.61997500000052,142.39488600992584,158.7918728837961
"10.0.2.109",49779,"173.194.122.9",443,12,1447,7,950,5,497,6744.037415,12.102851000000555,627.9512157920188,328.51763605119305
"10.0.2.109",49780,"194.247.12.49",38925,13,1605,7,846,6,759,6744.091958,55.51671299999998,121.90923479205266,109.37246951201888
"10.0.2.109",49781,"89.184.80.21",80,11,2003,6,1083,5,920,6744.14163,6.579077999999754,1316.901851596884,1118.6977871367806
"10.0.2.109",49782,"194.247.12.49",38925,13,2163,7,716,6,1447,6744.192727,3.41812900000059,1675.7705750716286,3386.6480755986686
"10.0.2.109",49783,"194.247.12.49",38925,12,2045,6,1242,6,803,6744.197475,55.41689299999962,179.2955083209026,115.92133106415844
"10.0.2.109",49784,"128.199.53.58",80,11,1462,6,740,5,722,6744.23776,15.247078000000329,388.2711166034484,378.82668403741854
"10.0.2.109",49785,"62.161.94.220",80,10,1615,5,1033,5,582,6744.438508,0.7832269999998971,10551.219505968367,5944.6367400518775
"10.0.2.109",49786,"213.180.193.119",80,12,3117,7,2012,5,1105,6744.516027,55.092319000000316,292.16413997747867,160.4579396993608
"10.0.2.109",49787,"88.85.84.106",80,8,1798,5,734,3,1064,6745.618055,53.99189200000001,108.75707041346132,157.6533009808213
"10.0.2.109",49788,"194.247.12.49",38925,17,2504,9,1324,8,1180,6746.652605,26.939351999999417,393.1794647473417,350.416743505939
"10.0.2.109",49789,"194.247.12.49",38925,18,8207,10,7310,8,897,6746.713911,52.8929420000004,1105.629556397138,135.67027525146824
"10.0.2.109",49790,"194.247.12.49",38925,21,10793,12,9841,9,952,6746.805822,52.800835999999435,1491.0369979748207,144.24014044020214
"10.0.2.109",49791,"178.79.215.17",80,16,8056,7,816,9,7240,6746.860087,3.8430719999996654,1698.6410871304436,15071.27631228482
"10.0.2.109",49792,"194.247.12.49",38925,16,6953,9,6109,7,844,6746.906413,52.70429200000035,927.2869086259554,128.11100849243843
"10.0.2.109",49793,"178.79.215.59",80,19,10642,8,871,11,9771,6746.952315,3.9885999999996784,1746.9788898361735,19597.85388356975
"10.0.2.109",49794,"194.247.12.49",38925,13,1103,7,461,6,642,6747.03313,4.01037499999984,919.6147492441847,1280.6782408129427
"10.0.2.109",49795,"178.79.215.7",80,15,6856,7,817,8,6039,6747.056793,3.6476550000006682,1791.8361248524882,13244.67363278357
"10.0.2.109",49796,"104.28.16.59",80,11,2142,6,1050,5,1092,6747.057548,26.53393899999992,316.57568821576115,329.23871574439164
"10.0.2.109",49797,"91.185.213.10",80,10,1945,5,1365,5,580,6747.323471,0.0532309999998688,205143.61932007506,87167.2521653066
"10.0.2.109",49798,"194.247.12.49",38925,22,10692,13,9752,9,940,6748.082545,51.52357599999959,1514.1806151032804,145.9526023581915
"10.0.2.109",49799,"194.247.12.49",38925,21,11026,12,10087,9,939,6748.143105,51.464906999999585,1567.9810710626691,145.9635397767271
"10.0.2.109",49800,"8.254.199.45",80,19,10491,8,863,11,9628,6748.208486,24.990230999999767,276.26795446588966,3082.1643865557194
"10.0.2.109",49801,"8.254.199.45",80,19,10879,8,862,11,10017,6748.271819,20.01057800000035,344.6177316817075,4004.681923730469
"10.0.2.109",49802,"194.247.12.49",38925,14,2326,7,1216,7,1110,6748.313123,25.78732300000047,377.23962274020545,344.355247731602
"10.0.2.109",49803,"194.247.12.49",38925,20,9086,11,6591,9,2495,6748.373765,51.240858999999546,1029.0225618583106,389.532892100817
"10.0.2.109",49804,"88.85.84.106",80,14,8728,7,2369,7,6359,6748.504079,51.10684499999934,370.83095229220754,995.4048229743131
"10.0.2.109",49805,"104.31.93.48",80,9,2022,5,984,4,1038,6749.4733,24.626846000000114,319.6511644243832,337.1929966184042
"10.0.2.109",49806,"194.247.12.49",38925,32,9446,14,5264,18,4182,6751.633983,47.97852899999998,877.7259511228453,697.3119163365766
"10.0.2.109",49807,"173.194.122.2",443,26,8871,13,3696,13,5175,6751.792818,47.819478999999774,618.3254317764554,865.755981992196
"10.0.2.109",49808,"194.247.12.49",38925,16,3469,8,765,8,2704,6752.415011,46.844796000000315,130.64418083921123,461.78021567219236
"10.0.2.109",49809,"8.37.70.24",80,11,3165,6,2578,5,587,6752.600979,1.5595869999997376,13224.013793397527,3011.053567387257
"10.0.2.109",49810,"194.247.12.49",38925,16,3474,8,765,8,2709,6752.872442,46.38864100000046,131.92884870242133,467.1833348168097
"10.0.2.109",49811,"8.21.198.146",80,11,3170,6,2583,5,587,6753.066505,0.34636700000010023,59659.263151495434,13557.873584950763
"10.0.2.109",49812,"194.247.12.49",38925,22,7808,11,5198,11,2610,6772.841955,1.3751069999998435,30240.555825840995,15184.272932944401
"10.0.2.109",49813,"217.69.139.58",443,20,7459,9,2296,11,5163,6772.975769,1.2410980000004201,14799.79824316354,33280.208331643444
"10.0.2.109",49814,"194.247.12.49",38925,160,83395,83,72665,77,10730,6773.551937,26.05931199999941,22307.57281696513,3294.024032560873
"10.0.2.109",49815,"194.247.12.49",38925,19,2204,9,752,10,1452,6773.671321,21.031138000000283,286.0520434034487,552.3238923162334
"10.0.2.109",49816,"173.194.122.23",443,144,82292,51,9122,93,73170,6773.701817,25.90920499999993,2816.605140914212,22592.74261792292
"10.0.2.109",49817,"194.247.12.49",38925,18,2150,8,698,10,1452,6773.793547,10.948159999999916,510.04004325841447,1061.0002046005986
"10.0.2.109",49818,"173.194.122.15",443,12,1587,7,1086,5,501,6773.831189,20.871077999999216,416.2698256410295,192.03607978467383
"10.0.2.109",49819,"173.194.122.23",443,12,1587,7,1086,5,501,6773.922277,10.819277000000511,803.011143905419,370.4498923541574
"10.0.2.109",49820,"194.247.12.49",38925,18,2150,8,698,10,1452,6774.16589,20.53440099999989,271.9339122675178,565.6848719375872
"10.0.2.109",49821,"173.194.122.24",443,12,1587,7,1086,5,501,6774.322349,20.377621999999974,426.3500422178805,196.6863454430554
"10.0.2.109",49822,"194.247.12.49",38925,19,2204,9,752,10,1452,6774.351371,20.350806999999804,295.6148127197146,570.7881756237043
"10.0.2.109",49823,"173.194.122.23",443,12,1587,7,1086,5,501,6775.503167,19.198742000000493,452.52965011977227,208.7636783701712
"10.0.2.109",49824,"194.247.12.49",38925,12,2721,6,1271,6,1450,6787.552198,0.4375869999994393,23236.52210877615,26509.014207494427
"10.0.2.109",49825,"194.247.12.49",38925,12,2726,6,1276,6,1450,6787.613224,0.5268059999998513,19377.15212052042,22019.491046045932
"10.0.2.109",49826,"91.185.213.10",80,10,2569,5,1368,5,1201,6787.677922,0.06675300000006246,163947.68774421763,143933.6059801209
"10.0.2.109",49827,"91.185.213.10",80,10,2574,5,1368,5,1206,6787.737833,0.0701840000001539,155932.9761765645,137467.2289977608
"10.0.2.109",49828,"194.247.12.49",38925,12,2286,6,835,6,1451,6793.692066,0.5273839999999836,12666.292492757093,22010.52743352161
"10.0.2.109",49829,"91.185.213.10",80,10,2134,5,1369,5,765,6793.84047,0.07383299999946757,148334.75546271962,82889.76473994194
"10.0.2.109",49830,"194.247.12.49",38925,12,2259,6,808,6,1451,6796.237507,0.4414090000000215,14644.014961180414,26297.606075090076
"10.0.2.109",49831,"91.185.213.10",80,10,2107,5,1369,5,738,6796.363956,0.0741360000001805,147728.49897449734,79637.42311408257
"10.0.2.109",49832,"194.247.12.49",38925,22,13000,13,11620,9,1380,6798.677627,1.7736299999996845,52412.284411075896,6224.522589267189
"10.0.2.109",49833,"91.185.213.10",80,18,12750,7,1254,11,11496,6798.808079,0.1842209999995248,54456.33234010171,499226.472553277
"10.0.2.109",49834,"194.247.12.49",38925,17,2303,9,899,8,1404,6799.642057,6.203454999999849,1159.3539406669631,1810.603929584445
"10.0.2.109",49835,"194.247.12.49",38925,16,3735,8,1762,8,1973,6799.716364,6.130755000000136,2299.227419787561,2574.560555755311
"10.0.2.109",49836,"194.247.12.49",38925,38,23480,23,21472,15,2008,6799.776922,2.3729000000002998,72390.74550127621,6769.775380335442
"10.0.2.109",49837,"194.247.12.49",38925,37,21488,22,20106,15,1382,6799.837889,3.281670999999733,49014.054120602916,3369.0153583344886
"10.0.2.109",49838,"91.185.202.180",80,12,3482,7,1898,5,1584,6799.847571,5.998866999999336,2531.1446311447944,2112.398891324212
"10.0.2.109",49839,"194.247.12.49",38925,12,1809,6,603,6,1206,6799.932626,5.897120000000541,818.0264264589422,1636.0528529178844
"10.0.2.109",49840,"88.85.84.106",80,8,1559,5,1134,3,425,6800.082305,5.7471400000004,1578.524274682602,591.5986038272538
"10.0.2.109",49841,"104.31.92.48",80,34,23230,12,1828,22,21402,6800.231674,1.9178160000001299,7625.340491475204,89276.55207798266
"10.0.2.109",49842,"104.28.16.59",80,30,21072,11,1144,19,19928,6800.274335,2.844731000000138,3217.1758946626433,56041.8542210115
"10.0.2.109",49843,"173.194.122.26",80,12,1983,7,1316,5,667,6800.785481,5.059178999999858,2080.970054627499,1054.7165854381017
"10.0.2.109",49844,"194.247.12.49",38925,18,7385,10,6500,8,885,6801.603704,4.242145000000164,12257.949692902526,1668.9669966490362
"10.0.2.109",49845,"194.247.12.49",38925,11,1068,6,344,5,724,6801.66463,3.1561799999999494,871.9401301573561,1835.1298088195517
"10.0.2.109",49846,"194.247.12.49",38925,13,1733,7,888,6,845,6801.788132,4.058884000000035,1750.23479360335,1665.482433102287
"10.0.2.109",49847,"8.254.199.45",80,13,3989,7,821,6,3168,6801.78973,3.060743000000002,2145.884185637277,8280.342387452974
"10.0.2.109",49848,"194.247.12.49",38925,13,1578,7,846,6,732,6802.051013,3.7940019999996366,1783.8683269014218,1543.488906964351
"10.0.2.109",49849,"194.247.12.49",38925,13,2082,7,809,6,1273,6802.111785,3.7356360000003406,1732.502845566166,2726.1756766449066
"10.0.2.109",49850,"128.199.53.58",80,8,1273,5,659,3,614,6802.178188,3.6660210000000006,1438.0714131206557,1339.8723029682587
"10.0.2.109",49851,"194.247.12.49",38925,12,1306,6,550,6,756,6802.205398,3.640041999999994,1208.777261361272,1661.5192901620394
"10.0.2.109",49852,"194.247.12.49",38925,12,1900,6,650,6,1250,6802.305998,0.422432000000299,12309.673509573895,23672.449056872872
"10.0.2.109",49853,"62.152.53.250",80,8,1061,5,689,3,372,6802.32999,3.514575999999579,1568.325738296927,846.7593245957283
"10.0.2.109",49854,"194.247.12.49",38925,12,2095,6,755,6,1340,6802.405762,3.421422999999777,1765.3473423193782,3133.1992565668434
"10.0.2.109",49855,"91.185.213.10",80,10,1758,5,1178,5,580,6802.429736,0.05317600000034872,177222.80728031817,87257.40935703271
"10.0.2.109",49856,"194.247.12.49",38925,19,10032,11,8534,8,1498,6802.506425,1.6951710000003004,40274.4029953249,7069.493284157101
"10.0.2.109",49857,"173.194.113.110",80,8,1767,5,1190,3,577,6802.524316,3.3224460000001272,2865.3588350268556,1389.3378553029374
"10.0.2.109",49858,"173.194.113.110",80,8,1834,5,1257,3,577,6802.553297,3.2734819999996034,3071.9582389642646,1410.1192552763569
"10.0.2.109",49859,"194.247.12.49",38925,14,1153,8,515,6,638,6802.606177,2.6748820000002524,1540.254859840401,1908.1215545207297
"10.0.2.109",49860,"194.247.12.49",38925,59,53186,42,50822,17,2364,6802.706911,1.9072550000000774,213173.38268872464,9915.821429226418
"10.0.2.109",49861,"194.247.12.49",38925,13,2152,7,929,6,1223,6802.727282,0.9543140000005224,7787.793116307559,10252.390722544827
"10.0.2.109",49862,"8.254.199.45",80,13,7076,6,754,7,6322,6802.728784,3.1159669999997277,1935.835649094014,16231.237365480578
"10.0.2.109",49863,"194.247.12.49",38925,11,1535,6,344,5,1191,6802.787789,2.145317999999861,1282.793506603766,4441.299611526411
"10.0.2.109",49864,"173.194.122.26",80,51,52706,14,2170,37,50536,6802.832038,1.7816020000000208,9744.03935334592,226923.85841506426
"10.0.2.109",49865,"194.247.12.49",38925,13,2137,7,918,6,1219,6802.886744,0.6532639999995808,11242.009356102146,14928.11482035786
"10.0.2.109",49866,"88.85.84.114",80,8,1430,5,774,3,656,6802.93586,2.910487000000103,2127.4790095265093,1803.1346644048967
"10.0.2.109",49867,"194.247.12.49",38925,11,1679,6,344,5,1335,6802.986597,1.6284909999994852,1689.9080191421813,6558.2186207988725
"10.0.2.109",49868,"91.185.213.10",80,10,1941,5,1147,5,794,6803.012616,0.29362099999980273,31251.170726910423,21633.33004112195
"10.0.2.109",49869,"194.247.12.49",38925,13,4557,7,3312,6,1245,6803.047467,1.5671480000000884,16907.14597472511,6355.494184339602
"10.0.2.109",49870,"91.185.213.10",80,10,1956,5,1151,5,805,6803.132033,0.30109300000003714,30581.913229463535,21388.74035596711
"10.0.2.109",49871,"194.247.12.49",38925,11,1535,6,344,5,1191,6803.146878,1.99029900000005,1382.706819427599,4787.220412611251
"10.0.2.109",49872,"194.247.12.49",38925,11,1209,6,344,5,865,6803.247057,1.369223000000602,2009.8990449318992,5053.961261238642
"10.0.2.109",49873,"194.247.12.49",38925,23,13464,14,12299,9,1165,6803.372916,1.2432689999996,79139.75173516886,7496.366433976073
"10.0.2.109",49874,"91.185.213.10",80,8,1483,5,1317,3,166,6803.389922,1.2244449999998324,8604.714789150548,1084.573010629454
"10.0.2.109",49875,"62.161.94.220",80,6,902,4,790,2,112,6803.397981,1.2178610000000845,5189.426379528995,735.7161449458829
"10.0.2.109",49876,"91.185.213.10",80,16,9826,7,1416,9,8410,6803.478167,0.08383099999991828,135129.00955506964,802567.0694619602
"10.0.2.109",49877,"195.5.165.160",80,21,13317,7,1034,14,12283,6803.801983,0.18727399999988847,44170.573598069815,524707.1136412878
"10.0.2.109",49878,"91.185.213.10",80,12,4395,6,1227,6,3168,6803.910102,1.0495310000005702,9352.748989781785,24147.928932052728
"10.0.2.109",49879,"91.185.213.10",80,12,4395,6,1227,6,3168,6804.110612,1.0528289999992921,9323.451386698694,24072.28524291888
"10.0.2.109",49880,"91.185.213.10",80,12,4469,6,1227,6,3242,6804.174614,0.09546100000079605,102827.33262712673,271692.10462684993
"10.0.2.109",49881,"194.247.12.49",38925,11,1080,6,344,5,736,6804.241735,1.1693510000004608,2353.4422085403917,5035.271701993396
"10.0.2.109",49882,"194.247.12.49",38925,18,8514,10,7616,8,898,6804.302718,0.3120710000002873,195237.62220758706,23020.402408405094
"10.0.2.109",49883,"178.79.215.17",80,9,929,5,709,4,220,6804.388866,1.0454879999997502,5425.217697382806,1683.4243912894462
"10.0.2.109",49884,"178.79.215.7",80,13,8201,6,763,7,7438,6804.44912,0.16482899999937217,37032.31834218038,361004.43490057363
"10.0.2.109",49885,"194.247.12.49",38925,13,2133,7,768,6,1365,6804.79379,0.9878029999999853,6219.8636772717755,11054.835832651006
"10.0.2.109",49886,"91.185.213.10",80,10,1927,5,1283,5,644,6805.199668,0.3394829999997455,30234.20907676583,15176.01765037973
"10.0.2.109",49887,"194.247.12.49",38925,12,1376,6,600,6,776,6805.21744,0.5951179999992746,8065.627320978109,10431.544668465021
"10.0.2.109",49888,"5.10.88.214",80,8,1109,5,687,3,422,6805.347644,0.4645569999993313,11830.625735933181,7267.1383705441085
"10.0.2.109",49889,"194.247.12.49",38925,42,23661,25,21572,17,2089,6805.981246,37.69376299999931,4578.370166969086,443.36247352115805
"10.0.2.109",49890,"104.31.93.48",80,35,23249,13,1855,22,21394,6806.118104,37.550185999999485,395.2044338741812,4557.9534546114455
"10.0.2.109",49891,"194.247.12.49",38925,47,23006,26,20681,21,2325,6806.201824,1.7499250000000757,94545.76624712079,10629.026958297753
"10.0.2.109",49892,"194.247.12.49",38925,27,13926,14,9195,13,4731,6806.26303,37.41154199999983,1966.2381197759862,1011.6663996367798
"10.0.2.109",49893,"104.28.16.59",80,39,22536,13,1871,26,20665,6806.331801,1.6196209999998246,9241.668266836266,102073.2628189051
"10.0.2.109",49894,"88.85.84.106",80,21,13568,10,4551,11,9017,6806.388191,37.27993100000003,976.6112496291897,1934.9821221503853
"10.0.2.109",49895,"194.247.12.49",38925,18,7991,10,7094,8,897,6807.612905,36.056493000000046,1573.9744849838814,199.0210195983284
"10.0.2.109",49896,"194.247.12.49",38925,21,11518,12,10567,9,951,6807.673883,35.99216399999932,2348.733463206091,211.3793435704545
"10.0.2.109",49897,"178.79.215.59",80,19,11367,8,870,11,10497,6807.797876,3.904907000000094,1782.3727940255255,21505.249676880394
"10.0.2.109",49898,"178.79.215.17",80,16,7840,7,816,9,7024,6808.740454,3.9716770000004544,1643.6381911215976,14148.179723576104
"10.0.2.109",49899,"194.247.12.49",38925,12,1689,6,834,6,855,6826.001074,17.67312200000015,377.52243208641596,387.02839260657754
"10.0.2.109",49900,"194.247.12.49",38925,12,1316,6,550,6,766,6826.062412,17.60188299999936,249.9732557022541,348.14457066895756
"10.0.2.109",49901,"88.85.84.114",80,8,1440,5,784,3,656,6826.14769,17.52026500000011,357.9854528456026,299.53884829938175
"10.0.2.109",49902,"194.247.12.49",38925,12,1534,6,792,6,742,6826.160287,17.508421000000453,361.8830047552453,339.0368554651414
"10.0.2.109",49903,"62.152.53.250",80,11,1233,6,753,5,480,6826.191132,10.117443000000094,595.407357372801,379.5425385643353
"10.0.2.109",49904,"194.247.12.49",38925,12,1997,6,755,6,1242,6826.260048,17.413652000000184,346.85429569856666,570.5868016657215
"10.0.2.109",49905,"128.199.53.58",80,11,1445,6,723,5,722,6826.311815,15.034469000000172,384.7159483983062,384.18383781960864
"10.0.2.109",49906,"194.247.12.49",38925,12,1573,6,652,6,921,6826.360649,0.5004199999993943,10423.244474653917,14723.632149012665
"10.0.2.109",49907,"173.194.113.98",80,8,1736,5,1159,3,577,6826.406841,17.260941999999886,537.1665115380181,267.4245704550789
"10.0.2.109",49908,"194.247.12.49",38925,17,2430,9,1312,8,1118,6826.460595,17.21266800000012,609.7834455413841,519.6172958195637
"10.0.2.109",49909,"62.161.94.220",80,10,1428,5,846,5,582,6826.513533,0.07758399999966059,87234.48133673964,60012.37368555847
"10.0.2.109",49910,"194.247.12.49",38925,13,1103,7,461,6,642,6826.560498,2.7688829999997324,1331.9450478768356,1854.899611143012
"10.0.2.109",49911,"104.28.16.59",80,12,2134,7,1054,5,1080,6826.619291,17.048345999999583,494.59343445987116,506.7940315148585
"10.0.2.109",49912,"194.247.12.49",38925,48,25708,28,22737,20,2971,6826.661027,20.000536999999895,9094.555811176519,1188.3680923167276
"10.0.2.109",49913,"194.247.12.49",38925,19,9281,11,8395,8,886,6826.761583,16.913753999999244,3970.7329313174946,419.067227772162
"10.0.2.109",49914,"104.31.93.48",80,39,25188,13,2575,26,22613,6826.806293,19.85467400000016,1037.5390701453891,9111.406210950558
"10.0.2.109",49915,"194.247.12.49",38925,28,8176,13,6289,15,1887,6826.861564,241.47591999999986,208.3520377518389,62.51555020475751
"10.0.2.109",49916,"8.254.199.45",80,15,9026,7,809,8,8217,6826.892227,16.776240999999573,385.78368062310057,3918.3986448455094
"10.0.2.109",49917,"194.247.12.49",38925,16,3454,8,765,8,2689,6826.961526,11.837690999999722,516.9927142041589,1817.246285614357
"10.0.2.109",49918,"173.194.122.2",443,27,7869,12,1507,15,6362,6827.023921,241.3135400000001,49.95989864472584,210.91232593082003
"10.0.2.109",49919,"194.247.12.49",38925,16,3450,8,765,8,2685,6827.061385,11.740061000000424,521.2920103225852,1829.6327421126027
"10.0.2.109",49920,"8.37.70.7",80,11,3150,6,2563,5,587,6827.145915,0.52379000000019,39145.45905800523,8965.425074931358
"10.0.2.109",49921,"194.247.12.49",38925,12,2028,6,1242,6,786,6827.161312,16.51158099999975,601.7594559842664,380.8236170721686
"10.0.2.109",49922,"8.37.70.24",80,11,3146,6,2559,5,587,6827.255396,0.5277830000004542,38788.66882787506,8897.596171146019
"10.0.2.109",49923,"88.85.84.114",80,8,1781,5,717,3,1064,6827.286911,16.3801940000003,350.1790027639413,519.651965049977
"10.0.2.109",49924,"194.247.12.49",38925,20,8805,11,6603,9,2202,6828.726065,14.949319999999716,3533.538649249665,1178.3813578142908
"10.0.2.109",49925,"88.85.84.123",80,14,8447,7,2076,7,6371,6828.875196,14.793867999999748,1122.6272939572182,3445.211218594141
"10.0.2.109",49926,"194.247.12.49",38925,49,13589,22,7582,27,6007,6829.11191,14.555138000000625,4167.325655036551,3301.651966473828
"10.0.2.109",49927,"194.247.12.49",38925,21,5858,10,4549,11,1309,6829.173534,11.667486000000281,3119.0952361116288,897.5369672609634
"10.0.2.109",49928,"216.58.211.42",443,43,13004,21,5457,22,7547,6829.267925,14.398457000000235,3031.991552983718,4193.227093708653
"10.0.2.109",49929,"216.58.211.42",443,15,5273,8,921,7,4352,6829.306913,11.533884999999827,638.813374678186,3018.5839376758586
"10.0.2.109",49930,"194.247.12.49",38925,59,50367,41,48970,18,1397,6830.897071,12.775314999999864,30665.388681218756,874.8120887821646
"10.0.2.109",49931,"194.247.12.49",38925,12,2290,6,685,6,1605,6831.412038,12.259886999999253,446.98617532121904,1047.3179728329292
"10.0.2.109",49932,"173.194.122.9",80,8,2033,5,1526,3,507,6831.540993,12.124516000000767,1006.8855532046992,334.52881748019826
"10.0.2.109",49933,"5.149.255.156",80,54,50066,14,1166,40,48900,6832.040927,11.624765999999909,802.4247541843056,33652.2902912629
"10.0.2.109",49934,"194.247.12.49",38925,21,7754,10,5144,11,2610,6832.792827,1.1518889999997555,35725.66453886506,18126.74658756567
"10.0.2.109",49935,"217.69.139.58",443,20,7459,9,2296,11,5163,6832.943067,1.001669999999649,18337.376581115972,41235.137320688926
"10.0.2.109",49936,"194.247.12.49",38925,26,17927,16,16296,10,1631,6838.31166,5.286328999999569,24661.348168078574,2468.253489330888
"10.0.2.109",49937,"91.185.213.10",80,25,17829,9,1549,16,16280,6838.439711,0.10589600000002974,117020.47291679119,1229885.9258136607
"10.0.2.109",49938,"194.247.12.49",38925,12,2130,6,991,6,1139,6839.100281,4.571254000000408,1734.3162292008478,1993.3261201410348
"10.0.2.109",49939,"194.247.12.49",38925,12,1414,6,600,6,814,6839.198284,4.471881000000394,1073.3738218882786,1456.2104850284313
"10.0.2.109",49940,"91.185.202.180",80,8,1877,5,1064,3,813,6839.245515,4.419823000000179,1925.868977106019,1471.5521413413471
"10.0.2.109",49941,"194.247.12.49",38925,12,2094,6,714,6,1380,6839.2802,0.7714269999996759,7404.459527605853,14311.140263439882
"10.0.2.109",49942,"5.10.88.214",80,8,1147,5,725,3,422,6839.321703,4.341913000000204,1335.8167241028843,777.5374587191961
"10.0.2.109",49943,"194.247.12.49",38925,13,3378,7,1999,6,1379,6839.411251,0.6694089999991775,23889.729597330854,16480.20866169047
"10.0.2.109",49944,"91.185.213.10",80,11,3226,5,1297,6,1929,6839.543703,0.07822599999963131,132641.32130044873,197274.5634453089
"10.0.2.109",49945,"91.185.213.10",80,10,1942,5,1298,5,644,6839.689297,0.0964270000004035,107687.68083582968,53429.01884304647
"10.0.2.109",49946,"194.247.12.49",38925,36,22451,22,20450,14,2001,6843.836391,3.582962999999836,45660.532916473734,4467.810580237846
"10.0.2.109",49947,"194.247.12.49",38925,30,15281,16,9969,14,5312,6843.8977,26.883403999999246,2966.5886061155884,1580.7521993866994
"10.0.2.109",49948,"104.28.16.59",80,31,22143,12,1871,19,20272,6844.263632,3.1553610000000845,4743.672752499508,51396.971693570296
"10.0.2.109",49949,"88.85.84.123",80,25,14977,12,5186,13,9791,6845.0243,25.756460999999945,1610.7803009116853,3041.1010270393967
"10.0.2.109",49950,"194.247.12.49",38925,19,9222,11,8336,8,886,6845.431699,10.08512200000041,6612.512967121002,702.817477071642
"10.0.2.109",49951,"194.247.12.49",38925,17,6916,10,6085,7,831,6845.49199,10.024484999999913,4856.109815117727,663.1762130423715
"10.0.2.109",49952,"8.254.199.45",80,15,8967,7,809,8,8158,6845.564769,9.951731000000109,650.3391219075284,6558.055076046498
"10.0.2.109",49953,"8.254.199.45",80,12,6607,6,754,6,5853,6845.617527,9.898510999999417,609.3845831964379,4730.408442239723
"10.0.2.109",49954,"194.247.12.49",38925,18,8613,10,7715,8,898,6845.990213,14.854491000000053,4154.972391851043,483.62478391214984
"10.0.2.109",49955,"194.247.12.49",38925,13,1668,7,706,6,962,6846.113466,2.3856320000004416,2367.5068074199853,3225.979530790405
"10.0.2.109",49956,"178.79.215.7",80,18,8570,8,871,10,7699,6846.116241,3.5858210000005784,1943.2091005097232,17176.5406025538
"10.0.2.109",49957,"194.247.12.49",38925,12,1333,6,550,6,783,6846.174526,18.149908000000323,242.42547124756345,345.12571633971305
"10.0.2.109",49958,"194.247.12.49",38925,13,1099,7,461,6,638,6846.235916,2.7382920000000013,1346.8249551180072,1863.9356211828388
"10.0.2.109",49959,"194.247.12.49",38925,13,2035,7,809,6,1226,6846.515935,17.809174999999414,363.4081870721251,550.727363844778
"10.0.2.109",49960,"62.161.94.220",80,10,1469,5,887,5,582,6846.539067,1.081916000000092,6558.734689198974,4303.476425156486
"10.0.2.109",49961,"194.247.12.49",38925,13,1605,7,846,6,759,6846.57663,17.748133000000053,381.3358847378471,342.12049233572804
"10.0.2.109",49962,"173.194.113.105",80,8,1720,5,1143,3,577,6846.643457,17.680967000000237,517.1662839481504,261.0716936466166
"10.0.2.109",49963,"194.247.12.49",38925,12,1706,6,834,6,872,6846.705085,17.6234170000007,378.58719452644937,395.83697077585595
"10.0.2.109",49964,"128.199.53.58",80,11,1462,6,740,5,722,6846.706541,16.24160700000084,364.4959516628923,355.6298339197409
"10.0.2.109",49965,"88.85.84.114",80,8,1457,5,801,3,656,6846.834919,17.492473000000246,366.3289919041127,300.01475491772527
"10.0.2.109",49966,"194.247.12.49",38925,12,2307,6,685,6,1622,6847.299264,17.029067999999825,321.80269642472837,761.991202337094
"10.0.2.109",49967,"62.152.53.250",80,11,1250,6,770,5,480,6847.321737,10.115041999999448,608.994011097565,379.63263029458597
"10.0.2.109",49968,"173.194.122.14",80,8,2050,5,1543,3,507,6847.463257,16.86382599999979,731.9809869954869,240.51481555846524
"10.0.2.109",49969,"194.247.12.49",38925,57,19664,24,6294,33,13370,6860.833161,131.7074390000007,382.3018683098054,812.1029519069111
"10.0.2.109",49970,"194.247.12.49",38925,18,2172,8,698,10,1474,6860.893899,3.432773999999881,1626.6727725158119,3435.122731645138
"10.0.2.109",49971,"216.58.211.42",443,50,19025,25,12712,25,6313,6860.962852,131.5775990000002,772.8975203446283,383.8343333807142
"10.0.2.109",49972,"216.58.211.42",443,12,1587,7,1086,5,501,6861.054079,3.2721870000004856,2655.104980246762,1224.868872102788
"10.0.2.109",49973,"194.247.12.49",38925,13,2099,7,1296,6,803,6861.319996,3.0081780000000435,3446.6045559803474,2135.5119278180705
"10.0.2.109",49974,"194.247.12.49",38925,16,3474,8,765,8,2709,6861.381499,129.93777500000033,47.099467418154454,166.78752579840577
"10.0.2.109",49975,"194.247.12.49",38925,16,3471,8,765,8,2706,6861.44543,129.87331300000005,47.12284501435639,166.68551452137046
"10.0.2.109",49976,"88.85.84.106",80,8,1798,5,734,3,1064,6861.450329,2.8765339999999924,2041.3455916043458,2959.116770391041
"10.0.2.109",49977,"194.247.12.49",38925,13,2777,7,1325,6,1452,6861.506303,0.9751100000003134,10870.568448684346,11912.502179237486
"10.0.2.109",49978,"8.21.198.139",80,11,3170,6,2583,5,587,6861.569256,0.679536000000553,30408.98495441475,6910.597819683105
"10.0.2.109",49979,"194.247.12.49",38925,12,2728,6,1276,6,1452,6861.571133,1.5499819999995452,6585.882932835991,7494.280578744404
"10.0.2.109",49980,"194.247.12.49",38925,18,2158,8,698,10,1460,6861.631575,19.98957699999937,279.34558094952064,584.3045102955589
"10.0.2.109",49981,"8.37.70.22",80,11,3167,6,2580,5,587,6861.63355,1.549366000000191,13321.577987381585,3030.917162245345
"10.0.2.109",49982,"194.247.12.49",38925,19,2208,9,752,10,1456,6861.88145,2.442565000000286,2462.9846083929374,4768.757433271432
"10.0.2.109",49983,"91.185.213.10",80,10,2571,5,1370,5,1201,6861.919318,0.30906899999990856,35461.33711243523,31086.90939564577
"10.0.2.109",49984,"194.247.12.49",38925,19,2212,9,752,10,1460,6861.942137,19.680115000000114,305.6892706165571,593.4924668885285
"10.0.2.109",49985,"91.185.213.10",80,10,2576,5,1370,5,1206,6861.976098,0.0673529999994571,162724.74871332152,143245.28974325967
"10.0.2.109",49986,"194.247.12.49",38925,33,6742,14,1940,19,4802,6862.041935,130.4970569999996,118.92988513909589,294.38211775151467
"10.0.2.109",49987,"194.247.12.49",38925,18,2158,8,698,10,1460,6862.141682,19.480325999999877,286.6481803230621,599.579288354829
"10.0.2.109",49988,"173.194.122.24",443,25,6063,12,4212,13,1851,6862.186234,130.35243600000013,258.4991967468868,113.59971822851078
"10.0.2.109",49989,"194.247.12.49",38925,19,2212,9,752,10,1460,6862.264826,19.356903000000784,310.7935189838868,603.4023107931846
"10.0.2.109",49990,"173.194.122.31",443,12,1587,7,1086,5,501,6862.301126,19.3206339999997,449.6746845885148,207.44660863613805
"10.0.2.109",49991,"173.194.122.31",443,12,1587,7,1086,5,501,6862.344319,19.27772499999992,450.6755854230744,207.90835018136303
"10.0.2.109",49992,"194.247.12.49",38925,19,2212,9,752,10,1460,6862.362231,19.257572999999866,312.39658289235314,606.5146423176005
"10.0.2.109",49993,"194.247.12.49",38925,47,35337,30,33527,17,1810,6862.462679,7.637392999999975,35118.78988026423,1895.9349086789234
"10.0.2.109",49994,"173.194.122.15",443,12,1587,7,1086,5,501,6862.508234,19.111299000000145,454.6001818086742,209.71886840344916
"10.0.2.109",49995,"173.194.122.31",443,12,1587,7,1086,5,501,6862.612382,1.7114889999993466,5076.28153029515,2341.820484970415
"10.0.2.109",49996,"173.194.122.15",443,12,1587,7,1086,5,501,6862.760783,18.86021400000027,460.652249226858,212.51084425658917
"10.0.2.109",49997,"78.47.105.107",80,41,34984,12,1527,29,33457,6862.887341,7.212467000000288,1693.7339193371024,37110.18712459819
"10.0.2.109",49998,"194.247.12.49",38925,1011,741666,576,577285,435,164381,6863.224199,160.17102999999952,28833.428866630962,8210.273730524203
"10.0.2.109",49999,"194.247.12.49",38925,16,1912,7,590,9,1322,6863.28498,1.0426789999992252,4526.800674036312,10143.102527247464
"10.0.2.109",50000,"173.194.122.24",443,12,1587,7,1086,5,501,6863.418968,18.202384000000166,477.30011629245496,220.19093762662976
"10.0.2.109",50001,"195.113.232.72",443,10,1329,6,936,4,393,6863.449461,0.8780390000001717,8528.0949935009,3580.7065517583906
"10.0.2.109",50002,"31.13.93.3",443,898,735319,277,155639,621,579680,6863.6297,159.76532399999996,7793.380746375229,29026.574001752728
"10.0.2.109",50003,"194.247.12.49",38925,20,9210,11,6717,9,2493,6864.325396,11.29318400000011,4758.268350183569,1766.0209910685778
"10.0.2.109",50004,"194.247.12.49",38925,11,1070,6,344,5,726,6864.586175,1.4167889999998806,1942.4205015709692,4099.410709710824
"10.0.2.109",50005,"194.247.12.49",38925,13,1411,7,595,6,816,6864.685461,0.6923100000003615,6875.532637109842,9429.30190232207
"10.0.2.109",50006,"194.247.12.49",38925,11,1070,6,344,5,726,6864.785974,0.5920229999992443,4648.46804938915,9810.429662373612
"10.0.2.109",50007,"194.247.12.49",38925,11,1034,6,344,5,690,6864.885857,0.4880859999993845,5638.350618545646,11309.48234533865
"10.0.2.109",50008,"78.47.105.107",80,6,771,4,659,2,112,6864.983582,0.39319700000032753,13408.037192541165,2278.755941676192
"10.0.2.109",50009,"78.47.105.107",80,12,3935,6,767,6,3168,6864.986032,1.2485619999997652,4914.4535874078765,20298.55145359603
"10.0.2.109",50010,"194.247.12.49",38925,9,510,5,290,4,220,6864.986236,1.3955519999999524,1662.4246176423947,1261.1497099356097
"10.0.2.109",50011,"194.247.12.49",38925,10,1119,5,290,5,829,6865.085754,0.2927900000004229,7923.767888236105,22651.046825337005
"10.0.2.109",50012,"173.194.122.13",80,8,1091,5,728,3,363,6865.150865,0.22574700000041048,25798.79245345192,12863.958325004185
"10.0.2.109",50013,"194.247.12.49",38925,12,1674,6,834,6,840,6865.186438,0.18815700000050128,35459.74903927159,35714.85514746779
"10.0.2.109",50014,"104.31.93.48",80,6,869,4,757,2,112,6865.214191,0.16316600000027393,37115.575548765264,5491.340107611241
"10.0.2.109",50015,"194.247.12.49",38925,9,510,5,290,4,220,6865.286394,0.39708800000062183,5842.5336449259785,4432.266903047294
"10.0.2.109",50016,"88.85.84.114",80,7,1371,4,715,3,656,6865.311243,0.06305599999996048,90713.01700081809,83227.60720634498
"10.0.2.109",50017,"78.47.105.107",80,6,735,4,623,2,112,6865.314348,0.05924899999990885,84119.56319950831,15122.618103282393
"10.0.2.109",50018,"194.247.12.49",38925,9,510,5,290,4,220,6865.386586,0.12143300000025192,19105.185575545256,14493.589057310193
"10.0.2.109",50019,"194.247.12.49",38925,9,510,5,290,4,220,6865.486609,0.12292000000070402,18874.06443204289,14318.255776032538
"10.0.2.109",50020,"88.85.84.106",80,14,8852,7,2367,7,6485,6865.722537,9.895463000000746,1913.6042446926003,5242.806728699415
"10.0.2.109",50021,"194.247.12.49",38925,45,11828,21,6239,24,5589,6866.513005,126.02832399999988,396.0379573087082,354.777391152167
"10.0.2.109",50022,"173.194.122.21",443,39,11261,19,5111,20,6150,6866.664011,125.8769970000003,324.8250353477999,390.85775139678526
"10.0.2.109",50023,"194.247.12.49",38925,73,41588,38,33875,35,7713,6869.411457,63.45433899999989,4270.787534324492,972.4157712839796
"10.0.2.109",50024,"194.247.12.49",38925,38,18505,21,16132,17,2373,6869.472446,63.22406899999987,2041.247930436117,300.2653941808149
"10.0.2.109",50025,"194.247.12.49",38925,36,13866,20,11546,16,2320,6869.572992,54.12189599999965,1706.6660044578002,342.92959729275043
"10.0.2.109",50026,"194.247.12.49",38925,32,12490,16,10171,16,2319,6869.672876,49.01978000000054,1659.9013704263689,378.45947085033424
"10.0.2.109",50027,"23.62.237.23",443,29,13215,11,1812,18,11403,6869.742571,53.95241100000021,268.6812272393155,1690.8234184381424
"10.0.2.109",50028,"194.247.12.49",38925,35,13500,18,11124,17,2376,6869.77272,58.92216399999961,1510.3314942743887,322.5950764469568
"10.0.2.109",50029,"23.62.237.17",443,30,12109,12,1865,18,10244,6869.833607,48.85907100000077,305.3680656351359,1677.3139219122424
"10.0.2.109",50030,"2.20.182.91",443,63,40779,24,6885,39,33894,6869.864114,63.001532999999654,874.2644405176665,4303.895271881741
"10.0.2.109",50031,"194.247.12.49",38925,36,18685,20,16479,16,2206,6869.872951,68.82057499999974,1915.5899235076213,256.4349396964508
"10.0.2.109",50032,"194.247.12.49",38925,19,2084,10,752,9,1332,6869.973257,21.664115000000493,277.69424229883674,491.8733121569821
"10.0.2.109",50033,"194.247.12.49",38925,17,1976,8,644,9,1332,6870.073155,10.347998999999618,497.8740334242582,1029.764305157006
"10.0.2.109",50034,"2.20.182.66",443,10,1329,6,936,4,393,6870.139826,21.49721800000043,348.3241412912057,146.2514824011152
"10.0.2.109",50035,"194.247.12.49",38925,17,1976,8,644,9,1332,6870.173169,21.462053000000196,240.0515924548296,496.50422538793947
"10.0.2.109",50036,"194.247.12.49",38925,19,2084,10,752,9,1332,6870.211526,21.42298000000028,280.8199419501825,497.4097907947382
"10.0.2.109",50037,"23.62.237.22",443,31,13011,12,1868,19,11143,6870.213774,58.48112300000048,255.5354485925292,1524.3209334403389
"10.0.2.109",50038,"2.20.182.66",443,10,1329,6,936,4,393,6870.224006,10.196719999999914,734.3537921998509,308.33444480186046
"10.0.2.109",50039,"194.247.12.49",38925,18,2030,9,698,9,1332,6870.272201,21.363784000000123,261.37691712292013,498.7880424179508
"10.0.2.109",50040,"194.247.12.49",38925,22,5450,11,4230,11,1220,6870.332772,21.28801900000053,1589.6265406376776,458.47384859999215
"10.0.2.109",50041,"2.20.182.66",443,10,1329,6,936,4,393,6870.344783,21.289437000000362,351.72372101713506,147.67887004245094
"10.0.2.109",50042,"194.247.12.49",38925,22,5449,11,4229,11,1220,6870.423764,21.197360999999546,1596.0477344326364,460.43467392003225
"10.0.2.109",50043,"194.247.12.49",38925,35,22165,21,20067,14,2098,6870.524229,66.17877700000008,2425.7927885249346,253.61604974960446
"10.0.2.109",50044,"194.247.12.49",38925,18,2110,8,726,10,1384,6870.623771,21.01011500000004,276.43827746778106,526.9842644840344
"10.0.2.109",50045,"23.62.237.8",443,36,18136,14,1985,22,16151,6870.638366,62.05819700000029,255.88883930997747,2082.0456643301995
"10.0.2.109",50046,"2.20.182.66",443,11,1395,7,1002,4,393,6870.676419,20.959129999999277,382.45862304400407,150.0062264034866
"10.0.2.109",50047,"194.247.12.49",38925,19,2164,9,780,10,1384,6870.724177,30.896719999999732,201.9631857362223,358.3551911011944
"10.0.2.109",50048,"194.247.12.49",38925,3679,4297100,3012,4251305,667,45795,6870.82487,121.71508300000005,279426.6672767252,3009.9802832160076
"10.0.2.109",50049,"31.13.91.6",443,15,4808,8,830,7,3978,6870.827772,20.793041000000812,319.3376091548966,1530.5120592990106
"10.0.2.109",50050,"194.247.12.49",38925,24,5558,13,4338,11,1220,6870.924425,20.712312999999995,1675.5250850061993,471.21728992797676
"10.0.2.109",50051,"23.62.237.15",443,35,21892,13,1806,22,20086,6870.956815,65.7461400000002,219.75434603461065,2444.067438788034
"10.0.2.109",50052,"194.247.12.49",38925,110,48464,53,29346,57,19118,6870.992342,105.87411400000019,2217.4258761683673,1444.5835173647802
"10.0.2.109",50053,"2.20.182.91",443,10,1329,6,936,4,393,6871.122003,20.512852999999268,365.03942186882864,153.26975725902741
"10.0.2.109",50054,"31.13.91.6",443,15,4809,8,830,7,3979,6871.282384,20.337948000000324,326.483281400852,1565.1529839686625
"10.0.2.109",50055,"23.62.237.15",443,32,18196,12,1752,20,16444,6871.313855,67.37946999999986,208.01588376993809,1952.4047903612225
"10.0.2.109",50056,"31.13.91.6",443,15,4809,8,830,7,3979,6871.328348,20.308114999999816,326.96289143527406,1567.4522229168138
"10.0.2.109",50057,"31.13.64.7",443,14,1651,9,1122,5,529,6871.851984,29.768614000000525,301.52562695729944,142.16315210375348
"10.0.2.109",50058,"31.13.64.7",443,3643,4294893,641,44163,3002,4250730,6871.951452,120.5883159999994,2929.836087934106,281999.46004719206
"10.0.2.109",50059,"31.13.93.3",443,109,48161,40,17986,69,30175,6872.121275,104.74508699999933,1373.6968875685875,2304.6426988981502
"10.0.2.109",50060,"31.13.64.7",443,12,1523,7,994,5,529,6874.90445,16.729137999999693,475.33829896078004,252.97179089562638
"10.0.2.109",50061,"194.247.12.49",38925,889,359775,376,162630,513,197145,6875.832476,1328.149926,979.5882035082838,1187.4864193607611
"10.0.2.109",50062,"179.60.192.3",443,976,364212,453,193679,523,170533,6875.95818,1328.0241010000009,1166.7197898240545,1027.2885853296718
"10.0.2.109",50063,"194.247.12.49",38925,12,2420,6,964,6,1456,6880.632133,1.706358000000364,4519.56740613538,6826.234588519827
"10.0.2.109",50064,"91.185.213.10",80,10,2268,5,1374,5,894,6881.75701,0.06948099999954138,158201.52271948525,102934.61521922839
"10.0.2.109",50065,"194.247.12.49",38925,34,5014,15,1633,19,3381,6888.849935,103.69167500000003,125.98889930170378,260.85025630071067
"10.0.2.109",50066,"173.194.122.2",443,28,4437,14,2889,14,1548,6888.998939,103.54254200000014,223.2125998992759,119.6030130301416
"10.0.2.109",50067,"194.247.12.49",38925,19,2222,9,756,10,1466,6889.216506,22.422904000000017,269.724206998344,523.0366236237729
"10.0.2.109",50068,"194.247.12.49",38925,23,15393,14,13785,9,1608,6891.937406,0.8408909999998286,131146.60520807392,15298.058844728534
"10.0.2.109",50069,"194.247.12.49",38925,13,2138,7,700,6,1438,6891.998253,1.4426119999998264,3881.847648571254,7974.424169493519
"10.0.2.109",50070,"91.185.213.10",80,21,15241,8,1522,13,13719,6892.066186,0.05485399999997753,221971.05042485482,2000802.1292894767
"10.0.2.109",50071,"91.185.213.10",80,10,1932,5,1352,5,580,6892.128426,1.0514169999996739,10287.069735417399,4413.092046258943
"10.0.2.109",50072,"173.194.122.2",443,12,1583,7,1082,5,501,6892.621022,19.018129000000044,455.1446674906864,210.74628319115885
"10.0.2.109",50073,"194.247.12.49",38925,22,7804,11,5194,11,2610,6892.813039,1.5923640000000887,26094.536173888435,13112.579787032888
"10.0.2.109",50074,"217.69.139.58",443,20,7455,9,2292,11,5163,6892.942476,1.4629800000002433,12533.32239674975,28232.78513718105
"10.0.2.109",50075,"194.247.12.49",38925,12,2117,6,646,6,1471,6893.090736,1.6787610000001223,3078.460841060534,7009.9317294118355
"10.0.2.109",50076,"91.185.213.10",80,10,1965,5,1385,5,580,6894.490744,0.053237000000081025,208125.9274561515,87157.42810438112
"10.0.2.109",50077,"194.247.12.49",38925,21,5928,10,4221,11,1707,6933.395818,18.23238500000025,1852.089016329983,748.9969085229285
"10.0.2.109",50078,"194.247.12.49",38925,43,22777,23,20248,20,2529,6933.456312,59.08664499999941,2741.465520677331,342.4124013133628
"10.0.2.109",50079,"194.247.12.49",38925,21,5928,10,4221,11,1707,6933.554818,18.073788000000604,1868.3410472668413,755.5693361015158
"10.0.2.109",50080,"2.20.182.113",443,15,5335,8,1307,7,4028,6933.5597,18.068310999999994,578.6927178749581,1783.4539155320058
"10.0.2.109",50081,"194.247.12.49",38925,128,83088,72,72266,56,10822,6933.654516,58.885283999999956,9817.868926300847,1470.2484919661772
"10.0.2.109",50082,"194.247.12.49",38925,21,5928,10,4221,11,1707,6933.754478,17.87308900000062,1889.3208666951098,764.0537122597849
"10.0.2.109",50083,"2.20.182.72",443,128,82819,44,9936,84,72883,6933.833271,58.70625099999961,1353.9955055212183,9931.889535920185
"10.0.2.109",50084,"194.247.12.49",38925,21,5928,10,4221,11,1707,6933.855219,17.76516199999969,1900.798878163936,768.6954951494524
"10.0.2.109",50085,"195.113.232.75",443,33,21974,12,1865,21,20109,6933.892874,58.649891000000025,254.39092461399449,2742.9206986931986
"10.0.2.109",50086,"2.20.182.65",443,15,5335,8,1307,7,4028,6933.923721,17.70364999999947,590.6126702685781,1820.1896219141795
"10.0.2.109",50087,"2.20.182.65",443,15,5335,8,1307,7,4028,6933.95195,17.676464000000124,591.5210191359497,1822.9890321955666
"10.0.2.109",50088,"2.20.182.113",443,15,5335,8,1307,7,4028,6934.007974,17.612207999999555,593.6791116707379,1829.6399860824272
"10.0.2.109",50089,"194.247.12.49",38925,54,30368,30,27594,24,2774,6949.399501,43.13983600000029,5117.12654633176,514.4201289963145
"10.0.2.109",50090,"23.62.237.23",443,46,29671,19,2270,27,27401,6950.843245,41.69590299999982,435.5343977080933,5257.303097620909
"10.0.2.109",50091,"194.247.12.49",38925,17,1976,8,640,9,1336,6950.919618,12.000578000000132,426.6461165453817,890.6237682884843
"10.0.2.109",50092,"194.247.12.49",38925,18,2038,9,702,9,1336,6950.980561,21.936604999999872,256.01044464264334,487.2221567557998
"10.0.2.109",50093,"194.247.12.49",38925,103,84927,70,80992,33,3935,6951.079506,41.46312200000011,15626.80205315939,759.2288877812895
"10.0.2.109",50094,"194.247.12.49",38925,38,16040,21,13339,17,2701,6951.17999,41.362341000000015,2579.931343827951,522.4075687592245
"10.0.2.109",50095,"194.247.12.49",38925,17,1976,8,640,9,1336,6951.279818,21.642455999999584,236.57204154649077,493.8441367282995
"10.0.2.109",50096,"23.62.237.6",443,29,15281,12,2189,17,13092,6951.343233,41.198890000000574,425.0599955484178,2542.204413759656
"10.0.2.109",50097,"23.62.237.14",443,10,1325,6,932,4,393,6951.445284,21.476643999999396,347.1678349745989,146.39158706546928
"10.0.2.109",50098,"23.62.237.6",443,10,1325,6,932,4,393,6951.866532,11.053533999999672,674.5354019809611,284.4339195048473
"10.0.2.109",50099,"23.62.237.22",443,92,84060,23,3153,69,80907,6952.241938,40.30050599999959,625.8978485282606,16060.741272082456
"10.0.2.109",50100,"194.247.12.49",38925,22,7804,11,5194,11,2610,6952.855223,1.698435000000245,24464.875017291804,12293.670349467002
"10.0.2.109",50101,"94.100.180.59",443,20,7455,9,2292,11,5163,6952.999124,1.5544369999997798,11795.91067376973,26571.678363295425
"10.0.2.109",50102,"23.62.237.14",443,10,1325,6,932,4,393,6954.380287,18.536611999999877,402.2310010049328,169.61028261259506
"10.0.2.109",50103,"194.247.12.49",38925,25,8042,12,5645,13,2397,6955.292364,37.249627000000146,1212.3611331732213,514.7971011897629
"10.0.2.109",50104,"94.100.180.202",443,18,7437,9,1985,9,5452,6956.4386,36.10321499999918,439.85002443689183,1208.0918555314531
"10.0.2.109",50105,"194.247.12.49",38925,12,2085,6,646,6,1439,6974.811732,0.4685849999996208,11028.948856673138,24567.58112190812
"10.0.2.109",50106,"194.247.12.49",38925,137,88504,46,2874,91,85630,6974.872439,10.986609999999928,2092.729240411751,62352.26334601888
"10.0.2.109",50107,"91.185.213.10",80,10,1933,5,1353,5,580,6974.942826,0.0528359999998429,204860.32250799047,87818.91134858424
"10.0.2.109",50108,"91.185.213.10",80,93,86084,64,84140,29,1944,6975.002049,10.586132000000362,63585.07526639353,1469.091826929748
"10.0.2.109",50109,"194.247.12.49",38925,12,2731,6,1059,6,1672,6986.130613,0.5080469999993511,16675.622531007604,26328.272777945906
"10.0.2.109",50110,"91.185.213.10",80,12,2687,6,1640,6,1047,6986.277625,0.09338900000057038,140487.63772949565,89689.36384315972
"10.0.2.109",50111,"194.247.12.49",38925,12,2079,6,646,6,1433,6986.850629,0.4492530000006809,11503.540321360497,25517.91529490649
"10.0.2.109",50112,"194.247.12.49",38925,13,4184,7,2704,6,1480,6986.912224,0.6488900000003923,33336.9292175668,18246.54409837236
"10.0.2.109",50113,"91.185.213.10",80,10,1927,5,1347,5,580,6986.984123,0.0534509999997681,201605.2085096023,86808.4787940381
"10.0.2.109",50114,"91.185.213.10",80,11,4032,5,1394,6,2638,6987.037998,0.05403900000055728,206369.47389635252,390532.7633705724
"10.0.2.109",50115,"194.247.12.49",38925,12,2075,6,646,6,1429,6987.089611,0.4276339999996708,12085.100810515485,26733.140957007163
"10.0.2.109",50116,"91.185.213.10",80,10,1923,5,1343,5,580,6987.215753,0.05298499999935302,202774.3701072226,87571.95432776555
"10.0.2.109",50117,"194.247.12.49",38925,20,6349,9,859,11,5490,6989.890204,0.727828999999474,9441.77821989089,60343.84450198019
"10.0.2.109",50118,"91.185.213.10",80,18,6197,9,5350,9,847,6990.017632,0.34776200000032986,123072.67614046216,19484.590035695597
"10.0.2.109",50119,"194.247.12.49",38925,21,11279,12,9644,9,1635,6990.809855,0.8918009999997594,86512.57399354881,14666.949240922055
"10.0.2.109",50120,"91.185.213.10",80,17,11019,7,1495,10,9524,6990.942848,0.09270500000002357,129011.38018442327,821875.8427267205
"10.0.2.109",50121,"194.247.12.49",38925,12,2173,6,987,6,1186,6991.609682,0.9306010000000242,8484.839367247396,10195.561792862627
"10.0.2.109",50122,"194.247.12.49",38925,12,2105,6,710,6,1395,6991.671393,0.44591400000081194,12737.882192507204,25027.247406405
"10.0.2.109",50123,"91.185.202.180",80,8,1920,5,1107,3,813,6991.754102,0.7843910000001415,11290.287624409768,8291.783052073299
"10.0.2.109",50124,"194.247.12.49",38925,12,2131,6,692,6,1439,6991.768332,0.6934559999999692,7983.20297178227,16600.909069934518
"10.0.2.109",50125,"91.185.213.10",80,10,1953,5,1309,5,644,6991.795872,0.09515300000020943,110054.33354678204,54144.37800162539
"10.0.2.109",50126,"194.247.12.49",38925,12,2140,6,708,6,1432,6991.869036,0.4283239999995203,13223.634444967696,26746.108086431836
"10.0.2.109",50127,"91.185.213.10",80,10,1988,5,1346,5,642,6991.994935,0.05295600000044942,203338.6207400222,96986.1772028932
"10.0.2.109",50128,"91.185.213.10",80,10,1979,5,1353,5,626,6992.173169,0.05268900000010035,205431.87382526495,95048.30230200729
"10.0.2.109",50129,"194.247.12.49",38925,15,2373,7,906,8,1467,6992.247147,34.361651000000165,210.93282159230256,341.54354224713893
"10.0.2.109",50130,"5.10.88.212",80,11,1331,6,801,5,530,6992.37262,9.828593000000183,651.975313251844,431.3944020268131
"10.0.2.109",50131,"194.247.12.49",38925,18,2092,8,722,10,1370,6992.410642,13.067931999999928,441.99801468205004,838.6942937872695
"10.0.2.109",50132,"194.247.12.49",38925,44,14342,20,7131,24,7211,6992.672185,30.721958000000086,1856.9128959814293,1877.744901545658
"10.0.2.109",50133,"194.247.12.49",38925,42,23724,24,21514,18,2210,6992.76992,30.62048600000071,5620.812158239291,577.3912275592096
"10.0.2.109",50134,"31.13.93.3",443,36,13661,17,6615,19,7046,6992.798869,30.595072000000073,1729.6903239841984,1842.3882120623828
"10.0.2.109",50135,"194.247.12.49",38925,12,2089,6,646,6,1443,6992.869861,0.4302660000003016,12011.174482753408,26829.91451797704
"10.0.2.109",50136,"194.247.12.49",38925,37,22517,23,20503,14,2014,6992.970386,14.066931999999724,11660.25399141783,1145.3812387804473
"10.0.2.109",50137,"91.185.213.10",80,10,1937,5,1357,5,580,6992.994354,0.052929999999832944,205101.0768946583,87662.95106772425
"10.0.2.109",50138,"194.247.12.49",38925,36,18591,20,13374,16,5217,6993.070289,30.31824299999971,3528.9643928245123,1376.5969221897324
"10.0.2.109",50139,"104.28.16.59",80,32,22209,11,1826,21,20383,6993.095616,13.941403000000719,1047.8141977532136,11696.383785763283
"10.0.2.109",50140,"194.247.12.49",38925,12,1665,6,830,6,835,6993.170202,30.22345200000018,219.69694262587743,221.02041818386465
"10.0.2.109",50141,"88.85.84.106",80,27,18071,12,4979,15,13092,6993.195742,30.19227899999987,1319.2776868549793,3468.9663539476583
"10.0.2.109",50142,"194.247.12.49",38925,13,2148,7,700,6,1448,6993.270974,0.649717000000237,8619.13725514025,17829.301064918687
"10.0.2.109",50143,"194.247.12.49",38925,20,10426,12,8856,8,1570,6993.370792,2.316378000000441,30585.681611544627,5422.258370610328
"10.0.2.109",50144,"194.247.12.49",38925,13,2037,7,805,6,1232,6993.394761,29.996197000000393,214.69388269452676,328.57498568901485
"10.0.2.109",50145,"91.185.213.10",80,10,1942,5,1362,5,580,6993.399121,0.29027700000006007,37536.55990656423,15984.731825115457
"10.0.2.109",50146,"194.247.12.49",38925,13,2146,7,701,6,1445,6993.455954,3.813068999999814,1470.731319050422,3031.6786819227673
"10.0.2.109",50147,"91.185.213.10",80,16,10166,7,1484,9,8682,6993.782573,1.0584759999992457,11216.125826195834,65618.87090500824
"10.0.2.109",50148,"194.247.12.49",38925,13,2158,7,700,6,1458,6993.805073,2.4759079999994356,2261.7964803220784,4710.9989547279865
"10.0.2.109",50149,"173.194.113.97",80,8,1722,5,1145,3,577,6993.837849,29.55236000000059,309.9583248173688,156.19733923111073
"10.0.2.109",50150,"104.31.92.48",80,34,23258,12,1864,22,21394,6993.916805,29.472985999999764,505.95484285169204,5807.080422730203
"10.0.2.109",50151,"194.247.12.49",38925,12,1688,6,648,6,1040,6994.06629,0.47240899999997055,10973.541994331868,17611.857521767193
"10.0.2.109",50152,"194.247.12.49",38925,13,2142,7,700,6,1442,6994.19051,2.4070889999993597,2326.461547537914,4792.510787928103
"10.0.2.109",50153,"62.161.94.220",80,10,1543,5,961,5,582,6994.212835,0.07496099999934813,102559.99786644863,62112.29839570562
"10.0.2.109",50154,"194.247.12.49",38925,12,2093,6,646,6,1447,6994.250777,4.727621999999428,1093.1500022634266,2448.5883177634337
"10.0.2.109",50155,"31.13.93.3",443,12,1519,7,990,5,529,6994.397925,11.08046099999956,714.7717048957002,381.9335675654802
"10.0.2.109",50156,"194.247.12.49",38925,12,2111,6,646,6,1465,6994.582211,1.8772930000004635,2752.9000534273146,6243.031854908693
"10.0.2.109",50157,"88.85.84.114",80,8,1416,5,760,3,656,6994.605249,28.788045999999667,211.19877326860149,182.29788850552973
"10.0.2.109",50158,"194.247.12.49",38925,12,1343,6,546,6,797,6994.643396,28.7545599999994,151.90634111598615,221.73874335062447
"10.0.2.109",50159,"62.152.53.250",80,11,1260,6,780,5,480,6994.772548,10.116839999999684,616.7933860770947,379.5651606628275
"10.0.2.109",50160,"194.247.12.49",38925,12,1560,6,788,6,772,6994.924765,28.46737800000028,221.44645706393956,216.95008230122
"10.0.2.109",50161,"91.185.213.10",80,10,1952,5,1372,5,580,6994.926212,1.049011000000064,10463.188660556782,4423.213865249952
"10.0.2.109",50162,"128.199.53.58",80,11,1471,6,749,5,722,6995.053506,15.034748000000036,398.5434275320069,384.1767085154993
"10.0.2.109",50163,"91.185.213.10",80,10,1936,5,1356,5,580,6995.312152,1.0512999999991735,10318.653096174763,4413.583182729619
"10.0.2.109",50164,"91.185.213.10",80,10,1959,5,1379,5,580,6995.573016,0.05307399999946938,207860.72276652025,87425.10457185043
"10.0.2.109",50165,"91.185.213.10",80,10,1941,5,1361,5,580,6995.662002,0.056260000000293076,193530.0391031511,82474.22680369408
"10.0.2.109",50166,"194.247.12.49",38925,16,6571,9,5122,7,1449,6995.890638,0.8885879999997996,46113.60945681152,13045.415873276044
"10.0.2.109",50167,"91.185.213.10",80,10,1940,5,1359,5,581,6995.980361,1.0509259999998903,10345.162266421361,4422.766208087425
"10.0.2.109",50168,"194.247.12.49",38925,18,3380,9,1550,9,1830,6995.994963,16.625175000000127,745.8568105298083,880.592234367451
"10.0.2.109",50169,"91.185.213.10",80,13,6365,6,1363,7,5002,6996.020357,0.053339000000050873,204428.27949510864,750220.2890935682
"10.0.2.109",50170,"104.28.16.59",80,16,3234,8,1750,8,1484,6996.160198,16.459396000000197,850.5779920478146,721.2901372565468
"10.0.2.109",50171,"194.247.12.49",38925,12,2054,6,1238,6,816,6996.228985,27.16554300000007,364.5794969016439,240.30441799009807
"10.0.2.109",50172,"88.85.84.114",80,8,1807,5,743,3,1064,6996.378309,27.015537000000222,220.02153797645965,315.07794940370536
"10.0.2.109",50173,"194.247.12.49",38925,19,9078,11,8180,8,898,6996.651066,26.742105999999694,2447.0772795531043,268.6400240878591
"10.0.2.109",50174,"178.79.215.59",80,18,8981,8,867,10,8114,6996.803658,3.89316400000007,1781.5843360310214,16673.327915289166
"10.0.2.109",50175,"194.247.12.49",38925,13,1099,7,457,6,642,6997.072266,2.740890999999465,1333.872817270265,1873.8432137582279
"10.0.2.109",50176,"194.247.12.49",38925,20,8954,11,6602,9,2352,6997.760534,25.628607999999986,2060.8220313799343,734.1795543480165
"10.0.2.109",50177,"194.247.12.49",38925,17,6908,10,6077,7,831,6998.265669,25.127144000000044,1934.8000711899417,264.5744379066713
"10.0.2.109",50178,"194.247.12.49",38925,15,2398,8,1275,7,1123,6998.326283,25.062066999999843,406.9895751216396,358.47003361694215
"10.0.2.109",50179,"8.254.199.45",80,15,6761,7,804,8,5957,6998.395709,17.229722999999467,373.308381103991,2765.917943080192
"10.0.2.109",50180,"104.31.92.48",80,9,2040,5,993,4,1047,6998.491318,24.89660499999991,319.0796496148784,336.43141303804396
"10.0.2.109",50181,"194.247.12.49",38925,68,61675,50,60248,18,1427,7000.090126,23.29985299999953,20686.139092809288,489.9601727101124
"10.0.2.109",50182,"5.149.255.156",80,66,61536,17,1354,49,60182,7000.238324,23.151034000000436,467.88406945451317,20796.30654941766
"10.0.2.109",50183,"194.247.12.49",38925,16,3481,8,761,8,2720,7001.276124,21.18325399999958,287.3968277017365,1027.2265063715156
"10.0.2.109",50184,"8.21.198.146",80,11,3177,6,2590,5,587,7001.463476,0.34016500000052474,60911.616421348575,13805.065188931125
"10.0.2.109",50185,"194.247.12.49",38925,16,3484,8,761,8,2723,7001.791291,20.676277000000482,294.4437240804937,1053.574586952936
"10.0.2.109",50186,"8.37.70.23",80,11,3180,6,2593,5,587,7001.979358,0.5299310000000332,39144.718840752284,8861.531029510834
"10.0.2.109",50187,"88.85.84.106",80,14,8596,7,2222,7,6374,7002.778669,20.609997999999905,862.4940186796758,2474.1390076796824
"10.0.2.109",50188,"194.247.12.49",38925,45,23717,24,20737,21,2980,7004.790595,18.605462999999872,8916.52091646422,1281.3440869490946
"10.0.2.109",50189,"194.247.12.49",38925,17,1962,8,640,9,1322,7004.851554,11.806689000000006,433.65248292726244,895.7634100466265
"10.0.2.109",50190,"195.113.232.88",443,38,23080,15,2428,23,20652,7004.958487,18.437423000000308,1053.5094844870498,8960.905219780294
"10.0.2.109",50191,"195.113.232.88",443,10,1325,6,932,4,393,7005.011714,11.646297000000231,640.2034912899655,269.95705158471725
"10.0.2.109",50192,"194.247.12.49",38925,28,9003,13,6424,15,2579,7006.869717,16.522813000000497,3110.3662554311095,1248.697785298386
"10.0.2.109",50193,"2.20.182.104",443,23,8464,11,2125,12,6339,7007.04017,16.352175999999417,1039.616990423819,3101.2386363748656
"10.0.2.109",50194,"194.247.12.49",38925,65,45852,41,43137,24,2715,7007.232252,16.166654000000563,21346.161054723383,1343.5062072831672
"10.0.2.109",50195,"195.113.232.91",443,55,45041,17,2097,38,42944,7011.479113,11.919605000000047,1407.429189138393,28822.43161581266
"10.0.2.109",50196,"194.247.12.49",38925,22,7804,11,5194,11,2610,7012.808607,1.4576399999996283,28506.352734564498,14324.524573972534
"10.0.2.109",50197,"217.69.139.59",443,20,7455,9,2292,11,5163,7012.952852,1.3133709999992789,13961.020914890056,31448.844233672495
"10.0.2.109",50198,"194.247.12.49",38925,12,2744,6,1461,6,1283,7018.668634,4.72097500000018,2475.7597741990908,2174.1271665280174
"10.0.2.109",50199,"88.85.84.123",80,8,2478,5,1191,3,1287,7018.813678,4.575258999999278,2082.5050559982515,2250.364405600126
"10.0.2.109",50200,"194.247.12.49",38925,12,2370,6,700,6,1670,7021.33059,0.4690630000004603,11938.694802179034,28482.314742341412
"10.0.2.109",50201,"91.185.213.10",80,12,2326,6,1638,6,688,7021.464712,0.09339799999997922,140302.7902096717,58930.59808562522
"10.0.2.109",50202,"194.247.12.49",38925,19,10639,11,9034,8,1605,7022.011976,0.6488140000001295,111390.93792671795,19789.955210580287
"10.0.2.109",50203,"91.185.213.10",80,16,10433,7,1519,9,8914,7022.137551,0.07439100000010512,163353.09378799624,958610.5846123755
"10.0.2.109",50204,"194.247.12.49",38925,15,3851,7,1688,8,2163,7022.812911,42.6790860000001,316.4079005815628,405.4444839798106
"10.0.2.109",50205,"194.247.12.49",38925,12,2116,6,710,6,1406,7022.873748,0.46333599999979924,12258.9222508125,24276.119274144192
"10.0.2.109",50206,"91.185.213.10",80,10,1964,5,1320,5,644,7022.997583,0.10579799999959505,99812.850904936,48696.57271422636
"10.0.2.109",50207,"5.10.88.211",80,8,1176,5,754,3,422,7023.351298,3.2569570000005115,1852.0355043063364,1036.5503750892228
"10.0.2.109",50208,"194.247.12.49",38925,13,2875,7,1546,6,1329,7023.530255,41.963277000000744,294.7338931609126,253.36438810533818
"10.0.2.109",50209,"194.247.12.49",38925,36,23385,22,21388,14,1997,7023.590745,9.548452999999427,17919.551994444573,1673.1506140315043
"10.0.2.109",50210,"194.247.12.49",38925,32,21221,20,19958,12,1263,7023.683914,4.11371599999984,38812.59668873743,2456.173445128539
"10.0.2.109",50211,"173.194.122.25",80,8,2560,5,1242,3,1318,7023.686896,41.802144000000226,237.6911576592805,252.2358661794941
"10.0.2.109",50212,"104.31.92.48",80,31,23081,11,1813,20,21268,7023.718979,9.419901999999638,1539.7187783907473,18062.183661784013
"10.0.2.109",50213,"194.247.12.49",38925,45,24409,23,16460,22,7949,7023.785078,41.708034000000225,3157.1854957248593,1524.6942591444051
"10.0.2.109",50214,"194.247.12.49",38925,13,1772,7,884,6,888,7023.884411,41.60925599999973,169.96218341419143,170.73124306764933
"10.0.2.109",50215,"194.247.12.49",38925,13,2175,7,700,6,1475,7023.984889,4.333909999999378,1292.1357388595527,2722.714592596915
"10.0.2.109",50216,"88.85.84.123",80,8,1469,5,813,3,656,7024.031371,41.45857199999955,156.87949888867544,126.5841959052535
"10.0.2.109",50217,"194.247.12.49",38925,12,2110,6,646,6,1464,7024.084816,0.43537000000014814,11870.363139394633,26901.256402590934
"10.0.2.109",50218,"91.185.213.10",80,10,1958,5,1378,5,580,7024.215081,0.054166999999324617,203518.74757947557,85661.0113179215
"10.0.2.109",50219,"104.28.16.59",80,26,20859,9,1075,17,19784,7024.829744,2.9675780000006853,2897.986169191851,53333.72871748054
"10.0.2.109",50220,"88.85.84.106",80,34,23781,15,7549,19,16232,7024.928159,40.560631999999714,1488.9314347961943,3201.528023527861
"10.0.2.109",50221,"91.185.202.180",80,11,2101,6,1180,5,921,7025.968316,14.778842999999142,638.7509495838441,498.5505292938309
"10.0.2.109",50222,"91.185.213.10",80,10,1969,5,1389,5,580,7026.958529,1.0491589999992357,10591.340302097295,4422.589902963593
"10.0.2.109",50223,"194.247.12.49",38925,13,2072,7,805,6,1267,7027.617366,37.87682599999971,170.02480619680352,267.6042601880125
"10.0.2.109",50224,"194.247.12.49",38925,13,1724,7,702,6,1022,7027.678449,0.7351980000003095,7638.758538512939,11120.813712763851
"10.0.2.109",50225,"194.247.12.49",38925,19,8826,11,7940,8,886,7027.799259,37.68755499999952,1685.4370096441864,188.07269402326816
"10.0.2.109",50226,"62.161.94.220",80,10,1525,5,943,5,582,7027.832231,0.3128579999993235,24113.175945688818,14882.151007837638
"10.0.2.109",50227,"194.247.12.49",38925,22,10873,13,9933,9,940,7027.860143,37.631218000000445,2111.65102336042,199.83408456244788
"10.0.2.109",50228,"194.247.12.49",38925,12,1345,6,546,6,799,7027.960004,37.528504000000794,116.39153002208421,170.32386902499138
"10.0.2.109",50229,"8.254.199.45",80,19,10672,8,859,11,9813,7027.989892,24.322814000000108,282.5330983495565,3227.5870711341067
"10.0.2.109",50230,"194.247.12.49",38925,12,1563,6,788,6,775,7028.060627,37.42990699999973,168.42147109796574,165.642944290512
"10.0.2.109",50231,"194.247.12.49",38925,12,2083,6,1238,6,845,7028.160988,7.708736999999928,1284.7759626512218,876.9270504364156
"10.0.2.109",50232,"128.199.53.58",80,11,1474,6,752,5,722,7028.18831,15.0380980000009,400.0505915043006,384.09112641769286
"10.0.2.109",50233,"194.247.12.49",38925,68,37117,35,27772,33,9345,7028.260869,59.14829499999996,3756.253667159808,1263.9417585916897
"10.0.2.109",50234,"194.247.12.49",38925,26,7477,13,5071,13,2406,7028.360772,6.464235999999801,6275.760971598384,2977.6140598828065
"10.0.2.109",50235,"194.247.12.49",38925,19,2865,9,1134,10,1731,7028.46091,37.04817400000047,244.870367970089,373.7836040178343
"10.0.2.109",50236,"194.247.12.49",38925,17,3310,8,929,9,2381,7028.561604,8.743943999999829,849.9596978205883,2178.422002702713
"10.0.2.109",50237,"217.20.147.94",443,12,2264,7,1377,5,887,7028.605354,36.90349799999967,298.5082877509362,192.28529501458272
"10.0.2.109",50238,"194.247.12.49",38925,17,2513,9,1333,8,1180,7028.661538,7.209254999999757,1479.2097102960513,1309.4279505996553
"10.0.2.109",50239,"193.0.170.53",443,16,3011,8,2113,8,898,7028.691221,8.614273999999568,1962.324393210716,833.9646498358841
"10.0.2.109",50240,"173.194.113.97",80,8,1757,5,1180,3,577,7028.739688,36.75047900000027,256.86740028612775,125.60380505516585
"10.0.2.109",50241,"194.247.12.49",38925,22,13224,13,12272,9,952,7028.761254,36.726840000000266,2673.140406307738,207.36877988958335
"10.0.2.109",50242,"104.31.92.48",80,11,2155,6,1050,5,1105,7028.789827,7.080500000000029,1186.3568956994513,1248.4993997598988
"10.0.2.109",50243,"194.247.12.49",38925,19,8154,11,7256,8,898,7028.862106,36.627801000000545,1584.807125057798,196.13517065902735
"10.0.2.109",50244,"178.79.215.17",80,21,13127,8,867,13,12260,7028.905914,3.7937709999996514,1828.2600610317907,25852.904669261537
"10.0.2.109",50245,"194.247.12.49",38925,12,1837,6,900,6,937,7028.961975,3.6379539999998087,1979.134425559086,2060.4988408320705
"10.0.2.109",50246,"178.79.215.7",80,16,7949,7,813,9,7136,7029.006118,3.691063999999642,1762.093531838145,15466.542980562119
"10.0.2.109",50247,"194.247.12.49",38925,17,2490,9,1331,8,1159,7029.061918,6.807518999999957,1564.1528139693871,1362.023374448174
"10.0.2.109",50248,"104.28.17.59",80,8,1583,5,857,3,726,7029.12563,3.473908000000847,1973.5698239557087,1671.8922896054196
"10.0.2.109",50249,"194.247.12.49",38925,23,12092,14,11141,9,951,7029.162507,36.32705999999962,2453.4878407446386,209.43065582516394
"10.0.2.109",50250,"104.28.16.59",80,11,2128,6,1025,5,1103,7029.191397,6.677558000000317,1227.993826485612,1321.441161574273
"10.0.2.109",50251,"194.247.12.49",38925,12,3257,6,1645,6,1612,7029.262455,33.42991999999958,393.6593327175226,385.7622154046483
"10.0.2.109",50252,"178.79.215.59",80,20,11887,8,866,12,11021,7029.306993,3.3898490000001402,2043.7488513499313,26009.418118623085
"10.0.2.109",50253,"31.13.93.3",443,61,36494,23,8591,38,27903,7029.384247,58.024717999999666,1184.460732751866,3847.050148524656
"10.0.2.109",50254,"194.247.12.49",38925,13,1095,7,457,6,638,7030.482409,3.730695999999625,979.9779987434964,1368.109328661599
"10.0.2.109",50255,"8.254.199.45",80,18,8733,8,859,10,7874,7031.03931,21.277788000000328,322.9659022826947,2960.4581077694274
"10.0.2.109",50256,"62.152.53.250",80,11,1262,6,782,5,480,7031.199277,10.10570800000005,619.056081968722,379.9832728196759
"10.0.2.109",50257,"128.140.169.242",443,22,7028,10,2042,12,4986,7031.368894,3.4558619999997973,4727.040605209629,11542.127550232717
"10.0.2.109",50258,"88.85.84.114",80,8,1836,5,772,3,1064,7031.431732,4.437476000000061,1391.7821752725908,1918.2075576295813
"10.0.2.109",50259,"173.194.122.13",80,8,2993,5,1522,3,1471,7032.293706,30.398368999999548,400.54780570629237,387.12603297894617
"10.0.2.109",50260,"194.247.12.49",38925,16,4954,8,2507,8,2447,7032.811426,32.681164999999964,613.686813184292,598.9994542728211
"10.0.2.109",50261,"173.194.122.18",80,10,4595,6,2316,4,2279,7032.963078,32.52459100000033,569.6612756790643,560.5604694613936
"10.0.2.109",50262,"194.247.12.49",38925,16,3483,8,761,8,2722,7036.07069,28.237379000000146,215.60074679735567,771.176389990016
"10.0.2.109",50263,"194.247.12.49",38925,16,3487,8,761,8,2726,7036.132419,28.1790060000003,216.04736519094874,773.9094842451067
"10.0.2.109",50264,"194.247.12.49",38925,13,2589,7,846,6,1743,7036.231925,29.26246699999956,231.28603613632788,476.51484750073223
"10.0.2.109",50265,"8.21.199.3",80,11,3179,6,2592,5,587,7036.259182,0.3429970000006506,60455.33925941238,13691.081846170937
"10.0.2.109",50266,"8.37.70.20",80,11,3183,6,2596,5,587,7036.324761,0.5301559999998062,39173.3753838636,8857.770165765767
"10.0.2.109",50267,"173.194.122.24",80,8,2285,5,1667,3,618,7036.381962,29.109025999999176,458.1396849211093,169.84422632348262
"10.0.2.109",50268,"194.247.12.49",38925,21,7750,10,5140,11,2610,7060.50376,1.0748419999999896,38256.78564849568,19426.111000500725
"10.0.2.109",50269,"194.247.12.49",38925,35,16605,18,12873,17,3732,7060.565622,3.6472960000000967,28235.71215497653,8185.7902402215805
"10.0.2.109",50270,"194.247.12.49",38925,25,6708,11,1819,14,4889,7060.626093,3.817334000000301,3812.0845595378482,10245.894124013492
"10.0.2.109",50271,"217.69.139.58",443,20,7455,9,2292,11,5163,7060.634934,0.94346300000052,19434.784405949034,43779.14131235378
"10.0.2.109",50272,"128.140.169.242",443,31,16156,13,3314,18,12842,7060.716633,3.4962159999995492,7583.055509157162,29384.91214502
"10.0.2.109",50273,"94.100.180.77",443,26,6529,13,4633,13,1896,7060.770463,3.672946000000593,10091.08219940996,4129.655050740618
"10.0.2.109",50274,"194.247.12.49",38925,17,1909,8,613,9,1296,7062.349053,20.728611000000456,236.581216175068,500.1782319133574
"10.0.2.109",50275,"194.247.12.49",38925,22,6177,11,4895,11,1282,7062.410543,20.668486999999914,1894.6718257606453,496.21435763537227
"10.0.2.109",50276,"94.100.180.77",443,10,1298,6,932,4,366,7062.473107,20.604362000000037,361.8651235112248,142.10583176513762
"10.0.2.109",50277,"194.247.12.49",38925,73,52613,48,49069,25,3544,7062.510145,24.901111000000128,15764.43717712025,1138.5837362838893
"10.0.2.109",50278,"173.194.122.23",443,15,5556,8,908,7,4648,7062.570176,20.50846399999955,354.19522398167703,1813.1050672542233
"10.0.2.109",50279,"194.247.12.49",38925,30,7063,14,4980,16,2083,7062.609954,24.789343000000372,1607.1422304334328,672.224350600972
"10.0.2.109",50280,"194.247.12.49",38925,58,38166,35,35152,23,3014,7062.694981,24.711342999999943,11380.037094705887,975.7462392877658
"10.0.2.109",50281,"194.247.12.49",38925,23,7302,11,6060,12,1242,7062.756051,2.731311999999889,17749.711493964063,3637.8121576738226
"10.0.2.109",50282,"173.194.122.26",443,23,6414,11,1573,12,4841,7062.770002,24.62912099999994,510.93987479293435,1572.4475104085157
"10.0.2.109",50283,"194.247.12.49",38925,19,10099,11,8530,8,1569,7062.829723,2.0478060000004916,33323.469117672095,6129.486875220107
"10.0.2.109",50284,"173.194.122.11",443,51,37525,18,2512,33,35013,7062.849906,24.55617600000005,818.3684625814686,11406.662014476498
"10.0.2.109",50285,"23.21.71.2",443,16,6677,8,810,8,5867,7062.904314,2.5827509999999165,2508.9526632649486,18172.870710340067
"10.0.2.109",50286,"194.247.12.49",38925,20,5793,10,3967,10,1826,7063.092105,3.2906650000004447,9644.251237970353,4439.224290530341
"10.0.2.109",50287,"194.247.12.49",38925,26,7881,12,4782,14,3099,7063.191238,24.15894499999922,1583.5128562112805,1026.2037518608863
"10.0.2.109",50288,"217.73.200.220",443,19,5490,9,1554,10,3936,7063.240508,3.1421820000005027,3956.4862888266853,10021.061797182647
"10.0.2.109",50289,"194.247.12.49",38925,23,5698,11,3733,12,1965,7063.291447,2.206137000000126,13536.783980323204,7125.577423341842
"10.0.2.109",50290,"217.69.133.148",443,20,7312,11,2723,9,4589,7063.316134,24.033870000000206,906.3875272688008,1527.5109668147363
"10.0.2.109",50291,"88.212.196.124",443,17,5129,9,1589,8,3540,7063.417295,2.080076999999619,6111.312225462003,13614.88060298017
"10.0.2.109",50292,"91.185.213.10",80,16,9893,7,1483,9,8410,7063.95255,0.0734759999995731,161467.69013104864,915673.1449778281
"10.0.2.109",50293,"91.185.202.180",80,8,1912,5,1099,3,813,7064.511552,0.974568999999974,9021.423829405854,6673.719356967206
"10.0.2.109",50294,"173.194.122.25",443,66,51968,21,3092,45,48876,7064.557275,22.853815999999824,1082.357537139539,17109.09022808283
"10.0.2.109",50295,"194.247.12.49",38925,13,2157,7,764,6,1393,7064.673546,0.7476459999998042,8174.99190793718,14905.449905440433
"10.0.2.109",50296,"91.185.213.10",80,10,1951,5,1307,5,644,7064.806559,0.33648400000038237,31074.285850109125,15311.277802196078
"10.0.2.109",50297,"194.247.12.49",38925,13,1465,7,650,6,815,7064.989967,9.718549999999595,535.0592423767142,670.8819731338803
"10.0.2.109",50298,"5.10.88.211",80,11,1306,6,776,5,530,7065.115645,9.561298999999963,649.2841610747686,443.45438836292186
"10.0.2.109",50299,"194.247.12.49",38925,35,23665,23,21700,12,1965,7065.68206,21.645166999999674,8020.26614070488,726.2591228794971
"10.0.2.109",50300,"194.247.12.49",38925,36,22450,21,20392,15,2058,7065.742643,4.204906000000847,38796.58665377232,3915.4264090556803
"10.0.2.109",50301,"194.247.12.49",38925,12,1731,6,830,6,901,7065.835206,21.514009000000442,308.6361077565722,335.0375097453874
"10.0.2.109",50302,"104.28.16.59",80,31,22142,12,1870,19,20272,7065.866291,4.080965999999535,3665.7987349077903,39739.61067061536
"10.0.2.109",50303,"194.247.12.49",38925,31,15214,17,10068,14,5146,7065.934584,21.42474200000015,3759.3918283823177,1921.5167211815065
"10.0.2.109",50304,"88.85.84.114",80,8,1482,5,826,3,656,7065.98436,21.364532999999938,309.29765700940055,245.64075423506873
"10.0.2.109",50305,"194.247.12.49",38925,12,1986,6,751,6,1235,7066.0348,21.311954999999216,281.9075021507985,463.5895674517126
"10.0.2.109",50306,"88.85.84.123",80,24,14802,12,5016,12,9786,7066.058735,21.30017500000031,1883.9281836886043,3675.4627602824326
"10.0.2.109",50307,"194.247.12.49",38925,12,1632,6,648,6,984,7066.135514,0.4644850000004226,11160.747925111216,16947.802404798516
"10.0.2.109",50308,"194.247.12.49",38925,13,1604,7,842,6,762,7066.235449,21.121565999999802,318.9157470615608,288.61496349276644
"10.0.2.109",50309,"62.161.94.220",80,10,1487,5,905,5,582,7066.284217,0.07739700000001903,93543.67740349393,60157.37044069996
"10.0.2.109",50310,"194.247.12.49",38925,12,1331,6,546,6,785,7066.335411,21.022202000000107,207.7803267231462,298.7317884206406
"10.0.2.109",50311,"128.199.53.58",80,11,1461,6,739,5,722,7066.379301,15.245020000000295,387.7987696965885,378.8778237089809
"10.0.2.109",50312,"104.31.92.48",80,30,23361,12,1943,18,21418,7067.651896,19.67504000000008,790.0365132675682,8708.698940383312
"10.0.2.109",50313,"173.194.113.105",80,8,1725,5,1148,3,577,7067.998142,19.348291999999674,474.6672212720459,238.574030203807
"10.0.2.109",50314,"62.152.53.250",80,11,1248,6,768,5,480,7068.084839,10.111902999999984,607.6007651576573,379.75047822353577
"10.0.2.109",50315,"194.247.12.49",38925,18,8681,10,7784,8,897,7068.928355,18.42216399999961,3380.2760631162178,389.53078476557647
"10.0.2.109",50316,"194.247.12.49",38925,22,12236,13,11285,9,951,7068.988982,18.347703000000365,4920.506943021598,414.65681017399555
"10.0.2.109",50317,"178.79.215.17",80,18,8638,8,866,10,7772,7069.08156,3.6182920000001104,1914.7155619280556,17183.79832252292
"10.0.2.109",50318,"178.79.215.59",80,20,12085,8,866,12,11219,7069.119102,3.575838000000658,1937.4479492635642,25099.57106557497
"10.0.2.109",50319,"194.247.12.49",38925,13,1099,7,457,6,642,7070.131311,2.737019999999575,1335.7593294899445,1876.4934125438608
"10.0.2.109",50320,"194.247.12.49",38925,29,7876,14,5116,15,2760,7070.268401,17.140430999999808,2387.804600712809,1288.1823100014374
"10.0.2.109",50321,"173.194.122.13",443,22,7245,11,2322,11,4923,7070.426913,16.98171000000002,1093.8827715230077,2319.2010698569197
"10.0.2.109",50322,"194.247.12.49",38925,12,2070,6,1238,6,832,7071.897364,2.9725439999992886,3331.826206778561,2239.1594539901153
"10.0.2.109",50323,"88.85.84.123",80,8,1823,5,759,3,1064,7072.028949,2.840711000000738,2137.4930431143553,2996.432935274933
"10.0.2.109",50324,"194.247.12.49",38925,22,12579,13,11639,9,940,7074.293501,13.054121000000123,7132.766733202421,576.0632983254812
"10.0.2.109",50325,"8.254.199.45",80,17,12270,7,805,10,11465,7074.418824,12.928423999999723,498.12722726297795,7094.445541080798
"10.0.2.109",50326,"194.247.12.49",38925,15,3422,8,761,7,2661,7074.420403,11.16650699999991,545.2018254231201,1906.4153185951677
"10.0.2.109",50327,"194.247.12.49",38925,16,3461,8,761,8,2700,7074.482591,11.096112999999605,548.660598535741,1946.6276163554544
"10.0.2.109",50328,"194.247.12.49",38925,12,2663,6,1195,6,1468,7074.745232,12.601034999999683,758.6678395862118,931.9869359937732
"10.0.2.109",50329,"88.85.84.106",80,8,2413,5,1392,3,1021,7074.874918,12.47106199999962,892.947208505606,654.9562499168273
"10.0.2.109",50330,"194.247.12.49",38925,12,2306,6,681,6,1625,7074.91291,12.44495199999983,437.7678596108747,1044.6002523754353
"10.0.2.109",50331,"194.247.12.49",38925,36,8319,15,2857,21,5462,7075.037751,12.373841000000539,1847.1224900981842,3531.320630352216
"10.0.2.109",50332,"173.194.122.2",80,8,2049,5,1542,3,507,7075.069495,12.28773799999999,1003.9276553585379,330.0851629486243
"10.0.2.109",50333,"194.247.12.49",38925,18,2168,8,694,10,1474,7075.125585,12.225500999999895,454.132718160184,964.5412486572208
"10.0.2.109",50334,"194.247.12.49",38925,20,9058,11,6675,9,2383,7075.186219,12.165390999999545,4389.501332098738,1567.0684156391449
"10.0.2.109",50335,"216.58.211.42",443,28,7626,14,4854,14,2772,7075.188371,12.223041999999623,3176.9505496259603,1814.2783114056783
"10.0.2.109",50336,"88.85.84.106",80,14,8700,7,2253,7,6447,7075.310539,12.04078699999991,1496.9121204452945,4283.440941194324
"10.0.2.109",50337,"8.37.70.21",80,11,3157,6,2570,5,587,7075.670736,0.562485999999808,36552.0208503092,8348.652233125096
"10.0.2.109",50338,"8.37.70.26",80,11,3172,6,2585,5,587,7077.453958,0.5316640000000916,38896.74681753219,8832.646182549865
"10.0.2.109",50339,"216.58.211.42",443,12,1583,7,1082,5,501,7077.582084,9.768815000000359,886.0849550328962,410.28517788491774
"10.0.2.109",50340,"194.247.12.49",38925,27,18029,17,16342,10,1687,7085.110317,2.169824000000517,60251.891397628955,6219.859306559787
"10.0.2.109",50341,"91.185.213.10",80,25,17877,9,1601,16,16276,7085.239723,0.11241599999993923,113933.95957876925,1158269.2855115854
"10.0.2.109",50342,"194.247.12.49",38925,7,1229,4,232,3,997,7085.891437,0.12417499999992287,14946.64787599076,64231.930742943056
"10.0.2.109",50343,"194.247.12.49",38925,13,3410,7,1995,6,1415,7085.952219,0.6180420000000595,25823.487724132767,18315.907333156825
"10.0.2.109",50344,"194.247.12.49",38925,12,2126,6,710,6,1416,7086.043929,0.48724399999991874,11657.403682756376,23249.13185180708
"10.0.2.109",50345,"91.185.213.10",80,11,3258,5,1329,6,1929,7086.082765,0.05352899999979854,198621.3080767437,288292.3275244835
"10.0.2.109",50346,"91.185.213.10",80,10,1974,5,1330,5,644,7086.175584,0.08898600000065926,119569.37046188359,57896.74780259626
"10.0.2.109",50347,"194.247.12.49",38925,12,1410,6,596,6,814,7086.449835,0.8788549999999304,5425.240796263749,7409.640953286395
"10.0.2.109",50348,"5.10.88.212",80,8,1143,5,721,3,422,7086.579197,0.7491739999995843,7699.145992790995,4506.296267625242
"10.0.2.109",50349,"194.247.12.49",38925,76,46985,45,42926,31,4059,7087.512482,61.714014000000134,5564.505980764746,526.1689832717724
"10.0.2.109",50350,"194.247.12.49",38925,34,22348,21,20401,13,1947,7087.573753,7.345726000000468,22218.089811679554,2120.4166885613495
"10.0.2.109",50351,"194.247.12.49",38925,30,15163,15,9741,15,5422,7087.666386,51.80359000000044,1504.2972890488736,837.3164871392047
"10.0.2.109",50352,"194.247.12.49",38925,16,3017,8,1428,8,1589,7087.766173,176.73273599999993,64.63997705552414,71.92781760590185
"10.0.2.109",50353,"88.85.84.106",80,24,14805,11,5184,13,9621,7087.812387,51.655964000000495,802.8501800876197,1490.0118793640027
"10.0.2.109",50354,"88.85.84.114",80,15,2930,8,1568,7,1362,7087.890739,116.91198099999929,107.29439269359465,93.1983181432882
"10.0.2.109",50355,"104.28.16.59",80,30,22094,11,1813,19,20281,7088.701812,6.217297999999573,2332.846197817926,26096.22379368194
"10.0.2.109",50356,"104.31.92.48",80,35,23344,12,1814,23,21530,7088.896303,47.64951199999996,304.55715894844866,3614.7274708710584
"10.0.2.109",50357,"194.247.12.49",38925,21,10984,12,10033,9,951,7090.129745,49.33675799999946,1626.860038107913,154.20551143632264
"10.0.2.109",50358,"178.79.215.7",80,19,10833,8,866,11,9967,7090.257338,3.4381509999993796,2015.0365705291158,23191.53521762552
"10.0.2.109",50359,"194.247.12.49",38925,16,6859,9,6028,7,831,7090.479304,48.98619099999996,984.4406967669734,135.71171516479012
"10.0.2.109",50360,"8.254.199.45",80,15,6766,7,804,8,5962,7090.603912,21.450576000000183,299.852087887987,2223.5300348111673
"10.0.2.109",50361,"194.247.12.49",38925,13,1099,7,457,6,642,7090.791169,2.769051999999647,1320.3074554036784,1854.7864034336137
"10.0.2.109",50362,"194.247.12.49",38925,13,1685,7,702,6,983,7091.969077,0.7101810000003752,7907.843211796758,11073.233443299448
"10.0.2.109",50363,"194.247.12.49",38925,12,1976,6,751,6,1225,7092.031725,47.43744700000025,126.65099789202334,206.58784609551077
"10.0.2.109",50364,"62.161.94.220",80,10,1486,5,904,5,582,7092.122249,0.3149069999999483,22965.510452296032,14785.31756995165
"10.0.2.109",50365,"194.247.12.49",38925,12,1547,6,788,6,759,7092.156584,47.30908099999942,133.25137302920928,128.34745194057086
"10.0.2.109",50366,"173.194.113.97",80,8,1715,5,1138,3,577,7092.188548,47.27921100000003,192.55820491589833,97.63276294944933
"10.0.2.109",50367,"194.247.12.49",38925,12,1330,6,546,6,784,7092.418601,47.051517999999305,92.8344118461824,133.30069393297987
"10.0.2.109",50368,"62.152.53.250",80,11,1247,6,767,5,480,7092.551363,10.106003000000783,607.163880715207,379.9721808908727
"10.0.2.109",50369,"194.247.12.49",38925,12,2067,6,1238,6,829,7093.277273,46.191955000000235,214.4096304215734,143.57478482995506
"10.0.2.109",50370,"128.199.53.58",80,11,1458,6,736,5,722,7093.278672,15.040001999999731,391.48930964238605,384.0425021220146
"10.0.2.109",50371,"194.247.12.49",38925,12,2303,6,681,6,1622,7093.406915,46.062653000000864,118.27369127001647,281.70327054326975
"10.0.2.109",50372,"88.85.84.123",80,8,1820,5,756,3,1064,7093.411072,46.05681699999968,131.3160655457376,184.81520336066774
"10.0.2.109",50373,"194.247.12.49",38925,60,19816,25,6338,35,13478,7093.467776,46.02354199999991,1101.697040180004,2342.800995195029
"10.0.2.109",50374,"216.58.211.42",443,53,19177,26,12762,27,6415,7093.598051,45.89242999999988,2224.6806281558916,1118.2672174909922
"10.0.2.109",50375,"194.247.12.49",38925,19,2222,9,748,10,1474,7097.496755,11.660073000000011,513.2043341409607,1011.3144231601285
"10.0.2.109",50376,"194.247.12.49",38925,16,3472,8,761,8,2711,7097.557968,41.211927999999716,147.724221977677,526.2554083856535
"10.0.2.109",50377,"216.58.211.42",443,12,1583,7,1082,5,501,7097.62246,11.534158000000389,750.466570685065,347.4896043560236
"10.0.2.109",50378,"194.247.12.49",38925,16,3467,8,761,8,2706,7097.68231,41.074697000000015,148.21777017612564,527.0397977616242
"10.0.2.109",50379,"194.247.12.49",38925,20,9138,11,6609,9,2529,7097.744153,41.72545600000012,1267.1401362276267,484.8838560326325
"10.0.2.109",50380,"8.21.198.203",80,11,3168,6,2581,5,587,7097.74541,1.336168999999245,15453.135045051687,3514.525482931166
"10.0.2.109",50381,"8.21.198.203",80,11,3163,6,2576,5,587,7097.871347,0.3395489999993515,60692.271218702925,13830.10993997617
"10.0.2.109",50382,"88.85.84.106",80,14,8780,7,2399,7,6381,7097.891315,41.576812000000245,461.60345338646664,1227.7997649266542
"10.0.2.109",50383,"194.247.12.49",38925,13,2808,7,1321,6,1487,7098.449573,1.4893920000004073,7095.51279985196,7987.1518042239695
"10.0.2.109",50384,"194.247.12.49",38925,13,2813,7,1326,6,1487,7098.510568,1.444829000000027,7342.045321626159,8233.500296574735
"10.0.2.109",50385,"173.194.122.8",80,8,2046,5,1539,3,507,7098.564414,40.90357799999947,301.00056283585167,99.16002947223963
"10.0.2.109",50386,"91.185.213.10",80,10,2602,5,1401,5,1201,7098.581514,1.066607999999178,10508.077944295033,9007.995439756129
"10.0.2.109",50387,"91.185.213.10",80,10,2607,5,1401,5,1206,7098.639578,1.0668869999999515,10505.329992773844,9043.132028040869
"10.0.2.109",50388,"194.247.12.49",38925,12,2450,6,960,6,1490,7108.612387,0.43647599999985687,17595.469166695348,27309.634435808402
"10.0.2.109",50389,"91.185.213.10",80,10,2298,5,1404,5,894,7108.739531,0.06519500000013068,172283.1505480096,109701.66423783518
"10.0.2.109",50390,"194.247.12.49",38925,36,8147,16,3366,20,4781,7108.852493,30.63562599999932,878.9766528681541,1248.481098444042
"10.0.2.109",50391,"173.194.122.21",443,29,7526,15,4299,14,3227,7108.998902,30.488978999999745,1128.0141588211363,846.7321913272405
"10.0.2.109",50392,"194.247.12.49",38925,27,4146,12,1230,15,2916,7112.810839,26.67872299999999,368.8332458791226,874.4046707183102
"10.0.2.109",50393,"173.194.122.14",443,20,3515,10,2424,10,1091,7112.946112,26.543265000000247,730.5808083519423,328.82164270295755
"10.0.2.109",50394,"194.247.12.49",38925,23,15427,14,13785,9,1642,7115.267262,1.9491689999995288,56577.95706787183,6739.282227453431
"10.0.2.109",50395,"91.185.213.10",80,21,15275,8,1556,13,13719,7115.393487,0.05505099999936647,226117.60004619812,1993642.2590191464
"10.0.2.109",50396,"194.247.12.49",38925,21,7750,10,5140,11,2610,7120.829599,1.114610999999968,36891.79453639088,18732.99294552144
"10.0.2.109",50397,"94.100.180.59",443,20,7455,9,2292,11,5163,7120.97842,0.9657789999992019,18985.709981284697,42767.5482693599
"10.0.2.109",50398,"194.247.12.49",38925,132,88258,39,2496,93,85762,7126.668726,6.969368000000031,2865.109146195166,98444.50745031644
"10.0.2.109",50399,"91.185.213.10",80,118,87458,68,84380,50,3078,7126.796076,6.604092000000492,102215.41432190068,3728.597360545275
"10.0.2.109",50400,"194.247.12.49",38925,12,2755,6,1059,6,1696,7133.889956,0.4688400000004549,18070.13053491976,28939.510280664694
"10.0.2.109",50401,"91.185.213.10",80,12,2711,6,1664,6,1047,7134.018364,0.08706100000017614,152904.28550066124,96208.40560047615
"10.0.2.109",50402,"194.247.12.49",38925,13,4208,7,2704,6,1504,7134.549545,0.6196179999997184,34911.83277440266,19418.415862685506
"10.0.2.109",50403,"91.185.213.10",80,11,4056,5,1418,6,2638,7134.676812,0.05649300000004587,200803.6393887878,373568.4067049522
"10.0.2.109",50404,"194.247.12.49",38925,19,6319,9,859,10,5460,7137.468957,0.6720809999997073,10224.958003578427,64992.166122861716
"10.0.2.109",50405,"91.185.213.10",80,16,6113,8,5320,8,793,7137.597667,0.2834290000000692,150161.0632644846,22383.030670815093
"10.0.2.109",50406,"194.247.12.49",38925,34,16882,18,13794,16,3088,7137.627566,1.8598409999995056,59334.104367001986,13282.855900050901
"10.0.2.109",50407,"31.13.93.3",443,26,16205,10,2550,16,13655,7137.753057,1.734201000000212,11763.342311529925,62991.54480938867
"10.0.2.109",50408,"194.247.12.49",38925,21,11303,12,9644,9,1659,7138.260022,0.8699249999999665,88688.10529643702,15256.487628244402
"10.0.2.109",50409,"91.185.213.10",80,17,11043,7,1519,10,9524,7138.388209,0.09285200000067562,130874.94076499784,820574.6779761944
"10.0.2.109",50410,"194.247.12.49",38925,12,2129,6,710,6,1419,7138.858945,0.5521019999996497,10287.95403748511,20561.417998861085
"10.0.2.109",50411,"91.185.213.10",80,10,1977,5,1333,5,644,7138.99018,0.10657900000023801,100057.23453941382,48339.72921484058
"10.0.2.109",50412,"194.247.12.49",38925,12,2173,6,987,6,1186,7139.032082,0.44519100000070466,17736.207605246967,21312.200830620975
"10.0.2.109",50413,"91.185.202.180",80,8,1920,5,1107,3,813,7139.177069,0.2997169999998732,29547.8734940085,21700.47077744256
"10.0.2.109",50414,"104.31.92.48",80,37,23377,13,1881,24,21496,7139.472238,9.753944999999476,1542.760390795807,17630.609973709023
"10.0.2.109",50415,"194.247.12.49",38925,28,11349,15,9246,13,2103,7139.567945,63.26470700000027,1169.1826850632483,265.93026029504773
"10.0.2.109",50416,"194.247.12.49",38925,13,1491,7,650,6,841,7139.628801,3.909207000000606,1330.1930544990823,1721.065167436505
"10.0.2.109",50417,"194.247.12.49",38925,37,22516,21,20394,16,2122,7139.691019,8.256021000000146,19761.577641335592,2056.1963202370366
"10.0.2.109",50418,"195.113.232.73",443,25,10916,10,1701,15,9215,7139.735289,63.09729199999947,215.66694177620354,1168.3544200280517
"10.0.2.109",50419,"5.10.88.214",80,8,1170,5,748,3,422,7139.753683,3.784077999999681,1581.3627520364284,892.1591996783059
"10.0.2.109",50420,"194.247.12.49",38925,28,14640,15,9583,13,5057,7139.78096,124.68908800000008,614.8412922869397,324.4550156626374
"10.0.2.109",50421,"88.85.84.106",80,27,14552,13,5035,14,9517,7139.936278,73.11687699999948,550.8988027483763,1041.2917389784104
"10.0.2.109",50422,"104.28.16.59",80,33,22262,12,1880,21,20382,7140.816794,7.1294389999993655,2109.562898287136,22870.80371962149
"10.0.2.109",50423,"194.247.12.49",38925,19,3367,10,1602,9,1765,7142.959019,121.50900999999976,105.473659936823,116.20537439980811
"10.0.2.109",50424,"194.247.12.49",38925,17,2526,9,1333,8,1193,7143.38913,4.557419000000664,2339.920906986706,2094.1677734697228
"10.0.2.109",50425,"194.247.12.49",38925,22,10942,13,9990,9,952,7143.450095,121.01851600000009,660.3948109890881,62.932518524685875
"10.0.2.109",50426,"194.247.12.49",38925,13,1741,7,702,6,1039,7143.537263,2.487333999999464,2257.839116098284,3341.730543626948
"10.0.2.109",50427,"104.28.17.59",80,11,2164,6,1059,5,1105,7143.551085,4.394750000000386,1927.7547073210665,2011.490983559753
"10.0.2.109",50428,"178.79.215.59",80,19,10737,8,867,11,9870,7143.575529,4.116483000000699,1684.9334735498296,19181.42258816242
"10.0.2.109",50429,"194.247.12.49",38925,12,2005,6,749,6,1256,7143.598195,120.90435500000058,49.55983595462687,83.10701463152384
"10.0.2.109",50430,"194.247.12.49",38925,13,1095,7,457,6,638,7143.668198,2.7334639999999126,1337.4970367270676,1867.2278105730177
"10.0.2.109",50431,"173.194.113.97",80,8,1744,5,1169,3,575,7143.747085,120.75406199999998,77.44667007557892,38.093956624001606
"10.0.2.109",50432,"194.247.12.49",38925,13,1614,7,842,6,772,7143.794268,120.70497500000056,55.80548771912648,51.16607662608746
"10.0.2.109",50433,"194.247.12.49",38925,12,1343,6,546,6,797,7144.055176,120.41837399999986,36.27353413690842,52.948730232813205
"10.0.2.109",50434,"104.31.92.48",80,16,3171,8,1689,8,1482,7144.103595,49.67855099999997,271.98860932960804,238.65430374569513
"10.0.2.109",50435,"194.247.12.49",38925,12,2080,6,1238,6,842,7144.849378,119.61891100000048,82.79627290704862,56.31216622595714
"10.0.2.109",50436,"62.161.94.220",80,10,1542,5,960,5,582,7144.875533,0.31344799999988027,24501.671728653346,14854.13848549609
"10.0.2.109",50437,"194.247.12.49",38925,17,6879,9,5981,8,898,7144.910441,119.55988799999977,400.2011109277728,60.087041901544886
"10.0.2.109",50438,"128.199.53.58",80,11,1471,6,749,5,722,7144.916172,16.24373899999955,368.8805883916361,355.58315730141686
"10.0.2.109",50439,"194.247.12.49",38925,18,2088,8,722,10,1366,7144.97276,13.002973999999995,444.2060716263835,840.4231216643211
"10.0.2.109",50440,"88.85.84.123",80,11,1995,6,823,5,1172,7144.995127,65.08868600000005,101.15429277524507,144.04961255478398
"10.0.2.109",50441,"194.247.12.49",38925,154,86996,81,62190,73,24806,7145.033568,119.53080399999999,4162.27435398159,1660.2247567915633
"10.0.2.109",50442,"31.13.93.3",443,128,85347,48,23242,80,62105,7145.163609,119.40059099999962,1557.2452233507001,4161.118431984994
"10.0.2.109",50443,"62.152.53.250",80,11,1260,6,780,5,480,7145.374691,10.128738999999769,616.0687919789564,379.1192566024347
"10.0.2.109",50444,"178.79.215.17",80,16,6782,7,813,9,5969,7146.250813,3.448406000000432,1886.0888190077344,13847.557393182247
"10.0.2.109",50445,"31.13.93.3",443,12,1519,7,990,5,529,7146.286616,11.68887099999938,677.5675768857761,362.05378603290467
"10.0.2.109",50446,"194.247.12.49",38925,35,8601,16,5762,19,2839,7146.560348,117.97002100000009,390.7433397846048,192.5234886581904
"10.0.2.109",50447,"173.194.122.27",443,29,8028,14,2351,15,5677,7146.73601,117.79387700000007,159.66874067656326,385.5548450960653
"10.0.2.109",50448,"194.247.12.49",38925,20,8988,11,6634,9,2354,7147.789329,116.71219099999962,454.7254193865675,161.354181072653
"10.0.2.109",50449,"88.85.84.106",80,17,8792,8,2278,9,6514,7147.940215,65.41904800000066,278.573298712629,796.5875626927417
"10.0.2.109",50450,"194.247.12.49",38925,16,3494,8,761,8,2733,7148.129847,114.36577599999964,53.23270835848671,191.1760735134615
"10.0.2.109",50451,"194.247.12.49",38925,17,3544,8,761,9,2783,7148.190627,114.29374499999994,53.266257046700176,194.7963119066578
"10.0.2.109",50452,"8.21.198.139",80,11,3190,6,2603,5,587,7148.318167,0.341682999999648,60945.37919656948,13743.733226425773
"10.0.2.109",50453,"8.21.198.146",80,11,3186,6,2599,5,587,7148.376913,1.3402299999997922,15513.755101738674,3503.876200354214
"10.0.2.109",50454,"194.247.12.49",38925,29,8263,13,5954,16,2309,7149.487782,115.02790399999958,414.09082790902784,160.58712153878824
"10.0.2.109",50455,"173.194.122.28",443,23,7704,11,1835,12,5869,7149.641892,114.8735970000007,127.79263802455765,408.72751638481134
"10.0.2.109",50456,"194.247.12.49",38925,37,7838,16,3163,21,4675,7151.833749,112.69266599999992,224.53990040487656,331.87607789845015
"10.0.2.109",50457,"173.194.122.9",443,30,7209,15,4131,15,3078,7151.989002,112.53714899999977,293.6630285524655,218.80774676458216
"10.0.2.109",50458,"194.247.12.49",38925,34,9208,14,1848,20,7360,7160.830373,103.70073899999988,142.56407565234434,567.7876606067395
"10.0.2.109",50459,"173.194.122.7",443,26,8521,13,6758,13,1763,7160.990288,103.54030799999964,522.1541353730587,136.2174816014653
"10.0.2.109",50460,"194.247.12.49",38925,21,7750,10,5140,11,2610,7181.808935,1.1545180000002802,35616.59497728924,18085.469433993178
"10.0.2.109",50461,"217.69.139.58",443,20,7455,9,2292,11,5163,7181.955741,1.007579000000078,18198.076776112426,40993.311690693045
"10.0.2.109",50462,"194.247.12.49",38925,33,8234,14,2514,19,5720,7192.611061,71.92175600000064,279.6372213158953,636.2469792867626
"10.0.2.109",50463,"194.247.12.49",38925,17,1972,8,640,9,1332,7193.32794,11.357410999999956,450.80696648206356,938.2419989907947
"10.0.2.109",50464,"194.247.12.49",38925,76,62506,53,59721,23,2785,7193.388821,62.13086700000076,7689.704378340546,358.5979252470391
"10.0.2.109",50465,"92.122.206.66",443,10,1325,6,932,4,393,7193.487969,11.197181999999884,665.881826338098,280.7849332090907
"10.0.2.109",50466,"194.247.12.49",38925,42,17287,22,13591,20,3696,7193.529164,70.99746100000084,1531.435046670172,416.4655972697341
"10.0.2.109",50467,"23.62.237.6",443,74,62152,21,2435,53,59717,7193.567311,61.952197000000524,314.4359836019994,7711.364941585461
"10.0.2.109",50468,"194.247.12.49",38925,22,5982,11,4275,11,1707,7193.590704,21.11524300000019,1619.682993939482,646.736577930923
"10.0.2.109",50469,"2.20.182.56",443,36,16694,15,3188,21,13506,7193.698548,70.82785299999978,360.08433010104204,1525.5015565698475
"10.0.2.109",50470,"31.13.93.3",443,26,7607,12,5124,14,2483,7193.74553,70.78695799999969,579.0897244094058,280.61666387754775
"10.0.2.109",50471,"92.122.206.59",443,15,5335,8,1307,7,4028,7193.757129,20.948624999999993,499.1258376146408,1538.239383253078
"10.0.2.109",50472,"194.247.12.49",38925,61,48741,41,46124,20,2617,7210.14934,54.379265999999916,6785.527410392052,384.99967984121065
"10.0.2.109",50473,"23.62.237.16",443,58,48306,18,2267,40,46039,7210.328274,54.20000600000003,334.6125090834859,6795.423601982623
"10.0.2.109",50474,"194.247.12.49",38925,28,6702,13,2530,15,4172,7230.889057,33.667208999999275,601.1784344820634,991.3503670589599
"10.0.2.109",50475,"173.194.122.21",443,21,6081,11,3744,10,2337,7231.044814,33.51127400000041,893.7887589710743,557.9017974667203
"10.0.2.109",50476,"194.247.12.49",38925,22,7804,11,5194,11,2610,7242.879858,1.1247089999997115,36944.66746510489,18564.802095480125
"10.0.2.109",50477,"217.69.139.58",443,20,7455,9,2292,11,5163,7243.009351,0.9951080000000729,18426.140680206227,41507.052500831036
"10.0.2.109",50478,"194.247.12.49",38925,20,4163,9,1666,11,2497,7244.507366,19.992081999999755,666.6639322507863,999.1955815307402
"10.0.2.109",50479,"94.100.180.200",443,14,3612,8,2139,6,1473,7244.632401,19.866789000000608,861.3369780088507,593.1507099612141
"10.0.2.109",50480,"194.247.12.49",38925,19,10406,11,8802,8,1604,7258.78973,0.6158639999994193,114336.93153044567,20835.768936018503
"10.0.2.109",50481,"91.185.213.10",80,16,10200,7,1518,9,8682,7258.915875,0.05746799999997165,211317.60283994555,1208603.0486537598
"10.0.2.109",50482,"194.247.12.49",38925,12,2396,6,700,6,1696,7261.310232,0.48156100000051083,11628.848681670774,28175.039091590905
"10.0.2.109",50483,"91.185.213.10",80,12,2352,6,1664,6,688,7261.43981,0.1023590000004333,130052.07162969206,53771.52961612267
"10.0.2.109",50484,"194.247.12.49",38925,19,10666,11,9035,8,1631,7261.990364,1.1992350000000442,60271.75657814968,10880.26950514246
"10.0.2.109",50485,"91.185.213.10",80,16,10460,7,1545,9,8915,7262.11583,0.10986500000035448,112501.70663960424,649160.3331340271
"10.0.2.109",50486,"194.247.12.49",38925,12,2192,6,987,6,1205,7262.878007,1.6241199999994933,4861.70972588384,5935.522005764973
"10.0.2.109",50487,"194.247.12.49",38925,13,2196,7,764,6,1432,7262.938631,1.4861369999998715,4112.6760184293435,7708.57599265814
"10.0.2.109",50488,"91.185.202.180",80,8,1939,5,1126,3,813,7263.006531,1.4944400000003952,6027.675918737198,4352.131902249859
"10.0.2.109",50489,"91.185.213.10",80,10,1990,5,1346,5,644,7263.063974,1.0973250000006374,9812.95422959811,4695.053881026139
"10.0.2.109",50490,"194.247.12.49",38925,12,1443,6,596,6,847,7263.529917,0.9387980000001335,5078.834850520902,7217.740131528866
"10.0.2.109",50491,"5.10.88.211",80,8,1176,5,754,3,422,7263.659038,0.8086929999999484,7458.949193328476,4174.6373469292
"10.0.2.109",50492,"194.247.12.49",38925,13,2878,7,1548,6,1330,7264.617897,10.334665000000314,1198.2971871850345,1029.5447409277106
"10.0.2.109",50493,"194.247.12.49",38925,41,23649,24,21527,17,2122,7264.678774,5.549624999999651,31032.0066671191,3058.945424240569
"10.0.2.109",50494,"194.247.12.49",38925,34,22368,21,20405,13,1963,7264.742095,6.295099000000846,25931.284003631725,2494.6390835152697
"10.0.2.109",50495,"173.194.122.25",80,8,2563,5,1243,3,1320,7264.771064,10.181152000000111,976.7067616709672,1037.2107203585492
"10.0.2.109",50496,"104.31.93.48",80,37,23399,13,1884,24,21515,7265.598398,4.629743999999846,3255.4715768302744,37177.00157935422
"10.0.2.109",50497,"104.28.16.59",80,29,22060,11,1829,18,20231,7265.871799,5.165099000000737,2832.859544414911,31334.92697816187
"10.0.2.109",50498,"194.247.12.49",38925,17,2475,9,1332,8,1143,7267.512119,3.53493299999991,3014.484291498671,2586.7534122995353
"10.0.2.109",50499,"194.247.12.49",38925,19,7392,11,6506,8,886,7267.573091,7.3527759999997215,7078.687015625387,963.9896550636479
"10.0.2.109",50500,"104.31.92.48",80,11,2117,6,1013,5,1104,7267.642406,3.404120000000148,2380.6446306239636,2594.5031314993644
"10.0.2.109",50501,"194.247.12.49",38925,32,15687,16,10133,16,5554,7267.697122,5.31253900000047,15258.993863384876,8363.609189503562
"10.0.2.109",50502,"8.254.199.45",80,13,7029,6,751,7,6278,7267.698826,7.226704000000609,831.3610187990948,6949.7795952339775
"10.0.2.109",50503,"194.247.12.49",38925,13,1798,7,884,6,914,7267.757954,7.172223000000486,986.0262292457334,1019.4886578400456
"10.0.2.109",50504,"88.85.84.106",80,25,15275,12,5316,13,9959,7267.827966,5.181394000000182,8207.829784802798,15376.556965171381
"10.0.2.109",50505,"194.247.12.49",38925,12,2019,6,751,6,1268,7267.884566,7.048502000000553,852.3796971327423,1439.1710465570136
"10.0.2.109",50506,"88.85.84.114",80,8,1495,5,839,3,656,7267.886021,7.0437080000001515,952.9071903605112,745.0621178504116
"10.0.2.109",50507,"194.247.12.49",38925,12,1671,6,648,6,1023,7267.945103,0.4800889999996798,10797.997871235246,17046.83923190379
"10.0.2.109",50508,"62.161.94.220",80,10,1526,5,944,5,582,7268.094346,0.0756920000003447,99772.7633034615,61512.44517226122
"10.0.2.109",50509,"194.247.12.49",38925,12,1563,6,788,6,775,7269.007308,5.924090999999862,1064.1295010492154,1046.5740651182002
"10.0.2.109",50510,"173.194.113.105",80,8,1758,5,1181,3,577,7269.03364,5.898914000000332,1601.650744526784,782.5169175207064
"10.0.2.109",50511,"194.247.12.49",38925,12,1345,6,546,6,799,7269.269163,5.660012999999708,771.7296762392994,1129.326028049817
"10.0.2.109",50512,"62.152.53.250",80,8,1100,5,728,3,372,7269.395155,5.533762000000024,1052.448587416657,537.7896628008192
"10.0.2.109",50513,"194.247.12.49",38925,15,2420,8,1278,7,1142,7269.588104,2.0463679999993474,4996.168822031648,4464.495144569752
"10.0.2.109",50514,"194.247.12.49",38925,16,6902,9,6058,7,844,7269.650724,5.27464400000008,9188.108240100993,1280.08639066445
"10.0.2.109",50515,"104.28.17.59",80,9,2058,5,1008,4,1050,7269.713871,1.9202519999998913,4199.448822342305,4374.425856606568
"10.0.2.109",50516,"194.247.12.49",38925,12,3261,6,1647,6,1614,7269.748295,4.731258999999227,2784.8824171329775,2729.083315878947
"10.0.2.109",50517,"178.79.215.7",80,15,6805,7,813,8,5992,7269.795392,3.8959610000001703,1669.4212288058623,12304.024603941853
"10.0.2.109",50518,"194.247.12.49",38925,19,10126,11,8530,8,1596,7269.848246,2.7898740000000544,24459.886002019688,4576.55076895937
"10.0.2.109",50519,"173.194.122.13",80,8,2997,5,1524,3,1473,7269.900304,4.578747000000476,2662.7372073623487,2573.6298598718763
"10.0.2.109",50520,"194.247.12.49",38925,137,86189,77,76122,60,10067,7269.94788,5.00416099999984,121693.92631452494,16093.80673403645
"10.0.2.109",50521,"194.247.12.49",38925,14,1149,8,511,6,638,7270.048712,2.6842500000002474,1522.9579957156088,1901.4622333983532
"10.0.2.109",50522,"194.247.12.49",38925,21,10993,12,10041,9,952,7270.072649,4.857405000000654,16537.225123288914,1567.9153786844981
"10.0.2.109",50523,"31.13.93.3",443,112,84594,33,8395,79,76199,7270.077144,4.874743000000308,13777.136558787974,125051.10525825905
"10.0.2.109",50524,"194.247.12.49",38925,12,2083,6,1238,6,845,7270.333694,3.9324109999997745,2518.556681893263,1719.047169789828
"10.0.2.109",50525,"194.247.12.49",38925,17,5014,9,2565,8,2449,7270.430157,4.505872000000636,4554.057461019111,4348.103985199144
"10.0.2.109",50526,"88.85.84.114",80,8,1836,5,772,3,1064,7270.459218,3.806518000000324,1622.4801774218524,2236.1643896073197
"10.0.2.109",50527,"173.194.122.20",80,10,4601,6,2318,4,2283,7270.554135,4.381593999999495,4232.249724644076,4168.346040277147
"10.0.2.109",50528,"128.199.53.58",80,8,1312,5,698,3,614,7270.937905,3.993242999999893,1398.3621833182076,1230.0779091079935
"10.0.2.109",50529,"91.185.213.10",80,16,9920,7,1510,9,8410,7270.975728,0.07487399999990885,161337.71402642716,898576.2748094386
"10.0.2.109",50530,"178.79.215.59",80,18,10788,8,867,10,9921,7271.223778,3.7058560000004945,1871.6323570044476,21416.9142028156
"10.0.2.109",50531,"194.247.12.49",38925,10,1977,5,286,5,1691,7271.227619,0.8381679999993139,2729.7630069411775,16139.962394187172
"10.0.2.109",50532,"194.247.12.49",38925,14,2847,7,394,7,2453,7271.833501,1.1720569999997679,2689.2890021565713,16743.213000736214
"10.0.2.109",50533,"173.194.122.31",80,6,1727,4,1615,2,112,7272.024076,0.04141100000015285,311994.3976226681,21636.763178785655
"10.0.2.109",50534,"88.85.84.106",80,7,2435,5,2323,2,112,7272.656723,0.34854300000006333,53319.1026645109,2570.7014629467158
"10.0.2.109",50535,"194.247.12.49",38925,12,2165,6,987,6,1178,7273.350245,1.5826130000004923,4989.217199654965,5954.709079223454
"10.0.2.109",50536,"194.247.12.49",38925,13,2184,7,764,6,1420,7273.411091,1.503751000000193,4064.5027002470592,7554.44219155867
"10.0.2.109",50537,"91.185.202.180",80,8,1912,5,1099,3,813,7273.481234,1.451230000000578,6058.309158435602,4481.715510289485
"10.0.2.109",50538,"194.247.12.49",38925,83,69236,57,66218,26,3018,7273.503572,64.38857100000041,8227.298599311927,374.97337842766916
"10.0.2.109",50539,"91.185.213.10",80,10,1978,5,1334,5,644,7273.537796,1.0966379999999845,9731.561372121112,4697.995145161915
"10.0.2.109",50540,"194.247.12.49",38925,13,1466,7,650,6,816,7273.603642,1.4089130000002115,3690.788572466305,4633.359192511546
"10.0.2.109",50541,"195.113.232.91",443,86,69127,24,2670,62,66457,7273.680716,64.21140300000025,332.6511959254327,8279.775478508045
"10.0.2.109",50542,"194.247.12.49",38925,22,5305,10,2350,12,2955,7273.703283,66.80838800000038,281.40179044583283,353.84778330529196
"10.0.2.109",50543,"5.10.88.210",80,8,1145,5,723,3,422,7273.73215,1.280007000000296,4518.725288220035,2637.4855762501447
"10.0.2.109",50544,"31.13.93.3",443,21,5002,10,2629,11,2373,7274.351937,66.15971999999965,317.8973550674052,286.9419640832836
"10.0.2.109",50545,"194.247.12.49",38925,19,2160,9,776,10,1384,7274.496814,22.854773000000023,271.6281627474486,484.45022840524337
"10.0.2.109",50546,"194.247.12.49",38925,111,59878,57,47086,54,12792,7274.730998,92.70722500000011,4063.200036458858,1103.862185498486
"10.0.2.109",50547,"194.247.12.49",38925,341,298500,232,287121,109,11379,7274.792598,97.34181400000034,23596.930297600495,935.1787917163705
"10.0.2.109",50548,"194.247.12.49",38925,27,7224,14,5030,13,2194,7274.885065,64.27246099999957,626.084630554294,273.08741141871195
"10.0.2.109",50549,"2.20.182.56",443,105,59285,42,11906,63,47379,7274.906718,92.53153199999997,1029.3572141440393,4096.246888033802
"10.0.2.109",50550,"31.13.64.7",443,312,296671,80,9581,232,287090,7274.919804,97.21463099999983,788.4409909450784,23625.25040083734
"10.0.2.109",50551,"194.247.12.49",38925,19,2160,9,776,10,1384,7274.985883,12.342765999999756,502.96667699931464,897.0436610400147
"10.0.2.109",50552,"194.247.12.49",38925,19,2160,9,776,10,1384,7275.085561,22.265301000000363,278.81949586039275,497.27600808090665
"10.0.2.109",50553,"194.247.12.49",38925,162,147843,115,142662,47,5181,7275.185369,67.50357500000064,16907.193433829085,614.0119245536197
"10.0.2.109",50554,"194.247.12.49",38925,39,23536,24,21498,15,2038,7275.285906,3.6894380000003366,46615.22974501382,4419.101228967261
"10.0.2.109",50555,"194.247.12.49",38925,37,22505,23,20501,14,2004,7275.385896,7.2791150000002744,22531.310468373398,2202.4655469791855
"10.0.2.109",50556,"194.247.12.49",38925,31,15050,17,9901,14,5149,7275.432937,15.959189000000151,4963.159468817573,2581.0835375155725
"10.0.2.109",50557,"104.31.93.48",80,33,23178,12,1854,21,21324,7275.434255,3.540834999999788,4188.8424623008095,48178.466378696045
"10.0.2.109",50558,"104.28.17.59",80,32,22197,12,1870,20,20327,7275.511842,7.15275500000007,2091.5018059474783,22734.736475665446
"10.0.2.109",50559,"31.13.64.7",443,13,1581,8,1052,5,529,7275.626983,21.724427999999534,387.3980019174811,194.80374811249763
"10.0.2.109",50560,"23.62.237.22",443,24,6789,11,1844,13,4945,7275.661683,63.49581399999988,232.33027613442403,623.0331971175308
"10.0.2.109",50561,"194.247.12.49",38925,20,2196,10,830,10,1366,7275.757511,21.591019000000415,307.5352765888387,506.13637086789606
"10.0.2.109",50562,"31.13.64.7",443,12,1519,7,990,5,529,7275.768301,21.582218999999895,366.9687533056744,196.08734393808257
"10.0.2.109",50563,"194.247.12.49",38925,377,244361,202,172617,175,71744,7275.856562,148.1684350000005,9320.041748433096,3873.6455575035134
"10.0.2.109",50564,"194.247.12.49",38925,19,2142,9,776,10,1366,7275.957047,21.391897000000426,290.2033419476485,510.847635438773
"10.0.2.109",50565,"31.13.93.3",443,338,242010,121,68614,217,173396,7275.98116,148.04362200000014,3707.7720241132674,9369.995014037138
"10.0.2.109",50566,"194.247.12.49",38925,19,2142,9,776,10,1366,7276.056922,21.294354000000567,291.5326757505691,513.1876740660791
"10.0.2.109",50567,"31.13.64.7",443,12,1519,7,990,5,529,7276.111864,11.216577999999572,706.0977064484642,377.29867344569453
"10.0.2.109",50568,"194.247.12.49",38925,21,2250,11,884,10,1366,7276.156796,21.195098999999573,333.66204139929437,515.5908920265115
"10.0.2.109",50569,"194.247.12.49",38925,12,1632,6,648,6,984,7276.25733,2.158934999999474,2401.183917070807,3646.2422444408558
"10.0.2.109",50570,"23.62.237.17",443,154,147138,40,4561,114,142577,7276.345869,66.34293700000035,549.9907247096976,17192.7269364031
"10.0.2.109",50571,"194.247.12.49",38925,17,1974,8,640,9,1334,7276.357781,16.09810800000014,318.0497981501898,662.9350480193019
"10.0.2.109",50572,"194.247.12.49",38925,13,2041,7,805,6,1236,7276.457793,9.668110000000524,666.1074398201563,1022.7438454878423
"10.0.2.109",50573,"31.13.93.3",443,12,1519,7,990,5,529,7276.506062,20.84232399999928,379.9960119610593,203.0483740680812
"10.0.2.109",50574,"194.247.12.49",38925,13,1785,7,884,6,901,7276.55856,15.901022000000012,444.75128705563674,453.30419642209125
"10.0.2.109",50575,"88.85.84.106",80,24,14638,12,5019,12,9619,7276.559965,14.831891999999243,2707.139453280947,5188.2794184318445
"10.0.2.109",50576,"194.247.12.49",38925,13,1387,7,600,6,787,7276.658224,9.237181000000419,519.6390543824768,681.5932263316822
"10.0.2.109",50577,"31.13.93.3",443,12,1519,7,990,5,529,7276.70591,20.642746000000443,383.6698857797228,205.01148442169028
"10.0.2.109",50578,"194.247.12.49",38925,12,1550,6,788,6,762,7276.758162,9.157492000000275,688.3980897826403,665.6844472263604
"10.0.2.109",50579,"194.247.12.49",38925,21,2250,11,884,10,1366,7276.858542,20.490877000000182,345.1292006681772,533.310506914853
"10.0.2.109",50580,"31.13.93.3",443,12,1519,7,990,5,529,7276.983361,20.365861000000223,388.88608735962174,207.7987274881211
"10.0.2.109",50581,"173.194.113.105",80,8,1726,5,1149,3,577,7277.206071,8.919541000000208,1030.546302774973,517.5154192351257
"10.0.2.109",50582,"88.85.84.114",80,8,1482,5,826,3,656,7277.284396,15.174753000000237,435.4601356608504,345.8375895805301
"10.0.2.109",50583,"62.152.53.250",80,8,1088,5,716,3,372,7277.363408,8.531678000000284,671.3802372756929,348.8176651767567
"10.0.2.109",50584,"128.199.53.58",80,8,1299,5,685,3,614,7277.467631,8.44776599999932,648.6922104613742,581.4554995960348
"10.0.2.109",50585,"31.13.93.3",443,12,1519,7,990,5,529,7277.860675,19.491044999999758,406.34045019136215,217.12535166790968
"10.0.2.109",50586,"62.161.94.220",80,10,1487,5,905,5,582,7277.995295,0.07518800000070769,96291.96148230908,61924.77522950705
"10.0.2.109",50587,"31.13.93.3",443,13,1581,8,1052,5,529,7278.073975,19.27712199999951,436.5796927570524,219.53484550235808
"10.0.2.109",50588,"194.247.12.49",38925,22,11806,13,10867,9,939,7278.147544,4.55800199999976,19073.269384261916,1648.090544936223
"10.0.2.109",50589,"194.247.12.49",38925,13,2124,7,1292,6,832,7278.786667,3.9083999999993466,2644.560433937603,1702.998669532574
"10.0.2.109",50590,"8.254.199.45",80,17,11497,7,804,10,10693,7278.866212,3.8389079999997193,1675.4764636194643,22283.42018094892
"10.0.2.109",50591,"194.247.12.49",38925,13,1095,7,457,6,638,7279.167887,2.760250000000269,1324.5177067293337,1849.1078706637088
"10.0.2.109",50592,"195.113.232.73",443,10,1325,6,932,4,393,7279.322533,13.133013000000574,567.7295834550438,239.39670203630064
"10.0.2.109",50593,"88.85.84.123",80,8,1823,5,759,3,1064,7280.444009,2.2505360000004657,2698.02393740813,3782.2101046142957
"10.0.2.109",50594,"194.247.12.49",38925,21,5629,10,4221,11,1408,7282.866465,9.610321000000113,3513.7223824261027,1172.0732325174017
"10.0.2.109",50595,"194.247.12.49",38925,22,5976,11,4275,11,1701,7282.927668,24.421480999999403,1400.406470025337,557.2143638627131
"10.0.2.109",50596,"194.247.12.49",38925,223,207740,158,193509,65,14231,7283.027068,71.294081,21713.89234963278,1596.8787086265968
"10.0.2.109",50597,"194.247.12.49",38925,17,1966,8,640,9,1326,7283.1269,9.330806999999368,548.7199553050821,1136.8791573977169
"10.0.2.109",50598,"195.113.232.75",443,220,207315,54,13405,166,193910,7283.200378,71.12063100000069,1507.8606375131706,21811.954958610884
"10.0.2.109",50599,"194.247.12.49",38925,21,5629,10,4221,11,1408,7283.227666,9.24121600000035,3654.0645733200827,1218.8872113799282
"10.0.2.109",50600,"194.247.12.49",38925,21,5922,10,4221,11,1701,7283.327593,9.130919000000176,3698.203871921254,1490.3209633115503
"10.0.2.109",50601,"195.113.232.90",443,15,5042,8,1014,7,4028,7283.407232,9.0614570000007,895.2202719716457,3556.161001481054
"10.0.2.109",50602,"195.113.232.90",443,15,5335,8,1307,7,4028,7283.495667,8.962561999999707,1166.6307022478998,3595.400511594905
"10.0.2.109",50603,"194.247.12.49",38925,17,3528,9,823,8,2705,7283.508558,7.747329999999238,849.841171087413,2793.220373987184
"10.0.2.109",50604,"194.247.12.49",38925,16,3471,8,761,8,2710,7283.770012,7.494786999999633,812.2979345510818,2892.6772702147587
"10.0.2.109",50605,"195.113.232.90",443,15,5042,8,1014,7,4028,7284.012837,8.463768999999957,958.4382560535432,3807.287273553917
"10.0.2.109",50606,"195.113.232.75",443,15,5335,8,1307,7,4028,7284.07815,23.270680999999968,449.320756878581,1384.7467549402634
"10.0.2.109",50607,"195.113.232.90",443,10,1325,6,932,4,393,7284.255606,8.201773000000685,909.0717336360538,383.33175034224155
"10.0.2.109",50608,"8.21.198.202",80,11,3167,6,2580,5,587,7284.362115,0.6712330000000293,30749.382107255005,6996.080347658407
"10.0.2.109",50609,"194.247.12.49",38925,12,2306,6,681,6,1625,7286.052525,6.409120000000257,850.0386948597907,2028.359587587606
"10.0.2.109",50610,"194.247.12.49",38925,68,24586,28,8052,40,16534,7286.113949,137.9128380000002,467.07761898134464,959.0985285938341
"10.0.2.109",50611,"194.247.12.49",38925,19,2222,9,748,10,1474,7286.37502,20.972099999999955,285.33146418336804,562.27082647899
"10.0.2.109",50612,"194.247.12.49",38925,21,9225,12,6839,9,2386,7286.472042,4.913256999999248,11135.586841886832,3884.999298836377
"10.0.2.109",50613,"216.58.211.42",443,12,1583,7,1082,5,501,7286.529999,20.816850999999588,415.8169744309632,192.53632549899498
"10.0.2.109",50614,"8.37.70.6",80,11,3162,6,2575,5,587,7286.714923,0.526002999999946,39163.274734178536,8927.705735519534
"10.0.2.109",50615,"173.194.122.7",80,8,2049,5,1542,3,507,7287.663018,4.798114000000169,2571.010192754813,845.3321450886447
"10.0.2.109",50616,"88.85.84.106",80,14,8813,7,2256,7,6557,7288.127892,3.2571519999992233,5541.03707779198,16104.867074061176
"10.0.2.109",50617,"216.58.211.42",443,60,23893,29,15710,31,8183,7288.608252,135.4183149999999,928.0871645759298,483.42057719445154
"10.0.2.109",50618,"194.247.12.49",38925,26,17971,16,16283,10,1688,7290.808563,0.8084660000004078,161124.89579021788,16703.237984025534
"10.0.2.109",50619,"91.185.213.10",80,25,17873,9,1602,16,16271,7290.939374,0.10225200000058976,125337.401712691,1273011.7748234677
"10.0.2.109",50620,"194.247.12.49",38925,7,1229,4,232,3,997,7291.527817,0.1217930000002525,15238.971040997038,65488.164344284676
"10.0.2.109",50621,"194.247.12.49",38925,12,1410,6,596,6,814,7291.588552,0.872309999999743,5465.946739119584,7465.235982623057
"10.0.2.109",50622,"194.247.12.49",38925,12,2127,6,710,6,1417,7291.679602,0.4764690000001792,11921.027391074475,23791.684243876804
"10.0.2.109",50623,"5.10.88.211",80,8,1143,5,721,3,422,7291.71905,0.7414040000003297,7779.833936689625,4553.522775704608
"10.0.2.109",50624,"194.247.12.49",38925,13,3411,7,1995,6,1416,7291.779593,0.6253129999995508,25523.217972457736,18115.7276436091
"10.0.2.109",50625,"91.185.213.10",80,10,1975,5,1331,5,644,7291.811111,0.0922389999996085,115439.2393677858,55854.8986873434
"10.0.2.109",50626,"91.185.213.10",80,11,3259,5,1330,6,1929,7291.909116,0.053840999999920314,197618.91495358085,286621.71950786276
"10.0.2.109",50627,"194.247.12.49",38925,38,23650,23,21615,15,2035,7292.656792,2.3387800000000425,73935.98371800547,6960.894141389829
"10.0.2.109",50628,"194.247.12.49",38925,12,1866,6,599,6,1267,7292.717574,1.8739269999996395,2557.196731783534,5408.962035341799
"10.0.2.109",50629,"104.31.92.48",80,32,23292,11,1797,21,21495,7292.782326,2.2129940000004353,6496.176672868147,77704.68424223752
"10.0.2.109",50630,"194.247.12.49",38925,36,22636,21,20581,15,2055,7292.81078,4.334995000000163,37981.12800591323,3792.3919174069133
"10.0.2.109",50631,"88.85.84.106",80,8,1616,5,1191,3,425,7292.842549,1.7485630000001038,5449.045873668512,1944.4538172200819
"10.0.2.109",50632,"194.247.12.49",38925,13,1782,7,884,6,898,7292.911474,131.078305,53.95248283077814,54.80693391633345
"10.0.2.109",50633,"194.247.12.49",38925,13,2033,7,805,6,1228,7293.011493,130.97969699999976,49.16792562132749,75.00399088570207
"10.0.2.109",50634,"194.247.12.49",38925,13,1685,7,702,6,983,7293.111542,2.075340000000324,2706.062621064078,3789.2586275014082
"10.0.2.109",50635,"194.247.12.49",38925,12,1330,6,547,6,783,7293.211365,1.3803680000000895,3170.1691143229314,4537.920322696262
"10.0.2.109",50636,"194.247.12.49",38925,13,1601,7,842,6,759,7293.311813,2.803643999999622,2402.5874897101444,2165.7528559263656
"10.0.2.109",50637,"62.152.53.218",80,8,1085,5,712,3,373,7293.336135,1.2550710000004983,4538.388664862577,2377.5547359462653
"10.0.2.109",50638,"128.199.53.58",80,8,1296,5,682,3,614,7293.437386,2.677733000000444,2037.5444452449499,1834.3875210856293
"10.0.2.109",50639,"173.194.113.105",80,8,1718,5,1141,3,577,7293.567178,130.42275100000006,69.98778917031122,35.39259802915826
"10.0.2.109",50640,"194.247.12.49",38925,22,5986,11,4275,11,1711,7293.876761,13.469701999999415,2539.0316727126915,1016.2065946225532
"10.0.2.109",50641,"104.28.16.59",80,32,22382,12,1867,20,20515,7293.961355,3.1841059999997015,4690.798610348211,51543.51017209081
"10.0.2.109",50642,"194.247.12.49",38925,41,12599,22,9713,19,2886,7294.101097,100.60524700000042,772.3652822998355,229.49101253138323
"10.0.2.109",50643,"194.247.12.49",38925,27,7947,14,5696,13,2251,7294.161559,63.41380500000014,718.5817031480748,283.97602067877745
"10.0.2.109",50644,"194.247.12.49",38925,257,231535,180,224615,77,6920,7294.25283,68.43906799999968,26255.7637400908,808.8947090863403
"10.0.2.109",50645,"88.85.84.114",80,11,1641,6,877,5,764,7294.398189,65.72794700000031,106.74302667630812,92.98936417411564
"10.0.2.109",50646,"23.62.237.9",443,15,5335,8,1307,7,4028,7294.39917,12.946907999999894,807.6059550280333,2488.9340373779023
"10.0.2.109",50647,"62.161.94.220",80,10,1486,5,904,5,582,7294.619436,0.31450000000040745,22995.230524612496,14804.451510314684
"10.0.2.109",50648,"23.62.237.8",443,34,11948,13,2320,21,9628,7294.632432,100.07395799999995,185.4628353961978,769.6707668942207
"10.0.2.109",50649,"23.62.237.15",443,238,230236,53,5382,185,224854,7294.791442,67.90048900000056,634.104417127241,26492.18034350217
"10.0.2.109",50650,"194.247.12.49",38925,22,11284,13,10344,9,940,7294.791603,11.300584999999955,7322.806739651118,665.4522752583189
"10.0.2.109",50651,"194.247.12.49",38925,20,10300,12,9414,8,886,7294.852718,11.236742999999478,6702.2979879493105,630.7877647464509
"10.0.2.109",50652,"8.254.199.45",80,16,10045,7,805,9,9240,7294.97867,11.109772999999223,579.669809635215,6653.601293204206
"10.0.2.109",50653,"194.247.12.49",38925,13,1095,7,457,6,638,7295.187636,3.073955000000751,1189.347274114002,1660.4016649556524
"10.0.2.109",50654,"8.254.199.45",80,16,10921,7,805,9,10116,7295.284846,10.806794000000082,595.9214175823053,7488.62243510882
"10.0.2.109",50655,"194.247.12.49",38925,12,2067,6,1238,6,829,7295.68938,10.40198700000019,952.1257813531029,637.5704949448484
"10.0.2.109",50656,"194.247.12.49",38925,20,9259,11,8307,9,952,7296.327133,9.760965000000397,6808.34323245676,780.2507231610492
"10.0.2.109",50657,"23.62.237.22",443,25,7566,11,1901,14,5665,7296.349854,61.225532999999814,248.39310096328677,740.2140541594001
"10.0.2.109",50658,"178.79.215.17",80,19,9162,8,867,11,8295,7296.473678,3.223855999999614,2151.460859294221,20584.045937538136
"10.0.2.109",50659,"88.85.84.114",80,8,1820,5,756,3,1064,7296.832646,9.256154000000606,653.4031305010271,919.6044058903344
"10.0.2.109",50660,"194.247.12.49",38925,28,14051,15,9676,13,4375,7297.349692,126.64267999999993,611.2315374248243,276.3681248691201
"10.0.2.109",50661,"194.247.12.49",38925,12,2303,6,681,6,1622,7297.659307,126.3325190000005,43.12428852938473,102.71306313459917
"10.0.2.109",50662,"173.194.122.7",80,8,2046,5,1539,3,507,7297.785596,126.2044390000001,97.5559980104978,32.13833072860454
"10.0.2.109",50663,"88.85.84.106",80,25,13855,12,4299,13,9556,7298.476912,66.80610100000013,514.803281215288,1144.3266237016264
"10.0.2.109",50664,"194.247.12.49",38925,16,3466,8,761,8,2705,7300.153071,122.86336699999993,49.55097803888122,176.13061182020198
"10.0.2.109",50665,"194.247.12.49",38925,16,3472,8,761,8,2711,7300.213577,122.81399599999986,49.570897440711946,176.5922509353089
"10.0.2.109",50666,"194.247.12.49",38925,23,11270,12,7496,11,3774,7300.312199,123.68055699999968,484.86198198476865,244.11274279756097
"10.0.2.109",50667,"8.37.70.22",80,11,3168,6,2581,5,587,7300.405278,1.54655399999956,13350.972549297261,3036.428084632891
"10.0.2.109",50668,"8.37.70.21",80,11,3162,6,2575,5,587,7300.715425,1.5263269999995828,13496.452595024284,3076.6670575841767
"10.0.2.109",50669,"88.85.84.106",80,21,11128,10,3698,11,7430,7301.443905,79.12415099999998,373.8934273051474,751.2244902318132
"10.0.2.109",50670,"194.247.12.49",38925,20,7696,10,5140,10,2556,7303.846184,2.2447849999998652,18318.012638182485,9109.112899454169
"10.0.2.109",50671,"94.100.180.59",443,18,7347,8,2238,10,5109,7303.975561,2.115213999999469,8464.39178258299,19322.86756801452
"10.0.2.109",50672,"194.247.12.49",38925,180,182478,135,178365,45,4113,7304.070883,66.86155299999973,21341.41275480104,492.12138401870703
"10.0.2.109",50673,"23.62.237.8",443,184,182421,39,3547,145,178874,7304.243435,66.68901199999982,425.4973817875736,21457.687812199165
"10.0.2.109",50674,"194.247.12.49",38925,160,156398,119,152741,41,3657,7305.647294,48.037882999999965,25436.757902091584,609.0193441705169
"10.0.2.109",50675,"23.62.237.17",443,163,156287,37,3199,126,153088,7305.818348,47.86681099999987,534.6501984433446,25585.66101259604
"10.0.2.109",50676,"194.247.12.49",38925,22,5703,11,4283,11,1420,7306.327411,21.017628999999943,1630.250491147222,540.4986452087451
"10.0.2.109",50677,"194.247.12.49",38925,21,5641,10,4221,11,1420,7306.388662,20.958439999999428,1611.188619000313,542.0250743853221
"10.0.2.109",50678,"194.247.12.49",38925,21,5641,10,4221,11,1420,7306.480608,20.866935000000012,1618.2539505682066,544.4019449909626
"10.0.2.109",50679,"194.247.12.49",38925,17,1976,8,640,9,1336,7306.581259,20.76441800000066,246.5756564908218,514.7266829245905
"10.0.2.109",50680,"194.247.12.49",38925,47,27733,28,25010,19,2723,7306.681176,87.27881199999956,2292.423503656317,249.5909316455878
"10.0.2.109",50681,"23.62.237.24",443,10,1325,6,932,4,393,7306.755737,20.589703999999983,362.12273862703444,152.6976784124727
"10.0.2.109",50682,"92.122.212.74",443,15,5046,8,1018,7,4028,7306.858922,20.487952999999834,397.5018880607578,1572.8267240753755
"10.0.2.109",50683,"92.122.212.161",443,15,5046,8,1018,7,4028,7307.531983,19.815319000000272,410.9951497626603,1626.2165650726872
"10.0.2.109",50684,"195.113.232.72",443,45,27366,16,2333,29,25033,7307.851856,86.10802400000011,216.75099639959194,2325.7298297775333
"10.0.2.109",50685,"92.122.212.72",443,15,5046,8,1018,7,4028,7313.507178,13.837626999999884,588.5402171918688,2328.722981187473
"10.0.2.109",50686,"194.247.12.49",38925,12,2754,6,1267,6,1487,7319.607245,0.44713400000000547,22668.8196379606,26604.999843447054
"10.0.2.109",50687,"194.247.12.49",38925,12,2759,6,1272,6,1487,7319.668655,0.4711639999995896,21597.575366557852,25248.108938735477
"10.0.2.109",50688,"91.185.213.10",80,10,2602,5,1401,5,1201,7319.735976,0.06565099999988888,170720.93342095276,146349.6367156062
"10.0.2.109",50689,"91.185.213.10",80,10,2607,5,1401,5,1206,7319.798277,0.06774399999994785,165446.38639597053,142418.5167691224
"10.0.2.109",50690,"194.247.12.49",38925,19,3418,9,983,10,2435,7327.807599,5.912022000000434,1330.170963504436,3294.980972668669
"10.0.2.109",50691,"194.247.12.49",38925,24,6023,11,4340,13,1683,7327.868111,96.12223799999992,361.20673761258064,140.07164502349613
"10.0.2.109",50692,"193.0.170.53",443,18,3119,9,2167,9,952,7327.942608,5.776901999999609,3000.9164081372983,1318.353678147996
"10.0.2.109",50693,"217.20.147.94",443,19,5530,10,1329,9,4201,7327.992046,95.99809199999982,110.75220119999906,350.09029137787513
"10.0.2.109",50694,"194.247.12.49",38925,19,3468,9,1563,10,1905,7334.19783,60.63940999999977,206.20253396264982,251.32170646119508
"10.0.2.109",50695,"195.113.232.88",443,17,3101,8,1569,9,1532,7334.358863,60.47841299999982,207.5451285403279,202.6508202191092
"10.0.2.109",50696,"194.247.12.49",38925,27,6328,12,2215,15,4113,7352.84622,71.17854999999963,248.95140460152803,462.2740980253204
"10.0.2.109",50697,"173.194.122.21",443,21,5761,12,3739,9,2022,7352.978904,71.04561900000044,421.0252570253461,227.68469368955598
"10.0.2.109",50698,"194.247.12.49",38925,21,7750,10,5140,11,2610,7363.827898,1.1330140000000029,36292.57890899839,18428.721975191787
"10.0.2.109",50699,"94.100.180.59",443,20,7455,9,2292,11,5163,7363.956605,1.0042759999996633,18257.929095195093,41128.13609009261
"10.0.2.109",50700,"194.247.12.49",38925,12,2302,6,811,6,1491,7388.006276,0.450380999999652,14405.581052497804,26484.243340658726
"10.0.2.109",50701,"91.185.213.10",80,10,2150,5,1405,5,745,7388.139759,0.06725200000073528,167132.5759810431,88621.89971948549
"10.0.2.109",50702,"194.247.12.49",38925,12,2400,6,909,6,1491,7389.686335,0.4490669999995589,16193.57467818197,26561.7380034866
"10.0.2.109",50703,"91.185.213.10",80,10,2248,5,1405,5,843,7389.817261,0.07450299999982235,150866.40806446454,90519.84483867872
"10.0.2.109",50704,"194.247.12.49",38925,12,2357,6,868,6,1489,7391.627256,0.4979540000003908,13945.063198597762,23921.888367179803
"10.0.2.109",50705,"91.185.213.10",80,10,2205,5,1403,5,802,7391.752036,0.08659700000043813,129611.8803185239,74090.32645435221
"10.0.2.109",50706,"194.247.12.49",38925,12,2451,6,960,6,1491,7393.229143,0.4590200000002369,16731.29711122835,25985.79582587653
"10.0.2.109",50707,"91.185.213.10",80,10,2299,5,1405,5,894,7393.358931,0.07599000000027445,147914.19923620747,94117.6470584836
"10.0.2.109",50708,"194.247.12.49",38925,26,4092,11,1176,15,2916,7399.625217,24.401990000000296,385.5423266708939,955.9876059288491
"10.0.2.109",50709,"173.194.122.9",443,20,3515,10,2424,10,1091,7399.785522,24.24150499999996,799.9503331166951,360.0436524052452
"10.0.2.109",50710,"194.247.12.49",38925,23,15428,14,13785,9,1643,7402.829186,0.8272450000004028,133309.9625865932,15888.88418786889
"10.0.2.109",50711,"91.185.213.10",80,21,15276,8,1557,13,13719,7402.960779,0.05429100000037579,229430.2923120551,2021550.5332235605
"10.0.2.109",50712,"194.247.12.49",38925,144,88917,47,2928,97,85989,7410.847987,6.630398000000241,3532.8195984613817,103751.23785932231
"10.0.2.109",50713,"91.185.213.10",80,114,87253,63,84121,51,3132,7410.977563,6.25637099999949,107565.23230480656,4004.8775879822415
"10.0.2.109",50714,"194.247.12.49",38925,12,2764,6,1057,6,1707,7417.748004,0.490020999999615,17256.403297015113,27868.19340397805
"10.0.2.109",50715,"91.185.213.10",80,12,2720,6,1675,6,1045,7417.88321,0.08676399999967543,154441.9344434342,96353.3262647097
"10.0.2.109",50716,"194.247.12.49",38925,13,4219,7,2704,6,1515,7418.416681,0.6182589999998527,34988.57275026349,19603.4348064531
"10.0.2.109",50717,"91.185.213.10",80,11,4067,5,1429,6,2638,7418.563547,0.053504000000430096,213666.26794086615,394437.79903989146
"10.0.2.109",50718,"194.247.12.49",38925,20,6384,9,859,11,5525,7421.609062,0.7272179999999935,9449.711090759665,60779.57366291868
"10.0.2.109",50719,"91.185.213.10",80,18,6232,9,5385,9,847,7421.739251,0.33166700000037963,129889.3166940054,20430.13022095127
"10.0.2.109",50720,"194.247.12.49",38925,21,11313,12,9643,9,1670,7422.543892,1.0498620000007577,73480.13357940789,12725.482015722408
"10.0.2.109",50721,"91.185.213.10",80,17,11053,7,1530,10,9523,7422.668113,0.09147000000029948,133814.36536525557,832885.0989368161
"10.0.2.109",50722,"194.247.12.49",38925,12,2173,6,987,6,1186,7423.399677,0.5911980000000767,13355.931515328157,16048.768771204857
"10.0.2.109",50723,"194.247.12.49",38925,12,2140,6,710,6,1430,7423.460551,0.46672099999977945,12170.011634365464,24511.431883299458
"10.0.2.109",50724,"91.185.202.180",80,8,1920,5,1107,3,813,7423.544559,0.4450150000002395,19900.452793715343,14615.237688609372
"10.0.2.109",50725,"91.185.213.10",80,10,1988,5,1344,5,644,7423.593967,0.09029700000064622,119073.72337866211,57056.15911894226
"10.0.2.109",50726,"194.247.12.49",38925,20,7696,10,5140,10,2556,7423.806266,1.0330740000008518,39803.53779106443,19793.354590264724
"10.0.2.109",50727,"94.100.180.59",443,18,7347,8,2238,10,5109,7423.931688,0.9075330000005124,19728.208230433374,45036.37884239683
"10.0.2.109",50728,"194.247.12.49",38925,12,1436,6,596,6,840,7424.027504,10.20972299999994,467.0058139677274,658.1961136457903
"10.0.2.109",50729,"194.247.12.49",38925,40,23621,23,21465,17,2156,7424.289157,9.945810999999594,17265.56034495397,1734.1974425213493
"10.0.2.109",50730,"194.247.12.49",38925,46,23001,26,20663,20,2338,7424.380009,8.165115999999216,20245.150221995114,2290.7206707169616
"10.0.2.109",50731,"194.247.12.49",38925,21,4366,11,2080,10,2286,7424.416402,73.66751900000054,225.8797394819266,248.2505213729251
"10.0.2.109",50732,"104.31.92.48",80,32,23155,11,1810,21,21345,7424.453203,9.78128099999958,1480.378694774296,17457.836044175332
"10.0.2.109",50733,"194.247.12.49",38925,35,18462,19,13243,16,5219,7424.476863,18.099968999999874,5853.2696934453725,2306.7442822692287
"10.0.2.109",50734,"104.28.16.59",80,38,22531,13,1934,25,20597,7424.828734,7.715978000000177,2005.1897504113729,21355.16716092195
"10.0.2.109",50735,"88.85.84.114",80,16,4063,9,2211,7,1852,7424.85723,73.22621100000015,241.552850522335,202.33192183055831
"10.0.2.109",50736,"5.10.88.210",80,8,1169,5,747,3,422,7425.156129,9.080770000000484,658.0939722071676,371.774640256258
"10.0.2.109",50737,"88.85.84.106",80,27,17996,12,4981,15,13015,7425.623494,16.952642999999625,2350.5479352099187,6141.815173008852
"10.0.2.109",50738,"194.247.12.49",38925,16,2452,8,1275,8,1177,7425.76701,8.478332000000592,1203.066829654617,1110.595810590968
"10.0.2.109",50739,"194.247.12.49",38925,18,8349,10,7464,8,885,7425.829082,16.705511999999544,3574.389099837325,423.8122124003259
"10.0.2.109",50740,"104.31.92.48",80,12,2202,6,1047,6,1155,7425.895853,8.349140000000261,1003.2170978088448,1106.7008099037398
"10.0.2.109",50741,"8.254.199.45",80,16,8202,7,804,9,7398,7425.976637,15.377693999999792,418.2681746691075,3848.6914878135044
"10.0.2.109",50742,"194.247.12.49",38925,15,2418,8,1279,7,1139,7426.371627,7.223628999999164,1416.4625564243656,1261.4158340636063
"10.0.2.109",50743,"194.247.12.49",38925,21,10642,12,9690,9,952,7426.432775,16.12188999999944,4808.36924206794,472.4011886943941
"10.0.2.109",50744,"194.247.12.49",38925,18,7835,10,6937,8,898,7426.523372,16.029481000000487,3462.1208259954465,448.17421100532084
"10.0.2.109",50745,"194.247.12.49",38925,21,10805,12,9853,9,952,7426.623278,15.929188000000067,4948.40038299502,478.116021984295
"10.0.2.109",50746,"178.79.215.7",80,16,7684,7,813,9,6871,7426.676278,4.011421000000155,1621.3705816466904,13702.87486653679
"10.0.2.109",50747,"194.247.12.49",38925,13,1095,7,457,6,638,7426.724466,3.7399930000001405,977.5419365757804,1364.7084366200172
"10.0.2.109",50748,"178.79.215.59",80,19,10654,8,867,11,9787,7426.769144,3.913346000000274,1772.3963074053545,20007.43098105675
"10.0.2.109",50749,"194.247.12.49",38925,19,5034,9,1737,10,3297,7426.823926,71.27754699999969,194.9562040904699,370.0464046553133
"10.0.2.109",50750,"104.28.16.59",80,9,2056,5,1005,4,1051,7426.826677,6.76826600000004,1187.8965749868507,1242.267960508637
"10.0.2.109",50751,"194.247.12.49",38925,12,1688,6,648,6,1040,7426.923986,0.5013880000005884,10339.298108438807,16593.93523576599
"10.0.2.109",50752,"194.247.12.49",38925,20,10461,12,8856,8,1605,7427.023685,1.0934019999995144,64795.9304995157,11743.164910989464
"10.0.2.109",50753,"62.161.94.220",80,10,1543,5,961,5,582,7427.074595,0.08615199999985634,89237.6265207171,54044.01522898788
"10.0.2.109",50754,"194.247.12.49",38925,13,1396,7,600,6,796,7427.153271,15.42185900000004,311.24652352222824,412.9203878728228
"10.0.2.109",50755,"91.185.213.10",80,16,10201,7,1519,9,8682,7427.154544,0.29591700000037235,41065.5690615433,234714.46385274452
"10.0.2.109",50756,"194.247.12.49",38925,12,1560,6,788,6,772,7427.213182,15.364121999999952,410.30655705545814,401.97545945027116
"10.0.2.109",50757,"178.79.215.17",80,19,10491,8,867,11,9624,7427.560192,3.1361589999996795,2211.6225612287863,24549.77569696175
"10.0.2.109",50758,"194.247.12.49",38925,12,2080,6,1238,6,842,7427.567495,6.67641999999978,1483.429742287083,1008.923944269567
"10.0.2.109",50759,"62.152.53.250",80,11,1259,6,779,5,480,7427.591632,10.360152000000198,601.5355759259015,370.6509325345735
"10.0.2.109",50760,"88.85.84.114",80,8,1833,5,769,3,1064,7427.696948,6.546621999999843,939.7212791574261,1300.2125370916795
"10.0.2.109",50761,"173.194.113.101",80,16,4827,9,3210,7,1617,7427.98062,70.12031200000001,366.2276916280691,184.48292129675633
"10.0.2.109",50762,"128.199.53.58",80,8,1309,5,695,3,614,7428.355197,14.221133000000009,390.96744260812386,345.40145289408355
"10.0.2.109",50763,"194.247.12.49",38925,23,11096,12,7474,11,3622,7429.147381,13.425441000000319,4453.633962563955,2158.290368264202
"10.0.2.109",50764,"88.85.84.106",80,18,10792,9,3492,9,7300,7429.276015,13.296528999999282,2100.9994412828723,4392.123688821583
"10.0.2.109",50765,"194.247.12.49",38925,15,3421,8,1980,7,1441,7431.832064,10.745044999999664,1474.1678606278983,1072.8666096791926
"10.0.2.109",50766,"194.247.12.49",38925,16,3481,8,761,8,2720,7431.935191,9.650387000000592,630.8555294206985,2254.8318528571617
"10.0.2.109",50767,"194.247.12.49",38925,16,3489,8,761,8,2728,7431.996922,9.597091999999975,634.3588245272647,2274.022172549774
"10.0.2.109",50768,"88.85.84.114",80,11,3155,6,1349,5,1806,7432.001808,10.574427000000469,1020.5753938250764,1366.3151677154099
"10.0.2.109",50769,"8.37.70.7",80,11,3177,6,2590,5,587,7432.148097,0.5275179999998727,39278.280551573596,8902.065901070928
"10.0.2.109",50770,"8.37.70.7",80,11,3185,6,2598,5,587,7432.201803,0.5608970000002955,37054.93165409879,8372.30364932871
"10.0.2.109",50771,"194.247.12.49",38925,13,2221,7,1363,6,858,7432.726305,9.959090000000288,1094.8791506050939,689.2195973728325
"10.0.2.109",50772,"54.219.142.13",80,8,1911,5,776,3,1135,7432.873649,9.811499999999796,632.7269021046862,925.4446313000243
"10.0.2.109",50773,"194.247.12.49",38925,16,6652,9,5668,7,984,7433.78638,0.5477340000006734,82784.70936612344,14371.939664125875
"10.0.2.109",50774,"50.7.163.230",80,13,6441,6,893,7,5548,7433.916232,0.054887000000235275,130158.32528593979,808643.2124147748
"10.0.2.109",50775,"194.247.12.49",38925,12,2403,6,700,6,1703,7440.373853,0.47988900000018475,11669.365207366378,28389.898497349917
"10.0.2.109",50776,"91.185.213.10",80,12,2359,6,1671,6,688,7440.500163,0.09747300000071846,137145.6711079116,56466.91904383194
"10.0.2.109",50777,"194.247.12.49",38925,21,10783,12,9089,9,1694,7441.12895,0.6586859999997614,110389.47237382659,20574.2948840645
"10.0.2.109",50778,"91.185.213.10",80,16,10469,7,1554,9,8915,7441.25577,0.07811099999980797,159158.12113569872,913059.6202861995
"10.0.2.109",50779,"194.247.12.49",38925,12,2192,6,987,6,1205,7441.965713,0.6121620000003531,12898.546463183675,15747.465540158388
"10.0.2.109",50780,"194.247.12.49",38925,12,2152,6,710,6,1442,7442.027115,0.47863800000050105,11867.00596274022,24101.721969396338
"10.0.2.109",50781,"91.185.202.180",80,8,1939,5,1126,3,813,7442.094056,0.4835620000003473,18628.428205676893,13450.188393619284
"10.0.2.109",50782,"91.185.213.10",80,10,2000,5,1356,5,644,7442.151077,0.10195499999917956,106399.88230187136,50532.09749439908
"10.0.2.109",50783,"194.247.12.49",38925,12,1442,6,596,6,846,7442.607547,4.3494610000007015,1096.2277854656545,1556.0548766844693
"10.0.2.109",50784,"194.247.12.49",38925,13,2878,7,1548,6,1330,7442.696153,55.38767000000007,223.58766851900404,192.10051623402802
"10.0.2.109",50785,"194.247.12.49",38925,36,23554,22,21557,14,1997,7442.758018,4.196621999999479,41094.00370107706,3806.871336041698
"10.0.2.109",50786,"173.194.122.26",80,8,2563,5,1243,3,1320,7442.854397,55.22889099999975,180.05069122246263,191.20427386456208
"10.0.2.109",50787,"194.247.12.49",38925,38,22751,22,20626,16,2125,7442.856668,4.100748999999269,40238.502771086314,4145.584135971997
"10.0.2.109",50788,"104.31.93.48",80,31,23250,11,1813,20,21437,7443.189355,3.764951999999539,3852.373151105718,45550.64712644969
"10.0.2.109",50789,"5.10.88.214",80,8,1175,5,753,3,422,7443.732234,3.224431999999979,1868.2360180025628,1047.006108362658
"10.0.2.109",50790,"194.247.12.49",38925,52,30128,27,19693,25,10435,7443.980492,52.174402000000555,3019.565034976315,1600.0183384947875
"10.0.2.109",50791,"104.28.17.59",80,35,22551,13,1937,22,20614,7444.019152,2.9379960000005667,5274.343464047266,56130.77757763053
"10.0.2.109",50792,"88.85.84.106",80,44,29662,20,10143,24,19519,7444.106437,52.04792699999962,1559.024627436182,3000.1579121489535
"10.0.2.109",50793,"194.247.12.49",38925,47,26343,27,22717,20,3626,7444.285923,46.38802499999929,3917.735234470594,625.3338011264857
"10.0.2.109",50794,"194.247.12.49",38925,21,10584,12,9644,9,940,7444.346453,22.581199999999626,3416.6474766620586,333.0203886418846
"10.0.2.109",50795,"194.247.12.49",38925,18,7811,10,6925,8,886,7444.438886,22.488444000000527,2463.4874693864413,315.1841007763736
"10.0.2.109",50796,"8.254.199.45",80,19,10437,8,859,11,9578,7444.471859,20.93178100000023,328.30460054975373,3660.6536252218175
"10.0.2.109",50797,"8.254.199.45",80,16,7664,7,805,9,6859,7444.568409,13.340526999999383,482.7395499443386,4113.180836109588
"10.0.2.109",50798,"194.247.12.49",38925,13,1095,7,457,6,638,7444.605061,2.763170000000173,1323.1180130067173,1847.1538124688964
"10.0.2.109",50799,"194.247.12.49",38925,13,1724,7,702,6,1022,7444.730212,0.7037389999995867,7980.231307350166,11617.943584204942
"10.0.2.109",50800,"194.247.12.49",38925,16,2661,8,1344,8,1317,7444.791351,52.271537999999964,205.6951146147643,201.56284668723555
"10.0.2.109",50801,"62.161.94.220",80,10,1525,5,943,5,582,7444.877279,0.31120000000009895,24241.64524420823,14961.439588684188
"10.0.2.109",50802,"194.247.12.49",38925,12,1345,6,546,6,799,7444.914884,22.090172000000166,197.7349927379455,289.35944907988727
"10.0.2.109",50803,"128.199.53.58",80,11,1474,6,752,5,722,7444.93525,15.035006999999496,400.1328366525005,384.17009050944864
"10.0.2.109",50804,"194.247.12.49",38925,12,3261,6,1647,6,1614,7445.174995,21.754667999999583,605.663115612716,593.5277890703846
"10.0.2.109",50805,"173.194.122.25",80,8,2997,5,1524,3,1473,7445.335421,21.593886999999995,564.6042326701072,545.7099965374462
"10.0.2.109",50806,"194.247.12.49",38925,12,2083,6,1238,6,845,7445.406167,21.521778000000268,460.18502746380324,314.1004428165701
"10.0.2.109",50807,"104.31.93.48",80,44,26147,16,3388,28,22759,7445.427071,45.24600499999997,599.0363127087136,4024.0458798517157
"10.0.2.109",50808,"88.85.84.123",80,8,1836,5,772,3,1064,7445.534255,21.393201000000772,288.68985057447816,397.8834209990217
"10.0.2.109",50809,"194.247.12.49",38925,15,2423,8,1281,7,1142,7446.038089,2.577627000000575,3975.7497884673435,3544.345244675805
"10.0.2.109",50810,"62.152.53.250",80,11,1262,6,782,5,480,7446.039502,10.118663000000197,618.2634998319322,379.4967773904443
"10.0.2.109",50811,"104.28.17.59",80,9,2061,5,1008,4,1053,7446.163478,2.451908000000003,3288.8672821329305,3435.691714371008
"10.0.2.109",50812,"194.247.12.49",38925,15,4906,8,2511,7,2395,7446.227026,51.8742400000001,387.2442275780804,369.3548088608134
"10.0.2.109",50813,"173.194.122.18",80,10,4601,6,2318,4,2283,7446.390562,51.71021700000074,358.6138499476754,353.1990592884137
"10.0.2.109",50814,"194.247.12.49",38925,12,2537,6,792,6,1745,7447.147652,50.95053300000018,124.35591203726912,273.99124558716494
"10.0.2.109",50815,"194.247.12.49",38925,21,9428,11,6812,10,2616,7447.208946,19.85899800000061,2744.146507290968,1053.8296040917753
"10.0.2.109",50816,"173.194.122.23",80,8,2287,5,1669,3,618,7447.301294,50.7965949999998,262.8522640149414,97.3293583949873
"10.0.2.109",50817,"88.85.84.106",80,14,9016,7,2432,7,6584,7447.402365,19.66521499999999,989.3611638621805,2678.4349929558375
"10.0.2.109",50818,"194.247.12.49",38925,17,3538,8,761,9,2777,7448.840694,15.833815999999388,384.4935421758239,1403.073017900477
"10.0.2.109",50819,"8.37.70.7",80,11,3180,6,2593,5,587,7449.026922,0.5292589999999109,39194.42087900913,8872.782512911053
"10.0.2.109",50820,"194.247.12.49",38925,16,3488,8,761,8,2727,7450.007337,14.66939900000034,415.013593944773,1487.1774910478266
"10.0.2.109",50821,"8.21.198.202",80,11,3184,6,2597,5,587,7450.200355,0.3501830000004702,59328.979419252515,13410.131274201472
"10.0.2.109",50822,"194.247.12.49",38925,270,155521,136,95594,134,59927,7456.878563,130.7958490000001,5846.913383313866,3665.376261290981
"10.0.2.109",50823,"31.13.93.3",443,242,153764,90,57337,152,96427,7457.01004,130.66418199999953,3510.4953245718225,5903.806140232085
"10.0.2.109",50824,"194.247.12.49",38925,19,10135,11,8530,8,1605,7464.208193,0.659403999999995,103487.3916445768,19472.129377437956
"10.0.2.109",50825,"91.185.213.10",80,16,9929,7,1519,9,8410,7464.334322,0.07902600000033999,153772.17624513095,851365.3734177428
"10.0.2.109",50826,"194.247.12.49",38925,12,2165,6,987,6,1178,7465.025721,2.0398800000002666,3870.815930348338,4619.879600760225
"10.0.2.109",50827,"91.185.202.180",80,8,1912,5,1099,3,813,7465.17728,1.8880369999997129,4656.688401764021,3444.8477439801177
"10.0.2.109",50828,"194.247.12.49",38925,12,1413,6,596,6,817,7465.71611,1.2154860000000554,3922.7107510903315,5377.272959128861
"10.0.2.109",50829,"5.10.88.210",80,8,1146,5,724,3,422,7465.849973,1.0813089999992371,5356.470722063801,3122.141774462602
"10.0.2.109",50830,"194.247.12.49",38925,12,2139,6,710,6,1429,7466.396735,0.498794000000089,11387.466569363278,22919.281306507215
"10.0.2.109",50831,"91.185.213.10",80,10,1987,5,1343,5,644,7466.521725,0.1068199999999706,100580.41565252721,48230.66841416792
"10.0.2.109",50832,"194.247.12.49",38925,43,22835,25,20615,18,2220,7467.105399,3.328889000000345,49542.0544211546,5335.113306571099
"10.0.2.109",50833,"194.247.12.49",38925,13,1686,7,702,6,984,7467.196788,2.4679919999998674,2275.5341184251415,3189.637567707036
"10.0.2.109",50834,"104.28.16.59",80,35,22365,12,1870,23,20495,7467.535844,2.898181999999906,5161.856639783314,56573.39670179627
"10.0.2.109",50835,"128.199.53.58",80,11,1461,6,739,5,722,7467.617304,15.247057999999925,387.74693452337027,378.8271809551737
"10.0.2.109",50836,"62.161.94.220",80,10,1487,5,905,5,582,7468.345874,1.072323000000324,6751.697016661782,4341.975319002383
"10.0.2.109",50837,"194.247.12.49",38925,28,8388,13,4028,15,4360,7468.523912,65.99255100000028,488.2975352778811,528.5445019393152
"10.0.2.109",50838,"194.247.12.49",38925,18,2092,8,722,10,1370,7468.584383,11.813517999999931,488.9314089164662,927.7507343705798
"10.0.2.109",50839,"31.13.93.3",443,28,8139,13,4034,15,4105,7468.653007,65.86333300000024,489.9843134267117,498.6082316848417
"10.0.2.109",50840,"194.247.12.49",38925,19,7753,11,6867,8,886,7468.684218,22.000982999999906,2496.9793395140678,322.167423155594
"10.0.2.109",50841,"31.13.93.3",443,12,1519,7,990,5,529,7468.718681,11.679022999999688,678.1389162432689,362.3590774673629
"10.0.2.109",50842,"194.247.12.49",38925,12,1332,6,546,6,786,7468.784662,22.25149599999986,196.30140822891312,282.5877415163475
"10.0.2.109",50843,"194.247.12.49",38925,23,12035,14,11095,9,940,7468.884655,21.7997890000006,4071.599041623639,344.9574672488707
"10.0.2.109",50844,"194.247.12.49",38925,12,2070,6,1238,6,832,7468.991273,21.683203999999932,456.7590656805162,306.9657048838364
"10.0.2.109",50845,"8.254.199.45",80,20,11834,8,859,12,10975,7469.012874,21.234410000000025,323.62566230943037,4134.798188412105
"10.0.2.109",50846,"194.247.12.49",38925,13,1095,7,457,6,638,7469.084585,3.018497000000025,1211.1988184848187,1690.9077597227886
"10.0.2.109",50847,"8.254.199.45",80,13,7390,6,751,7,6639,7469.089867,21.59476100000029,278.2156283183648,2459.485427970205
"10.0.2.109",50848,"88.85.84.114",80,8,1823,5,759,3,1064,7469.120022,21.553546999999526,281.7169721531279,394.92339706314635
"10.0.2.109",50849,"194.247.12.49",38925,17,6441,10,5609,7,832,7469.184391,21.500450999999885,2087.025988431603,309.5749014753242
"10.0.2.109",50850,"62.152.53.250",80,11,1249,6,769,5,480,7469.195406,10.123051999999916,607.7218609565624,379.3322409091677
"10.0.2.109",50851,"8.254.199.45",80,15,6294,7,805,8,5489,7469.30941,17.226631000000452,373.83978329830313,2549.0764851234608
"10.0.2.109",50852,"194.247.12.49",38925,22,12605,13,11653,9,952,7469.911622,21.001279000000068,4438.967740964715,362.6445798848716
"10.0.2.109",50853,"178.79.215.17",80,22,12562,9,921,13,11641,7470.057014,3.6384429999998247,2025.0420303410979,25595.563816721737
"10.0.2.109",50854,"194.247.12.49",38925,20,9192,11,6805,9,2387,7470.673148,20.403653000000304,2668.1496690812764,935.9108391031604
"10.0.2.109",50855,"88.85.84.114",80,14,8834,7,2257,7,6577,7470.819423,20.25692799999979,891.3493694601761,2597.4323451216565
"10.0.2.109",50856,"194.247.12.49",38925,16,3465,8,761,8,2704,7473.70042,23.21523100000013,262.24162921316463,931.8020570202328
"10.0.2.109",50857,"194.247.12.49",38925,16,3469,8,761,8,2708,7473.789779,23.13429200000064,263.15912326168575,936.4453426972997
"10.0.2.109",50858,"8.21.199.6",80,11,3161,6,2574,5,587,7473.899433,0.3450810000003912,59672.946351658466,13608.399187421724
"10.0.2.109",50859,"8.37.70.7",80,11,3165,6,2578,5,587,7473.976324,0.5598879999997735,36835.93861630959,8387.391764070493
"10.0.2.109",50860,"194.247.12.49",38925,30,6642,13,2421,17,4221,7474.857612,112.81189799999993,171.68401864845862,299.33012916775874
"10.0.2.109",50861,"173.194.122.21",443,23,6021,11,3685,12,2336,7475.012202,112.65712499999972,261.67896615504856,165.88387108227772
"10.0.2.109",50862,"194.247.12.49",38925,22,7804,11,5194,11,2610,7483.850739,3.106394999999793,13376.277002764546,6721.617823876677
"10.0.2.109",50863,"217.69.139.58",443,20,7455,9,2292,11,5163,7483.979078,2.978089999999611,6156.9663777798505,13869.292063035502
"10.0.2.109",50864,"194.247.12.49",38925,29,8043,15,5940,14,2103,7488.969471,60.85708199999954,780.8458512683924,276.4509806763349
"10.0.2.109",50865,"195.113.232.72",443,24,7514,10,1659,14,5855,7489.138963,60.68734899999981,218.69467390971454,771.8247834486912
"10.0.2.109",50866,"194.247.12.49",38925,48,35407,32,32995,16,2412,7490.627417,61.694085000000086,4278.530105438789,312.76904422846974
"10.0.2.109",50867,"194.247.12.49",38925,17,1962,8,640,9,1322,7490.688487,7.41395299999931,690.5897569084234,1426.499466613962
"10.0.2.109",50868,"194.247.12.49",38925,82,62882,52,59168,30,3714,7490.950808,69.38606400000026,6821.888614405311,428.21278924251834
"10.0.2.109",50869,"194.247.12.49",38925,17,1976,8,640,9,1336,7491.046411,7.057388000000174,725.4808719599764,1514.4413202164508
"10.0.2.109",50870,"195.113.232.72",443,47,35094,14,2076,33,33018,7491.064019,61.25736699999925,271.11841094966104,4312.036460855446
"10.0.2.109",50871,"31.13.64.7",443,71,62025,20,2942,51,59083,7491.075927,69.26092100000005,339.8164456981446,6824.396689729258
"10.0.2.109",50872,"194.247.12.49",38925,35,15167,19,12810,16,2357,7491.145974,49.54101999999966,2068.5888179129274,380.6138832022459
"10.0.2.109",50873,"194.247.12.49",38925,83,63681,54,59760,29,3921,7491.246565,61.44069899999977,7781.161474090681,510.54106659821883
"10.0.2.109",50874,"23.62.237.17",443,30,14624,11,1845,19,12779,7491.314973,49.37207000000035,298.9544493475744,2070.644394695205
"10.0.2.109",50875,"194.247.12.49",38925,37,17595,21,15347,16,2248,7491.34693,6.8570300000001225,17905.128021898374,2622.709832099273
"10.0.2.109",50876,"23.62.237.23",443,75,62976,20,3193,55,59783,7491.427202,61.26011500000004,416.97603734501615,7807.102549513655
"10.0.2.109",50877,"194.247.12.49",38925,22,5986,11,4275,11,1711,7491.446372,6.759764999999788,5059.347477316308,2024.922464020632
"10.0.2.109",50878,"194.247.12.49",38925,18,2106,8,722,10,1384,7491.546592,10.739091000000371,537.8481288593048,1030.9997373147892
"10.0.2.109",50879,"23.62.237.9",443,15,5335,8,1307,7,4028,7491.612706,6.5930349999998725,1585.9160462518707,4887.5821226492235
"10.0.2.109",50880,"194.247.12.49",38925,19,2160,9,776,10,1384,7491.647344,20.62861200000043,300.94123637595544,536.730246320003
"10.0.2.109",50881,"31.13.64.7",443,12,1519,7,990,5,529,7491.675631,10.609887999999955,746.4734783251278,398.87320205453796
"10.0.2.109",50882,"194.247.12.49",38925,41,22080,25,19449,16,2631,7491.747212,63.07358599999952,2466.832946520611,333.70545952469166
"10.0.2.109",50883,"195.113.232.72",443,10,1325,6,932,4,393,7491.830094,6.272157000000334,1188.7457536537436,501.26296264583823
"10.0.2.109",50884,"194.247.12.49",38925,18,2106,8,722,10,1384,7491.847261,20.427905999999894,282.7504688928973,542.0036689027284
"10.0.2.109",50885,"23.62.237.15",443,38,21645,14,2281,24,19364,7491.929854,62.8907449999997,290.1539805260709,2463.1923186790164
"10.0.2.109",50886,"194.247.12.49",38925,46,26882,27,24096,19,2786,7491.947045,53.74328700000024,3586.829365312158,414.71225978418295
"10.0.2.109",50887,"31.13.64.7",443,12,1519,7,990,5,529,7491.998022,20.276692999999796,390.5962377592875,208.7125351259223
"10.0.2.109",50888,"194.247.12.49",38925,18,2030,9,694,9,1336,7492.047494,6.055531999999403,916.8476031504,1764.9976913673406
"10.0.2.109",50889,"31.13.64.7",443,12,1519,7,990,5,529,7492.04976,20.225854000000254,391.57802681656364,209.23714766258803
"10.0.2.109",50890,"194.247.12.49",38925,13,2360,7,735,6,1625,7492.148356,5.949368000000504,988.3402741265126,2185.1060482388884
"10.0.2.109",50891,"194.247.12.49",38925,79,35003,33,11756,46,23247,7492.247852,95.42789399999947,985.5399302849597,1948.8641340025908
"10.0.2.109",50892,"173.194.122.5",80,8,2049,5,1542,3,507,7492.304293,5.793149000000085,2129.411827660538,700.1373518961692
"10.0.2.109",50893,"194.247.12.49",38925,20,2284,10,810,10,1474,7492.34795,19.938736000000063,324.99552629614936,591.4116120500298
"10.0.2.109",50894,"23.62.237.9",443,44,26501,16,2382,28,24119,7492.388595,53.301713999999265,357.51195543168205,3619.996159973442
"10.0.2.109",50895,"23.62.237.23",443,10,1325,6,932,4,393,7492.46832,5.6351379999996425,1323.1264256528364,557.9277739072583
"10.0.2.109",50896,"23.62.237.15",443,10,1325,6,932,4,393,7492.488334,5.614340000000084,1328.0278714862102,559.9945852940779
"10.0.2.109",50897,"23.62.237.24",443,31,16998,12,1790,19,15208,7492.506367,5.697191000000203,2513.519381744353,21355.085339423527
"10.0.2.109",50898,"216.58.211.42",443,73,34418,37,22531,36,11887,7492.679212,94.99635099999978,1897.420249331476,1001.0489771338714
"10.0.2.109",50899,"216.58.211.42",443,13,1645,8,1144,5,501,7495.756721,16.529551999999967,553.6750179315216,242.4748111745562
"10.0.2.109",50900,"194.247.12.49",38925,26,17982,16,16284,10,1698,7496.40962,0.9066049999992174,143692.1261189961,14983.372030831206
"10.0.2.109",50901,"91.185.213.10",80,25,17884,9,1612,16,16272,7496.54291,0.10616200000004028,121474.72730350886,1226201.4656840547
"10.0.2.109",50902,"194.247.12.49",38925,12,2137,6,710,6,1427,7497.253908,0.4710350000004837,12058.551912265897,24235.990956061178
"10.0.2.109",50903,"194.247.12.49",38925,7,1229,4,232,3,997,7497.315465,1.1225530000001527,1653.3740500446283,7105.232447821097
"10.0.2.109",50904,"91.185.213.10",80,10,1985,5,1341,5,644,7497.378227,0.09187099999962811,116772.43090902925,56078.63199508937
"10.0.2.109",50905,"194.247.12.49",38925,13,3421,7,1995,6,1426,7497.415522,0.6177539999998771,25835.52676308559,18466.89782664664
"10.0.2.109",50906,"91.185.213.10",80,11,3269,5,1340,6,1929,7497.541382,0.056028999999398366,191329.4900875459,275428.7958051314
"10.0.2.109",50907,"194.247.12.49",38925,15,2341,7,906,8,1435,7497.910789,89.7579110000006,80.75054242293976,127.8995898199984
"10.0.2.109",50908,"5.10.88.214",80,11,1305,6,775,5,530,7498.036356,10.018789000000652,618.8372666596329,423.20484042529733
"10.0.2.109",50909,"194.247.12.49",38925,37,23650,23,21669,14,1981,7498.248325,8.329055000000153,20812.925355877323,1902.7368651065108
"10.0.2.109",50910,"194.247.12.49",38925,24,10632,13,7054,11,3578,7498.309217,89.13460399999985,633.1098974759577,321.13229560093237
"10.0.2.109",50911,"194.247.12.49",38925,37,22510,22,20455,15,2055,7498.406684,2.151299000000108,76065.67009048568,7641.894501879642
"10.0.2.109",50912,"194.247.12.49",38925,16,3017,8,1428,8,1589,7498.506649,103.86451699999998,109.98943941558022,122.39020954576819
"10.0.2.109",50913,"104.28.16.59",80,32,22202,11,1813,21,20389,7498.560644,1.9970229999998992,7262.8106937179655,81677.577073478
"10.0.2.109",50914,"194.247.12.49",38925,16,3511,8,1271,8,2240,7498.607277,103.76497000000018,97.99068028449275,172.69797312137197
"10.0.2.109",50915,"88.85.84.114",80,11,1641,6,877,5,764,7498.653944,65.27154500000051,107.48941211671863,93.63957908457586
"10.0.2.109",50916,"104.31.93.48",80,32,23346,11,1797,21,21549,7498.656901,7.920135999999729,1815.120346418356,21766.29290204182
"10.0.2.109",50917,"194.247.12.49",38925,12,1630,6,648,6,982,7498.707049,1.0292859999999564,5036.5010308118635,7632.475327557484
"10.0.2.109",50918,"194.247.12.49",38925,12,1328,6,546,6,782,7498.833951,88.60722200000055,49.29620748069467,70.6037257324235
"10.0.2.109",50919,"194.247.12.49",38925,13,1601,7,842,6,759,7498.895458,88.55164200000036,76.0686063845092,68.57015706157064
"10.0.2.109",50920,"62.152.53.250",80,11,1245,6,765,5,480,7498.982182,10.111877000000277,605.228880849701,379.7514546507928
"10.0.2.109",50921,"62.161.94.220",80,10,1485,5,903,5,582,7499.112335,0.07482900000013615,96540.11145393974,62221.865854034244
"10.0.2.109",50922,"128.199.53.58",80,11,1458,6,736,5,722,7499.297882,16.028661000000284,367.3419757270988,360.35449249315946
"10.0.2.109",50923,"88.85.84.106",80,21,10436,10,3502,11,6934,7499.436049,67.44723200000044,415.3765717175735,822.450356450501
"10.0.2.109",50924,"194.247.12.49",38925,12,2067,6,1238,6,829,7499.761638,87.68007899999975,112.95610260570167,75.63861798071622
"10.0.2.109",50925,"173.194.113.97",80,12,3250,7,2153,5,1097,7499.76777,102.60420599999998,167.86836204355993,85.53255604356026
"10.0.2.109",50926,"88.85.84.123",80,11,1982,6,810,5,1172,7499.911977,65.07367599999998,99.57943669879664,144.08283927282673
"10.0.2.109",50927,"194.247.12.49",38925,18,7446,10,6548,8,898,7500.428775,87.01115599999957,602.0377432981152,82.56412545536155
"10.0.2.109",50928,"194.247.12.49",38925,34,18291,17,11442,17,6849,7500.489639,86.93518499999936,1052.922358191343,630.2626491218763
"10.0.2.109",50929,"178.79.215.7",80,16,7295,7,813,9,6482,7500.574068,3.16551200000049,2054.6439249002983,16381.552178602378
"10.0.2.109",50930,"88.85.84.106",80,29,15994,14,5527,15,10467,7500.613797,67.98260300000038,650.4016917386901,1231.7268875391478
"10.0.2.109",50931,"194.247.12.49",38925,13,1099,7,457,6,642,7500.745543,2.742677000000185,1333.0042144954557,1872.6229884159357
"10.0.2.109",50932,"194.247.12.49",38925,12,2303,6,681,6,1622,7503.411673,84.03320800000074,64.83151279908238,154.41514502219033
"10.0.2.109",50933,"173.194.122.7",80,8,2046,5,1539,3,507,7503.561496,83.88294700000006,146.7759591231337,48.35309374621754
"10.0.2.109",50934,"194.247.12.49",38925,16,3468,8,761,8,2707,7506.76806,79.50741799999923,76.57147160784493,272.377100712794
"10.0.2.109",50935,"194.247.12.49",38925,16,3471,8,761,8,2710,7506.828897,79.45511600000009,76.6218754246107,272.8584525633312
"10.0.2.109",50936,"8.21.198.137",80,11,3164,6,2577,5,587,7506.955942,0.3424810000005891,60196.04007219244,13711.709554667039
"10.0.2.109",50937,"8.21.198.202",80,11,3167,6,2580,5,587,7507.014411,0.3447869999999966,59863.04588050072,13620.003074361986
"10.0.2.109",50938,"194.247.12.49",38925,12,2765,6,1267,6,1498,7522.768476,0.44542899999942165,22755.59067778066,26904.400027873264
"10.0.2.109",50939,"194.247.12.49",38925,12,2770,6,1272,6,1498,7522.829021,0.44678600000042934,22776.00461963943,26822.684685707438
"10.0.2.109",50940,"91.185.213.10",80,10,2613,5,1412,5,1201,7522.895781,0.07180199999947945,157321.52307849214,133812.42862412825
"10.0.2.109",50941,"91.185.213.10",80,10,2618,5,1412,5,1206,7522.959685,0.06731700000000274,167803.080945371,143321.89491509733
"10.0.2.109",50942,"194.247.12.49",38925,82,66576,54,63181,28,3395,7539.92594,47.74799900000016,10585.74203287552,568.8196483375127
"10.0.2.109",50943,"195.113.232.90",443,75,65935,22,2839,53,63096,7540.088872,47.58480299999974,477.29524066749053,10607.756430135956
"10.0.2.109",50944,"194.247.12.49",38925,12,2461,6,960,6,1501,7541.046293,0.446484999999484,17201.02579035998,26894.52053263576
"10.0.2.109",50945,"91.185.213.10",80,10,2309,5,1415,5,894,7541.171519,0.07130599999982223,158752.41915165933,100300.11499758548
"10.0.2.109",50946,"194.247.12.49",38925,20,7696,10,5140,10,2556,7543.829405,1.0130589999998847,40589.93602544835,20184.411766740464
"10.0.2.109",50947,"217.69.139.59",443,18,7347,8,2238,10,5109,7543.959425,0.8830580000003465,20274.99892418502,46284.615506551054
"10.0.2.109",50948,"194.247.12.49",38925,24,7989,11,5591,13,2398,7545.303753,42.143959999999424,1061.3145988179708,455.2016469263985
"10.0.2.109",50949,"217.69.139.202",443,18,7438,9,1986,9,5452,7545.446974,42.000442999999905,378.2817243141944,1038.4652371404773
"10.0.2.109",50950,"194.247.12.49",38925,25,4038,11,1176,14,2862,7548.116322,39.55890499999987,237.8225585364416,578.7824511320542
"10.0.2.109",50951,"173.194.122.7",443,19,3461,10,2424,9,1037,7548.272578,39.402484999999615,492.1517005843715,210.5450963308553
"10.0.2.109",50952,"194.247.12.49",38925,23,15438,14,13785,9,1653,7552.629507,1.0851450000000114,101626.97151071871,12186.389837302722
"10.0.2.109",50953,"91.185.213.10",80,21,15286,8,1567,13,13719,7553.022477,0.059158999999453954,211903.51426014147,1855203.7729003706
"10.0.2.109",50954,"194.247.12.49",38925,144,88927,45,2820,99,86107,7560.773391,5.9386789999998655,3798.8246207617067,115994.81972337882
"10.0.2.109",50955,"91.185.213.10",80,120,87587,66,84293,54,3294,7560.899817,5.567003999999542,121132.30024624654,4733.605364753136
"10.0.2.109",50956,"194.247.12.49",38925,12,2776,6,1059,6,1717,7566.94551,0.5300170000000435,15984.392953432258,25916.149859342007
"10.0.2.109",50957,"91.185.213.10",80,12,2732,6,1685,6,1047,7567.07512,0.09075899999970716,148525.21513065917,92288.36809602383
"10.0.2.109",50958,"194.247.12.49",38925,13,4229,7,2704,6,1525,7567.667064,0.6079270000000179,35583.2196957848,20068.198977837208
"10.0.2.109",50959,"91.185.213.10",80,11,4077,5,1439,6,2638,7567.791731,0.05420299999968847,212386.76826128009,389351.14292790607
"10.0.2.109",50960,"88.85.84.106",80,8,2411,5,1390,3,1021,7569.988269,17.43565099999978,637.7737200635721,468.4654447373432
"10.0.2.109",50961,"194.247.12.49",38925,14,3073,7,707,7,2366,7578.884888,7.387968000000001,765.5690982960402,2562.0035170699166
"10.0.2.109",50962,"194.247.12.49",38925,14,3077,7,707,7,2370,7578.945736,7.337736000000405,770.8099610015526,2583.9032638948793
"10.0.2.109",50963,"8.21.199.6",80,11,2877,6,2290,5,587,7579.015155,0.34107200000016746,53712.99901484439,13768.353895944827
"10.0.2.109",50964,"8.37.70.21",80,11,2881,6,2294,5,587,7579.071486,0.5287520000001678,34708.14294791164,8881.290283532753
"10.0.2.109",50965,"194.247.12.49",38925,19,6340,8,805,11,5535,7584.290351,1.3025160000006508,4944.27707605648,33995.743622326234
"10.0.2.109",50966,"91.185.213.10",80,18,6242,9,5395,9,847,7584.419885,0.3227409999999509,133729.52305411018,20995.16330432462
"10.0.2.109",50967,"194.247.12.49",38925,21,11324,12,9644,9,1680,7585.786124,1.069869999999355,72113.43434253368,12562.273921138178
"10.0.2.109",50968,"91.185.213.10",80,17,11064,7,1540,10,9524,7585.915993,0.08917999999994208,138147.566719085,854361.9645666011
"10.0.2.109",50969,"194.247.12.49",38925,12,2173,6,987,6,1186,7586.747035,0.6775199999992765,11654.268508691157,14004.01464164915
"10.0.2.109",50970,"194.247.12.49",38925,12,2150,6,710,6,1440,7586.807902,0.5165090000000419,10996.904216576168,22303.580382915043
"10.0.2.109",50971,"91.185.202.180",80,8,1920,5,1107,3,813,7586.893523,0.5302250000004278,16702.343344792975,12266.490640755816
"10.0.2.109",50972,"91.185.213.10",80,10,1998,5,1354,5,644,7586.933531,0.09574100000008912,113138.57177165392,53811.846544272616
"10.0.2.109",50973,"5.10.88.212",80,8,1170,5,748,3,422,7587.327251,0.3411820000001171,17539.02609164008,9895.012046353093
"10.0.2.109",50974,"88.85.84.123",80,8,1492,5,836,3,656,7587.471405,14.899054999999862,448.88753011516917,352.2371049707548
"10.0.2.109",50975,"194.247.12.49",38925,54,26744,30,22898,24,3846,7587.676609,14.358288999999786,12758.066089908256,2142.8737086988885
"10.0.2.109",50976,"194.247.12.49",38925,27,14503,14,9443,13,5060,7587.938862,6.8049049999999625,11101.40406074742,5948.650275058979
"10.0.2.109",50977,"194.247.12.49",38925,39,22814,22,20638,17,2176,7588.035497,5.987253000000237,27575.918371913373,2907.510339048527
"10.0.2.109",50978,"194.247.12.49",38925,13,1742,7,702,6,1040,7588.136456,1.4573209999998653,3853.6465198817,5709.105955380296
"10.0.2.109",50979,"104.28.17.59",80,34,22506,13,1934,21,20572,7588.195429,5.8268269999998665,2655.3045079252147,28244.53171511764
"10.0.2.109",50980,"62.161.94.220",80,10,1543,5,961,5,582,7588.284975,1.07281200000034,7166.21365159745,4339.996196909174
"10.0.2.109",50981,"104.31.93.48",80,44,26170,16,3392,28,22778,7588.840046,13.194244999999682,2056.654245847387,13810.86981483248
"10.0.2.109",50982,"88.85.84.106",80,23,14253,11,4930,12,9323,7589.065188,5.677046000000701,6947.275044097782,13137.818506313106
"10.0.2.109",50983,"194.247.12.49",38925,19,7555,11,6669,8,886,7590.304478,12.01814800000011,4439.286319323036,589.7747306822928
"10.0.2.109",50984,"194.247.12.49",38925,13,1614,7,842,6,772,7590.428842,11.94220899999982,564.0497499248339,517.1572529002041
"10.0.2.109",50985,"8.254.199.45",80,16,7362,8,867,8,6495,7590.430418,11.891717999999855,583.263074351417,4369.4275293107885
"10.0.2.109",50986,"194.247.12.49",38925,12,1342,6,546,6,796,7590.488068,4.255973000000267,1026.3223004468603,1496.2500936917597
"10.0.2.109",50987,"128.199.53.58",80,8,1309,5,695,3,614,7590.557488,11.812873999999283,470.67292853545524,415.8175224759274
"10.0.2.109",50988,"62.152.53.250",80,8,1097,5,725,3,372,7590.616434,4.127113000000463,1405.3407309175564,721.0851750363186
"10.0.2.109",50989,"194.247.12.49",38925,12,2080,6,1238,6,842,7590.683107,4.060167999999976,2439.3079301152216,1659.0446503691571
"10.0.2.109",50990,"194.247.12.49",38925,19,2142,9,776,10,1366,7590.743931,11.960323999999673,519.0494839437602,913.687622509248
"10.0.2.109",50991,"88.85.84.106",80,8,1833,5,769,3,1064,7590.833371,3.90753500000028,1574.3940873209222,2178.355408204761
"10.0.2.109",50992,"194.247.12.49",38925,18,3384,9,1554,9,1830,7590.840041,6.61746199999925,1878.6658691808746,2212.328533205277
"10.0.2.109",50993,"31.13.93.3",443,12,1519,7,990,5,529,7590.872334,11.831732000000557,669.3863586497419,357.6822057835489
"10.0.2.109",50994,"194.247.12.49",38925,19,9355,11,8458,8,897,7590.939798,3.80372399999942,17788.88268444564,1886.57221186424
"10.0.2.109",50995,"104.28.16.59",80,13,3076,7,1696,6,1380,7590.968588,6.48865300000034,2091.0349189576464,1701.431714717896
"10.0.2.109",50996,"194.247.12.49",38925,22,11814,13,10862,9,952,7591.039752,3.7023550000003524,23470.466770472234,2057.0690817059076
"10.0.2.109",50997,"178.79.215.17",80,18,9258,8,866,10,8392,7591.090218,3.604964000000109,1921.7945033569795,18623.2095521614
"10.0.2.109",50998,"194.247.12.49",38925,18,2088,8,722,10,1366,7591.140197,21.57946600000014,267.6618596586201,506.4073411269737
"10.0.2.109",50999,"178.79.215.59",80,22,11771,9,921,13,10850,7591.188093,3.5036180000006425,2102.9689880571023,24774.39035876174
"10.0.2.109",51000,"194.247.12.49",38925,20,2196,10,830,10,1366,7591.239994,21.478564000000006,309.14543448994067,508.78634158223974
"10.0.2.109",51001,"194.247.12.49",38925,13,1095,7,457,6,638,7591.340797,2.7344950000006065,1336.9927536891416,1866.5238005550816
"10.0.2.109",51002,"194.247.12.49",38925,19,10030,11,9133,8,897,7591.44029,3.301074000000881,22133.402644103255,2173.83796909675
"10.0.2.109",51003,"178.79.215.7",80,19,9987,8,866,11,9121,7591.570134,3.128065000000788,2214.7877361877886,23326.88099511411
"10.0.2.109",51004,"194.247.12.49",38925,18,2088,8,722,10,1366,7591.689341,21.029853999999432,274.65716119570567,519.6422191043407
"10.0.2.109",51005,"194.247.12.49",38925,384,248466,206,179381,178,69085,7591.950559,77.01115699999991,18634.286977405125,7176.622473026871
"10.0.2.109",51006,"179.60.192.3",443,328,245197,113,65361,215,179836,7592.079418,76.88213799999994,6801.163620085596,18712.903119317532
"10.0.2.109",51007,"194.247.12.49",38925,20,9137,11,6782,9,2355,7592.166858,2.5726830000003247,21089.26750788696,7323.094217203449
"10.0.2.109",51008,"31.13.93.3",443,12,1519,7,990,5,529,7592.267411,20.452092999999877,387.2464299864101,206.92258733617265
"10.0.2.109",51009,"88.85.84.106",80,14,8779,7,2225,7,6554,7592.312787,2.4263019999998505,7336.267290716942,21609.840819487115
"10.0.2.109",51010,"31.13.93.3",443,12,1519,7,990,5,529,7592.364222,20.354032999999617,389.11207425084496,207.91948209969394
"10.0.2.109",51011,"31.13.93.3",443,12,1519,7,990,5,529,7592.810605,19.90835000000061,397.8230240075022,212.57412090905927
"10.0.2.109",51012,"194.247.12.49",38925,19,10417,11,8802,8,1615,7594.236569,0.6573379999999815,107122.97174361131,19655.032875020708
"10.0.2.109",51013,"91.185.213.10",80,16,10211,7,1529,9,8682,7594.363569,0.05763399999977992,212235.83301604452,1205121.97661563
"10.0.2.109",51014,"194.247.12.49",38925,20,2214,10,830,10,1384,7594.946833,12.77688500000022,519.6884843214825,866.5648943384721
"10.0.2.109",51015,"194.247.12.49",38925,293,242381,188,232422,105,9959,7595.007677,73.9443310000006,25145.619344368468,1077.4592037352986
"10.0.2.109",51016,"194.247.12.49",38925,517,490573,360,470884,157,19689,7595.106015,73.8451959999993,51013.09501568708,2133.0026668221108
"10.0.2.109",51017,"194.247.12.49",38925,143,99065,84,92280,59,6785,7595.205674,73.75508900000023,10009.343219692919,735.949217009281
"10.0.2.109",51018,"31.13.64.7",443,482,488420,110,16919,372,471501,7595.230667,73.72037499999988,1836.018875378757,51166.42447898571
"10.0.2.109",51019,"194.247.12.49",38925,157,114009,99,106964,58,7045,7595.306134,73.64546999999948,11619.343321456243,765.2880754240607
"10.0.2.109",51020,"31.13.64.7",443,12,1519,7,990,5,529,7595.353352,12.370186000000103,640.2490633528012,342.1128833471028
"10.0.2.109",51021,"23.62.237.22",443,140,98630,43,5679,97,92951,7595.366293,73.59422900000027,617.3310138217473,10104.161835841738
"10.0.2.109",51022,"194.247.12.49",38925,159,107858,93,100428,66,7430,7595.406196,73.55516799999987,10922.740330088043,808.1009345257713
"10.0.2.109",51023,"194.247.12.49",38925,164,111278,96,103729,68,7549,7595.505949,73.45508599999994,11297.134687174701,822.1622666128259
"10.0.2.109",51024,"23.62.237.16",443,145,106829,45,6054,100,100775,7595.567119,73.39406599999984,659.8898608506048,10984.539267793145
"10.0.2.109",51025,"194.247.12.49",38925,21,2268,11,884,10,1384,7595.606728,17.1111690000007,413.29730306560066,647.0627459760083
"10.0.2.109",51026,"23.62.237.23",443,149,110195,45,6065,104,104130,7595.666981,73.29385599999932,661.9927323785564,11365.754859452445
"10.0.2.109",51027,"194.247.12.49",38925,18,2030,9,694,9,1336,7595.706455,6.69634700000006,829.1087663169113,1596.0941092210282
"10.0.2.109",51028,"23.62.237.22",443,143,112980,47,6209,96,106771,7595.747344,73.2040649999999,678.5415536691859,11668.313774651739
"10.0.2.109",51029,"194.247.12.49",38925,109,65968,63,60472,46,5496,7595.806741,73.1536529999994,6613.14890180541,601.0362872787824
"10.0.2.109",51030,"23.62.237.16",443,10,1325,6,932,4,393,7595.875786,6.526585999999952,1142.4043136794726,481.72199063952013
"10.0.2.109",51031,"194.247.12.49",38925,18,2030,9,694,9,1336,7595.906617,6.49869100000069,854.3258942453812,1644.638897279293
"10.0.2.109",51032,"194.247.12.49",38925,18,2106,8,722,10,1384,7596.006823,11.717819999999847,492.92445181783603,944.8856527920846
"10.0.2.109",51033,"31.13.64.7",443,12,1519,7,990,5,529,7596.011762,16.70571999999993,474.08911438717,253.32640556647772
"10.0.2.109",51034,"23.62.237.22",443,11,1387,7,994,4,393,7596.077021,6.32807799999955,1256.6216788099903,496.83331969046895
"10.0.2.109",51035,"194.247.12.49",38925,18,2030,9,694,9,1336,7596.107507,6.264103000000432,886.3200365638331,1706.229926295794
"10.0.2.109",51036,"31.13.64.7",443,12,1519,7,990,5,529,7596.139611,11.584818000000269,683.6533815205225,365.3056957821782
"10.0.2.109",51037,"23.62.237.8",443,276,241190,73,7989,203,233201,7596.180493,72.77131000000008,878.2582036794436,25636.586726279875
"10.0.2.109",51038,"194.247.12.49",38925,19,2160,9,776,10,1384,7596.207439,11.517627000000175,538.9999172572532,961.3091307784001
"10.0.2.109",51039,"23.62.237.24",443,96,64993,32,4498,64,60495,7596.247247,72.71291000000019,494.8777321661299,6655.764430277907
"10.0.2.109",51040,"23.62.237.16",443,11,1387,7,994,4,393,7596.28582,6.085619999999835,1306.6869111118037,516.627722401347
"10.0.2.109",51041,"194.247.12.49",38925,17,1893,8,593,9,1300,7596.307193,6.062945000000582,782.4580298847416,1715.3380081790287
"10.0.2.109",51042,"31.13.64.7",443,12,1519,7,990,5,529,7596.335619,11.38926999999967,695.3913639768159,371.577809640137
"10.0.2.109",51043,"194.247.12.49",38925,19,2160,9,776,10,1384,7596.40768,16.29682899999989,380.93300236506394,679.3959732902687
"10.0.2.109",51044,"23.62.237.23",443,10,1242,6,896,4,346,7596.471692,5.898212000000058,1215.2835469460795,469.2947625483745
"10.0.2.109",51045,"194.247.12.49",38925,16,3480,8,761,8,2719,7596.507746,4.655283000000054,1307.7615259909933,4672.540853047977
"10.0.2.109",51046,"31.13.64.7",443,12,1519,7,990,5,529,7596.533341,16.170836999999665,489.77056660704477,261.70568660113804
"10.0.2.109",51047,"194.247.12.49",38925,16,3489,8,761,8,2728,7596.607734,4.556808999999703,1336.0226421604234,4789.316383460756
"10.0.2.109",51048,"8.21.198.203",80,12,3238,7,2651,5,587,7596.692732,3.7765779999999722,5615.665822339736,1243.4537298051396
"10.0.2.109",51049,"8.21.198.203",80,11,3185,6,2598,5,587,7597.071141,0.3458869999994931,60088.988600411285,13576.688340431649
"10.0.2.109",51050,"194.247.12.49",38925,13,2461,7,754,6,1707,7597.645356,2.589947000000393,2329.0051881367012,5272.694769428845
"10.0.2.109",51051,"91.185.213.10",80,12,2363,6,1675,6,688,7598.61387,1.3245529999994687,10116.62047498694,4155.364111517023
"10.0.2.109",51052,"194.247.12.49",38925,30,6575,13,2354,17,4221,7598.843838,70.11824100000013,268.5749062073586,481.5865246819289
"10.0.2.109",51053,"173.194.122.21",443,23,5954,12,3739,11,2215,7599.967556,68.99427300000025,433.54323046493863,256.8329113345384
"10.0.2.109",51054,"194.247.12.49",38925,20,10730,12,9088,8,1642,7600.460217,1.9104690000003757,38055.57692900838,6875.798560456839
"10.0.2.109",51055,"91.185.213.10",80,16,10470,7,1556,9,8914,7600.589439,0.31633099999999104,39351.18594130943,225434.75030901816
"10.0.2.109",51056,"194.247.12.49",38925,12,2153,6,710,6,1443,7601.544493,0.7695509999994101,7380.927319962359,15000.955102402373
"10.0.2.109",51057,"194.247.12.49",38925,12,2192,6,987,6,1205,7601.606157,0.7679680000001099,10281.678403265332,12552.606358596478
"10.0.2.109",51058,"91.185.202.180",80,8,1939,5,1126,3,813,7601.736773,0.6370980000001509,14139.112036135517,10208.790484350067
"10.0.2.109",51059,"91.185.213.10",80,10,2001,5,1357,5,644,7601.951835,0.10158200000023498,106869.32724276828,50717.646827076474
"10.0.2.109",51060,"194.247.12.49",38925,12,1442,6,596,6,846,7602.22259,2.274981999999909,2095.840758300589,2974.9685931582185
"10.0.2.109",51061,"5.10.88.212",80,8,1175,5,753,3,422,7602.347759,2.1493030000001454,2802.769083744634,1570.7417707041639
"10.0.2.109",51062,"194.247.12.49",38925,13,2876,7,1546,6,1330,7602.513358,4.319582999999511,2863.2393450945146,2463.2007302559537
"10.0.2.109",51063,"194.247.12.49",38925,41,23636,24,21514,17,2122,7602.627059,8.139333000000079,21145.71304552822,2085.6745878316856
"10.0.2.109",51064,"173.194.122.26",80,8,2561,5,1243,3,1318,7602.673219,4.1592319999999745,2390.8259986459184,2535.0834000123255
"10.0.2.109",51065,"194.247.12.49",38925,38,22758,22,20633,16,2125,7602.888158,2.504613000000063,65903.99395036114,6787.475749746397
"10.0.2.109",51066,"194.247.12.49",38925,12,1744,6,830,6,914,7602.98703,4.7241979999998875,1405.5295734853107,1547.775939958523
"10.0.2.109",51067,"104.28.16.59",80,34,22504,13,1937,21,20567,7603.012095,2.3801910000001953,6510.4018963178705,69127.22550416605
"10.0.2.109",51068,"104.31.93.48",80,35,23278,13,1884,22,21394,7603.075509,7.69060300000001,1959.7943100170403,22254.691862263568
"10.0.2.109",51069,"194.247.12.49",38925,33,15657,18,10154,15,5503,7603.087256,13.747852000000421,5908.704865312597,3202.2457035468997
"10.0.2.109",51070,"88.85.84.114",80,8,1495,5,839,3,656,7603.112034,4.598936000000322,1459.468016080139,1141.1335143606332
"10.0.2.109",51071,"194.247.12.49",38925,13,2072,7,805,6,1267,7603.187005,3.5783849999997983,1799.6945549459779,2832.5627343062783
"10.0.2.109",51072,"88.85.84.106",80,25,15191,12,5319,13,9872,7603.230184,13.603341,3128.0550858792703,5805.632601579274
"10.0.2.109",51073,"194.247.12.49",38925,12,1671,6,648,6,1023,7603.287374,0.5065389999999752,10234.157685785802,16156.702642837769
"10.0.2.109",51074,"194.247.12.49",38925,13,1399,7,600,6,799,7603.387815,8.19799299999977,585.5091605957866,779.7030321933893
"10.0.2.109",51075,"62.161.94.220",80,10,1526,5,944,5,582,7603.433157,0.07792499999959546,96913.69907012135,59749.75938433329
"10.0.2.109",51076,"194.247.12.49",38925,12,1563,6,788,6,775,7603.487892,3.265497000000323,1930.4871509602906,1898.639012683027
"10.0.2.109",51077,"62.152.53.250",80,8,1100,5,728,3,372,7603.516355,8.06910500000049,721.7653011083195,368.81413737952585
"10.0.2.109",51078,"194.247.12.49",38925,13,3319,7,1707,6,1612,7603.519987,4.157923000000665,3284.332105235671,3101.548537574635
"10.0.2.109",51079,"173.194.113.99",80,8,1757,5,1180,3,577,7603.622441,3.142689999999675,3003.7961109753037,1468.8053864684323
"10.0.2.109",51080,"194.247.12.49",38925,12,2083,6,1238,6,845,7603.923982,0.6878349999997226,14398.802038285336,9827.938386390233
"10.0.2.109",51081,"88.85.84.123",80,8,1836,5,772,3,1064,7604.050658,0.5608940000001894,11010.993164480124,15175.772962444109
"10.0.2.109",51082,"194.247.12.49",38925,11,1374,6,340,5,1034,7604.703572,62.290978999999425,43.66603388911298,132.7961148274789
"10.0.2.109",51083,"194.247.12.49",38925,22,11499,13,10548,9,951,7604.764381,6.809288999999808,12392.483268077238,1117.2972684813665
"10.0.2.109",51084,"194.247.12.49",38925,22,7804,11,5194,11,2610,7604.825015,1.7807800000000498,23333.59539078316,11725.199070070092
"10.0.2.109",51085,"104.28.17.59",80,9,1228,5,1008,4,220,7604.83187,16.016031000000112,503.4955289484607,109.88989719113229
"10.0.2.109",51086,"217.69.139.58",443,20,7455,9,2292,11,5163,7604.970534,1.6351979999999458,11213.320955627763,25259.326393501808
"10.0.2.109",51087,"128.199.53.58",80,8,1312,5,698,3,614,7605.449531,1.30343399999947,4284.068084768596,3768.506882590141
"10.0.2.109",51088,"194.247.12.49",38925,13,1099,7,457,6,642,7605.668908,3.7283440000001065,980.5962110792071,1377.555289962475
"10.0.2.109",51089,"178.79.215.59",80,19,11294,8,866,11,10428,7605.725936,4.97129700000005,1393.6001007382845,16781.13377655754
"10.0.2.109",51090,"194.247.12.49",38925,22,5982,11,4275,11,1707,7606.928749,15.804307000000335,2163.967075557269,864.0682568365515
"10.0.2.109",51091,"173.194.122.13",80,8,2993,5,1522,3,1471,7606.963675,0.7137499999998909,17059.194395799455,16487.565674258214
"10.0.2.109",51092,"194.247.12.49",38925,18,2034,9,702,9,1332,7606.989327,15.734875999999531,356.914156806839,677.2217334283612
"10.0.2.109",51093,"194.247.12.49",38925,43,21162,21,16183,22,4979,7607.0833,61.812895000000026,2094.449709886585,644.3962865677134
"10.0.2.109",51094,"194.247.12.49",38925,22,9270,12,6654,10,2616,7607.18284,9.652099999999336,5515.069259539754,2168.2328198010214
"10.0.2.109",51095,"92.122.206.59",443,39,20677,17,4471,22,16206,7607.252647,61.643457000000126,580.2400082785741,2103.191584469374
"10.0.2.109",51096,"88.85.84.106",80,14,8804,7,2432,7,6372,7607.369755,9.463606000000254,2055.875952570244,5386.530250730919
"10.0.2.109",51097,"194.247.12.49",38925,17,5008,9,2561,8,2447,7607.850883,61.09114599999975,335.36774707091075,320.43923353475935
"10.0.2.109",51098,"194.247.12.49",38925,17,1972,8,640,9,1332,7607.923358,14.798533000000134,345.98024006838745,720.0713746423313
"10.0.2.109",51099,"2.20.182.112",443,15,5335,8,1307,7,4028,7607.925972,14.806932999999844,706.1556907159713,2176.2778287711803
"10.0.2.109",51100,"194.247.12.49",38925,21,5928,10,4221,11,1707,7607.986649,14.737913999999364,2291.2333455061184,926.5897466901075
"10.0.2.109",51101,"173.194.122.17",80,11,4657,7,2378,4,2279,7608.006836,60.93486600000051,312.20221276928453,299.2047278810763
"10.0.2.109",51102,"194.247.12.49",38925,17,1972,8,640,9,1332,7608.084436,14.640765000000101,349.7085022538074,727.8308203157367
"10.0.2.109",51103,"194.247.12.49",38925,20,3436,10,1611,10,1825,7608.184498,8.636157000000821,1492.3304428114002,1690.5667648235913
"10.0.2.109",51104,"104.31.93.48",80,15,3132,8,1695,7,1437,7608.341918,8.478140000000167,1599.4074171928905,1355.957792629017
"10.0.2.109",51105,"92.122.206.59",443,10,1325,6,932,4,393,7608.347947,14.373705999999402,518.7249551368527,218.73273322830806
"10.0.2.109",51106,"92.122.206.59",443,10,1325,6,932,4,393,7609.217742,13.507252000000335,551.9997701975069,232.76385159615901
"10.0.2.109",51107,"2.20.182.91",443,15,5335,8,1307,7,4028,7609.44376,13.280557999999473,787.3163160765093,2426.4040712748124
"10.0.2.109",51108,"2.20.182.112",443,10,1325,6,932,4,393,7610.140873,12.583013999999821,592.5448386213435,249.8606454701588
"10.0.2.109",51109,"194.247.12.49",38925,16,3487,8,761,8,2726,7610.969276,56.023450000000594,108.66878066238219,389.2655664726069
"10.0.2.109",51110,"194.247.12.49",38925,16,3484,8,761,8,2723,7611.030342,55.94535999999971,108.82046339499882,389.379923553984
"10.0.2.109",51111,"8.37.70.21",80,11,3183,6,2596,5,587,7611.156262,0.5304459999997562,39151.9589176081,8852.927536454528
"10.0.2.109",51112,"194.247.12.49",38925,12,2535,6,792,6,1743,7611.767919,57.180325000000266,110.80734500896891,243.86010397807175
"10.0.2.109",51113,"173.194.122.15",80,8,2285,5,1667,3,618,7611.92529,57.02261999999973,233.87210198338943,86.70243492845512
"10.0.2.109",51114,"8.37.70.21",80,11,3180,6,2593,5,587,7612.224911,0.5271609999999782,39350.407181109484,8908.09449105718
"10.0.2.109",51115,"194.247.12.49",38925,21,5930,10,4221,11,1709,7614.249289,18.473470999999336,1827.9185324729292,740.0883136688548
"10.0.2.109",51116,"194.247.12.49",38925,17,1962,8,640,9,1322,7614.309713,18.416979999999967,278.0043199265031,574.252673348183
"10.0.2.109",51117,"194.247.12.49",38925,21,5930,10,4221,11,1709,7614.403577,18.323562999999922,1842.873026386852,746.1430945499005
"10.0.2.109",51118,"195.113.232.72",443,10,1325,6,932,4,393,7614.488884,18.237553999999363,408.82675385088703,172.39153890922597
"10.0.2.109",51119,"194.247.12.49",38925,17,1974,8,640,9,1334,7614.503337,18.221255999999812,280.99050910651016,585.6895924188821
"10.0.2.109",51120,"92.122.212.89",443,15,5335,8,1307,7,4028,7614.569311,18.157632999999805,575.8459816871567,1774.6806535852083
"10.0.2.109",51121,"194.247.12.49",38925,18,2092,8,722,10,1370,7614.603498,18.124196999999185,318.689981134075,604.7164461962366
"10.0.2.109",51122,"92.122.212.72",443,10,1325,6,932,4,393,7614.676024,18.048342999999477,413.1127162199996,174.19881703268223
"10.0.2.109",51123,"92.122.212.99",443,15,5335,8,1307,7,4028,7614.690923,18.031554000000142,579.872372619682,1787.0894544086298
"10.0.2.109",51124,"31.13.93.3",443,12,1519,7,990,5,529,7614.732037,17.995426999999836,440.11181285112445,235.17085757398468
"10.0.2.109",51125,"194.247.12.49",38925,95,62834,56,58054,39,4780,7617.023255,51.936767000000145,8942.258573776813,736.2799459581281
"10.0.2.109",51126,"194.247.12.49",38925,86,52382,50,47738,36,4644,7617.08358,51.87611299999935,7361.84686774826,716.1677668486933
"10.0.2.109",51127,"194.247.12.49",38925,21,5932,10,4221,11,1711,7617.177748,15.547099000000344,2171.980766315263,880.421485706092
"10.0.2.109",51128,"23.62.237.16",443,15,5335,8,1307,7,4028,7617.35328,15.371330999999373,680.2273661272682,2096.370184208597
"10.0.2.109",51129,"23.62.237.9",443,84,61967,28,3944,56,58023,7617.461541,51.498281000000134,612.6806446219034,9013.58241452756
"10.0.2.109",51130,"23.62.237.9",443,70,51245,24,3754,46,47491,7618.531683,50.42782999999963,595.5441667825131,7534.09377322012
"10.0.2.109",51131,"194.247.12.49",38925,22,7260,11,4963,11,2297,7626.84491,3.977545000000646,9982.036658288858,4619.935161009371
"10.0.2.109",51132,"217.69.128.168",443,20,6919,9,1987,11,4932,7626.975549,3.846889999999803,4132.169102833929,10256.596887356285
"10.0.2.109",51133,"194.247.12.49",38925,25,7389,12,4991,13,2398,7628.824398,6.671666000000187,5984.712064422722,2875.4437047657157
"10.0.2.109",51134,"194.247.12.49",38925,24,6023,11,4340,13,1683,7628.887006,40.07547599999998,866.3652553995869,335.9660656307615
"10.0.2.109",51135,"193.0.170.53",443,23,7036,11,2076,12,4960,7628.95183,6.5442119999997885,2537.8150952323267,6063.373252578199
"10.0.2.109",51136,"217.20.147.94",443,19,5530,10,1329,9,4201,7629.015425,39.946867000000566,266.15353839888996,841.3175431254602
"10.0.2.109",51137,"194.247.12.49",38925,76,62297,53,59438,23,2859,7648.039527,20.919864999999845,22729.783390093748,1093.314894718497
"10.0.2.109",51138,"195.113.232.90",443,71,61764,21,2519,50,59245,7649.20439,19.75474099999974,1020.1095524360591,23992.21533706801
"10.0.2.109",51139,"194.247.12.49",38925,21,7750,10,5140,11,2610,7664.843356,1.1154079999996611,36865.43399367092,18719.607533751187
"10.0.2.109",51140,"217.69.139.58",443,20,7455,9,2292,11,5163,7664.974357,0.9842660000003889,18629.110423394442,41964.26575741078
"10.0.2.109",51141,"194.247.12.49",38925,19,10136,11,8530,8,1606,7666.52437,0.6316610000003493,108032.63142724066,20340.024158516822
"10.0.2.109",51142,"91.185.213.10",80,16,9930,7,1520,9,8410,7666.654138,0.0828190000001996,146826.21137626262,812373.97215419
"10.0.2.109",51143,"194.247.12.49",38925,12,2165,6,987,6,1178,7667.36778,1.575397000000521,5012.069973471695,5981.9842236572
"10.0.2.109",51144,"194.247.12.49",38925,13,2194,7,764,6,1430,7667.428348,1.485168999999587,4115.356568849538,7702.827085673874
"10.0.2.109",51145,"91.185.202.180",80,8,1912,5,1099,3,813,7667.49701,1.4457999999995081,6081.062387607547,4498.547516947166
"10.0.2.109",51146,"194.247.12.49",38925,12,1412,6,596,6,816,7667.519822,1.4244360000002416,3347.2897343223503,4582.866481891003
"10.0.2.109",51147,"91.185.213.10",80,10,1988,5,1344,5,644,7667.558711,1.0890630000003512,9872.70708856745,4730.672146605237
"10.0.2.109",51148,"5.10.88.212",80,8,1145,5,723,3,422,7667.645051,1.29888899999969,4453.036402649788,2599.144345668341
"10.0.2.109",51149,"194.247.12.49",38925,74,46867,43,42744,31,4123,7669.14604,68.07820400000037,5022.929218285461,484.5016181684203
"10.0.2.109",51150,"194.247.12.49",38925,65,44693,38,40746,27,3947,7669.207047,68.00733899999977,4793.129753246206,464.3028306106802
"10.0.2.109",51151,"194.247.12.49",38925,15,2953,7,1374,8,1579,7669.302393,68.06580399999984,161.4907832426401,185.5851140757851
"10.0.2.109",51152,"194.247.12.49",38925,41,25580,21,16926,20,8654,7669.402304,67.96318799999972,1992.3726944651355,1018.6691065757582
"10.0.2.109",51153,"88.85.84.123",80,12,2758,7,1504,5,1254,7669.427194,67.9406310000004,177.09579412060407,147.65832834257813
"10.0.2.109",51154,"194.247.12.49",38925,16,3514,8,1271,8,2243,7669.502869,67.86450400000012,149.8279571895196,264.40921162556447
"10.0.2.109",51155,"88.85.84.106",80,37,25330,17,8470,20,16860,7669.526328,67.83865100000003,998.8406166862011,1988.2470835099587
"10.0.2.109",51156,"104.31.92.48",80,65,46347,22,3615,43,42732,7669.547113,67.67662000000018,427.32630559859405,5051.3160970509325
"10.0.2.109",51157,"194.247.12.49",38925,12,1632,6,648,6,984,7669.60289,0.44513800000004267,11645.826687453111,17684.403488354725
"10.0.2.109",51158,"62.161.94.220",80,10,1487,5,905,5,582,7669.727872,0.07525299999997515,96208.78901840978,61871.28752344143
"10.0.2.109",51159,"194.247.12.49",38925,16,2645,8,1344,8,1301,7669.823515,67.54131400000006,159.1914542852985,154.0982753163492
"10.0.2.109",51160,"194.247.12.49",38925,17,2264,9,915,8,1349,7669.884353,67.48170399999981,108.47384648141103,159.9248294026486
"10.0.2.109",51161,"173.194.113.101",80,12,3253,7,2156,5,1097,7669.914874,67.45219499999985,255.7070233222216,130.10695945476675
"10.0.2.109",51162,"194.247.12.49",38925,12,2070,6,1238,6,832,7669.945631,26.495845000000372,373.79445720639825,251.20919902724017
"10.0.2.109",51163,"128.199.53.58",80,11,1461,6,739,5,722,7669.969734,15.033403999999791,393.25757493113883,384.2110542628988
"10.0.2.109",51164,"62.152.53.218",80,11,1250,6,769,5,481,7670.282836,16.113730000000032,381.786215854429,238.8025615422371
"10.0.2.109",51165,"104.28.16.59",80,57,44223,19,3489,38,40734,7670.61256,66.60154899999998,419.08935181072155,4892.859173590694
"10.0.2.109",51166,"88.85.84.123",80,8,1823,5,759,3,1064,7671.074126,25.366980999999214,239.36628485668783,335.5543176383608
"10.0.2.109",51167,"194.247.12.49",38925,19,9142,11,8257,8,885,7671.364088,65.99772099999973,1000.883045643353,107.2764315604175
"10.0.2.109",51168,"8.254.199.45",80,18,9049,8,858,10,8191,7671.490382,22.651364000000285,303.0281090357258,2892.894220409825
"10.0.2.109",51169,"194.247.12.49",38925,13,1095,7,457,6,638,7672.2138,2.741067999999359,1333.786684606458,1862.047931682539
"10.0.2.109",51170,"194.247.12.49",38925,18,8528,10,7630,8,898,7672.274326,65.09086300000035,937.7660271611343,110.36879323600243
"10.0.2.109",51171,"194.247.12.49",38925,18,7525,10,6627,8,898,7672.366718,64.99654499999997,815.6741254477454,110.52895196198511
"10.0.2.109",51172,"178.79.215.17",80,16,8377,7,813,9,7564,7672.426573,3.308620000000701,1965.7742502912458,18289.196099880668
"10.0.2.109",51173,"194.247.12.49",38925,45,24299,24,16653,21,7646,7672.490084,64.87683800000013,2053.4909546608874,942.8326331193865
"10.0.2.109",51174,"178.79.215.7",80,16,7374,7,813,9,6561,7672.51247,3.185557000000699,2041.7151537387567,16476.867310799487
"10.0.2.109",51175,"88.85.84.114",80,34,23671,15,7300,19,16371,7673.632816,63.73367099999996,916.31313689745,2054.9263512531716
"10.0.2.109",51176,"194.247.12.49",38925,16,3466,8,761,8,2705,7676.529801,18.624072000000524,326.88877061900473,1161.9370887311534
"10.0.2.109",51177,"194.247.12.49",38925,16,3470,8,761,8,2709,7676.590475,18.570958000000246,327.8236911633702,1166.9834157182258
"10.0.2.109",51178,"8.37.70.6",80,11,3162,6,2575,5,587,7676.74229,0.5291879999995217,38927.56449507287,8873.972954799134
"10.0.2.109",51179,"8.21.199.10",80,11,3166,6,2579,5,587,7676.782692,0.3447869999999966,59839.84314953929,13620.003074361986
"10.0.2.109",51180,"194.247.12.49",38925,15,4103,7,1076,8,3027,7680.924958,56.44131800000014,152.5123846328319,429.0473868806526
"10.0.2.109",51181,"173.194.122.3",80,12,3900,7,2944,5,956,7681.079846,56.28582000000006,418.4357623287708,135.87791738665248
"10.0.2.109",51182,"194.247.12.49",38925,67,24296,28,7800,39,16496,7681.164243,57.80298700000003,1079.5289869708631,2283.0654062911995
"10.0.2.109",51183,"216.58.211.42",443,60,23657,30,15780,30,7877,7681.325,57.64202000000023,2190.068980927447,1093.2302511258235
"10.0.2.109",51184,"194.247.12.49",38925,18,2168,8,694,10,1474,7681.460295,11.06503100000009,501.7609078546599,1065.6996803714246
"10.0.2.109",51185,"216.58.211.42",443,12,1583,7,1082,5,501,7681.62061,10.904301999999916,793.8151382821263,367.5613533080825
"10.0.2.109",51186,"194.247.12.49",38925,27,18036,17,16338,10,1698,7694.684109,0.8600780000006125,151967.6122397119,15793.916365713721
"10.0.2.109",51187,"91.185.213.10",80,25,17884,9,1612,16,16272,7694.814357,0.10911200000009558,118190.48317314964,1193049.343792488
"10.0.2.109",51188,"194.247.12.49",38925,12,1410,6,596,6,814,7695.467368,41.75512200000048,114.18958373537849,155.9569146989901
"10.0.2.109",51189,"194.247.12.49",38925,12,2137,6,710,6,1427,7695.529005,0.5048329999999623,11251.245461371233,22613.41869489683
"10.0.2.109",51190,"5.10.88.212",80,11,1305,6,775,5,530,7695.593378,9.600726000000577,645.7844958807935,441.6332681507362
"10.0.2.109",51191,"194.247.12.49",38925,7,1229,4,232,3,997,7695.620698,0.1238920000005237,14980.789720015455,64378.65237437676
"10.0.2.109",51192,"91.185.213.10",80,10,1985,5,1341,5,644,7695.662088,0.12165300000015122,88185.24820585325,42349.96259848582
"10.0.2.109",51193,"194.247.12.49",38925,13,3421,7,1995,6,1426,7695.720463,0.6136380000007193,26008.819532006313,18590.76523941905
"10.0.2.109",51194,"91.185.213.10",80,11,3269,5,1340,6,1929,7695.852444,0.059882999999899766,179015.7473743457,257702.5199142633
"10.0.2.109",51195,"128.199.53.58",80,11,1458,6,736,5,722,7696.632577,15.250457000000097,386.08679071059726,378.7427484959935
"10.0.2.109",51196,"62.152.53.250",80,11,1246,6,766,5,480,7696.634591,10.37764100000004,590.5002880712464,370.0262901751935
"10.0.2.109",51197,"194.247.12.49",38925,12,1630,6,648,6,982,7696.644414,0.46977399999923364,11035.093470495296,16722.9348580654
"10.0.2.109",51198,"62.161.94.220",80,10,1485,5,903,5,582,7696.793451,0.07451800000035291,96943.02047781459,62481.54808204661
"10.0.2.109",51199,"194.247.12.49",38925,12,2067,6,1238,6,829,7696.923005,40.304574000000684,245.72893389221363,164.54708093428522
"10.0.2.109",51200,"88.85.84.123",80,8,1820,5,756,3,1064,7697.056198,40.170876999999564,150.55683250330995,211.89480130095473
"10.0.2.109",51201,"194.247.12.49",38925,13,1099,7,457,6,642,7698.803685,2.7397110000001703,1334.4473194434643,1874.6502824566828
"10.0.2.109",51202,"194.247.12.49",38925,16,3478,8,761,8,2717,7703.164223,57.48310600000059,105.90937796576159,378.1284887424103
"10.0.2.109",51203,"194.247.12.49",38925,16,3473,8,761,8,2712,7703.264297,57.34020099999998,106.1733285518131,378.3732812516651
"10.0.2.109",51204,"8.37.70.22",80,11,3174,6,2587,5,587,7703.357427,0.5326900000000023,38851.86506223115,8815.633858341585
"10.0.2.109",51205,"8.21.199.3",80,11,3169,6,2582,5,587,7703.464872,0.3376690000004601,61172.33148429929,13907.1102173833
"10.0.2.109",51206,"194.247.12.49",38925,12,2765,6,1267,6,1498,7709.38475,0.475680999999895,21308.397854869625,25193.354369845852
"10.0.2.109",51207,"194.247.12.49",38925,12,2770,6,1272,6,1498,7709.446485,0.4668099999998958,21799.018872779656,25672.1149932578
"10.0.2.109",51208,"91.185.213.10",80,10,2613,5,1412,5,1201,7709.51026,0.06737900000007357,167648.67391899056,142596.35791551534
"10.0.2.109",51209,"91.185.213.10",80,10,2618,5,1412,5,1206,7709.572258,0.07169100000010076,157565.10580106464,134577.56203688664
"10.0.2.109",51210,"194.247.12.49",38925,12,2451,6,952,6,1499,7716.125116,0.4463260000002265,17063.76056961982,26868.253249853056
"10.0.2.109",51211,"91.185.213.10",80,10,2299,5,1413,5,886,7716.253525,0.07278299999961746,155310.9929524671,97385.37845427166
"10.0.2.109",51212,"194.247.12.49",38925,26,4092,11,1176,15,2916,7721.784136,17.181840000000193,547.5548602477903,1357.7125616348271
"10.0.2.109",51213,"173.194.122.4",443,20,3515,10,2424,10,1091,7721.939147,17.026652999999897,1138.9202563768768,512.6080856877775
"10.0.2.109",51214,"194.247.12.49",38925,23,7858,11,5194,12,2664,7724.832814,1.1403029999992214,36439.43758810454,18689.76929817299
"10.0.2.109",51215,"217.69.139.58",443,20,7455,9,2292,11,5163,7724.984111,0.9888980000005176,18541.85163686285,41767.70506157195
"10.0.2.109",51216,"194.247.12.49",38925,24,15491,15,13839,9,1652,7725.103469,0.8268109999999069,133902.42751972636,15984.305965935973
"10.0.2.109",51217,"91.185.213.10",80,21,15285,8,1566,13,13719,7725.228361,0.055438999999751104,225978.10205913248,1979689.3883456183
"10.0.2.109",51218,"194.247.12.49",38925,31,16417,16,12765,15,3652,7729.343006,3.5923940000002403,28426.726021698392,8132.738224147475
"10.0.2.109",51219,"194.247.12.49",38925,25,6708,11,1819,14,4889,7729.403831,3.813622000000578,3815.795063065452,10255.86699468224
"10.0.2.109",51220,"94.100.181.216",443,30,16130,12,3288,18,12842,7729.471589,3.4638670000003913,7593.8250515961,29659.337382176738
"10.0.2.109",51221,"194.247.12.49",38925,20,7696,10,5140,10,2556,7729.499503,1.0759189999998853,38218.49042539855,19005.148157065894
"10.0.2.109",51222,"94.100.180.77",443,26,6529,13,4633,13,1896,7729.528749,3.688723999999638,10047.919009392852,4111.991029960899
"10.0.2.109",51223,"94.100.180.59",443,18,7347,8,2238,10,5109,7729.629938,0.9454150000001391,18937.715183276516,43231.80825351193
"10.0.2.109",51224,"194.247.12.49",38925,18,1963,9,667,9,1296,7731.04358,7.500943000000007,711.3772228371813,1382.2262080914347
"10.0.2.109",51225,"194.247.12.49",38925,18,2178,8,694,10,1484,7731.104431,6.259724999999889,886.9399214821894,1896.5689387313676
"10.0.2.109",51226,"94.100.180.77",443,10,1298,6,932,4,366,7731.173867,7.370437999999922,1011.6088080518524,397.26268642379614
"10.0.2.109",51227,"194.247.12.49",38925,72,49439,45,45789,27,3650,7731.201333,7.764291999999841,47179.06024142414,3760.8065229901963
"10.0.2.109",51228,"173.194.122.26",443,12,1583,7,1082,5,501,7731.265013,6.098903999999493,1419.2713969593094,657.1672549691442
"10.0.2.109",51229,"173.194.122.26",443,60,48524,17,2874,43,45650,7731.326808,7.6385980000004565,3009.9764380844003,47809.82059796551
"10.0.2.109",51230,"194.247.12.49",38925,113,101758,80,97920,33,3838,7731.472975,7.492146000000503,104557.49260625026,4098.158257994163
"10.0.2.109",51231,"173.194.122.10",443,109,101279,29,3390,80,97889,7731.632207,7.332655000000159,3698.5239316454154,106797.87880378704
"10.0.2.109",51232,"194.247.12.49",38925,21,2996,10,1050,11,1946,7731.824283,5.539361000000099,1516.4203957820857,2810.4324668494655
"10.0.2.109",51233,"194.247.12.49",38925,20,5821,10,3967,10,1854,7731.886282,3.628711999999723,8745.802918501777,4087.400708571287
"10.0.2.109",51234,"194.247.12.49",38925,27,7937,13,4836,14,3101,7731.982643,6.969868999999562,5550.749949533116,3559.320842328824
"10.0.2.109",51235,"217.69.136.175",443,20,7314,11,2725,9,4589,7732.132182,6.820117999999638,3196.4256336915514,5382.898067159827
"10.0.2.109",51236,"194.247.12.49",38925,134,85308,70,62616,64,22692,7732.995122,29.404104999999618,17035.988682532814,6173.831851029044
"10.0.2.109",51237,"194.247.12.49",38925,27,4129,12,1148,15,2981,7733.243312,5.721394000000146,1605.2032074700267,4168.214949014067
"10.0.2.109",51238,"194.226.130.228",443,19,5518,9,1582,10,3936,7733.282194,2.232702999999674,5668.465532586219,14103.084915461035
"10.0.2.109",51239,"31.13.93.3",443,115,84037,42,21290,73,62747,7734.122687,28.276356000000305,6023.406976485872,17752.499650237627
"10.0.2.109",51240,"173.194.122.26",443,20,3498,10,2489,10,1009,7734.397115,4.567450000000463,4359.54416578134,1767.288092918189
"10.0.2.109",51241,"88.212.196.77",443,14,2365,8,1570,6,795,7734.952086,2.411369999999806,5208.657319283648,2637.5048209111465
"10.0.2.109",51242,"194.247.12.49",38925,161,146817,114,140678,47,6139,7737.488958,24.903392000000167,45191.59478355368,1972.1008286742492
"10.0.2.109",51243,"194.247.12.49",38925,79,53723,49,49469,30,4254,7737.551327,24.840562999999747,15931.683996051299,1370.017257660398
"10.0.2.109",51244,"31.13.64.7",443,138,145312,32,5097,106,140215,7737.614083,24.777988999999252,1645.6541327870164,45270.82484377702
"10.0.2.109",51245,"194.247.12.49",38925,19,2100,10,764,9,1336,7737.650812,24.73609899999974,247.0882737007183,432.08106500544454
"10.0.2.109",51246,"194.247.12.49",38925,87,60630,54,56202,33,4428,7737.751462,24.64306099999976,18245.13602429521,1437.4837606415997
"10.0.2.109",51247,"194.247.12.49",38925,18,2106,8,722,10,1384,7737.851097,13.461620000000039,429.07168676578175,822.4864466535207
"10.0.2.109",51248,"23.62.237.8",443,76,59763,22,3592,54,56171,7737.91308,24.481198999999833,1173.7987179467882,18355.636911411206
"10.0.2.109",51249,"194.247.12.49",38925,113,86648,71,81412,42,5236,7737.951043,24.442667999999685,26645.863700313254,1713.7245410362134
"10.0.2.109",51250,"194.247.12.49",38925,77,57046,50,53488,27,3558,7738.051825,24.345691000000443,17576.169844593536,1169.159667721055
"10.0.2.109",51251,"194.247.12.49",38925,18,2033,9,703,9,1330,7738.151653,3.152125000000524,1784.193202997681,3375.500654319937
"10.0.2.109",51252,"194.247.12.49",38925,17,1976,8,640,9,1336,7738.251695,1.1325319999996282,4520.843561154723,9437.260933910484
"10.0.2.109",51253,"194.247.12.49",38925,21,2268,11,884,10,1384,7738.352081,22.957358999999997,308.0493710099668,482.28544058573993
"10.0.2.109",51254,"23.62.237.8",443,10,1325,6,932,4,393,7738.381066,1.0028160000001662,7435.062862976622,3135.1713574568803
"10.0.2.109",51255,"23.62.237.22",443,111,86267,31,4400,80,81867,7738.40765,23.985834000000068,1467.5328779478712,27305.116845217814
"10.0.2.109",51256,"194.247.12.49",38925,101,70022,59,65103,42,4919,7738.451645,23.943240999999944,21752.443622816194,1643.5536024550768
"10.0.2.109",51257,"23.62.237.17",443,70,52964,23,3634,47,49330,7738.541072,23.850561999999627,1218.9230593392497,16546.360626638743
"10.0.2.109",51258,"194.247.12.49",38925,22,5698,11,4275,11,1423,7738.551745,22.189062000000376,1541.2999431881988,513.0455717325864
"10.0.2.109",51259,"31.13.64.7",443,12,1446,7,990,5,456,7738.55993,2.7438389999997526,2886.466735111176,1329.5240719299964
"10.0.2.109",51260,"194.247.12.49",38925,19,2084,10,748,9,1336,7738.652344,22.650061999999707,264.19353730687703,471.8750880240477
"10.0.2.109",51261,"23.62.237.17",443,15,5047,8,1019,7,4028,7738.698843,22.041771999999582,369.84322313106924,1461.9514256839518
"10.0.2.109",51262,"194.247.12.49",38925,20,2222,10,838,10,1384,7738.751926,22.552010999999766,297.268389945361,490.9539996233646
"10.0.2.109",51263,"31.13.91.6",443,12,1519,7,990,5,529,7738.760485,22.548585999999887,351.24153683073695,187.68360907420188
"10.0.2.109",51264,"194.247.12.49",38925,18,2030,9,694,9,1336,7738.852925,8.438325999999506,657.9504039071642,1266.6019302881432
"10.0.2.109",51265,"23.62.237.22",443,92,69263,27,3867,65,65396,7738.88951,23.505027000000155,1316.1439891134692,22257.706830117513
"10.0.2.109",51266,"194.247.12.49",38925,42,17424,24,14951,18,2473,7738.952783,23.444484000000557,5101.754425475824,843.8658748044755
"10.0.2.109",51267,"194.247.12.49",38925,24,6102,13,4391,11,1711,7739.052659,16.948660000000018,2072.6122301114046,807.6154693055372
"10.0.2.109",51268,"194.247.12.49",38925,53,34879,33,31754,20,3125,7739.152468,23.240646000000197,10930.505115907616,1075.701596246498
"10.0.2.109",51269,"23.62.237.23",443,69,56341,24,3154,45,53187,7739.209452,23.1878829999996,1088.1545331240645,18349.928710611803
"10.0.2.109",51270,"194.247.12.49",38925,21,2268,11,884,10,1384,7739.253344,22.049980000000687,320.72591449061537,502.1319747228639
"10.0.2.109",51271,"194.247.12.49",38925,17,1976,8,640,9,1336,7739.353106,21.954415000000154,233.21049547437107,486.8269093027496
"10.0.2.109",51272,"194.247.12.49",38925,63,46302,42,43553,21,2749,7739.452863,22.942485999999917,15186.845924195019,958.5709238310129
"10.0.2.109",51273,"194.247.12.49",38925,10,568,6,348,4,220,7739.553795,3.126516000000265,890.4480258536223,562.9269128959681
"10.0.2.109",51274,"23.62.237.17",443,45,34174,14,2559,31,31615,7739.599619,22.79331000000002,898.1582753886988,11096.238326070228
"10.0.2.109",51275,"195.113.232.90",443,56,45661,18,2355,38,43306,7739.631715,22.763403999999355,827.644231064938,15219.516378130873
"10.0.2.109",51276,"194.247.12.49",38925,23,6040,12,4329,11,1711,7739.653927,21.650697999999466,1599.578914268762,632.2198018743017
"10.0.2.109",51277,"194.247.12.49",38925,19,2092,10,756,9,1336,7739.753919,21.55183600000055,280.6257434401341,495.92062597357034
"10.0.2.109",51278,"194.247.12.49",38925,19,2092,10,756,9,1336,7739.853644,21.453276000000187,281.9149858511095,498.1989697051353
"10.0.2.109",51279,"31.13.91.6",443,12,1519,7,990,5,529,7739.940557,11.37178700000004,696.4604595566178,372.1490738438897
"10.0.2.109",51280,"194.247.12.49",38925,9,506,5,286,4,220,7739.954183,0.12183600000025763,18779.342722964986,14445.648248434603
"10.0.2.109",51281,"23.62.237.22",443,31,16557,13,1961,18,14596,7739.960404,22.436656999999286,699.2128996757627,5204.340379228675
"10.0.2.109",51282,"23.62.237.9",443,15,5335,8,1307,7,4028,7740.103189,21.201043999999456,493.18326022059426,1519.9251508558177
"10.0.2.109",51283,"23.62.237.8",443,10,1325,6,932,4,393,7740.300141,6.990819999999985,1066.5415502044132,449.7326493887708
"10.0.2.109",51284,"194.247.12.49",38925,18,2030,9,694,9,1336,7740.333446,20.975334000000657,264.6918518675233,509.55088486312854
"10.0.2.109",51285,"194.247.12.49",38925,9,506,5,286,4,220,7740.42482,0.4058209999993778,5637.953679093757,4336.887445456737
"10.0.2.109",51286,"194.247.12.49",38925,68,48624,45,45281,23,3343,7740.525531,21.871414000000186,16562.623705993446,1222.7833097576486
"10.0.2.109",51287,"23.62.237.17",443,10,1325,6,932,4,393,7740.614093,20.68764800000008,360.40829774365704,151.97474357645623
"10.0.2.109",51288,"194.247.12.49",38925,18,2030,9,694,9,1336,7740.625047,20.685072999999647,268.40611101542135,516.7011013207535
"10.0.2.109",51289,"23.62.237.8",443,57,47757,18,2831,39,44926,7740.691917,21.7048420000001,1043.4538062981476,16558.885800689004
"10.0.2.109",51290,"23.62.237.16",443,10,1325,6,932,4,393,7741.065347,20.244466000000102,368.29818084606245,155.30170072156926
"10.0.2.109",51291,"31.13.91.6",443,12,1519,7,990,5,529,7741.214013,20.089069999999992,394.24423330696754,210.66181759533924
"10.0.2.109",51292,"23.62.237.22",443,10,1325,6,932,4,393,7741.335487,19.971614000000045,373.3298670803463,157.42343107572543
"10.0.2.109",51293,"23.62.237.17",443,10,1325,6,932,4,393,7741.494518,19.813938999999664,376.3007446424523,158.67617236532593
"10.0.2.109",51294,"194.247.12.49",38925,19,2084,10,748,9,1336,7741.511399,19.78938300000027,302.3843643836656,540.0875813055846
"10.0.2.109",51295,"194.247.12.49",38925,17,1893,8,593,9,1300,7742.123434,19.184784999999465,247.27928929097368,542.0962497103976
"10.0.2.109",51296,"23.62.237.9",443,16,5397,9,1369,7,4028,7742.502827,13.498295999999755,811.3616711324303,2387.264288766566
"10.0.2.109",51297,"23.62.237.14",443,10,1325,6,932,4,393,7742.681132,18.619236000000456,400.4460763051619,168.85762659648995
"10.0.2.109",51298,"23.62.237.23",443,10,1325,6,932,4,393,7743.014742,18.291615000000093,407.6184634325598,171.88203447317167
"10.0.2.109",51299,"23.62.237.9",443,10,1325,6,932,4,393,7743.193102,18.112223000000085,411.6557089651538,173.58443521813888
"10.0.2.109",51300,"23.62.237.22",443,10,1242,6,896,4,346,7743.550659,17.75723299999936,403.66649466165467,155.88014191175503
"10.0.2.109",51301,"31.13.64.7",443,12,1519,7,990,5,529,7745.886293,15.417421000000104,513.704594302766,274.4946771577407
"10.0.2.109",51302,"194.247.12.49",38925,141,88755,44,2766,97,85989,7747.508746,7.602479999999559,2910.6291631153626,90485.21008934452
"10.0.2.109",51303,"91.185.213.10",80,120,87577,67,84337,53,3240,7747.63496,7.205371999999443,93637.9134901088,3597.3160025605903
"10.0.2.109",51304,"23.62.237.24",443,10,1325,6,932,4,393,7752.864424,9.522173999999723,783.0144670744535,330.1767012449144
"10.0.2.109",51305,"194.247.12.49",38925,26,4299,11,1375,15,2924,7754.848985,7.545121000000108,1457.89577132028,3100.281625702181
"10.0.2.109",51306,"173.194.122.0",443,20,3724,10,2434,10,1290,7755.003737,7.390164999999797,2634.8532136969247,1396.4505528632017
"10.0.2.109",51307,"194.247.12.49",38925,12,2765,6,1058,6,1707,7755.368069,0.4525869999997667,18701.37675188276,30173.204267924266
"10.0.2.109",51308,"91.185.213.10",80,12,2721,6,1675,6,1046,7755.492745,0.08804700000018784,152191.44320614458,95040.14901112074
"10.0.2.109",51309,"194.247.12.49",38925,13,4219,7,2704,6,1515,7756.0452,0.6710320000001957,32236.91269565936,18061.731780297312
"10.0.2.109",51310,"91.185.213.10",80,11,4067,5,1429,6,2638,7756.176019,0.0536099999999351,213243.79779917627,393657.8996460651
"10.0.2.109",51311,"194.247.12.49",38925,26,6033,11,2055,15,3978,7756.18919,6.2034969999995155,2650.11815110111,5130.009734832222
"10.0.2.109",51312,"173.194.122.0",443,20,5458,11,3542,9,1916,7756.339539,6.052969000000303,4681.339025525916,2532.311003079519
"10.0.2.109",51313,"194.247.12.49",38925,20,6382,9,859,11,5523,7759.184232,0.7476940000005925,9190.925699543603,59093.69340928908
"10.0.2.109",51314,"91.185.213.10",80,16,6122,8,5329,8,793,7759.308882,0.3655319999998028,116630.00776956053,17355.525644822952
"10.0.2.109",51315,"194.247.12.49",38925,21,11293,12,9623,9,1670,7760.123982,2.6278169999995953,29295.79951724639,5084.067878395664
"10.0.2.109",51316,"91.185.213.10",80,17,11033,7,1530,10,9503,7760.248878,0.09125499999936437,134129.63673316812,833094.0770426776
"10.0.2.109",51317,"194.247.12.49",38925,35,7482,15,1818,20,5664,7760.843035,122.76513700000032,118.47011582775298,369.0950143280489
"10.0.2.109",51318,"194.247.12.49",38925,12,2173,6,987,6,1186,7760.944358,1.4408730000004653,5480.011076616364,6584.896795204669
"10.0.2.109",51319,"194.247.12.49",38925,12,2140,6,710,6,1430,7761.00552,0.5572019999999611,10193.789684890571,20531.153872385235
"10.0.2.109",51320,"173.194.122.1",443,26,6741,13,5062,13,1679,7761.007294,122.60061599999972,330.30829143631786,109.5589927541639
"10.0.2.109",51321,"91.185.202.180",80,8,1920,5,1107,3,813,7761.09617,1.2885800000003655,6872.681556440025,5047.41653603048
"10.0.2.109",51322,"91.185.213.10",80,10,1988,5,1344,5,644,7761.13566,0.1015399999996589,105889.30470786014,50738.62517251632
"10.0.2.109",51323,"194.247.12.49",38925,12,1436,6,596,6,840,7761.761707,0.6232200000004013,7650.588877117117,10782.709155668419
"10.0.2.109",51324,"194.247.12.49",38925,11,1783,6,340,5,1443,7761.822571,1.1544960000001083,2356.006430511448,9999.168468317705
"10.0.2.109",51325,"5.10.88.212",80,8,1169,5,747,3,422,7761.891519,0.4929360000005545,12123.27766686401,6848.759270972707
"10.0.2.109",51326,"91.185.213.10",80,12,4633,6,1465,6,3168,7761.952683,1.2928299999994124,9065.383693142428,19603.50548796943
"10.0.2.109",51327,"194.247.12.49",38925,40,22421,24,20953,16,1468,7762.563046,3.280240999999478,51101.12336259033,3580.2247456823657
"10.0.2.109",51328,"194.247.12.49",38925,27,14472,14,9414,13,5058,7762.624155,10.18059699999958,7397.601535548761,3974.619563076868
"10.0.2.109",51329,"194.247.12.49",38925,40,23232,24,20999,16,2233,7762.716821,3.6774569999997766,45681.56745272894,4857.704658409625
"10.0.2.109",51330,"194.247.12.49",38925,13,1795,7,884,6,911,7762.81686,9.989746000000196,707.925907225255,729.5480785997819
"10.0.2.109",51331,"104.28.17.59",80,35,22924,13,2045,22,20879,7762.884336,3.5096160000002783,4661.478634699267,47592.671107034716
"10.0.2.109",51332,"194.247.12.49",38925,13,1614,7,842,6,772,7762.916705,4.174555999999939,1613.584774045455,1479.4387714526026
"10.0.2.109",51333,"88.85.84.123",80,8,1492,5,836,3,656,7762.966005,9.839669999999387,679.6975914843096,533.3512201120898
"10.0.2.109",51334,"104.31.92.48",80,31,21901,10,1122,21,20779,7763.039324,2.803704999999354,3201.4780442314964,59290.11789758134
"10.0.2.109",51335,"194.247.12.49",38925,12,1677,6,648,6,1029,7763.248494,2.093246999999792,2476.535258381125,3932.6462667811384
"10.0.2.109",51336,"128.199.53.58",80,8,1309,5,695,3,614,7763.462769,3.6281870000002527,1532.4458193581568,1353.844220267494
"10.0.2.109",51337,"194.247.12.49",38925,19,10427,11,8812,8,1615,7763.509934,1.6430890000001455,42904.55355735067,7863.238083876684
"10.0.2.109",51338,"91.185.213.10",80,16,10221,7,1529,9,8692,7763.638489,0.0549989999999525,222404.0437100777,1264313.896617394
"10.0.2.109",51339,"88.85.84.123",80,23,14222,11,4928,12,9294,7763.765488,9.038024999999834,4362.014931359531,8226.576049524245
"10.0.2.109",51340,"194.247.12.49",38925,12,2005,6,749,6,1256,7763.963672,8.840895999999702,677.7593583275045,1136.5363872621438
"10.0.2.109",51341,"194.247.12.49",38925,12,1343,6,547,6,796,7764.025056,2.576890999999705,1698.170392151046,2471.194939949237
"10.0.2.109",51342,"173.194.113.99",80,8,1744,5,1169,3,575,7764.109543,8.693653000000268,1075.7273150883423,529.121647712401
"10.0.2.109",51343,"194.247.12.49",38925,12,2054,6,1238,6,816,7764.118628,1.6147839999994176,6133.328048831034,4042.645951410439
"10.0.2.109",51344,"62.152.54.250",80,8,1098,5,725,3,373,7764.171569,2.4300849999999627,2386.747788657635,1227.940586440411
"10.0.2.109",51345,"88.85.84.106",80,8,1807,5,743,3,1064,7764.270337,1.462760000000344,4063.551095188959,5819.136427026989
"10.0.2.109",51346,"62.161.94.220",80,10,1532,5,950,5,582,7764.39267,0.07866000000012718,96618.35748776648,59191.45690303168
"10.0.2.109",51347,"194.247.12.49",38925,1127,1020610,740,870414,387,150196,7764.842912,118.7649679999995,58631.026617209456,10117.192133626517
"10.0.2.109",51348,"179.60.192.3",443,1111,1019501,305,145554,806,873947,7764.972844,118.63482000000022,9815.263343426474,58933.591335157646
"10.0.2.109",51349,"194.247.12.49",38925,170,147372,115,140790,55,6582,7765.823417,91.26826000000074,12340.76337162548,576.9366042477371
"10.0.2.109",51350,"194.247.12.49",38925,21,2268,11,884,10,1384,7765.883849,21.282130000000507,332.297566080079,520.2486781163228
"10.0.2.109",51351,"194.247.12.49",38925,18,2030,9,694,9,1336,7765.981032,6.8797700000004625,807.003722508111,1553.5403073066805
"10.0.2.109",51352,"194.247.12.49",38925,18,2106,8,722,10,1384,7766.081805,21.06858199999988,274.15228988832916,525.521841004775
"10.0.2.109",51353,"194.247.12.49",38925,18,2106,8,722,10,1384,7766.182016,6.680190000000039,864.646065456217,1657.4378872457125
"10.0.2.109",51354,"31.13.64.7",443,12,1519,7,990,5,529,7766.205994,20.944126999999753,378.1489674885992,202.0614179812818
"10.0.2.109",51355,"31.13.91.6",443,159,146515,45,5810,114,140705,7766.252401,90.8392160000003,511.6732843665212,12391.564453836723
"10.0.2.109",51356,"194.247.12.49",38925,40,19882,24,17630,16,2252,7766.281484,6.58033499999965,21433.55923368757,2737.8545317223147
"10.0.2.109",51357,"31.13.91.6",443,12,1519,7,990,5,529,7766.307631,6.5543360000001485,1208.3603892140745,645.6794402972176
"10.0.2.109",51358,"194.247.12.49",38925,18,2106,8,722,10,1384,7766.381928,20.770594999999958,278.08543761023753,533.0612820672698
"10.0.2.109",51359,"23.62.237.24",443,10,1325,6,932,4,393,7766.43456,6.425998000000618,1160.286697879346,489.26252389118355
"10.0.2.109",51360,"194.247.12.49",38925,40,18513,23,15825,17,2688,7766.48233,65.21328200000062,1941.3223214252398,329.7487772506189
"10.0.2.109",51361,"31.13.91.6",443,12,1519,7,990,5,529,7766.51096,20.641363000000638,383.69559219513536,205.02522047598646
"10.0.2.109",51362,"194.247.12.49",38925,48,26550,28,23688,20,2862,7766.582027,61.3870739999993,3087.0342508913545,372.977542470916
"10.0.2.109",51363,"23.62.237.17",443,37,18078,14,2284,23,15794,7766.643871,65.05166599999939,280.88442807906216,1942.3330372507476
"10.0.2.109",51364,"194.247.12.49",38925,19,2084,10,748,9,1336,7766.682867,6.181562999999187,968.0399601202458,1729.012549091776
"10.0.2.109",51365,"23.62.237.22",443,43,26007,15,2350,28,23657,7766.742258,61.22625100000005,307.0578337386685,3091.0924139385875
"10.0.2.109",51366,"23.62.237.6",443,30,19069,12,1794,18,17275,7766.748813,6.112838000000011,2347.845632421467,22608.156800490993
"10.0.2.109",51367,"194.247.12.49",38925,61,38163,38,35143,23,3020,7766.782481,63.48680499999955,4428.384764361696,380.55151775239233
"10.0.2.109",51368,"194.247.12.49",38925,55,34269,34,31356,21,2913,7766.882937,58.80746999999974,4265.580546144922,396.27618736191346
"10.0.2.109",51369,"23.62.237.24",443,56,37620,17,2454,39,35166,7766.930228,63.33892399999968,309.9515867999289,4441.628973678198
"10.0.2.109",51370,"194.247.12.49",38925,40,19395,24,17029,16,2366,7766.98308,63.52743600000031,2144.4592852763544,297.9500069859566
"10.0.2.109",51371,"23.62.237.23",443,47,33564,14,2293,33,31271,7767.043831,58.64649199999985,312.78938218504265,4265.694186789563
"10.0.2.109",51372,"194.247.12.49",38925,20,2214,10,830,10,1384,7767.082954,20.082745999999133,330.6320759123422,551.3190277863633
"10.0.2.109",51373,"23.62.237.23",443,10,1325,6,932,4,393,7767.109356,5.75482699999975,1295.6080174087465,546.3239815897397
"10.0.2.109",51374,"194.247.12.49",38925,19,2084,10,748,9,1336,7767.183312,5.680006999999932,1053.5198284086748,1881.6878218636223
"10.0.2.109",51375,"31.13.91.6",443,12,1519,7,990,5,529,7767.212705,19.952737999999954,396.93800419772055,212.10121638443854
"10.0.2.109",51376,"194.247.12.49",38925,20,9298,12,8400,8,898,7767.283366,5.51838300000054,12177.48025100712,1301.8306268338563
"10.0.2.109",51377,"31.13.91.6",443,12,1519,7,990,5,529,7767.308154,19.857528999999886,398.84116498080124,213.11815785337765
"10.0.2.109",51378,"23.62.237.22",443,11,1387,7,994,4,393,7767.308889,5.554213000000345,1431.7059860685042,566.05679328463
"10.0.2.109",51379,"194.247.12.49",38925,14,3066,7,394,7,2672,7767.383237,3.272817000000032,963.0847065387308,6531.376486983474
"10.0.2.109",51380,"23.62.237.15",443,36,18933,13,1962,23,16971,7767.443371,63.066978999999264,248.87826004794337,2152.758894634886
"10.0.2.109",51381,"194.247.12.49",38925,13,2461,7,754,6,1707,7767.483794,1.0896300000003976,5535.82408707341,12532.694584395636
"10.0.2.109",51382,"194.247.12.49",38925,11,1248,6,340,5,908,7767.584254,3.069488999999521,886.1409830758228,2366.5176842142564
"10.0.2.109",51383,"91.185.213.10",80,12,2363,6,1675,6,688,7767.617269,0.30613199999970675,43771.967647984646,17979.1723831722
"10.0.2.109",51384,"194.247.12.49",38925,21,10539,12,9599,9,940,7767.684313,5.117948000000069,15004.451002628193,1469.3388834743726
"10.0.2.109",51385,"178.79.215.17",80,18,9147,8,867,10,8280,7767.772251,4.920971999999892,1409.4776397833907,13460.755314194319
"10.0.2.109",51386,"194.247.12.49",38925,17,4236,9,1184,8,3052,7767.785581,5.021316999999726,1886.3577025709621,4862.46934818123
"10.0.2.109",51387,"8.254.199.45",80,16,10230,7,805,9,9425,7767.808929,4.992261000000326,1289.99665682535,15103.377006930343
"10.0.2.109",51388,"194.247.12.49",38925,33,8557,13,2101,20,6456,7767.88416,115.72036300000036,145.24669266721835,446.3173002663312
"10.0.2.109",51389,"173.194.122.4",80,12,3925,7,2969,5,956,7767.937859,4.86803400000008,4879.177096955283,1571.0654444894747
"10.0.2.109",51390,"194.247.12.49",38925,20,2276,10,802,10,1474,7767.98435,19.17745500000001,334.5595127194926,614.888680484454
"10.0.2.109",51391,"194.247.12.49",38925,20,8983,11,6630,9,2353,7768.084472,2.592361000000892,20460.1133869788,7261.334358908162
"10.0.2.109",51392,"194.247.12.49",38925,19,2622,10,1391,9,1231,7768.184515,4.61960900000031,2408.861875539522,2131.7821486622224
"10.0.2.109",51393,"104.31.92.48",80,14,2318,6,1047,8,1271,7768.311529,4.490990000000238,1865.067613154239,2264.088764392586
"10.0.2.109",51394,"104.31.92.48",80,6,944,4,832,2,112,7768.733744,1.9193740000000616,3467.7973130821747,466.8188690687543
"10.0.2.109",51395,"194.247.12.49",38925,19,10677,11,9035,8,1642,7768.804841,2.3557700000001205,30682.112430329067,5576.096138417302
"10.0.2.109",51396,"216.58.211.42",443,12,1583,7,1082,5,501,7769.127924,18.033681999999317,479.9907195879537,222.25078605689907
"10.0.2.109",51397,"216.58.211.42",443,27,7972,14,5902,13,2070,7769.350356,114.25366800000029,413.2558790147541,144.9406420807423
"10.0.2.109",51398,"8.21.199.10",80,7,2654,5,2542,2,112,7769.48601,1.1694350000007034,17389.59412022709,766.1819596638214
"10.0.2.109",51399,"88.85.84.106",80,14,8625,7,2223,7,6402,7769.529616,1.1464530000002924,15512.19282429848,44673.44060331033
"10.0.2.109",51400,"91.185.213.10",80,16,10471,7,1556,9,8915,7769.927924,0.07717500000035216,161295.7563970612,924133.4629047562
"10.0.2.109",51401,"194.247.12.49",38925,36,9531,17,6637,19,2894,7771.023952,293.943217,180.63352691686708,78.7635116615057
"10.0.2.109",51402,"194.247.12.49",38925,12,2153,6,710,6,1443,7771.285036,1.5181769999999233,3741.329238949271,7603.856467329292
"10.0.2.109",51403,"194.247.12.49",38925,12,1442,6,596,6,846,7771.765301,1.0423839999994016,4574.130071070485,6492.808792157099
"10.0.2.109",51404,"173.194.113.110",443,34,9164,15,2450,19,6714,7772.183705,292.7834299999995,66.94367915561354,183.45300483705682
"10.0.2.109",51405,"5.10.88.212",80,8,1175,5,753,3,422,7772.193448,0.6137380000000121,9815.263190481739,5500.718547653776
"10.0.2.109",51406,"91.185.213.10",80,10,2001,5,1357,5,644,7772.408375,0.10764199999994162,100852.82696350763,47862.35855895277
"10.0.2.109",51407,"194.247.12.49",38925,12,2192,6,987,6,1205,7772.808027,110.79748300000028,71.26515680866126,87.00558657997651
"10.0.2.109",51408,"194.247.12.49",38925,37,23542,22,21491,15,2051,7773.067585,2.603428000000349,66039.08385404818,6302.459680082491
"10.0.2.109",51409,"194.247.12.49",38925,13,2878,7,1548,6,1330,7773.161782,110.44771899999978,112.12544824035727,96.33517193777466
"10.0.2.109",51410,"194.247.12.49",38925,42,23077,25,20898,17,2179,7773.262176,2.3100949999998193,72371.04967545191,7546.010012575831
"10.0.2.109",51411,"194.247.12.49",38925,49,28387,27,20434,22,7953,7773.362011,110.24036999999953,1482.8687530711363,577.1388466856586
"10.0.2.109",51412,"104.28.17.59",80,38,22823,14,1991,24,20832,7773.411539,2.160399000000325,7372.712170297063,77141.30584210367
"10.0.2.109",51413,"194.247.12.49",38925,13,1806,7,892,6,914,7773.461886,110.14141000000018,64.78943750583898,66.38738327392021
"10.0.2.109",51414,"194.247.12.49",38925,12,1671,6,648,6,1023,7773.562407,1.6503969999994297,3141.0624231635124,4958.806881012767
"10.0.2.109",51415,"194.247.12.49",38925,13,2073,7,805,6,1268,7773.662342,109.94783700000062,58.57323050384305,92.26193326568074
"10.0.2.109",51416,"88.85.84.123",80,40,27867,17,7661,23,20206,7773.803323,71.84493500000008,853.0594397503447,2249.9567993206456
"10.0.2.109",51417,"173.194.113.97",80,8,1758,5,1181,3,577,7773.812386,109.79740800000036,86.04939016410997,42.04106530456516
"10.0.2.109",51418,"194.247.12.49",38925,13,1399,7,601,6,798,7773.82336,6.396727999999712,751.6342730221164,998.010232731529
"10.0.2.109",51419,"194.247.12.49",38925,13,1617,7,842,6,775,7773.884233,109.72163200000068,61.39172264590412,56.50663307669322
"10.0.2.109",51420,"91.185.202.180",80,11,2101,6,1180,5,921,7773.939417,14.768223000000035,639.2102827808043,498.9090427467125
"10.0.2.109",51421,"62.152.54.250",80,8,1100,5,727,3,373,7773.973898,6.245832999999948,931.1808368875775,477.75853116790427
"10.0.2.109",51422,"62.161.94.220",80,10,1526,5,944,5,582,7774.006055,0.07600800000000163,99357.96231975369,61256.70982001763
"10.0.2.109",51423,"128.199.53.58",80,11,1474,6,752,5,722,7774.016826,16.03454099999999,375.190035062432,360.222347493452
"10.0.2.109",51424,"104.31.92.48",80,32,23238,11,1813,21,21425,7774.190736,1.479855000000498,9800.960229208347,115822.15825195193
"10.0.2.109",51425,"194.247.12.49",38925,45,11363,21,8402,24,2961,7774.303656,244.1257889999997,275.3334675346408,97.03194446204137
"10.0.2.109",51426,"173.194.122.26",80,8,2563,5,1243,3,1320,7774.317874,109.28855699999986,90.98848290219453,96.62493759525084
"10.0.2.109",51427,"173.194.122.8",443,45,11092,21,2559,24,8533,7774.458089,243.97127900000032,83.91151648633188,279.8034271894763
"10.0.2.109",51428,"194.247.12.49",38925,17,2529,9,1333,8,1196,7774.783834,1.9605520000004617,5439.284446419931,4880.2582129919265
"10.0.2.109",51429,"104.28.16.59",80,12,2221,6,1062,6,1159,7774.948425,1.7954230000004827,4732.03250710151,5164.242632514737
"10.0.2.109",51430,"194.247.12.49",38925,13,3314,7,1700,6,1614,7775.006433,0.6766550000002098,20098.86869970041,19082.10240077439
"10.0.2.109",51431,"173.194.122.26",80,8,2996,5,1524,3,1472,7775.162887,0.5197619999999006,23456.889884220724,22656.523562711882
"10.0.2.109",51432,"194.247.12.49",38925,20,9108,12,8222,8,886,7775.303104,4.909701000000496,13397.149846801945,1443.6724354495893
"10.0.2.109",51433,"194.247.12.49",38925,17,6489,10,5658,7,831,7775.363883,1.8516490000001795,24445.237731338722,3590.3132829166625
"10.0.2.109",51434,"8.254.199.45",80,15,8799,7,805,8,7994,7775.433031,4.779437000000144,1347.4390393679855,13380.655503984692
"10.0.2.109",51435,"194.247.12.49",38925,18,3351,9,1543,9,1808,7775.490331,7.179374999999709,1719.3697222948376,2014.660050491942
"10.0.2.109",51436,"8.254.199.45",80,12,6180,6,750,6,5430,7775.494364,1.7207809999999881,3486.788847622121,25244.351256784157
"10.0.2.109",51437,"104.31.93.48",80,13,3047,7,1678,6,1369,7775.651059,7.018286999999873,1912.7174480040846,1560.4947475075041
"10.0.2.109",51438,"194.247.12.49",38925,13,1099,7,457,6,642,7775.762336,3.0272039999999834,1207.7151060846973,1696.6150943246732
"10.0.2.109",51439,"194.247.12.49",38925,15,4903,8,2509,7,2394,7776.024543,107.58468799999991,186.56930064248562,178.01789786293767
"10.0.2.109",51440,"173.194.122.19",80,10,4598,6,2317,4,2281,7776.171599,107.43453099999988,172.53298197020118,169.85227961762146
"10.0.2.109",51441,"88.85.84.123",80,11,1657,6,893,5,764,7776.894406,65.04588799999965,109.83015559723066,93.9644332321212
"10.0.2.109",51442,"194.247.12.49",38925,12,2536,6,792,6,1744,7776.924442,106.68304499999977,59.390880715862714,130.77991915210174
"10.0.2.109",51443,"194.247.12.49",38925,12,2057,6,1238,6,819,7777.396924,1.5636780000004364,6333.784832936983,4190.120983986582
"10.0.2.109",51444,"88.85.84.106",80,8,1810,5,746,3,1064,7777.522996,1.4372440000006463,4152.3916607043175,5922.446014731091
"10.0.2.109",51445,"173.194.122.24",80,8,2286,5,1668,3,618,7778.08124,105.52245699999912,126.45649446923048,46.852586080326404
"10.0.2.109",51446,"194.247.12.49",38925,78,58353,50,55040,28,3313,7779.712565,53.97631999999976,8157.65135526101,491.03014062463166
"10.0.2.109",51447,"23.62.237.6",443,75,57918,22,2747,53,55171,7779.878674,53.81026700000075,408.3978992336108,8202.300873177119
"10.0.2.109",51448,"194.247.12.49",38925,17,3539,8,761,9,2778,7780.483217,105.11688200000026,57.916481959577006,211.42179616781198
"10.0.2.109",51449,"8.37.70.23",80,11,3181,6,2594,5,587,7780.669284,0.5267410000005839,39396.97118693437,8915.197412000955
"10.0.2.109",51450,"194.247.12.49",38925,16,3481,8,761,8,2720,7780.764042,104.82805300000018,58.07605717908344,207.57802303167801
"10.0.2.109",51451,"8.21.198.137",80,11,3177,6,2590,5,587,7780.979999,0.3418899999996938,60604.28792892028,13735.411974624018
"10.0.2.109",51452,"194.247.12.49",38925,30,6502,13,2281,17,4221,7782.893669,100.7168730000003,181.1811611744533,335.27649334386996
"10.0.2.109",51453,"173.194.122.22",443,23,5881,12,3739,11,2142,7783.04424,100.56610699999965,297.4361928915087,170.39537982712267
"10.0.2.109",51454,"194.247.12.49",38925,21,7750,10,5140,11,2610,7789.822048,1.0333360000004177,39793.445694317605,20206.399467348045
"10.0.2.109",51455,"217.69.139.59",443,20,7455,9,2292,11,5163,7789.947996,0.907296000000315,20209.501640031074,45524.28314462498
"10.0.2.109",51456,"194.247.12.49",38925,19,4140,9,1697,10,2443,7791.302347,90.88182400000005,149.3808046810327,215.04850078713196
"10.0.2.109",51457,"217.69.139.200",443,18,3859,9,2193,9,1666,7791.44848,90.73564400000032,193.3529010936423,146.88825044323212
"10.0.2.109",51458,"194.247.12.49",38925,82,47092,45,38736,37,8356,7850.906072,32.70306900000014,9475.807912706867,2044.0895012024623
"10.0.2.109",51459,"194.247.12.49",38925,21,7750,11,5194,10,2556,7850.9664,1.338673000000199,31039.693786304666,15274.82813203595
"10.0.2.109",51460,"2.20.182.96",443,75,46445,29,7686,46,38759,7851.070814,32.53810599999997,1889.722776119792,9529.503653347256
"10.0.2.109",51461,"94.100.180.59",443,18,7347,8,2238,10,5109,7851.096311,1.2087759999994887,14811.677266927514,33812.71633455437
"10.0.2.109",51462,"194.247.12.49",38925,18,2026,9,694,9,1332,7851.921616,20.524884000000384,270.50091976158774,519.1746759689263
"10.0.2.109",51463,"194.247.12.49",38925,17,1972,8,640,9,1332,7851.981979,20.465288999999757,250.17970672195545,520.6865146150698
"10.0.2.109",51464,"194.247.12.49",38925,17,1972,8,640,9,1332,7852.075064,20.372895000000426,251.31430756404,523.0479026176582
"10.0.2.109",51465,"194.247.12.49",38925,17,1972,8,640,9,1332,7852.175477,20.27148699999998,252.5715059778301,525.6644468163589
"10.0.2.109",51466,"2.20.182.96",443,10,1325,6,932,4,393,7852.205193,20.242576000000554,368.33256794983976,155.3162008629689
"10.0.2.109",51467,"92.122.206.58",443,10,1325,6,932,4,393,7852.345898,20.100862000000234,370.92936611374745,156.41120266384414
"10.0.2.109",51468,"92.122.206.67",443,10,1325,6,932,4,393,7852.361942,20.084352999999282,371.2342638072666,156.53977003890105
"10.0.2.109",51469,"194.247.12.49",38925,17,1972,8,640,9,1332,7852.921312,19.523800999999366,262.24401693093296,545.7953602375043
"10.0.2.109",51470,"92.122.206.58",443,10,1325,6,932,4,393,7853.103195,19.343886000000566,385.44478601661433,162.5319752194522
"10.0.2.109",51471,"2.20.182.82",443,10,1325,6,932,4,393,7853.374036,19.070842000000084,390.96333554648334,164.85900307915014
"10.0.2.109",51472,"194.247.12.49",38925,17,1974,8,640,9,1334,7858.629154,13.802974999999606,370.9345267958644,773.1666542901298
"10.0.2.109",51473,"194.247.12.49",38925,17,1974,8,640,9,1334,7858.690697,13.753235000000132,372.2760499620599,775.9628916396687
"10.0.2.109",51474,"194.247.12.49",38925,22,5984,11,4275,11,1709,7858.786209,13.660061999999925,2503.6489585479326,1000.8739345399805
"10.0.2.109",51475,"92.122.212.122",443,10,1325,6,932,4,393,7858.852596,13.591080000000147,548.5951079678671,231.32819466885383
"10.0.2.109",51476,"194.247.12.49",38925,17,1976,8,640,9,1336,7858.885121,13.563174999999319,377.4927330805845,788.0160803057202
"10.0.2.109",51477,"92.122.212.161",443,15,5335,8,1307,7,4028,7858.962857,13.483162999999877,775.4856927858913,2389.943665295769
"10.0.2.109",51478,"194.247.12.49",38925,17,1976,8,640,9,1336,7858.985261,13.460732999999891,380.3656160478067,794.0132234997965
"10.0.2.109",51479,"23.62.237.22",443,10,1325,6,932,4,393,7859.061342,13.38673000000017,556.9694764890235,234.8594466311011
"10.0.2.109",51480,"194.247.12.49",38925,18,2092,8,722,10,1370,7859.08517,13.359574999999495,432.34908296111354,820.3853790259357
"10.0.2.109",51481,"23.62.237.24",443,10,1325,6,932,4,393,7859.155789,13.289933999999448,561.0261119430924,236.57002359832114
"10.0.2.109",51482,"194.247.12.49",38925,18,2106,8,722,10,1384,7859.185652,13.259696000000076,435.6057635107145,835.0116020759402
"10.0.2.109",51483,"31.13.93.3",443,12,1519,7,990,5,529,7859.211084,13.233488000000762,598.4816701386319,319.794751013471
"10.0.2.109",51484,"194.247.12.49",38925,18,2016,9,694,9,1322,7859.285489,13.160209000000577,421.8777984452797,803.6346535225646
"10.0.2.109",51485,"31.13.91.6",443,12,1519,7,990,5,529,7859.31055,13.134578999999576,602.9884931980123,322.2029423249985
"10.0.2.109",51486,"195.113.232.72",443,10,1325,6,932,4,393,7859.454519,12.990947000000233,573.9381432315802,242.0146891523723
"10.0.2.109",51487,"92.122.212.99",443,10,1325,6,932,4,393,7859.803603,12.628287999999884,590.4204908852307,248.9648636458108
"10.0.2.109",51488,"194.247.12.49",38925,17,1962,8,640,9,1322,7873.082194,10.522885000000315,486.5585816056953,1005.0475701292643
"10.0.2.109",51489,"194.247.12.49",38925,62,40109,36,36834,26,3275,7873.142553,10.466208000000734,28154.609577793537,2503.2944118823325
"10.0.2.109",51490,"31.13.64.7",443,53,39360,18,2611,35,36749,7873.276115,10.332415000000765,2021.5990162995247,28453.3673879706
"10.0.2.109",51491,"195.113.232.72",443,10,1325,6,932,4,393,7874.239985,9.364746000000196,796.1774937622274,335.72720498772037
"10.0.2.109",51492,"194.247.12.49",38925,246,234259,176,227122,70,7137,7877.825742,163.09423100000004,11140.651566026267,350.07982593817184
"10.0.2.109",51493,"195.113.232.75",443,255,234482,61,6419,194,228063,7877.987901,162.9320119999993,315.1744053832725,11197.946785313175
"10.0.2.109",51494,"194.247.12.49",38925,37,18637,19,15908,18,2729,7878.723315,4.88510099999985,26051.457277956775,4469.0990012285665
"10.0.2.109",51495,"23.62.237.9",443,31,18040,13,2217,18,15823,7878.89537,4.712826999999379,3763.3462887566925,26859.462483986084
"10.0.2.109",51496,"194.247.12.49",38925,35,10323,15,4669,20,5654,7879.421193,4.180696999999782,8934.395389094678,10819.248560707068
"10.0.2.109",51497,"31.13.93.3",443,29,9750,13,5058,16,4692,7879.546889,4.054607999999462,9979.756366091462,9257.615039482234
"10.0.2.109",51498,"194.247.12.49",38925,20,2200,10,830,10,1370,7880.321284,3.279851000000235,2024.4822097099911,3341.615213617696
"10.0.2.109",51499,"194.247.12.49",38925,19,2154,9,784,10,1370,7880.382061,7.211146999999983,869.76454647229,1519.8691692181599
"10.0.2.109",51500,"31.13.93.3",443,12,1519,7,990,5,529,7880.746013,2.8546409999999014,2774.4294291297133,1482.498149504665
"10.0.2.109",51501,"31.13.93.3",443,12,1519,7,990,5,529,7883.51372,4.079281999999694,1941.5181397119873,1037.437470613779
"10.0.2.109",51502,"194.247.12.49",38925,20,2262,10,802,10,1460,7883.521045,4.120832999999948,1556.9667589053188,2834.3783890296327
"10.0.2.109",51503,"194.247.12.49",38925,20,10095,12,8584,8,1511,7883.800722,1.9610540000003311,35017.90363752778,6164.0321990103075
"10.0.2.109",51504,"194.247.12.49",38925,22,5744,11,4558,11,1186,7883.861474,3.7110569999995278,9825.772010509309,2556.6839851829836
"10.0.2.109",51505,"194.247.12.49",38925,22,5772,11,4558,11,1214,7883.961399,3.5512900000003356,10267.818173113588,2734.780882439644
"10.0.2.109",51506,"173.194.122.24",443,12,1583,7,1082,5,501,7883.978966,3.662709000000177,2363.2781091808224,1094.2720265245769
"10.0.2.109",51507,"194.247.12.49",38925,22,5744,11,4558,11,1186,7884.061275,13.691275999999561,2663.301798897427,692.9960363081062
"10.0.2.109",51508,"91.185.213.112",443,15,5151,8,840,7,4311,7884.093891,3.418467999999848,1965.7928639379684,10088.729805281644
"10.0.2.109",51509,"194.247.12.49",38925,22,5744,11,4558,11,1186,7884.161371,3.3427160000001095,10908.494768924074,2838.4104422869573
"10.0.2.109",51510,"91.185.213.10",80,16,9835,7,1425,9,8410,7884.221401,1.072226000000228,10632.086892126825,62747.96544756954
"10.0.2.109",51511,"91.185.213.112",443,15,5123,8,812,7,4311,7884.595829,2.9079280000005383,2233.8929987258275,11859.991031412612
"10.0.2.109",51512,"91.185.213.112",443,15,5123,8,812,7,4311,7885.007056,2.565270000000055,2532.2870497062145,13444.198856260457
"10.0.2.109",51513,"91.185.213.112",443,15,5123,8,812,7,4311,7885.069181,12.683179999999993,512.1743915957989,2719.1918745929665
"10.0.2.109",51514,"194.247.12.49",38925,18,2088,8,722,10,1366,7885.267402,2.3766659999992044,2430.295211864828,4598.0377554118495
"10.0.2.109",51515,"194.247.12.49",38925,1665,1481579,1087,1239413,578,242166,7885.328503,329.08164300000044,30130.225161176757,5887.0740474575705
"10.0.2.109",51516,"31.13.93.3",443,12,1519,7,990,5,529,7885.685125,1.958716000000095,4043.465208840698,2160.5990863401303
"10.0.2.109",51517,"194.247.12.49",38925,12,2120,6,710,6,1410,7885.691468,1.7511459999996077,3243.590197505675,6441.496026032396
"10.0.2.109",51518,"31.13.93.3",443,1665,1481333,487,237038,1178,1244295,7885.745422,328.66475399999945,5769.721203509407,30287.275647452043
"10.0.2.109",51519,"91.185.213.10",80,10,1968,5,1324,5,644,7887.102009,0.08994999999958964,117754.30794939768,57276.264591700994
"10.0.2.109",51520,"194.247.12.49",38925,13,1426,7,650,6,776,7887.451039,2.533042000000023,2052.8676587281034,2450.808158727705
"10.0.2.109",51521,"194.247.12.49",38925,13,2109,7,1041,6,1068,7887.513043,111.00758700000006,75.02189917883717,76.96771212583872
"10.0.2.109",51522,"194.247.12.49",38925,43,23745,26,21619,17,2126,7887.725852,5.224034000000756,33106.982075533,3255.7215362682437
"10.0.2.109",51523,"194.247.12.49",38925,47,23031,26,20669,21,2362,7887.787297,2.3316820000000007,70915.33064971979,8104.0210457515195
"10.0.2.109",51524,"104.31.92.48",80,35,23279,12,1834,23,21445,7887.857009,5.092313999999533,2881.204890350702,33689.98848068201
"10.0.2.109",51525,"5.10.88.210",80,8,1105,5,683,3,422,7887.870107,2.113618000000315,2585.140739717009,1597.2611891077274
"10.0.2.109",51526,"194.247.12.49",38925,31,17741,16,12848,15,4893,7887.886736,110.64018099999976,928.9934187652876,353.79551665773295
"10.0.2.109",51527,"104.28.17.59",80,38,22507,14,1958,24,20549,7887.91367,2.2049669999996695,7103.961193071074,74555.3108051162
"10.0.2.109",51528,"194.247.12.49",38925,13,1765,7,884,6,881,7887.986983,110.5322070000002,63.98135160731919,63.76422032358394
"10.0.2.109",51529,"88.85.84.114",80,30,17653,13,4763,17,12890,7888.039064,70.35899600000084,541.565431092842,1465.6263713598012
"10.0.2.109",51530,"194.247.12.49",38925,12,1967,6,751,6,1216,7888.086983,110.4344259999998,54.40332528191898,88.08847342585017
"10.0.2.109",51531,"88.85.84.123",80,11,1624,6,860,5,764,7888.131683,66.73778400000083,103.0900276820686,91.58230366174466
"10.0.2.109",51532,"91.185.202.180",80,11,1964,6,1043,5,921,7888.924528,18.81629200000043,443.4454992513833,391.57555590654266
"10.0.2.109",51533,"173.194.113.99",80,8,1706,5,1129,3,577,7889.211322,109.30959799999982,82.62769386454075,42.22867968099203
"10.0.2.109",51534,"194.247.12.49",38925,13,1602,7,702,6,900,7889.691271,5.450655000000552,1030.3348863575902,1320.9421619969107
"10.0.2.109",51535,"194.247.12.49",38925,12,1313,6,547,6,766,7889.952859,105.40901500000018,41.514475777996715,58.1354450565731
"10.0.2.109",51536,"194.247.12.49",38925,13,1584,7,842,6,742,7890.275967,108.24405100000058,62.229747850068584,54.8390414545735
"10.0.2.109",51537,"194.247.12.49",38925,17,6515,10,5672,7,843,7890.370888,104.99132699999973,432.1880796877643,64.23387714682393
"10.0.2.109",51538,"128.199.53.58",80,11,1441,6,719,5,722,7890.405135,15.248488999999608,377.21770334097675,378.791629780508
"10.0.2.109",51539,"194.247.12.49",38925,19,9014,11,8117,8,897,7890.470604,104.89173800000026,619.0764042826694,68.41339591493833
"10.0.2.109",51540,"194.247.12.49",38925,18,2016,9,694,9,1322,7890.570966,17.20888500000001,322.6240398491824,614.5662545830246
"10.0.2.109",51541,"178.79.215.17",80,18,8917,8,866,10,8051,7890.622979,3.069398999999976,2257.1193904735273,20983.9124857995
"10.0.2.109",51542,"194.247.12.49",38925,17,1962,8,640,9,1322,7890.67136,17.108001999999942,299.2751579056407,618.1902480488391
"10.0.2.109",51543,"194.247.12.49",38925,17,1962,8,640,9,1322,7890.770965,16.999131999999918,301.19184908970794,622.1494132759279
"10.0.2.109",51544,"178.79.215.7",80,15,6364,7,812,8,5552,7890.77846,3.915031999999883,1659.2456970978,11344.990283604662
"10.0.2.109",51545,"62.161.94.220",80,10,1403,5,821,5,582,7890.819803,4.081327999999303,1609.280116668183,1140.8051496965682
"10.0.2.109",51546,"194.247.12.49",38925,50,28288,30,25169,20,3119,7890.87114,64.14721599999939,3138.9047343847615,388.9802481841182
"10.0.2.109",51547,"194.247.12.49",38925,17,1962,8,640,9,1322,7890.970886,16.799992000000202,304.7620498866868,629.5241092971874
"10.0.2.109",51548,"195.113.232.88",443,46,27813,16,2675,30,25138,7891.039799,63.97839000000022,334.4879419441459,3143.311358725959
"10.0.2.109",51549,"194.247.12.49",38925,40,22581,24,20102,16,2479,7891.070989,61.551312999999936,2612.7143705285403,322.2027123938042
"10.0.2.109",51550,"62.152.54.250",80,11,1230,6,749,5,481,7891.097183,15.118419999999787,396.3377125387497,254.5239515769541
"10.0.2.109",51551,"195.113.232.88",443,10,1325,6,932,4,393,7891.116102,16.65453400000024,447.6858974258837,188.77742241241663
"10.0.2.109",51552,"194.247.12.49",38925,13,1099,7,457,6,642,7891.171923,3.0385009999999966,1203.2248796363747,1690.3071613272484
"10.0.2.109",51553,"195.113.232.88",443,10,1325,6,932,4,393,7891.212995,16.556856000000153,450.3270427670526,189.89112425692238
"10.0.2.109",51554,"195.113.232.88",443,37,22160,13,2089,24,20071,7891.223143,61.39918399999988,272.1860277491641,2615.148761586153
"10.0.2.109",51555,"194.247.12.49",38925,12,2024,6,1238,6,786,7891.271745,2.328182000000197,4253.962963376214,2700.819781271167
"10.0.2.109",51556,"88.85.84.123",80,8,1777,5,713,3,1064,7891.396233,2.2033679999995,2588.76411021731,3863.1767367057755
"10.0.2.109",51557,"195.113.232.88",443,10,1325,6,932,4,393,7891.842179,15.936883999999736,467.8455336689483,197.2782132316488
"10.0.2.109",51558,"195.113.232.88",443,10,1325,6,932,4,393,7891.978429,15.801195000000007,471.86304580128257,198.97229291835197
"10.0.2.109",51559,"194.247.12.49",38925,20,8768,11,6563,9,2205,7893.143606,102.22052200000053,513.634630040333,172.5680876487787
"10.0.2.109",51560,"88.85.84.123",80,17,8572,8,2129,9,6443,7893.298958,65.14356199999929,261.4533113801819,791.2370527113725
"10.0.2.109",51561,"194.247.12.49",38925,26,6919,13,5105,13,1814,7893.821062,67.13334899999973,608.3414667723514,216.16678172870624
"10.0.2.109",51562,"31.13.93.3",443,24,6554,11,1480,13,5074,7894.947827,66.00656299999991,179.37610234303543,614.9691508706499
"10.0.2.109",51563,"194.247.12.49",38925,25,3637,11,1362,14,2275,7895.212939,241.67708099999982,45.08495367005864,75.30709955901865
"10.0.2.109",51564,"173.194.122.0",443,24,3332,11,1893,13,1439,7895.373663,241.51623500000005,62.703859225033035,47.665532712531714
"10.0.2.109",51565,"194.247.12.49",38925,16,3442,8,761,8,2681,7895.975097,228.26435300000048,26.670831078035153,93.96123274666525
"10.0.2.109",51566,"8.21.198.202",80,11,3138,6,2551,5,587,7896.186118,0.34201200000006793,59670.420920891505,13730.512379679858
"10.0.2.109",51567,"194.247.12.49",38925,16,3446,8,761,8,2685,7897.586966,226.65321399999993,26.86041769520198,94.77033050146824
"10.0.2.109",51568,"8.37.70.20",80,11,3142,6,2555,5,587,7897.783007,0.5247300000000905,38953.36649323742,8949.36443504124
"10.0.2.109",51569,"194.247.12.49",38925,38,8657,17,3771,21,4886,7906.043459,361.9934899999989,83.33851528655968,107.97984239992856
"10.0.2.109",51570,"173.194.122.22",443,36,8306,17,4458,19,3848,7906.201371,361.835458999999,98.56413768447193,85.07734450647106
"10.0.2.109",51571,"194.247.12.49",38925,22,7804,11,5194,11,2610,7910.822397,1.0643390000004729,39040.193021191124,19617.809739181524
"10.0.2.109",51572,"94.100.180.59",443,20,7455,9,2292,11,5163,7910.951771,0.9349369999999908,19612.016638554447,44178.37779444006
"10.0.2.109",51573,"194.247.12.49",38925,19,3418,9,983,10,2435,7928.85394,5.856713000000127,1342.732689821036,3326.097761662485
"10.0.2.109",51574,"193.0.170.53",443,18,3119,9,2167,9,952,7928.983198,5.72748700000011,3026.807393888396,1329.72802906403
"10.0.2.109",51575,"194.247.12.49",38925,25,6108,12,4425,13,1683,7929.842072,123.11909199999991,287.52648695622304,109.35753164911263
"10.0.2.109",51576,"217.20.147.94",443,23,5777,11,1383,12,4394,7929.970458,122.9904660000002,89.95819236915472,285.81077170648285
"10.0.2.109",51577,"194.247.12.49",38925,185,149110,119,142255,66,6855,7939.124281,122.19799899999998,9313.082123382399,448.7798527699296
"10.0.2.109",51578,"23.62.237.14",443,185,148837,50,5749,135,143088,7939.305187,122.01700299999993,376.93107410612294,9381.512181544082
"10.0.2.109",51579,"194.247.12.49",38925,17,1972,8,640,9,1332,7952.281405,17.689707000000453,289.43384986534085,602.3842000322406
"10.0.2.109",51580,"194.247.12.49",38925,18,2106,8,722,10,1384,7952.341899,17.628711000000294,327.64732486679844,628.0663401878796
"10.0.2.109",51581,"2.20.182.75",443,10,1325,6,932,4,393,7953.297459,16.67346599999928,447.17756943879107,188.56307380841727
"10.0.2.109",51582,"31.13.91.6",443,12,1519,7,990,5,529,7953.462547,16.507760999999846,479.77433160075884,256.3642640573752
"10.0.2.109",51583,"194.247.12.49",38925,20,7696,10,5140,10,2556,7971.840818,4.818548000000192,8533.691062120448,4243.602014548613
"10.0.2.109",51584,"217.69.139.58",443,18,7347,8,2238,10,5109,7971.991226,4.668123999999807,3835.37369615733,8755.55148063798
"10.0.2.109",51585,"194.247.12.49",38925,22,5337,11,3393,11,1944,7977.661517,60.822315000000344,446.28357207383254,255.6956275011879
"10.0.2.109",51586,"195.113.232.88",443,20,4970,9,1608,11,3362,7977.82603,60.657782000000225,212.0750145463603,443.4055963338702
"10.0.2.109",51587,"194.247.12.49",38925,24,4587,11,1097,13,3490,7994.883622,243.46190800000022,36.04670673984857,114.67913083142344
"10.0.2.109",51588,"194.247.12.49",38925,21,5932,10,4221,11,1711,7995.581134,14.400061000000278,2344.990066361479,950.5515289136439
"10.0.2.109",51589,"194.247.12.49",38925,73,46279,44,42631,29,3648,7995.642084,62.04344200000014,5496.922623989804,470.38009270987794
"10.0.2.109",51590,"194.247.12.49",38925,119,80798,73,75623,46,5175,7995.741999,82.94493899999998,7293.802458520106,499.12629388997453
"10.0.2.109",51591,"23.62.237.9",443,15,5335,8,1307,7,4028,7995.74639,14.23454799999945,734.5508968743092,2263.788073917152
"10.0.2.109",51592,"23.62.237.6",443,66,45628,23,3082,43,42546,7995.812464,61.87287000000015,398.4945259529733,5501.086340426736
"10.0.2.109",51593,"194.247.12.49",38925,192,178195,137,170928,55,7267,7995.841833,81.93966,16688.18249917073,709.4976962315928
"10.0.2.109",51594,"23.62.237.22",443,107,79877,30,4069,77,75808,7995.90373,82.78312499999993,393.2202366122326,7325.937502359334
"10.0.2.109",51595,"194.247.12.49",38925,59,30674,34,27289,25,3385,7995.941854,44.755292000000736,4877.903600762931,605.0681112749651
"10.0.2.109",51596,"31.13.64.7",443,187,177662,48,6657,139,171005,7995.966904,81.8145110000005,650.9358712661582,16721.239096570433
"10.0.2.109",51597,"194.247.12.49",38925,20,2214,10,830,10,1384,7996.0426,13.941187000000355,476.2865601042315,794.19349299308
"10.0.2.109",51598,"23.62.237.9",443,53,30077,19,2819,34,27258,7996.119087,44.577940999999555,505.9004407583613,4891.746794675918
"10.0.2.109",51599,"194.247.12.49",38925,61,35318,37,32249,24,3069,7996.142176,60.54483900000014,4261.1724510490385,405.51763627614804
"10.0.2.109",51600,"194.247.12.49",38925,21,2268,11,884,10,1384,7996.243147,13.738459999999577,514.7592961656705,805.9127442231764
"10.0.2.109",51601,"23.62.237.8",443,51,34505,16,2395,35,32110,7996.308172,60.37873000000036,317.330291644092,4254.478356865049
"10.0.2.109",51602,"173.194.122.3",443,24,4336,12,3216,12,1120,7996.316526,242.0290210000012,106.30130177653312,37.020353852523975
"10.0.2.109",51603,"194.247.12.49",38925,22,5986,11,4275,11,1711,7996.342848,13.625788999999713,2509.9463964986335,1004.5656805635467
"10.0.2.109",51604,"31.13.64.7",443,12,1519,7,990,5,529,7996.367528,13.613836999999876,581.7610420926937,310.8601931990253
"10.0.2.109",51605,"194.247.12.49",38925,23,5752,12,4329,11,1423,7996.442532,13.54091900000003,2557.5812099607065,840.7110329808468
"10.0.2.109",51606,"23.62.237.22",443,15,5335,8,1307,7,4028,7996.513304,13.455105000000003,777.1028171091937,2394.9274271735517
"10.0.2.109",51607,"194.247.12.49",38925,78,52635,48,48943,30,3692,7996.543328,64.14082599999983,6104.442746028887,460.486742094654
"10.0.2.109",51608,"23.62.237.6",443,15,5047,8,1019,7,4028,7996.61889,13.364363000000594,609.9804382745094,2411.1886215600825
"10.0.2.109",51609,"194.247.12.49",38925,19,2168,9,784,10,1384,7996.643092,23.33951100000013,268.72885211690874,474.38868792066546
"10.0.2.109",51610,"23.62.237.6",443,72,52038,22,3018,50,49020,7996.694076,63.99000800000067,377.30890735315654,6128.456805318666
"10.0.2.109",51611,"194.247.12.49",38925,17,1976,8,640,9,1336,7996.742997,1.7774030000000494,2880.6072680196094,6013.267671990935
"10.0.2.109",51612,"194.247.12.49",38925,18,2106,8,722,10,1384,7996.843692,23.137283999999454,249.6403640116159,478.53499140176785
"10.0.2.109",51613,"194.247.12.49",38925,20,2214,10,830,10,1384,7996.922857,23.0618970000005,287.92080720852476,480.09927370674495
"10.0.2.109",51614,"31.13.91.6",443,12,1519,7,990,5,529,7997.169021,12.814565000000584,618.0467304196154,330.249212517148
"10.0.2.109",51615,"23.62.237.16",443,10,1325,6,932,4,393,7997.182978,1.337188999999853,5575.875960691285,2351.2009147550166
"10.0.2.109",51616,"31.13.91.6",443,12,1519,7,990,5,529,7997.247084,22.733416000000034,348.3858299166297,186.1576808342395
"10.0.2.109",51617,"194.247.12.49",38925,18,2030,9,694,9,1336,7998.759979,21.22186099999999,261.61701841322974,503.6316089338256
"10.0.2.109",51618,"194.247.12.49",38925,19,2084,10,748,9,1336,7998.82074,21.16332700000021,282.7532740953226,505.02456442693983
"10.0.2.109",51619,"194.247.12.49",38925,95,66583,54,61752,41,4831,7998.915966,57.77746300000035,8550.323505897048,668.9113365881046
"10.0.2.109",51620,"31.13.91.6",443,12,1519,7,990,5,529,7999.013104,20.971385000000737,377.65746039184927,201.79878439120026
"10.0.2.109",51621,"194.247.12.49",38925,32,13107,18,10862,14,2245,7999.01653,64.47999400000026,1347.6428053017444,278.53600606724507
"10.0.2.109",51622,"23.62.237.6",443,89,65986,26,3779,63,62207,7999.092244,57.6012039999996,524.8501402852658,8639.680517789237
"10.0.2.109",51623,"194.247.12.49",38925,18,2030,9,694,9,1336,7999.116354,20.863712000000305,266.1079677480172,512.277009958719
"10.0.2.109",51624,"194.247.12.49",38925,17,1976,8,640,9,1336,7999.216841,20.76665899999989,246.54904768263526,514.6711370375011
"10.0.2.109",51625,"23.62.237.16",443,10,1325,6,932,4,393,7999.390441,20.5926670000008,362.07063417282035,152.67570732823862
"10.0.2.109",51626,"23.62.237.24",443,27,12564,11,1841,16,10723,7999.46446,64.03200500000003,230.00997704194947,1339.7050428141358
"10.0.2.109",51627,"23.62.237.14",443,10,1325,6,932,4,393,7999.578957,20.400802000000112,365.4758278620595,154.1115883581431
"10.0.2.109",51628,"23.62.237.16",443,10,1325,6,932,4,393,7999.752667,20.228909999999814,368.5814015683528,155.42112748536766
"10.0.2.109",51629,"31.13.64.7",443,12,1519,7,990,5,529,8000.05684,19.92533899999944,397.48382700039497,212.39287321536256
"10.0.2.109",51630,"23.62.237.6",443,10,1325,6,932,4,393,8000.228067,19.755694000000403,377.4101785540841,159.14399160059554
"10.0.2.109",51631,"194.247.12.49",38925,25,5458,11,2404,14,3054,8028.83031,65.70947999999953,292.68227354713713,371.8184955960719
"10.0.2.109",51632,"31.13.93.3",443,22,5047,10,2620,12,2427,8028.960266,65.57945800000016,319.61227858882194,296.0683206622408
"10.0.2.109",51633,"194.247.12.49",38925,20,7696,10,5140,10,2556,8031.930965,1.2868760000001203,31953.350594770713,15889.642824948238
"10.0.2.109",51634,"217.69.139.59",443,18,7347,8,2238,10,5109,8032.05738,1.1604699999998047,15428.231664759118,35220.212500113645
"10.0.2.109",51635,"194.247.12.49",38925,21,5928,10,4221,11,1707,8086.660099,11.708544000000074,2884.0477517955933,1166.3277688498172
"10.0.2.109",51636,"194.247.12.49",38925,18,2016,9,694,9,1322,8086.720794,21.64772400000038,256.47037998081936,488.5502050931458
"10.0.2.109",51637,"2.20.182.65",443,15,5335,8,1307,7,4028,8086.836952,11.53128100000049,906.7509498727467,2794.485712385175
"10.0.2.109",51638,"195.113.232.72",443,10,1325,6,932,4,393,8086.883561,21.4846950000001,347.03774012151274,146.33672947183962
"10.0.2.109",51639,"194.247.12.49",38925,12,2363,6,920,6,1443,8091.94016,285.05817899999965,25.819290735032755,40.496996228969856
"10.0.2.109",51640,"88.85.84.123",80,11,2259,6,1405,5,854,8092.08836,65.10219300000063,172.65163402406264,104.94270139256191
"10.0.2.109",51641,"194.247.12.49",38925,12,1798,6,1026,6,772,8092.719839,0.8261499999998705,9935.241784181186,7475.640016947247
"10.0.2.109",51642,"194.247.12.49",38925,20,7696,10,5140,10,2556,8092.82052,1.91915599999993,21426.085216627256,10654.68362134227
"10.0.2.109",51643,"88.85.80.162",80,8,1547,5,695,3,852,8092.868426,0.6773139999995692,8208.895726359615,10063.279365263874
"10.0.2.109",51644,"194.247.12.49",38925,13,2340,7,735,6,1605,8092.912614,284.08822000000055,20.697795917056993,45.197227818879554
"10.0.2.109",51645,"217.69.139.59",443,18,7347,8,2238,10,5109,8092.949662,1.789918999999827,10002.687272441786,22834.552848483057
"10.0.2.109",51646,"173.194.122.6",80,11,2191,6,1576,5,615,8093.071746,240.23905399999967,52.481059137037796,20.47960112263848
"10.0.2.109",51647,"194.247.12.49",38925,18,2168,8,694,10,1474,8093.08514,15.282862999999452,363.2827173809121,771.5831778378451
"10.0.2.109",51648,"194.247.12.49",38925,33,8206,14,2867,19,5339,8093.146794,241.31459799999902,95.04605270502572,176.99716616398058
"10.0.2.109",51649,"216.58.211.42",443,28,7675,13,4785,15,2890,8093.302376,241.15897700000096,158.7334648545961,95.87036853286995
"10.0.2.109",51650,"216.58.211.42",443,12,1583,7,1082,5,501,8094.209471,14.158314999999675,611.372186591427,283.0845337174722
"10.0.2.109",51651,"194.247.12.49",38925,23,7964,11,5621,12,2343,8095.239618,91.50914600000033,491.4044329514324,204.83198477231917
"10.0.2.109",51652,"217.69.139.202",443,22,7683,10,2039,12,5644,8095.38552,91.36307600000055,178.54039853036366,494.2040261428997
"10.0.2.109",51653,"194.247.12.49",38925,21,6123,10,4841,11,1282,8101.820956,16.56674700000076,2337.6949017207917,619.0714447440726
"10.0.2.109",51654,"194.247.12.49",38925,58,13896,27,8841,31,5055,8101.881623,241.56980399999975,292.7849376406336,167.40502881726078
"10.0.2.109",51655,"194.247.12.49",38925,21,6123,10,4841,11,1282,8101.943034,16.448930000000473,2354.4388601567935,623.5056018841168
"10.0.2.109",51656,"173.194.122.7",443,15,5556,8,908,7,4648,8101.976178,16.41132000000016,442.6213126061724,2265.753150873887
"10.0.2.109",51657,"173.194.122.4",443,50,13221,20,4249,30,8972,8102.047532,241.40382899999986,140.80969693318335,297.32751256402
"10.0.2.109",51658,"173.194.122.7",443,15,5556,8,908,7,4648,8102.092397,16.299301000000014,445.663283351844,2281.324824911201
"10.0.2.109",51659,"194.247.12.49",38925,21,6125,10,4843,11,1282,8102.119754,16.268598999999995,2381.520375540636,630.4169154332222
"10.0.2.109",51660,"173.194.122.7",443,15,5558,8,908,7,4650,8102.245942,16.142139000000498,450.0023200147004,2304.5272996347544
"10.0.2.109",51661,"194.247.12.49",38925,30,12601,16,10455,14,2146,8122.419843,1.4888250000003609,56178.53004885042,11531.24107937188
"10.0.2.109",51662,"91.185.213.10",443,26,13899,11,1774,15,12125,8122.566498,1.3420649999998204,10574.748615008884,72276.67810427437
"10.0.2.109",51663,"194.247.12.49",38925,20,5473,10,3628,10,1845,8124.589993,1.3269680000003063,21872.418927957042,11123.101687453347
"10.0.2.109",51664,"91.185.213.10",443,21,9961,9,1581,12,8380,8124.734453,1.1823279999998704,10697.539092368097,56701.69360787138
"10.0.2.109",51665,"31.28.27.51",80,17,1928,8,817,9,1111,8246.856974,1620.507384999999,4.033304667722946,5.484701941052867
"10.0.2.109",51666,"194.247.12.49",38925,18,2448,8,1775,10,673,8247.557721,0.5148050000007061,27583.2596808122,10458.328881795274
"10.0.2.109",51667,"5.101.114.217",80,7,1820,4,339,3,1481,8247.776836,0.29535000000032596,9182.3260538243,40115.11765697283
"10.0.2.109",51668,"194.247.12.49",38925,9,506,5,286,4,220,8977.076589,0.12227700000039476,18711.61379484787,14393.549072959902
"10.0.2.109",51669,"194.247.12.49",38925,9,506,5,286,4,220,9577.27953,0.13141499999983353,17410.493474891744,13392.687288378263
"10.0.2.109",51670,"31.28.27.51",80,11,944,6,478,5,466,9867.364547,1620.009059,2.3604806274111088,2.301221699526311
"10.0.2.109",51671,"194.247.12.49",38925,18,2448,8,1775,10,673,9867.632486,0.5280879999991157,26889.457817681483,10195.270485239233
"10.0.2.109",51672,"5.101.114.217",80,7,1820,4,339,3,1481,9867.861852,0.298532000000705,9084.453257920743,39687.53768430862
"10.0.2.109",51673,"194.247.12.49",38925,15,1182,7,616,8,566,10073.157176,0.33013000000028114,14927.452821603014,13715.808923745628
"10.0.2.109",51674,"80.78.242.47",80,10,878,5,394,5,484,10073.383016,0.10430099999939557,30220.22799415409,37123.3257593162
"10.0.2.109",51675,"194.247.12.49",38925,18,1675,8,1000,10,675,10073.629203,0.4586189999990893,17443.673288755777,11774.47946991015
"10.0.2.109",51676,"217.23.10.139",80,7,1047,4,341,3,706,10073.855072,0.2325650000002497,11730.053963395485,24285.68357230854
"10.0.2.109",51677,"194.247.12.49",38925,19,2751,9,2073,10,678,10074.128339,0.5309479999996256,31234.69718317367,10215.689672065484
"10.0.2.109",51678,"37.187.78.159",80,9,2177,5,398,4,1779,10074.356197,0.3029100000003382,10511.373015075254,46984.252748288636
"10.0.2.109",51679,"194.247.12.49",38925,9,506,5,286,4,220,10674.736975,0.12749900000017078,17945.23878616252,13804.029835509631
"10.0.2.109",51680,"194.247.12.49",38925,9,506,5,286,4,220,11274.939674,0.12345100000129605,18533.669228892268,14256.668637609437
"10.0.2.109",51681,"31.28.27.51",80,17,1928,8,817,9,1111,11487.373856,1620.650207999999,4.032949224784232,5.484218590863257
"10.0.2.109",51682,"194.247.12.49",38925,18,2448,8,1775,10,673,11488.214133,0.5227759999997943,27162.68535664527,10298.866053533671
"10.0.2.109",51683,"5.101.114.217",80,7,1820,4,339,3,1481,11488.436037,0.3005670000002283,9022.946630860806,39418.83174131226
"10.0.2.109",51684,"194.247.12.49",38925,9,506,5,286,4,220,12088.814539,0.12196199999925739,18759.941621274917,14430.724324057628
"10.0.2.109",51685,"194.247.12.49",38925,9,506,5,286,4,220,12689.013305,0.12164599999960046,18808.674350225367,14468.211038634896
"10.0.2.109",51686,"31.28.27.51",80,11,944,6,478,5,466,13108.024272,1620.0109109999994,2.360477928904518,2.3012190687646554
"10.0.2.109",51687,"194.247.12.49",38925,18,2448,8,1775,10,673,13108.283527,0.7556420000000799,18791.96762487858,7125.067161432836
"10.0.2.109",51688,"5.101.114.217",80,7,1820,4,339,3,1481,13108.74289,0.29614500000025146,9157.676138370383,40007.42879329362
"10.0.2.109",51689,"194.247.12.49",38925,9,506,5,286,4,220,13709.116998,0.12841000000116765,17817.92695256752,13706.097655821168
"10.0.2.109",51690,"194.247.12.49",38925,9,506,5,286,4,220,14309.321487,0.12165200000163168,18807.74668701963,14467.49745155356
"10.0.2.109",51691,"31.28.27.51",80,17,1928,8,817,9,1111,14728.035455,1620.5098720000005,4.033298477801558,5.484693523668949
"10.0.2.109",51692,"194.247.12.49",38925,18,2448,8,1775,10,673,14728.738984,0.5270140000011452,26944.255750263073,10216.047391508197
"10.0.2.109",51693,"5.101.114.217",80,7,1820,4,339,3,1481,14728.966194,0.29961899999943853,9051.495399173891,39543.55364653844
"10.0.2.109",51694,"194.247.12.49",38925,9,506,5,286,4,220,15329.342093,0.12660500000129105,18071.956083698657,13901.504679768197
"10.0.2.109",51695,"194.247.12.49",38925,9,506,5,286,4,220,15929.546233,0.12792500000068685,17885.47977320864,13758.061364006646
"10.0.2.109",51696,"31.28.27.51",80,11,944,6,478,5,466,16348.545729,1620.008104999999,2.3604820174649697,2.3012230546834225
"10.0.2.109",51697,"194.247.12.49",38925,18,2448,8,1775,10,673,16348.801793,0.533966999999393,26593.403712244657,10083.020111741213
"10.0.2.109",51698,"5.101.114.217",80,7,1820,4,339,3,1481,16349.030513,0.30505300000004354,8890.258414110378,38839.152540700496
"10.0.2.109",51699,"194.247.12.49",38925,9,506,5,286,4,220,16949.413217,0.1272659999995085,17978.093127849043,13829.302406037725
"10.0.2.109",51700,"194.247.12.49",38925,9,506,5,286,4,220,17549.614034,0.12354200000117999,18520.0174837557,14246.167295196692
"10.0.2.109",51701,"194.247.12.49",38925,15,1182,7,616,8,566,17906.921058,0.3404550000013842,14474.747029651391,13299.848731790076
"10.0.2.109",51702,"80.78.242.47",80,10,878,5,394,5,484,17907.153661,0.10789400000066962,29213.858045678517,35887.074350528936
"10.0.2.109",51703,"194.247.12.49",38925,18,1675,8,1000,10,675,17907.401523,0.46754199999850243,17110.762241735767,11549.764513171644
"10.0.2.109",51704,"217.23.10.139",80,7,1047,4,341,3,706,17907.630265,0.23862699999881443,11432.067620233895,23668.738240132345
"10.0.2.109",51705,"194.247.12.49",38925,19,2751,9,2073,10,678,17907.908275,0.5444569999999658,30459.7057251556,9962.219238618185
"10.0.2.109",51706,"37.187.78.159",80,9,2177,5,398,4,1779,17908.14723,0.3052300000017567,10431.477901849998,46627.13363666117
"10.0.2.109",51707,"31.28.27.51",80,11,944,6,478,5,466,17968.554217,1620.0075450000004,2.3604828334302597,2.301223850164228
"10.0.2.109",51708,"194.247.12.49",38925,18,2448,8,1775,10,673,17968.80563,0.5211530000015046,27247.27671136692,10330.939282676021
"10.0.2.109",51709,"5.101.114.217",80,7,1820,4,339,3,1481,17969.02813,0.29844800000137184,9087.010132376608,39698.70798244766
"10.0.2.109",51710,"194.247.12.49",38925,9,506,5,286,4,220,18569.404401,0.1295109999991837,17666.45304271005,13589.579263623114
"10.0.2.109",51711,"194.247.12.49",38925,9,506,5,286,4,220,19169.609358,0.1311150000001362,17450.329863079154,13423.330663907042
"10.0.2.109",51712,"31.28.27.51",80,17,1928,8,817,9,1111,19588.561785,1620.8682849999968,4.0324066184070055,5.483480725887618
"10.0.2.109",51713,"194.247.12.49",38925,18,2448,8,1775,10,673,19589.3141,0.5380250000016531,26392.82561211165,10006.969936310501
"10.0.2.109",51714,"5.101.114.217",80,7,1820,4,339,3,1481,19589.548728,0.3032019999991462,8944.532028178035,39076.25939153885
"10.0.2.109",51715,"194.247.12.49",38925,9,506,5,286,4,220,20189.927893,0.12386200000037206,18472.170641464912,14209.362031896088
"10.0.2.109",51716,"194.247.12.49",38925,9,506,5,286,4,220,20790.128678,0.12605899999834946,18150.231241164514,13961.71633935732
"10.0.2.109",51717,"31.28.27.51",80,11,944,6,478,5,466,21209.134619,1620.0063320000008,2.3604846008712994,2.301225573234363
"10.0.2.109",51718,"194.247.12.49",38925,18,2448,8,1775,10,673,21209.386731,0.7635530000006838,18597.26829701053,7051.245951486247
"10.0.2.109",51719,"5.101.114.217",80,7,1820,4,339,3,1481,21209.852589,0.2973700000002282,9119.951575471363,39842.620304640375
"10.0.2.109",51720,"194.247.12.49",38925,9,506,5,286,4,220,21810.228317,0.13026199999876553,17564.600574393782,13511.231211072141
"10.0.2.109",51721,"194.247.12.49",38925,9,506,5,286,4,220,22410.433442,0.1264149999988149,18099.117984586082,13922.398449681601
"10.0.2.109",51722,"194.247.12.49",38925,15,1182,7,616,8,566,22574.847534,0.33958699999857345,14511.745149315791,13333.843757325874
"10.0.2.109",51723,"80.78.242.47",80,10,878,5,394,5,484,22575.07918,0.10783100000116974,29230.926171192026,35908.04128643894
"10.0.2.109",51724,"194.247.12.49",38925,18,1675,8,1000,10,675,22575.329179,0.4580070000010892,17466.981945649248,11790.212813313243
"10.0.2.109",51725,"217.23.10.139",80,7,1047,4,341,3,706,22575.5541,0.23290300000007846,11713.030746701765,24250.439023963183
"10.0.2.109",51726,"194.247.12.49",38925,15,1182,7,616,8,566,22575.822963,0.3240140000016254,15209.219354642944,13974.704796636212
"10.0.2.109",51727,"194.247.12.49",38925,19,2751,9,2073,10,678,22575.884053,0.5378959999979998,30831.238752587247,10083.733658588593
"10.0.2.109",51728,"80.78.242.47",80,10,878,5,394,5,484,22576.044405,0.1025179999996908,30745.8202462934,37768.97715534519
"10.0.2.109",51729,"37.187.78.159",80,9,2177,5,398,4,1779,22576.118238,0.30357200000071316,10488.450845244357,46881.79410474802
"10.0.2.109",51730,"194.247.12.49",38925,18,1675,8,1000,10,675,22576.293374,0.4810990000005404,16628.59411470615,11224.30102742665
"10.0.2.109",51731,"217.23.10.139",80,7,1047,4,341,3,706,22576.529148,0.2450589999971271,11132.013107178194,23047.511007823476
"10.0.2.109",51732,"194.247.12.49",38925,19,2747,9,2069,10,678,22576.805558,0.536073999999644,30876.33423745787,10118.006096180008
"10.0.2.109",51733,"37.187.78.159",80,9,2173,5,398,4,1775,22577.03778,0.30362700000114273,10486.55093251923,46767.9093096021
"10.0.2.109",51734,"31.28.27.51",80,17,1928,8,817,9,1111,22829.14118,1620.4702160000015,4.0333971803157125,5.4848277445908895
"10.0.2.109",51735,"194.247.12.49",38925,18,2448,8,1775,10,673,22829.803942,0.7660670000004757,18536.23769199193,7028.105896738349
"10.0.2.109",51736,"5.101.114.217",80,7,1820,4,339,3,1481,22830.03008,0.5397799999991548,5024.269146697259,21949.683204302775
"10.0.2.109",51737,"194.247.12.49",38925,9,506,5,286,4,220,23430.645771,0.12713300000177696,17996.900883075363,13843.769910057972
"10.0.2.109",51738,"194.247.12.49",38925,9,506,5,286,4,220,24030.848377,0.12297700000272016,18605.10501922629,14311.619245558682
"10.0.2.109",51739,"31.28.27.51",80,11,944,6,478,5,466,24449.611823,1620.0080650000018,2.360482075748182,2.301223111503458
"10.0.2.109",51740,"194.247.12.49",38925,18,2448,8,1775,10,673,24449.866452,0.5241030000033788,27093.910929547157,10272.789890470556
"10.0.2.109",51741,"5.101.114.217",80,7,1820,4,339,3,1481,24450.093713,0.2966270000033546,9142.795497272095,39942.41926684357
"10.0.2.109",51742,"194.247.12.49",38925,9,506,5,286,4,220,25050.466302,0.1259169999975711,18170.699747009017,13977.46134385309
"10.0.2.109",51743,"194.247.12.49",38925,9,506,5,286,4,220,25650.670804,0.12153199999738717,18826.31734892201,14481.782576093854
"10.0.2.109",51744,"31.28.27.51",80,17,1928,8,817,9,1111,26069.620154,1620.5202439999994,4.033272663022655,5.484658419361285
"10.0.2.109",51745,"194.247.12.49",38925,18,2448,8,1775,10,673,26070.326628,0.5116180000004533,27755.08289385326,10523.476500035631
"10.0.2.109",51746,"5.101.114.217",80,7,1820,4,339,3,1481,26070.544455,0.29351300000053016,9239.795170895672,40366.184802644515
"10.0.2.109",51747,"194.247.12.49",38925,15,1182,7,616,8,566,26112.946582,0.33176499999899534,14853.887540924821,13648.21485091469
"10.0.2.109",51748,"80.78.242.47",80,10,878,5,394,5,484,26113.173903,0.10440500000186148,30190.124993475423,37086.34643868555
"10.0.2.109",51749,"194.247.12.49",38925,18,1675,8,1000,10,675,26113.415629,0.4533750000009604,17645.43700023833,11910.669975160872
"10.0.2.109",51750,"217.23.10.139",80,7,1047,4,341,3,706,26113.636253,0.2325779999991937,11729.398309425042,24284.326118633664
"10.0.2.109",51751,"194.247.12.49",38925,19,2751,9,2073,10,678,26113.910185,0.5310089999984484,31231.109077338533,10214.516138174398
"10.0.2.109",51752,"37.187.78.159",80,9,2177,5,398,4,1779,26114.13361,0.30745000000024447,10356.155472426308,46290.45373227739
"10.0.2.109",51753,"194.247.12.49",38925,9,506,5,286,4,220,26714.519523,0.12183400000139954,18779.651000325994,14445.88538486615
"10.0.2.109",51754,"194.247.12.49",38925,9,506,5,286,4,220,27314.718175,0.12644199999704142,18095.25315997482,13919.425507672939
"10.0.2.109",51755,"31.28.27.51",80,11,944,6,478,5,466,27690.140672,1620.0094809999973,2.3604800125240786,2.3012211000757756
"10.0.2.109",51756,"194.247.12.49",38925,18,2448,8,1775,10,673,27690.390481,0.5269630000002508,26946.86344201252,10217.036110689816
"10.0.2.109",51757,"5.101.114.217",80,7,1820,4,339,3,1481,27690.617086,0.3002050000031886,9033.82688486599,39466.36465040275
"10.0.2.109",51758,"194.247.12.49",38925,9,506,5,286,4,220,28290.995777,0.12093000000095344,18920.036384536186,14553.874141950912
"10.0.2.109",51759,"194.247.12.49",38925,9,506,5,286,4,220,28891.195516,0.12219399999958114,18724.323616608366,14403.325858929515
"10.0.2.109",51760,"31.28.27.51",80,17,1928,8,817,9,1111,29310.150581,1620.4387949999982,4.0334753896089035,5.48493409774234
"10.0.2.109",51761,"194.247.12.49",38925,18,2448,8,1775,10,673,29310.78031,0.5266260000025795,26964.10735499281,10223.5742253015
"10.0.2.109",51762,"5.101.114.217",80,7,1820,4,339,3,1481,29311.007552,0.29903700000068056,9069.111849014764,39620.5151869937
"10.0.2.109",51763,"194.247.12.49",38925,9,506,5,286,4,220,29911.382474,0.126047000001563,18151.959189600933,13963.045530462256
"10.0.2.109",51764,"194.247.12.49",38925,9,506,5,286,4,220,30511.586141,0.1266619999987597,18063.82340419703,13895.248772459256
"10.0.2.109",51765,"31.28.27.51",80,11,944,6,478,5,466,30930.589593,1620.010115000001,2.3604790887370464,2.3012201994800496
"10.0.2.109",51766,"194.247.12.49",38925,18,2448,8,1775,10,673,30930.848698,0.5233979999975418,27130.405542372522,10286.627002826313
"10.0.2.109",51767,"5.101.114.217",80,7,1820,4,339,3,1481,30931.075062,0.29689199999847915,9134.634816747815,39906.767444258156
"10.0.2.109",51768,"194.247.12.49",38925,9,506,5,286,4,220,31531.447501,0.1260760000004666,18147.783876324855,13959.83375101912
"10.0.2.109",51769,"194.247.12.49",38925,15,1182,7,616,8,566,31994.765417,0.33480100000087987,14719.191400225953,13524.4518385193
"10.0.2.109",51770,"80.78.242.47",80,10,878,5,394,5,484,31994.994505,0.10553900000013527,29865.736836581356,36687.85946422684
"10.0.2.109",51771,"194.247.12.49",38925,18,1675,8,1000,10,675,31995.239161,0.4559019999978773,17547.630850571502,11844.650824135764
"10.0.2.109",51772,"217.23.10.139",80,7,1047,4,341,3,706,31995.461523,0.23318099999960396,11699.06639050623,24221.527482983573
"10.0.2.109",51773,"194.247.12.49",38925,19,2751,9,2073,10,678,31995.734019,0.5163900000006834,32115.261720749924,10503.689072198962
"10.0.2.109",51774,"37.187.78.159",80,9,2177,5,398,4,1779,31995.954917,0.29527100000268547,10783.314311161752,48199.789345619996
"10.0.2.109",51775,"31.28.27.51",80,17,1928,8,817,9,1111,32550.600164,1621.2290390000016,4.031509331976624,5.482260548134674
"10.0.2.109",51776,"194.247.12.49",38925,18,2448,8,1775,10,673,32552.018802,0.511491000001115,27761.974306427768,10526.089413085007
"10.0.2.109",51777,"5.101.114.217",80,7,1820,4,339,3,1481,32552.237751,0.2922729999991134,9278.99600718584,40537.4427334579
"10.0.2.109",51778,"194.247.12.49",38925,9,506,5,286,4,220,33152.611111,0.12529899999935878,18260.321311516524,14046.401008858864
"10.0.2.109",51779,"194.247.12.49",38925,9,506,5,286,4,220,33752.81268,0.12624599999981,18123.346482292058,13941.035755609277
"10.0.2.109",51780,"31.28.27.51",80,11,944,6,478,5,466,34171.829357,1620.0101649999997,2.3604790158832127,2.301220128455182
"10.0.2.109",51781,"194.247.12.49",38925,18,2448,8,1775,10,673,34172.092747,0.5306339999951888,26760.441283688473,10146.353230378785
"10.0.2.109",51782,"5.101.114.217",80,7,1820,4,339,3,1481,34172.32082,0.30230699999810895,8971.012910772706,39191.94725915746
"10.0.2.109",51783,"194.247.12.49",38925,9,506,5,286,4,220,34772.699412,0.12097999999969034,18912.216895403013,14547.859150310009
"10.0.2.109",51784,"194.247.12.49",38925,15,1182,7,616,8,566,35350.645494,0.3261250000068685,15110.770409800572,13884.2468375765
"10.0.2.109",51785,"80.78.242.47",80,10,878,5,394,5,484,35350.866964,0.10463699999672826,30123.187783466223,37004.11900303973
"10.0.2.109",51786,"194.247.12.49",38925,18,1675,8,1000,10,675,35351.114417,0.7421480000048177,10779.521065809067,7276.17671942112
"10.0.2.109",51787,"217.23.10.139",80,7,1047,4,341,3,706,35351.62086,0.23546799999894574,11585.438361103055,23986.274143515417
"10.0.2.109",51788,"194.247.12.49",38925,19,2751,9,2073,10,678,35351.896909,0.532787999996799,31126.82718097937,10180.40946874289
"10.0.2.109",51789,"37.187.78.159",80,9,2177,5,398,4,1779,35352.126644,0.3027769999971497,10515.990316404395,47004.89138915433
"10.0.2.109",51790,"31.28.27.51",80,11,944,6,478,5,466,35791.840001,1620.0075730000026,2.3604827926319785,2.3012238103901717
"10.0.2.109",51791,"194.247.12.49",38925,18,2448,8,1775,10,673,35792.084635,0.7913929999995162,17943.044732526927,6803.193861966547
"10.0.2.109",51792,"5.101.114.217",80,7,1820,4,339,3,1481,35792.580859,0.2948580000011134,9197.64768122201,40182.05373418819
"10.0.2.109",51793,"194.247.12.49",38925,9,506,5,286,4,220,36392.95356,0.12231400000018766,18705.95352941192,14389.195022624554
"10.0.2.109",51794,"194.247.12.49",38925,9,506,5,286,4,220,36993.153825,0.12268899999617133,18648.778619692068,14345.214322840051
"10.0.2.109",51795,"31.28.27.51",80,17,1928,8,817,9,1111,37411.847903,1620.4913579999993,4.033344557953516,5.484756185907413
"10.0.2.109",51796,"194.247.12.49",38925,18,2448,8,1775,10,673,37412.536034,0.5201670000024023,27298.925152757514,10350.522043834259
"10.0.2.109",51797,"5.101.114.217",80,7,1820,4,339,3,1481,37412.760048,0.2959100000007311,9164.948801977966,40039.20110834621
"10.0.2.109",51798,"194.247.12.49",38925,9,506,5,286,4,220,38013.131534,0.12278900000092108,18633.59095670489,14333.531505157609
"10.0.2.109",51799,"194.247.12.49",38925,15,1182,7,616,8,566,38482.099794,0.3330050000004121,14798.576597930665,13597.393432514216
"10.0.2.109",51800,"80.78.242.47",80,10,878,5,394,5,484,38482.328038,0.10477800000080606,30082.650937942617,36954.322471990425
"10.0.2.109",51801,"194.247.12.49",38925,18,1675,8,1000,10,675,38482.571179,0.4510710000031395,17735.567127889666,11971.507811325524
"10.0.2.109",51802,"217.23.10.139",80,7,1047,4,341,3,706,38482.791928,0.2301389999993262,11853.705803918445,24541.690022188923
"10.0.2.109",51803,"194.247.12.49",38925,19,2751,9,2073,10,678,38483.061887,0.5308929999955581,31237.933067753307,10216.748007687767
"10.0.2.109",51804,"37.187.78.159",80,9,2177,5,398,4,1779,38483.289725,0.3027529999963008,10516.823945721113,47008.61758652728
"10.0.2.109",51805,"31.28.27.51",80,11,944,6,478,5,466,39032.339663,1620.006343000001,2.3604845848433804,2.3012255576088183
"10.0.2.109",51806,"194.247.12.49",38925,18,2448,8,1775,10,673,39032.583849,0.5098479999942356,27851.438075976657,10560.010042328051
"10.0.2.109",51807,"5.101.114.217",80,7,1820,4,339,3,1481,39032.801486,0.29203800000686897,9286.462720386427,40570.06279909233
"10.0.2.109",51808,"194.247.12.49",38925,9,506,5,286,4,220,39633.171341,0.1306479999984731,17512.705896965435,13471.31222843495
"10.0.2.109",51809,"194.247.12.49",38925,9,506,5,286,4,220,40233.377501,0.12073499999678461,18950.594277226435,14577.380213251103
"10.0.2.109",51810,"31.28.27.51",80,17,1928,8,817,9,1111,40652.346241,1620.4704869999987,4.033396505789004,5.484826827333639
"10.0.2.109",51811,"194.247.12.49",38925,18,2448,8,1775,10,673,40653.011739,0.5232079999987036,27140.257794290577,10290.362532708485
"10.0.2.109",51812,"5.101.114.217",80,7,1820,4,339,3,1481,40653.238365,0.29624600000533974,9154.553985374037,39993.788944952656
"10.0.2.109",51813,"194.247.12.49",38925,9,506,5,286,4,220,41253.610964,0.1212260000029346,18873.838944983854,14518.337649987581
"10.0.2.109",51814,"194.247.12.49",38925,9,506,5,286,4,220,41853.811826,0.12083500000153435,18934.911242363116,14565.31634027932
"10.0.2.109",51815,"194.247.12.49",38925,15,1182,7,616,8,566,41898.349238,0.3232429999989108,15245.496422247676,14008.037297065233
"10.0.2.109",51816,"80.78.242.47",80,10,878,5,394,5,484,41898.568972,0.10353100000065751,30444.987491475807,37399.42625856419
"10.0.2.109",51817,"194.247.12.49",38925,18,1675,8,1000,10,675,41898.813651,0.4663600000058068,17154.129856549425,11579.03765317086
"10.0.2.109",51818,"217.23.10.139",80,7,1047,4,341,3,706,41899.04164,0.23807300000044052,11458.670239779194,23723.815804352234
"10.0.2.109",51819,"194.247.12.49",38925,19,2751,9,2073,10,678,41899.317565,0.5275380000020959,31436.597932156757,10281.72378099483
"10.0.2.109",51820,"37.187.78.159",80,9,2177,5,398,4,1779,41899.545255,0.2996800000037183,10624.666310599621,47490.65669989127
"10.0.2.109",51821,"31.28.27.51",80,11,944,6,478,5,466,42272.816946,1620.0090500000006,2.360480640524816,2.301221712310804
"10.0.2.109",51822,"194.247.12.49",38925,18,2448,8,1775,10,673,42273.065537,0.5128899999981513,27686.24851342624,10497.377605372314
"10.0.2.109",51823,"5.101.114.217",80,7,1820,4,339,3,1481,42273.286087,0.2920430000012857,9286.303729204468,40569.3682092974
"10.0.2.109",51824,"194.247.12.49",38925,9,506,5,286,4,220,42873.656776,0.12063399999897229,18966.460533676178,14589.585025904753
"10.0.2.109",51825,"194.247.12.49",38925,9,506,5,286,4,220,43473.855637,0.12107699999614852,18897.065504371447,14536.204234131883
"10.0.2.109",51826,"31.28.27.51",80,17,1928,8,817,9,1111,43892.825957,1620.5997349999961,4.033074829547603,5.484389394892762
"10.0.2.109",51827,"194.247.12.49",38925,18,2448,8,1775,10,673,43893.623825,0.5186119999998482,27380.777922616824,10381.556925025985
"10.0.2.109",51828,"5.101.114.217",80,7,1820,4,339,3,1481,43893.84759,0.2945509999990463,9207.23406136384,40223.93405569277
"10.0.2.109",51829,"194.247.12.49",38925,9,506,5,286,4,220,44494.220902,0.1213320000024396,18857.350080390956,14505.653907993044
"10.0.2.109",51830,"194.247.12.49",38925,15,1182,7,616,8,566,44878.066554,0.3243170000059763,15195.009820358446,13961.64863364104
"10.0.2.109",51831,"80.78.242.47",80,10,878,5,394,5,484,44878.287279,0.10350100000505336,30453.81203897649,37410.26656564625
"10.0.2.109",51832,"194.247.12.49",38925,18,1675,8,1000,10,675,44878.52846,0.46035699999629287,17377.817650354882,11730.026913989544
"10.0.2.109",51833,"217.23.10.139",80,7,1047,4,341,3,706,44878.754552,0.2340810000023339,11654.085551466374,24128.39999805062
"10.0.2.109",51834,"194.247.12.49",38925,19,2751,9,2073,10,678,44879.030076,0.5442550000007031,30471.01083128051,9965.916711822569
"10.0.2.109",51835,"37.187.78.159",80,9,2177,5,398,4,1779,44879.259385,0.3148120000041672,10113.972783622776,45207.93362327869
"10.0.2.109",51836,"194.247.12.49",38925,23,1473,10,723,13,750,45032.757178,1.712945999999647,3376.6388432567005,3502.737389270436
"10.0.2.109",51837,"194.247.12.49",38925,23,1473,10,723,13,750,45032.816107,2.120205999999598,2728.036803971452,2829.9136970658215
"10.0.2.109",51838,"60.37.51.72",587,14,946,8,463,6,483,45033.156237,1.3136339999982738,2819.659052677433,2941.4585797909294
"10.0.2.109",51839,"60.37.51.72",587,14,946,8,463,6,483,45033.186604,1.7495689999996102,2117.0928382937886,2208.543932820518
"10.0.2.109",51840,"194.247.12.49",38925,24,1527,11,777,13,750,45035.64598,1.869542000000365,3324.878499653277,3209.3421811325065
"10.0.2.109",51841,"60.37.51.72",587,14,946,8,463,6,483,45036.015627,1.4997299999959068,2469.777893360878,2576.463763484458
"10.0.2.109",51842,"194.247.12.49",38925,23,1473,10,723,13,750,45036.136452,1.9397170000011101,2981.8782843047156,3093.234734755929
"10.0.2.109",51843,"60.37.51.72",587,14,946,8,463,6,483,45036.517439,1.558469999996305,2376.689958747221,2479.3547517816583
"10.0.2.109",51844,"194.247.12.49",38925,9,506,5,286,4,220,45038.716904,0.12582200000179,18184.419258694423,13988.014814380327
"10.0.2.109",51845,"31.28.27.51",80,11,944,6,478,5,466,45513.42583,1620.0104379999975,2.360478618101352,2.301219740659477
"10.0.2.109",51846,"194.247.12.49",38925,18,2448,8,1775,10,673,45513.685978,0.5107379999972181,27802.904816319413,10541.608417680543
"10.0.2.109",51847,"5.101.114.217",80,7,1820,4,339,3,1481,45513.903144,0.2934099999984028,9243.038751285789,40380.355134673315
"10.0.2.109",51848,"194.247.12.49",38925,9,506,5,286,4,220,46114.274974,0.12057900000218069,18975.111752117875,14596.239809321441
"10.0.2.109",51849,"194.247.12.49",38925,9,506,5,286,4,220,46714.473637,0.12226499999815132,18713.450292680613,14394.961763600471
"10.0.2.109",51850,"194.247.12.49",38925,15,1182,7,616,8,566,46821.569026,0.3318680000011227,14849.277423503709,13643.9789313362
"10.0.2.109",51851,"80.78.242.47",80,10,878,5,394,5,484,46821.792435,0.10833399999683024,29095.205568817037,35741.318516008745
"10.0.2.109",51852,"194.247.12.49",38925,18,1675,8,1000,10,675,46822.041223,0.4681960000016261,17086.86105812996,11533.631214237723
"10.0.2.109",51853,"217.23.10.139",80,7,1047,4,341,3,706,46822.269262,0.23991599999862956,11370.646392969134,23541.57288397715
"10.0.2.109",51854,"194.247.12.49",38925,19,2751,9,2073,10,678,46822.545266,0.5205629999982193,31857.815480655998,10419.488131155218
"10.0.2.109",51855,"37.187.78.159",80,9,2177,5,398,4,1779,46822.77029,0.2953419999976177,10780.722010502004,48188.20215247002
"10.0.2.109",51856,"31.28.27.51",80,17,1928,8,817,9,1111,47133.436599,1620.548275000001,4.033202898568385,5.484563549950399
"10.0.2.109",51857,"194.247.12.49",38925,18,2448,8,1775,10,673,47134.176228,0.5137370000011288,27640.6020978999,10480.070541907962
"10.0.2.109",51858,"5.101.114.217",80,7,1820,4,339,3,1481,47134.395195,0.294556000000739,9207.077771266571,40223.25126621177
"10.0.2.109",51859,"194.247.12.49",38925,9,506,5,286,4,220,47734.767537,0.1211780000012368,18881.31509000518,14524.088530773215
"10.0.2.109",51860,"194.247.12.49",38925,9,506,5,286,4,220,48334.966667,0.1207700000013574,18945.10226028222,14573.155584832479
"10.0.2.109",51861,"31.28.27.51",80,11,944,6,478,5,466,48753.985125,1620.010599000001,2.3604783835121053,2.3012195119595003
"10.0.2.109",51862,"194.247.12.49",38925,18,2448,8,1775,10,673,48754.233506,0.5298350000011851,26800.79647431415,10161.654099838548
"10.0.2.109",51863,"5.101.114.217",80,7,1820,4,339,3,1481,48754.463666,0.29935399999521906,9059.508141008015,39578.55916469873
"10.0.2.109",51864,"194.247.12.49",38925,9,506,5,286,4,220,49354.838376,0.12519199999951525,18275.928174395005,14058.406287996157
"10.0.2.109",51865,"194.247.12.49",38925,9,506,5,286,4,220,49955.039682,0.12048099999810802,18990.54622750417,14608.112482695515
"10.0.2.109",51866,"31.28.27.51",80,11,944,6,478,5,466,50373.996181,1620.007077999995,2.3604835138874694,2.30122451353883
"10.0.2.109",51867,"194.247.12.49",38925,18,2448,8,1775,10,673,50374.251042,0.5225059999938821,27176.72141595745,10304.187894613726
"10.0.2.109",51868,"5.101.114.217",80,7,1820,4,339,3,1481,50374.477471,0.29585400000360096,9166.683566782911,40046.77983010469
"10.0.2.109",51869,"194.247.12.49",38925,23,1473,10,723,13,750,50924.53246,1.3767860000007204,4201.088622339981,4357.975749315334
"10.0.2.109",51870,"194.247.12.49",38925,23,1473,10,723,13,750,50924.593399,1.817564000004495,3182.2813391911895,3301.1217211526864
"10.0.2.109",51871,"60.37.51.72",587,14,946,8,463,6,483,50924.909122,0.9998840000043856,3704.4297138305583,3864.448275983066
"10.0.2.109",51872,"60.37.51.72",587,14,946,8,463,6,483,50924.970982,1.43966100000398,2572.8279087853043,2683.9651834628553
"10.0.2.109",51873,"194.247.12.49",38925,23,1473,10,723,13,750,50927.111803,1.700419000000693,3401.514567878648,3528.5420828616684
"10.0.2.109",51874,"60.37.51.72",587,14,946,8,463,6,483,50927.481108,1.3309660000013537,2782.9411119414267,2903.1545509021794
"10.0.2.109",51875,"194.247.12.49",38925,24,1527,11,777,13,750,50927.614437,2.7096700000038254,2294.006281204436,2214.291777224359
"10.0.2.109",51876,"60.37.51.72",587,14,946,8,463,6,483,50928.003588,2.32025099999737,1596.3790124448599,1665.3370691379423
"10.0.2.109",51877,"194.247.12.49",38925,17,1029,8,518,9,511,50930.031477,0.6276230000003125,6602.689831312646,6513.464293051665
"10.0.2.109",51878,"60.37.51.72",587,6,394,4,224,2,170,50930.399667,0.25918900000397116,6913.873659655865,5247.136259560254
"10.0.2.109",51879,"194.247.12.49",38925,15,1182,7,616,8,566,51514.467923,1.327145000002929,3713.2340475148712,3411.835180021781
"10.0.2.109",51880,"80.78.242.47",80,10,878,5,394,5,484,51515.690409,0.10467599999537924,30111.96453952329,36990.332073932164
"10.0.2.109",51881,"194.247.12.49",38925,18,1675,8,1000,10,675,51515.933007,0.4498860000021523,17782.282622623792,12003.04077027106
"10.0.2.109",51882,"217.23.10.139",80,7,1047,4,341,3,706,51516.152718,0.2299540000021807,11863.242213547623,24561.434025702703
"10.0.2.109",51883,"194.247.12.49",38925,19,2747,9,2069,10,678,51516.42139,0.5196979999964242,31849.266304880693,10436.830620932387
"10.0.2.109",51884,"37.187.78.159",80,9,2173,5,398,4,1775,51516.64591,0.2949109999972279,10796.477581473491,48150.11986712424
"10.0.2.109",51885,"31.28.27.51",80,17,1928,8,817,9,1111,51994.003482,1620.480064000003,4.033372668508181,5.484794412132912
"10.0.2.109",51886,"194.247.12.49",38925,18,2448,8,1775,10,673,51994.676911,0.5109139999985928,27793.327252804018,10537.97703726034
"10.0.2.109",51887,"5.101.114.217",80,7,1820,4,339,3,1481,51994.894421,0.2932520000031218,9248.018768742002,40402.11149412066
"10.0.2.109",51888,"194.247.12.49",38925,9,506,5,286,4,220,52595.266529,0.12690899999870453,18028.666209830317,13868.20477679255
"10.0.2.109",51889,"194.247.12.49",38925,9,506,5,286,4,220,53195.469172,0.12543100000038976,18241.104671037385,14031.618977721066
"10.0.2.109",51890,"194.247.12.49",38925,15,1182,7,616,8,566,53404.10355,0.32602200000110315,15115.544349716662,13888.63328236953
"10.0.2.109",51891,"80.78.242.47",80,10,878,5,394,5,484,53404.324956,0.104631000001973,30124.915177534032,37006.24097950881
"10.0.2.109",51892,"194.247.12.49",38925,18,1675,8,1000,10,675,53404.833863,0.45120699999824865,17730.221384045577,11967.899434230763
"10.0.2.109",51893,"217.23.10.139",80,7,1047,4,341,3,706,53405.05332,0.2315660000022035,11780.658645803102,24390.454556999972
"10.0.2.109",51894,"194.247.12.49",38925,19,2751,9,2073,10,678,53405.324216,0.5348069999963627,31009.31738012552,10141.976451386929
"10.0.2.109",51895,"37.187.78.159",80,9,2177,5,398,4,1779,53405.556108,0.3027670000010403,10516.337645744285,47006.44389894242
"10.0.2.109",51896,"31.28.27.51",80,11,944,6,478,5,466,53614.483771,1620.0084790000037,2.3604814725170282,2.3012225234161825
"10.0.2.109",51897,"194.247.12.49",38925,18,2448,8,1775,10,673,53614.737345,0.5151379999952042,27565.429069748687,10451.568317713165
"10.0.2.109",51898,"5.101.114.217",80,7,1820,4,339,3,1481,53614.957217,0.2950979999950505,9190.167334395648,40149.37410690252
"10.0.2.109",51899,"194.247.12.49",38925,9,506,5,286,4,220,54215.330412,0.12500100000033854,18303.853569121875,14079.88736086298
"10.0.2.109",51900,"194.247.12.49",38925,9,506,5,286,4,220,54815.531181,0.1205919999993057,18973.066206822783,14594.666312940602
"10.0.2.109",51901,"31.28.27.51",80,17,1928,8,817,9,1111,55234.492415,1620.4497919999994,4.033448016882464,5.484896874854857
"10.0.2.109",51902,"194.247.12.49",38925,18,2448,8,1775,10,673,55235.138513,0.5132159999993746,27668.6619279549,10490.709564796422
"10.0.2.109",51903,"5.101.114.217",80,7,1820,4,339,3,1481,55235.356936,0.29461600000649923,9205.202704334364,40215.05960212152
"10.0.2.109",51904,"194.247.12.49",38925,9,506,5,286,4,220,55835.729404,0.12089299999934155,18925.82697106087,14558.328439277591
"10.0.2.109",51905,"194.247.12.49",38925,15,1182,7,616,8,566,56292.187884,0.3341209999998682,14749.147763839877,13551.976679112615
"10.0.2.109",51906,"80.78.242.47",80,10,878,5,394,5,484,56292.411547,0.1103819999989355,28555.380406501034,35078.18303742767
"10.0.2.109",51907,"194.247.12.49",38925,18,1675,8,1000,10,675,56292.663002,0.4665229999955045,17148.136319274912,11574.992015510565
"10.0.2.109",51908,"217.23.10.139",80,7,1047,4,341,3,706,56292.891267,0.23811700000078417,11456.552871029855,23719.432043833072
"10.0.2.109",51909,"194.247.12.49",38925,19,2746,9,2068,10,678,56293.164468,0.5161519999965094,32052.57366068887,10508.532370380588
"10.0.2.109",51910,"37.187.78.159",80,9,2172,5,398,4,1774,56293.384208,0.2962589999951888,10747.352823211135,47904.029920544104
"10.0.2.109",51911,"31.28.27.51",80,11,944,6,478,5,466,56854.942412,1620.009134,2.3604805181302146,2.3012215929888704
"10.0.2.109",51912,"194.247.12.49",38925,18,2448,8,1775,10,673,56855.190815,0.5081070000014734,27946.86945851725,10596.19332145471
"10.0.2.109",51913,"5.101.114.217",80,7,1820,4,339,3,1481,56855.408591,0.2901189999975031,9347.8882804068,40838.414581954195
"10.0.2.109",51914,"194.247.12.49",38925,9,506,5,286,4,220,57455.777257,0.12495800000033341,18310.15221109409,14084.732470072377
"10.0.2.109",51915,"194.247.12.49",38925,9,506,5,286,4,220,58055.978064,0.12090799999714363,18923.479009280218,14556.522314830936
"10.0.2.109",51916,"31.28.27.51",80,17,1928,8,817,9,1111,58474.951723,1620.7397410000049,4.0327264363661826,5.483915631337612
"10.0.2.109",51917,"194.247.12.49",38925,18,2448,8,1775,10,673,58475.889056,0.5084310000020196,27929.060187013765,10589.44084837198
"10.0.2.109",51918,"5.101.114.217",80,7,1820,4,339,3,1481,58476.106458,0.29072099999757484,9328.531478711971,40753.8499114231
"10.0.2.109",51919,"194.247.12.49",38925,9,506,5,286,4,220,59076.475553,0.1211680000051274,18882.873365106134,14525.287203927795
"10.0.2.109",51920,"194.247.12.49",38925,9,506,5,286,4,220,59676.674306,0.1255989999990561,18216.705547155587,14012.850420888914
"10.0.2.109",51921,"31.28.27.51",80,11,944,6,478,5,466,60095.691605,1620.008858000001,2.3604809202839543,2.3012219850467
"10.0.2.109",51922,"194.247.12.49",38925,18,2448,8,1775,10,673,60095.942249,0.5096770000018296,27860.782416999446,10563.552995290494
"10.0.2.109",51923,"5.101.114.217",80,7,1820,4,339,3,1481,60096.160862,0.2909330000038608,9321.733869873857,40724.15298313623
"10.0.2.109",51924,"194.247.12.49",38925,9,506,5,286,4,220,60696.52982,0.1207769999964512,18944.004239774367,14572.31095367259
"10.0.2.109",51925,"194.247.12.49",38925,9,506,5,286,4,220,61296.728799,0.1255070000042906,18230.058880554727,14023.122215811329
"10.0.2.109",51926,"194.247.12.49",38925,15,1182,7,616,8,566,61626.806402,0.32644299999810755,15096.050459126305,13870.721688093327
"10.0.2.109",51927,"80.78.242.47",80,10,878,5,394,5,484,61627.028586,0.10420000000158325,30249.52015309124,37159.30902054863
"10.0.2.109",51928,"194.247.12.49",38925,18,1675,8,1000,10,675,61627.274373,0.45970200000010664,17402.5781919551,11746.740279569694
"10.0.2.109",51929,"217.23.10.139",80,7,1047,4,341,3,706,61627.496166,0.23777500000142027,11473.031226931786,23753.548522621233
"10.0.2.109",51930,"194.247.12.49",38925,19,2747,9,2069,10,678,61627.770105,0.5164789999980712,32047.76960933903,10501.879069662573
"10.0.2.109",51931,"37.187.78.159",80,9,2173,5,398,4,1775,61627.990144,0.29630899999756366,10745.539285091509,47922.94530411414
"10.0.2.109",51932,"31.28.27.51",80,17,1928,8,817,9,1111,61715.700661,1620.6805559999993,4.032873705927279,5.484115896309922
"10.0.2.109",51933,"194.247.12.49",38925,18,2448,8,1775,10,673,61716.569638,0.5233349999980419,27133.671548918246,10287.865325308157
"10.0.2.109",51934,"5.101.114.217",80,7,1820,4,339,3,1481,61716.788584,0.30418700000154786,8915.568383876365,38949.72500448642
"10.0.2.109",51935,"194.247.12.49",38925,9,506,5,286,4,220,62317.170917,0.12090399999578949,18924.105075759944,14557.003904430725
"10.0.2.109",51936,"194.247.12.49",38925,9,506,5,286,4,220,62917.369746,0.12700200000108453,18015.46432324264,13858.049479417416
"10.0.2.109",51937,"31.28.27.51",80,11,944,6,478,5,466,63336.381425,1620.0087950000016,2.3604810120799353,2.3012220745381797
"10.0.2.109",51938,"194.247.12.49",38925,18,2448,8,1775,10,673,63336.62578,0.5253069999962463,27031.81187401171,10249.244727442187
"10.0.2.109",51939,"5.101.114.217",80,7,1820,4,339,3,1481,63336.844709,0.3062030000000959,8856.869462412682,38693.28517354921
"10.0.2.109",51940,"194.247.12.49",38925,9,506,5,286,4,220,63937.228957,0.12137200000142911,18851.135352248126,14500.873347883175
"10.0.2.109",51941,"194.247.12.49",38925,9,506,5,286,4,220,64537.428873,0.12550000000192085,18231.07569693212,14023.904382255476
"10.0.2.109",51942,"31.28.27.51",80,17,1928,8,817,9,1111,64956.390428,1620.4994860000006,4.033324327756064,5.484728675810266
"10.0.2.109",51943,"194.247.12.49",38925,18,2448,8,1775,10,673,64957.08306,0.546068000003288,26004.087402877478,9859.577927964248
"10.0.2.109",51944,"5.101.114.217",80,7,1820,4,339,3,1481,64957.301789,0.32713100000546547,8290.256808296033,36217.9065872756
"10.0.2.109",51945,"194.247.12.49",38925,9,506,5,286,4,220,65557.70698,0.12127899999904912,18865.590910363204,14511.993007971694
"10.0.2.109",51946,"194.247.12.49",38925,9,506,5,286,4,220,66157.907031,0.12090000000898726,18924.731181388903,14557.485524145312
"10.0.2.109",51947,"31.28.27.51",80,11,944,6,478,5,466,66576.890186,1620.009171999991,2.3604804627612452,2.3012215390099167
"10.0.2.109",51948,"194.247.12.49",38925,18,2448,8,1775,10,673,66577.144677,0.5177519999997457,27426.258131319577,10398.800970353845
"10.0.2.109",51949,"5.101.114.217",80,7,1820,4,339,3,1481,66577.361722,0.3005669999984093,9022.946630915412,39418.83174155081
"10.0.2.109",51950,"194.247.12.49",38925,9,506,5,286,4,220,67177.740122,0.12074399999983143,18949.181739905867,14576.293646081438
"10.0.2.109",51951,"194.247.12.49",38925,9,506,5,286,4,220,67777.93936,0.1218349999981001,18779.49686080091,14445.766816000702
"10.0.2.109",51952,"31.28.27.51",80,11,944,6,478,5,466,68196.89956,1620.0093479999923,2.360480206315463,2.3012212890021035
"10.0.2.109",51953,"194.247.12.49",38925,18,2448,8,1775,10,673,68197.158078,0.5282440000009956,26881.5168747269,10192.25963757251
"10.0.2.109",51954,"5.101.114.217",80,7,1820,4,339,3,1481,68197.377298,0.3088909999933094,8779.796109497338,38356.5723839692
"10.0.2.109",51955,"194.247.12.49",38925,15,1182,7,616,8,566,68393.162567,0.8836039999878267,5577.158998904365,5124.4675217205695
"10.0.2.109",51956,"194.247.12.49",38925,15,1182,7,616,8,566,68393.222639,2.5915379999933066,1901.5735057763877,1747.2250069309016
"10.0.2.109",51957,"194.247.12.49",38925,15,1182,7,616,8,566,68393.319796,0.3250350000016624,15161.444152090684,13930.807451433973
"10.0.2.109",51958,"80.78.242.47",80,10,878,5,394,5,484,68393.540897,0.10389100000611506,30339.490425681455,37269.830878248285
"10.0.2.109",51959,"80.78.242.47",80,10,878,5,394,5,484,68393.942648,0.10354599999845959,30440.577135252843,37394.00846056441
"10.0.2.109",51960,"194.247.12.49",38925,19,1729,9,1054,10,675,68394.049591,2.8698139999905834,2938.1695120407344,1881.655048033677
"10.0.2.109",51961,"194.247.12.49",38925,18,1675,8,1000,10,675,68394.309821,1.7433000000019092,4588.997877583456,3097.5735673688328
"10.0.2.109",51962,"217.23.10.139",80,8,1101,5,395,3,706,68395.269221,1.6499480000056792,1915.211873337295,3423.1381837370386
"10.0.2.109",51963,"217.23.10.139",80,8,1101,5,395,3,706,68395.536827,0.51604899999802,6123.449517414285,10944.697112137937
"10.0.2.109",51964,"80.78.242.47",80,10,878,5,394,5,484,68395.710643,0.10345500000403263,30467.35295420363,37426.900583336435
"10.0.2.109",51965,"194.247.12.49",38925,19,1729,9,1054,10,675,68395.953337,3.220113000003039,2618.541647449031,1676.959783707871
"10.0.2.109",51966,"194.247.12.49",38925,21,2859,11,2181,10,678,68396.089897,2.027060000007623,8607.53998398389,2675.796473700632
"10.0.2.109",51967,"37.187.78.159",80,9,2177,5,398,4,1779,68396.593323,1.523395000011078,2090.068563948842,9342.291395138165
"10.0.2.109",51968,"194.247.12.49",38925,20,2809,10,2131,10,678,68396.959317,3.8043929999985266,4481.135361148704,1425.720213448532
"10.0.2.109",51969,"217.23.10.139",80,8,1101,5,395,3,706,68397.728763,1.4443389999942156,2187.8520208985947,3910.4393082390075
"10.0.2.109",51970,"194.247.12.49",38925,20,2809,10,2131,10,678,68399.210333,4.081716000000597,4176.674712301764,1328.852864824306
"10.0.2.109",51971,"37.187.78.159",80,9,2173,5,398,4,1775,68400.184988,0.5785090000135824,5503.803743632761,24545.85840439234
"10.0.2.109",51972,"37.187.78.159",80,9,2173,5,398,4,1775,68402.713006,0.5787349999882281,5501.654470638142,24536.27307885101
"10.0.2.109",51973,"194.247.12.49",38925,15,1182,7,616,8,566,68423.212406,0.3242339999997057,15198.899560207976,13965.222647853432
"10.0.2.109",51974,"80.78.242.47",80,10,878,5,394,5,484,68423.433662,0.1029500000004191,30616.80427379474,37610.49052923009
"10.0.2.109",51975,"194.247.12.49",38925,18,1675,8,1000,10,675,68423.675854,0.4546200000040699,17597.114073134446,11878.05199936575
"10.0.2.109",51976,"217.23.10.139",80,7,1047,4,341,3,706,68423.897128,0.23301999999966938,11707.149600909237,24238.262810093613
"10.0.2.109",51977,"194.247.12.49",38925,19,2747,9,2069,10,678,68424.168724,0.5228550000028918,31656.96034255856,10373.813007372984
"10.0.2.109",51978,"37.187.78.159",80,9,2173,5,398,4,1775,68424.393941,0.2974370000010822,10704.787904626577,47741.2023384728
"10.0.2.109",51979,"194.247.12.49",38925,9,506,5,286,4,220,69024.769703,0.1255010000022594,18230.93043050501,14023.792638850007
"10.0.2.109",51980,"194.247.12.49",38925,9,506,5,286,4,220,69624.971052,0.12160100000619423,18815.634738887442,14473.56518375957
"10.0.2.109",51981,"31.28.27.51",80,17,1928,8,817,9,1111,69816.909051,1620.4798410000076,4.033373223554942,5.484795166914982
"10.0.2.109",51982,"194.247.12.49",38925,18,2448,8,1775,10,673,69817.576694,0.5526309999986552,25695.26501414969,9742.486396914219
"10.0.2.109",51983,"5.101.114.217",80,7,1820,4,339,3,1481,69817.80185,0.3272869999927934,8286.305291868348,36200.64347273458
"10.0.2.109",51984,"194.247.12.49",38925,9,506,5,286,4,220,70418.204969,0.12146599999687169,18836.54685310232,14489.651425463324
"10.0.2.109",51985,"194.247.12.49",38925,9,506,5,286,4,220,71018.404471,0.12100099999224767,18908.93463811529,14545.334337011762
"10.0.2.109",51986,"31.28.27.51",80,11,944,6,478,5,466,71437.389034,1620.0106319999904,2.3604783354286174,2.301219465083129
"10.0.2.109",51987,"194.247.12.49",38925,18,2448,8,1775,10,673,71437.631031,0.5573830000066664,25476.19859204562,9659.426283068566
"10.0.2.109",51988,"5.101.114.217",80,7,1820,4,339,3,1481,71437.856722,0.3314140000002226,8183.118395717074,35749.84762258698
"10.0.2.109",51989,"194.247.12.49",38925,9,506,5,286,4,220,72038.262949,0.1255630000086967,18221.92843306969,14016.868025438223
"10.0.2.109",51990,"194.247.12.49",38925,9,506,5,286,4,220,72638.464192,0.12551700000767596,18228.60648246913,14022.004986514716
"10.0.2.109",51991,"31.28.27.51",80,17,1928,8,817,9,1111,73057.400093,1620.5577150000026,4.0331794045360425,5.4845316015171885
"10.0.2.109",51992,"194.247.12.49",38925,18,2448,8,1775,10,673,73058.143832,0.5348229999945033,26550.84018478252,10066.881940483738
"10.0.2.109",51993,"5.101.114.217",80,7,1820,4,339,3,1481,73058.363541,0.314979000002495,8610.097815976676,37615.206092806664
"10.0.2.109",51994,"194.247.12.49",38925,9,506,5,286,4,220,73658.756655,0.1259040000004461,18172.575930803574,13978.904562156595
"10.0.2.109",51995,"194.247.12.49",38925,9,506,5,286,4,220,74258.958089,0.12579699998605065,18188.033102965182,13990.794694588603
"10.0.2.109",51996,"194.247.12.49",38925,15,1182,7,616,8,566,74323.756761,0.3300210000015795,14932.383090701544,13720.33900866408
"10.0.2.109",51997,"80.78.242.47",80,10,878,5,394,5,484,74323.981483,0.10517999999865424,29967.674463209063,36813.082335515704
"10.0.2.109",51998,"194.247.12.49",38925,18,1675,8,1000,10,675,74324.225364,0.4635899999993853,17256.627623569548,11648.223645909446
"10.0.2.109",51999,"217.23.10.139",80,7,1047,4,341,3,706,74324.452731,0.23602799999935087,11557.950751637529,23929.364312774473
"10.0.2.109",52000,"194.247.12.49",38925,19,2751,9,2073,10,678,74324.725892,0.5249320000002626,31592.66343067617,10332.766910756605
"10.0.2.109",52001,"37.187.78.159",80,9,2177,5,398,4,1779,74324.952215,0.29826199999661185,10675.17819915433,47716.437226873255
"10.0.2.109",52002,"31.28.27.51",80,11,944,6,478,5,466,74677.957991,1620.0104460000002,2.3604786064447385,2.3012197292954983
"10.0.2.109",52003,"194.247.12.49",38925,18,2448,8,1775,10,673,74678.203123,0.5128350000013597,27689.21777952431,10498.503417250626
"10.0.2.109",52004,"5.101.114.217",80,7,1820,4,339,3,1481,74678.423299,0.29242599999997765,9274.141150240428,40516.233166684586
"10.0.2.109",52005,"194.247.12.49",38925,9,506,5,286,4,220,75278.794239,0.12568800000008196,18203.80625038594,14002.927884912262
"10.0.2.109",52006,"194.247.12.49",38925,9,506,5,286,4,220,75878.99597,0.12196999999287073,18758.71115957806,14429.777815060046
"10.0.2.109",52007,"194.247.12.49",38925,15,1182,7,616,8,566,76219.059172,0.3238920000003418,15214.948192591357,13979.968631504396
"10.0.2.109",52008,"80.78.242.47",80,10,878,5,394,5,484,76219.281172,0.1018669999903068,30942.30712890269,38010.34682839823
"10.0.2.109",52009,"194.247.12.49",38925,18,1675,8,1000,10,675,76219.521183,0.45345200000156183,17642.44065517948,11908.647442246149
"10.0.2.109",52010,"217.23.10.139",80,7,1047,4,341,3,706,76219.741575,0.23287000000709668,11714.690599548523,24253.87555214445
"10.0.2.109",52011,"194.247.12.49",38925,19,2747,9,2069,10,678,76220.013851,0.5230930000107037,31642.55686782524,10369.093067368542
"10.0.2.109",52012,"37.187.78.159",80,9,2173,5,398,4,1775,76220.235544,0.30126300000119954,10568.838523108787,47134.8954234123
"10.0.2.109",52013,"31.28.27.51",80,17,1928,8,817,9,1111,76297.96886,1620.6391380000132,4.032976772402215,5.484256051577552
"10.0.2.109",52014,"194.247.12.49",38925,18,2448,8,1775,10,673,76298.796487,0.5097180000011576,27858.541389489383,10562.703298662736
"10.0.2.109",52015,"5.101.114.217",80,7,1820,4,339,3,1481,76299.01439,0.2914500000042608,9305.198147059024,40651.91284895108
"10.0.2.109",52016,"194.247.12.49",38925,9,506,5,286,4,220,76899.384155,0.12284499999077525,18625.0966679296,14326.997436868924
"10.0.2.109",52017,"194.247.12.49",38925,9,506,5,286,4,220,77499.584867,0.12642800000321586,18097.25693629419,13920.966874072454
"10.0.2.109",52018,"31.28.27.51",80,11,944,6,478,5,466,77918.60816,1620.0078569999896,2.3604823788209717,2.3012234069677255
"10.0.2.109",52019,"194.247.12.49",38925,18,2448,8,1775,10,673,77918.871923,0.5102349999942817,27830.313483314832,10552.000548885004
"10.0.2.109",52020,"5.101.114.217",80,7,1820,4,339,3,1481,77919.090549,0.29141799999342766,9306.219931717202,40656.37675183828
"10.0.2.109",52021,"194.247.12.49",38925,9,506,5,286,4,220,78519.460004,0.12568200001260266,18204.67528978352,14003.596376756555
"10.0.2.109",52022,"194.247.12.49",38925,9,506,5,286,4,220,79119.661123,0.12227600000915118,18711.766821197663,14393.666785536663
"10.0.2.109",52023,"31.28.27.51",80,17,1928,8,817,9,1111,79538.616235,1620.4712160000054,4.0333946912883505,5.484824359879263
"10.0.2.109",52024,"194.247.12.49",38925,18,2448,8,1775,10,673,79539.272321,0.5225290000089444,27175.525185696737,10303.734338013468
"10.0.2.109",52025,"5.101.114.217",80,7,1820,4,339,3,1481,79539.498221,0.2963049999962095,9152.731138639892,39985.825416889915
"10.0.2.109",52026,"194.247.12.49",38925,9,506,5,286,4,220,80139.86999,0.12147499999264255,18835.15126683333,14488.577897564099
"10.0.2.109",52027,"194.247.12.49",38925,9,506,5,286,4,220,80740.069271,0.12126600000192411,18867.613345568392,14513.548727360301
"10.0.2.109",52028,"31.28.27.51",80,11,944,6,478,5,466,81159.087703,1620.007528000002,2.3604828582006414,2.3012238743127593
"10.0.2.109",52029,"194.247.12.49",38925,18,2448,8,1775,10,673,81159.335062,0.5242010000074515,27088.845690485417,10270.86938011081
"10.0.2.109",52030,"5.101.114.217",80,7,1820,4,339,3,1481,81159.562447,0.2965849999891361,9144.09022741993,39948.075595306545
"10.0.2.109",52031,"194.247.12.49",38925,9,506,5,286,4,220,81759.933588,0.1208139999944251,18938.20252707119,14567.848097747068
"10.0.2.109",52032,"194.247.12.49",38925,9,506,5,286,4,220,82360.13262,0.121541000000434,18824.92327685168,14480.710212962831
"10.0.2.109",52033,"31.28.27.51",80,11,944,6,478,5,466,82779.095576,1620.009619999997,2.3604798099902684,2.301220902626496
"10.0.2.109",52034,"194.247.12.49",38925,18,2448,8,1775,10,673,82779.34147,0.5099510000000009,27845.81263690036,10557.877129371234
"10.0.2.109",52035,"5.101.114.217",80,7,1820,4,339,3,1481,82779.560856,0.29037000000244007,9339.807831309055,40803.11326893425
"10.0.2.109",52036,"194.247.12.49",38925,9,506,5,286,4,220,83379.928734,0.12682999999378808,18039.895924560926,13876.843018893022
"10.0.2.109",52037,"194.247.12.49",38925,9,506,5,286,4,220,83980.131165,0.12127200000395533,18866.679859533742,14512.830661179802
"10.0.2.109",52038,"31.28.27.51",80,17,1928,8,817,9,1111,84399.105329,1620.490438000008,4.033346847801621,5.484759299764505
"10.0.2.109",52039,"194.247.12.49",38925,18,2448,8,1775,10,673,84399.781729,0.5226919999986421,27167.05057670079,10300.521148236412
"10.0.2.109",52040,"5.101.114.217",80,7,1820,4,339,3,1481,84400.008285,0.2959089999931166,9164.97977440053,40039.33641854626
"10.0.2.109",52041,"194.247.12.49",38925,9,506,5,286,4,220,85000.379839,0.12571399999433197,18200.04136455095,14000.031818885347
"10.0.2.109",52042,"194.247.12.49",38925,9,506,5,286,4,220,85600.581416,0.12125399999786168,18869.48059478738,14514.985072913369
"10.0.2.109",52043,"31.28.27.51",80,11,944,6,478,5,466,86019.596221,1620.0079799999949,2.3604821996000367,2.301223232246061
"10.0.2.109",52044,"194.247.12.49",38925,18,2448,8,1775,10,673,86019.852555,0.5127549999888288,27693.537850063618,10500.141393291728
"10.0.2.109",52045,"5.101.114.217",80,7,1820,4,339,3,1481,86020.073791,0.2913819999957923,9307.369707254267,40661.399812517906
"10.0.2.109",52046,"194.247.12.49",38925,15,1182,7,616,8,566,86212.453849,0.32800000000861473,15024.390243507833,13804.87804841791
"10.0.2.109",52047,"80.78.242.47",80,10,878,5,394,5,484,86212.675453,0.10619399999268353,29681.52626529902,36461.5703360526
"10.0.2.109",52048,"194.247.12.49",38925,18,1675,8,1000,10,675,86212.920999,0.4657790000055684,17175.527449507943,11593.481028417862
"10.0.2.109",52049,"217.23.10.139",80,7,1047,4,341,3,706,86213.149583,0.23690699999860954,11515.067093906095,23840.578792661887
"10.0.2.109",52050,"194.247.12.49",38925,19,2747,9,2069,10,678,86213.424269,0.5233420000004116,31627.501710137883,10364.159574419278
"10.0.2.109",52051,"37.187.78.159",80,9,2173,5,398,4,1775,86213.6482,0.29922200000146404,10640.928808658526,47456.40360645448
"10.0.2.109",52052,"194.247.12.49",38925,9,506,5,286,4,220,86814.025379,0.12229600000136998,18708.70674408296,14391.312880063815
"10.0.2.109",52053,"194.247.12.49",38925,9,506,5,286,4,220,87414.22607,0.12168699999165256,18802.33714494524,14463.336265342492
"10.0.2.109",52054,"31.28.27.51",80,23,2877,10,1139,13,1738,87639.604398,1620.719827000008,5.622193205883422,8.578904119249682
"10.0.2.109",52055,"91.185.215.137",495,464,26932,231,12486,233,14446,87641.328448,87495.32339399999,1.1416381599070682,1.3208477381080814
"10.0.2.109",52056,"91.185.215.137",35341,18,2452,8,1778,10,674,87641.551113,0.30945400000200607,45964.82837484017,17424.23752792029
"10.0.2.109",52057,"5.101.114.217",80,7,1824,4,340,3,1484,87641.655456,0.20492800000647549,13272.954403078404,57932.542159318684
"10.0.2.109",52058,"91.185.215.137",35341,9,506,5,286,4,220,88241.978479,0.0519849999982398,44012.695971481604,33855.919978062775
"10.0.2.109",52059,"91.185.215.137",35341,9,506,5,286,4,220,88842.165979,0.056263999998918734,40665.43438155784,31281.103370429104
"10.0.2.109",52060,"91.185.215.137",35341,15,1183,7,616,8,567,88873.761648,0.16360499999427702,30121.328811297844,27725.31401949006
"10.0.2.109",52061,"80.78.242.47",80,10,879,5,395,5,484,88873.867781,0.05738700000802055,55064.73590810376,67471.72703676512
"10.0.2.109",52062,"91.185.215.137",35341,18,1676,8,1000,10,676,88874.007911,0.24672100000316277,32425.29010460174,21919.496110710777
"10.0.2.109",52063,"217.23.10.139",80,7,1048,4,342,3,706,88874.113602,0.1407290000061039,19441.621839715557,40133.87432409118
"10.0.2.109",52064,"91.185.215.137",35341,19,2751,9,2072,10,679,88874.28308,0.28205000000889413,58769.721678699854,19258.99663119556
"10.0.2.109",52065,"37.187.78.159",80,9,2177,5,399,4,1778,88874.38944,0.17536399999517016,18202.13955023787,81111.2885221126
"10.0.2.109",52066,"31.28.27.51",80,11,945,6,479,5,466,89260.324466,1620.0100539999985,2.365417418576097,2.301220286130399
"10.0.2.109",52067,"91.185.215.137",35341,18,2452,8,1778,10,674,89260.53425,0.29894100000092294,47581.29530561577,18037.003957246925
"10.0.2.109",52068,"5.101.114.217",80,7,1824,4,340,3,1484,89260.639419,0.19342799999867566,14062.079947156684,61376.843063472115
"10.0.2.109",52069,"91.185.215.137",35341,9,506,5,286,4,220,89860.95661,0.06055800001195166,37781.961087691845,29063.046990532188
"10.0.2.109",52070,"91.185.215.137",35341,9,506,5,286,4,220,90461.133923,0.053253999998560175,42963.90881552298,33049.160627325364
"10.0.2.109",52071,"31.28.27.51",80,11,945,6,479,5,466,90880.334944,1620.007442000002,2.3654212324291257,2.3012239964759345
"10.0.2.109",52072,"91.185.215.137",35341,18,2452,8,1778,10,674,90880.553109,0.29450099999667145,48298.64754333861,18308.936132851646
"10.0.2.109",52073,"5.101.114.217",80,7,1824,4,340,3,1484,90880.655065,0.1922820000036154,14145.889890623444,61742.64881672115
"10.0.2.109",52074,"91.185.215.137",35341,9,506,5,286,4,220,91480.976722,0.06889499998942483,33209.95718631542,25546.120912550323
"10.0.2.109",52075,"91.185.215.137",35341,9,506,5,286,4,220,92081.16336,0.05334299999231007,42892.22579025998,32994.01983866152
"10.0.2.109",52076,"31.28.27.51",80,17,1929,8,818,9,1111,92500.342637,1620.7285380000103,4.037690363665305,5.483953537936618
"10.0.2.109",52077,"91.185.215.137",35341,18,2452,8,1778,10,674,92500.926038,0.29447899998922367,48302.25585023218,18310.303961224123
"10.0.2.109",52078,"5.101.114.217",80,7,1824,4,340,3,1484,92501.027094,0.19311799999559298,14084.652906834533,61475.36739336014
"10.0.2.109",52079,"91.185.215.137",35341,9,506,5,286,4,220,93101.342452,0.052970999997342005,43193.44547233029,33225.72728640792
"10.0.2.109",52080,"91.185.215.137",35341,9,506,5,286,4,220,93701.517715,0.05220099999860395,43830.577959448856,33715.829199576045
"10.0.2.109",52081,"31.28.27.51",80,11,945,6,479,5,466,94120.774361,1620.0077889999957,2.3654207257641833,2.301223503561815
"10.0.2.109",52082,"91.185.215.137",35341,18,2452,8,1778,10,674,94120.994149,0.299444999996922,47501.21057338145,18006.645627929753
"10.0.2.109",52083,"5.101.114.217",80,7,1824,4,340,3,1484,94121.098258,0.19520099999499507,13934.3548448509,60819.36055811393
"10.0.2.109",52084,"91.185.215.137",35341,15,1183,7,616,8,567,94374.167345,0.41990700000314973,11735.932003903328,10802.39195813829
"10.0.2.109",52085,"91.185.215.137",35341,15,1183,7,616,8,567,94374.192685,0.1712299999926472,28780.00350529471,26490.685044646267
"10.0.2.109",52086,"91.185.215.137",35341,16,1237,8,670,8,567,94374.28476,0.5920920000062324,9052.647223646967,7660.9716056833295
"10.0.2.109",52087,"80.78.242.47",80,10,879,5,395,5,484,94374.306192,0.05763699999079108,54825.89309826825,67179.06901154894
"10.0.2.109",52088,"80.78.242.47",80,10,879,5,395,5,484,94374.391063,0.4856809999910183,6506.328227907696,7972.311043816012
"10.0.2.109",52089,"91.185.215.137",35341,18,1676,8,1000,10,676,94374.447346,0.2774959999951534,28829.244386008173,19488.569204941527
"10.0.2.109",52090,"80.78.242.47",80,10,879,5,395,5,484,94374.529155,0.058073000007425435,54414.271685567306,66674.70252104956
"10.0.2.109",52091,"217.23.10.139",80,7,1048,4,342,3,706,94374.557932,0.16669800000090618,16412.914372008825,33881.630253328156
"10.0.2.109",52092,"91.185.215.137",35341,19,1730,9,1054,10,676,94374.67092,1.259344999998575,6695.544112224641,4294.29584427311
"10.0.2.109",52093,"91.185.215.137",35341,19,2751,9,2072,10,679,94374.753173,0.5037479999882635,32905.341560435365,10783.169362710238
"10.0.2.109",52094,"217.23.10.139",80,7,1048,4,342,3,706,94374.779502,1.1505820000020321,2377.9269969416937,4908.820058014139
"10.0.2.109",52095,"37.187.78.159",80,9,2177,5,399,4,1778,94374.866471,0.39014899999892805,8181.489636033336,36457.86609741171
"10.0.2.109",52096,"91.185.215.137",35341,18,1676,8,1000,10,676,94374.976884,0.2791659999929834,28656.78485274379,19371.986560454803
"10.0.2.109",52097,"217.23.10.139",80,7,1048,4,342,3,706,94375.087023,0.16868699999758974,16219.388571965195,33482.129625167916
"10.0.2.109",52098,"91.185.215.137",35341,19,2751,9,2072,10,679,94375.283461,1.34362699999474,12336.757150656314,4042.788660856968
"10.0.2.109",52099,"91.185.215.137",35341,19,2751,9,2072,10,679,94375.958538,0.30598900000040885,54171.88199568564,17752.272140478064
"10.0.2.109",52100,"37.187.78.159",80,9,2177,5,399,4,1778,94376.0713,0.19303200001013465,16536.118362926416,73687.26428391771
"10.0.2.109",52101,"91.185.215.137",35341,15,1183,7,616,8,567,94376.321781,0.16876999998930842,29199.502283060905,26876.81460145379
"10.0.2.109",52102,"37.187.78.159",80,9,2177,5,399,4,1778,94376.405687,0.2212159999908181,14429.33603415887,64299.14653818164
"10.0.2.109",52103,"80.78.242.47",80,10,879,5,395,5,484,94376.430405,0.060052999993786216,52620.18550825055,64476.37920504625
"10.0.2.109",52104,"91.185.215.137",35341,15,1183,7,616,8,567,94376.51429,1.160011999993003,4248.231914867885,3910.3043761852123
"10.0.2.109",52105,"91.185.215.137",35341,18,1676,8,1000,10,676,94376.767825,0.27969199999643024,28602.89175272123,19335.55482483955
"10.0.2.109",52106,"217.23.10.139",80,7,1048,4,342,3,706,94376.879498,0.167834000007133,16301.822037749915,33652.29929430245
"10.0.2.109",52107,"91.185.215.137",35341,19,2751,9,2072,10,679,94377.075639,0.3074659999983851,53911.652020343914,17666.994074234324
"10.0.2.109",52108,"37.187.78.159",80,9,2177,5,399,4,1778,94377.187046,0.19592699999338947,16291.782143898989,72598.46779912883
"10.0.2.109",52109,"80.78.242.47",80,10,879,5,395,5,484,94377.617264,0.05696200000238605,55475.5802090452,67975.14131943767
"10.0.2.109",52110,"91.185.215.137",35341,18,1676,8,1000,10,676,94377.756783,0.2712150000006659,29496.893608319446,19939.900079223946
"10.0.2.109",52111,"217.23.10.139",80,7,1048,4,342,3,706,94377.863241,0.16462599999795202,16619.48902381177,34308.0679848278
"10.0.2.109",52112,"91.185.215.137",35341,19,2755,9,2076,10,679,94378.057389,0.31546300000627525,52646.42763071939,17219.135048775755
"10.0.2.109",52113,"37.187.78.159",80,9,2181,5,399,4,1782,94378.17765,0.19506800000090152,16363.524514452642,73082.20722996142
"10.0.2.109",52114,"91.185.215.137",35341,9,506,5,286,4,220,94978.496653,0.05656000001181383,40452.61668179101,31117.397447531548
"10.0.2.109",52115,"91.185.215.137",35341,9,506,5,286,4,220,95578.672904,0.052546999999322,43541.97194948373,33493.82457652595
"10.0.2.109",52116,"31.28.27.51",80,17,1929,8,818,9,1111,95740.782392,1620.5112190000073,4.038231838986096,5.484688964686495
"10.0.2.109",52117,"91.185.215.137",35341,18,2452,8,1778,10,674,95741.450973,0.2983490000042366,47675.70864925982,18072.79394240783
"10.0.2.109",52118,"5.101.114.217",80,7,1824,4,340,3,1484,95741.55257,0.19645600000512786,13845.339414062197,60430.8343837303
"10.0.2.109",52119,"91.185.215.137",35341,9,506,5,286,4,220,96341.871728,0.052637000000686385,43467.52284458013,33436.556034292415
"10.0.2.109",52120,"91.185.215.137",35341,9,506,5,286,4,220,96942.046449,0.052622000002884306,43479.91334184544,33446.08718603495
"10.0.2.109",52121,"31.28.27.51",80,11,945,6,479,5,466,97361.293959,1620.0079279999918,2.3654205228062435,2.3012233061121283
"10.0.2.109",52122,"91.185.215.137",35341,18,2452,8,1778,10,674,97361.50718,0.2929100000037579,48560.99143019191,18408.384827868027
"10.0.2.109",52123,"5.101.114.217",80,7,1824,4,340,3,1484,97361.608284,0.1915339999977732,14201.13400248323,61983.77311672092
"10.0.2.109",52124,"91.185.215.137",35341,9,506,5,286,4,220,97961.921048,0.05257299999357201,43520.43825309092,33477.260194685325
"10.0.2.109",52125,"91.185.215.137",35341,15,1183,7,616,8,567,98497.158195,0.17134600000281353,28760.519649825976,26472.75104131709
"10.0.2.109",52126,"80.78.242.47",80,10,879,5,395,5,484,98497.269246,0.06031200000143144,52394.216738377116,64199.4959528469
"10.0.2.109",52127,"91.185.215.137",35341,18,1676,8,1000,10,676,98497.414342,0.2731740000017453,29285.36390706615,19796.906001176718
"10.0.2.109",52128,"217.23.10.139",80,7,1048,4,342,3,706,98497.51981,0.16755700000794604,16328.771700795854,33707.93222444992
"10.0.2.109",52129,"91.185.215.137",35341,19,2751,9,2072,10,679,98497.717445,0.3058129999990342,54203.05873214137,17762.488841276056
"10.0.2.109",52130,"37.187.78.159",80,9,2177,5,399,4,1778,98497.837691,0.1853230000124313,17223.98191150523,76752.48079863733
"10.0.2.109",52131,"31.28.27.51",80,17,1929,8,818,9,1111,98981.302239,1620.4695590000047,4.038335656263927,5.484829968348683
"10.0.2.109",52132,"91.185.215.137",35341,18,2452,8,1778,10,674,98981.932807,0.3036569999967469,46842.325387369245,17756.87700286101
"10.0.2.109",52133,"5.101.114.217",80,7,1824,4,340,3,1484,98982.041966,0.1942049999925075,14005.818594294371,61131.278805684844
"10.0.2.109",52134,"91.185.215.137",35341,9,506,5,286,4,220,99582.358306,0.05835200000728946,39210.30983880892,30161.776799083782
"10.0.2.109",52135,"91.185.215.137",35341,9,506,5,286,4,220,100182.539094,0.05213099998945836,43889.4324003504,33761.101846423386
"10.0.2.109",52136,"91.185.215.137",35341,15,1183,7,616,8,567,100565.998441,0.1705050000018673,28902.37822906091,26603.32541538561
"10.0.2.109",52137,"80.78.242.47",80,10,879,5,395,5,484,100566.105866,0.06306300000869669,50108.62153028275,61398.91853330848
"10.0.2.109",52138,"91.185.215.137",35341,18,1676,8,1000,10,676,100566.251096,0.24682499999471474,32411.627672121154,21910.2603063539
"10.0.2.109",52139,"217.23.10.139",80,7,1048,4,342,3,706,100566.358017,0.13960599999700207,19598.01154720251,40456.71389568705
"10.0.2.109",52140,"91.185.215.137",35341,19,2751,9,2072,10,679,100566.528042,0.2920610000001034,56755.26687915926,18598.854348913675
"10.0.2.109",52141,"37.187.78.159",80,9,2177,5,399,4,1778,100566.637722,0.18209000000206288,17529.792959326915,78115.21774857958
"10.0.2.109",52142,"31.28.27.51",80,11,945,6,479,5,466,100601.772302,1620.0096849999973,2.365417957362401,2.3012208102941103
"10.0.2.109",52143,"91.185.215.137",35341,18,2452,8,1778,10,674,100601.995094,0.3364900000015041,42271.68712275675,16024.250349121514
"10.0.2.109",52144,"5.101.114.217",80,7,1824,4,340,3,1484,100602.106739,0.2246690000029048,12106.699188427565,52842.18116360737
"10.0.2.109",52145,"91.185.215.137",35341,9,506,5,286,4,220,101202.461006,0.05651199999556411,40486.976220618555,31143.827862014274
"10.0.2.109",52146,"91.185.215.137",35341,9,506,5,286,4,220,101802.637171,0.0523280000052182,43724.20118811799,33634.00091393692
"10.0.2.109",52147,"31.28.27.51",80,17,1929,8,818,9,1111,102221.782396,1622.410572000008,4.03350428858027,5.478268049648753
"10.0.2.109",52148,"91.185.215.137",35341,18,2452,8,1778,10,674,102224.351527,0.3064899999881163,46409.344515486686,17592.74364647808
"10.0.2.109",52149,"5.101.114.217",80,7,1824,4,340,3,1484,102224.45355,0.2043310000008205,13311.734391693271,58101.80540374357
"10.0.2.109",52150,"91.185.215.137",35341,9,506,5,286,4,220,102824.792274,0.054848999992827885,41714.52533864212,32088.09641434009
"10.0.2.109",52151,"91.185.215.137",35341,9,506,5,286,4,220,103424.967472,0.053142999997362494,43053.64770738487,33118.190544142206
"10.0.2.109",52152,"31.28.27.51",80,11,945,6,479,5,466,103844.193248,1620.0082330000005,2.365420077466976,2.301222872859313
"10.0.2.109",52153,"91.185.215.137",35341,18,2452,8,1778,10,674,103844.411058,0.333241000000271,42683.82341905237,16180.481993499045
"10.0.2.109",52154,"5.101.114.217",80,7,1824,4,340,3,1484,103844.522628,0.22149799999897368,12280.020587150237,53598.67809214986
"10.0.2.109",52155,"91.185.215.137",35341,9,506,5,286,4,220,104444.866527,0.055116999996243976,41511.69330979406,31932.071776764657
"10.0.2.109",52156,"91.185.215.137",35341,9,506,5,286,4,220,105045.048146,0.05570399999851361,41074.24960615131,31595.57662011639
"10.0.2.109",52157,"31.28.27.51",80,11,945,6,479,5,466,105464.201618,1620.0091519999987,2.3654187356097127,2.3012215674198875
"10.0.2.109",52158,"91.185.215.137",35341,18,2452,8,1778,10,674,105464.428148,0.33623899999656714,42303.242634391674,16036.21233722159
"10.0.2.109",52159,"5.101.114.217",80,7,1824,4,340,3,1484,105464.538968,0.2251420000102371,12081.264268223267,52731.1652177745
"10.0.2.109",52160,"91.185.215.137",35341,9,506,5,286,4,220,106064.882,0.05253699999593664,43550.259820259256,33500.199861737885
"10.0.2.109",52161,"91.185.215.137",35341,9,506,5,286,4,220,106665.056632,0.05211599999165628,43902.06463209583,33770.81894776603
"10.0.2.109",52162,"31.28.27.51",80,17,1929,8,818,9,1111,107084.210911,1620.6102719999908,4.037985019016365,5.484353736096799
"10.0.2.109",52163,"91.185.215.137",35341,18,2452,8,1778,10,674,107084.964283,0.31721800001105294,44839.82623780614,16997.774400608178
"10.0.2.109",52164,"5.101.114.217",80,7,1824,4,340,3,1484,107085.081072,0.20015999999304768,13589.128697514368,59312.549962092125
"10.0.2.109",52165,"91.185.215.137",35341,9,506,5,286,4,220,107685.400881,0.052051000006031245,43956.88843124791,33812.99110095994
"10.0.2.109",52166,"91.185.215.137",35341,9,506,5,286,4,220,108285.575427,0.053331000002799556,42901.87695486478,33001.44381143445
"10.0.2.109",52167,"31.28.27.51",80,11,945,6,479,5,466,108704.82138,1620.0085780000081,2.3654195737227637,2.3012223827866554
"10.0.2.109",52168,"91.185.215.137",35341,18,2452,8,1778,10,674,108705.05234,0.33593000000109896,42342.15461540638,16050.962998191173
"10.0.2.109",52169,"5.101.114.217",80,7,1824,4,340,3,1484,108705.164497,0.22347199999785516,12171.547218560294,53125.223742186696
"10.0.2.109",52170,"91.185.215.137",35341,9,506,5,286,4,220,109305.512472,0.05318200000328943,43022.07513554364,33093.903950418186
"10.0.2.109",52171,"91.185.215.137",35341,9,506,5,286,4,220,109905.688238,0.05267000000458211,43440.28858555063,33415.60660426972
"10.0.2.109",52172,"31.28.27.51",80,17,1929,8,818,9,1111,110324.830206,1621.0307650000032,4.036937571632077,5.482931102791243
"10.0.2.109",52173,"91.185.215.137",35341,18,2452,8,1778,10,674,110326.025548,0.3331539999926463,42694.96989474527,16184.707372923687
"10.0.2.109",52174,"5.101.114.217",80,7,1824,4,340,3,1484,110326.134453,0.2240649999876041,12139.334568765662,52984.62500014189
"10.0.2.109",52175,"91.185.215.137",35341,9,506,5,286,4,220,110926.488948,0.05611299999873154,40774.865005466134,31365.28077343549
"10.0.2.109",52176,"91.185.215.137",35341,9,506,5,286,4,220,111526.667297,0.05484499999147374,41717.567697250335,32090.436690192568
"10.0.2.109",52177,"91.185.215.137",35341,15,1183,7,616,8,567,111607.025966,0.17056299999239855,28892.54996816206,26594.278947967352
"10.0.2.109",52178,"80.78.242.47",80,10,879,5,395,5,484,111607.138938,0.05750299998908304,54953.6546023673,67335.61728492602
"10.0.2.109",52179,"91.185.215.137",35341,18,1676,8,1000,10,676,111607.27912,0.27867599998717196,28707.172488367338,19406.04860213632
"10.0.2.109",52180,"217.23.10.139",80,7,1048,4,342,3,706,111607.389385,0.16828399999940302,16258.230134829846,33562.311330964534
"10.0.2.109",52181,"91.185.215.137",35341,19,2755,9,2076,10,679,111607.585776,0.3122529999964172,53187.63951087919,17396.149917093917
"10.0.2.109",52182,"37.187.78.159",80,9,2181,5,399,4,1782,111607.70227,0.1955080000043381,16326.697628379265,72917.73226509235
"10.0.2.109",52183,"31.28.27.51",80,11,945,6,479,5,466,111945.861163,1620.008685000008,2.365419417489099,2.3012222307931527
"10.0.2.109",52184,"91.185.215.137",35341,18,2452,8,1778,10,674,111946.080165,0.30063299999164883,47313.50184575587,17935.489451090805
"10.0.2.109",52185,"5.101.114.217",80,7,1824,4,340,3,1484,111946.183237,0.19740299999830313,13778.919266796254,60140.929976251886
"10.0.2.109",52186,"91.185.215.137",35341,9,506,5,286,4,220,112546.515682,0.05455699999583885,41937.7898376837,32259.838336679768
"10.0.2.109",52187,"91.185.215.137",35341,9,506,5,286,4,220,113146.705849,0.05591599999752361,40918.52063991219,31475.78510762476
"10.0.2.109",52188,"31.28.27.51",80,17,1929,8,818,9,1111,113565.870261,1620.499238999997,4.038261692759741,5.484729511804489
"10.0.2.109",52189,"91.185.215.137",35341,18,2452,8,1778,10,674,113566.532711,0.33593099999416154,42342.02857207942,16050.915217987362
"10.0.2.109",52190,"5.101.114.217",80,7,1824,4,340,3,1484,113566.644573,0.22377599999890663,12155.012155071545,53053.05305331227
"10.0.2.109",52191,"91.185.215.137",35341,9,506,5,286,4,220,114166.99447,0.05568499999935739,41088.26434455246,31606.35718811728
"10.0.2.109",52192,"91.185.215.137",35341,9,506,5,286,4,220,114767.170866,0.054090999998152256,42299.088574405316,32537.76044185024
"10.0.2.109",52193,"91.185.215.137",35341,15,1183,7,616,8,567,114978.260967,0.17255699999805074,28558.679161411408,26286.966046299138
"10.0.2.109",52194,"80.78.242.47",80,10,879,5,395,5,484,114978.368653,0.06485399999655783,48724.82807795539,59703.33364488711
"10.0.2.109",52195,"91.185.215.137",35341,18,1676,8,1000,10,676,114978.516455,0.2508430000016233,31892.458629294935,21559.302033403375
"10.0.2.109",52196,"217.23.10.139",80,7,1048,4,342,3,706,114978.622831,0.14430200000060722,18960.236171283053,39140.13665767788
"10.0.2.109",52197,"91.185.215.137",35341,19,2755,9,2076,10,679,114978.795898,0.28860500000882894,57545.780563371845,18821.57273724927
"10.0.2.109",52198,"37.187.78.159",80,9,2181,5,399,4,1782,114978.907596,0.17670799999905284,18063.698304644437,80675.46460871275
"10.0.2.109",52199,"31.28.27.51",80,11,945,6,479,5,466,115186.369748,1620.0109479999956,2.3654161132249403,2.3012190162063093
"10.0.2.109",52200,"91.185.215.137",35341,18,2452,8,1778,10,674,115186.592479,0.29298100000596605,48549.2233274866,18403.923803557915
"10.0.2.109",52201,"5.101.114.217",80,7,1824,4,340,3,1484,115186.694107,0.1912199999933364,14224.453509542864,62085.55590635767
"10.0.2.109",52202,"91.185.215.137",35341,9,506,5,286,4,220,115787.0087,0.05229500000132248,43751.79271330221,33655.22516407863
"10.0.2.109",52203,"91.185.215.137",35341,9,506,5,286,4,220,116387.183541,0.05570199999783654,41075.724392102005,31596.711070847694
"10.0.2.109",52204,"31.28.27.51",80,17,1929,8,818,9,1111,116806.381044,1620.5580650000047,4.038115104502585,5.484530416995564
"10.0.2.109",52205,"91.185.215.137",35341,18,2452,8,1778,10,674,116807.096544,0.29261000000406057,48610.77885172281,18427.2581248938
"10.0.2.109",52206,"5.101.114.217",80,7,1824,4,340,3,1484,116807.197752,0.1911310000141384,14231.07711359641,62114.46598993256
"10.0.2.109",52207,"91.185.215.137",35341,18,2452,8,1778,10,674,116867.938108,0.3072399999946356,46296.05520195401,17549.79820366536
"10.0.2.109",52208,"5.101.114.217",80,7,1824,4,340,3,1484,116868.045309,0.19983900000806898,13610.956819690718,59407.823295355956
"10.0.2.109",52209,"91.185.215.137",35341,18,2452,8,1778,10,674,116869.122977,0.30522799999744166,46601.22924541399,17665.48285231104
"10.0.2.109",52210,"5.101.114.217",80,7,1824,4,340,3,1484,116869.229729,0.1982739999948535,13718.389703494162,59876.73623525099
"10.0.2.109",52211,"91.185.215.137",35341,29,11200,16,10404,13,796,116869.456426,0.6080379999912111,136886.1814577429,10473.029646324812
"10.0.2.109",52212,"141.101.123.93",80,17,10518,7,462,10,10056,116869.574476,0.4897800000035204,7546.245252916481,164253.33823231197
"10.0.2.109",52213,"91.185.215.137",35341,30,8744,14,7281,16,1463,116870.09271,1.1200450000033015,52005.05336823816,10449.580150766711
"10.0.2.109",52214,"2.19.189.224",443,22,8278,10,1129,12,7149,116870.22084,0.9918960000068182,9105.793349240157,57659.27072959954
"10.0.2.109",52215,"91.185.215.137",35341,18,2452,8,1778,10,674,117367.843857,0.306773999996949,46366.380462951434,17576.456935899478
"10.0.2.109",52216,"5.101.114.217",80,7,1824,4,340,3,1484,117367.951375,0.1991159999888623,13660.378875389948,59623.536032584365
"10.0.2.109",52217,"91.185.215.137",35341,9,506,5,286,4,220,117968.273018,0.05227599998761434,43767.69455471137,33667.45734977798
"10.0.2.109",52218,"91.185.215.137",35341,18,2452,8,1778,10,674,118070.758228,0.3094589999964228,45964.08571140094,17423.956000834776
"10.0.2.109",52219,"5.101.114.217",80,7,1824,4,340,3,1484,118070.86453,0.2029669999901671,13401.19329808182,58492.26721868653
"10.0.2.109",52220,"91.185.215.137",35341,3145,674720,1534,331610,1611,343110,118102.048906,6996.649627000006,379.1643345641549,392.3134852154856
"10.0.2.109",52221,"86.59.34.124",5222,3134,674093,1526,338511,1608,335582,118102.308313,6996.390184999997,387.06932123454766,383.72016554419787
"10.0.2.109",52222,"31.28.27.51",80,11,945,6,479,5,466,118426.939329,1620.0105230000045,2.3654167337775927,2.3012196199172403
"10.0.2.109",52223,"91.185.215.137",35341,18,2452,8,1778,10,674,118427.156434,0.29164399999717716,48771.7902653155,18488.29394759429
"10.0.2.109",52224,"5.101.114.217",80,7,1824,4,340,3,1484,118427.25669,0.19121800000721123,14224.602285859193,62086.205271220715
"10.0.2.109",52225,"91.185.215.137",35341,15,1183,7,616,8,567,119884.795538,0.1660239999910118,29682.45555020233,27321.351131436237
"10.0.2.109",52226,"80.78.242.47",80,10,879,5,395,5,484,119884.903638,0.057937999998102896,54541.06113610187,66830.05972119824
"10.0.2.109",52227,"91.185.215.137",35341,18,1676,8,1000,10,676,119885.046059,0.24894999999378342,32134.96686161787,21723.23759845368
"10.0.2.109",52228,"217.23.10.139",80,7,1048,4,342,3,706,119885.152339,0.1424540000007255,19206.199896009,39647.88633503612
"10.0.2.109",52229,"91.185.215.137",35341,19,2755,9,2076,10,679,119885.32372,0.2913319999934174,57007.12589202441,18645.39425851858
"10.0.2.109",52230,"37.187.78.159",80,9,2181,5,399,4,1782,119885.434361,0.18043099998612888,17690.97328200472,79010.81300384062
"10.0.2.109",52231,"31.28.27.51",80,17,1929,8,818,9,1111,120046.950309,1620.4376899999916,4.0384150778423535,5.484937837998601
"10.0.2.109",52232,"91.185.215.137",35341,18,2452,8,1778,10,674,120047.537491,0.310752000004868,45772.83492874439,17351.45711022144
"10.0.2.109",52233,"5.101.114.217",80,7,1824,4,340,3,1484,120047.646039,0.2020360000024084,13462.947197368667,58761.80482616206
"10.0.2.109",52234,"31.28.27.51",80,11,945,6,479,5,466,121667.388305,1620.0087789999961,2.3654192802371283,2.301222097266183
"10.0.2.109",52235,"91.185.215.137",35341,18,2452,8,1778,10,674,121667.59655,0.3336859999981243,42626.900739257726,16158.903879786114
"10.0.2.109",52236,"5.101.114.217",80,7,1824,4,340,3,1484,121667.705989,0.2239970000082394,12143.019772139576,53000.70982898568
"10.0.2.109",52237,"91.185.215.137",35341,15,1183,7,616,8,567,122643.529346,0.1720120000099996,28649.164010147662,26370.25323661319
"10.0.2.109",52238,"80.78.242.47",80,10,879,5,395,5,484,122643.640458,0.060877000010805205,51907.94552029706,63603.65982740196
"10.0.2.109",52239,"91.185.215.137",35341,18,1676,8,1000,10,676,122643.805806,0.2839629999944009,28172.68447001103,19044.734701727455
"10.0.2.109",52240,"217.23.10.139",80,7,1048,4,342,3,706,122643.92124,0.16834200000448618,16252.628577105463,33550.747881393145
"10.0.2.109",52241,"91.185.215.137",35341,19,2751,9,2072,10,679,122644.121364,0.3345899999985704,49541.22956475335,16234.794823584713
"10.0.2.109",52242,"37.187.78.159",80,9,2177,5,399,4,1778,122644.253477,0.20218100000056438,15787.833673743278,70352.80268650514
"10.0.2.109",52243,"31.28.27.51",80,11,945,6,479,5,466,123287.397379,1620.0104869999923,2.3654167863420863,2.3012196710551405
"10.0.2.109",52244,"91.185.215.137",35341,18,2452,8,1778,10,674,123287.619781,0.3050890000013169,46622.46098659278,17673.53133012572
"10.0.2.109",52245,"5.101.114.217",80,7,1824,4,340,3,1484,123287.723276,0.20142800000030547,13503.584407311173,58939.174295440534
"10.0.2.109",52246,"91.185.215.137",35341,15,1183,7,616,8,567,124567.784231,0.18518200000107754,26611.657720357944,24494.821310784017
"10.0.2.109",52247,"80.78.242.47",80,10,879,5,395,5,484,124567.893471,0.07591600000159815,41624.95389553555,51003.74097579547
"10.0.2.109",52248,"91.185.215.137",35341,18,1676,8,1000,10,676,124568.058383,0.27656199999910314,28926.60596909895,19554.385635110888
"10.0.2.109",52249,"217.23.10.139",80,7,1048,4,342,3,706,124568.167748,0.16660599999886472,16421.977599958245,33900.339723890414
"10.0.2.109",52250,"91.185.215.137",35341,19,2755,9,2076,10,679,124568.365875,0.3077259999990929,53970.090275273964,17652.06709870473
"10.0.2.109",52251,"37.187.78.159",80,9,2181,5,399,4,1782,124568.48046,0.19300499999371823,16538.431647386806,73863.37141765235
"10.0.2.109",52252,"31.28.27.51",80,17,1929,8,818,9,1111,124907.408443,1620.6501470000076,4.037885667127866,5.484218797284914
"10.0.2.109",52253,"91.185.215.137",35341,18,2452,8,1778,10,674,124908.228069,0.33789100000285544,42096.41570766844,15957.808879059914
"10.0.2.109",52254,"5.101.114.217",80,7,1824,4,340,3,1484,124908.339695,0.22612999999546446,12028.479193625595,52500.773892177596
"10.0.2.109",52255,"91.185.215.137",35341,9,506,5,286,4,220,125698.821031,0.05200999999942724,43991.54008892899,33839.64622225307
"10.0.2.109",52256,"91.185.215.137",35341,9,506,5,286,4,220,126298.995884,0.05313299999397714,43061.75070595214,33124.423619963185
"10.0.2.109",52257,"31.28.27.51",80,11,945,6,479,5,466,126528.059007,1620.0089099999896,2.3654190889604583,2.301221911180738
"10.0.2.109",52258,"91.185.215.137",35341,18,2452,8,1778,10,674,126528.29455,0.3358729999890784,42349.34037705479,16053.68695958095
"10.0.2.109",52259,"5.101.114.217",80,7,1824,4,340,3,1484,126528.40598,0.22424799999862444,12129.428133212714,52941.386322610786
"10.0.2.109",52260,"91.185.215.137",35341,9,506,5,286,4,220,127128.751629,0.052172999989124946,43854.10078923803,33733.92368402925
"10.0.2.109",52261,"91.185.215.137",35341,15,1183,7,616,8,567,127597.330504,0.17566700000315905,28053.077697640303,25821.582880782553
"10.0.2.109",52262,"80.78.242.47",80,10,879,5,395,5,484,127597.443348,0.0627189999941038,50383.45637361997,61735.67818944827
"10.0.2.109",52263,"91.185.215.137",35341,18,1676,8,1000,10,676,127597.591115,0.27066999999806285,29556.28625284389,19980.049506922467
"10.0.2.109",52264,"217.23.10.139",80,7,1048,4,342,3,706,127597.696902,0.1646889999974519,16613.131417655895,34294.94380369901
"10.0.2.109",52265,"91.185.215.137",35341,19,2755,9,2076,10,679,127597.890103,0.30657899999641813,54172.00786809937,17718.108546454467
"10.0.2.109",52266,"37.187.78.159",80,9,2181,5,399,4,1782,127598.005551,0.19099899999855552,16712.12938300274,74639.13423686939
"10.0.2.109",52267,"31.28.27.51",80,17,1929,8,818,9,1111,128148.068273,1620.4890160000068,4.038287168495052,5.4847641127114946
"10.0.2.109",52268,"91.185.215.137",35341,18,2452,8,1778,10,674,128148.720947,0.2921150000038324,48693.15166908029,18458.483816063057
"10.0.2.109",52269,"5.101.114.217",80,7,1824,4,340,3,1484,128148.822028,0.19081400000141002,14254.719255295211,62217.65698487675
"10.0.2.109",52270,"91.185.215.137",35341,9,506,5,286,4,220,128749.135899,0.053442999997059815,42811.9678933794,32932.282994907226
"10.0.2.109",52271,"91.185.215.137",35341,9,506,5,286,4,220,129349.321042,0.055424000005587004,41281.75519214345,31755.196301648808
"10.0.2.109",52272,"91.185.215.137",35341,15,1183,7,616,8,567,129468.553939,0.16971399998874404,29037.0859229459,26727.31772452975
"10.0.2.109",52273,"80.78.242.47",80,10,879,5,395,5,484,129468.665606,0.05801800001063384,54465.85541419592,66737.90891258436
"10.0.2.109",52274,"91.185.215.137",35341,18,1676,8,1000,10,676,129468.806063,0.27957500000775326,28614.861843076604,19343.646605919785
"10.0.2.109",52275,"217.23.10.139",80,7,1048,4,342,3,706,129468.917429,0.1679910000093514,16286.586780528109,33620.84873407264
"10.0.2.109",52276,"91.185.215.137",35341,19,2751,9,2072,10,679,129469.112972,0.30822900000202935,53778.197378867226,17623.26062753419
"10.0.2.109",52277,"37.187.78.159",80,9,2177,5,399,4,1778,129469.231138,0.18988199999148492,16810.44016885825,74909.68075245606
"10.0.2.109",52278,"31.28.27.51",80,11,945,6,479,5,466,129768.557687,1620.0089300000109,2.3654190597578832,2.3012218827707174
"10.0.2.109",52279,"91.185.215.137",35341,18,2452,8,1778,10,674,129768.771251,0.3328670000046259,42731.78176209215,16198.66192781221
"10.0.2.109",52280,"5.101.114.217",80,7,1824,4,340,3,1484,129768.879732,0.22409499999776017,12137.70945370127,52977.53185086085
"10.0.2.109",52281,"91.185.215.137",35341,9,506,5,286,4,220,130369.233892,0.0551160000031814,41512.44647412607,31932.65113394313
"10.0.2.109",52282,"91.185.215.137",35341,9,506,5,286,4,220,130969.411875,0.05557599999883678,41168.849864112,31668.346049316922
"10.0.2.109",52283,"91.185.215.137",35341,15,1183,7,616,8,567,131318.710278,0.17186399997444823,28673.835129711093,26392.9618807568
"10.0.2.109",52284,"80.78.242.47",80,10,879,5,395,5,484,131318.824458,0.05751000001328066,54946.965732399025,67327.42130248387
"10.0.2.109",52285,"91.185.215.137",35341,18,1676,8,1000,10,676,131318.966201,0.26021700000273995,30743.571710978777,20782.654476621654
"10.0.2.109",52286,"217.23.10.139",80,7,1048,4,342,3,706,131319.076332,0.14992900000652298,18248.637687711947,37671.16434948723
"10.0.2.109",52287,"91.185.215.137",35341,19,2755,9,2076,10,679,131319.254048,0.29951000001165085,55450.56926097277,18136.289271772886
"10.0.2.109",52288,"37.187.78.159",80,9,2181,5,399,4,1782,131319.365842,0.1874320000060834,17030.17627671048,76059.58427342876
"10.0.2.109",52289,"31.28.27.51",80,17,1929,8,818,9,1111,131388.567106,1620.4180889999843,4.038463927564846,5.4850041852378295
"10.0.2.109",52290,"91.185.215.137",35341,18,2452,8,1778,10,674,131389.158258,0.31479099998250604,45185.535802454564,17128.82515796084
"10.0.2.109",52291,"5.101.114.217",80,7,1824,4,340,3,1484,131389.26701,0.20577099997899495,13218.577935071788,57695.20486954863
"10.0.2.109",52292,"91.185.215.137",35341,9,506,5,286,4,220,131989.608324,0.05586399999447167,40956.6089113995,31505.083777999615
"10.0.2.109",52293,"91.185.215.137",35341,9,506,5,286,4,220,132589.785352,0.05206899999757297,43941.69275589406,33801.3021199185
"10.0.2.109",52294,"31.28.27.51",80,11,945,6,479,5,466,133008.985178,1620.0103829999862,2.365416938195039,2.301219818786823
"10.0.2.109",52295,"91.185.215.137",35341,18,2452,8,1778,10,674,133009.20681,0.335640000004787,42378.739124648826,16064.831366711649
"10.0.2.109",52296,"5.101.114.217",80,7,1824,4,340,3,1484,133009.318455,0.223798999999417,12153.762974843881,53047.60074902447
"10.0.2.109",52297,"91.185.215.137",35341,9,506,5,286,4,220,133609.663055,0.055668999993940815,41100.07365408096,31615.441272369968
"10.0.2.109",52298,"91.185.215.137",35341,15,1183,7,616,8,567,134038.970731,0.16922799998428673,29120.476519592372,26804.07497826116
"10.0.2.109",52299,"80.78.242.47",80,10,879,5,395,5,484,134039.082066,0.05780599999707192,54665.60564924169,66982.66616261513
"10.0.2.109",52300,"91.185.215.137",35341,18,1676,8,1000,10,676,134039.222521,0.26144400000339374,30599.287036214846,20685.118036481235
"10.0.2.109",52301,"217.23.10.139",80,7,1048,4,342,3,706,134039.33596,0.14786299999104813,18503.61483376938,38197.52068023738
"10.0.2.109",52302,"91.185.215.137",35341,19,2755,9,2076,10,679,134039.51232,0.29507100000046194,56284.75858343924,18409.128650363797
"10.0.2.109",52303,"37.187.78.159",80,9,2181,5,399,4,1782,134039.623424,0.18358900002203882,17386.66259752392,77651.71114984366
"10.0.2.109",52304,"31.28.27.51",80,17,1929,8,818,9,1111,134628.995917,1620.4481280000182,4.038389064682191,5.4849025071661535
"10.0.2.109",52305,"91.185.215.137",35341,18,2452,8,1778,10,674,134629.604228,0.2921079999941867,48694.318540687265,18458.92615096919
"10.0.2.109",52306,"5.101.114.217",80,7,1824,4,340,3,1484,134629.705066,0.19104999999399297,14237.110704451834,62140.80083943094
"10.0.2.109",52307,"91.185.215.137",35341,9,506,5,286,4,220,135230.018762,0.05181000000447966,44161.35880722201,33970.27600555539
"10.0.2.109",52308,"91.185.215.137",35341,9,506,5,286,4,220,135830.193159,0.05227000001468696,43772.71856432202,33671.3219725554
"10.0.2.109",52309,"91.185.215.137",35341,15,1183,7,616,8,567,135884.440054,0.16493299999274313,29878.79927132124,27502.0766020116
"10.0.2.109",52310,"80.78.242.47",80,10,879,5,395,5,484,135884.548326,0.05654800002230331,55881.72877473389,68472.80184043343
"10.0.2.109",52311,"91.185.215.137",35341,18,1676,8,1000,10,676,135884.686349,0.24781699999584816,32281.885424059,21822.554546663883
"10.0.2.109",52312,"217.23.10.139",80,7,1048,4,342,3,706,135884.79498,0.1389740000013262,19687.135723040934,40640.69538148216
"10.0.2.109",52313,"91.185.215.137",35341,19,2751,9,2072,10,679,135884.962257,0.2865400000009686,57848.81691890825,18957.213652480066
"10.0.2.109",52314,"37.187.78.159",80,9,2177,5,399,4,1778,135885.07395,0.17467500001657754,18273.937310416848,81431.22941834877
"10.0.2.109",52315,"31.28.27.51",80,11,945,6,479,5,466,136249.444127,1620.0193579999905,2.3654038336497596,2.301207069897261
"10.0.2.109",52316,"91.185.215.137",35341,18,2452,8,1778,10,674,136249.650032,0.29493899998487905,48226.92150149433,18281.746395954546
"10.0.2.109",52317,"5.101.114.217",80,7,1824,4,340,3,1484,136249.752957,0.19179700000677258,14181.660817968757,61898.77839372245
"10.0.2.109",52318,"91.185.215.137",35341,9,506,5,286,4,220,136850.066791,0.052303000004030764,43745.100660070624,33650.077430823556
"10.0.2.109",52319,"91.185.215.137",35341,9,506,5,286,4,220,137450.250888,0.054391999990912154,42065.00956725769,32357.699667121302
"10.0.2.109",52320,"91.185.215.137",35341,17,1291,8,670,9,621,137762.053658,0.16959900001529604,31603.95992615867,29292.625543499307
"10.0.2.109",52321,"80.78.242.47",80,10,879,5,395,5,484,137762.164928,0.058194999990519136,54300.19762032499,66534.92569173999
"10.0.2.109",52322,"91.185.215.137",35341,18,1676,8,1000,10,676,137762.305926,0.27878100000089034,28696.36022531826,19398.739512315144
"10.0.2.109",52323,"217.23.10.139",80,7,1048,4,342,3,706,137762.416666,0.16778699998394586,16306.388458353656,33661.725881864564
"10.0.2.109",52324,"91.185.215.137",35341,19,2755,9,2076,10,679,137762.613463,0.3080770000233315,53908.60076780231,17631.955646116458
"10.0.2.109",52325,"37.187.78.159",80,9,2181,5,399,4,1782,137762.725282,0.19607800000812858,16279.235813643922,72705.75994965782
"10.0.2.109",52326,"31.28.27.51",80,11,945,6,479,5,466,137869.463632,1620.009911000001,2.3654176273740077,2.301220489261561
"10.0.2.109",52327,"91.185.215.137",35341,18,2452,8,1778,10,674,137869.696372,0.3360030000039842,42332.95536001564,16047.475766395133
"10.0.2.109",52328,"5.101.114.217",80,7,1824,4,340,3,1484,137869.808574,0.22362199999042787,12163.382851939565,53089.58868317152
"10.0.2.109",52329,"91.185.215.137",35341,9,506,5,286,4,220,138470.159187,0.054954999999608845,41634.06423466992,32026.2032574384
"10.0.2.109",52330,"91.185.215.137",35341,9,506,5,286,4,220,139070.334542,0.0526489999901969,43457.61553735151,33428.935028731925
"10.0.2.109",52331,"31.28.27.51",80,17,1929,8,818,9,1111,139489.47399,1621.0693550000142,4.036841471227456,5.482800580114552
"10.0.2.109",52332,"91.185.215.137",35341,18,2452,8,1778,10,674,139490.700383,0.29323300000396557,48507.50086043399,18388.107750243256
"10.0.2.109",52333,"5.101.114.217",80,7,1824,4,340,3,1484,139490.801987,0.1913889999850653,14211.893056613757,62030.733223572985
"10.0.2.109",52334,"91.185.215.137",35341,9,506,5,286,4,220,140091.116067,0.0522460000065621,43792.82623957101,33686.78941505463
"10.0.2.109",52335,"91.185.215.137",35341,9,506,5,286,4,220,140691.290456,0.05184600001666695,44130.69473564935,33946.6882581918
"10.0.2.109",52336,"91.185.215.137",35341,15,1183,7,616,8,567,140692.149285,0.17002099999808706,28984.654837081573,26679.05729322281
"10.0.2.109",52337,"80.78.242.47",80,10,879,5,395,5,484,140692.260279,0.05903899998520501,53523.9418145952,65583.76667914957
"10.0.2.109",52338,"91.185.215.137",35341,18,1676,8,1000,10,676,140692.402732,0.24770800000987947,32296.090556949843,21832.157216498093
"10.0.2.109",52339,"217.23.10.139",80,7,1048,4,342,3,706,140692.511074,0.1391730000032112,19658.985578645796,40582.58426468985
"10.0.2.109",52340,"91.185.215.137",35341,19,2751,9,2072,10,679,140692.678891,0.2856710000196472,58024.79075180882,19014.880753126537
"10.0.2.109",52341,"37.187.78.159",80,9,2177,5,399,4,1778,140692.790013,0.1744089999992866,18301.807819625457,81555.42431903274
"10.0.2.109",52342,"31.28.27.51",80,11,945,6,479,5,466,141110.543643,1620.008410999988,2.3654198175641623,2.301222620010229
"10.0.2.109",52343,"91.185.215.137",35341,18,2452,8,1778,10,674,141110.754129,0.29697299998952076,47896.61013123052,18156.532749409093
"10.0.2.109",52344,"5.101.114.217",80,7,1824,4,340,3,1484,141110.854912,0.1960469999758061,13874.224039825509,60556.90727970898
"10.0.2.109",52345,"91.185.215.137",35341,9,506,5,286,4,220,141711.172213,0.054933999985223636,41649.97998717434,32038.44614398026
"10.0.2.109",52346,"91.185.215.137",35341,9,506,5,286,4,220,142311.347698,0.05130500000086613,44596.04326988352,34304.64866914117
"10.0.2.109",52347,"31.28.27.51",80,17,1929,8,818,9,1111,142730.552311,1620.4997370000056,4.038260451750988,5.484727826277932
"10.0.2.109",52348,"91.185.215.137",35341,18,2452,8,1778,10,674,142731.200105,0.29458400001749396,48285.03923891082,18303.777529260904
"10.0.2.109",52349,"5.101.114.217",80,7,1824,4,340,3,1484,142731.300687,0.19381199998315424,14034.218728646405,61255.23703915078
"10.0.2.109",52350,"91.185.215.137",35341,9,506,5,286,4,220,143331.630038,0.055985999992117286,40867.359702821166,31436.430540631663
"10.0.2.109",52351,"91.185.215.137",35341,17,1291,8,670,9,621,143929.100327,0.1748070000030566,30662.387661285175,28419.91453381805
"10.0.2.109",52352,"80.78.242.47",80,10,879,5,395,5,484,143929.211089,0.06391500000609085,49440.66337634146,60580.458415567766
"10.0.2.109",52353,"91.185.215.137",35341,18,1676,8,1000,10,676,143929.361088,0.27447299999766983,29146.764891511793,19703.213066661974
"10.0.2.109",52354,"217.23.10.139",80,7,1048,4,342,3,706,143929.475781,0.15959100000327453,17143.823899492214,35390.46688023832
"10.0.2.109",52355,"91.185.215.137",35341,19,2755,9,2076,10,679,143929.665942,0.30744000000413507,54020.29664252089,17668.4881600538
"10.0.2.109",52356,"37.187.78.159",80,9,2181,5,399,4,1782,143929.784684,0.18854099998134188,16930.004616056358,75612.20106719907
"10.0.2.109",52357,"31.28.27.51",80,11,945,6,479,5,466,144351.052228,1620.0093690000067,2.365418418762234,2.3012212591716095
"10.0.2.109",52358,"91.185.215.137",35341,18,2452,8,1778,10,674,144351.260671,0.29269400000339374,48596.82808610725,18421.96970193267
"10.0.2.109",52359,"5.101.114.217",80,7,1824,4,340,3,1484,144351.361025,0.19214900000952184,14155.681267481026,61785.385296887776
"10.0.2.109",52360,"91.185.215.137",35341,9,506,5,286,4,220,144951.675463,0.05355100001906976,42725.62602351464,32865.866171934336
"10.0.2.109",52361,"91.185.215.137",35341,9,506,5,286,4,220,145551.849442,0.05202699999790639,43977.16570419342,33828.58900322571
"10.0.2.109",52362,"91.185.215.137",35341,15,1183,7,616,8,567,145758.797794,0.16197899999679066,30423.696899583527,28003.630100753016
"10.0.2.109",52363,"80.78.242.47",80,10,879,5,395,5,484,145758.90249,0.05730699998093769,55141.605755861005,67565.91692616892
"10.0.2.109",52364,"91.185.215.137",35341,18,1676,8,1000,10,676,145759.042128,0.2465749999973923,32444.48950657855,21932.4749064471
"10.0.2.109",52365,"217.23.10.139",80,7,1048,4,342,3,706,145759.149023,0.13944400000036694,19620.77966777201,40503.71475276912
"10.0.2.109",52366,"91.185.215.137",35341,19,2747,9,2068,10,679,145759.316603,0.28100599997560494,58874.18774487463,19330.548103853904
"10.0.2.109",52367,"37.187.78.159",80,9,2173,5,399,4,1774,145759.422531,0.17484600000898354,18256.065336559004,81168.57119562826
"10.0.2.109",52368,"31.28.27.51",80,17,1929,8,818,9,1111,145971.061629,1620.7683529999922,4.037591175745293,5.483818821825208
"10.0.2.109",52369,"91.185.215.137",35341,18,2452,8,1778,10,674,145971.680845,0.2941599999903701,48354.63693386473,18330.16045749428
"10.0.2.109",52370,"5.101.114.217",80,7,1824,4,340,3,1484,145971.781799,0.19303799999761395,14090.489955519744,61500.84439409206
"10.0.2.109",52371,"91.185.215.137",35341,18,1591,8,980,10,611,146124.776146,23.879856000014115,328.310187464923,204.6913515725183
"10.0.2.109",52372,"173.194.122.16",80,8,1007,5,321,3,686,146138.584733,10.070990000007441,254.989827216401,544.9315310605954
"10.0.2.109",52373,"91.185.215.137",35341,9,506,5,286,4,220,146748.745332,0.05224900000030175,43790.31177604904,33684.855212345414
"10.0.2.109",52374,"91.185.215.137",35341,9,506,5,286,4,220,147348.920382,0.05233599999337457,43717.517584256486,33628.859680197296
"10.0.2.109",52375,"31.28.27.51",80,11,945,6,479,5,466,147591.532004,1620.0084749999805,2.365419724115978,2.3012225290982165
"10.0.2.109",52376,"91.185.215.137",35341,18,2452,8,1778,10,674,147591.743645,0.2940259999886621,48376.67417353734,18338.514281757125
"10.0.2.109",52377,"5.101.114.217",80,7,1824,4,340,3,1484,147591.844532,0.1929660000023432,14095.74743720122,61523.79175531356
"10.0.2.109",52378,"91.185.215.137",35341,16,909,8,460,8,449,147758.508142,21.508438999997452,171.09563367199434,167.00421634505534
"10.0.2.109",52379,"46.203.245.55",9084,3,186,3,186,0,0,147758.985074,9.00824600001215,165.18198992323178,0
"10.0.2.109",52380,"91.185.215.137",35341,16,909,8,460,8,449,147948.742344,21.557637999998406,170.70515795841234,166.62307809418942
"10.0.2.109",52381,"77.247.182.241",9084,3,186,3,186,0,0,147949.273906,8.993100000021514,165.4601861423136,0
"10.0.2.109",52382,"91.185.215.137",35341,16,909,8,460,8,449,148016.38686,21.72116700001061,169.41999479117317,165.36864708964512
"10.0.2.109",52383,"78.190.154.225",9084,3,186,3,186,0,0,148017.078374,8.995320999994874,165.4193330066651,0
"10.0.2.109",52384,"91.185.215.137",35341,16,909,8,460,8,449,148634.810467,21.74666099998285,169.22138069853125,165.17478246443594
"10.0.2.109",52385,"109.201.154.154",9084,3,186,3,186,0,0,148635.532332,9.001006000005873,165.31485480612156,0
"10.0.2.109",52386,"91.185.215.137",35341,15,1183,7,616,8,567,149099.947066,0.16964500001631677,29048.896221674768,26738.18856767791
"10.0.2.109",52387,"80.78.242.47",80,10,879,5,395,5,484,149100.055447,0.061245999997481704,51595.20621967038,63220.45521600117
"10.0.2.109",52388,"91.185.215.137",35341,18,1676,8,1000,10,676,149100.205383,0.2580290000187233,31004.26695999092,20958.884464953862
"10.0.2.109",52389,"217.23.10.139",80,7,1048,4,342,3,706,149100.315516,0.1476109999930486,18535.20401683374,38262.73109907784
"10.0.2.109",52390,"91.185.215.137",35341,19,2755,9,2076,10,679,149100.491033,0.2797969999955967,59357.31977205391,19414.07520482881
"10.0.2.109",52391,"37.187.78.159",80,9,2181,5,399,4,1782,149100.596645,0.1738539999932982,18360.233299912838,81999.8389484829
"10.0.2.109",52392,"31.28.27.51",80,17,1929,8,818,9,1111,149211.540675,1621.3113900000171,4.036238837500507,5.481982088585652
"10.0.2.109",52393,"91.185.215.137",35341,18,2452,8,1778,10,674,149212.992152,0.2967190000053961,47937.61100482721,18172.075262797265
"10.0.2.109",52394,"5.101.114.217",80,7,1824,4,340,3,1484,149213.092944,0.19567399998777546,13900.671525956077,60672.34277799652
"10.0.2.109",52395,"91.185.215.137",35341,16,909,8,460,8,449,149339.56202,23.241084999986924,158.34028402727628,154.55388593097186
"10.0.2.109",52396,"203.88.132.183",28388,3,186,3,186,0,0,149341.776773,9.001748000009684,165.30122816128593,0
"10.0.2.109",52397,"91.185.215.137",35341,9,506,5,286,4,220,149962.927276,0.052575000008801,43518.78268410825,33475.98668008327
"10.0.2.109",52398,"91.185.215.137",35341,18,2452,8,1778,10,674,150502.238224,0.31592200000886805,45023.77168921673,17067.504003673832
"10.0.2.109",52399,"5.101.114.217",80,7,1824,4,340,3,1484,150502.346592,0.2073789999994915,13116.082149140799,57247.84090977925
"10.0.2.109",52400,"31.28.27.51",80,11,945,6,479,5,466,150832.852301,1620.0102919999918,2.365417071066373,2.3012199480520454
"10.0.2.109",52401,"91.185.215.137",35341,18,2452,8,1778,10,674,150833.060134,0.2995480000099633,47484.877213424545,18000.45401678748
"10.0.2.109",52402,"5.101.114.217",80,7,1824,4,340,3,1484,150833.161368,0.19818099998519756,13724.827305358036,59904.834473974486
"10.0.2.109",52403,"91.185.215.137",35341,9,506,5,286,4,220,151433.481492,0.05217000000993721,43856.622571673135,33735.86351667164
"10.0.2.109",52404,"91.185.215.137",35341,15,1183,7,616,8,567,151973.449909,0.16468000001623295,29924.702450292894,27544.32839174687
"10.0.2.109",52405,"80.78.242.47",80,10,879,5,395,5,484,151973.555993,0.058487000002060086,54029.10048196514,66202.74590701552
"10.0.2.109",52406,"91.185.215.137",35341,18,1676,8,1000,10,676,151973.699114,0.24747300002491102,32326.758875492305,21852.888999832798
"10.0.2.109",52407,"217.23.10.139",80,7,1048,4,342,3,706,151973.805003,0.14139800000702962,19349.637193340637,39943.98789034646
"10.0.2.109",52408,"91.185.215.137",35341,19,2755,9,2076,10,679,151973.975835,0.28811300001689233,57644.04938002193,18853.71364597056
"10.0.2.109",52409,"37.187.78.159",80,9,2181,5,399,4,1782,151974.087198,0.17652500001713634,18082.42458399736,80759.09926988294
"10.0.2.109",52410,"31.28.27.51",80,17,1929,8,818,9,1111,152452.863071,1620.638169999991,4.037915508308703,5.484259327299473
"10.0.2.109",52411,"91.185.215.137",35341,18,2452,8,1778,10,674,152453.663111,0.3390650000073947,41950.658427410046,15902.555556847228
"10.0.2.109",52412,"5.101.114.217",80,7,1824,4,340,3,1484,152453.77947,0.22252499999012798,12223.34569203761,53351.30884407004
"10.0.2.109",52413,"91.185.215.137",35341,28,4428,12,2211,16,2217,152860.131972,5.680155999987619,3113.998981724895,3122.4494538598337
"10.0.2.109",52414,"94.198.110.184",3389,26,4287,13,2046,13,2241,152860.821608,4.990531999996165,3279.810649448311,3592.4025735159653
"10.0.2.109",52415,"91.185.215.137",35341,9,506,5,286,4,220,153465.975994,0.05563600000459701,41124.4517904046,31634.19368492662
"10.0.2.109",52416,"91.185.215.137",35341,36,5031,18,2546,18,2485,153701.183817,7.260325999988709,2805.383670104025,2738.1690574267486
"10.0.2.109",52417,"200.55.194.230",3389,24,4350,13,2206,11,2144,153702.021187,6.422682999982499,2747.7613327713807,2670.535039647253
"10.0.2.109",52418,"31.28.27.51",80,11,945,6,479,5,466,154073.501317,1620.010430000024,2.365416869569132,2.3012197520234143
"10.0.2.109",52419,"91.185.215.137",35341,18,2452,8,1778,10,674,154073.722142,0.2964759999886155,47976.90201077386,18186.96960363419
"10.0.2.109",52420,"5.101.114.217",80,7,1824,4,340,3,1484,154073.822656,0.1957819999952335,13893.003442942769,60638.873850961965
"10.0.2.109",52421,"91.185.215.137",35341,9,506,5,286,4,220,154674.143091,0.05225599999539554,43784.44580912438,33680.34293009568
"10.0.2.109",52422,"91.185.215.137",35341,9,506,5,286,4,220,155274.317798,0.053081999998539686,43103.1234705351,33156.24882348854
"10.0.2.109",52423,"91.185.215.137",35341,15,1183,7,616,8,567,155377.653647,0.16476300000795163,29909.627766926857,27530.45283092131
"10.0.2.109",52424,"80.78.242.47",80,10,879,5,395,5,484,155377.760978,0.057480999996187165,54974.68729162,67361.38898517488
"10.0.2.109",52425,"91.185.215.137",35341,18,1676,8,1000,10,676,155377.90148,0.24657300001126714,32444.752668112244,21932.652803643876
"10.0.2.109",52426,"217.23.10.139",80,7,1048,4,342,3,706,155378.007615,0.1402319999760948,19510.525418352463,40276.113875312396
"10.0.2.109",52427,"91.185.215.137",35341,19,2755,9,2076,10,679,155378.176732,0.2875200000125915,57762.938227854334,18892.59877490997
"10.0.2.109",52428,"37.187.78.159",80,9,2181,5,399,4,1782,155378.288575,0.1754979999968782,18188.241461764694,81231.69494953554
"10.0.2.109",52429,"31.28.27.51",80,11,945,6,479,5,466,155693.512123,1620.0079600000172,2.3654204760820803,2.301223260656053
"10.0.2.109",52430,"91.185.215.137",35341,18,2452,8,1778,10,674,155693.714387,0.29226599997491576,48667.99422861639,18448.947193525
"10.0.2.109",52431,"5.101.114.217",80,7,1824,4,340,3,1484,155693.814509,0.19200500001898035,14166.297751262304,61831.72312609782
"10.0.2.109",52432,"91.185.215.137",35341,9,506,5,286,4,220,156294.134552,0.06375699999625795,35886.25562893938,27604.812022261063
"10.0.2.109",52433,"91.185.215.137",35341,9,506,5,286,4,220,156894.310233,0.0537039999908302,42603.902882293114,32772.23298637932
"10.0.2.109",52434,"31.28.27.51",80,17,1929,8,818,9,1111,157313.520293,1620.439308000001,4.038411045506431,5.484932361317413
"10.0.2.109",52435,"91.185.215.137",35341,18,2452,8,1778,10,674,157314.12016,0.2999050000216812,47428.352308136564,17979.026690485964
"10.0.2.109",52436,"5.101.114.217",80,7,1824,4,340,3,1484,157314.2234,0.19633299999986775,13854.013334497165,60468.69349527587
"10.0.2.109",52437,"91.185.215.137",35341,9,506,5,286,4,220,157914.540222,0.05367299998761155,42628.50968882122,32791.16129909325
"10.0.2.109",52438,"91.185.215.137",35341,15,1183,7,616,8,567,158402.823611,0.1707159999932628,28866.655733466578,26570.444481940827
"10.0.2.109",52439,"80.78.242.47",80,10,879,5,395,5,484,158402.936538,0.05783399997744709,54639.13962776691,66950.23691098527
"10.0.2.109",52440,"91.185.215.137",35341,18,1676,8,1000,10,676,158403.075764,0.2480329999816604,32253.77268585842,21803.55033564029
"10.0.2.109",52441,"217.23.10.139",80,7,1048,4,342,3,706,158403.181377,0.14221200000611134,19238.88279387411,39715.354539400934
"10.0.2.109",52442,"91.185.215.137",35341,20,2809,10,2130,10,679,158403.352641,1.5715590000036173,10842.736416488837,3456.4403881670987
"10.0.2.109",52443,"37.187.78.159",80,9,2181,5,399,4,1782,158403.464593,1.4593309999909252,2187.303634350157,9768.859840631529
"10.0.2.109",52444,"31.28.27.51",80,11,945,6,479,5,466,158933.959626,1620.0088289999985,2.365419207230755,2.3012220262411938
"10.0.2.109",52445,"91.185.215.137",35341,18,2452,8,1778,10,674,158934.173694,0.33808200000203215,42072.633266232755,15948.793487874509
"10.0.2.109",52446,"5.101.114.217",80,7,1824,4,340,3,1484,158934.289517,0.22206000000005588,12248.941727457965,53463.02801043417
"10.0.2.109",52447,"91.185.215.137",35341,9,506,5,286,4,220,159534.634303,0.0517519999993965,44210.85175503712,34008.347503874706
"10.0.2.109",52448,"91.185.215.137",35341,9,506,5,286,4,220,160134.808133,0.05217899999115616,43849.058057605434,33730.04465969649
"10.0.2.109",52449,"31.28.27.51",80,17,1929,8,818,9,1111,160553.968657,1620.5310739999986,4.03818236193847,5.484621765420098
"10.0.2.109",52450,"91.185.215.137",35341,18,2452,8,1778,10,674,160554.644466,0.2928799999936018,48565.96558423495,18410.270418320786
"10.0.2.109",52451,"5.101.114.217",80,7,1824,4,340,3,1484,160554.743779,0.1932719999749679,14073.43019346976,61426.38355032095
"10.0.2.109",52452,"91.185.215.137",35341,9,506,5,286,4,220,161155.068519,0.0562670000072103,40663.26620766712,31279.43554435932
"10.0.2.109",52453,"91.185.215.137",35341,9,506,5,286,4,220,161755.24666,0.05743099999381229,39839.11128565605,30645.470219735424
"10.0.2.109",52454,"31.28.27.51",80,11,945,6,479,5,466,162174.500111,1620.008387000009,2.3654198526072068,2.3012226541022094
"10.0.2.109",52455,"91.185.215.137",35341,18,2452,8,1778,10,674,162174.712217,0.32491700001992285,43777.33390105113,16595.007339318596
"10.0.2.109",52456,"5.101.114.217",80,7,1824,4,340,3,1484,162174.812972,0.22398299997439608,12143.778770312605,53004.0226327762
"10.0.2.109",52457,"91.185.215.137",35341,9,506,5,286,4,220,162775.155744,0.05537899999762885,41315.30002524359,31781.000019418145
"10.0.2.109",52458,"91.185.215.137",35341,9,506,5,286,4,220,163375.331999,0.052149000024655834,43874.283282867225,33749.44867912863
"10.0.2.109",52459,"31.28.27.51",80,17,1929,8,818,9,1111,163794.508873,1620.619566999987,4.037961859311583,5.4843222808009395
"10.0.2.109",52460,"91.185.215.137",35341,18,2452,8,1778,10,674,163795.287794,0.33535499998833984,42414.754515348104,16078.483995131957
"10.0.2.109",52461,"5.101.114.217",80,7,1824,4,340,3,1484,163795.399138,0.2237899999890942,12154.251754468705,53049.73412832811
"10.0.2.109",52462,"91.185.215.137",35341,9,506,5,286,4,220,164395.741349,0.052626000018790364,43476.608504979646,33443.54500383049
"10.0.2.109",52463,"91.185.215.137",35341,9,506,5,286,4,220,164995.926479,0.05564900001627393,41114.84481897069,31626.80370690053
"10.0.2.109",52464,"31.28.27.51",80,11,945,6,479,5,466,165415.128666,1620.009760999994,2.3654178463928495,2.3012207023362583
"10.0.2.109",52465,"91.185.215.137",35341,18,2452,8,1778,10,674,165415.357927,0.3635049999866169,39130.13576298451,14833.358551322586
"10.0.2.109",52466,"5.101.114.217",80,7,1824,4,340,3,1484,165415.509725,0.21154799999203533,12857.602057700411,56119.651334198265
"10.0.2.109",52467,"91.185.215.137",35341,9,506,5,286,4,220,166015.844157,0.05366099998354912,42638.042539301045,32798.49426100081
"10.0.2.109",52468,"91.185.215.137",35341,15,1183,7,616,8,567,166485.06743,0.16577500000130385,29727.039661958923,27362.388779757643
"10.0.2.109",52469,"80.78.242.47",80,10,879,5,395,5,484,166485.175439,0.05768299999181181,54782.1715314489,67125.49625625637
"10.0.2.109",52470,"91.185.215.137",35341,18,1676,8,1000,10,676,166485.318993,0.25138200001674704,31824.0765029598,21513.075716000825
"10.0.2.109",52471,"217.23.10.139",80,7,1048,4,342,3,706,166485.428731,0.1415090000082273,19334.45929121773,39912.65572982373
"10.0.2.109",52472,"91.185.215.137",35341,19,2755,9,2076,10,679,166485.599695,0.28896499998518266,57474.088560384866,18798.12434128195
"10.0.2.109",52473,"37.187.78.159",80,9,2181,5,399,4,1782,166485.705922,0.1825609999941662,17484.56680288781,78088.9675256794
"10.0.2.109",52474,"31.28.27.51",80,17,1929,8,818,9,1111,167035.138927,1620.5976289999962,4.0380165211262415,5.484396521969749
"10.0.2.109",52475,"91.185.215.137",35341,18,2452,8,1778,10,674,167035.904712,0.3350009999994654,42459.574747605824,16095.474341893321
"10.0.2.109",52476,"5.101.114.217",80,7,1824,4,340,3,1484,167036.015808,0.2237299999978859,12157.511286039879,53063.961024950535
"10.0.2.109",52477,"91.185.215.137",35341,9,506,5,286,4,220,167636.35539,0.05992899998091161,38178.511250459145,29368.085577276266
"10.0.2.109",52478,"91.185.215.137",35341,3300,735254,1569,376556,1731,358698,168080.203267,7056.475076000002,426.9054970867439,406.6596946908849
"10.0.2.109",52479,"86.59.34.124",5222,3312,735869,1587,350913,1725,384956,168080.460769,7056.217441999994,397.8482838822929,436.4446001436024
"10.0.2.109",52480,"31.28.27.51",80,11,945,6,479,5,466,168655.736775,1620.0094910000043,2.3654182406268323,2.3012210858707802
"10.0.2.109",52481,"91.185.215.137",35341,18,2452,8,1778,10,674,168655.962466,0.2960029999958351,48053.56702533467,18216.03159453069
"10.0.2.109",52482,"5.101.114.217",80,7,1824,4,340,3,1484,168656.063379,0.19490999999106862,13955.15879187645,60910.163668072506
"10.0.2.109",52483,"31.28.27.51",80,11,945,6,479,5,466,170275.746606,1620.0085390000022,2.365419630667758,2.30122243818617
"10.0.2.109",52484,"91.185.215.137",35341,18,2452,8,1778,10,674,170275.9672,0.29432199997245334,48328.021695052616,18320.07121623479
"10.0.2.109",52485,"5.101.114.217",80,7,1824,4,340,3,1484,170276.069131,0.19210800001746975,14158.702395281045,61798.571631167855
"10.0.2.109",52486,"31.28.27.51",80,17,1929,8,818,9,1111,171895.755354,1620.4605370000063,4.03835813991191,5.484860505430479
"10.0.2.109",52487,"91.185.215.137",35341,18,2452,8,1778,10,674,171896.33075,0.29380400001537055,48413.22786366374,18352.370967440587
"10.0.2.109",52488,"5.101.114.217",80,7,1824,4,340,3,1484,171896.432477,0.1918710000172723,14176.191293916978,61874.90552991998
"10.0.2.109",52489,"31.28.27.51",80,11,945,6,479,5,466,173516.216219,1620.0093300000008,2.365418475707173,2.30122131457107
"10.0.2.109",52490,"91.185.215.137",35341,18,2452,8,1778,10,674,173516.426086,0.2982320000010077,47694.41240360504,18079.884117002137
"10.0.2.109",52491,"5.101.114.217",80,7,1824,4,340,3,1484,173516.530983,0.1931449999974575,14082.683994075982,61466.77366826105
"10.0.2.109",52492,"31.28.27.51",80,23,2869,10,1135,13,1734,175136.22605,1620.4280100000033,5.60345781729605,8.56070119400119
"10.0.2.109",52493,"46.38.51.49",495,644,38308,308,16644,336,21664,175138.225574,87495.36517099998,1.5218177527434646,1.980813494078011
"10.0.2.109",52494,"46.38.51.49",6107,18,2436,8,1766,10,670,175138.561899,0.5711219999939203,24737.27154644786,9385.035071415667
"10.0.2.109",52495,"5.101.114.217",80,7,1808,4,336,3,1472,175138.802927,0.32986099997651763,8148.886955994662,35699.88571197661
"10.0.2.109",52496,"46.38.51.49",6107,9,506,5,286,4,220,175739.260002,0.1222600000037346,18714.21560551374,14395.5504657798
"10.0.2.109",52497,"46.38.51.49",6107,9,506,5,286,4,220,176339.509556,0.1218759999901522,18773.17929850729,14440.907152697917
"10.0.2.109",52498,"31.28.27.51",80,11,941,6,475,5,466,176756.654298,1620.0092939999886,2.345665555175529,2.3012213657090452
"10.0.2.109",52499,"46.38.51.49",6107,18,2436,8,1766,10,670,176756.913374,0.5547300000034738,25468.245813119043,9662.358264320363
"10.0.2.109",52500,"5.101.114.217",80,7,1808,4,336,3,1472,176757.147236,0.32069600000977516,8381.76965075357,36720.13370806326
"10.0.2.109",52501,"46.38.51.49",6107,9,506,5,286,4,220,177357.595103,0.12190900000859983,18768.09751403586,14436.99808771989
"10.0.2.109",52502,"46.38.51.49",6107,9,506,5,286,4,220,177957.843797,0.12166499998420477,18805.737067332764,14465.951590255974
"10.0.2.109",52503,"31.28.27.51",80,11,941,6,475,5,466,178376.663865,1620.0088309999846,2.3456662255688876,2.301222023400214
"10.0.2.109",52504,"46.38.51.49",6107,18,2436,8,1766,10,670,178376.934905,0.5655860000115354,24979.40189416261,9476.896528362939
"10.0.2.109",52505,"5.101.114.217",80,7,1808,4,336,3,1472,178377.172355,0.3279679999977816,8195.921553377713,35905.94204336903
"10.0.2.109",52506,"46.38.51.49",6107,9,506,5,286,4,220,178977.62732,0.12499499999103136,18304.73219060097,14080.56322353921
"10.0.2.109",52507,"46.38.51.49",6107,9,506,5,286,4,220,179577.87944,0.12175400002161041,18791.990403550582,14455.377233500447
"10.0.2.109",52508,"31.28.27.51",80,17,1925,8,814,9,1111,179996.672831,1620.489544000011,4.018538733626014,5.484762325624694
"10.0.2.109",52509,"46.38.51.49",6107,18,2436,8,1766,10,670,179997.36326,0.5694579999835696,24809.555753730092,9412.458864665437
"10.0.2.109",52510,"5.101.114.217",80,7,1808,4,336,3,1472,179997.603215,0.3293029999767896,8162.695147597986,35760.37874185784
"10.0.2.109",52511,"46.38.51.49",6107,9,506,5,286,4,220,180598.060087,0.12191099999472499,18767.789617827762,14436.761244482894
"10.0.2.109",52512,"46.38.51.49",6107,9,506,5,286,4,220,181198.309317,0.12296799998148344,18606.466725851667,14312.66671219359
"10.0.2.109",52513,"31.28.27.51",80,11,941,6,475,5,466,181617.162538,1620.0111259999976,2.345662902564538,2.3012187633580523
"10.0.2.109",52514,"46.38.51.49",6107,18,2436,8,1766,10,670,181617.432815,0.5578070000046864,25327.756732850794,9609.058330130256
"10.0.2.109",52515,"5.101.114.217",80,7,1808,4,336,3,1472,181617.668366,0.32205899999826215,8346.296796594737,36564.72882317695
"10.0.2.109",52516,"46.38.51.49",6107,9,506,5,286,4,220,182218.11784,0.12171900001703762,18797.39399501916,14459.533842322431
"10.0.2.109",52517,"46.38.51.49",6107,9,506,5,286,4,220,182818.366476,0.12174600001890212,18793.225236515107,14456.32710501162
"10.0.2.109",52518,"46.38.51.49",6107,17,1287,8,670,9,617,182974.907787,0.388357999996515,13801.698433013094,12709.922288312058
"10.0.2.109",52519,"80.78.242.47",80,10,875,5,391,5,484,182975.161643,0.1343089999863878,23289.5785116189,28829.043477298073
"10.0.2.109",52520,"46.38.51.49",6107,18,1672,8,1000,10,672,182975.482954,0.5600629999826197,14284.107324083652,9598.920121784215
"10.0.2.109",52521,"217.23.10.139",80,7,1044,4,338,3,706,182975.732044,0.3105419999919832,8707.356815083967,18187.555951033377
"10.0.2.109",52522,"46.38.51.49",6107,19,2739,9,2064,10,675,182976.105729,0.5951329999952577,27745.05866777943,9073.602035247633
"10.0.2.109",52523,"37.187.78.159",80,9,2165,5,395,4,1770,182976.351152,0.349532000022009,9040.660082055503,40511.31226642592
"10.0.2.109",52524,"31.28.27.51",80,17,1925,8,814,9,1111,183237.174001,1620.5090659999987,4.018490322966207,5.484696251616038
"10.0.2.109",52525,"46.38.51.49",6107,18,2436,8,1766,10,670,183237.877895,0.5576699999801349,25333.978877298872,9611.418939858575
"10.0.2.109",52526,"5.101.114.217",80,7,1808,4,336,3,1472,183238.112375,0.322825000010198,8326.49268153051,36477.96793813366
"10.0.2.109",52527,"46.38.51.49",6107,9,506,5,286,4,220,183838.562051,0.12238700001034886,18694.79601433592,14380.61231871994
"10.0.2.109",52528,"46.38.51.49",6107,9,506,5,286,4,220,184438.811726,0.12184299997170456,18778.263835684767,14444.81833514213
"10.0.2.109",52529,"31.28.27.51",80,11,941,6,475,5,466,184857.683445,1620.007077999995,2.3456687638003095,2.30122451353883
"10.0.2.109",52530,"46.38.51.49",6107,18,2436,8,1766,10,670,184857.957226,0.5560209999966901,25409.112245911758,9639.923672005027
"10.0.2.109",52531,"5.101.114.217",80,7,1808,4,336,3,1472,184858.19143,0.32153899999684654,8359.79461286613,36623.86211350875
"10.0.2.109",52532,"46.38.51.49",6107,9,506,5,286,4,220,185458.640493,0.12168199999723583,18803.109745500362,14463.930573461816
"10.0.2.109",52533,"46.38.51.49",6107,9,506,5,286,4,220,186058.888728,0.12132200002088211,18858.904399912517,14506.849538394243
"10.0.2.109",52534,"31.28.27.51",80,17,1925,8,814,9,1111,186477.690993,1620.6005379999988,4.018263506216363,5.484386677403415
"10.0.2.109",52535,"46.38.51.49",6107,18,2436,8,1766,10,670,186478.50057,0.5680369999899995,24871.619278759536,9436.005049133006
"10.0.2.109",52536,"5.101.114.217",80,7,1808,4,336,3,1472,186478.739932,0.3285409999953117,8181.627255162545,35843.31940356924
"10.0.2.109",52537,"46.38.51.49",6107,9,506,5,286,4,220,187079.195981,0.12211500000557862,18736.436964299854,14412.643818692195
"10.0.2.109",52538,"46.38.51.49",6107,9,506,5,286,4,220,187679.445288,0.12220700000762008,18722.331780154447,14401.793677041882
"10.0.2.109",52539,"31.28.27.51",80,11,941,6,475,5,466,188098.291737,1620.0090760000166,2.3456658708250107,2.3012216753778
"10.0.2.109",52540,"46.38.51.49",6107,18,2436,8,1766,10,670,188098.554661,0.5722860000096262,24686.957220275108,9365.946397273116
"10.0.2.109",52541,"5.101.114.217",80,7,1808,4,336,3,1472,188098.793896,0.33283700002357364,8076.025200953075,35380.681832746806
"10.0.2.109",52542,"46.38.51.49",6107,9,506,5,286,4,220,188699.254247,0.12153299999772571,18826.1624418291,14481.663416791616
"10.0.2.109",52543,"46.38.51.49",6107,9,506,5,286,4,220,189299.437846,0.12314200002583675,18580.175728183305,14292.442867833312
"10.0.2.109",52544,"31.28.27.51",80,17,1925,8,814,9,1111,189718.300983,1620.6597150000161,4.0181167827695,5.48418641972594
"10.0.2.109",52545,"46.38.51.49",6107,18,2436,8,1766,10,670,189719.174872,0.5684020000044256,24855.64793911703,9429.94570736603
"10.0.2.109",52546,"5.101.114.217",80,7,1808,4,336,3,1472,189719.413584,0.32941100001335144,8160.018942570382,35748.65441507025
"10.0.2.109",52547,"46.38.51.49",6107,9,506,5,286,4,220,190319.87014,0.12278299999888986,18634.501519108402,14334.231937775694
"10.0.2.109",52548,"46.38.51.49",6107,9,506,5,286,4,220,190920.119644,0.12178899999707937,18786.589922364652,14451.223017203578
"10.0.2.109",52549,"46.38.51.49",6107,15,1179,7,616,8,563,191188.839437,0.374911000020802,13144.452949437517,12013.517874242405
"10.0.2.109",52550,"80.78.242.47",80,10,875,5,391,5,484,191189.086994,0.12730500000179745,24570.912375443502,30415.144730728018
"10.0.2.109",52551,"46.38.51.49",6107,18,1672,8,1000,10,672,191189.401642,0.5289879999763798,15123.216406340434,10162.801425060772
"10.0.2.109",52552,"217.23.10.139",80,7,1044,4,338,3,706,191189.649374,0.28095300000859424,9624.385573093314,20103.006552082483
"10.0.2.109",52553,"46.38.51.49",6107,19,2735,9,2060,10,675,191189.992707,0.6018409999960568,27382.647576532632,8972.469472892973
"10.0.2.109",52554,"37.187.78.159",80,9,2161,5,395,4,1766,191190.24442,0.3499479999882169,9029.913015952085,40371.712370054134
"10.0.2.109",52555,"31.28.27.51",80,11,941,6,475,5,466,191338.96089,1620.0089090000256,2.3456661126299645,2.301221912601186
"10.0.2.109",52556,"46.38.51.49",6107,18,2436,8,1766,10,670,191339.23648,0.5692370000178926,24819.187789191357,9416.113147654705
"10.0.2.109",52557,"5.101.114.217",80,7,1808,4,336,3,1472,191339.474792,0.33073200000217184,8127.426435852438,35605.868195163064
"10.0.2.109",52558,"46.38.51.49",6107,9,506,5,286,4,220,191939.932627,0.12196099999709986,18760.095440791785,14430.84264676291
"10.0.2.109",52559,"46.38.51.49",6107,9,506,5,286,4,220,192540.18164,0.12300300001516007,18601.172326837597,14308.594097567382
"10.0.2.109",52560,"31.28.27.51",80,11,941,6,475,5,466,192958.969928,1620.0091949999915,2.3456656985209396,2.301221506338438
"10.0.2.109",52561,"46.38.51.49",6107,18,2436,8,1766,10,670,192959.247543,0.5713809999870136,24726.05844492747,9380.780950227296
"10.0.2.109",52562,"5.101.114.217",80,7,1808,4,336,3,1472,192959.485555,0.33306900001480244,8070.399826704192,35356.037336037414
"10.0.2.109",52563,"46.38.51.49",6107,9,506,5,286,4,220,193559.945462,0.12262000000919215,18659.27254794064,14353.286575338952
"10.0.2.109",52564,"46.38.51.49",6107,9,506,5,286,4,220,194160.277963,0.2827650000108406,8091.5247640701045,6224.2498185154645
"10.0.2.109",52565,"31.28.27.51",80,17,1925,8,814,9,1111,194578.979387,1620.4194959999877,4.018712448273363,5.484999422643374
"10.0.2.109",52566,"46.38.51.49",6107,18,2436,8,1766,10,670,194579.70198,1.1527989999740385,12255.388840828426,4649.552957732189
"10.0.2.109",52567,"5.101.114.217",80,7,1808,4,336,3,1472,194580.197606,0.6568689999985509,4092.1401375402556,17927.471078747785
"10.0.2.109",52568,"46.38.51.49",6107,15,1179,7,616,8,563,194592.028467,0.6915790000057314,7125.7224409057535,6512.632685438213
"10.0.2.109",52569,"80.78.242.47",80,10,875,5,391,5,484,194592.511205,0.208851000003051,14977.18469125982,18539.532968209085
"10.0.2.109",52570,"46.38.51.49",6107,18,1672,8,1000,10,672,194592.990196,0.9306830000132322,8595.837680376946,5776.402921213308
"10.0.2.109",52571,"217.23.10.139",80,8,1098,5,392,3,706,194593.47875,0.44189399998867884,7096.724554034096,12781.345752928755
"10.0.2.109",52572,"46.38.51.49",6107,19,2735,9,2060,10,675,194593.984241,1.100200999993831,14979.08109526569,4908.194048205991
"10.0.2.109",52573,"37.187.78.159",80,9,2161,5,395,4,1766,194594.482378,0.6019300000043586,5249.779874698252,23471.167743587623
"10.0.2.109",52574,"46.38.51.49",6107,9,506,5,286,4,220,195195.203927,0.2886350000044331,7926.966583972349,6097.6666030556535
"10.0.2.109",52575,"46.38.51.49",6107,9,506,5,286,4,220,195795.540525,0.1220679999969434,18743.6510801954,14418.193138611845
"10.0.2.109",52576,"31.28.27.51",80,11,941,6,475,5,466,196199.399075,1620.306933999993,2.345234671445291,2.300798646091591
"10.0.2.109",52577,"46.38.51.49",6107,18,2436,8,1766,10,670,196199.676534,0.5635480000055395,25069.73673912626,9511.168525036577
"10.0.2.109",52578,"5.101.114.217",80,7,1808,4,336,3,1472,196199.91336,0.32652000000234693,8232.267548636162,36065.17211783461
"10.0.2.109",52579,"46.38.51.49",6107,9,506,5,286,4,220,196800.367225,0.12205199999152683,18746.108217471563,14420.083244208894
"10.0.2.109",52580,"46.38.51.49",6107,9,506,5,286,4,220,197400.61659,0.12159399999654852,18816.717930695148,14474.398408227034
"10.0.2.109",52581,"31.28.27.51",80,17,1925,8,814,9,1111,197819.408299,1620.569209999987,4.018341185193845,5.484492698710517
"10.0.2.109",52582,"46.38.51.49",6107,18,2436,8,1766,10,670,197820.189396,0.5533500000019558,25531.761091443146,9686.455227217955
"10.0.2.109",52583,"5.101.114.217",80,7,1808,4,336,3,1472,197820.422274,0.32028299997909926,8392.577814543423,36767.48375895214
"10.0.2.109",52584,"46.38.51.49",6107,9,506,5,286,4,220,198420.870236,0.12175400002161041,18791.990403550582,14455.377233500447
"10.0.2.109",52585,"46.38.51.49",6107,9,506,5,286,4,220,199021.076168,0.12210599999525584,18737.817962171353,14413.706124747194
"10.0.2.109",52586,"31.28.27.51",80,11,941,6,475,5,466,199439.977683,1620.0094499999832,2.3456653292979492,2.3012211441112513
"10.0.2.109",52587,"46.38.51.49",6107,18,2436,8,1766,10,670,199440.259432,0.5686030000215396,24846.86151755233,9426.612240520986
"10.0.2.109",52588,"5.101.114.217",80,7,1808,4,336,3,1472,199440.497725,0.3301180000125896,8142.54296917311,35672.093007806005
"10.0.2.109",52589,"46.38.51.49",6107,9,506,5,286,4,220,200040.930996,0.12158700000145473,18817.801244973765,14475.231726902897
"10.0.2.109",52590,"46.38.51.49",6107,9,506,5,286,4,220,200641.179765,0.12135999999009073,18852.999342343603,14502.307186418155
"10.0.2.109",52591,"46.38.51.49",6107,15,1179,7,616,8,563,200976.864945,0.37372299999697134,13186.236865378734,12051.706745467902
"10.0.2.109",52592,"80.78.242.47",80,10,875,5,391,5,484,200977.111765,0.12684099999023601,24660.795801363816,30526.40707892605
"10.0.2.109",52593,"46.38.51.49",6107,18,1672,8,1000,10,672,200977.425837,0.5264360000146553,15196.529112327597,10212.067563484145
"10.0.2.109",52594,"217.23.10.139",80,7,1044,4,338,3,706,200977.671665,0.2804269999905955,9642.438139304284,20140.713983280544
"10.0.2.109",52595,"46.38.51.49",6107,19,2739,9,2064,10,675,200978.015303,0.5964939999976195,27681.7537143138,9052.899107152041
"10.0.2.109",52596,"37.187.78.159",80,9,2165,5,395,4,1770,200978.261599,0.3499220000230707,9030.583958115403,40466.16102750446
"10.0.2.109",52597,"31.28.27.51",80,17,1925,8,814,9,1111,201059.987342,1620.4212439999974,4.018708113160241,5.484993505799788
"10.0.2.109",52598,"46.38.51.49",6107,18,2436,8,1766,10,670,201060.618142,0.5652030000055674,24996.32875243202,9483.31838285926
"10.0.2.109",52599,"5.101.114.217",80,7,1808,4,336,3,1472,201060.854122,0.32888200000161305,8173.144167168822,35806.155399025316
"10.0.2.109",52600,"46.38.51.49",6107,9,506,5,286,4,220,201661.310274,0.1219260000216309,18765.480698079868,14434.985152369129
"10.0.2.109",52601,"46.38.51.49",6107,9,506,5,286,4,220,202261.559248,0.12158700000145473,18817.801244973765,14475.231726902897
"10.0.2.109",52602,"31.28.27.51",80,11,941,6,475,5,466,202680.409045,1620.0089919999882,2.345665992451496,2.3012217946997833
"10.0.2.109",52603,"46.38.51.49",6107,18,2436,8,1766,10,670,202680.685101,0.5659799999848474,24962.01279263974,9470.29930411587
"10.0.2.109",52604,"5.101.114.217",80,7,1808,4,336,3,1472,202680.924579,0.3262809999869205,8238.297664000518,36091.5897660975
"10.0.2.109",52605,"46.38.51.49",6107,9,506,5,286,4,220,203281.37826,0.1228910000063479,18618.125004124093,14321.634618556996
"10.0.2.109",52606,"46.38.51.49",6107,9,506,5,286,4,220,203881.628238,0.12157799999113195,18819.19426349249,14476.303279609605
"10.0.2.109",52607,"46.38.51.49",6107,15,1179,7,616,8,563,203968.635602,0.3762109999952372,13099.032192207,11972.005071773607
"10.0.2.109",52608,"80.78.242.47",80,10,875,5,391,5,484,203968.884564,0.12706199998501688,24617.90307384468,30473.31224486145
"10.0.2.109",52609,"46.38.51.49",6107,18,1672,8,1000,10,672,203969.197786,0.525259999994887,15230.55248843977,10234.931272231524
"10.0.2.109",52610,"217.23.10.139",80,7,1044,4,338,3,706,203969.442761,0.2798379999876488,9662.733439058835,20183.105940756028
"10.0.2.109",52611,"46.38.51.49",6107,19,2739,9,2064,10,675,203969.785551,0.6000289999938104,27518.669931237204,8999.565021116818
"10.0.2.109",52612,"37.187.78.159",80,9,2165,5,395,4,1770,203970.036201,0.34917800000403076,9049.825590282098,40552.38302480839
"10.0.2.109",52613,"31.28.27.51",80,17,1925,8,814,9,1111,204300.418436,1620.5274369999825,4.01844476762171,5.484634074726928
"10.0.2.109",52614,"46.38.51.49",6107,18,2436,8,1766,10,670,204301.148297,0.5664429999887943,24941.609306284106,9462.558457084004
"10.0.2.109",52615,"5.101.114.217",80,7,1808,4,336,3,1472,204301.38602,0.32855400000698864,8181.303529839307,35841.90117834363
"10.0.2.109",52616,"46.38.51.49",6107,9,506,5,286,4,220,204901.841833,0.12224599998444319,18716.358819848232,14397.199092190947
"10.0.2.109",52617,"46.38.51.49",6107,9,506,5,286,4,220,205502.091271,0.12103799998294562,18903.154383932168,14540.887987640128
"10.0.2.109",52618,"46.38.51.49",6107,15,1179,7,616,8,563,205876.114299,0.38780599998426624,12707.384620660678,11614.054450376561
"10.0.2.109",52619,"80.78.242.47",80,10,875,5,391,5,484,205876.365695,0.1361460000043735,22975.335301070303,28440.056996721298
"10.0.2.109",52620,"46.38.51.49",6107,18,1672,8,1000,10,672,205876.693069,0.5522669999918435,14485.746930593632,9734.42193735892
"10.0.2.109",52621,"217.23.10.139",80,7,1044,4,338,3,706,205876.94848,0.29667199999676086,9114.442886519533,19037.859993736067
"10.0.2.109",52622,"46.38.51.49",6107,19,2735,9,2060,10,675,205877.313909,0.6240810000163037,26406.82860008472,8652.722963619992
"10.0.2.109",52623,"37.187.78.159",80,9,2161,5,395,4,1766,205877.58233,0.3553890000039246,8891.665189313973,39753.62208690754
"10.0.2.109",52624,"31.28.27.51",80,11,941,6,475,5,466,205920.946096,1620.0091989999928,2.3456656927292032,2.3012215006564394
"10.0.2.109",52625,"46.38.51.49",6107,18,2436,8,1766,10,670,205921.231041,0.6195690000022296,22802.94850121481,8651.175252442765
"10.0.2.109",52626,"5.101.114.217",80,7,1808,4,336,3,1472,205921.495269,0.35504100000252947,7570.956593691572,33168.00031522022
"10.0.2.109",52627,"46.38.51.49",6107,9,506,5,286,4,220,206521.977493,0.12187899998389184,18772.71720560879,14440.551696622148
"10.0.2.109",52628,"46.38.51.49",6107,9,506,5,286,4,220,207122.226532,0.1222729999863077,18712.2259227811,14394.019940600847
"10.0.2.109",52629,"31.28.27.51",80,17,1925,8,814,9,1111,207540.955552,1620.5493819999974,4.01839035103221,5.484559803435854
"10.0.2.109",52630,"46.38.51.49",6107,18,2436,8,1766,10,670,207541.706983,0.5580789999803528,25315.412334987297,9604.375008177514
"10.0.2.109",52631,"5.101.114.217",80,7,1808,4,336,3,1472,207541.945221,0.3196319999988191,8409.67112182113,36842.36872416876
"10.0.2.109",52632,"46.38.51.49",6107,9,506,5,286,4,220,208142.392,0.12162099999841303,18812.540597675197,14471.185075134767
"10.0.2.109",52633,"46.38.51.49",6107,9,506,5,286,4,220,208742.640803,0.12157000001752749,18820.432669820886,14477.255899862219
"10.0.2.109",52634,"31.28.27.51",80,11,941,6,475,5,466,209161.505213,1620.0101960000175,2.345664249140293,2.3012200844197404
"10.0.2.109",52635,"46.38.51.49",6107,18,2436,8,1766,10,670,209161.762466,0.5545290000154637,25477.47728181218,9665.860576904959
"10.0.2.109",52636,"5.101.114.217",80,7,1808,4,336,3,1472,209161.996229,0.3206229999777861,8383.678027422344,36728.49421537408
"10.0.2.109",52637,"46.38.51.49",6107,9,506,5,286,4,220,209762.444264,0.12139600000227802,18847.408480980142,14498.006523830878
"10.0.2.109",52638,"46.38.51.49",6107,9,506,5,286,4,220,210362.664269,0.12197400000877678,18758.095986319742,14429.30460486134
"10.0.2.109",52639,"46.38.51.49",6107,15,1179,7,616,8,563,210504.489143,0.3721289999957662,13242.719594699867,12103.3297594416
"10.0.2.109",52640,"80.78.242.47",80,10,875,5,391,5,484,210504.734367,0.1268500000005588,24659.04611735294,30524.241229664513
"10.0.2.109",52641,"46.38.51.49",6107,18,1672,8,1000,10,672,210505.047613,0.5270010000094771,15180.236849372459,10201.119162778292
"10.0.2.109",52642,"217.23.10.139",80,7,1044,4,338,3,706,210505.293394,0.2809830000041984,9623.357996603343,20100.86019408864
"10.0.2.109",52643,"46.38.51.49",6107,19,2739,9,2064,10,675,210505.637552,0.5958899999968708,27709.81221380911,9062.075215271874
"10.0.2.109",52644,"37.187.78.159",80,9,2165,5,395,4,1770,210505.882669,0.3505159999767784,9015.28033016852,40397.585276957674
"10.0.2.109",52645,"31.28.27.51",80,11,941,6,475,5,466,210781.515603,1620.0084069999866,2.3456668394931555,2.3012226256922323
"10.0.2.109",52646,"46.38.51.49",6107,18,2436,8,1766,10,670,210781.785725,0.5685950000188313,24847.211107259285,9426.744870817509
"10.0.2.109",52647,"5.101.114.217",80,7,1808,4,336,3,1472,210782.023826,0.33022299999720417,8139.953910002507,35660.75046286813
"10.0.2.109",52648,"46.38.51.49",6107,9,506,5,286,4,220,211382.480924,0.1251650000049267,18279.870570126957,14061.438900097659
"10.0.2.109",52649,"46.38.51.49",6107,9,506,5,286,4,220,211982.733557,0.121740000002319,18794.151469988636,14457.03959229895
"10.0.2.109",52650,"31.28.27.51",80,17,1925,8,814,9,1111,212401.524434,1620.4294010000012,4.018687883582776,5.484965895160275
"10.0.2.109",52651,"46.38.51.49",6107,18,2436,8,1766,10,670,212402.153093,0.554361999995308,25485.152301419606,9668.772390685808
"10.0.2.109",52652,"5.101.114.217",80,7,1808,4,336,3,1472,212402.387029,0.3202349999919534,8393.83577706229,36772.99483284431
"10.0.2.109",52653,"46.38.51.49",6107,9,506,5,286,4,220,213002.834212,0.12236100001609884,18698.768395967436,14383.667996898028
"10.0.2.109",52654,"46.38.51.49",6107,15,1179,7,616,8,563,213471.587756,0.373011999996379,13211.371216067682,12074.678562737183
"10.0.2.109",52655,"80.78.242.47",80,10,875,5,391,5,484,213471.83348,0.12731300000450574,24569.368406127393,30413.233525743373
"10.0.2.109",52656,"46.38.51.49",6107,18,1672,8,1000,10,672,213472.14785,0.5250539999979082,15236.52805241341,10238.946851221812
"10.0.2.109",52657,"217.23.10.139",80,7,1044,4,338,3,706,213472.392754,0.2800090000091586,9656.832458640818,20170.78022426159
"10.0.2.109",52658,"46.38.51.49",6107,19,2735,9,2060,10,675,213472.736552,0.6053309999988414,27224.774544887907,8920.739231941427
"10.0.2.109",52659,"37.187.78.159",80,9,2161,5,395,4,1766,213472.988827,0.35286499999347143,8955.266178449167,40037.97486364868
"10.0.2.109",52660,"31.28.27.51",80,11,941,6,475,5,466,214021.953977,1620.0084609999903,2.345666761304664,2.3012225489852067
"10.0.2.109",52661,"46.38.51.49",6107,18,2436,8,1766,10,670,214022.224006,0.5615110000071581,25160.68251524885,9545.672301934728
"10.0.2.109",52662,"5.101.114.217",80,7,1808,4,336,3,1472,214022.461151,0.32413399999495596,8292.866530638037,36330.65337231902
"10.0.2.109",52663,"46.38.51.49",6107,9,506,5,286,4,220,214622.912558,0.12198199998238124,18756.86576978958,14428.358284453525
"10.0.2.109",52664,"46.38.51.49",6107,9,506,5,286,4,220,215223.161674,0.12194000001181848,18763.326224194243,14433.327864764802
"10.0.2.109",52665,"46.38.51.49",6107,15,1179,7,616,8,563,215575.909747,0.37422900000819936,13168.407579027888,12035.411472390748
"10.0.2.109",52666,"80.78.242.47",80,10,875,5,391,5,484,215576.156459,0.12728800001787022,24574.193950418372,30419.206833765966
"10.0.2.109",52667,"46.38.51.49",6107,18,1672,8,1000,10,672,215576.471161,0.5263500000000931,15199.012064213137,10213.736107151228
"10.0.2.109",52668,"217.23.10.139",80,7,1044,4,338,3,706,215576.715959,0.2813000000023749,9612.513330882231,20078.20831835164
"10.0.2.109",52669,"46.38.51.49",6107,19,2739,9,2064,10,675,215577.059452,0.6042569999990519,27326.12117033962,8936.594859486067
"10.0.2.109",52670,"37.187.78.159",80,9,2165,5,395,4,1770,215577.311747,0.3517649999994319,8983.270080892367,40254.1469447582
"10.0.2.109",52671,"31.28.27.51",80,17,1925,8,814,9,1111,215641.962634,1620.411770000006,4.018731609188432,5.485025574703131
"10.0.2.109",52672,"46.38.51.49",6107,18,2436,8,1766,10,670,215642.5714,0.5597730000154115,25238.80215660818,9575.309991465165
"10.0.2.109",52673,"5.101.114.217",80,7,1808,4,336,3,1472,215642.807225,0.32376400000066496,8302.343682418303,36372.17232297542
"10.0.2.109",52674,"46.38.51.49",6107,9,506,5,286,4,220,216243.258438,0.12271200001123361,18645.283263173496,14342.525587056536
"10.0.2.109",52675,"46.38.51.49",6107,9,506,5,286,4,220,216843.507427,0.12176000000908971,18791.06438755909,14454.664913506991
"10.0.2.109",52676,"31.28.27.51",80,11,941,6,475,5,466,217262.374793,1620.0064669999992,2.345669648490361,2.3012253814663333
"10.0.2.109",52677,"46.38.51.49",6107,18,2436,8,1766,10,670,217262.638303,0.5529099999985192,25552.079000267382,9694.163607122959
"10.0.2.109",52678,"5.101.114.217",80,7,1808,4,336,3,1472,217262.871723,0.3191710000101011,8421.817771398186,36895.582617553955
"10.0.2.109",52679,"46.38.51.49",6107,9,506,5,286,4,220,217863.3179,0.12172200001077726,18796.93070930005,14459.177468692345
"10.0.2.109",52680,"46.38.51.49",6107,9,506,5,286,4,220,218463.514103,0.1214719999989029,18835.616438526282,14488.935721943293
"10.0.2.109",52681,"46.38.51.49",6107,15,1179,7,616,8,563,218498.03411,0.3974049999960698,12400.44790591144,11333.52625166906
"10.0.2.109",52682,"80.78.242.47",80,10,875,5,391,5,484,218498.293561,0.1378100000147242,22697.917420113135,28096.654811597844
"10.0.2.109",52683,"46.38.51.49",6107,18,1672,8,1000,10,672,218498.618238,0.5509529999981169,14520.294834636246,9757.638128875557
"10.0.2.109",52684,"217.23.10.139",80,7,1044,4,338,3,706,218498.874127,0.2949310000112746,9168.24613179568,19150.241920259617
"10.0.2.109",52685,"46.38.51.49",6107,19,2739,9,2064,10,675,218499.232703,0.622923000017181,26507.289022149733,8668.808183115829
"10.0.2.109",52686,"37.187.78.159",80,9,2165,5,395,4,1770,218499.494589,0.3607929999998305,8758.484782136806,39246.881175651004
"10.0.2.109",52687,"31.28.27.51",80,17,1925,8,814,9,1111,218882.381454,1620.4503640000185,4.01863589571814,5.484894938750434
"10.0.2.109",52688,"46.38.51.49",6107,18,2436,8,1766,10,670,218883.055459,0.5838010000006761,24200.027063988648,9181.210720765795
"10.0.2.109",52689,"5.101.114.217",80,7,1808,4,336,3,1472,218883.293782,0.3452720000059344,7785.166477310062,34106.44361488218
"10.0.2.109",52690,"46.38.51.49",6107,9,506,5,286,4,220,219483.767184,0.12346400000387803,18531.71774710145,14255.167497770346
"10.0.2.109",52691,"46.38.51.49",6107,9,506,5,286,4,220,220084.018306,0.12133799999719486,18856.417610747623,14504.936623652016
"10.0.2.109",52692,"31.28.27.51",80,11,941,6,475,5,466,220502.831949,1620.00912599999,2.3456657984283624,2.3012216043528775
"10.0.2.109",52693,"46.38.51.49",6107,18,2436,8,1766,10,670,220503.096215,0.5532130000065081,25538.08388420698,9688.85402175463
"10.0.2.109",52694,"5.101.114.217",80,7,1808,4,336,3,1472,220503.330174,0.3191170000063721,8423.242885669915,36901.82597531582
"10.0.2.109",52695,"46.38.51.49",6107,9,506,5,286,4,220,221103.77696,0.12141400002292357,18844.6142913339,14495.857147179922
"10.0.2.109",52696,"46.38.51.49",6107,15,1179,7,616,8,563,221544.541056,0.3725760000234004,13226.831571788001,12088.808725514034
"10.0.2.109",52697,"80.78.242.47",80,10,875,5,391,5,484,221544.786972,0.12659999998868443,24707.74091848011,30584.518170190215
"10.0.2.109",52698,"46.38.51.49",6107,18,1672,8,1000,10,672,221545.100471,0.5262179999845102,15202.82468527395,10216.298188504095
"10.0.2.109",52699,"217.23.10.139",80,7,1044,4,338,3,706,221545.346178,0.2803189999831375,9646.153133261243,20148.47370438591
"10.0.2.109",52700,"46.38.51.49",6107,19,2739,9,2064,10,675,221545.689826,0.6007150000077672,27487.24436677376,8989.28776529665
"10.0.2.109",52701,"37.187.78.159",80,9,2165,5,395,4,1770,221545.942126,0.348173999984283,9075.921809620035,40669.320513993574
"10.0.2.109",52702,"31.28.27.51",80,17,1925,8,814,9,1111,222122.841245,1620.6310940000112,4.018187744335575,5.48428327267423
"10.0.2.109",52703,"46.38.51.49",6107,18,2436,8,1766,10,670,222123.6722,0.5546819999872241,25470.449735750226,9663.194407107958
"10.0.2.109",52704,"5.101.114.217",80,7,1808,4,336,3,1472,222123.906,0.3207410000031814,8380.593687658697,36714.98186974286
"10.0.2.109",52705,"46.38.51.49",6107,9,506,5,286,4,220,222724.353957,0.12144099999568425,18840.42456897844,14492.634283829568
"10.0.2.109",52706,"46.38.51.49",6107,9,506,5,286,4,220,223324.603038,0.1218010000011418,18784.739041375287,14449.799262596376
"10.0.2.109",52707,"46.38.51.49",6107,15,1179,7,616,8,563,223501.328662,0.3721009999862872,13243.716088324429,12104.240515790021
"10.0.2.109",52708,"80.78.242.47",80,10,875,5,391,5,484,223501.573552,0.12722500000381842,24586.362742433634,30434.269993191505
"10.0.2.109",52709,"46.38.51.49",6107,18,1672,8,1000,10,672,223501.888286,0.5249320000002626,15240.069189906497,10241.326495617166
"10.0.2.109",52710,"217.23.10.139",80,7,1044,4,338,3,706,223502.133058,0.2799249999807216,9659.730285563004,20176.83308167894
"10.0.2.109",52711,"46.38.51.49",6107,19,2739,9,2064,10,675,223502.476289,0.6000109999731649,27519.49547714707,8999.835003427457
"10.0.2.109",52712,"37.187.78.159",80,9,2165,5,395,4,1770,223502.72663,0.3494710000231862,9042.238125024236,40518.38349694404
"10.0.2.109",52713,"31.28.27.51",80,11,941,6,475,5,466,223743.472755,1620.0091830000165,2.3456657158961063,2.3012215233843905
"10.0.2.109",52714,"46.38.51.49",6107,18,2436,8,1766,10,670,223743.74818,0.5695830000040587,24804.111077576625,9410.393217427145
"10.0.2.109",52715,"5.101.114.217",80,7,1808,4,336,3,1472,223743.985754,0.33183999999891967,8100.2892960726585,35486.9816780326
"10.0.2.109",52716,"46.38.51.49",6107,9,506,5,286,4,220,224344.441813,0.1211159999947995,18890.98054838537,14531.523498757979
"10.0.2.109",52717,"46.38.51.49",6107,9,506,5,286,4,220,224944.690003,0.12216900000930764,18728.155258909257,14406.273276084044
"10.0.2.109",52718,"31.28.27.51",80,11,941,6,475,5,466,225363.482324,1620.0073499999999,2.345668369961408,2.3012241271621394
"10.0.2.109",52719,"46.38.51.49",6107,18,2436,8,1766,10,670,225363.770387,0.5735330000170507,24633.281780786783,9345.582555564635
"10.0.2.109",52720,"5.101.114.217",80,7,1808,4,336,3,1472,225364.010584,0.3331410000100732,8068.655614045473,35348.39602343731
"10.0.2.109",52721,"46.38.51.49",6107,15,1179,7,616,8,563,225364.427592,0.3733510000165552,13199.375386115162,12063.714841530578
"10.0.2.109",52722,"80.78.242.47",80,10,875,5,391,5,484,225364.672873,0.12796199999866076,24444.75703750127,30258.983135935076
"10.0.2.109",52723,"46.38.51.49",6107,18,1672,8,1000,10,672,225364.98781,0.5260940000007395,15206.407980301534,10218.706162762632
"10.0.2.109",52724,"217.23.10.139",80,7,1044,4,338,3,706,225365.233314,0.28040299998247065,9643.263446429033,20142.43784964171
"10.0.2.109",52725,"46.38.51.49",6107,19,2735,9,2060,10,675,225365.576202,0.6000240000139456,27465.56804330656,8999.640014190256
"10.0.2.109",52726,"37.187.78.159",80,9,2161,5,395,4,1766,225365.82647,0.3494490000011865,9042.807391033515,40429.361652063766
"10.0.2.109",52727,"46.38.51.49",6107,9,506,5,286,4,220,225966.303144,0.12170299998251721,18799.865248421764,14461.43480647828
"10.0.2.109",52728,"46.38.51.49",6107,9,506,5,286,4,220,226566.551981,0.12172100000316277,18797.08513683382,14459.296259102937
"10.0.2.109",52729,"31.28.27.51",80,17,1925,8,814,9,1111,226983.489928,1620.6395150000171,4.018166865442579,5.484254775806763
"10.0.2.109",52730,"46.38.51.49",6107,18,2436,8,1766,10,670,226984.343152,0.5612050000054296,25174.401510790733,9550.877130367944
"10.0.2.109",52731,"5.101.114.217",80,7,1808,4,336,3,1472,226984.580006,0.32411399998818524,8293.3782561012,36332.89521720526
"10.0.2.109",52732,"46.38.51.49",6107,9,506,5,286,4,220,227585.031287,0.12181700000655837,18782.271767297003,14447.901359459232
"10.0.2.109",52733,"46.38.51.49",6107,9,506,5,286,4,220,228185.280363,0.12323200001264922,18566.606074438027,14282.004672644636
"10.0.2.109",52734,"31.28.27.51",80,11,941,6,475,5,466,228604.129671,1620.0088040000119,2.345666264663073,2.301222061753667
"10.0.2.109",52735,"46.38.51.49",6107,18,2436,8,1766,10,670,228604.397329,0.5644160000083502,25031.182673402214,9496.541557859277
"10.0.2.109",52736,"5.101.114.217",80,7,1808,4,336,3,1472,228604.634448,0.3270839999895543,8218.072422025669,36002.98394411245
"10.0.2.109",52737,"46.38.51.49",6107,9,506,5,286,4,220,229205.088937,0.12384700000984594,18474.407937359018,14211.083028737705
"10.0.2.109",52738,"46.38.51.49",6107,9,506,5,286,4,220,229805.339965,0.12154700001701713,18823.994007911915,14479.995390701475
"10.0.2.109",52739,"31.28.27.51",80,17,1925,8,814,9,1111,230224.138619,1621.022087999998,4.017218548844356,5.482960451801081
"10.0.2.109",52740,"46.38.51.49",6107,18,2436,8,1766,10,670,230225.366829,0.565824999997858,24968.85079318426,9472.8935625331
"10.0.2.109",52741,"5.101.114.217",80,7,1808,4,336,3,1472,230225.604746,0.3275969999958761,8205.20334445626,35946.60512809409
"10.0.2.109",52742,"46.38.51.49",6107,9,506,5,286,4,220,230826.024124,0.12131000001681969,18860.769925667857,14508.284558206044
"10.0.2.109",52743,"46.38.51.49",6107,9,506,5,286,4,220,231426.273031,0.1218300000182353,18780.26758316947,14446.359679361129
"10.0.2.109",52744,"31.28.27.51",80,11,941,6,475,5,466,231845.161108,1620.0077600000077,2.345667776307431,2.3012235447563425
"10.0.2.109",52745,"46.38.51.49",6107,18,2436,8,1766,10,670,231845.429973,0.5734140000131447,24638.393899828283,9347.52203447619
"10.0.2.109",52746,"5.101.114.217",80,7,1808,4,336,3,1472,231845.671691,0.33155500001157634,8107.252190152909,35517.48578543179
"10.0.2.109",52747,"46.38.51.49",6107,9,506,5,286,4,220,232446.130727,0.12209599997731857,18739.3526440263,14414.886649251
"10.0.2.109",52748,"46.38.51.49",6107,9,506,5,286,4,220,233046.379622,0.1213409999909345,18855.95141107242,14504.578008517246
"10.0.2.109",52749,"46.38.51.49",6107,15,1179,7,616,8,563,233390.179806,0.37265500001376495,13224.027585348304,12086.245991154374
"10.0.2.109",52750,"80.78.242.47",80,10,875,5,391,5,484,233390.425073,0.12740100000519305,24552.397546899145,30392.22611943526
"10.0.2.109",52751,"46.38.51.49",6107,18,1672,8,1000,10,672,233390.739476,0.5283700000145473,15140.905047182356,10174.688191706544
"10.0.2.109",52752,"217.23.10.139",80,7,1044,4,338,3,706,233390.985369,0.2822699999960605,9579.4806392381,20009.21103935532
"10.0.2.109",52753,"46.38.51.49",6107,19,2735,9,2060,10,675,233391.329768,0.6023449999920558,27359.735700001413,8964.961940534444
"10.0.2.109",52754,"37.187.78.159",80,9,2161,5,395,4,1766,233391.580584,0.35125999999581836,8996.185162095368,40220.91897787448
"10.0.2.109",52755,"31.28.27.51",80,17,1925,8,814,9,1111,233465.169135,1620.4306900000083,4.01868468684703,5.484961532047973
"10.0.2.109",52756,"46.38.51.49",6107,18,2436,8,1766,10,670,233465.810793,0.5737260000023525,24624.995206670203,9342.438725067404
"10.0.2.109",52757,"5.101.114.217",80,7,1808,4,336,3,1472,233466.050881,0.33334300000569783,8063.7661506437935,35326.97551710614
"10.0.2.109",52758,"46.38.51.49",6107,9,506,5,286,4,220,234066.511022,0.121796000021277,18785.510194097515,14450.392456998088
"10.0.2.109",52759,"46.38.51.49",6107,9,506,5,286,4,220,234666.75998,0.12116899999091402,18882.717528176086,14525.167329366219
"10.0.2.109",52760,"31.28.27.51",80,11,941,6,475,5,466,235085.6003,1620.0065150000155,2.3456695789892943,2.3012253132821288
"10.0.2.109",52761,"46.38.51.49",6107,18,2436,8,1766,10,670,235085.863369,0.5665349999908358,24937.559021470046,9461.021825812531
"10.0.2.109",52762,"5.101.114.217",80,7,1808,4,336,3,1472,235086.101632,0.32793599998694845,8196.721311801632,35909.44574694048
"10.0.2.109",52763,"46.38.51.49",6107,9,506,5,286,4,220,235686.556678,0.12160800001583993,18814.551671781286,14472.732055216375
"10.0.2.109",52764,"46.38.51.49",6107,2869,2897392,2077,2841605,792,55787,236214.821197,679.4171439999773,33459.326425240695,656.88068654331
"10.0.2.109",52765,"65.182.219.217",80,8,1129,5,551,3,578,236214.981403,0.5968789999897126,7385.081398534667,7746.963790114405
"10.0.2.109",52766,"23.206.102.19",80,16,10680,7,663,9,10017,236215.615938,1.6430560000007972,3228.1309949249608,48772.53118576672
"10.0.2.109",52767,"23.63.92.101",80,115,119137,26,2100,89,117037,236217.295752,15.74486999999499,1067.0142084377544,59466.734244252126
"10.0.2.109",52768,"46.38.51.49",6107,21,9205,12,8009,9,1196,236224.009185,118.75281800000812,539.5408806214234,80.57071959336027
"10.0.2.109",52769,"46.38.51.49",6107,42,23726,24,21231,18,2495,236224.069557,127.70019899998442,1330.052743300899,156.30359354414503
"10.0.2.109",52770,"46.38.51.49",6107,139,126592,96,122761,43,3831,236224.163185,126.61116299999412,7756.725210714995,242.0639639808176
"10.0.2.109",52771,"23.63.92.101",80,17,8944,8,1109,9,7835,236224.183436,118.5782659999968,74.8197818983138,528.5960245025145
"10.0.2.109",52772,"23.63.92.101",80,19,11878,8,1110,11,10768,236224.194537,8.912893000000622,996.3095035472074,9665.099760537234
"10.0.2.109",52773,"46.38.51.49",6107,56,40589,36,38544,20,2045,236224.26368,126.50765099999262,2437.417796968011,129.32024166665585
"10.0.2.109",52774,"23.63.92.101",80,12,6631,6,625,6,6006,236224.309651,0.43373700001393445,11527.723020723082,110776.80713994053
"10.0.2.109",52775,"46.38.51.49",6107,83,70150,56,67471,27,2679,236224.363582,125.40328399999999,4304.257295207676,170.9046152252281
"10.0.2.109",52776,"46.38.51.49",6107,14,3043,8,2381,6,662,236224.463887,119.30669200001284,159.65575510213583,44.3897983526308
"10.0.2.109",52777,"23.63.92.101",80,73,68558,20,1749,53,66809,236224.507725,8.53728499999852,1638.9285352430459,62604.44626132227
"10.0.2.109",52778,"46.38.51.49",6107,75,59540,51,57064,24,2476,236224.563588,128.20838399999775,3560.7031752307867,154.4984764802928
"10.0.2.109",52779,"23.63.92.101",80,21,15503,9,788,12,14715,236224.653906,8.401704000018071,750.3239818953917,14011.443392881587
"10.0.2.109",52780,"46.38.51.49",6107,14,2830,8,2166,6,664,236224.664308,117.09659800000372,147.98038795285453,45.36425558665531
"10.0.2.109",52781,"46.38.51.49",6107,16,5311,9,4593,7,718,236224.764309,117.99668999999994,311.39856550213415,48.67933159819994
"10.0.2.109",52782,"23.45.236.253",80,12,5685,6,651,6,5034,236224.780246,0.9746649999869987,5343.374390246362,41318.81210522302
"10.0.2.109",52783,"23.63.92.101",80,9,2515,5,577,4,1938,236224.844885,116.9154489999928,39.48152309623585,132.60865123137793
"10.0.2.109",52784,"46.38.51.49",6107,39,22737,23,20488,16,2249,236224.864697,125.90752799998154,1301.780779938941,142.89852470141926
"10.0.2.109",52785,"46.38.51.49",6107,15,2686,9,2032,6,654,236224.964547,119.80498499999521,135.68717528741104,43.67097078640099
"10.0.2.109",52786,"23.63.92.101",80,36,30890,11,1272,25,29618,236224.993719,8.057135000010021,1262.9799550320733,29407.971940361593
"10.0.2.109",52787,"46.38.51.49",6107,17,5842,10,5096,7,746,236225.064413,119.70487300000968,340.57093064203576,49.85594863794323
"10.0.2.109",52788,"23.63.92.101",80,11,4996,6,631,5,4365,236225.153611,117.60682800001814,42.922677924781894,296.9215358822076
"10.0.2.109",52789,"46.38.51.49",6107,16,4808,9,4095,7,713,236225.165136,118.60483299999032,276.2113412360074,48.092475287246224
"10.0.2.109",52790,"46.38.51.49",6107,14,2840,8,2153,6,687,236225.264804,116.49613699998008,147.85039610371754,47.177530015445406
"10.0.2.109",52791,"23.63.92.101",80,29,19798,11,1640,18,18158,236225.274247,8.986761000007391,1459.9253279339698,16164.222015015257
"10.0.2.109",52792,"46.38.51.49",6107,14,2754,8,2066,6,688,236225.364761,117.39650499998243,140.78783691220173,46.88384888460541
"10.0.2.109",52793,"23.63.92.101",80,9,2525,5,600,4,1925,236225.392343,116.36810100000002,41.24841738201089,132.33867243395161
"10.0.2.109",52794,"46.38.51.49",6107,14,2838,8,2150,6,688,236225.465362,119.30315100000007,144.17054248634213,46.134573595629476
"10.0.2.109",52795,"23.63.92.101",80,9,2439,5,601,4,1838,236225.488946,117.27182699998957,40.9987643494326,125.38390827663414
"10.0.2.109",52796,"46.38.51.49",6107,14,2865,8,2176,6,689,236225.565228,118.20433400000911,147.2704038076866,46.631115911533115
"10.0.2.109",52797,"46.38.51.49",6107,14,2874,8,2184,6,690,236225.665831,119.1010360000073,146.69897581746417,46.347203898374666
"10.0.2.109",52798,"23.63.92.101",80,9,2550,5,602,4,1948,236225.689953,118.07832699999562,40.78648573671084,131.98018972610086
"10.0.2.109",52799,"46.38.51.49",6107,13,2838,7,2147,6,691,236225.765748,120.00029900000663,143.1329766936585,46.06655188417234
"10.0.2.109",52800,"23.63.92.101",80,113,113208,31,2010,82,111198,236225.776697,9.167795000015758,1753.9659209190827,97033.58332057719
"10.0.2.109",52801,"23.63.92.101",80,10,2613,6,657,4,1956,236225.790945,118.97550700002466,44.17715992585693,131.52286882035943
"10.0.2.109",52802,"46.38.51.49",6107,14,2775,8,2087,6,688,236225.865528,117.90151799999876,141.6097119292406,46.68302913623265
"10.0.2.109",52803,"46.38.51.49",6107,15,2909,9,2220,6,689,236225.966229,120.79925299997558,147.02077669307766,45.62942123492365
"10.0.2.109",52804,"46.38.51.49",6107,14,2883,8,2194,6,689,236226.066078,118.69849599999725,147.87044984967972,46.43698265561956
"10.0.2.109",52805,"23.63.92.101",80,11,4493,6,626,5,3867,236226.090424,117.67813000001479,42.55676054675045,262.8865703423067
"10.0.2.109",52806,"46.38.51.49",6107,14,2899,8,2211,6,688,236226.166671,117.6007549999922,150.40719764087547,46.8024206137143
"10.0.2.109",52807,"23.63.92.101",80,9,2460,5,601,4,1859,236226.254368,117.51196900001378,40.9149811794868,126.55732115252239
"10.0.2.109",52808,"46.38.51.49",6107,14,2884,8,2192,6,692,236226.266828,119.49949400001788,146.74539123987736,46.32655599361092
"10.0.2.109",52809,"23.63.92.101",80,10,2638,6,655,4,1983,236226.290269,117.47625600002357,44.60475825854502,135.0400543919004
"10.0.2.109",52810,"46.38.51.49",6107,14,2873,8,2185,6,688,236226.366929,117.39847799998824,148.89460491985042,46.883060954168
"10.0.2.109",52811,"23.63.92.101",80,9,2728,5,575,4,2153,236226.391938,117.3772830000089,39.18986606632947,146.74048981009975
"10.0.2.109",52812,"46.38.51.49",6107,14,2898,8,2209,6,689,236226.466489,118.29878899999312,149.38445396935575,46.59388356038303
"10.0.2.109",52813,"23.63.92.101",80,10,2612,6,655,4,1957,236226.491786,117.27284200000577,44.682126830351244,133.5006445908357
"10.0.2.109",52814,"46.38.51.49",6107,13,2408,7,1722,6,686,236226.566651,117.19759900000645,117.54507018526243,46.826897878681784
"10.0.2.109",52815,"23.63.92.101",80,9,2569,5,605,4,1964,236226.657641,119.10791799999424,40.63541770581729,131.91398408962837
"10.0.2.109",52816,"46.38.51.49",6107,14,2603,8,1917,6,686,236226.666915,117.09903199999826,130.96606981345693,46.866313976020585
"10.0.2.109",52817,"46.38.51.49",6107,14,2739,8,2050,6,689,236226.767181,116.9965979999979,140.17501602910107,47.11248099709787
"10.0.2.109",52818,"23.63.92.101",80,9,2288,5,599,4,1689,236226.800133,116.96468499998446,40.96963113268451,115.52204838581659
"10.0.2.109",52819,"46.38.51.49",6107,29,11468,14,9465,15,2003,236226.867704,120.89901799999643,626.3078166606964,132.54036521620444
"10.0.2.109",52820,"46.38.51.49",6107,40,12633,19,9963,21,2670,236226.968052,150.13713899999857,530.874642549308,142.26992829535806
"10.0.2.109",52821,"46.38.51.49",6107,14,2818,8,2127,6,691,236227.100254,117.66579300002195,144.61297175804378,46.98051879868747
"10.0.2.109",52822,"23.63.92.101",80,9,2424,5,602,4,1822,236227.161828,116.6008219999785,41.30331088061187,125.00769505726716
"10.0.2.109",52823,"46.38.51.49",6107,13,3134,7,2315,6,819,236227.198054,117.56683699999121,157.5274156606032,55.730001479928305
"10.0.2.109",52824,"23.63.92.101",80,9,2583,5,602,4,1981,236227.39669,117.3676470000064,41.033454474892366,135.02869321389
"10.0.2.109",52825,"46.38.51.49",6107,223,199419,155,189338,68,10081,236227.423519,149.89298599999165,10105.2360115108,538.0371834076645
"10.0.2.109",52826,"23.63.92.101",80,9,2568,5,602,4,1966,236227.454741,117.30900700000348,41.05396612895937,134.07325151085402
"10.0.2.109",52827,"23.63.92.101",80,9,2523,5,601,4,1922,236227.465793,117.30236599998898,40.988090555653855,131.08004999661682
"10.0.2.109",52828,"23.63.92.101",80,8,2093,5,599,3,1494,236227.494859,116.26821499998914,41.215047465899836,102.79679618373015
"10.0.2.109",52829,"23.206.102.19",80,9,2873,5,732,4,2141,236227.589674,117.17420700000366,49.976869056172205,146.1755145481758
"10.0.2.109",52830,"173.194.122.31",443,41,12464,19,2370,22,10094,236227.923335,149.18182600001455,127.09322917121386,541.2991794321657
"10.0.2.109",52831,"23.63.92.101",80,12,5527,6,659,6,4868,236228.066586,116.7021090000053,45.174847697051995,333.70433776820806
"10.0.2.109",52832,"23.63.29.170",443,26,11083,12,1649,14,9434,236228.301511,119.46502400000463,110.42562549520342,631.7497579877192
"10.0.2.109",52833,"23.63.92.101",80,9,2309,5,567,4,1742,236228.358641,116.41024399999878,38.965642920566744,119.7145502074555
"10.0.2.109",52834,"23.63.92.101",80,9,2503,5,604,4,1899,236229.026821,115.73883799999021,41.74916634293847,131.2610378894705
"10.0.2.109",52835,"23.63.92.101",80,9,2532,5,602,4,1930,236229.090456,117.67472399998223,40.92637599898452,131.2091456445849
"10.0.2.109",52836,"46.38.51.49",6107,41,16142,19,10609,22,5533,236229.426201,154.3470030000026,549.8778618979636,286.782374387919
"10.0.2.109",52837,"23.63.92.101",80,9,2577,5,604,4,1973,236229.919908,115.845513999986,41.71072174620922,136.25042053852778
"10.0.2.109",52838,"23.37.43.27",80,16,5428,8,1361,8,4067,236230.594191,5.5484379999979865,1962.3540895660997,5863.9927129061925
"10.0.2.109",52839,"93.184.221.48",80,16,9977,7,647,9,9330,236233.043992,1.2088130000047386,4281.886445612109,61746.52324197987
"10.0.2.109",52840,"31.13.74.1",80,11,1580,6,818,5,762,236233.047695,66.23802100002649,98.79522215794132,92.03173506644411
"10.0.2.109",52841,"199.96.57.6",80,36,28426,12,1096,24,27330,236233.053186,13.312440000008792,658.6320764633838,16423.735994292227
"10.0.2.109",52842,"173.194.122.30",80,26,21760,9,773,17,20987,236233.08694,1.1687119999842253,5291.29503255162,143659.00239089373
"10.0.2.109",52843,"23.206.102.19",80,13,7408,6,780,7,6628,236233.144522,1.1193090000015218,5574.868065915235,47372.08402677716
"10.0.2.109",52844,"173.194.122.2",80,26,19880,10,1689,16,18191,236234.284042,1.7102729999751318,7900.493079289956,85090.5089433769
"10.0.2.109",52845,"23.63.68.90",80,9,3236,5,560,4,2676,236234.293299,116.47772899997653,38.46228835729535,183.79479222164704
"10.0.2.109",52846,"173.194.122.25",80,11,4395,6,618,5,3777,236234.295175,117.47424399998272,42.08582095664074,257.21382807966353
"10.0.2.109",52847,"172.227.135.79",80,12,2977,6,601,6,2376,236234.303402,99.40094200000749,48.36976293443615,191.22555196708868
"10.0.2.109",52848,"46.38.51.49",6107,54,16487,24,13010,30,3477,236234.761163,184.0637160000042,565.4563662074366,151.12158226773693
"10.0.2.109",52849,"173.194.122.3",443,213,198648,52,9025,161,189623,236234.857628,142.45883099999628,506.813087635135,10648.578184668942
"10.0.2.109",52850,"23.63.68.90",80,8,1273,5,696,3,577,236234.993064,115.78094499997678,48.090814943694895,39.86839112429878
"10.0.2.109",52851,"31.13.74.1",443,53,16208,24,2959,29,13249,236235.153996,183.67086299997754,128.88271777763083,577.0757444527985
"10.0.2.109",52852,"46.38.51.49",6107,32,7537,14,5331,18,2206,236235.911223,138.25187000000733,308.48045672002655,127.65107625668328
"10.0.2.109",52853,"173.194.122.25",80,8,1769,5,824,3,945,236236.024807,0.2708869999914896,24334.870260319247,27908.316014565156
"10.0.2.109",52854,"74.125.136.154",443,35,7460,17,1944,18,5516,236236.06598,138.09709599998314,112.61641591653671,319.54328713766284
"10.0.2.109",52855,"93.184.220.29",80,24,5867,13,2616,11,3251,236236.19744,4.067242000019178,5145.501546232391,6394.505170795681
"10.0.2.109",52856,"173.194.122.19",80,8,1753,5,771,3,982,236236.326501,0.5322089999972377,11589.431971334596,14761.118282555866
"10.0.2.109",52857,"173.194.122.24",80,8,1240,5,695,3,545,236236.889994,8.191720000002533,678.7341364204685,532.2447544592163
"10.0.2.109",52858,"46.38.51.49",6107,27,7325,13,5000,14,2325,236237.419315,119.35359499999322,335.13862737022936,155.83946172715667
"10.0.2.109",52859,"199.16.156.120",443,23,6870,12,2009,11,4861,236237.542849,119.23001300002215,134.79827432373938,326.1594880476342
"10.0.2.109",52860,"46.38.51.49",6107,278,267342,201,261403,77,5939,236238.111031,186.71418599999743,11200.13452004139,254.4637931260384
"10.0.2.109",52861,"46.38.51.49",6107,43,9429,19,6542,24,2887,236238.17188,185.65299800000503,281.9022615514056,124.40413162624702
"10.0.2.109",52862,"195.113.232.88",443,287,267562,69,5272,218,262290,236239.088549,185.73659399998724,227.0742619518634,11297.28910609906
"10.0.2.109",52863,"46.38.51.49",6107,38,8139,19,5716,19,2423,236239.155692,138.17000400001416,330.9546115377931,140.29094187475027
"10.0.2.109",52864,"216.58.209.205",443,36,7800,17,2115,19,5685,236239.311254,138.01433800000814,122.59595810979438,329.5309796000856
"10.0.2.109",52865,"173.194.122.4",80,14,3266,8,1374,6,1892,236240.300456,27.647251999995206,397.58020073755995,547.4685151349806
"10.0.2.109",52866,"195.113.232.88",443,42,9128,21,2517,21,6611,236241.56701,182.2576340000087,110.48096893433303,290.18263234997045
"10.0.2.109",52867,"46.38.51.49",6107,54,31566,31,29123,23,2443,236242.103174,137.0023210000072,1700.5843280566592,142.65451750995496
"10.0.2.109",52868,"173.194.122.11",443,56,31427,21,2119,35,29308,236242.256079,136.8490939999756,123.87367358093744,1713.3032681973168
"10.0.2.109",52869,"95.100.72.163",80,9,2660,5,942,4,1718,236245.120234,24.225328000000445,311.07937939993474,567.340099585019
"10.0.2.109",52870,"46.38.51.49",6107,26,8043,12,5931,14,2112,236266.761852,7.996595000004163,5933.52545676945,2112.8993027646397
"10.0.2.109",52871,"63.245.217.44",443,21,7548,11,1756,10,5792,236266.906955,7.851279999973485,1789.26238779504,5901.712841747649
"10.0.2.109",52872,"23.37.43.27",80,14,2936,7,835,7,2101,236267.994654,37.7089289999858,177.14637294531795,445.7299755186982
"10.0.2.109",52873,"63.245.215.110",80,8,1384,5,809,3,575,236269.36763,0.6305670000147074,10263.778472151327,7295.021781813366
"10.0.2.109",52874,"195.113.232.88",80,2303,2531437,401,24761,1902,2506676,236270.060959,537.8355370000063,368.3058971984547,37285.390459425456
"10.0.2.109",52875,"46.38.51.49",6107,23,8190,11,4911,12,3279,236386.8244,14.326224999997066,2742.3832865955997,1831.047606749536
"10.0.2.109",52876,"46.38.51.49",6107,24,6124,11,3905,13,2219,236386.884251,2.535054999985732,12323.20403311795,7002.609410880597
"10.0.2.109",52877,"63.245.217.161",443,24,7983,12,3049,12,4934,236386.969444,14.18107200000668,1720.0392184729412,2783.4285024419455
"10.0.2.109",52878,"63.245.216.134",443,19,5607,10,1841,9,3766,236387.02798,2.3911349999834783,6159.418017009397,12599.874118445077
"10.0.2.109",52879,"46.38.51.49",6107,15,2873,7,1471,8,1402,236388.194668,119.63639400000102,98.36471667643126,93.75073608453883
"10.0.2.109",52880,"46.38.51.49",6107,12,1941,6,1128,6,813,236388.304771,116.520531999995,77.44557843248079,55.818488710644395
"10.0.2.109",52881,"93.184.220.29",80,17,2939,9,1426,8,1513,236388.337941,19.423571999999695,587.3276038001753,623.1603538216447
"10.0.2.109",52882,"93.184.220.29",80,13,1953,7,837,6,1116,236388.694626,15.02991299997666,445.51156084605407,594.0154144614054
"10.0.2.109",52883,"46.38.51.49",6107,43,22804,23,20802,20,2002,236389.511426,118.31717100000242,1406.5245018408748,135.36496743993035
"10.0.2.109",52884,"68.232.34.191",443,34,22081,13,1418,21,20663,236390.688196,117.14018899999792,96.84123012641034,1411.16384915516
"10.0.2.109",52885,"46.38.51.49",6107,25,4406,12,2486,13,1920,236392.89057,2.2320030000119004,8910.382288865187,6881.711180459034
"10.0.2.109",52886,"63.245.216.134",443,18,3781,9,1488,9,2293,236393.033819,2.0886220000102185,5699.451600118049,8782.824273569011
"10.0.2.109",52887,"46.38.51.49",6107,26,7321,12,5075,14,2246,236506.830044,3.211684999987483,12641.33935929527,5594.571074084173
"10.0.2.109",52888,"63.245.216.132",443,21,6822,11,1886,10,4936,236506.974095,3.067455999989761,4918.733960666546,12873.208287301206
"10.0.2.109",52889,"46.38.51.49",6107,15,3376,7,1970,8,1406,236508.217242,118.99434799997834,132.44326528855697,94.52549796736604
"10.0.2.109",52890,"93.184.220.29",80,17,3442,9,1430,8,2012,236509.339243,17.39922099999967,657.5007007497759,925.0988880479365
"10.0.2.109",52891,"46.38.51.49",6107,41,27602,23,25131,18,2471,236510.225884,14.045223999972222,14314.332046281186,1407.453522993944
"10.0.2.109",52892,"63.245.217.115",443,46,27623,16,2145,30,25478,236510.349568,13.92152899998473,1232.6232269471852,14640.920548326521
"10.0.2.109",52893,"46.38.51.49",6107,123,93556,71,81546,52,12010,236682.936942,162.37539800000377,4017.652969817416,591.7152547949275
"10.0.2.109",52894,"23.206.102.19",443,111,92675,34,10836,77,81839,236683.097711,162.21438999997918,534.4038836505881,4036.0907561905206
"10.0.2.109",52895,"46.38.51.49",6107,25,8531,13,5918,12,2613,236683.988728,131.60781499999575,359.7354761949473,158.8355524328147
"10.0.2.109",52896,"23.37.43.27",80,16,5463,8,1391,8,4072,236684.152677,10.74359500000719,1035.7799228277456,3032.132168047865
"10.0.2.109",52897,"46.38.51.49",6107,31,10166,15,7726,16,2440,236686.097442,120.28621900000144,513.8410743461748,162.27960411657602
"10.0.2.109",52898,"46.38.51.49",6107,30,11738,15,9720,15,2018,236686.157926,118.22435899998527,657.7324728824259,136.5539228679769
"10.0.2.109",52899,"23.63.29.170",443,25,9619,12,2032,13,7587,236686.256584,120.12688500000513,135.32357889742423,505.2657446332468
"10.0.2.109",52900,"46.38.51.49",6107,120,94088,73,82865,47,11223,236686.258244,159.05624599999283,4167.833811443217,564.4795615257011
"10.0.2.109",52901,"23.63.31.106",443,24,11181,11,1600,13,9581,236686.326228,118.0558510000119,108.42325807298369,649.2520222482855
"10.0.2.109",52902,"46.38.51.49",6107,112,81577,64,70796,48,10781,236686.357853,160.9562230000156,3518.770442320488,535.8475639676985
"10.0.2.109",52903,"23.206.102.19",443,118,93747,36,10427,82,83320,236686.41551,158.89880200001062,524.9630516408452,4194.871148241605
"10.0.2.109",52904,"46.38.51.49",6107,98,70951,56,62130,42,8821,236686.45831,158.85816500001238,3128.8287888756695,444.22016331357287
"10.0.2.109",52905,"23.206.102.19",443,104,80912,33,9769,71,71143,236686.500972,160.81281999999192,485.9811549850561,3539.170571102656
"10.0.2.109",52906,"46.38.51.49",6107,65,38598,34,29465,31,9133,236686.557996,158.75800400000298,1484.7755329551483,460.22246538195725
"10.0.2.109",52907,"46.38.51.49",6107,65,43902,37,37569,28,6333,236686.65884,158.66044300000067,1894.309598013657,319.3234497649788
"10.0.2.109",52908,"23.206.102.19",443,57,43237,20,5699,37,37538,236686.801722,158.51742399999057,287.6150700001453,1894.4542020820238
"10.0.2.109",52909,"23.206.102.19",443,88,70178,28,7863,60,62315,236686.850986,158.46545699998387,396.95717407994096,3145.922205620186
"10.0.2.109",52910,"23.206.102.19",443,62,38203,25,8607,37,29596,236686.950946,158.36501400000998,434.7930029545267,1495.0776943699514
"10.0.2.109",52911,"46.38.51.49",6107,47,24037,26,21791,21,2246,236689.99331,137.546090000018,1267.4151624373849,130.6325755970064
"10.0.2.109",52912,"46.38.51.49",6107,55,28639,30,26175,25,2464,236690.05449,138.68600099999458,1509.8856300572702,142.13402836527655
"10.0.2.109",52913,"173.194.122.13",443,48,23848,19,1926,29,21922,236690.146141,137.39315499999793,112.14532485261171,1276.4536923255212
"10.0.2.109",52914,"173.194.122.30",443,53,28290,21,2038,32,26252,236691.203967,137.53631799999857,118.54323452224574,1526.985766770361
"10.0.2.109",52915,"46.38.51.49",6107,67,42985,43,40557,24,2428,236693.726028,138.0303450000065,2350.6135553018053,140.72267949485374
"10.0.2.109",52916,"46.38.51.49",6107,37,9252,17,5597,20,3655,236693.786139,174.91841199999908,255.98220043296664,167.163648844469
"10.0.2.109",52917,"46.38.51.49",6107,33,9256,15,7090,18,2166,236693.879039,137.67252100000042,411.99216508862963,125.86389697912155
"10.0.2.109",52918,"173.194.122.25",443,65,42628,23,2156,42,40472,236693.879563,137.87672299999394,125.09725807742586,2348.300662759545
"10.0.2.109",52919,"173.194.116.254",443,39,9119,19,3391,20,5728,236693.938252,174.76619100000244,155.2245308132831,262.2017435855163
"10.0.2.109",52920,"46.38.51.49",6107,26,9282,12,7305,14,1977,236693.979054,119.54091999999946,488.8702546374937,132.30615926328886
"10.0.2.109",52921,"173.194.122.12",443,36,9175,17,1900,19,7275,236694.031994,137.51960900000995,110.52969180561661,423.2123725715057
"10.0.2.109",52922,"46.38.51.49",6107,26,8823,12,6907,14,1916,236694.078657,119.43971899998724,462.6266744650153,128.33251893368603
"10.0.2.109",52923,"23.63.68.90",443,24,8943,12,1669,12,7274,236694.151183,119.36864899998181,111.85516558876388,487.4981872334742
"10.0.2.109",52924,"46.38.51.49",6107,35,10531,16,8384,19,2147,236694.179264,136.36432500000228,491.8588494461354,125.9566972520101
"10.0.2.109",52925,"172.227.135.79",443,24,8482,12,1606,12,6876,236694.246625,119.27160099998582,107.72052938235923,461.1994769820063
"10.0.2.109",52926,"173.194.122.13",443,37,10398,17,1829,20,8569,236694.335084,136.20840600001975,107.4236196552941,503.2875871111072
"10.0.2.109",52927,"173.194.122.3",80,14,3266,8,1374,6,1892,236694.927208,120.66903799999272,91.09213251539026,125.43399906777174
"10.0.2.109",52928,"46.38.51.49",6107,17,4255,9,2827,8,1428,236695.129279,35.70809800000279,633.3577330273439,319.9274293466739
"10.0.2.109",52929,"46.38.51.49",6107,16,4205,8,2777,8,1428,236695.282656,6.244780000008177,3557.531250095425,1829.3678880577124
"10.0.2.109",52930,"46.38.51.49",6107,13,1989,7,1176,6,813,236695.34343,116.09240699998918,81.03889171667254,56.024335855148614
"10.0.2.109",52931,"46.38.51.49",6107,13,1989,7,1176,6,813,236695.404932,116.03154199998244,81.08140112454443,56.05372373661107
"10.0.2.109",52932,"173.194.122.3",80,10,1783,6,781,4,1002,236695.49713,115.93782799999462,53.890952657835626,69.14050520249846
"10.0.2.109",52933,"173.194.122.3",80,10,1783,6,781,4,1002,236695.528927,115.9062350000022,53.905641918227104,69.15935109099047
"10.0.2.109",52934,"213.155.158.42",80,17,4204,8,1389,9,2815,236696.284374,34.31493699998828,323.82399536399544,656.2739718859951
"10.0.2.109",52935,"213.155.158.73",80,17,4208,8,1389,9,2819,236696.721135,4.568595999997342,2432.257087299132,4936.308660256482
"10.0.2.109",52936,"46.38.51.49",6107,37,9490,17,6082,20,3408,236697.016776,172.93963700000313,281.3467221513777,157.65038294835503
"10.0.2.109",52937,"173.194.122.25",443,39,9351,19,3138,20,6213,236697.171879,172.78447700000834,145.29082956913305,287.66473043754735
"10.0.2.109",52938,"46.38.51.49",6107,37,9769,17,6352,20,3417,236698.660799,171.46346400000039,296.36634426095515,159.42755011644894
"10.0.2.109",52939,"173.194.122.18",443,39,9656,19,3173,20,6483,236698.815238,171.30900300000212,148.1766839773137,302.7511636384887
"10.0.2.109",52940,"46.38.51.49",6107,58,10194,24,5373,34,4821,236698.832607,319.6366010000056,134.4777158358008,120.66202643670123
"10.0.2.109",52941,"31.13.74.1",443,57,9915,28,4303,29,5612,236698.95653,319.5123920000042,107.73917025415261,140.51411189084465
"10.0.2.109",52942,"46.38.51.49",6107,36,8333,16,5353,20,2980,236700.318476,167.18331100000069,256.14996941889626,142.59796541533922
"10.0.2.109",52943,"173.194.122.24",443,39,8276,19,2738,20,5538,236700.470439,167.0311470000015,131.13721837759877,265.24394279588824
"10.0.2.109",52944,"31.28.27.51",80,17,1925,8,814,9,1111,236705.607072,1620.4503009999753,4.018636051955103,5.484895151992776
"10.0.2.109",52945,"46.38.51.49",6107,18,2436,8,1766,10,670,236706.263311,0.5656680000247434,24975.780845623252,9475.522744375754
"10.0.2.109",52946,"5.101.114.217",80,7,1808,4,336,3,1472,236706.501196,0.32758599999942817,8205.478866632555,35947.81217762834
"10.0.2.109",52947,"46.38.51.49",6107,36,17547,19,15188,17,2359,236728.392363,5.99359500000719,20272.307354743563,3148.69456477746
"10.0.2.109",52948,"80.252.88.135",443,34,17208,15,2051,19,15157,236728.537214,5.8487069999973755,2805.4063915336096,20732.103694039455
"10.0.2.109",52949,"74.86.126.88",80,221,189404,63,7611,158,181793,236807.920097,86.31798100000015,705.3918464566484,16848.679535263895
"10.0.2.109",52950,"46.38.51.49",6107,141,106655,87,100876,54,5779,236808.673793,68.01592999999411,11864.985158624897,679.7231178049612
"10.0.2.109",52951,"46.38.51.49",6107,148,111361,90,104646,58,6715,236808.733682,333.13295600001584,2513.014653524583,161.2569367048676
"10.0.2.109",52952,"74.86.126.88",80,125,105756,35,4730,90,101026,236808.817281,67.87208100000862,557.5193723615929,11907.81228587786
"10.0.2.109",52953,"46.38.51.49",6107,171,126563,107,118202,64,8361,236808.82425,182.64022699999623,5177.479329348509,366.22819133925725
"10.0.2.109",52954,"74.86.126.88",80,111,81587,39,4497,72,77090,236808.876628,125.3881570000085,286.917049111724,4918.486839231222
"10.0.2.109",52955,"46.38.51.49",6107,49,24828,28,22016,21,2812,236808.924168,55.10262399999192,3196.363207676386,408.2564198758175
"10.0.2.109",52956,"74.86.126.88",80,159,125880,52,7690,107,118190,236808.967849,126.15552599998773,487.6520430821713,7494.875809087363
"10.0.2.109",52957,"46.38.51.49",6107,48,32684,30,30760,18,1924,236809.024176,25.453126000007614,9667.967698738708,604.7194360329413
"10.0.2.109",52958,"74.86.126.88",80,44,24523,20,2735,24,21788,236809.067276,54.95902000000933,398.1148135464622,3171.5267120842113
"10.0.2.109",52959,"46.38.51.49",6107,1352,1320969,957,1279474,395,41495,236809.124861,429.25192300000344,23845.652055471208,773.345399782862
"10.0.2.109",52960,"74.86.126.88",80,44,32433,16,1793,28,30640,236809.167583,25.309215999994194,566.7500723848298,9685.009602828322
"10.0.2.109",52961,"46.38.51.49",6107,98,84411,67,80966,31,3445,236809.224599,70.17855499999132,9229.714119934219,392.71256012614407
"10.0.2.109",52962,"74.86.126.88",80,241,208042,62,9206,179,198836,236809.24912,63.897555000003194,1152.5949623580482,24894.34846137572
"10.0.2.109",52963,"46.38.51.49",6107,113,80345,69,75469,44,4876,236809.324341,75.73565099999541,7971.833502824667,515.0546603210998
"10.0.2.109",52964,"74.86.126.88",80,8,1180,5,564,3,616,236809.34846,0.7570189999823924,5960.220285230549,6509.744141315635
"10.0.2.109",52965,"46.38.51.49",6107,63,42265,39,39636,24,2629,236809.42464,68.9383299999754,4599.58922706879,305.08426879513195
"10.0.2.109",52966,"74.86.126.88",80,111,80202,39,4583,72,75619,236809.448657,75.61085200001253,484.9039394503044,8000.862098470994
"10.0.2.109",52967,"46.38.51.49",6107,227,180292,139,169905,88,10387,236809.524815,179.93788199999835,7553.9401980957655,461.8038129402944
"10.0.2.109",52968,"46.38.51.49",6107,141,106035,85,98917,56,7118,236809.624771,180.83963000000222,4375.899242881609,314.8867314094776
"10.0.2.109",52969,"74.86.126.88",80,201,178853,53,8474,148,170379,236809.648784,128.61293900001328,527.1009318898543,10597.938361395032
"10.0.2.109",52970,"46.38.51.49",6107,461,438298,325,425321,136,12977,236809.72555,334.13293600000907,10183.276275404074,310.7026839161919
"10.0.2.109",52971,"74.86.126.88",80,130,105406,38,6123,92,99283,236809.767595,124.67883099999744,392.8814507412329,6370.480005543333
"10.0.2.109",52972,"74.86.126.88",80,60,42068,21,2444,39,39624,236809.814654,68.54770400002599,285.2320188578831,4624.399965312913
"10.0.2.109",52973,"46.38.51.49",6107,263,235462,176,227758,87,7704,236809.825849,128.25255500001367,14206.843676524071,480.5518299420501
"10.0.2.109",52974,"46.38.51.49",6107,171,160251,121,156859,50,3392,236809.925697,63.85245100001339,19652.683340217227,424.97977094088856
"10.0.2.109",52975,"46.38.51.49",6107,221,192843,145,185358,76,7485,236810.025578,85.06341400000383,17432.45339294674,703.9454118311934
"10.0.2.109",52976,"74.86.126.88",80,174,161798,50,3369,124,158429,236810.049483,63.7283639999805,422.9200046624176,19888.036039970957
"10.0.2.109",52977,"46.38.51.49",6107,235,192623,149,185720,86,6903,236810.125712,64.22856299998239,23132.387377254687,859.8043832930708
"10.0.2.109",52978,"172.227.135.79",80,55,56326,13,968,42,55358,236810.151943,8.030686999991303,964.3010616661297,55146.46505342315
"10.0.2.109",52979,"46.38.51.49",6107,288,260242,194,251008,94,9234,236810.226308,127.84630999999354,15706.85927501624,577.8187888254556
"10.0.2.109",52980,"46.38.51.49",6107,126,107518,81,104779,45,2739,236810.326164,25.77314999999362,32523.459491765945,850.1871133332721
"10.0.2.109",52981,"74.86.126.88",80,216,192546,57,6444,159,186102,236810.41436,84.67434600001434,608.8266687054338,17582.846166886815
"10.0.2.109",52982,"46.38.51.49",6107,138,116666,87,112835,51,3831,236810.426841,64.29026399998111,14040.69518209266,476.71292810384176
"10.0.2.109",52983,"46.38.51.49",6107,301,259031,196,250722,105,8309,236810.5265,127.5457409999799,15725.934745248107,521.1620511892316
"10.0.2.109",52984,"74.86.126.88",80,135,116469,37,3052,98,113417,236810.550357,64.16643700000714,380.5104528399681,14140.35191014111
"10.0.2.109",52985,"74.86.126.88",80,256,258479,65,7645,191,250834,236810.619487,127.45233800000278,479.86565770177293,15744.489520466515
"10.0.2.109",52986,"46.38.51.49",6107,169,140530,110,134396,59,6134,236810.626878,127.45021599999745,8435.984133601009,385.02877076333067
"10.0.2.109",52987,"74.86.126.88",80,400,416015,89,9315,311,406700,236810.649533,193.44639300002018,385.2230007720652,16819.12983510455
"10.0.2.109",52988,"74.86.126.88",80,116,106943,30,1906,86,105037,236810.718628,25.38041599999997,600.7781747942988,33108.046771179834
"10.0.2.109",52989,"46.38.51.49",6107,369,317643,243,305336,126,12307,236810.726464,331.13976099999854,7376.607365492454,297.3246091096878
"10.0.2.109",52990,"46.38.51.49",6107,114,83855,70,78860,44,4995,236810.827151,71.22229899998638,8857.899967538546,561.060237609118
"10.0.2.109",52991,"74.86.126.88",80,327,313733,86,9340,241,304393,236810.850909,193.2571009999956,386.63521088418736,12600.540872234524
"10.0.2.109",52992,"46.38.51.49",6107,246,209881,160,202999,86,6882,236810.927157,127.14937800000189,12772.315724580076,433.00251142399753
"10.0.2.109",52993,"74.86.126.88",80,162,140117,49,5571,113,134546,236811.01795,127.05782600000384,350.76942053139373,8471.481323786915
"10.0.2.109",52994,"46.38.51.49",6107,91,67332,56,63274,35,4058,236811.026968,182.43991899999673,2774.5682127824725,177.94351246122062
"10.0.2.109",52995,"46.38.51.49",6107,211,168075,131,158523,80,9552,236811.127838,178.33334000001196,7111.311883688799,428.50091856068457
"10.0.2.109",52996,"74.86.126.88",80,95,67513,35,4035,60,63478,236811.151133,123.06162100000074,262.30761254152344,4126.58305549215
"10.0.2.109",52997,"46.38.51.49",6107,33,20693,20,19340,13,1353,236811.227569,25.444843000004767,6080.603444869792,425.3907166964234
"10.0.2.109",52998,"74.86.126.88",80,190,176954,47,3975,143,172979,236811.246372,45.72063799999887,695.5283519884562,30267.11919461916
"10.0.2.109",52999,"46.38.51.49",6107,190,150257,118,143012,72,7245,236811.327473,126.75012799998512,9026.389306684836,457.27764472164324
"10.0.2.109",53000,"46.38.51.49",6107,126,98915,80,94955,46,3960,236811.427757,57.84969900001306,13131.269706344168,547.6260127125786
"10.0.2.109",53001,"74.86.126.88",80,284,258078,77,6774,207,251304,236811.45374,126.61795200000051,427.99618177365386,15877.938066791601
"10.0.2.109",53002,"74.86.126.88",80,30,20496,12,1276,18,19220,236811.617836,25.05429600001662,407.43511611714126,6137.071263143774
"10.0.2.109",53003,"74.86.126.88",80,174,149358,52,6142,122,143216,236811.742603,126.33346100000199,388.93892094034555,9069.077906446195
"10.0.2.109",53004,"74.86.126.88",80,248,234625,60,6231,188,228394,236811.750525,126.3273990000016,394.5937333832019,14463.623999730864
"10.0.2.109",53005,"74.86.126.88",80,238,209422,62,5571,176,203851,236811.85517,126.22023300000001,353.0971139943942,12920.337423240218
"10.0.2.109",53006,"46.38.51.49",6107,970,966525,703,935605,267,30920,236812.008507,426.76024000000325,17538.747283486256,579.6228814568061
"10.0.2.109",53007,"74.86.126.88",80,188,166798,49,7855,139,158943,236812.054983,126.4975609999965,496.76847129093454,10051.925032768302
"10.0.2.109",53008,"46.38.51.49",6107,112,82912,69,78403,43,4509,236812.109089,76.08327800000552,8243.913991192052,474.1120644144352
"10.0.2.109",53009,"46.38.51.49",6107,47,16706,24,13687,23,3019,236812.20903,139.37510900001507,785.6209102587188,173.28775685475796
"10.0.2.109",53010,"46.38.51.49",6107,32,4322,15,1890,17,2432,236812.331403,140.26310800001374,107.79741170428449,138.71074352635972
"10.0.2.109",53011,"74.86.126.88",80,104,83288,31,4278,73,79010,236812.849974,69.1991960000014,494.57222017434003,9134.210172037076
"10.0.2.109",53012,"74.86.126.88",80,116,98340,34,3289,82,95051,236813.430148,55.84699599997839,471.1444103459062,13615.915885615303
"10.0.2.109",53013,"74.86.126.88",80,105,82499,36,4108,69,78391,236813.502235,74.6897980000067,440.00654547220824,8396.434543844176
"10.0.2.109",53014,"216.58.209.205",443,31,4037,15,2124,16,1913,236813.755174,138.83922300001723,122.38616460708579,110.22821699310505
"10.0.2.109",53015,"173.194.122.5",443,47,16483,19,2611,28,13872,236814.174555,137.4094589999877,152.01282467753455,807.6299900140785
"10.0.2.109",53016,"74.86.126.88",80,259,253744,65,7288,194,246456,236815.405966,188.6735430000117,309.0205392496201,10450.05022246218
"10.0.2.109",53017,"46.38.51.49",6107,123,97029,80,93157,43,3872,236817.17402,143.42108599998755,5196.279158003758,215.97939929141722
"10.0.2.109",53018,"173.194.122.24",443,114,96316,35,3244,79,93072,236817.598136,142.9969530000235,181.48638453852746,5206.936122617086
"10.0.2.109",53019,"195.113.232.73",80,17,11672,7,738,10,10934,236818.218848,32.65863800002262,180.77912495909692,2678.3725640958883
"10.0.2.109",53020,"46.38.51.49",6107,37,17891,20,15753,17,2138,236818.44848,122.01125500001945,1032.8883183766934,140.18378878241415
"10.0.2.109",53021,"172.227.117.226",443,29,17218,12,1658,17,15560,236819.885603,120.57363699999405,110.00746373770457,1032.398151844803
"10.0.2.109",53022,"46.38.51.49",6107,13,3152,7,2317,6,835,236822.307717,118.15266400002292,156.88177796817516,56.53702399802601
"10.0.2.109",53023,"213.155.158.42",80,11,2993,6,796,5,2197,236823.738871,116.72009399998933,54.55787244311662,150.5824695446322
"10.0.2.109",53024,"74.86.126.88",80,25,15509,11,1343,14,14166,236850.881037,28.5215549999848,376.69755383273196,3973.4158954538207
"10.0.2.109",53025,"46.38.51.49",6107,28,15781,17,14799,11,982,236851.114417,53.4697879999876,2214.1849524450604,146.92409104000603
"10.0.2.109",53026,"46.38.51.49",6107,35,22618,21,21474,14,1144,236851.963508,28.98268100002315,5927.40195428652,315.77478977851257
"10.0.2.109",53027,"46.38.51.49",6107,31,19199,19,18163,12,1036,236852.0562,28.36968600002001,5121.805013982091,292.1428175128253
"10.0.2.109",53028,"46.38.51.49",6107,50,31862,30,29665,20,2197,236852.156305,30.97984399998677,7660.4646556677735,567.3366205461689
"10.0.2.109",53029,"74.86.126.88",80,27,18956,12,1021,15,17935,236852.452849,27.972758999996586,291.9983688416647,5129.275950220624
"10.0.2.109",53030,"74.86.126.230",80,8,1616,5,586,3,1030,236853.297916,3.4446069999830797,1360.9680291606642,2392.1451707090173
"10.0.2.109",53031,"74.86.126.88",80,31,22367,12,1013,19,21354,236853.890415,27.055503999989014,299.5323982877307,6314.131128367424
"10.0.2.109",53032,"74.86.126.88",80,41,30132,15,1559,26,28573,236856.745787,26.390067000000272,472.6020589489171,8661.743829600646
"10.0.2.109",53033,"74.86.126.230",80,15,7189,7,764,8,6425,236856.989357,1.3495399999956135,4528.950605406188,38087.051884469576
"10.0.2.109",53034,"74.86.126.88",80,24,15522,10,905,14,14617,236858.251225,46.332509999978356,156.26176954374762,2523.8434093049273
"10.0.2.109",53035,"74.86.126.88",80,17,7703,8,797,9,6906,236858.34099,16.01298400000087,398.1768794622947,3450.2001625678886
"10.0.2.109",53036,"46.38.51.49",6107,24,11962,14,11034,10,928,236869.458936,120.00253399999929,735.5844669080114,61.86536027647586
"10.0.2.109",53037,"74.86.126.88",80,23,11873,9,851,14,11022,236871.46321,66.6249330000137,102.18396767466318,1323.468497896754
"10.0.2.109",53038,"195.113.232.88",80,287,316360,54,3277,233,313083,236873.184527,55.0311909999873,476.38438353998276,45513.53431548625
"10.0.2.109",53039,"74.86.126.88",80,47,32442,17,3536,30,28906,236928.221676,10.969840000005206,2578.7067085742888,21080.34392478744
"10.0.2.109",53040,"46.38.51.49",6107,15,1179,7,616,8,563,236931.279961,1.36308700000518,3615.323159843262,3304.264511350254
"10.0.2.109",53041,"46.38.51.49",6107,18,1341,9,724,9,617,236931.602951,1.8867169999866746,3069.8827646334385,2616.1846212414803
"10.0.2.109",53042,"80.78.242.47",80,10,875,5,391,5,484,236932.369816,1.119527000002563,2794.037124600692,3458.6034995057157
"10.0.2.109",53043,"80.78.242.47",80,10,875,5,391,5,484,236932.520563,0.12251200000173412,25532.192764428986,31605.06725827015
"10.0.2.109",53044,"46.38.51.49",6107,18,1672,8,1000,10,672,236932.821272,0.5136150000034831,15575.869084714712,10466.984024928286
"10.0.2.109",53045,"217.23.10.139",80,7,1044,4,338,3,706,236933.062657,0.2717990000091959,9948.52813994354,20780.06173609509
"10.0.2.109",53046,"46.38.51.49",6107,21,2847,11,2172,10,675,236933.39388,2.3299470000201836,7457.68036777209,2317.6492855645306
"10.0.2.109",53047,"37.187.78.159",80,9,2165,5,395,4,1770,236933.637296,2.0862320000014734,1514.6925174178941,6787.35634387259
"10.0.2.109",53048,"46.38.51.49",6107,18,1672,8,1000,10,672,236933.667021,0.5108450000116136,15660.32749624275,10523.740077475128
"10.0.2.109",53049,"217.23.10.139",80,7,1044,4,338,3,706,236933.907245,0.2702879999997094,10004.143728182187,20896.229207386463
"10.0.2.109",53050,"46.38.51.49",6107,19,2735,9,2060,10,675,236934.238091,0.5870500000019092,28072.566220843888,9198.53504809205
"10.0.2.109",53051,"37.187.78.159",80,9,2161,5,395,4,1766,236934.482885,0.3420859999896493,9237.443216312899,41299.556253186274
"10.0.2.109",53052,"74.86.126.88",80,36,27964,11,958,25,27006,236938.965969,65.65728200000012,116.72734183544158,3290.541329444609
"10.0.2.109",53053,"74.86.126.230",80,23,15263,9,1269,14,13994,236939.21326,11.062104000011459,917.7277667963964,10120.31707529454
"10.0.2.109",53054,"195.113.232.83",80,286,316306,58,3493,228,312813,236950.33734,72.69505700000445,384.4002763488897,34424.678970949106
"10.0.2.109",53055,"74.86.126.88",80,32,14837,14,2347,18,12490,237023.036427,70.22083099998417,267.38504419015254,1422.939583270134
"10.0.2.109",53056,"74.86.126.88",80,13,3270,7,1132,6,2138,237023.648885,2.3812040000048,3803.1180864729545,7182.920908903866
"10.0.2.109",53057,"74.86.126.88",80,13,3487,7,1119,6,2368,237023.663878,3.4189270000206307,2618.365352622616,5540.919709571362
"10.0.2.109",53058,"74.86.126.88",80,15,2402,8,1197,7,1205,237023.669295,66.97373600001447,142.98142185166333,143.9370203268624
"10.0.2.109",53059,"74.86.126.88",80,15,2501,8,1199,7,1302,237023.676467,67.35862799998722,142.40195034854065,154.63497861034188
"10.0.2.109",53060,"46.38.51.49",6107,17,2817,9,1598,8,1219,237023.855063,118.00932000001194,108.33042678322956,82.63754083151241
"10.0.2.109",53061,"46.38.51.49",6107,14,1628,8,906,6,722,237023.916565,118.94282600001316,60.93684036058802,48.56114651252158
"10.0.2.109",53062,"74.86.126.88",80,15,2674,8,1196,7,1478,237023.978915,67.04887899997993,142.70186381494705,176.34895879472555
"10.0.2.109",53063,"46.38.51.49",6107,17,2867,9,1646,8,1221,237024.013523,117.85156800001278,111.73377005894883,82.88392056013154
"10.0.2.109",53064,"46.38.51.49",6107,16,2599,8,1375,8,1224,237024.11345,117.75046300000395,93.41789169864776,83.15890868301445
"10.0.2.109",53065,"74.86.126.88",80,15,2724,8,1198,7,1526,237024.137185,66.90828999999212,143.2408450432843,182.4587057896927
"10.0.2.109",53066,"46.38.51.49",6107,17,2616,9,1393,8,1223,237024.214038,117.64900999999372,94.72242902851961,83.16262074793933
"10.0.2.109",53067,"74.86.126.88",80,15,2510,8,1201,7,1309,237024.23807,66.43160100001842,144.62996308033183,157.63582154217684
"10.0.2.109",53068,"46.38.51.49",6107,35,23686,21,22585,14,1101,237024.313851,117.54948499999591,1537.0547986663344,74.93014537664973
"10.0.2.109",53069,"74.86.126.88",80,15,2473,8,1200,7,1273,237024.338642,66.70568500002264,143.91576969784123,152.67064568779324
"10.0.2.109",53070,"46.38.51.49",6107,17,3279,9,2096,8,1183,237024.414361,117.44777100000647,142.76984447835179,80.58049905433691
"10.0.2.109",53071,"46.38.51.49",6107,27,14540,16,13540,11,1000,237024.514283,116.34550900000613,931.0200361923235,68.7607116833326
"10.0.2.109",53072,"74.86.126.88",80,15,3136,8,1160,7,1976,237024.539451,66.49052900000243,139.568749708694,237.74814605549946
"10.0.2.109",53073,"74.86.126.88",80,33,23539,11,912,22,22627,237024.583215,65.27327500001411,111.77622081929277,2773.2023557874318
"10.0.2.109",53074,"46.38.51.49",6107,37,22337,22,21133,15,1204,237024.613949,122.3360120000143,1381.9642902858418,78.73397082781212
"10.0.2.109",53075,"74.86.126.88",80,23,14289,9,869,14,13420,237024.657091,65.25709299999289,106.53248069142089,1645.1851448548541
"10.0.2.109",53076,"74.86.126.88",80,33,22086,13,1073,20,21013,237024.738229,65.25031699999818,131.55491643052463,2576.293997161802
"10.0.2.109",53077,"195.113.232.88",80,281,316036,50,3061,231,312975,237026.079583,112.45101099999738,217.7659389829814,22265.695770401373
"10.0.2.109",53078,"74.86.126.88",80,11,1423,6,699,5,724,237027.042363,65.25180600001477,85.69877744071535,88.76382670540474
"10.0.2.109",53079,"74.86.126.88",80,28,17647,10,858,18,16789,237027.104447,65.27756700001191,105.15097782364877,2057.55217561916
"10.0.2.109",53080,"195.113.232.83",80,286,316306,54,3277,232,313029,237102.242833,37.045111999992514,707.677709275256,67599.52568102659
"10.0.2.109",53081,"74.86.126.88",80,21,12716,9,1325,12,11391,237138.534998,39.455437000025995,268.65752367647116,2309.6436620367417
"10.0.2.109",53082,"74.86.126.88",80,56,45082,17,1577,39,43505,237139.309699,69.92148499999894,180.4309505154273,4977.583070496934
"10.0.2.109",53083,"195.113.232.88",80,279,315928,49,3007,230,312921,237178.043315,38.14023000001907,630.7250900161843,65635.89155069983
"10.0.2.109",53084,"46.38.51.49",6107,38,15401,16,6852,22,8549,237210.273948,120.24289400002453,455.8772512576819,568.7820521018568
"10.0.2.109",53085,"23.206.102.19",443,35,15006,18,8131,17,6875,237210.456806,120.05985099999816,541.7964411766677,458.10484972200106
"10.0.2.109",53086,"46.38.51.49",6107,12,893,6,359,6,534,237213.629568,0.393776999990223,7293.4681306203975,10848.779893457639
"10.0.2.109",53087,"23.206.102.19",443,4,228,3,170,1,58,237213.793472,0.22973000002093613,5919.993034762801,2019.7623295073086
"10.0.2.109",53088,"23.206.102.19",80,25,20539,9,1263,16,19276,237215.276863,1.3447109999833629,7513.882165108346,114677.42883185153
"10.0.2.109",53089,"23.206.102.19",80,11,4702,6,1115,5,3587,237216.205411,0.521547999989707,17102.93204110847,55020.822629108596
"10.0.2.109",53090,"46.38.51.49",6107,51,26057,28,19136,23,6921,237216.42293,21.97664700000314,6965.93979964178,2519.401617543936
"10.0.2.109",53091,"46.38.51.49",6107,78,61629,52,55358,26,6271,237216.484415,22.020157999999356,20111.753966525263,2278.2761140951607
"10.0.2.109",53092,"46.38.51.49",6107,68,44402,40,38364,28,6038,237216.580036,21.802204000006896,14077.108901462574,2215.555821786858
"10.0.2.109",53093,"23.212.207.152",80,9,2955,5,1060,4,1895,237216.582464,0.4838259999814909,17526.962173021722,31333.57860176997
"10.0.2.109",53094,"23.63.92.101",80,66,58407,20,4326,46,54081,237216.653825,16.648248000012245,2078.7772983664436,25987.599415847348
"10.0.2.109",53095,"23.63.92.101",80,54,33464,21,6388,33,27076,237216.658088,14.493057000014232,3526.1021880994335,14945.639142921144
"10.0.2.109",53096,"46.38.51.49",6107,97,72681,58,64588,39,8093,237216.680503,21.701247999997577,23809.874897520072,2983.422888859075
"10.0.2.109",53097,"23.63.92.101",80,34,20673,14,4053,20,16620,237216.749615,9.417377999983728,3442.9965538237952,14118.57950272674
"10.0.2.109",53098,"46.38.51.49",6107,57,34323,33,28454,24,5869,237216.780303,25.380451999983052,8968.792202761086,1849.9276529839324
"10.0.2.109",53099,"23.63.92.101",80,49,33447,19,5587,30,27860,237216.805244,11.329330000007758,3945.158275023271,19672.83149134568
"10.0.2.109",53100,"46.38.51.49",6107,58,35641,34,29346,24,6295,237216.880757,22.01201000000583,10665.450360959214,2287.841955368304
"10.0.2.109",53101,"198.232.124.162",80,13,7953,6,636,7,7317,237216.938849,1.2995759999903385,3915.1230863280225,45042.38305450022
"10.0.2.109",53102,"46.38.51.49",6107,49,25672,28,19253,21,6419,237216.980685,21.71590000001015,7092.68324130835,2364.7189386567443
"10.0.2.109",53103,"23.63.92.101",80,29,18310,13,3250,16,15060,237217.010257,11.303429000021424,2300.186960961202,10658.71250217714
"10.0.2.109",53104,"23.63.92.101",80,44,32189,17,4174,27,28015,237217.024773,16.36378399998648,2040.6038114428538,13696.098652987912
"10.0.2.109",53105,"46.38.51.49",6107,58,32706,34,25745,24,6961,237217.08131,21.31793099999777,9661.350343990773,2612.2610116340943
"10.0.2.109",53106,"23.63.92.101",80,32,18976,13,3941,19,15035,237217.091125,16.38644299999578,1924.0295163512985,7340.214102598775
"10.0.2.109",53107,"46.38.51.49",6107,32,16033,19,13336,13,2697,237217.181144,21.216623999993317,5028.509719549802,1016.9384158387685
"10.0.2.109",53108,"23.63.92.101",80,42,27469,18,4207,24,23262,237217.205238,16.12482799999998,2087.2160620876107,11540.960312879011
"10.0.2.109",53109,"46.38.51.49",6107,52,29664,30,23597,22,6067,237217.281077,21.11690200000885,8939.568881833182,2298.4432091402264
"10.0.2.109",53110,"46.38.51.49",6107,72,45016,42,37237,30,7779,237217.381719,20.997468999994453,14187.233708980768,2963.7857781819534
"10.0.2.109",53111,"46.38.51.49",6107,56,31935,33,25728,23,6207,237217.48122,20.902728000015486,9846.753017110854,2375.5750923976625
"10.0.2.109",53112,"23.63.92.101",80,46,36104,16,4121,30,31983,237217.506993,15.839915000018664,2081.3243000332486,16153.116983247608
"10.0.2.109",53113,"46.38.51.49",6107,46,23722,25,17118,21,6604,237217.581553,20.81007999999565,6580.657066192375,2538.769673158923
"10.0.2.109",53114,"23.63.92.101",80,39,26764,15,4032,24,22732,237217.625103,15.783563000004506,2043.6450248901842,11521.859798066385
"10.0.2.109",53115,"46.38.51.49",6107,41,16684,22,10359,19,6325,237217.68155,18.932902999978978,4377.14174102577,2672.5959563652855
"10.0.2.109",53116,"23.63.92.101",80,30,21294,11,2517,19,18777,237217.692991,11.125219000008656,1809.9418986704293,13502.295999735657
"10.0.2.109",53117,"46.38.51.49",6107,29,12505,16,9410,13,3095,237217.78221,20.670507000002544,3641.903897180206,1197.8419300502378
"10.0.2.109",53118,"46.38.51.49",6107,115,86745,71,80186,44,6559,237217.881943,15.669099000020651,40939.68644905202,3348.756683452625
"10.0.2.109",53119,"23.63.92.101",80,19,10004,9,1724,10,8280,237217.907055,11.704802000022028,1178.3198041260368,5659.215764596047
"10.0.2.109",53120,"23.63.92.101",80,21,13910,9,1742,12,12168,237217.975299,15.440810999978567,902.5432666729322,6304.332071685556
"10.0.2.109",53121,"46.38.51.49",6107,159,111004,94,88817,65,22187,237217.982356,211.39302099999622,3361.2084099976637,839.6492900302662
"10.0.2.109",53122,"46.38.51.49",6107,47,27588,28,23497,19,4091,237218.082071,20.308640999981435,9255.961538744608,1611.5307764822826
"10.0.2.109",53123,"46.38.51.49",6107,31,13480,16,8838,15,4642,237218.182419,20.216402000020025,3497.358234166988,1836.9242954291874
"10.0.2.109",53124,"23.63.92.101",80,31,24465,11,2509,20,21956,237218.20602,15.116227999998955,1327.844486071617,11619.8300263804
"10.0.2.109",53125,"23.63.92.101",80,34,23235,14,3373,20,19862,237218.276216,15.099947000009706,1787.0261398919251,10522.950842138576
"10.0.2.109",53126,"46.38.51.49",6107,34,19649,21,16962,13,2687,237218.282357,22.103182999999262,6139.206285357386,972.5296125902191
"10.0.2.109",53127,"46.38.51.49",6107,39,21282,23,16728,16,4554,237218.383357,22.333451999991667,5992.087564432491,1631.2749144204663
"10.0.2.109",53128,"46.38.51.49",6107,44,24888,25,19468,19,5420,237218.482994,19.892537000006996,7829.267830440392,2179.7119190973353
"10.0.2.109",53129,"46.38.51.49",6107,26,9587,14,5915,12,3672,237218.583435,19.80464399998891,2389.338581396691,1483.2884650699325
"10.0.2.109",53130,"23.63.92.101",80,28,18815,11,2506,17,16309,237218.607575,14.823011000000406,1352.4917440862353,8801.990364845336
"10.0.2.109",53131,"46.38.51.49",6107,31,13639,17,9129,14,4510,237218.683145,19.712248000025284,3704.90468666518,1830.3341151122754
"10.0.2.109",53132,"23.63.92.101",80,27,17936,11,2540,16,15396,237218.77853,14.586859999981243,1393.0345530173136,8443.763770966361
"10.0.2.109",53133,"46.38.51.49",6107,39,22673,23,19066,16,3607,237218.783267,20.362003999995068,7490.814754777425,1417.1493139873162
"10.0.2.109",53134,"46.38.51.49",6107,100,86326,70,81313,30,5013,237218.883599,28.84061099999235,22555.139348475404,1390.5391948877448
"10.0.2.109",53135,"23.63.92.101",80,16,6357,9,1774,7,4583,237218.981445,14.486877999996068,979.6451657840877,2530.842048922477
"10.0.2.109",53136,"46.38.51.49",6107,41,23720,24,20198,17,3522,237218.983987,29.41691199998604,5492.894699487039,957.8163744723909
"10.0.2.109",53137,"23.63.92.101",80,8,1960,5,904,3,1056,237219.078537,0.8999130000011064,8036.332401011107,9387.574132154568
"10.0.2.109",53138,"46.38.51.49",6107,45,23652,26,18167,19,5485,237219.083663,18.941737999994075,7672.791166261801,2316.577285569768
"10.0.2.109",53139,"23.63.92.101",80,22,9520,11,3250,11,6270,237219.113769,14.373011000017868,1808.9459473709217,3489.8741815432854
"10.0.2.109",53140,"23.63.92.101",80,33,22565,13,2595,20,19970,237219.127863,14.232474999997066,1458.6359716074878,11225.03289133007
"10.0.2.109",53141,"46.38.51.49",6107,32,11994,17,7423,15,4571,237219.184071,19.19644500000868,3093.489445570425,1904.9360441468962
"10.0.2.109",53142,"23.63.92.101",80,80,71571,23,4514,57,67057,237219.274963,10.198700999986613,3540.843093649613,52600.424309008
"10.0.2.109",53143,"46.38.51.49",6107,69,56895,49,53333,20,3562,237219.283874,14.270552000001771,29898.21276709878,1996.8393654286438
"10.0.2.109",53144,"23.63.92.101",80,16,6247,9,1765,7,4482,237219.308506,14.185423999995692,995.3879418764141,2527.6650172748373
"10.0.2.109",53145,"185.59.220.23",80,75,74140,22,1518,53,72622,237219.841359,7.11722699998063,1706.2825170579847,81629.54476533925
"10.0.2.109",53146,"23.206.102.19",80,9,3681,5,1091,4,2590,237219.980566,7.586246999999275,1150.503008931931,2731.2582888484885
"10.0.2.109",53147,"23.63.92.101",80,21,13759,9,1762,12,11997,237220.307558,13.089319999999134,1076.908502504403,7332.390070684065
"10.0.2.109",53148,"23.63.92.101",80,59,55377,16,2861,43,52516,237220.702464,11.965705999988131,1912.7997963532366,35111.00807594777
"10.0.2.109",53149,"37.235.110.18",80,12,5407,6,670,6,4737,237220.741519,6.778144000010798,790.7769442477854,5590.911022241432
"10.0.2.109",53150,"23.63.92.101",80,26,18478,11,1860,15,16618,237221.407011,11.932132999994792,1247.0528110947553,11141.679362780991
"10.0.2.109",53151,"23.63.92.101",80,14,7076,7,1656,7,5420,237221.585336,6.8367700000235345,1937.757157247413,6342.176203068224
"10.0.2.109",53152,"23.63.92.101",80,24,16801,10,2506,14,14295,237222.482672,10.956271999981254,1829.8194860472888,10437.85696450359
"10.0.2.109",53153,"23.63.92.101",80,31,20103,13,3341,18,16762,237224.135253,9.268470000009984,2883.755355519434,14467.97583634144
"10.0.2.109",53154,"23.63.92.101",80,37,29915,12,2551,25,27364,237225.116212,8.20935200000531,2485.9452975078666,26666.17292081743
"10.0.2.109",53155,"173.194.122.26",80,22,17468,8,751,14,16717,237226.198383,1.2031299999798648,4993.6415849497125,111156.73285699647
"10.0.2.109",53156,"23.63.92.101",80,14,5321,7,1660,7,3661,237226.961336,4.321242000005441,3073.1905317923133,6777.681046320276
"10.0.2.109",53157,"23.63.92.101",80,9,3379,5,897,4,2482,237227.404193,1.8602689999970607,3857.5066294236685,10673.725144068612
"10.0.2.109",53158,"23.63.92.101",80,19,14115,8,1060,11,13055,237227.522898,5.858785000018543,1447.3990767664561,17826.22164828876
"10.0.2.109",53159,"23.63.92.101",80,12,5273,7,1006,5,4267,237227.569115,5.891066000011051,1366.1364513629455,5794.537015870466
"10.0.2.109",53160,"46.38.51.49",6107,22,4850,12,3813,10,1037,237227.692577,10.682404999999562,2855.536744768734,776.6041448531805
"10.0.2.109",53161,"173.194.122.25",80,39,36084,13,1032,26,35052,237228.165559,8.218007000017678,1004.6231403772521,34122.1417795576
"10.0.2.109",53162,"46.38.51.49",6107,31,6546,14,2339,17,4207,237228.309116,112.12376499999664,166.88701097399434,300.1683006274451
"10.0.2.109",53163,"173.194.122.30",80,27,21851,10,864,17,20987,237228.344691,4.9690410000039265,1391.0128735091014,33788.41108372166
"10.0.2.109",53164,"107.20.158.112",80,8,2315,5,1169,3,1146,237228.774174,4.679452000011224,1998.5246135610682,1959.2037700093963
"10.0.2.109",53165,"173.194.122.11",80,9,3174,5,671,4,2503,237228.854164,4.57102100001066,1174.3547010585778,4380.640561474844
"10.0.2.109",53166,"23.212.207.152",80,17,10929,8,2576,9,8353,237229.285621,3.3660860000236426,6122.244054327564,19852.136873368847
"10.0.2.109",53167,"37.235.110.18",80,18,13249,7,771,11,12478,237229.495058,3.1671149999892805,1947.5137467445534,31518.906007624562
"10.0.2.109",53168,"185.59.220.15",80,8,1633,5,673,3,960,237229.633398,3.8124339999922086,1412.221168946401,2014.4611028061588
"10.0.2.109",53169,"23.22.42.26",443,15,4239,8,735,7,3504,237231.109796,7.264858999988064,809.37565340355,3858.5745435728422
"10.0.2.109",53170,"23.206.102.19",80,7,1633,5,1521,2,112,237231.153348,7.223041000019293,1684.6090171670767,124.0474752943541
"10.0.2.109",53171,"95.100.72.163",80,12,6368,6,1558,6,4810,237231.318433,1.3399499999941327,9301.839620922106,28717.489458687633
"10.0.2.109",53172,"46.38.51.49",6107,22,5430,10,3697,12,1733,237231.530501,6.843755999987479,4321.603517140896,2025.7881783081343
"10.0.2.109",53173,"54.224.225.90",443,19,5043,10,1431,9,3612,237231.673106,6.700951000006171,1708.414223591466,4312.2237425663
"10.0.2.109",53174,"207.46.194.8",80,14,1381,8,879,6,502,237232.661146,15.093396000011126,465.8991256834987,266.0766337805647
"10.0.2.109",53175,"207.46.194.8",80,10,1456,5,701,5,755,237232.665319,0.28428100000019185,19726.96029631321,21246.58348604347
"10.0.2.109",53176,"46.38.51.49",6107,21,4319,11,3084,10,1235,237232.670011,5.638466999982484,4375.65742604801,1752.24932593038
"10.0.2.109",53177,"207.46.194.8",80,10,1456,5,701,5,755,237232.689969,0.2880019999865908,19472.087000302447,20972.076583777955
"10.0.2.109",53178,"172.227.135.79",80,8,1986,5,582,3,1404,237232.699071,0.5944349999772385,7832.647808723044,18895.253476713326
"10.0.2.109",53179,"173.194.122.13",80,8,2032,5,924,3,1108,237233.325474,1.7584439999773167,4203.71646756755,5040.82017972386
"10.0.2.109",53180,"173.194.122.13",80,8,2030,5,923,3,1107,237233.332883,1.1448859999945853,6449.550435619723,7735.2679655807515
"10.0.2.109",53181,"173.194.122.13",80,8,2030,5,923,3,1107,237233.33726,2.1665679999860004,3408.1552021666125,4087.5707570947343
"10.0.2.109",53182,"173.194.122.13",80,8,2031,5,923,3,1108,237233.345443,0.7312979999987874,10097.114992810377,12120.913772517766
"10.0.2.109",53183,"173.194.122.13",80,8,2031,5,923,3,1108,237233.347468,1.7528650000167545,4212.532054624527,5056.864048238327
"10.0.2.109",53184,"173.194.122.13",80,8,2031,5,923,3,1108,237233.352206,1.1467549999943003,6439.03885314361,7729.637106482253
"10.0.2.109",53185,"173.194.122.13",80,13,2309,7,1039,6,1270,237233.370022,7.037177000020165,1181.155454804701,1443.7607580384702
"10.0.2.109",53186,"173.194.122.13",80,14,2371,8,1101,6,1270,237233.382015,15.042376999976113,585.5457551698104,675.4251671804352
"10.0.2.109",53187,"173.194.122.13",80,9,2092,6,985,3,1107,237233.399975,4.997348999982933,1576.8360384729808,1772.1395884158273
"10.0.2.109",53188,"173.194.122.25",80,8,2033,5,924,3,1109,237233.407373,1.7341160000069067,4262.690615835711,5116.15139930931
"10.0.2.109",53189,"173.194.122.25",80,8,2031,5,923,3,1108,237233.418451,1.7500969999819063,4219.194707536977,5064.862119123479
"10.0.2.109",53190,"173.194.122.13",80,8,2031,5,923,3,1108,237233.441252,2.667905000009341,2767.7147424567765,3322.4571339567806
"10.0.2.109",53191,"173.194.122.13",80,8,2031,5,923,3,1108,237233.462525,1.8236509999842383,4049.0203443881637,4860.579134975174
"10.0.2.109",53192,"173.194.122.13",80,8,2030,5,923,3,1107,237233.503852,1.1379759999981616,6488.71329449121,7782.237938246771
"10.0.2.109",53193,"23.63.68.90",80,8,1473,5,896,3,577,237233.530936,2.1749330000020564,3295.7337076559243,2122.3642291489605
"10.0.2.109",53194,"46.38.51.49",6107,13,2075,7,1268,6,807,237233.637816,3.201314999983879,3168.697863237789,2016.6712741584352
"10.0.2.109",53195,"46.38.51.49",6107,72,12550,31,5436,41,7114,237233.96181,295.251935999986,147.29115950657834,192.75741514529034
"10.0.2.109",53196,"46.38.51.49",6107,19,4965,10,1957,9,3008,237234.055097,6.949653999996372,2252.774022995702,3462.6184267608955
"10.0.2.109",53197,"198.254.74.90",443,13,3666,7,883,6,2783,237234.098333,4.209738000005018,1678.014166200267,5288.690175011714
"10.0.2.109",53198,"207.46.194.3",80,10,1104,5,675,5,429,237234.123215,0.28561600000830367,18906.50383677037,12016.133549591836
"10.0.2.109",53199,"46.38.51.49",6107,18,5297,10,3262,8,2035,237234.15557,4.22333300000173,6179.006012547272,3854.775363437676
"10.0.2.109",53200,"46.38.51.49",6107,13,1308,7,549,6,759,237234.255729,4.125933000002988,1064.486505233318,1471.6671356504341
"10.0.2.109",53201,"31.13.74.1",443,68,12109,32,6434,36,5675,237234.349736,294.8638949999877,174.56189405624636,153.9693423638791
"10.0.2.109",53202,"173.194.122.13",80,8,2031,5,923,3,1108,237234.367028,1.8815159999940079,3924.494928570108,4711.09467048286
"10.0.2.109",53203,"173.194.122.13",80,8,2031,5,923,3,1108,237234.386987,3.3239440000033937,2221.4574012054536,2666.7115932130473
"10.0.2.109",53204,"173.194.122.13",80,10,2147,6,985,4,1162,237234.396421,3.744124999997439,2104.630587922516,2482.8230895085926
"10.0.2.109",53205,"173.194.122.13",80,8,2031,5,923,3,1108,237234.407464,1.8800020000198856,3927.655396069736,4714.888601132468
"10.0.2.109",53206,"173.194.122.13",80,8,2030,5,923,3,1107,237234.407774,1.7339740000024904,4258.426020222561,5107.343016669962
"10.0.2.109",53207,"173.194.122.13",80,9,2092,6,985,3,1107,237234.408352,3.4820640000107232,2263.025607793462,2543.319134850114
"10.0.2.109",53208,"207.46.194.3",80,10,1104,5,675,5,429,237234.430797,0.3066140000009909,17611.720273642262,11193.226662803749
"10.0.2.109",53209,"173.194.122.13",80,8,2031,5,923,3,1108,237234.446373,1.7303489999903832,4267.347223040577,5122.6660055568345
"10.0.2.109",53210,"173.194.122.13",80,8,2031,5,923,3,1108,237234.467748,2.35294400001294,3138.196234147261,3767.1954793447076
"10.0.2.109",53211,"23.63.68.90",80,8,1411,5,834,3,577,237234.489436,1.7582530000072438,3794.675737776368,2625.333214264945
"10.0.2.109",53212,"173.194.122.13",80,8,2030,5,923,3,1107,237234.507233,0.5575189999944996,13244.391671087173,15884.660433254063
"10.0.2.109",53213,"173.194.122.13",80,9,2351,6,1198,3,1153,237234.672613,3.726425000000745,2571.9020240573964,2475.2946859250237
"10.0.2.109",53214,"173.194.122.25",80,8,2289,5,1135,3,1154,237235.094814,0.7575070000020787,11986.687911761981,12187.346123500729
"10.0.2.109",53215,"173.194.122.13",80,8,2290,5,1135,3,1155,237235.105348,2.660405999980867,3413.0129010629585,3473.1540975574603
"10.0.2.109",53216,"173.194.122.25",80,12,4399,7,2146,5,2253,237235.122068,2.405073000001721,7138.244868237976,7494.159220941361
"10.0.2.109",53217,"173.194.122.25",80,13,2570,7,1252,6,1318,237235.144341,7.247846999991452,1381.9276262332542,1454.7768461465087
"10.0.2.109",53218,"173.194.122.13",80,12,4402,7,2147,5,2255,237235.190869,1.4172679999901447,12119.091096475357,12728.714682138767
"10.0.2.109",53219,"173.194.122.25",80,7,1256,5,1144,2,112,237235.28855,3.1064619999960996,2946.1168364562295,288.43101895375673
"10.0.2.109",53220,"173.194.122.9",80,8,2191,5,1144,3,1047,237235.308613,1.2750320000050124,7177.859065469746,6569.246889464008
"10.0.2.109",53221,"173.194.122.13",80,8,2031,5,923,3,1108,237235.428728,0.733806000003824,10062.605102658632,12079.486948803646
"10.0.2.109",53222,"173.194.122.13",80,8,2031,5,923,3,1108,237235.449198,1.7011700000148267,4340.542097459775,5210.531575282156
"10.0.2.109",53223,"173.194.122.13",80,13,2308,7,1039,6,1269,237235.44958,3.6486510000249837,2278.102235577775,2782.3982068798814
"10.0.2.109",53224,"173.194.122.25",80,8,2290,5,1135,3,1155,237235.49907,2.671392999996897,3398.9757403761064,3458.8695860215003
"10.0.2.109",53225,"173.194.122.25",80,13,2570,7,1252,6,1318,237235.49928,3.653221000015037,2741.690141373537,2886.2201328516944
"10.0.2.109",53226,"173.194.122.13",80,8,2292,5,1136,3,1156,237235.535356,2.846581999998307,3192.6008103772897,3248.8085711233684
"10.0.2.109",53227,"178.255.83.1",80,12,1982,6,780,6,1202,237235.562169,0.7760159999888856,8041.07131823232,12391.497082711856
"10.0.2.109",53228,"46.38.51.49",6107,30,11105,16,7834,14,3271,237235.622233,73.12812199999462,857.0164019801385,357.83771392354265
"10.0.2.109",53229,"173.194.122.13",80,12,4397,7,2145,5,2252,237235.708028,2.6722219999937806,6421.6221556592,6741.954822631477
"10.0.2.109",53230,"54.246.196.171",80,30,6437,16,4118,14,2319,237235.728495,104.70387900000787,314.6397279130177,177.1854125862768
"10.0.2.109",53231,"173.194.122.17",80,9,3044,5,1270,4,1774,237235.883234,0.7308559999801219,13901.507274040763,19418.3259087782
"10.0.2.109",53232,"46.38.51.49",6107,13,2075,7,1268,6,807,237236.043901,4.690883000002941,2162.492647971318,1376.2867246946794
"10.0.2.109",53233,"173.194.122.13",80,8,1856,5,984,3,872,237236.111794,1.1576399999903515,6800.041463724137,6026.053004438463
"10.0.2.109",53234,"173.194.122.25",80,8,2292,5,1136,3,1156,237236.144093,1.5494639999815263,5865.254049212084,5968.515564163002
"10.0.2.109",53235,"173.194.122.13",80,10,3299,6,2090,4,1209,237236.165654,2.231765999982599,7491.824859833138,4333.787682075725
"10.0.2.109",53236,"173.194.122.13",80,12,4152,7,2105,5,2047,237236.198511,2.176593000011053,7736.862151038106,7523.68495162708
"10.0.2.109",53237,"173.194.122.13",80,8,2292,5,1136,3,1156,237236.250132,1.7485250000027008,5197.523627049062,5289.029324708377
"10.0.2.109",53238,"173.194.122.11",80,9,3211,5,708,4,2503,237236.270878,0.6919639999978244,8185.396928189628,28937.921626071526
"10.0.2.109",53239,"173.194.122.16",80,9,3047,5,1271,4,1776,237236.318459,2.065093999990495,4923.746812516428,6880.074224255843
"10.0.2.109",53240,"173.194.122.19",80,9,3053,5,1273,4,1780,237236.413271,1.9680419999931473,5174.686312606876,7235.617939073243
"10.0.2.109",53241,"23.63.92.101",80,9,2978,5,933,4,2045,237236.625972,1.752448999992339,4259.182435570239,9335.507053313118
"10.0.2.109",53242,"173.194.122.9",80,8,1763,5,1186,3,577,237236.631419,0.7097609999764245,13367.880174192656,6503.597690142633
"10.0.2.109",53243,"108.162.232.196",80,20,8571,10,1591,10,6980,237236.761992,8.231020999985049,1546.3452225456745,6784.0915483147755
"10.0.2.109",53244,"173.194.122.19",80,6,1330,4,1218,2,112,237236.841854,1.5459609999961685,6302.875687047829,579.57477582049
"10.0.2.109",53245,"46.38.51.49",6107,9,506,5,286,4,220,237236.971781,1.936959000013303,1181.233056551164,908.6408127316646
"10.0.2.109",53246,"173.194.122.31",80,8,1602,5,1057,3,545,237236.993736,0.734907000005478,11506.217793458178,5932.7234602031285
"10.0.2.109",53247,"46.38.51.49",6107,13,2083,7,1268,6,815,237237.058645,0.919118999998318,11036.655754062927,7093.749558013632
"10.0.2.109",53248,"173.194.122.13",80,8,2292,5,1136,3,1156,237237.153212,1.244951000000583,7299.8856983092055,7428.404812716058
"10.0.2.109",53249,"178.255.83.1",80,12,1986,6,784,6,1202,237237.183397,0.2907050000212621,21575.136304987074,33078.206426778655
"10.0.2.109",53250,"178.255.83.1",80,13,2044,7,842,6,1202,237237.186545,3.304991999990307,2038.1289879127562,2909.5380563790177
"10.0.2.109",53251,"173.194.122.19",80,9,3047,5,1271,4,1776,237237.291087,0.7340130000084173,13852.615689209044,19356.605400499815
"10.0.2.109",53252,"173.194.122.17",80,7,2002,4,934,3,1068,237237.362807,1.0285239999939222,7264.779431538937,8307.04971400812
"10.0.2.109",53253,"23.63.92.101",80,9,2783,5,922,4,1861,237237.564795,0.9052769999834709,8147.7823916156885,16445.795044248152
"10.0.2.109",53254,"173.194.122.19",80,15,3374,7,1380,8,1994,237237.696677,1.2265429999970365,9000.907428460865,13005.65899445722
"10.0.2.109",53255,"173.194.122.19",80,16,3436,8,1442,8,1994,237237.714004,3.227560999977868,3574.2159482281218,4942.431761974254
"10.0.2.109",53256,"173.194.122.13",80,8,2292,5,1136,3,1156,237237.730973,0.6476869999896735,14031.46890418504,14278.501807427734
"10.0.2.109",53257,"173.194.122.19",80,12,3212,6,1326,6,1886,237237.76811,1.0237039999919944,10362.37037276689,14738.635386906755
"10.0.2.109",53258,"173.194.122.17",80,15,3371,7,1379,8,1992,237237.892784,1.2261890000081621,8996.9817050443,12996.36516058611
"10.0.2.109",53259,"173.194.122.16",80,16,3433,8,1441,8,1992,237238.001659,3.2278560000122525,3571.410868377103,4937.023212912692
"10.0.2.109",53260,"173.194.122.17",80,15,3374,7,1380,8,1994,237238.142809,1.2273259999928996,8995.165098811456,12997.361744224669
"10.0.2.109",53261,"173.194.122.31",80,6,1116,4,1004,2,112,237238.204147,0.1942659999767784,41345.3718147288,4612.232712400026
"10.0.2.109",53262,"46.38.51.49",6107,10,568,6,348,4,220,237238.206336,3.121848000009777,891.7794844564121,563.7686395988812
"10.0.2.109",53263,"95.100.72.163",80,36,34255,11,1832,25,32423,237238.491424,2.1823980000044685,6715.548676258863,118852.74821525172
"10.0.2.109",53264,"46.38.51.49",6107,15,5002,8,3975,7,1027,237239.915171,117.28088800000842,271.14392244367826,70.05403983639185
"10.0.2.109",53265,"46.38.51.49",6107,14,3004,8,2014,6,990,237240.293284,115.90026399999624,139.0160767882334,68.33461570027362
"10.0.2.109",53266,"46.38.51.49",6107,16,5835,9,4807,7,1028,237240.389226,118.80411200001254,323.6924998016562,69.22319321741264
"10.0.2.109",53267,"23.63.92.101",80,9,2689,5,903,4,1786,237240.439899,115.7532760000031,62.4086008589494,123.43495142201952
"10.0.2.109",53268,"23.63.92.101",80,23,15797,9,1812,14,13985,237240.696418,4.463893000007374,3247.389666368807,25063.324770512012
"10.0.2.109",53269,"46.38.51.49",6107,12,2773,6,1798,6,975,237240.721452,117.4708249999967,122.44742471162866,66.39946556943156
"10.0.2.109",53270,"46.38.51.49",6107,17,7381,10,6336,7,1045,237240.814865,116.38186100000166,435.53178789604743,71.83249973979949
"10.0.2.109",53271,"46.38.51.49",6107,528,484464,362,437429,166,47035,237240.915029,216.0828829999955,16194.85982145135,1741.368843176754
"10.0.2.109",53272,"23.63.92.101",80,13,7120,6,958,7,6162,237240.940646,116.25564600000507,65.92367995615169,424.0310186741197
"10.0.2.109",53273,"23.63.92.101",80,11,4741,6,940,5,3801,237241.058263,116.1371639999852,64.75102147320351,261.8283325740921
"10.0.2.109",53274,"23.63.92.101",80,57,54163,18,1637,39,52526,237241.310971,10.459243999997852,1252.0981439961329,40175.75266434996
"10.0.2.109",53275,"46.38.51.49",6107,382,383114,279,371670,103,11444,237241.565555,216.43118799998774,13738.130938874523,423.0074271920791
"10.0.2.109",53276,"46.38.51.49",6107,16,4495,9,3436,7,1059,237241.656407,117.53570199999376,233.86936507174184,72.08022631285641
"10.0.2.109",53277,"23.63.92.101",80,63,59782,18,2963,45,56819,237241.725153,72.56776899998658,326.6463931115807,6263.827678098854
"10.0.2.109",53278,"46.38.51.49",6107,14,3229,8,2228,6,1001,237241.733724,119.46053599999868,149.20408527214542,67.03469001679423
"10.0.2.109",53279,"23.63.92.101",80,12,5574,6,941,6,4633,237241.78232,117.41065100001288,64.11684064335164,315.6783450591372
"10.0.2.109",53280,"23.63.92.101",80,11,4180,6,972,5,3208,237241.78978,117.4019580000022,66.23398904471298,218.59942063316797
"10.0.2.109",53281,"46.38.51.49",6107,16,6027,9,4371,7,1656,237241.794145,119.39905900001759,292.8666297110001,110.95564831878657
"10.0.2.109",53282,"23.63.92.101",80,9,2566,5,888,4,1678,237241.8426,116.34934499999508,61.057498862587494,115.37667014799754
"10.0.2.109",53283,"46.38.51.49",6107,32,20898,19,18866,13,2032,237241.886631,185.49352399999043,813.6564379466304,87.63648266233186
"10.0.2.109",53284,"46.38.51.49",6107,14,3192,8,2195,6,997,237241.986957,117.20288400002755,149.8256646994785,68.05293289538955
"10.0.2.109",53285,"23.63.92.101",80,25,20475,9,1783,16,18692,237242.011799,185.36673000000883,76.95016252376746,806.7035546238145
"10.0.2.109",53286,"46.38.51.49",6107,15,4672,8,3618,7,1054,237242.087171,116.10104000000865,249.30009240225448,72.62639507793705
"10.0.2.109",53287,"23.63.92.101",80,9,2877,5,910,4,1967,237242.112509,117.07698099999106,62.181309577845674,134.40729224134333
"10.0.2.109",53288,"46.38.51.49",6107,48,37356,31,35108,17,2248,237242.187243,185.1889010000159,1516.6351681085675,97.11165141586135
"10.0.2.109",53289,"23.63.92.101",80,11,4411,6,967,5,3444,237242.232291,115.95555300000706,66.71521802840722,237.60828427076987
"10.0.2.109",53290,"46.38.51.49",6107,32,21781,20,19803,12,1978,237242.287152,185.08948699999019,855.9319201095868,85.49378063812365
"10.0.2.109",53291,"23.63.92.101",80,39,36825,12,1945,27,34880,237242.312123,185.0614549999882,84.08017758209559,1507.8234416778892
"10.0.2.109",53292,"46.38.51.49",6107,35,21927,21,19030,14,2897,237242.387653,184.9879030000011,822.972732438613,125.2838678862145
"10.0.2.109",53293,"46.38.51.49",6107,38,23710,23,20890,15,2820,237242.487375,184.88958099999581,903.8908471538144,122.01877400544551
"10.0.2.109",53294,"23.63.92.101",80,20,14872,8,1068,12,13804,237242.517517,2.658105999988038,3214.3187668356527,41545.37102752748
"10.0.2.109",53295,"46.38.51.49",6107,33,17528,20,14815,13,2713,237242.588132,184.7924340000027,641.3682499576702,117.4506960604225
"10.0.2.109",53296,"23.63.92.101",80,31,23287,12,2625,19,20662,237242.617523,184.7565220000106,113.66310521908827,894.6693638235436
"10.0.2.109",53297,"23.63.92.101",80,28,21520,10,1837,18,19683,237242.682105,184.69165699998848,79.57045942795844,852.5777642463288
"10.0.2.109",53298,"46.38.51.49",6107,46,35016,30,32823,16,2193,237242.687918,184.6919999999809,1421.7399779093146,94.99057890976228
"10.0.2.109",53299,"23.63.92.101",80,27,17159,11,2572,16,14587,237242.718952,184.66070900001796,111.4259774665871,631.9481855774129
"10.0.2.109",53300,"46.38.51.49",6107,29,15958,17,13974,12,1984,237242.788136,184.58939700000337,605.6252515955614,85.98543718087832
"10.0.2.109",53301,"46.38.51.49",6107,16,5809,9,4762,7,1047,237242.888355,118.30435600000783,322.0168833005395,70.80043612256716
"10.0.2.109",53302,"46.38.51.49",6107,17,6487,10,5440,7,1047,237242.98833,117.2079130000202,371.3059885299084,71.4627518365467
"10.0.2.109",53303,"46.38.51.49",6107,17,6318,10,5271,7,1047,237243.088025,117.10368100000778,360.09115716863926,71.52635961972402
"10.0.2.109",53304,"23.63.92.101",80,12,6172,6,960,6,5212,237243.112697,117.08318099999451,65.59439139256355,356.1228832687929
"10.0.2.109",53305,"23.63.92.101",80,9,2914,5,914,4,2000,237243.122868,118.07089499998256,61.928894500215996,135.51180415802187
"10.0.2.109",53306,"46.38.51.49",6107,41,28959,26,26819,15,2140,237243.188715,184.18940900001326,1164.8443912428459,92.94779810058877
"10.0.2.109",53307,"23.63.92.101",80,12,6003,6,960,6,5043,237243.212461,116.97834800000419,65.65317540644124,344.88433705696167
"10.0.2.109",53308,"46.38.51.49",6107,50,37960,33,35712,17,2248,237243.288668,184.0916000000143,1551.923064387391,97.69049755664356
"10.0.2.109",53309,"23.63.92.101",80,32,28428,10,1837,22,26591,237243.312939,184.06194000001415,79.84268773869748,1155.7413770602639
"10.0.2.109",53310,"46.38.51.49",6107,16,5637,9,4590,7,1047,237243.388564,116.804575999995,314.37124518136665,71.70951932568428
"10.0.2.109",53311,"46.38.51.49",6107,42,28020,26,25826,16,2194,237243.488589,184.88587000002735,1117.4894003526038,94.93424240585504
"10.0.2.109",53312,"23.63.92.101",80,11,5322,6,960,5,4362,237243.512828,116.67975700000534,65.82118610342708,299.0750143574468
"10.0.2.109",53313,"46.38.51.49",6107,18,6351,10,5250,8,1101,237243.589284,116.60293800002546,360.19675593415,75.53840538733319
"10.0.2.109",53314,"23.63.92.101",80,36,27659,14,2061,22,25598,237243.61259,184.76144599998952,89.23939683823937,1108.3697623800347
"10.0.2.109",53315,"23.63.92.101",80,38,34539,12,1944,26,32595,237243.665592,183.7127469999832,84.65389720617166,1419.3898042361961
"10.0.2.109",53316,"46.38.51.49",6107,16,5522,9,4475,7,1047,237243.689257,118.50367299999925,302.1003408054721,70.6813534800736
"10.0.2.109",53317,"23.63.92.101",80,13,6036,6,960,7,5076,237243.713203,116.47779600002104,65.93531354249365,348.6329703559352
"10.0.2.109",53318,"95.100.72.163",80,11,5712,6,1569,5,4143,237243.73724,117.45507700002054,106.86638943668484,282.1844814762175
"10.0.2.109",53319,"46.38.51.49",6107,148,97412,86,64599,62,32813,237243.789221,213.20666199998232,2423.9017446839575,1231.2185629547625
"10.0.2.109",53320,"46.38.51.49",6107,57,43899,38,41510,19,2389,237243.889666,183.48997299998882,1809.7991654291661,104.15828008215557
"10.0.2.109",53321,"23.63.92.101",80,22,15535,9,1789,13,13746,237243.911126,183.4631250000093,78.01022685075965,599.4011058080168
"10.0.2.109",53322,"23.63.92.101",80,41,38653,13,1364,28,37289,237243.913307,5.483768999984022,1989.8722940429827,54399.08209132609
"10.0.2.109",53323,"23.63.92.101",80,11,5207,6,960,5,4247,237244.077666,118.11491699999897,65.0214231619878,287.65206684266894
"10.0.2.109",53324,"23.63.92.101",80,40,37375,12,1945,28,35430,237244.214909,183.1638040000107,84.951282186731,1547.46731510328
"10.0.2.109",53325,"23.63.92.101",80,11,5494,6,960,5,4534,237244.279069,116.91269399999874,65.69004388864808,310.24860311576083
"10.0.2.109",53326,"23.63.92.101",80,49,43430,16,2202,33,41228,237244.282349,183.09539000000223,96.21214384480017,1801.3779593248962
"10.0.2.109",53327,"46.38.51.49",6107,25,3482,11,1291,14,2191,237244.892979,63.96348100001342,161.46713466075798,274.03136486577904
"10.0.2.109",53328,"54.246.196.171",80,14,2678,8,1832,6,846,237245.015653,63.73435199999949,229.95448357269117,106.19077134415761
"10.0.2.109",53329,"173.194.122.4",80,8,1685,5,1108,3,577,237245.19186,0.9053580000181682,9790.602170436581,5098.535606806776
"10.0.2.109",53330,"173.194.122.25",80,8,1986,5,1046,3,940,237245.197769,65.13218899999629,128.47718046142248,115.45750442995903
"10.0.2.109",53331,"54.224.225.90",443,25,3257,12,1889,13,1368,237246.033407,62.82302999999956,240.5487287066559,174.20363201201974
"10.0.2.109",53332,"173.194.122.17",80,8,2257,5,1049,3,1208,237246.099682,0.5181929999962449,16194.738254011176,18649.422126640133
"10.0.2.109",53333,"173.194.122.31",80,8,1381,5,836,3,545,237246.649742,3.556691999983741,1880.3989774854201,1225.8581850831984
"10.0.2.109",53334,"23.206.102.19",80,8,2220,5,1580,3,640,237249.419129,0.5920740000146907,21348.682765475893,8647.567702471248
"10.0.2.109",53335,"23.63.92.101",80,8,1504,5,925,3,579,237250.014525,2.4125809999823105,3067.2545295077175,1919.9355379296956
"10.0.2.109",53336,"23.212.207.152",80,28,12333,15,8807,13,3526,237250.243493,60.04207000002498,1173.4438869274609,469.80392248282357
"10.0.2.109",53337,"23.206.102.19",80,8,2220,5,1580,3,640,237251.807963,2.1594420000037644,5853.363970867458,2370.982874275426
"10.0.2.109",53338,"23.206.102.19",80,72,34620,37,24716,35,9904,237252.449156,57.82705300001544,3419.2992681115397,1370.1545537860773
"10.0.2.109",53339,"195.113.232.83",80,284,316198,53,3223,231,312975,237254.019068,16.477270000003045,1564.822327970303,151954.7837717982
"10.0.2.109",53340,"23.206.102.19",80,16,6276,9,4472,7,1804,237270.521606,5.00690599999507,7145.330869010768,2882.418803151929
"10.0.2.109",53341,"23.63.92.101",80,11,4412,6,965,5,3447,237275.575958,1.8908860000083223,4082.7421642373056,14583.639627073568
"10.0.2.109",53342,"23.206.102.19",80,28,12360,15,8814,13,3546,237277.504011,15.65926999997464,4502.891897266871,1811.578700670334
"10.0.2.109",53343,"23.63.92.101",80,12,6555,6,977,6,5578,237293.212131,1.0553389999840874,7406.15100940821,42284.04332699999
"10.0.2.109",53344,"23.206.102.19",80,57,45071,21,10423,36,34648,237294.289272,15.980943000002299,5217.714624223865,17344.658572398395
"10.0.2.109",53345,"46.38.51.49",6107,25,6203,12,4235,13,1968,237309.305122,424.23147900000913,79.8620604012256,37.11181460911735
"10.0.2.109",53346,"54.237.50.81",443,27,6086,13,1774,14,4312,237309.452868,424.08374600001844,33.46508828470729,81.34242428616564
"10.0.2.109",53347,"23.63.92.101",80,12,5491,7,1018,5,4473,237310.307659,119.06735999998637,68.3982579272853,300.5357639575119
"10.0.2.109",53348,"23.63.92.101",80,22,17024,9,1126,13,15898,237310.313092,3.966453000000911,2271.0467009184104,32064.920471759226
"10.0.2.109",53349,"23.63.92.101",80,18,13864,7,1010,11,12854,237310.321058,19.628472000011243,411.64691780365644,5238.920278661584
"10.0.2.109",53350,"23.63.92.101",80,11,5183,6,955,5,4228,237310.332456,117.04092800000217,65.27631086451962,288.99292391119263
"10.0.2.109",53351,"46.38.51.49",6107,28,3644,13,1399,15,2245,237313.411811,28.100838999991538,398.27992324369285,639.1268246476701
"10.0.2.109",53352,"54.237.50.81",443,25,3257,12,1889,13,1368,237313.555756,27.956700000009732,540.5502080000407,391.462511669696
"10.0.2.109",53353,"173.194.122.4",80,8,1678,5,1101,3,577,237314.28301,1.301856999984011,6765.720044604113,3545.7043285527457
"10.0.2.109",53354,"173.194.122.25",80,8,1957,5,1029,3,928,237314.295365,2.195844000001671,3748.900195092974,3380.932343096482
"10.0.2.109",53355,"173.194.122.16",80,8,2217,5,1033,3,1184,237315.588283,0.4828189999971073,17116.14497368478,19618.11776267452
"10.0.2.109",53356,"173.194.122.31",80,8,1365,5,820,3,545,237316.073668,0.8578970000089612,7646.6055947642635,5082.195181886004
"10.0.2.109",53357,"23.206.102.19",80,12,4236,7,3018,5,1218,237316.5273,13.272756999998819,1819.0644189449222,734.135342039402
"10.0.2.109",53358,"23.206.102.19",80,28,12629,15,8787,13,3842,237316.95338,23.478893000021344,2994.008277985512,1309.0906798703013
"10.0.2.109",53359,"195.113.232.83",80,291,316576,57,3439,234,313137,237329.839128,128.15708400000585,214.67404798316684,19547.07396432245
"10.0.2.109",53360,"23.206.102.19",80,12,4294,7,3015,5,1279,237329.986113,10.452938000002177,2307.4852256843938,978.8635501327826
"10.0.2.109",53361,"23.63.92.101",80,9,3150,5,922,4,2228,237340.476749,116.51880399999209,63.30308711373746,152.97101745054997
"10.0.2.109",53362,"23.63.92.101",80,8,1682,5,993,3,689,237340.532057,0.30926400001044385,25686.79186627519,17822.960318090238
"10.0.2.109",53363,"23.206.102.19",80,8,2122,5,1522,3,600,237340.878349,116.11919999998645,104.85776684649413,41.3368331852145
"10.0.2.109",53364,"46.38.51.49",6107,17,2896,9,1549,8,1347,237340.999419,123.00246200000402,100.74595092250752,87.60800251298748
"10.0.2.109",53365,"54.246.196.175",80,8,1090,5,665,3,425,237341.143318,6.951288000011118,765.3257928590343,489.11798791742797
"10.0.2.109",53366,"46.38.51.49",6107,66,43341,35,31530,31,11811,237341.689249,120.31847200001357,2096.4361980924386,785.3158241569868
"10.0.2.109",53367,"23.206.102.19",443,62,42892,24,11231,38,31661,237341.814291,120.19330600000103,747.529151082667,2107.3386566136874
"10.0.2.109",53368,"46.38.51.49",6107,11,1181,6,340,5,841,237341.861681,9.38117899998906,289.94223433996643,717.1806443526816
"10.0.2.109",53369,"46.38.51.49",6107,25,6203,12,4235,13,1968,237341.936579,423.16169400000945,80.06395777402112,37.20563610372457
"10.0.2.109",53370,"54.246.196.175",80,6,864,4,752,2,112,237342.012391,9.229744999989634,651.8056566033792,97.07743821752456
"10.0.2.109",53371,"54.197.0.107",443,27,6086,13,1774,14,4312,237342.080358,423.0176329999813,33.54942889579411,81.54742807140033
"10.0.2.109",53372,"46.38.51.49",6107,77,62124,48,54483,29,7641,237343.834271,119.16786399998819,3657.5632504417736,512.9570837990858
"10.0.2.109",53373,"23.206.102.19",443,69,61459,21,7007,48,54452,237344.003869,118.99807400000282,471.0664476804782,3660.697903396232
"10.0.2.109",53374,"46.38.51.49",6107,34,15904,16,8825,18,7079,237344.029417,117.9698619999981,598.4579349597029,480.0548126435963
"10.0.2.109",53375,"46.38.51.49",6107,30,11721,14,6120,16,5601,237344.089583,117.91702799999621,415.20720824138795,379.99600871895655
"10.0.2.109",53376,"23.206.102.19",443,32,15563,15,6715,17,8848,237344.154221,117.84483699998236,455.8536578060525,600.6542314620928
"10.0.2.109",53377,"46.38.51.49",6107,30,11785,14,6152,16,5633,237344.183636,117.82174499999383,417.71576206075184,382.4760870754576
"10.0.2.109",53378,"23.206.102.19",443,29,11434,14,5291,15,6143,237344.233469,117.7729849999887,359.40330458639613,417.27735779138754
"10.0.2.109",53379,"46.38.51.49",6107,27,9128,13,4973,14,4155,237344.283979,118.7216330000083,335.10320734888495,279.98267173428854
"10.0.2.109",53380,"23.206.102.19",443,29,11498,14,5323,15,6175,237344.307387,117.6976180000056,361.8085117066513,419.7196242323073
"10.0.2.109",53381,"23.206.102.19",443,24,8733,12,3845,12,4888,237344.678872,118.32667100001709,259.95829799010875,330.47494423293927
"10.0.2.109",53382,"46.38.51.49",6107,36,16787,18,14631,18,2156,237347.186336,4.055452000000514,28861.887651483772,4253.040105023512
"10.0.2.109",53383,"80.252.88.135",443,31,16286,13,1686,18,14600,237347.331154,3.9105639999907,3449.118848338009,29867.814463662475
"10.0.2.109",53384,"46.38.51.49",6107,27,4101,11,1361,16,2740,237348.056492,136.96565800000099,79.49437953271412,160.04011750156994
"10.0.2.109",53385,"46.38.51.49",6107,27,4349,11,1679,16,2670,237348.11617,134.90453299999353,99.56670618325808,158.33419029737885
"10.0.2.109",53386,"93.184.220.29",80,13,1953,7,837,6,1116,237348.116639,15.609290999971563,428.9752814533472,571.9670419377962
"10.0.2.109",53387,"173.194.122.13",443,30,4264,15,2400,15,1864,237348.260192,134.76043900000514,142.47504788849247,110.65562052672915
"10.0.2.109",53388,"173.194.116.254",443,29,3968,14,2422,15,1546,237348.4778,136.54426700001932,141.90269885148132,90.57868390767553
"10.0.2.109",53389,"46.38.51.49",6107,27,4606,11,1988,16,2618,237349.992666,135.02882300000056,117.78226045856842,155.10762468839644
"10.0.2.109",53390,"173.194.122.19",443,29,4493,14,2320,15,2173,237350.136994,134.88452200000756,137.59918280319042,128.88061389281586
"10.0.2.109",53391,"31.28.27.51",80,11,941,6,475,5,466,238326.057565,1620.0090539999946,2.345665902679586,2.301221706628815
"10.0.2.109",53392,"46.38.51.49",6107,18,2436,8,1766,10,670,238326.337127,0.5756129999936093,24544.2684584206,9311.811929298869
"10.0.2.109",53393,"5.101.114.217",80,7,1808,4,336,3,1472,238326.578092,0.3343219999806024,8040.1529069458775,35223.52702090575
"10.0.2.109",53394,"46.38.51.49",6107,9,506,5,286,4,220,238927.039746,0.130899000010686,17479.1251255794,13445.48086583031
"10.0.2.109",53395,"46.38.51.49",6107,9,506,5,286,4,220,239527.297115,0.12195600001723506,18760.864571457372,14431.43428573644
"10.0.2.109",53396,"31.28.27.51",80,17,1925,8,814,9,1111,239946.066902,1620.7199160000018,4.017967531411512,5.483982711791388
"10.0.2.109",53397,"46.38.51.49",6107,18,2436,8,1766,10,670,239947.000634,0.5636539999977686,25065.022159083288,9509.37986782888
"10.0.2.109",53398,"5.101.114.217",80,7,1808,4,336,3,1472,239947.237699,0.3264140000101179,8234.940903014822,36076.88395606493
"10.0.2.109",53399,"46.38.51.49",6107,9,506,5,286,4,220,240547.691844,0.12175900000147521,18791.21871871713,14454.783629782407
"10.0.2.109",53400,"46.38.51.49",6107,9,506,5,286,4,220,241147.940554,0.15134300000499934,15117.977045019725,11629.213111553634
"10.0.2.109",53401,"31.28.27.51",80,11,941,6,475,5,466,241566.787078,1620.0090670000063,2.3456658838564297,2.301221688162308
"10.0.2.109",53402,"46.38.51.49",6107,18,2436,8,1766,10,670,241567.049649,0.564689000020735,25019.081298699337,9491.950436086385
"10.0.2.109",53403,"5.101.114.217",80,7,1808,4,336,3,1472,241567.28687,0.3272960000031162,8212.749315526029,35979.663668018795
"10.0.2.109",53404,"46.38.51.49",6107,9,506,5,286,4,220,242167.741577,0.12149999997927807,18831.2757233763,14485.596710289461
"10.0.2.109",53405,"46.38.51.49",6107,9,506,5,286,4,220,242767.990581,0.12229800000204705,18708.40079119612,14391.077531689323
"10.0.2.109",53406,"31.28.27.51",80,11,941,6,475,5,466,243186.796332,1620.0091810000013,2.3456657187919956,2.3012215262254103
"10.0.2.109",53407,"46.38.51.49",6107,18,2436,8,1766,10,670,243187.0598,0.5699670000176411,24787.3999715119,9404.053216825012
"10.0.2.109",53408,"5.101.114.217",80,7,1808,4,336,3,1472,243187.298555,0.33101900000474416,8120.379796813704,35574.99720508861
"10.0.2.109",53409,"46.38.51.49",6107,9,506,5,286,4,220,243787.769055,0.12211799999931827,18735.97667839936,14412.289752614892
"10.0.2.109",53410,"46.38.51.49",6107,9,506,5,286,4,220,244388.0192,0.12245799999800511,18683.956948809162,14372.274576007048
"10.0.2.109",53411,"31.28.27.51",80,17,1925,8,814,9,1111,244806.805714,1620.5195959999983,4.018464211154165,5.484660612521226
"10.0.2.109",53412,"46.38.51.49",6107,18,2436,8,1766,10,670,244807.522045,0.5542460000142455,25490.486173354206,9670.79600008342
"10.0.2.109",53413,"5.101.114.217",80,7,1808,4,336,3,1472,244807.755771,0.3203370000119321,8391.163056093663,36761.28576955319
"10.0.2.109",53414,"46.38.51.49",6107,9,506,5,286,4,220,245408.203737,0.13986100000329316,16359.099391153552,12583.922608579654
"10.0.2.109",53415,"46.38.51.49",6107,9,506,5,286,4,220,246008.468929,0.1219940000155475,18755.020736334627,14426.939027949713
"10.0.2.109",53416,"31.28.27.51",80,11,941,6,475,5,466,246427.325382,1620.009183999995,2.345665714448204,2.3012215219639223
"10.0.2.109",53417,"46.38.51.49",6107,18,2436,8,1766,10,670,246427.605579,0.5754379999998491,24551.732767046502,9314.643801767359
"10.0.2.109",53418,"5.101.114.217",80,7,1808,4,336,3,1472,246427.846353,0.3344079999951646,8038.085213388637,35214.46855389308
"10.0.2.109",53419,"46.38.51.49",6107,9,506,5,286,4,220,247028.308062,0.12163400001008995,18810.529948946863,14469.638422266818
"10.0.2.109",53420,"46.38.51.49",6107,15,1179,7,616,8,563,247455.211305,0.37354999998933636,13192.343729462396,12057.2881813106
"10.0.2.109",53421,"80.78.242.47",80,10,875,5,391,5,484,247455.456569,0.1282249999931082,24394.61883539187,30196.919479104003
"10.0.2.109",53422,"46.38.51.49",6107,18,1672,8,1000,10,672,247455.772169,0.5277939999941736,15157.428845512288,10185.792184184258
"10.0.2.109",53423,"217.23.10.139",80,7,1044,4,338,3,706,247456.018179,0.281594000000041,9602.477325509799,20057.24553789917
"10.0.2.109",53424,"46.38.51.49",6107,19,2739,9,2064,10,675,247456.363104,0.5954920000222046,27728.332201581725,9068.131897319605
"10.0.2.109",53425,"37.187.78.159",80,9,2165,5,395,4,1770,247456.608664,0.34967100000358187,9037.066270773472,40495.20835257986
"10.0.2.109",53426,"31.28.27.51",80,17,1925,8,814,9,1111,248047.335012,1620.470061,4.018587048736595,5.484828269221569
"10.0.2.109",53427,"46.38.51.49",6107,18,2436,8,1766,10,670,248048.010872,0.5654829999839421,24983.951772911278,9478.622699802127
"10.0.2.109",53428,"5.101.114.217",80,7,1808,4,336,3,1472,248048.249427,0.32669499999610707,8227.857787942976,36045.85316622637
"10.0.2.109",53429,"46.38.51.49",6107,9,506,5,286,4,220,248648.703197,0.1214719999989029,18835.616438526282,14488.935721943293
"10.0.2.109",53430,"46.38.51.49",6107,9,506,5,286,4,220,249248.952066,0.12199499999405816,18754.86700365948,14426.820772045754
"10.0.2.109",53431,"31.28.27.51",80,11,941,6,475,5,466,249667.805268,1620.0080360000138,2.3456673766771163,2.301223152697971
"10.0.2.109",53432,"46.38.51.49",6107,18,2436,8,1766,10,670,249668.079485,0.5714239999942947,24724.197793829204,9380.075040693979
"10.0.2.109",53433,"5.101.114.217",80,7,1808,4,336,3,1472,249668.319203,0.3315180000208784,8108.157022637428,35521.44981345921
"10.0.2.109",53434,"46.38.51.49",6107,9,506,5,286,4,220,250268.777949,0.12161199998809025,18813.93283741793,14472.256028783024
"10.0.2.109",53435,"46.38.51.49",6107,9,506,5,286,4,220,250869.026805,0.12412100000074133,18433.625252667433,14179.711732821102
"10.0.2.109",53436,"46.38.51.49",6107,17,1287,8,670,9,617,250921.829293,0.37290800001937896,14373.518400574554,13236.508736051494
"10.0.2.109",53437,"80.78.242.47",80,10,875,5,391,5,484,250922.075006,0.12707799999043345,24614.803508360837,30469.47544257454
"10.0.2.109",53438,"46.38.51.49",6107,18,1672,8,1000,10,672,250922.388466,0.5276069999963511,15162.801100166085,10189.40233931161
"10.0.2.109",53439,"217.23.10.139",80,7,1044,4,338,3,706,250922.633917,0.28194000001531094,9590.693054739155,20032.631055165217
"10.0.2.109",53440,"46.38.51.49",6107,19,2735,9,2060,10,675,250922.979197,0.6010769999993499,27417.452339746527,8983.873946276168
"10.0.2.109",53441,"37.187.78.159",80,9,2161,5,395,4,1766,250923.230737,0.3493049999815412,9046.535263357204,40446.028544528664
"10.0.2.109",53442,"31.28.27.51",80,17,1925,8,814,9,1111,251287.813472,1620.6998329999915,4.018017320299208,5.484050666894865
"10.0.2.109",53443,"46.38.51.49",6107,18,2436,8,1766,10,670,251288.716311,0.5555659999954514,25429.921917676154,9647.818621088914
"10.0.2.109",53444,"5.101.114.217",80,7,1808,4,336,3,1472,251288.950718,0.3208909999812022,8376.676192717974,36697.819510954934
"10.0.2.109",53445,"46.38.51.49",6107,9,506,5,286,4,220,251889.39964,0.12207900002249517,18741.96216858261,14416.893975832778
"10.0.2.109",53446,"46.38.51.49",6107,9,506,5,286,4,220,252489.648766,0.12351199999102391,18524.515837864157,14249.627567587813
"10.0.2.109",53447,"31.28.27.51",80,11,941,6,475,5,466,252908.513558,1620.0093340000021,2.345665497258175,2.301221308889073
"10.0.2.109",53448,"46.38.51.49",6107,18,2436,8,1766,10,670,252908.779861,0.835441000002902,16910.82913090323,6415.773226333615
"10.0.2.109",53449,"5.101.114.217",80,7,1808,4,336,3,1472,252909.02003,0.5951079999795184,4516.827197907795,19788.004867024625
"10.0.2.109",53450,"46.38.51.49",6107,9,506,5,286,4,220,253509.742503,0.1214730000065174,18835.461377238084,14488.816444029297
"10.0.2.109",53451,"46.38.51.49",6107,9,506,5,286,4,220,254109.991237,0.12536499998532236,18250.7079349729,14039.006103825306
"10.0.2.109",53452,"31.28.27.51",80,17,1925,8,814,9,1111,254528.523222,1621.681666999997,4.015584644332057,5.480730392939699
"10.0.2.109",53453,"46.38.51.49",6107,18,2436,8,1766,10,670,254530.421559,0.5685249999805819,24850.270437505023,9427.905545372801
"10.0.2.109",53454,"5.101.114.217",80,7,1808,4,336,3,1472,254530.661066,0.32883499999297783,8174.312345271645,35811.273131666254
"10.0.2.109",53455,"46.38.51.49",6107,9,506,5,286,4,220,255131.117991,0.12302899998030625,18597.241303808445,14305.570233698805
"10.0.2.109",53456,"46.38.51.49",6107,9,506,5,286,4,220,255731.369553,0.12166599999181926,18805.58249760692,14465.832690466861
"10.0.2.109",53457,"46.38.51.49",6107,15,1179,7,616,8,563,255841.297008,0.374180000013439,13170.13202154847,12036.98754566849
"10.0.2.109",53458,"80.78.242.47",80,10,875,5,391,5,484,255841.543531,0.12767700001131743,24499.32250697252,30326.527093029923
"10.0.2.109",53459,"46.38.51.49",6107,18,1672,8,1000,10,672,255841.858791,0.5281799999938812,15146.351622728384,10178.348290473474
"10.0.2.109",53460,"217.23.10.139",80,7,1044,4,338,3,706,255842.105156,0.2816279999969993,9601.3180508643,20054.82409440886
"10.0.2.109",53461,"46.38.51.49",6107,19,2739,9,2064,10,675,255842.449843,0.6034959999960847,27360.579026384807,8947.863780431077
"10.0.2.109",53462,"37.187.78.159",80,9,2165,5,395,4,1770,255842.701564,0.35162600001785904,8986.821224367663,40270.05966362219
"10.0.2.109",53463,"31.28.27.51",80,11,941,6,475,5,466,256150.204923,1620.0092779999832,2.3456655783424716,2.301221388437035
"10.0.2.109",53464,"46.38.51.49",6107,18,2436,8,1766,10,670,256150.472555,0.5702910000109114,24773.31748130286,9398.710482713996
"10.0.2.109",53465,"5.101.114.217",80,7,1808,4,336,3,1472,256150.713557,0.32909499999368563,8167.854267161685,35782.98059899405
"10.0.2.109",53466,"46.38.51.49",6107,9,506,5,286,4,220,256751.169497,0.12295600000652485,18608.282636704054,14314.063566695428
"10.0.2.109",53467,"46.38.51.49",6107,9,506,5,286,4,220,257351.420203,0.12208200001623482,18741.501611177202,14416.53970090554
"10.0.2.109",53468,"31.28.27.51",80,11,941,6,475,5,466,257770.214566,1620.0285569999833,2.3456376639662158,2.3011940029647504
"10.0.2.109",53469,"46.38.51.49",6107,18,2436,8,1766,10,670,257770.484854,0.5701199999894015,24780.7479131808,9401.529502735637
"10.0.2.109",53470,"5.101.114.217",80,7,1808,4,336,3,1472,257770.725225,0.32958099999814294,8155.809952682787,35730.215030800784
"10.0.2.109",53471,"46.38.51.49",6107,9,506,5,286,4,220,258371.177315,0.12258299998939037,18664.904596869284,14357.618920668681
"10.0.2.109",53472,"46.38.51.49",6107,9,506,5,286,4,220,258971.427155,0.12209299998357892,18739.813095818172,14415.240842937055
"10.0.2.109",53473,"46.38.51.49",6107,15,1179,7,616,8,563,259202.703499,0.3788090000161901,13009.19460675269,11889.897018834034
"10.0.2.109",53474,"80.78.242.47",80,10,875,5,391,5,484,259202.948274,0.13398099999176338,23346.59392146869,28899.620097163293
"10.0.2.109",53475,"46.38.51.49",6107,18,1672,8,1000,10,672,259203.269498,0.5273480000032578,15170.248109314112,10194.406729459084
"10.0.2.109",53476,"217.23.10.139",80,7,1044,4,338,3,706,259203.515929,0.2807430000102613,9631.584758662433,20118.043904188395
"10.0.2.109",53477,"46.38.51.49",6107,19,2739,9,2064,10,675,259203.860068,0.6023620000050869,27412.08774766761,8964.708929106413
"10.0.2.109",53478,"37.187.78.159",80,9,2165,5,395,4,1770,259204.108461,0.3537019999930635,8934.074447025945,40033.700686673226
"10.0.2.109",53479,"31.28.27.51",80,17,1925,8,814,9,1111,259390.243383,1622.2941630000132,4.014068563223911,5.478661147102906
"10.0.2.109",53480,"46.38.51.49",6107,18,2436,8,1766,10,670,259392.744328,0.5690330000070389,24828.0855413047,9419.488852023867
"10.0.2.109",53481,"5.101.114.217",80,7,1808,4,336,3,1472,259392.983156,0.3300279999966733,8144.763474696374,35681.82093676507
"10.0.2.109",53482,"46.38.51.49",6107,9,506,5,286,4,220,259993.441352,0.12164900000789203,18808.21050605895,14467.85423542996
"10.0.2.109",53483,"46.38.51.49",6107,9,506,5,286,4,220,260593.690192,0.12252499998430721,18673.740055442096,14364.415427263151
"10.0.2.109",53484,"31.28.27.51",80,11,941,6,475,5,466,261012.537966,1620.0065899999754,2.34566947039398,2.30122520674441
"10.0.2.109",53485,"46.38.51.49",6107,18,2436,8,1766,10,670,261012.840835,0.5934569999808446,23806.274086338217,9031.825389494114
"10.0.2.109",53486,"5.101.114.217",80,7,1808,4,336,3,1472,261013.094628,0.3394760000228416,7918.085519503995,34688.7556092556
"10.0.2.109",53487,"46.38.51.49",6107,9,506,5,286,4,220,261613.567301,0.21383500000229105,10699.838660534926,8230.645123488406
"10.0.2.109",53488,"46.38.51.49",6107,9,506,5,286,4,220,262213.90824,0.12248699995689094,18679.533344806037,14368.871803696951
"10.0.2.109",53489,"31.28.27.51",80,23,2875,10,1138,13,1737,262632.544803,1621.0506569999852,5.616110737000913,8.572218233893308
"10.0.2.109",53490,"194.247.12.49",495,392,22748,195,10542,197,12206,262634.11349,67032.85952599999,1.2581292308929273,1.4567184018477586
"10.0.2.109",53491,"194.247.12.49",16455,18,2448,8,1775,10,673,262634.489158,0.6239070000010543,22759.80234229782,8629.491254290948
"10.0.2.109",53492,"5.101.114.217",80,7,1820,4,339,3,1481,262634.777261,0.3356490000151098,8079.869148658017,35298.77937806054
"10.0.2.109",53493,"194.247.12.49",16455,9,506,5,286,4,220,263235.191181,0.16270900005474687,14061.914210216732,10816.857084782101
"10.0.2.109",53494,"194.247.12.49",16455,9,506,5,286,4,220,263835.433709,0.16393899999093264,13956.41061691573,10735.700474550562
"10.0.2.109",53495,"194.247.12.49",16455,15,1182,7,616,8,566,264045.294586,0.40654900000663474,12121.540084761189,11137.648844114989
"10.0.2.109",53496,"80.78.242.47",80,10,878,5,394,5,484,264045.578054,0.12309599999571219,25606.031066076834,31455.124456805042
"10.0.2.109",53497,"194.247.12.49",16455,18,1675,8,1000,10,675,264045.866997,0.5736109999706969,13946.733937125828,9414.045407559934
"10.0.2.109",53498,"217.23.10.139",80,7,1047,4,341,3,706,264046.159217,0.28122100001201034,9700.555790227234,20083.84864486929
"10.0.2.109",53499,"194.247.12.49",16455,19,2751,9,2073,10,678,264046.483348,0.6800670000375248,24385.832571033334,7975.6847482685
"10.0.2.109",53500,"37.187.78.159",80,9,2177,5,398,4,1779,264046.787362,0.37588300002971664,8470.720941751233,37862.84561652121
"10.0.2.109",53501,"31.28.27.51",80,11,944,6,478,5,466,264253.595706,1620.0086829999927,2.3604811752728225,2.301222233634174
"10.0.2.109",53502,"194.247.12.49",16455,18,2448,8,1775,10,673,264253.843323,0.6141729999799281,23120.52141735972,8766.259669793291
"10.0.2.109",53503,"5.101.114.217",80,7,1820,4,339,3,1481,264254.126842,0.33035399997606874,8209.375397895774,35864.55741676591
"10.0.2.109",53504,"194.247.12.49",16455,9,506,5,286,4,220,264854.537021,0.16474099998595193,13888.467352966816,10683.436425359088
"10.0.2.109",53505,"194.247.12.49",16455,9,506,5,286,4,220,265454.781775,0.16762300004484132,13649.678143142233,10499.752417801717
"10.0.2.109",53506,"31.28.27.51",80,11,944,6,478,5,466,265873.604589,1620.0087289999938,2.3604811082471735,2.3012221682911775
"10.0.2.109",53507,"194.247.12.49",16455,18,2448,8,1775,10,673,265873.848353,0.6238390000071377,22762.28321704403,8630.431890180638
"10.0.2.109",53508,"5.101.114.217",80,7,1820,4,339,3,1481,265874.137209,0.33474500000011176,8101.689345618589,35394.10596124227
"10.0.2.109",53509,"194.247.12.49",16455,9,506,5,286,4,220,266474.549423,1.1651239999919198,1963.739481819847,1510.568832169113
"10.0.2.109",53510,"194.247.12.49",16455,9,506,5,286,4,220,267075.79247,0.16793400002643466,13624.40005978446,10480.307738295738
"10.0.2.109",53511,"31.28.27.51",80,17,1928,8,817,9,1111,267493.613546,1620.6902129999944,4.032849675757265,5.484083218808227
"10.0.2.109",53512,"194.247.12.49",16455,18,2448,8,1775,10,673,267494.498226,0.6252390000154264,22711.315192509817,8611.107112427666
"10.0.2.109",53513,"5.101.114.217",80,7,1820,4,339,3,1481,267494.786359,0.3368459999910556,8051.1569087120315,35173.34330915197
"10.0.2.109",53514,"194.247.12.49",16455,9,506,5,286,4,220,268095.201529,0.16876899998169392,13556.992103100541,10428.455463923494
"10.0.2.109",53515,"194.247.12.49",16455,15,1182,7,616,8,566,268625.320339,0.424600999976974,11606.190282800191,10664.129383222255
"10.0.2.109",53516,"80.78.242.47",80,10,878,5,394,5,484,268625.617024,0.1278110000421293,24661.414111156566,30294.732055329383
"10.0.2.109",53517,"194.247.12.49",16455,18,1675,8,1000,10,675,268625.907741,0.5558689999743365,14391.880101911325,9714.519068790145
"10.0.2.109",53518,"217.23.10.139",80,7,1047,4,341,3,706,268626.190894,0.27257999998982996,10008.071025393581,20720.52241621076
"10.0.2.109",53519,"194.247.12.49",16455,19,2751,9,2073,10,678,268626.503529,0.6553770000464283,25304.519381707254,8276.15250400266
"10.0.2.109",53520,"37.187.78.159",80,9,2177,5,398,4,1779,268626.793263,0.36522599996533245,8717.88974580733,38967.652909023214
"10.0.2.109",53521,"31.28.27.51",80,11,944,6,478,5,466,269114.303947,1620.0090830000117,2.3604805924412045,2.301221665434312
"10.0.2.109",53522,"194.247.12.49",16455,18,2448,8,1775,10,673,269114.567273,0.6331650000065565,22427.01349546004,8503.312722504004
"10.0.2.109",53523,"5.101.114.217",80,7,1820,4,339,3,1481,269114.862087,0.3381679999874905,8019.682524958963,35035.84017541069
"10.0.2.109",53524,"194.247.12.49",16455,9,506,5,286,4,220,269715.291134,0.1647440000087954,13888.214441059143,10683.241877737802
"10.0.2.109",53525,"194.247.12.49",16455,9,506,5,286,4,220,270315.524501,0.1644479999667965,13913.21269010245,10702.471300078807
"10.0.2.109",53526,"31.28.27.51",80,17,1928,8,817,9,1111,270734.313201,1620.4612110000453,4.033419594145298,5.484858224107008
"10.0.2.109",53527,"194.247.12.49",16455,18,2448,8,1775,10,673,270734.965564,0.6133709999849088,23150.752155464426,8777.721803170456
"10.0.2.109",53528,"5.101.114.217",80,7,1820,4,339,3,1481,270735.248136,0.33058100001653656,8203.738266459168,35839.93030273165
"10.0.2.109",53529,"194.247.12.49",16455,9,506,5,286,4,220,271335.658877,0.16442500002449378,13915.158884957671,10703.968373044363
"10.0.2.109",53530,"194.247.12.49",16455,9,506,5,286,4,220,271935.90257,0.16437200002837926,13919.645679343019,10707.419753340784
"10.0.2.109",53531,"31.28.27.51",80,11,944,6,478,5,466,272354.774685,1620.0077440000023,2.3604825434710976,2.3012235674843753
"10.0.2.109",53532,"194.247.12.49",16455,18,2448,8,1775,10,673,272355.033427,0.6390480000409298,22220.55307127245,8425.032234910626
"10.0.2.109",53533,"5.101.114.217",80,7,1820,4,339,3,1481,272355.319906,0.3523760000243783,7696.32438024263,33623.17524229892
"10.0.2.109",53534,"194.247.12.49",16455,9,506,5,286,4,220,272955.750911,0.1633600000059232,14005.87659106905,10773.75122389927
"10.0.2.109",53535,"194.247.12.49",16455,9,506,5,286,4,220,273555.994223,0.16910999995889142,13529.655257265596,10407.427120973534
"10.0.2.109",53536,"31.28.27.51",80,17,1928,8,817,9,1111,273974.78289,1620.4990560000297,4.033325398000034,5.48473013118487
"10.0.2.109",53537,"194.247.12.49",16455,18,2448,8,1775,10,673,273975.469157,0.67978199996287,20889.049725905672,7920.186177765925
"10.0.2.109",53538,"5.101.114.217",80,7,1820,4,339,3,1481,273975.756962,0.39182100002653897,6921.5279421376335,30238.297587922818
"10.0.2.109",53539,"194.247.12.49",16455,9,506,5,286,4,220,274576.226545,0.16390000004321337,13959.731539943581,10738.255030725832
"10.0.2.109",53540,"194.247.12.49",16455,9,506,5,286,4,220,275176.47042,0.16340699995635077,14001.848149780424,10770.652422908019
"10.0.2.109",53541,"31.28.27.51",80,11,944,6,478,5,466,275595.282119,1620.0088589999941,2.360480918826885,2.30122198362621
"10.0.2.109",53542,"194.247.12.49",16455,18,2448,8,1775,10,673,275595.544494,0.6464360000099987,21966.59839455161,8328.744067342666
"10.0.2.109",53543,"5.101.114.217",80,7,1820,4,339,3,1481,275595.832108,0.3585200000088662,7564.4315517486675,33046.97087946837
"10.0.2.109",53544,"194.247.12.49",16455,9,506,5,286,4,220,276196.267788,0.16856199997710064,13573.640561400716,10441.261970308244
"10.0.2.109",53545,"194.247.12.49",16455,9,506,5,286,4,220,276796.51405,0.163025000016205,14034.657259761192,10795.8901998163
"10.0.2.109",53546,"31.28.27.51",80,17,1928,8,817,9,1111,277215.291232,1620.520978000015,4.033270836189039,5.484655935135891
"10.0.2.109",53547,"194.247.12.49",16455,18,2448,8,1775,10,673,277216.003283,0.6651529999799095,21348.47170565103,8094.378286142617
"10.0.2.109",53548,"5.101.114.217",80,7,1820,4,339,3,1481,277216.290196,0.37793299998156726,7175.875089320782,31349.471997888137
"10.0.2.109",53549,"194.247.12.49",16455,9,506,5,286,4,220,277816.745974,0.16798199998447672,13620.506960337625,10477.313046413557
"10.0.2.109",53550,"194.247.12.49",16455,9,506,5,286,4,220,278416.991907,0.16459800000302494,13900.533420563748,10692.718015818267
"10.0.2.109",53551,"194.247.12.49",16455,15,1182,7,616,8,566,278516.34191,0.4087529999669641,12056.180628394866,11077.59453842775
"10.0.2.109",53552,"80.78.242.47",80,10,878,5,394,5,484,278516.626079,0.12450599996373057,25316.0490331245,31098.902873178315
"10.0.2.109",53553,"194.247.12.49",16455,18,1675,8,1000,10,675,278516.91226,0.5618479999830015,14238.726488733673,9611.140379895229
"10.0.2.109",53554,"217.23.10.139",80,7,1047,4,341,3,706,278517.199003,0.27489599998807535,9923.752983376758,20545.951924527835
"10.0.2.109",53555,"194.247.12.49",16455,19,2751,9,2073,10,678,278517.51411,0.6654620000044815,24921.032305207984,8150.728366102756
"10.0.2.109",53556,"37.187.78.159",80,9,2177,5,398,4,1779,278517.8091,0.37010599998757243,8602.940779417015,38453.84835824841
"10.0.2.109",53557,"31.28.27.51",80,11,944,6,478,5,466,278835.812559,1620.0106939999969,2.36047824508991,2.3012193770123393
"10.0.2.109",53558,"194.247.12.49",16455,18,2448,8,1775,10,673,278836.300707,0.676404999976512,20993.339789760706,7959.72826958251
"10.0.2.109",53559,"5.101.114.217",80,7,1820,4,339,3,1481,278836.582324,0.3945889999740757,6872.974158372831,30026.179140265966
"10.0.2.109",53560,"194.247.12.49",16455,9,506,5,286,4,220,279437.057113,0.16756099998019636,13654.728727271939,10503.637482516877
"10.0.2.109",53561,"194.247.12.49",16455,9,506,5,286,4,220,280037.304439,0.16295699996408075,14040.513758257237,10800.395198659413
"10.0.2.109",53562,"31.28.27.51",80,11,944,6,478,5,466,280455.823662,1620.0056149999727,2.360485645600719,2.3012265917362655
"10.0.2.109",53563,"194.247.12.49",16455,18,2448,8,1775,10,673,280456.083536,0.6910940000088885,20547.13251716462,7790.546582564389
"10.0.2.109",53564,"5.101.114.217",80,7,1820,4,339,3,1481,280456.364531,0.40977399999974295,6618.282272671524,28913.49866025524
"10.0.2.109",53565,"194.247.12.49",16455,9,506,5,286,4,220,281056.853949,0.16359800001373515,13985.501044070876,10758.077726208367
"10.0.2.109",53566,"194.247.12.49",16455,9,506,5,286,4,220,281657.09744,0.16740700002992526,13667.289895828746,10513.299919868266
"10.0.2.109",53567,"31.28.27.51",80,17,1928,8,817,9,1111,282075.8295,1620.5001470000134,4.033322682568042,5.484726438596199
"10.0.2.109",53568,"194.247.12.49",16455,18,2448,8,1775,10,673,282076.514154,0.6510220000054687,21811.858892450204,8270.073822320557
"10.0.2.109",53569,"5.101.114.217",80,7,1820,4,339,3,1481,282076.795848,0.3690970000461675,7347.661995791829,32099.962878370792
"10.0.2.109",53570,"194.247.12.49",16455,15,1182,7,616,8,566,282124.21915,0.4086999999708496,12057.744067412497,11079.031074927718
"10.0.2.109",53571,"80.78.242.47",80,10,878,5,394,5,484,282124.503092,0.12477599998237565,25261.268196169243,31031.608647070847
"10.0.2.109",53572,"194.247.12.49",16455,18,1675,8,1000,10,675,282124.793882,0.6043249999638647,13237.91006574005,8935.589294374535
"10.0.2.109",53573,"217.23.10.139",80,7,1047,4,341,3,706,282125.085862,0.312158000015188,8739.164140810966,18093.40141763209
"10.0.2.109",53574,"194.247.12.49",16455,19,2751,9,2073,10,678,282125.434183,0.6619189999764785,25054.425089156404,8194.356107307303
"10.0.2.109",53575,"37.187.78.159",80,9,2177,5,398,4,1779,282125.725403,0.3705290000070818,8593.119566725265,38409.94901810112
"10.0.2.109",53576,"194.247.12.49",16455,9,506,5,286,4,220,282726.173406,0.16758399998070672,13652.854689370157,10502.195914900121
"10.0.2.109",53577,"194.247.12.49",16455,9,506,5,286,4,220,283326.418938,0.1212449999875389,18870.88127539405,14516.062519533887
"10.0.2.109",53578,"31.28.27.51",80,11,944,6,478,5,466,283696.329862,1620.3079889999935,2.3600451432446867,2.3007971480167866
"10.0.2.109",53579,"194.247.12.49",16455,18,2448,8,1775,10,673,283696.582463,0.5342779999482445,26577.923854951077,10077.150847539198
"10.0.2.109",53580,"5.101.114.217",80,7,1820,4,339,3,1481,283696.806871,0.3095860000466928,8760.08604908157,38270.464420913886
"10.0.2.109",53581,"194.247.12.49",16455,9,506,5,286,4,220,284297.171889,0.12152600003173575,18827.246839380077,14482.497568753904
"10.0.2.109",53582,"194.247.12.49",16455,9,506,5,286,4,220,284897.373041,0.1255210000090301,18228.025588032273,14021.55814464021
"10.0.2.109",53583,"31.28.27.51",80,17,1928,8,817,9,1111,285316.339185,1620.4292209999985,4.033499220636435,5.48496650443951
"10.0.2.109",53584,"194.247.12.49",16455,18,2448,8,1775,10,673,285316.953453,0.5144389999913983,27602.88391867147,10465.769508318815
"10.0.2.109",53585,"5.101.114.217",80,7,1820,4,339,3,1481,285317.173598,0.29401799995684996,9223.925067166,40296.852579565915
"10.0.2.109",53586,"194.247.12.49",16455,9,506,5,286,4,220,285917.548344,0.12195599998813123,18760.864575934505,14431.434289180388
"10.0.2.109",53587,"194.247.12.49",16455,9,506,5,286,4,220,286517.768516,0.19305100000929087,11851.790458945494,9116.761891496533
"10.0.2.109",53588,"31.28.27.51",80,11,944,6,478,5,466,286936.768599,1620.0092389999772,2.3604803651370125,2.3012214438365017
"10.0.2.109",53589,"194.247.12.49",16455,18,2448,8,1775,10,673,286937.038292,0.7596870000124909,18691.90864101468,7087.129304452327
"10.0.2.109",53590,"5.101.114.217",80,7,1820,4,339,3,1481,286937.374894,0.4229139999952167,6412.651271962322,28015.152017038934
"10.0.2.109",53591,"194.247.12.49",16455,9,506,5,286,4,220,287537.876001,0.19268899998860434,11874.05612222448,9133.88932478806
"10.0.2.109",53592,"194.247.12.49",16455,15,1182,7,616,8,566,288046.505529,0.47982199996476993,10270.47530201164,9436.832826199008
"10.0.2.109",53593,"80.78.242.47",80,10,878,5,394,5,484,288046.842012,0.14327400003094226,21999.804565512768,27025.140633777104
"10.0.2.109",53594,"194.247.12.49",16455,18,1675,8,1000,10,675,288047.161414,0.6538950000540353,12234.380136472846,8258.20659211917
"10.0.2.109",53595,"217.23.10.139",80,7,1047,4,341,3,706,288047.491203,0.32393000001320615,8421.572561629931,17435.86577275874
"10.0.2.109",53596,"194.247.12.49",16455,19,2747,9,2069,10,678,288047.858803,0.7445799999986775,22229.982003316498,7284.643691758621
"10.0.2.109",53597,"37.187.78.159",80,9,2173,5,398,4,1775,288048.194484,0.40872700000181794,7790.040785134915,34742.01606435797
"10.0.2.109",53598,"31.28.27.51",80,17,1928,8,817,9,1111,288556.777991,1620.7300890000188,4.032750452626368,5.483948289923984
"10.0.2.109",53599,"194.247.12.49",16455,18,2448,8,1775,10,673,288557.720377,0.7695570000214502,18452.174432308715,6996.232897433107
"10.0.2.109",53600,"5.101.114.217",80,7,1820,4,339,3,1481,288558.059929,0.4297160000423901,6311.145034703083,27571.69851444031
"10.0.2.109",53601,"194.247.12.49",16455,9,506,5,286,4,220,289158.567847,0.1929289999534376,11859.285024813256,9122.526942164044
"10.0.2.109",53602,"194.247.12.49",16455,9,506,5,286,4,220,289758.840681,0.1931550000444986,11845.409124655826,9111.853172812174
"10.0.2.109",53603,"31.28.27.51",80,11,944,6,478,5,466,290177.508225,1620.0095490000094,2.360479913442768,2.301221003481862
"10.0.2.109",53604,"194.247.12.49",16455,18,2448,8,1775,10,673,290177.787014,0.7478439999977127,18987.917266225886,7199.362433898604
"10.0.2.109",53605,"5.101.114.217",80,7,1820,4,339,3,1481,290178.113995,0.4204359999857843,6450.446679379734,28180.27000637577
"10.0.2.109",53606,"194.247.12.49",16455,9,506,5,286,4,220,290778.614824,0.1939729999867268,11795.45606943525,9073.427745719422
"10.0.2.109",53607,"194.247.12.49",16455,9,506,5,286,4,220,291378.888656,0.20252399996388704,11297.426479864034,8690.328061433873
"10.0.2.109",53608,"194.247.12.49",16455,15,1182,7,616,8,566,291724.141968,0.4672980000032112,10545.733129536475,9689.748297593578
"10.0.2.109",53609,"80.78.242.47",80,10,878,5,394,5,484,291724.470266,0.13881499995477498,22706.479854676374,27893.239212343567
"10.0.2.109",53610,"194.247.12.49",16455,18,1675,8,1000,10,675,291724.784423,0.6608799999812618,12105.07202552177,8170.923617227195
"10.0.2.109",53611,"217.23.10.139",80,7,1047,4,341,3,706,291725.118571,0.3264820000040345,8355.743961278995,17299.57547408496
"10.0.2.109",53612,"194.247.12.49",16455,19,2747,9,2069,10,678,291725.486899,0.7407699999748729,22344.317400220647,7322.110776872691
"10.0.2.109",53613,"37.187.78.159",80,9,2173,5,398,4,1775,291725.820746,0.4067800000193529,7827.3268101886,34908.304241419006
"10.0.2.109",53614,"31.28.27.51",80,17,1928,8,817,9,1111,291797.518035,1621.4305019999738,4.0310084162954185,5.481579376382142
"10.0.2.109",53615,"194.247.12.49",16455,18,2448,8,1775,10,673,291799.161252,0.7453049999894574,19052.602626040163,7223.888206943679
"10.0.2.109",53616,"5.101.114.217",80,7,1820,4,339,3,1481,291799.487446,0.41884600004414096,6474.933507098528,28287.24638351894
"10.0.2.109",53617,"194.247.12.49",16455,9,506,5,286,4,220,292399.98653,0.19821000000229105,11543.312648067977,8879.471267744597
"10.0.2.109",53618,"194.247.12.49",16455,9,506,5,286,4,220,293000.262631,0.1925679999985732,11881.517178435422,9139.628598796478
"10.0.2.109",53619,"31.28.27.51",80,11,944,6,478,5,466,293418.948725,1620.0103200000012,2.360478790036348,2.3012199082781133
"10.0.2.109",53620,"194.247.12.49",16455,18,2448,8,1775,10,673,293419.217177,0.7411560000036843,19159.2593191304,7264.327617901273
"10.0.2.109",53621,"5.101.114.217",80,7,1820,4,339,3,1481,293419.541308,0.416851999994833,6505.9061730149215,28422.557646711204
"10.0.2.109",53622,"194.247.12.49",16455,9,506,5,286,4,220,294020.038441,0.1937430000398308,11809.458919959017,9084.199169199244
"10.0.2.109",53623,"194.247.12.49",16455,15,1182,7,616,8,566,294547.56705,0.4772679999587126,10325.435605207787,9487.33206582404
"10.0.2.109",53624,"80.78.242.47",80,10,878,5,394,5,484,294547.901946,0.14238500001374632,22137.16332265123,27193.87575675938
"10.0.2.109",53625,"194.247.12.49",16455,18,1675,8,1000,10,675,294548.218885,0.6626740000210702,12072.301010369554,8148.8031819994485
"10.0.2.109",53626,"217.23.10.139",80,7,1047,4,341,3,706,294548.553825,0.3275569999823347,8328.321483427686,17242.80049061568
"10.0.2.109",53627,"194.247.12.49",16455,19,2747,9,2069,10,678,294548.919724,0.7337570000090636,22557.876789993887,7392.093022530621
"10.0.2.109",53628,"37.187.78.159",80,9,2173,5,398,4,1775,294549.251553,0.4017110000131652,7926.096123570555,35348.795525974216
"10.0.2.109",53629,"31.28.27.51",80,17,1928,8,817,9,1111,295038.959513,1620.5383809999912,4.0332275227981995,5.484597035286169
"10.0.2.109",53630,"194.247.12.49",16455,18,2448,8,1775,10,673,295039.699233,0.7468670000089332,19012.755952304968,7208.780144169715
"10.0.2.109",53631,"5.101.114.217",80,7,1820,4,339,3,1481,295040.025429,0.4204850000096485,6449.694994917227,28176.986098738682
"10.0.2.109",53632,"194.247.12.49",16455,9,506,5,286,4,220,295640.52562,0.19871400005649775,11514.035243362234,8856.950187201719
"10.0.2.109",53633,"194.247.12.49",16455,9,506,5,286,4,220,296240.802232,0.2016000000294298,11349.20634754958,8730.158728884291
"10.0.2.109",53634,"194.247.12.49",16455,15,1182,7,616,8,566,296451.600613,0.4656400000094436,10583.283222876162,9724.250493746602
"10.0.2.109",53635,"80.78.242.47",80,10,878,5,394,5,484,296451.927925,0.1382589999702759,22797.79255366843,28005.41014206985
"10.0.2.109",53636,"194.247.12.49",16455,18,1675,8,1000,10,675,296452.241968,0.6546830000006594,12219.654397612192,8248.26671838823
"10.0.2.109",53637,"217.23.10.139",80,7,1047,4,341,3,706,296452.571465,0.324945000000298,8395.26689131237,17381.403006646724
"10.0.2.109",53638,"194.247.12.49",16455,19,2751,9,2073,10,678,296452.935524,0.7477170000202022,22179.514441362073,7254.081423658217
"10.0.2.109",53639,"37.187.78.159",80,9,2177,5,398,4,1779,296453.273828,0.4092800000216812,7779.5152458740495,34773.2603578139
"10.0.2.109",53640,"31.28.27.51",80,11,944,6,478,5,466,296659.498041,1620.0084440000355,2.3604815235147725,2.3012225731336486
"10.0.2.109",53641,"194.247.12.49",16455,18,2448,8,1775,10,673,296659.76704,0.7455499999923632,19046.341627181886,7221.514318362483
"10.0.2.109",53642,"5.101.114.217",80,7,1820,4,339,3,1481,296660.092481,0.4198430000105873,6459.55750109353,28220.07274076554
"10.0.2.109",53643,"194.247.12.49",16455,9,506,5,286,4,220,297260.592362,0.1927109999815002,11872.700573499398,9132.846594999537
"10.0.2.109",53644,"194.247.12.49",16455,9,506,5,286,4,220,297860.865027,0.20104199997149408,11380.706520649504,8754.389631268848
"10.0.2.109",53645,"31.28.27.51",80,11,944,6,478,5,466,298279.506983,1620.0087999999523,2.3604810047946114,2.301222067435751
"10.0.2.109",53646,"194.247.12.49",16455,18,2448,8,1775,10,673,298279.784908,1.0549020000034943,13460.966042298682,5103.791631812402
"10.0.2.109",53647,"5.101.114.217",80,8,1874,5,393,3,1481,298280.118979,0.7206209999858402,4362.903662343698,16441.374870053478
"10.0.2.109",53648,"194.247.12.49",16455,9,506,5,286,4,220,298880.917584,0.19700899999588728,11613.682623878929,8933.602018368407
"10.0.2.109",53649,"194.247.12.49",16455,9,506,5,286,4,220,299481.194418,0.19246500002918765,11887.875715860135,9144.519781430872
"10.0.2.109",53650,"194.247.12.49",16455,15,1182,7,616,8,566,299528.762532,0.47463700000662357,10382.671388727027,9539.922087693989
"10.0.2.109",53651,"80.78.242.47",80,10,878,5,394,5,484,299529.096672,0.1403009999776259,22465.98385259304,27597.807575266575
"10.0.2.109",53652,"194.247.12.49",16455,18,1675,8,1000,10,675,299529.418382,0.6751659999717958,11848.937891324784,7998.033076644229
"10.0.2.109",53653,"217.23.10.139",80,7,1047,4,341,3,706,299529.751115,0.3422930000233464,7969.780275418821,16500.483502773277
"10.0.2.109",53654,"194.247.12.49",16455,19,2751,9,2073,10,678,299530.128915,0.7468089999747463,22206.48117599118,7262.901223985537
"10.0.2.109",53655,"37.187.78.159",80,9,2177,5,398,4,1779,299530.464241,0.4112019999884069,7743.153000446902,34610.7266025001
"10.0.2.109",53656,"31.28.27.51",80,17,1928,8,817,9,1111,299899.51605,1620.5014310000115,4.033319486775543,5.484722092787795
"10.0.2.109",53657,"194.247.12.49",16455,18,2448,8,1775,10,673,299900.240292,0.737174000008963,19262.7520772943,7303.567407334684
"10.0.2.109",53658,"5.101.114.217",80,7,1820,4,339,3,1481,299900.572895,0.40436200000112876,6706.861673432295,29300.47828422781
"10.0.2.109",53659,"194.247.12.49",16455,9,506,5,286,4,220,300501.03926,0.1266429999959655,18066.53348446333,13897.333449587175
"10.0.2.109",53660,"194.247.12.49",16455,9,506,5,286,4,220,301101.243537,0.12083300005178899,18935.22464077995,14565.557415984578
"10.0.2.109",53661,"194.247.12.49",16455,15,1182,7,616,8,566,301361.096163,0.32915000000502914,14971.897311027507,13756.645905911639
"10.0.2.109",53662,"80.78.242.47",80,10,878,5,394,5,484,301361.320233,0.10486300004413351,30058.26648744956,36924.36796935428
"10.0.2.109",53663,"194.247.12.49",16455,18,1675,8,1000,10,675,301361.565021,0.47860100003890693,16715.385047982883,11282.884907388447
"10.0.2.109",53664,"217.23.10.139",80,7,1047,4,341,3,706,301361.791826,0.25151900004129857,10846.099100076224,22455.560013647548
"10.0.2.109",53665,"194.247.12.49",16455,19,2747,9,2069,10,678,301362.085908,0.520650000020396,31791.03044147045,10417.747046552426
"10.0.2.109",53666,"37.187.78.159",80,9,2173,5,398,4,1775,301362.310491,0.29592399997636676,10759.519336905025,47985.29352514175
"10.0.2.109",53667,"31.28.27.51",80,11,944,6,478,5,466,301520.017937,1620.0072259999579,2.3604832982393744,2.301224303304495
"10.0.2.109",53668,"194.247.12.49",16455,18,2448,8,1775,10,673,301520.279015,0.5201850000303239,27297.980524567643,10350.163883399451
"10.0.2.109",53669,"5.101.114.217",80,7,1820,4,339,3,1481,301520.505156,0.29390199994668365,9227.565652809373,40312.757320975456
"10.0.2.109",53670,"194.247.12.49",16455,9,506,5,286,4,220,302120.876672,0.12492800003383309,18314.54917536791,14088.114750283008
"10.0.2.109",53671,"194.247.12.49",16455,9,506,5,286,4,220,302721.080757,0.1223809999646619,18695.712575160123,14381.317365507786
"10.0.2.109",53672,"31.28.27.51",80,17,1928,8,817,9,1111,303140.025324,1621.3825550000183,4.031127619971171,5.48174147587267
"10.0.2.109",53673,"194.247.12.49",16455,18,2448,8,1775,10,673,303141.606286,0.5174240000196733,27443.64389641782,10405.39286889532
"10.0.2.109",53674,"5.101.114.217",80,7,1820,4,339,3,1481,303141.831936,0.2915110000176355,9303.250991681041,40643.4062497924
"10.0.2.109",53675,"194.247.12.49",16455,9,506,5,286,4,220,303742.201212,0.12490600004093722,18317.774960771472,14090.596123670362
"10.0.2.109",53676,"194.247.12.49",16455,9,506,5,286,4,220,304342.406667,0.12244300002930686,18686.245840532858,14374.035261948353
"10.0.2.109",53677,"194.247.12.49",16455,15,1182,7,616,8,566,304390.758365,0.3216169999795966,15322.573123661476,14078.857772714928
"10.0.2.109",53678,"80.78.242.47",80,10,878,5,394,5,484,304390.977698,0.10224800003925338,30827.008829414128,37868.71135389958
"10.0.2.109",53679,"194.247.12.49",16455,18,1675,8,1000,10,675,304391.218668,0.48304199997801334,16561.70685026175,11179.152123926682
"10.0.2.109",53680,"217.23.10.139",80,7,1047,4,341,3,706,304391.445993,0.25544899998931214,10679.235385983653,22110.08851174328
"10.0.2.109",53681,"194.247.12.49",16455,19,2751,9,2073,10,678,304391.744175,0.5256090000038967,31551.97114181274,10319.458000071894
"10.0.2.109",53682,"37.187.78.159",80,9,2177,5,398,4,1779,304391.965345,0.30428000004030764,10464.046271783289,46772.70934045847
"10.0.2.109",53683,"31.28.27.51",80,11,944,6,478,5,466,304761.408307,1620.0082410000032,2.3604818193020494,2.301222861495303
"10.0.2.109",53684,"194.247.12.49",16455,18,2448,8,1775,10,673,304761.663491,0.5132359999697655,27667.58372529697,10490.300758943582
"10.0.2.109",53685,"5.101.114.217",80,7,1820,4,339,3,1481,304761.884529,0.2919840000104159,9288.180173924788,40577.56589257407
"10.0.2.109",53686,"194.247.12.49",16455,9,506,5,286,4,220,305362.256522,0.12636300001759082,18106.56600176864,13928.127693668184
"10.0.2.109",53687,"194.247.12.49",16455,9,506,5,286,4,220,305962.460575,0.1266950000426732,18059.118349022137,13891.629499247798
"10.0.2.109",53688,"31.28.27.51",80,17,1928,8,817,9,1111,306381.416886,1620.7695609999937,4.032652239574004,5.4838147345981865
"10.0.2.109",53689,"194.247.12.49",16455,18,2448,8,1775,10,673,306382.376136,0.5043530000257306,28154.88358208548,10675.06290182734
"10.0.2.109",53690,"5.101.114.217",80,7,1820,4,339,3,1481,306382.592853,0.28735900000901893,9437.672040600371,41230.65572899455
"10.0.2.109",53691,"194.247.12.49",16455,9,506,5,286,4,220,306982.959987,0.12608400004683062,18146.6323970542,13958.947997734002
"10.0.2.109",53692,"194.247.12.49",16455,15,1182,7,616,8,566,307494.385597,0.33081799995852634,14896.40829887675,13687.284248643247
"10.0.2.109",53693,"80.78.242.47",80,10,878,5,394,5,484,307494.609014,0.10742700000992045,29340.85471723985,36043.08041407129
"10.0.2.109",53694,"194.247.12.49",16455,15,1182,7,616,8,566,307494.734955,0.3248800000292249,15168.677664235092,13937.453827852374
"10.0.2.109",53695,"194.247.12.49",16455,18,1675,8,1000,10,675,307494.856041,0.4825800000107847,16577.562269097798,11189.854531641015
"10.0.2.109",53696,"80.78.242.47",80,10,878,5,394,5,484,307494.956778,0.10303100000601262,30592.7342238361,37580.922244509326
"10.0.2.109",53697,"217.23.10.139",80,7,1047,4,341,3,706,307495.082441,0.2560510000330396,10654.127496662742,22058.10560892638
"10.0.2.109",53698,"194.247.12.49",16455,18,1675,8,1000,10,675,307495.200871,0.49521500000264496,16154.599517295057,10904.354674174163
"10.0.2.109",53699,"194.247.12.49",16455,19,2747,9,2069,10,678,307495.377834,0.5390040000202134,30708.491958091734,10063.00509791503
"10.0.2.109",53700,"217.23.10.139",80,7,1047,4,341,3,706,307495.429065,0.26676100003533065,10226.382415865495,21172.510221703928
"10.0.2.109",53701,"37.187.78.159",80,9,2173,5,398,4,1775,307495.610989,0.3055119999917224,10421.84922388079,46479.35269444322
"10.0.2.109",53702,"194.247.12.49",16455,19,2751,9,2073,10,678,307495.737665,0.5444229999557137,30461.60798009825,9962.841394359197
"10.0.2.109",53703,"37.187.78.159",80,9,2177,5,398,4,1779,307495.97086,0.31109199998900294,10234.914430819674,45748.5245538397
"10.0.2.109",53704,"31.28.27.51",80,11,944,6,478,5,466,308002.186862,1620.0088930000202,2.3604808692861616,2.301221935329187
"10.0.2.109",53705,"194.247.12.49",16455,18,2448,8,1775,10,673,308002.435721,0.5151429999968968,27565.161518424087,10451.466874309526
"10.0.2.109",53706,"5.101.114.217",80,7,1820,4,339,3,1481,308002.659113,0.2914100000052713,9306.475412480502,40657.49287871275
"10.0.2.109",53707,"194.247.12.49",16455,9,506,5,286,4,220,308603.028273,0.12555600004270673,18222.944337361478,14017.64949027806
"10.0.2.109",53708,"194.247.12.49",16455,9,506,5,286,4,220,309203.231792,0.1258580000139773,18179.217846667703,13984.013728205926
"10.0.2.109",53709,"194.247.12.49",16455,17,1290,8,670,9,620,309481.959272,0.3370020000147633,15904.950118293631,14718.013542301569
"10.0.2.109",53710,"80.78.242.47",80,10,878,5,394,5,484,309482.189406,0.10672599996905774,29533.57195916492,36279.81936100462
"10.0.2.109",53711,"194.247.12.49",16455,18,1675,8,1000,10,675,309482.435661,0.5054749999544583,15826.697662042186,10683.020921878477
"10.0.2.109",53712,"217.23.10.139",80,7,1047,4,341,3,706,309482.668639,0.2723359999945387,10017.03777706475,20739.087010579806
"10.0.2.109",53713,"194.247.12.49",16455,19,2751,9,2073,10,678,309482.980944,0.531446999986656,31205.369492002785,10206.097692029854
"10.0.2.109",53714,"37.187.78.159",80,9,2177,5,398,4,1779,309483.208904,0.30329800001345575,10497.926131589205,46924.147206274356
"10.0.2.109",53715,"31.28.27.51",80,17,1928,8,817,9,1111,309622.195959,1620.4791170000099,4.0333750255912495,5.484797617419679
"10.0.2.109",53716,"194.247.12.49",16455,18,2448,8,1775,10,673,309622.865026,0.5207589999772608,27267.891674690305,10338.75554764314
"10.0.2.109",53717,"5.101.114.217",80,7,1820,4,339,3,1481,309623.091043,0.29452799999853596,9207.953063931038,40227.07518490226
"10.0.2.109",53718,"194.247.12.49",16455,9,506,5,286,4,220,310223.463615,0.12186700000893325,18774.5657137066,14441.973625928154
"10.0.2.109",53719,"194.247.12.49",16455,9,506,5,286,4,220,310823.66554,0.12226999999256805,18712.68504243945,14394.373109568809
"10.0.2.109",53720,"31.28.27.51",80,11,944,6,478,5,466,311242.675258,1620.010784000042,2.3604781139530373,2.3012192491676053
"10.0.2.109",53721,"194.247.12.49",16455,18,2448,8,1775,10,673,311242.924639,0.5218950000125915,27208.538115248095,10316.251352992658
"10.0.2.109",53722,"5.101.114.217",80,7,1820,4,339,3,1481,311243.152206,0.2940989999915473,9221.38463605094,40285.754117968856
"10.0.2.109",53723,"194.247.12.49",16455,9,506,5,286,4,220,311843.525959,0.1268549999804236,18036.34070673672,13874.108235951324
"10.0.2.109",53724,"194.247.12.49",16455,9,506,5,286,4,220,312443.730999,0.12534299999242648,18253.911268584972,14041.470206603826
"10.0.2.109",53725,"31.28.27.51",80,11,944,6,478,5,466,312862.686448,1620.0068739999551,2.3604838111323385,2.301224803321485
"10.0.2.109",53726,"194.247.12.49",16455,18,2448,8,1775,10,673,312862.942735,0.5219400000059977,27206.19228232522,10315.361918875984
"10.0.2.109",53727,"5.101.114.217",80,7,1820,4,339,3,1481,312863.169053,0.2954730000346899,9178.503618542467,40098.41846330795
"10.0.2.109",53728,"194.247.12.49",16455,18,1595,8,984,10,611,313062.79553,4.624542000005022,1702.2226200976122,1056.9695334142693
"10.0.2.109",53729,"173.194.122.20",80,8,1011,5,321,3,690,313063.629477,3.7904510000371374,677.4919396068805,1456.2910851362851
"10.0.2.109",53730,"194.247.12.49",16455,9,506,5,286,4,220,313667.497703,0.12581800000043586,18184.997377100844,13988.459520846802
"10.0.2.109",53731,"194.247.12.49",16455,30,4812,12,2515,18,2297,314036.300674,19.69687400001567,1021.4818859065654,932.9399172673482
"10.0.2.109",53732,"94.198.110.184",3389,24,4455,13,2018,11,2437,314037.051758,18.94560300000012,852.123841083332,1029.051437423231
"10.0.2.109",53733,"31.28.27.51",80,17,1928,8,817,9,1111,314482.693556,1620.570624999993,4.033147274898944,5.484487909929898
"10.0.2.109",53734,"194.247.12.49",16455,18,2448,8,1775,10,673,314483.465636,0.5266130000236444,26964.772991480335,10223.826604657052
"10.0.2.109",53735,"5.101.114.217",80,7,1820,4,339,3,1481,314483.694859,0.2971380000235513,9127.072268727143,39873.72870202035
"10.0.2.109",53736,"194.247.12.49",16455,9,506,5,286,4,220,315084.069736,0.12569900002563372,18202.213219941365,14001.702476877972
"10.0.2.109",53737,"194.247.12.49",16455,9,506,5,286,4,220,315684.273682,0.12518899998394772,18276.366136748256,14058.743182114042
"10.0.2.109",53738,"31.28.27.51",80,11,944,6,478,5,466,316103.264372,1620.009760999994,2.360479604542342,2.3012207023362583
"10.0.2.109",53739,"194.247.12.49",16455,18,2448,8,1775,10,673,316103.573532,0.5114409999805503,27764.688401086372,10527.118475454157
"10.0.2.109",53740,"5.101.114.217",80,7,1820,4,339,3,1481,316103.793457,0.29137699998682365,9307.529421068373,40662.0975592987
"10.0.2.109",53741,"194.247.12.49",16455,9,506,5,286,4,220,316704.165185,0.12242299999343231,18689.29858051792,14376.383523475324
"10.0.2.109",53742,"194.247.12.49",16455,9,506,5,286,4,220,317304.367545,0.1267620000289753,18049.57321182222,13884.287086017091
"10.0.2.109",53743,"194.247.12.49",16455,22,1545,11,773,11,772,317580.95281,4.358185000019148,1418.9393061498836,1417.103679621876
"10.0.2.109",53744,"69.125.179.241",8333,9,792,5,421,4,371,317581.704319,3.6065100000123493,933.8668130653921,822.956265195393
"10.0.2.109",53745,"31.28.27.51",80,17,1928,8,817,9,1111,317723.274591,1620.6485220000031,4.0329534203592035,5.484224296228978
"10.0.2.109",53746,"194.247.12.49",16455,18,2448,8,1775,10,673,317724.114003,0.5167950000031851,27477.046023882744,10418.057450182021
"10.0.2.109",53747,"5.101.114.217",80,7,1820,4,339,3,1481,317724.33821,0.2923519999603741,9276.488617719699,40526.48862195538
"10.0.2.109",53748,"194.247.12.49",16455,16,909,8,460,8,449,318188.577434,21.85695000004489,168.3674986671261,164.3413193511731
"10.0.2.109",53749,"146.185.141.232",9084,3,186,3,186,0,0,318189.365664,8.998339999991003,165.36383377395026,0
"10.0.2.109",53750,"194.247.12.49",16455,16,909,8,460,8,449,318351.731095,21.68486799998209,169.70359238539243,165.64546300226345
"10.0.2.109",53751,"37.52.230.221",9084,3,186,3,186,0,0,318352.362489,8.996011999959592,165.40662684828385,0
"10.0.2.109",53752,"194.247.12.49",16455,9,506,5,286,4,220,318973.502074,0.12549599999329075,18231.65678684835,14024.351374498732
"10.0.2.109",53753,"31.28.27.51",80,11,944,6,478,5,466,319343.923287,1620.0119280000217,2.3604764470598076,2.3012176241210676
"10.0.2.109",53754,"194.247.12.49",16455,18,2448,8,1775,10,673,319344.178842,0.5209819999872707,27256.219985233565,10334.33016904912
"10.0.2.109",53755,"5.101.114.217",80,7,1820,4,339,3,1481,319344.404636,0.2950190000119619,9192.628271026742,40160.12527843837
"10.0.2.109",53756,"194.247.12.49",16455,9,506,5,286,4,220,319944.779451,0.12395100004505366,18458.907142083233,14199.159340064025
"10.0.2.109",53757,"194.247.12.49",16455,9,506,5,286,4,220,320544.982981,0.12075800000457093,18946.984878131425,14574.603752408788
"10.0.2.109",53758,"31.28.27.51",80,17,1928,8,817,9,1111,320963.935758,1620.4364620000124,4.033481196746824,5.484941994596967
"10.0.2.109",53759,"194.247.12.49",16455,18,2448,8,1775,10,673,320964.567198,0.5110710000153631,27784.7891967518,10534.739791219134
"10.0.2.109",53760,"5.101.114.217",80,7,1820,4,339,3,1481,320964.787107,0.2909619999700226,9320.804779591195,40720.0940370931
"10.0.2.109",53761,"194.247.12.49",16455,9,506,5,286,4,220,321565.15708,0.12643000000389293,18096.97065514158,13920.746657801214
"10.0.2.109",53762,"194.247.12.49",16455,16,909,8,460,8,449,322144.387349,21.724201999953948,169.39632581246488,165.34554410825376
"10.0.2.109",53763,"179.233.37.156",28388,3,186,3,186,0,0,322145.045782,9.00588000001153,165.22538608088215,0
"10.0.2.109",53764,"194.247.12.49",16455,16,909,8,460,8,449,322299.975918,21.938129000016488,167.74447811831328,163.73319711983189
"10.0.2.109",53765,"141.136.202.75",28388,3,186,3,186,0,0,322300.853112,8.991834000044037,165.48348201186906,0
"10.0.2.109",53766,"194.247.12.49",16455,15,1182,7,616,8,566,322496.072949,0.33230000000912696,14829.972915632403,13626.241347805097
"10.0.2.109",53767,"80.78.242.47",80,10,878,5,394,5,484,322496.30126,0.10387799999443814,30343.287319439776,37274.495082763584
"10.0.2.109",53768,"194.247.12.49",16455,18,1675,8,1000,10,675,322496.546213,0.4615969999576919,17331.135169278066,11698.516239262695
"10.0.2.109",53769,"217.23.10.139",80,7,1047,4,341,3,706,322496.773101,0.23451500001829118,11632.518174902363,24083.747306396093
"10.0.2.109",53770,"194.247.12.49",16455,19,2751,9,2073,10,678,322497.050052,0.5402460000477731,30697.12686171393,10039.870724670547
"10.0.2.109",53771,"37.187.78.159",80,9,2177,5,398,4,1779,322497.284627,0.3054480000282638,10424.032894978449,46593.8555783082
"10.0.2.109",53772,"31.28.27.51",80,11,944,6,478,5,466,322584.372352,1620.3524029999971,2.359980454202472,2.3007340829672636
"10.0.2.109",53773,"194.247.12.49",16455,18,2448,8,1775,10,673,322584.613552,0.518947999982629,27363.0498633299,10374.835243955506
"10.0.2.109",53774,"5.101.114.217",80,7,1820,4,339,3,1481,322584.83909,0.29323199996724725,9248.649534508235,40404.86714043273
"10.0.2.109",53775,"194.247.12.49",16455,9,506,5,286,4,220,323185.210466,0.12318999995477498,18572.936121762817,14286.873939817551
"10.0.2.109",53776,"194.247.12.49",16455,9,506,5,286,4,220,323785.414256,0.12111099995672703,18891.760457906406,14532.123429158773
"10.0.2.109",53777,"31.28.27.51",80,17,1928,8,817,9,1111,324204.725213,1620.577930999978,4.033129092389256,5.484463184387349
"10.0.2.109",53778,"194.247.12.49",16455,18,2448,8,1775,10,673,324205.504414,0.511590999958571,27756.547713212163,10524.0318935165
"10.0.2.109",53779,"5.101.114.217",80,7,1820,4,339,3,1481,324205.724569,0.29126699996413663,9311.044506703216,40677.45402485977
"10.0.2.109",53780,"194.247.12.49",16455,16,909,8,460,8,449,324380.48535,22.053596000012476,166.8662108437063,162.8759318887481
"10.0.2.109",53781,"62.210.97.100",3128,3,186,3,186,0,0,324381.482979,8.993765999970492,165.44793360255116,0
"10.0.2.109",53782,"194.247.12.49",16455,22,2665,10,1588,12,1077,324383.688539,3.5647839999874122,3563.7502861449275,2416.9767368879643
"10.0.2.109",53783,"96.32.46.235",50002,12,2066,7,772,5,1294,324384.657762,2.595320000022184,2379.6680177963444,3988.718154181956
"10.0.2.109",53784,"194.247.12.49",16455,18,1094,9,514,9,580,324385.004017,2.2488229999435134,1828.512070582383,2063.3015582447124
"10.0.2.109",53785,"76.174.18.21",50002,6,396,4,284,2,112,324386.053231,1.1993879999499768,1894.2994261196202,747.0476610049207
"10.0.2.109",53786,"194.247.12.49",16455,15,867,7,406,8,461,324387.463048,2.012272000021767,1614.0959074940497,1832.754220085608
"10.0.2.109",53787,"78.47.61.83",50002,4,228,3,170,1,58,324388.758734,0.7163150000269525,1898.606060111582,647.7597146263045
"10.0.2.109",53788,"194.247.12.49",16455,17,1863,8,1274,9,589,324422.591408,4.342006999999285,2347.3016049954963,1085.2124374743698
"10.0.2.109",53789,"194.247.12.49",16455,16,2137,7,1552,9,585,324422.951577,3.849646999966353,3225.23078092836,1215.6958806978678
"10.0.2.109",53790,"70.38.9.66",50002,13,1595,7,453,6,1142,324423.438519,3.4948790000053123,1036.9457712254105,2614.1105314335955
"10.0.2.109",53791,"78.49.248.111",50002,13,1927,7,453,6,1474,324424.175382,2.62572499999078,1380.1902331785413,4490.950118554459
"10.0.2.109",53792,"194.247.12.49",16455,21,2621,9,1558,12,1063,324427.737057,3.3396199999842793,3732.1611440998295,2546.3974943376884
"10.0.2.109",53793,"78.47.61.83",50002,12,2090,7,772,5,1318,324428.634107,2.4423899999819696,2528.6706873372364,4317.082857396992
"10.0.2.109",53794,"194.247.12.49",16455,28,3515,12,2081,16,1434,324443.829434,54.716183999960776,304.26098428230915,209.66374409458496
"10.0.2.109",53795,"70.38.9.66",50002,20,3031,11,1136,9,1895,324444.401756,54.143711999990046,167.84959258060604,279.99557917275393
"10.0.2.109",53796,"194.247.12.49",16455,27,4427,12,2660,15,1767,324457.726647,40.40246399998432,526.7005497488534,349.87965090459545
"10.0.2.109",53797,"192.198.93.86",50002,17,3832,9,1412,8,2420,324458.578347,39.550565999990795,285.6090605631947,489.49994799074443
"10.0.2.109",53798,"194.247.12.49",16455,21,3295,9,1966,12,1329,324522.561482,3.199138000025414,4916.32433482865,3323.395239566264
"10.0.2.109",53799,"194.247.12.49",16455,22,2565,10,1508,12,1057,324523.14505,3.3510039999964647,3600.115069994762,2523.422830891554
"10.0.2.109",53800,"192.198.93.86",50002,12,2754,7,1028,5,1726,324523.479716,2.28069600003073,3605.9167902645468,6054.29219844028
"10.0.2.109",53801,"144.76.99.209",110,12,1986,7,772,5,1214,324524.256447,2.239413999952376,2757.864334210352,4336.848836439594
"10.0.2.109",53802,"194.247.12.49",16455,21,2785,9,1719,12,1066,324537.432484,3.0065080000204034,4574.077301609267,2836.513323743734
"10.0.2.109",53803,"78.49.248.111",50002,12,2251,7,772,5,1479,324538.232425,2.206160000001546,2799.4343111994017,5363.164956300408
"10.0.2.109",53804,"194.247.12.49",16455,15,869,7,406,8,463,324581.697531,1.662676999985706,1953.4762314195257,2227.73274666808
"10.0.2.109",53805,"84.250.46.245",50002,4,228,3,170,1,58,324582.854669,0.5052269999869168,2691.8593029177346,918.39905628958
"10.0.2.109",53806,"194.247.12.49",16455,22,2665,10,1588,12,1077,324723.815692,3.5577590000466444,3570.7871162249726,2421.7491965833096
"10.0.2.109",53807,"194.247.12.49",16455,21,2566,9,1504,12,1062,324724.68384,3.162226999993436,3804.913436013599,2686.7141416532195
"10.0.2.109",53808,"96.32.46.235",50002,12,2066,7,772,5,1294,324724.873723,2.4995469999848865,2470.84771762137,4141.55044896639
"10.0.2.109",53809,"162.210.198.184",50002,12,2036,7,772,5,1264,324725.505629,2.3402529999730177,2639.030908227105,4320.900347149042
"10.0.2.109",53810,"194.247.12.49",16455,24,2738,12,1670,12,1068,324789.05302,3.9329799999832176,3396.915316136113,2172.398537505011
"10.0.2.109",53811,"76.174.18.21",50002,12,2040,7,772,5,1268,324790.118421,2.8672919999808073,2153.9487432885594,3537.832909961002
"10.0.2.109",53812,"194.247.12.49",16455,24,2738,12,1670,12,1068,324797.952406,2.4435059999814257,5467.55358902395,3496.6151096272924
"10.0.2.109",53813,"76.174.18.21",50002,12,2040,7,772,5,1268,324798.576792,1.8188160000136122,3395.6156092500714,5577.254653535092
"10.0.2.109",53814,"194.247.12.49",16455,24,2738,12,1670,12,1068,324800.840287,2.8412789999856614,4702.107747978083,3007.0964520003554
"10.0.2.109",53815,"76.174.18.21",50002,12,2040,7,772,5,1268,324801.843136,1.8381330000120215,3359.930973416836,5518.643101415218
"10.0.2.109",53816,"194.247.12.49",16455,16,1809,7,1220,9,589,324851.664313,3.566549999988638,2736.5381110684257,1321.1647109994283
"10.0.2.109",53817,"70.38.9.66",50002,13,1595,7,453,6,1142,324852.524874,2.7059720000252128,1339.259977548265,3376.2359698898863
"10.0.2.109",53818,"194.247.12.49",16455,22,2565,10,1508,12,1057,324855.254513,3.5862449999549426,3363.964257922025,2357.8980242861935
"10.0.2.109",53819,"144.76.99.209",110,12,1986,7,772,5,1214,324856.160604,2.6799060000339523,2304.5584434385964,3624.007707687119
"10.0.2.109",53820,"194.247.12.49",16455,18,2019,8,1391,10,628,324862.741021,17.25011199997971,645.0972608185436,291.2444858332462
"10.0.2.109",53821,"162.210.198.184",50002,8,1435,5,338,3,1097,324863.640005,16.350903999991715,165.37311943127855,536.7287337754809
"10.0.2.109",53822,"194.247.12.49",16455,104,12888,49,6600,55,6288,324916.235161,1197.5850540000247,44.088726578245115,42.004532230909895
"10.0.2.109",53823,"162.220.47.184",50002,98,12514,50,5992,48,6522,324917.620286,1196.1997329999576,40.07357523795878,43.618133795388374
"10.0.2.109",53824,"194.247.12.49",16455,17,1968,8,1383,9,585,324920.094556,3.134520999970846,3529.725913497758,1493.051091392761
"10.0.2.109",53825,"38.124.124.141",50002,13,1704,7,453,6,1251,324921.243461,1.9856320000253618,1825.1116017236386,5040.208860389121
"10.0.2.109",53826,"194.247.12.49",16455,12,709,6,352,6,357,325052.931874,1.1411819999921136,2467.616909502131,2502.668286057559
"10.0.2.109",53827,"194.247.12.49",16455,16,932,8,460,8,472,325052.993923,22.15068500000052,166.13481704967197,170.46876879879386
"10.0.2.109",53828,"88.150.147.146",8333,7,390,4,224,3,166,325053.963835,0.10923399997409433,16405.148584003025,12157.38689707367
"10.0.2.109",53829,"90.203.35.76",8333,3,186,3,186,0,0,325054.079328,8.994625999999698,165.4321146871532,0
"10.0.2.109",53830,"194.247.12.49",16455,16,932,8,460,8,472,325308.540187,22.359161000000313,164.5857820872594,168.87932422866615
"10.0.2.109",53831,"162.217.250.56",8333,3,186,3,186,0,0,325309.840936,9.000245000002906,165.32883271505605,0
"10.0.2.109",53832,"31.28.27.51",80,11,944,6,478,5,466,325825.303659,1620.0080849999795,2.360482046606606,2.3012230830934692
"10.0.2.109",53833,"194.247.12.49",16455,18,2448,8,1775,10,673,325825.559141,0.5224650000454858,27178.85408355344,10304.996506045896
"10.0.2.109",53834,"5.101.114.217",80,7,1820,4,339,3,1481,325825.785675,0.295685000019148,9171.922822680812,40069.6687327147
"10.0.2.109",53835,"194.247.12.49",16455,9,506,5,286,4,220,326713.899313,0.12140500004170462,18846.011278069553,14496.931752361195
"10.0.2.109",53836,"194.247.12.49",16455,9,506,5,286,4,220,327314.10101,0.1211769999936223,18881.470907188825,14524.20839014525
"10.0.2.109",53837,"31.28.27.51",80,17,1928,8,817,9,1111,327445.311913,1620.5906049999758,4.033097550877199,5.484420292563731
"10.0.2.109",53838,"194.247.12.49",16455,18,2448,8,1775,10,673,327446.09999,0.5108250000048429,27798.169627299714,10539.813047421245
"10.0.2.109",53839,"5.101.114.217",80,7,1820,4,339,3,1481,327446.31949,0.2909759999602102,9320.356319321372,40718.13483455738
"10.0.2.109",53840,"194.247.12.49",16455,3949,1188849,1900,975183,2049,213666,328021.860534,355.89308300003177,21920.808165859475,4802.925602237252
"10.0.2.109",53841,"94.198.110.184",3389,3742,1177638,1469,182337,2273,995301,328022.532323,355.22126699995715,4106.44332283229,22415.347108147555
"10.0.2.109",53842,"194.247.12.49",16455,9,506,5,286,4,220,328977.830862,0.12135799997486174,18853.31004527052,14502.546188669628
"10.0.2.109",53843,"31.28.27.51",80,9,836,5,424,4,412,329065.903072,76.38610299996799,44.405983114512615,43.149210007498105
"10.0.2.109",53844,"194.247.12.49",16455,18,2448,8,1775,10,673,329066.166142,0.5217880000127479,27214.117610318895,10318.366846053304
"10.0.2.109",53845,"5.101.114.217",80,7,1820,4,339,3,1481,329066.392421,0.2953069999930449,9183.663103359804,40120.95886748044
"10.0.2.109",53846,"194.247.12.49",16455,9,506,5,286,4,220,329666.768155,0.1254709999775514,18235.28943269247,14027.145717455745
