"Address A","Port A","Address B","Port B","Packets","Bytes","Packets A → B","Bytes A → B","Packets B → A","Bytes B → A","Rel Start","Duration","Bits/s A → B","Bits/s B → A"
"94.236.95.170",80,"147.32.84.165",61408,3,180,1,60,2,120,6359.691482,0.00014999999984866008,0,0
"111.221.102.89",12200,"147.32.84.165",8088,3,180,1,60,2,120,6055.152602,0.00023299999975279206,0,0
"111.221.102.89",12200,"147.32.84.165",8008,3,180,1,60,2,120,6055.179311,0.0003210000004401081,0,0
"111.221.102.89",12200,"147.32.84.165",8000,3,180,1,60,2,120,8253.709811,0.00031799999851500615,0,0
"111.221.102.89",12200,"147.32.84.165",8088,3,180,1,60,2,120,8253.840464,0.00023399999918183312,0,0
"111.221.102.89",12200,"147.32.84.165",8090,3,180,1,60,2,120,8253.8863,0.0002679999997781124,0,0
"111.221.102.89",12200,"147.32.84.165",8008,3,180,1,60,2,120,8253.925582,0.0002700000004551839,0,0
"111.221.102.89",12200,"147.32.84.165",57118,3,180,1,60,2,120,8253.983793,0.0002519999998185085,0,0
"111.221.102.89",12200,"147.32.84.165",58896,3,180,1,60,2,120,8254.077502,0.00027799999952549115,0,0
"111.221.102.89",12200,"147.32.84.165",35868,3,180,1,60,2,120,8254.130013,0.00027799999952549115,0,0
"111.221.102.89",12200,"147.32.84.165",8000,3,180,1,60,2,120,14304.513523,0.00026000000070780516,0,0
"111.221.102.89",12200,"147.32.84.165",8088,3,180,1,60,2,120,14304.549531,0.00025599999935366213,0,0
"111.221.102.89",12200,"147.32.84.165",8090,3,180,1,60,2,120,14304.585472,0.00018799999998009298,0,0
"147.32.84.165",1027,"74.125.232.195",80,11,1511,8,1258,3,253,166.207297,0.04513599999998519,222970.57780936066,44842.25451968859
"147.32.84.165",1039,"60.190.222.139",65520,179,11557,94,5992,85,5565,282.672963,3761.725178,12.743089335804743,11.834995352762583
"147.32.84.165",1040,"94.63.149.152",80,43,28496,32,2092,11,26404,295.602462,0.21636200000000372,77351.84551815805,976289.7366450502
"147.32.84.165",1041,"60.190.223.75",2012,88,61419,60,3794,28,57625,297.915603,2.568153000000052,11818.610495558241,179506.43906340108
"147.32.84.165",1042,"195.88.191.59",80,93,43433,60,3924,33,39509,299.76285,13.53588099999996,2319.1693248485335,23350.678097716795
"147.32.84.165",1044,"60.190.223.75",888,13,3146,10,1222,3,1924,302.034151,0.7582400000000007,12893.01540409368,20299.641274530473
"147.32.84.165",1045,"122.224.6.164",82,174,139267,118,7442,56,131825,303.560884,7.599409000000037,7834.293429923263,138773.94939527466
"147.32.84.165",1046,"147.32.84.171",139,33,4810,22,3278,11,1532,311.0735,0.018971999999962463,1382247.5226677149,646004.6384157838
"147.32.84.165",1047,"60.190.223.75",888,17,2153,12,1666,5,487,311.13014,0.980858000000012,13588.10347675182,3972.0326489664685
"147.32.84.165",1049,"60.190.223.75",888,17,2169,12,1682,5,487,312.473229,1.0298609999999826,13065.840924163773,3783.034797899975
"147.32.84.165",1048,"174.133.57.141",80,17,2283,12,1428,5,855,312.484102,297.34849299999996,38.41956582574643,23.003311471297756
"147.32.84.165",1050,"61.147.99.179",81,61,38434,42,2882,19,35552,313.434647,2.807179000000019,8213.227585415765,101317.37235138837
"147.32.84.165",1051,"94.63.150.20",80,26,11056,18,1674,8,9382,313.659773,0.8291000000000395,16152.454468700233,90527.07755396988
"147.32.84.165",1052,"195.88.191.59",80,57,33553,36,2520,21,31033,314.751246,7.151880000000006,2818.8392422691636,34713.11039894402
"147.32.84.165",1053,"60.190.223.75",888,17,2161,12,1674,5,487,316.45523,0.9909260000000017,13514.631768668878,3931.6760282806113
"147.32.84.165",1054,"94.63.149.152",80,70,49080,50,3170,20,45910,317.191975,0.25118299999996907,100962.24664887004,1462200.8655046131
"147.32.84.165",1055,"60.190.223.75",888,17,2169,12,1682,5,487,317.833036,0.973118999999997,13827.702470098768,4003.6213453853147
"147.32.84.165",1056,"74.222.3.26",443,9,552,6,372,3,180,318.014879,1.3540429999999901,2197.8622540052434,1063.4817358089888
"147.32.84.165",1057,"222.88.205.195",443,12,994,10,872,2,122,321.367546,9.560682999999983,729.6549838541882,102.08475691537956
"147.32.84.165",1058,"94.63.150.20",80,15,2068,10,1526,5,542,321.547517,0.3094809999999484,39446.68654942318,14010.553151892114
"147.32.84.165",1059,"94.63.150.20",80,15,2076,10,1534,5,542,332.458367,0.30194099999999935,40643.70191527493,14360.421406831167
"147.32.84.165",1060,"195.88.191.59",80,526,269150,322,19688,204,249462,332.867922,55.45288399999998,2840.3211634583345,35989.03891094286
"147.32.84.165",1061,"62.209.146.67",3128,6,372,6,372,0,0,337.421668,9.011905000000013,330.22984596486486,0
"147.32.84.165",1062,"94.95.56.138",3128,6,372,6,372,0,0,337.425054,9.008586000000037,330.3515113248614,0
"147.32.84.165",1063,"86.126.40.27",3128,6,372,6,372,0,0,337.425658,9.008005000000026,330.3728183987455,0
"147.32.84.165",1064,"77.127.110.198",3128,6,372,6,372,0,0,337.426249,9.007441000000028,330.3935046590914,0
"147.32.84.165",1065,"117.205.50.80",3128,6,372,6,372,0,0,337.426879,9.006834000000026,330.4157709579183,0
"147.32.84.165",1066,"188.129.211.240",3128,6,372,6,372,0,0,337.427498,9.006241999999986,330.43748990977645,0
"147.32.84.165",1067,"49.114.102.212",3128,6,372,6,372,0,0,337.430196,9.003569999999968,330.53555423015655,0
"147.32.84.165",1068,"115.99.115.251",3128,6,372,6,372,0,0,337.433862,8.999931000000004,330.66920179721365,0
"147.32.84.165",1069,"222.252.117.126",3128,6,372,6,372,0,0,337.440704,8.993115000000046,330.91982032921686,0
"147.32.84.165",1070,"115.184.216.90",3128,6,372,6,372,0,0,337.440901,8.992943000000025,330.9261495374753,0
"147.32.84.165",1071,"117.207.49.181",3128,6,372,6,372,0,0,364.259688,8.912553000000003,333.9110578080152,0
"147.32.84.165",1112,"174.123.157.154",80,14,1807,10,1308,4,499,364.259763,0.4421459999999797,23666.390739711496,9028.691880058133
"147.32.84.165",1163,"74.222.3.26",443,9,552,6,372,3,180,364.259791,1.3755239999999844,2163.539131269272,1046.8737731948088
"147.32.84.165",1072,"59.163.172.10",3128,6,372,6,372,0,0,364.25982,8.912490999999989,333.91338066989397,0
"147.32.84.165",1073,"117.199.114.136",3128,6,372,6,372,0,0,364.25985,8.912487000000056,333.9135305330579,0
"147.32.84.165",1074,"111.88.4.78",3128,6,372,6,372,0,0,364.259878,8.912484000000006,333.9136429305228,0
"147.32.84.165",1075,"27.255.59.64",3128,6,372,6,372,0,0,364.259906,8.912482000000011,333.91371786220674,0
"147.32.84.165",1077,"79.140.237.191",3128,6,372,6,372,0,0,364.259936,8.912479000000019,333.9138302597957,0
"147.32.84.165",1078,"89.34.90.20",3128,6,372,6,372,0,0,364.259964,8.912481999999954,333.9137178622089,0
"147.32.84.165",1079,"59.94.130.46",3128,6,372,6,372,0,0,364.259993,8.912479000000019,333.9138302597957,0
"147.32.84.165",1080,"59.48.7.172",3128,6,372,6,372,0,0,364.406504,8.865555000000029,335.6811840883047,0
"147.32.84.165",1081,"111.253.202.95",3128,6,372,6,372,0,0,365.635498,8.838873000000035,336.6945084514721,0
"147.32.84.165",1214,"222.88.205.195",443,6,372,6,372,0,0,385.189275,9.013470999999981,330.17247184797134,0
"147.32.84.165",1082,"182.2.117.2",3128,6,372,6,372,0,0,385.189417,9.013457000000017,330.1729846827909,0
"147.32.84.165",1083,"112.205.182.117",3128,6,372,6,372,0,0,385.189482,9.013445999999988,330.17338762555454,0
"147.32.84.165",1084,"178.121.31.113",3128,6,372,6,372,0,0,385.189546,9.013436000000013,330.1737539380094,0
"147.32.84.165",1085,"61.82.197.229",3128,6,372,6,372,0,0,385.189606,9.013428999999974,330.1740103572135,0
"147.32.84.165",1086,"203.84.189.77",3128,6,372,6,372,0,0,385.189668,9.013426000000038,330.1741202512771,0
"147.32.84.165",1087,"94.137.182.140",3128,6,372,6,372,0,0,385.189733,9.013416000000007,330.17448656535964,0
"147.32.84.165",1088,"88.135.194.91",3128,6,372,6,372,0,0,385.189796,9.013406999999972,330.17481624872914,0
"147.32.84.165",1089,"111.88.31.68",3128,6,372,6,372,0,0,385.289646,9.01308899999998,330.18646548369895,0
"147.32.84.165",1090,"91.203.175.83",3128,6,372,6,372,0,0,386.491576,9.012731999999971,330.1995443778878,0
"147.32.84.165",1265,"94.63.150.20",80,15,2074,10,1532,5,542,406.219717,0.3189750000000231,38423.07390861074,13593.541813620774
"147.32.84.165",1266,"143.107.171.10",6667,6,372,6,372,0,0,406.320841,9.014372000000037,330.13947061425773,0
"147.32.84.165",1268,"74.222.8.74",443,6,372,6,372,0,0,409.32423,9.013008000000013,330.1894328730204,0
"147.32.84.165",1267,"180.222.136.3",6667,4,248,4,248,0,0,409.324301,3.004897000000028,660.2555761478618,0
"147.32.84.165",1269,"94.63.150.20",80,15,2076,10,1534,5,542,415.018427,0.2998380000000225,40928.76820149241,14461.142350201359
"147.32.84.165",1270,"195.88.191.59",80,167,104101,106,6744,61,97357,415.425394,12.611388000000034,4278.038230209067,61758.15064923844
"147.32.84.165",1271,"84.111.18.150",6667,4,248,4,248,0,0,417.639436,3.000982000000022,661.116927725653,0
"147.32.84.165",1272,"31.192.109.167",80,15,1282,10,782,5,500,425.801306,0.23147399999999152,27026.793505967104,17280.5585076516
"147.32.84.165",1273,"212.12.200.158",6667,9,552,6,372,3,180,427.667565,1.045362999999952,2846.857981390327,1377.5119264791904
"147.32.84.165",1274,"94.63.150.20",80,15,2069,10,1526,5,543,427.695079,0.31210199999998167,39115.417395597324,13918.52663552382
"147.32.84.165",1276,"31.192.109.167",80,15,1528,10,1038,5,490,428.974532,0.2366519999999923,35089.49850413379,16564.406808309785
"147.32.84.165",1277,"67.195.168.31",25,6,372,6,372,0,0,429.326294,8.93948899999998,332.9049344990532,0
"147.32.84.165",1278,"221.130.69.202",6667,9,552,6,372,3,180,431.726883,2.013124000000005,1478.2993993415175,715.306160971702
"147.32.84.165",1279,"74.222.3.26",443,9,552,6,372,3,180,432.357408,1.3820069999999873,2153.38996112178,1041.9628844137644
"147.32.84.165",1280,"222.88.205.195",443,14,1118,12,996,2,122,435.742585,21.462897999999996,371.24529967947484,45.47382184828909
"147.32.84.165",1281,"82.227.106.170",6667,4,248,4,248,0,0,436.754067,2.813411999999971,705.1935514599427,0
"147.32.84.165",1282,"94.63.150.20",80,15,2077,10,1534,5,543,438.640278,0.2997649999999794,40938.73534268791,14491.351558721994
"147.32.84.165",1283,"195.88.191.59",80,214,107317,136,8532,78,98785,439.035933,15.650941999999986,4361.143246202054,50494.08527614508
"147.32.84.165",1284,"123.194.145.64",6667,4,248,4,248,0,0,446.758264,2.924386000000027,678.4330112372245,0
"147.32.84.165",1285,"94.63.150.20",80,15,2059,10,1516,5,543,454.346369,0.29995200000001887,40433.13596841907,14482.317170746408
"147.32.84.165",1286,"94.63.150.20",80,15,2077,10,1534,5,543,454.77016,0.3310950000000048,37064.89074132748,13120.101481447733
"147.32.84.165",1287,"58.143.125.236",6667,9,552,6,372,3,180,456.7623,1.8613410000000385,1598.84728268487,773.6357819442919
"147.32.84.165",1288,"200.171.4.222",6667,15,1738,10,1180,5,558,461.629378,1.2275320000000534,7690.227220145454,3636.5650752891215
"147.32.84.165",1289,"212.117.171.138",65500,46,4234,30,3214,16,1020,462.610762,87.40051800000003,294.18589944741507,93.36329105051753
"147.32.84.165",1290,"187.106.81.34",6667,4,248,4,248,0,0,465.565688,2.943698999999981,673.9819526385044,0
"147.32.84.165",1292,"195.113.232.98",80,18,5867,14,1062,4,4805,466.290642,499.999743,16.99200873389249,76.8800395163403
"147.32.84.165",1294,"60.199.114.56",10298,74,47339,46,3062,28,44277,469.2702,17.03633400000001,1437.868029588994,20791.797108462408
"147.32.84.165",1295,"77.79.4.96",41422,73,47819,50,3294,23,44525,469.27036,15.33239500000002,1718.713873468559,23231.856471216634
"147.32.84.165",1296,"77.79.4.96",41422,72,47253,50,3294,22,43959,469.270507,15.348004000000003,1716.9659325082268,22913.20747635979
"147.32.84.165",1297,"60.199.114.56",10298,73,47795,46,3060,27,44735,469.270709,16.994436000000007,1440.471457834787,21058.65708047033
"147.32.84.165",1298,"220.164.82.72",6667,4,248,4,248,0,0,475.569727,2.9536039999999844,671.7217338546435,0
"147.32.84.165",1299,"218.201.21.157",6667,4,248,4,248,0,0,485.57431,2.963688999999988,669.4359630851982,0
"147.32.84.165",1300,"74.222.8.74",443,6,372,6,372,0,0,487.366719,8.982763000000034,331.30118205278137,0
"147.32.84.165",1301,"59.78.181.188",6667,4,248,4,248,0,0,495.578611,2.973634000000004,667.1971063015816,0
"147.32.84.165",1302,"173.192.170.88",80,28,4642,20,1654,8,2988,497.382631,48.96007800000001,270.2610073456173,488.2345162930499
"147.32.84.165",1304,"173.236.81.226",3817,11,666,8,484,3,182,505.218639,0.390515999999991,9915.086705794614,3728.4003728401235
"147.32.84.165",1305,"61.17.216.82",6667,4,248,4,248,0,0,505.583379,2.8831860000000233,688.1276476786388,0
"147.32.84.165",1306,"184.154.132.106",9541,11,666,8,484,3,182,505.619538,0.5644160000000511,6860.1882299574245,2579.6575575459733
"147.32.84.165",1307,"69.175.10.98",4190,11,666,8,484,3,182,505.770566,0.4493510000000356,8616.871888567497,3240.2286853704227
"147.32.84.165",1309,"74.222.3.26",443,9,552,6,372,3,180,510.269216,1.3765710000000126,2161.8935746866473,1046.0775361387002
"147.32.84.165",1310,"222.88.205.195",443,25,2914,22,2732,3,182,513.6446,189.24062200000003,115.49317355340332,7.693908340673282
"147.32.84.165",1311,"218.248.255.243",6667,4,248,4,248,0,0,515.587465,2.9940920000000233,662.6382890038063,0
"147.32.84.165",1313,"208.73.210.29",80,66,35797,40,4052,26,31745,519.694853,19.80677000000003,1636.612128075398,12821.878579899683
"147.32.84.165",1314,"74.125.232.220",80,14,3714,10,1580,4,2134,520.790121,18.711719000000016,675.5124956718295,912.3694087111925
"147.32.84.165",1315,"74.125.232.217",80,13,2940,10,2066,3,874,520.813489,18.688535,884.3924898340077,374.133124934619
"147.32.84.165",1316,"94.127.76.180",80,24,9430,18,4844,6,4586,520.88114,18.62106700000004,2081.0837531490497,1970.241554901227
"147.32.84.165",1317,"94.127.76.180",80,24,9046,18,4822,6,4224,520.881462,18.620923999999945,2071.6480020003364,1814.7327168082581
"147.32.84.165",1318,"208.73.210.29",80,13,3926,10,2958,3,968,520.968497,18.534072000000037,1276.7836447381856,417.82507373447044
"147.32.84.165",1319,"195.113.232.91",80,13,3207,10,1492,3,1715,521.160048,18.34270200000003,650.7220146737367,747.981404266393
"147.32.84.165",1320,"50.22.198.84",80,13,3359,10,2328,3,1031,521.194806,0.36791500000003907,50620.38786132129,22418.22160009547
"147.32.84.165",1321,"67.214.158.5",80,15,2571,10,1716,5,855,521.293262,0.315021999999999,43577.90884446179,21712.76926690841
"147.32.84.165",1322,"195.113.232.83",80,13,2136,10,1548,3,588,521.36133,18.141602000000034,682.6299022544964,259.29352876333587
"147.32.84.165",1323,"50.22.198.84",80,13,2952,10,2432,3,520,521.442449,0.3705730000000358,52502.47589543254,11225.858332904983
"147.32.84.165",1324,"67.214.158.5",80,15,2656,10,1760,5,896,521.505834,0.32722799999999097,43028.10272959645,21905.215935067285
"147.32.84.165",1325,"68.67.185.212",80,16,2230,12,1288,4,942,521.766535,10.274034000000029,1002.9166732366245,733.4996166062891
"147.32.84.165",1326,"68.67.185.212",80,16,2257,12,1288,4,969,521.766747,10.274059999999963,1002.9141352104267,754.5215815364157
"147.32.84.165",1327,"217.163.21.38",80,15,2142,10,1186,5,956,521.820204,0.1428600000000415,66414.67170654658,53534.92930139841
"147.32.84.165",1328,"94.245.121.179",80,13,2297,10,1212,3,1085,521.952705,0.11235099999998965,86300.96750363498,77257.87932462372
"147.32.84.165",1329,"190.151.53.33",6667,4,248,4,248,0,0,525.59158,3.0041290000000345,660.4243692597679,0
"147.32.84.165",1330,"77.127.110.198",6667,9,552,6,372,3,180,535.596126,1.2050009999999247,2469.7074940188313,1195.0197551704023
"147.32.84.165",1331,"117.224.216.244",6667,9,552,6,372,3,180,539.811918,3.2245450000000346,922.92090822115,446.57463301023387
"147.32.84.165",1332,"59.48.7.172",6667,9,552,6,372,3,180,546.051139,1.9162400000000162,1553.041372688168,751.4716319458877
"147.32.84.165",1333,"173.192.170.88",80,17,1641,12,1084,5,557,546.14213,72.93598100000008,118.89879153061628,61.09467424589785
"147.32.84.165",1334,"74.222.8.74",443,6,372,6,372,0,0,547.362704,8.97284000000002,331.6675656759726,0
"147.32.84.165",1336,"212.117.171.138",65500,22,1356,16,972,6,384,548.11361,108.02709200000004,71.9819431962493,28.4373108923454
"147.32.84.165",1337,"64.12.175.136",587,24,2237,16,1054,8,1183,548.437523,1.6695379999999886,5050.499000322279,5668.634077211818
"147.32.84.165",1338,"31.192.109.167",80,15,1540,10,1050,5,490,549.135496,0.2333210000000463,36001.902957720624,16800.88804693629
"147.32.84.165",1339,"61.17.216.23",6667,4,248,4,248,0,0,550.978345,2.953473000000031,671.7515277776297,0
"147.32.84.165",1340,"190.107.110.169",6667,4,248,4,248,0,0,560.982889,2.9636319999999614,669.4488384522862,0
"147.32.84.165",1341,"74.222.3.26",443,9,552,6,372,3,180,570.355652,1.3750760000000355,2164.2440126945153,1047.2148448521848
"147.32.84.165",1342,"125.99.28.64",6667,4,248,4,248,0,0,570.986861,2.9743310000000065,667.0407563919401,0
"147.32.84.165",1343,"222.88.205.195",443,6,372,6,372,0,0,573.730811,8.842906999999968,336.54091352538376,0
"147.32.84.165",1344,"61.17.216.4",6667,15,1708,10,1150,5,558,580.991213,1.0415269999999737,8833.184353358321,4286.014668846908
"147.32.84.165",1346,"190.53.151.16",6667,4,248,4,248,0,0,584.846782,2.9344030000000885,676.1170841223718,0
"147.32.84.165",1348,"98.126.71.122",80,18,4863,14,1430,4,3433,592.034694,15.967853000000105,716.4394612099651,1719.955713520147
"147.32.84.165",1349,"195.113.232.83",80,17,7242,14,1372,3,5870,592.602612,19.402158999999983,565.710238741988,2420.349199282412
"147.32.84.165",1350,"195.113.232.88",80,17,5675,12,2556,5,3119,592.699798,19.30517599999996,1059.1978027032771,1292.5031090107675
"147.32.84.165",1351,"195.113.232.83",80,37,23376,28,2492,9,20884,592.991845,19.013315000000034,1048.5283602570075,8787.105247033445
"147.32.84.165",1352,"41.251.251.106",6667,9,552,6,372,3,180,594.838042,2.400649000000044,1239.6647739840125,599.8377938632318
"147.32.84.165",1353,"74.222.8.74",443,6,372,6,372,0,0,596.585506,8.934105000000045,333.10555450154044,0
"147.32.84.165",1354,"114.120.50.74",6667,4,248,4,248,0,0,600.24904,2.963722999999959,669.428283277495,0
"147.32.84.165",1355,"208.81.160.62",6667,4,248,4,248,0,0,610.251222,3.0047630000000254,660.2850208152801,0
"147.32.84.165",1356,"173.192.170.88",80,11,1283,8,846,3,437,618.875908,12.65923900000007,534.6292932774207,276.16193990807665
"147.32.84.165",1357,"74.222.3.26",443,9,552,6,372,3,180,619.565885,1.2744579999999814,2335.1102978678337,1129.8920796134678
"147.32.84.165",1358,"178.122.247.101",6667,4,248,4,248,0,0,620.266898,2.9033560000000307,683.347133455208,0
"147.32.84.165",1359,"222.88.205.195",443,6,372,6,372,0,0,622.840535,8.94227699999999,332.8011422594048,0
"147.32.84.165",1360,"173.236.81.226",3817,11,666,8,484,3,182,625.473909,0.39927299999999377,9697.625434226858,3646.6277459282815
"147.32.84.165",1361,"184.154.132.106",9541,11,666,8,484,3,182,626.03487,0.4643510000000788,8338.519783524409,3135.559092151741
"147.32.84.165",1362,"69.175.10.98",4190,11,666,8,484,3,182,626.084947,0.41786599999988994,9266.128376084725,3484.3705877012812
"147.32.84.165",1363,"124.123.147.161",6667,4,248,4,248,0,0,630.270849,2.914372999999955,680.763924178556,0
"147.32.84.165",1365,"212.117.171.138",65500,299,185021,198,13398,101,171623,635.007305,79.07041200000003,1355.5513028059088,17364.067863969136
"147.32.84.165",1366,"205.188.103.1",25,6,372,6,372,0,0,635.176595,8.924139999999966,333.477511558538,0
"147.32.84.165",1367,"115.98.214.212",6667,4,248,4,248,0,0,640.275554,2.9237059999999246,678.5908022215815,0
"147.32.84.165",1368,"74.222.8.74",443,6,372,6,372,0,0,645.803083,9.013342999999963,330.1771606827802,0
"147.32.84.165",1369,"180.241.97.224",6667,4,248,4,248,0,0,650.280214,2.9337229999999863,676.2737995373146,0
"147.32.84.165",1370,"178.123.195.112",6667,9,552,6,372,3,180,660.284931,1.5213830000000144,1956.1149296396582,946.5072240191894
"147.32.84.165",1371,"190.77.235.75",6667,4,248,4,248,0,0,664.82051,2.9139979999999923,680.8515311266532,0
"147.32.84.165",1372,"74.222.3.26",443,9,552,6,372,3,180,668.836483,1.3794029999999111,2157.455072955613,1043.9298740107806
"147.32.84.165",1373,"31.192.109.167",80,15,1540,10,1050,5,490,669.296926,0.23403300000006766,35892.37415235275,16749.774604431284
"147.32.84.165",1374,"222.88.205.195",443,25,2914,22,2732,3,182,672.210983,189.20187799999997,115.51682378121006,7.6954838682943745
"147.32.84.165",1375,"200.29.244.194",6667,4,248,4,248,0,0,674.825364,2.923314000000005,678.6817974394802,0
"147.32.84.165",1376,"41.223.57.72",6667,4,248,4,248,0,0,684.829461,2.9342570000000023,676.1507257203436,0
"147.32.84.165",1378,"212.117.171.138",65500,69,6880,44,4274,25,2606,686.682061,150.08679100000006,227.81485147483755,138.90629455859303
"147.32.84.165",1379,"205.188.186.137",587,68,24462,42,22020,26,2442,686.936551,27.02141199999994,6519.274418376079,722.9822038907531
"147.32.84.165",1380,"190.107.110.169",6667,4,248,4,248,0,0,694.834231,2.943612999999914,674.001643558463,0
"147.32.84.165",1381,"60.190.223.75",88,88,61577,60,3962,28,57615,697.21595,133.28536599999995,237.80555173626496,3458.1440846251653
"147.32.84.165",1382,"60.190.223.75",888,13,3146,10,1222,3,1924,701.548533,0.7763879999999972,12591.642323168358,19825.138976903374
"147.32.84.165",1383,"122.224.6.164",82,175,139321,118,7442,57,131879,702.530135,7.653002000000015,7779.430869089004,137858.58150827582
"147.32.84.165",1384,"186.92.63.171",6667,4,248,4,248,0,0,704.83785,2.9546920000000227,671.4743871780831,0
"147.32.84.165",1385,"74.222.3.26",443,9,552,6,372,3,180,705.929442,1.4407899999999927,2065.5334920425703,999.451689698018
"147.32.84.165",1386,"222.88.205.195",443,25,2914,22,2732,3,182,709.364538,193.40784999999994,113.00472033580853,7.528132906704668
"147.32.84.165",1387,"60.190.223.75",888,17,2161,12,1674,5,487,710.146586,0.9749180000000024,13736.53989361153,3996.233529384
"147.32.84.165",1388,"60.190.223.75",888,17,2169,12,1682,5,487,711.527158,0.9721090000000459,13842.069150681009,4007.7810204409343
"147.32.84.165",1389,"61.147.99.179",81,63,38542,42,2882,21,35660,712.462202,3.3225889999999936,6939.1670170460575,85860.7549714998
"147.32.84.165",1390,"101.0.32.121",6667,4,248,4,248,0,0,714.842602,2.9636299999999665,669.4492902285449,0
"147.32.84.165",1391,"60.190.223.75",888,17,2161,12,1674,5,487,715.992055,1.0076789999999392,13289.946500821005,3866.3106008959553
"147.32.84.165",1392,"60.190.223.75",888,17,2169,12,1682,5,487,716.93453,0.9555609999999888,14081.78023171745,4077.186071846848
"147.32.84.165",1393,"188.173.49.47",6667,4,248,4,248,0,0,724.846758,2.9740070000000287,667.1134264310679,0
"147.32.84.165",1394,"115.98.214.212",6667,4,248,4,248,0,0,734.851583,2.9839600000000246,664.8882692797436,0
"147.32.84.165",1395,"211.157.110.34",6667,19,4506,18,4444,1,62,744.855471,93.22382700000003,381.3617306227944,5.3205281950074825
"147.32.84.165",1396,"173.236.81.226",3817,11,666,8,484,3,182,745.738061,0.44527400000004036,8695.769346513942,3269.896737738714
"147.32.84.165",1397,"69.175.10.98",4190,14,850,10,608,4,242,746.359608,1.2024639999999636,4045.0275434442506,1610.0274103840602
"147.32.84.165",1398,"184.154.132.106",9541,46662,2867642,31074,1864444,15588,1003198,746.359908,16303.384907999998,914.8745542210075,492.2648913270692
"147.32.84.165",1399,"66.94.238.147",25,4,248,4,248,0,0,746.999406,2.9533709999999473,671.7747279295542,0
"147.32.84.165",1400,"74.222.3.26",443,9,552,6,372,3,180,747.328998,1.3953390000000354,2132.815036345952,1032.0072756512673
"147.32.84.165",1401,"72.249.19.141",25,4,248,4,248,0,0,747.739807,2.9142539999999144,680.7917223413122,0
"147.32.84.165",1402,"64.12.90.97",25,4,248,4,248,0,0,750.122914,2.9342929999999114,676.1424302208607,0
"147.32.84.165",1403,"222.88.205.195",443,25,2914,22,2732,3,182,750.723827,189.20193399999994,115.5167895905335,7.695481590584589
"147.32.84.165",1404,"65.55.92.168",25,4,248,4,248,0,0,750.86443,2.994060999999988,662.6451498483191,0
"147.32.84.165",1405,"66.94.238.147",25,4,248,4,248,0,0,754.388987,2.9744569999999158,667.0125000966752,0
"147.32.84.165",1406,"218.93.203.210",6667,4,248,4,248,0,0,755.661125,3.0038580000000366,660.4839509723748,0
"147.32.84.165",1407,"74.125.113.27",25,4,248,4,248,0,0,759.1663,2.9042239999999993,683.1428980684688,0
"147.32.84.165",1408,"98.139.54.60",25,6,372,6,372,0,0,761.127444,8.954115999999999,332.36111750171654,0
"147.32.84.165",1409,"66.94.238.147",25,4,248,4,248,0,0,762.32047,2.9544200000000274,671.5362067681581,0
"147.32.84.165",1410,"61.135.132.110",25,4,248,4,248,0,0,763.041731,2.934110999999916,676.1843706662961,0
"147.32.84.165",1411,"207.115.20.21",25,6,372,6,372,0,0,764.023279,8.962576000000013,332.0473935172205,0
"147.32.84.165",1412,"74.125.113.27",25,6,372,6,372,0,0,764.543546,8.942817999999988,332.7810092970699,0
"147.32.84.165",1413,"65.54.188.72",25,4,248,4,248,0,0,764.824469,2.9539250000000266,671.6487385427803,0
"147.32.84.165",1415,"205.188.190.2",25,4,248,4,248,0,0,767.177753,3.0040769999999384,660.4358010796797,0
"147.32.84.165",1414,"200.161.192.230",6667,4,248,4,248,0,0,768.980057,3.00444600000003,660.3546876861758,0
"147.32.84.165",1416,"65.55.88.22",25,4,248,4,248,0,0,774.387821,3.004636000000005,660.3129297525546,0
"147.32.84.165",1417,"66.94.238.147",25,6,372,6,372,0,0,774.388027,9.012839999999983,330.1955876283176,0
"147.32.84.165",1418,"65.123.201.4",25,2,124,2,124,0,0,775.58977,1.1999999969702912e-05,0,0
"147.32.84.165",1422,"178.125.252.68",6667,2,124,2,124,0,0,779.795677,1.0000000088439265e-05,0,0
"147.32.84.165",1419,"205.188.156.193",25,6,372,6,372,0,0,781.598683,9.01229699999999,330.2154822460915,0
"147.32.84.165",1420,"32.97.110.158",25,6,372,6,372,0,0,782.199177,9.01278000000002,330.19778581081454,0
"147.32.84.165",1421,"65.54.188.94",25,6,372,6,372,0,0,782.199329,9.01267699999994,330.2015594256867,0
"147.32.84.165",1427,"74.222.8.74",443,6,372,6,372,0,0,784.602721,9.012505000000033,330.20786118842534,0
"147.32.84.165",1428,"91.203.175.83",6667,4,248,4,248,0,0,787.607267,3.003586000000041,660.5437633548607,0
"147.32.84.165",1423,"205.188.156.193",25,6,372,6,372,0,0,788.207485,9.013272000000029,330.1797615782582,0
"147.32.84.165",1424,"209.86.93.229",25,2,124,2,124,0,0,788.207619,5.999999984851456e-06,0,0
"147.32.84.165",1425,"74.125.113.27",25,6,372,6,372,0,0,789.409396,9.013105999999993,330.18584270505664,0
"147.32.84.165",1432,"31.192.109.167",80,15,1540,10,1050,5,490,792.41353,0.24031300000001465,34954.413618903214,16312.059688821499
"147.32.84.165",1426,"207.115.21.24",25,6,372,6,372,0,0,792.491338,8.935435999999982,333.0559359386611,0
"147.32.84.165",1429,"205.188.59.193",25,6,372,6,372,0,0,794.216762,9.01248099999998,330.20874052328173,0
"147.32.84.165",1430,"65.54.188.94",25,6,372,6,372,0,0,795.418128,9.01291900000001,330.19269339933004,0
"147.32.84.165",1431,"65.54.188.126",25,6,372,6,372,0,0,795.418187,9.012911000000031,330.19298648350014,0
"147.32.84.165",1438,"173.192.170.88",80,6,372,6,372,0,0,800.224728,9.012931999999978,330.19221713866335,0
"147.32.84.165",1434,"117.196.25.55",6667,2,124,2,124,0,0,802.628435,1.200000008338975e-05,0,0
"147.32.84.165",1433,"64.12.90.33",25,6,372,6,372,0,0,803.229308,9.013052000000016,330.1878209512155,0
"147.32.84.165",1435,"212.94.129.132",25,6,372,6,372,0,0,803.229377,9.013107999999988,330.1857694371358,0
"147.32.84.165",1437,"212.117.171.138",65500,70,6855,46,4394,24,2461,804.430799,171.60592900000006,204.84140731524485,114.7279707334587
"147.32.84.165",1439,"64.12.90.33",25,2,124,2,124,0,0,804.430932,5.999999984851456e-06,0,0
"147.32.84.165",1443,"64.12.168.40",587,44,5639,28,3866,16,1773,804.430989,32.432607000000075,953.6082005371917,437.33764603011923
"147.32.84.165",1440,"66.94.238.147",25,2,124,2,124,0,0,804.549125,8.999999977277184e-06,0,0
"147.32.84.165",1441,"216.228.2.128",25,6,372,6,372,0,0,805.632838,9.012786000000006,330.1975659912482,0
"147.32.84.165",1446,"74.222.3.26",443,9,552,6,372,3,180,810.439404,1.375421000000074,2163.701150411285,1046.9521695538476
"147.32.84.165",1444,"67.197.202.25",6667,6,368,4,248,2,120,811.815107,0.7616900000000442,2604.734209455139,1260.3552626395835
"147.32.84.165",1442,"74.125.113.27",25,6,372,6,372,0,0,813.44395,9.012952000000041,330.1914844326239,0
"147.32.84.165",1453,"222.88.205.195",443,23,2790,20,2608,3,182,814.645429,93.23428799999999,223.78033283205855,15.616572306531692
"147.32.84.165",1445,"66.94.238.147",25,6,372,6,372,0,0,814.645563,9.013455999999906,330.17302131391455,0
"147.32.84.165",1447,"205.188.190.2",25,6,372,6,372,0,0,815.246675,9.013026999999965,330.1887368139485,0
"147.32.84.165",1457,"79.136.165.190",6667,4,248,4,248,0,0,816.448896,3.003747999999973,660.5081384989745,0
"147.32.84.165",1448,"74.125.113.27",25,4,248,4,248,0,0,818.250591,3.0046270000000277,660.3149076407759,0
"147.32.84.165",1449,"72.214.132.82",25,6,372,6,372,0,0,818.250728,9.013299000000075,330.178772500499,0
"147.32.84.165",1450,"158.52.11.15",25,6,372,6,372,0,0,821.255449,8.912383999999975,333.9173895559267,0
"147.32.84.165",1460,"173.192.170.88",80,19,5451,14,1728,5,3723,824.259509,4.49485100000004,3075.519077273057,6626.248567527541
"147.32.84.165",1451,"66.96.141.50",25,6,372,6,372,0,0,824.259763,8.91373699999997,333.8667048399577,0
"147.32.84.165",1452,"66.94.238.147",25,6,372,6,372,0,0,824.259825,8.913798000000043,333.8644200822125,0
"147.32.84.165",1454,"205.188.59.193",25,6,372,6,372,0,0,824.259883,8.913790000000063,333.8647197207898,0
"147.32.84.165",1455,"66.94.238.147",25,2,124,2,124,0,0,824.460422,7.999999979801942e-06,0,0
"147.32.84.165",1456,"74.125.67.27",25,6,372,6,372,0,0,824.460484,8.912646999999993,333.9075361113261,0
"147.32.84.165",1463,"184.106.213.57",6667,5,306,4,244,1,62,832.672455,0.13068999999995867,14936.108348003805,3795.2406458042456
"147.32.84.165",1458,"69.84.129.233",25,6,372,6,372,0,0,834.374242,9.012732000000028,330.19954437788573,0
"147.32.84.165",1459,"216.228.2.128",25,2,124,2,124,0,0,834.474251,8.999999977277184e-06,0,0
"147.32.84.165",1461,"64.12.90.33",25,6,372,6,372,0,0,835.575694,9.013482999999951,330.17203227653687,0
"147.32.84.165",1469,"61.178.56.36",6667,4,248,4,248,0,0,836.176562,3.004107999999974,660.4289859086349,0
"147.32.84.165",1462,"207.115.21.23",25,6,372,6,372,0,0,839.180807,9.01310699999999,330.18580607109214,0
"147.32.84.165",1464,"205.188.156.193",25,6,372,6,372,0,0,842.886222,9.01302099999998,330.18895662175936,0
"147.32.84.165",1465,"65.55.92.168",25,6,372,6,372,0,0,844.688704,9.013535999999931,330.17009085003076,0
"147.32.84.165",1466,"66.94.238.147",25,6,372,6,372,0,0,845.189785,9.012920000000008,330.1926567638454,0
"147.32.84.165",1467,"205.188.59.193",25,6,372,6,372,0,0,845.189926,9.012904999999932,330.1932062969733,0
"147.32.84.165",1468,"94.126.40.212",25,2,124,2,124,0,0,845.389965,8.00000009348878e-06,0,0
"147.32.84.165",1476,"74.222.8.74",443,6,372,6,372,0,0,848.895161,9.012522999999987,330.2072016903595,0
"147.32.84.165",1477,"178.123.29.226",6667,6,372,6,372,0,0,854.30251,9.012921000000006,330.19262012836884,0
"147.32.84.165",1470,"65.55.92.152",25,6,372,6,372,0,0,855.40415,9.012927999999988,330.1923636802606,0
"147.32.84.165",1479,"113.255.129.49",6667,4,248,4,248,0,0,856.605808,3.0043249999999944,660.3812836494067,0
"147.32.84.165",1471,"168.95.5.68",25,6,372,6,372,0,0,857.30685,9.013124999999945,330.1851466611212,0
"147.32.84.165",1472,"66.94.238.147",25,6,372,6,372,0,0,860.21223,9.011944999999969,330.2283802220287,0
"147.32.84.165",1473,"64.12.90.33",25,6,372,6,372,0,0,860.212363,9.011940999999979,330.22852679572657,0
"147.32.84.165",1474,"212.122.94.171",25,4,248,4,248,0,0,863.916303,3.0045129999999745,660.3399619172947,0
"147.32.84.165",1480,"183.83.68.80",6667,4,248,4,248,0,0,865.719634,3.0036929999999984,660.520232926601,0
"147.32.84.165",1475,"64.12.90.97",25,2,124,2,124,0,0,866.22029,8.999999977277184e-06,0,0
"147.32.84.165",1478,"74.125.113.27",25,2,124,2,124,0,0,866.220427,6.999999982326699e-06,0,0
"147.32.84.165",1481,"173.236.81.226",3817,11,666,8,484,3,182,869.925046,0.5491400000000795,7051.025239464326,2651.41858178204
"147.32.84.165",1482,"69.175.10.98",4190,11,666,8,484,3,182,870.051289,0.6243749999999864,6201.4014014015365,2331.931931931983
"147.32.84.165",1483,"207.115.37.21",25,4,248,4,248,0,0,870.180556,2.9492609999999786,672.7108926609121,0
"147.32.84.165",1490,"74.222.3.26",443,9,552,6,372,3,180,874.131374,1.381644999999935,2153.954163334388,1042.2358854843812
"147.32.84.165",1484,"66.94.238.147",25,6,372,6,372,0,0,875.333569,9.012391999999977,330.2120014309195,0
"147.32.84.165",1485,"65.55.92.168",25,6,372,6,372,0,0,875.513233,8.93258800000001,333.16212501908706,0
"147.32.84.165",1493,"61.150.114.216",6667,15,1760,10,1202,5,558,876.434489,1.6171779999999671,5946.160533967315,2760.36404155887
"147.32.84.165",1486,"64.15.138.19",25,6,372,6,372,0,0,876.782041,8.966050999999993,331.9187008862656,0
"147.32.84.165",1495,"222.88.205.195",443,23,2790,20,2608,3,182,880.740937,93.23389399999996,223.78127851229735,15.616638301088235
"147.32.84.165",1497,"114.58.187.40",6667,9,552,6,372,3,180,880.74107,2.584321999999929,1151.5592871167298,557.2061066693855
"147.32.84.165",1487,"205.188.156.193",25,2,124,2,124,0,0,880.741127,5.999999984851456e-06,0,0
"147.32.84.165",1488,"74.125.113.27",25,4,248,4,248,0,0,880.741184,3.003778000000011,660.5015417251184,0
"147.32.84.165",1489,"98.129.185.3",25,6,372,6,372,0,0,880.741244,9.012768999999935,330.19818881411715,0
"147.32.84.165",1491,"66.94.238.147",25,6,372,6,372,0,0,881.242798,9.011626999999976,330.2400332370623,0
"147.32.84.165",1492,"65.55.37.72",25,2,124,2,124,0,0,881.242934,4.9999999873762135e-06,0,0
"147.32.84.165",1494,"205.188.59.193",25,2,124,2,124,0,0,883.325685,8.999999977277184e-06,0,0
"147.32.84.165",1496,"207.115.37.21",25,2,124,2,124,0,0,884.345806,1.1999999969702912e-05,0,0
"147.32.84.165",1502,"168.187.75.100",6667,4,248,4,248,0,0,889.753861,3.004575999999929,660.3261158978994,0
"147.32.84.165",1498,"80.67.18.126",25,6,372,6,372,0,0,893.9596,8.91297899999995,333.89509837283543,0
"147.32.84.165",1499,"66.94.238.147",25,6,372,6,372,0,0,893.959737,8.912964999999986,333.89562283706994,0
"147.32.84.165",1500,"208.65.144.13",25,4,248,4,248,0,0,893.959797,3.0043339999999716,660.3793053635244,0
"147.32.84.165",1501,"209.191.88.254",25,6,372,6,372,0,0,895.762431,9.012862000000041,330.1947816353991,0
"147.32.84.165",1510,"42.201.161.145",6667,4,248,4,248,0,0,896.363407,2.90376399999991,683.2511182038421,0
"147.32.84.165",1503,"64.12.90.97",25,6,372,6,372,0,0,896.463063,8.912916999999993,333.8974210126721,0
"147.32.84.165",1504,"65.55.88.22",25,2,124,2,124,0,0,896.963831,8.999999977277184e-06,0,0
"147.32.84.165",1505,"203.188.197.119",25,6,372,6,372,0,0,896.963964,8.912789999999973,333.90217877903655,0
"147.32.84.165",1506,"66.94.238.147",25,6,372,6,372,0,0,901.670667,9.013111999999978,330.1856229013916,0
"147.32.84.165",1507,"64.12.90.33",25,6,372,6,372,0,0,901.771346,9.012676000000056,330.2015960631428,0
"147.32.84.165",1508,"64.15.138.19",25,6,372,6,372,0,0,904.775066,9.013451999999916,330.17316783847383,0
"147.32.84.165",1514,"115.98.214.212",6667,4,248,4,248,0,0,909.582264,3.0044789999999466,660.3474346134672,0
"147.32.84.165",1509,"209.86.93.226",25,6,372,6,372,0,0,914.389302,9.012703999999985,330.2005702173293,0
"147.32.84.165",1522,"31.192.109.167",80,15,1540,10,1050,5,490,914.889558,0.23767100000009123,35342.9741112579,16493.387918587017
"147.32.84.165",1520,"74.222.3.26",443,9,552,6,372,3,180,914.967207,1.397852999999941,2128.9792274295837,1030.1512390788307
"147.32.84.165",1511,"205.188.59.193",25,6,372,6,372,0,0,914.9897,9.013186000000019,330.18291201357584,0
"147.32.84.165",1526,"85.186.104.184",6667,4,248,4,248,0,0,916.365277,2.9310159999999996,676.8983860886465,0
"147.32.84.165",1512,"64.12.90.33",25,6,372,6,372,0,0,917.393329,9.012751999999978,330.1988116393314,0
"147.32.84.165",1513,"66.94.237.64",25,6,372,6,372,0,0,917.393442,9.012764999999945,330.198335361015,0
"147.32.84.165",1515,"98.137.54.238",25,6,372,6,372,0,0,917.894988,9.012089999999944,330.22306701331416,0
"147.32.84.165",1528,"222.88.205.195",443,6,372,6,372,0,0,921.599166,9.013003000000026,330.1896160469481,0
"147.32.84.165",1516,"205.188.156.193",25,6,372,6,372,0,0,921.599299,9.012995000000046,330.1899091256552,0
"147.32.84.165",1517,"65.55.92.184",25,6,372,6,372,0,0,922.702607,9.01153700000009,330.2433314094999,0
"147.32.84.165",1518,"66.94.238.147",25,6,372,6,372,0,0,922.8025,9.011772999999948,330.2346830085508,0
"147.32.84.165",1519,"203.188.197.119",25,6,372,6,372,0,0,925.204448,9.012970999999993,330.19078836490235,0
"147.32.84.165",1521,"64.12.90.97",25,6,372,6,372,0,0,925.805398,9.013373999999999,330.176025093378,0
"147.32.84.165",1536,"62.24.74.140",6667,9,552,6,372,3,180,934.818636,1.011630000000082,2941.7870169921403,1423.4453308026484
"147.32.84.165",1523,"98.137.34.115",25,6,372,6,372,0,0,935.419221,9.012868000000026,330.19456181983264,0
"147.32.84.165",1524,"66.94.238.147",25,6,372,6,372,0,0,935.830487,9.007874000000015,330.3776229552051,0
"147.32.84.165",1525,"203.188.197.119",25,6,372,6,372,0,0,935.830549,9.007933999999977,330.3754223776515,0
"147.32.84.165",1527,"205.188.59.193",25,6,372,6,372,0,0,935.830604,9.00793299999998,330.3754590537037,0
"147.32.84.165",1529,"65.55.92.136",25,6,372,6,372,0,0,935.830665,9.007927999999993,330.37564243408724,0
"147.32.84.165",1530,"66.94.238.147",25,6,372,6,372,0,0,936.019943,9.013245999999981,330.1807140291085,0
"147.32.84.165",1531,"65.55.92.136",25,6,372,6,372,0,0,936.020075,9.013237000000004,330.18104372491246,0
"147.32.84.165",1532,"205.188.156.193",25,6,372,6,372,0,0,936.020134,9.013226000000031,330.18144668734476,0
"147.32.84.165",1533,"198.17.145.13",25,6,372,6,372,0,0,936.02019,9.013226000000031,330.18144668734476,0
"147.32.84.165",1541,"86.101.54.123",6667,4,248,4,248,0,0,938.423878,3.003904000000034,660.4738367138156,0
"147.32.84.165",1534,"74.125.113.27",25,6,372,6,372,0,0,940.827182,9.013097000000016,330.1861724111029,0
"147.32.84.165",1535,"66.94.238.147",25,6,372,6,372,0,0,942.62984,9.012975000000097,330.1906418246992,0
"147.32.84.165",1543,"212.117.171.138",65500,182,89172,124,8958,58,80214,942.629974,78.47240600000009,913.2382152268902,8177.549698170325
"147.32.84.165",1537,"64.12.90.97",25,6,372,6,372,0,0,942.630032,9.01290599999993,330.19316966137484,0
"147.32.84.165",1538,"198.17.145.13",25,6,372,6,372,0,0,942.630072,9.012921000000006,330.19262012836884,0
"147.32.84.165",1539,"66.94.238.147",25,6,372,6,372,0,0,942.630102,9.012941000000069,330.19188742054087,0
"147.32.84.165",1540,"64.12.90.33",25,6,372,6,372,0,0,942.63013,9.012966000000006,330.19097154033403,0
"147.32.84.165",1547,"205.188.186.137",587,44,5469,28,3696,16,1773,943.731764,32.400004999999965,912.5924517604251,437.7777102194896
"147.32.84.165",1544,"64.12.90.97",25,2,124,2,124,0,0,943.831778,5.999999984851456e-06,0,0
"147.32.84.165",1545,"216.221.81.26",25,4,248,4,248,0,0,943.831835,3.0037320000000136,660.5116568322311,0
"147.32.84.165",1546,"66.94.238.147",25,4,248,4,248,0,0,943.849701,2.9859780000000455,664.4389208493732,0
"147.32.84.165",1548,"74.222.8.74",443,6,372,6,372,0,0,946.23464,9.01316399999996,330.1837179485487,0
"147.32.84.165",1550,"182.177.235.90",6667,4,248,4,248,0,0,946.835718,3.0044359999999415,660.3568856184784,0
"147.32.84.165",1549,"205.188.156.193",25,6,372,6,372,0,0,955.247714,9.01316200000008,330.18379121555495,0
"147.32.84.165",1557,"114.59.51.188",6667,4,248,4,248,0,0,956.449563,3.004248999999959,660.3979896473386,0
"147.32.84.165",1551,"207.115.21.24",25,2,124,2,124,0,0,956.850047,9.999999974752427e-06,0,0
"147.32.84.165",1552,"212.227.15.186",25,6,372,6,372,0,0,957.050227,9.012935000000084,330.19210723254656,0
"147.32.84.165",1553,"195.179.68.193",25,6,372,6,372,0,0,959.453676,8.91334500000005,333.88138796377604,0
"147.32.84.165",1554,"66.94.238.147",25,6,372,6,372,0,0,961.256476,8.913131000000021,333.88940429575115,0
"147.32.84.165",1555,"66.94.238.147",25,6,372,6,372,0,0,961.857178,8.91422,333.8486149096612,0
"147.32.84.165",1556,"72.44.238.67",25,6,372,6,372,0,0,961.857312,8.914207000000033,333.84910177652245,0
"147.32.84.165",1558,"66.94.238.147",25,2,124,2,124,0,0,963.659934,9.999999974752427e-06,0,0
"147.32.84.165",1559,"24.113.32.75",25,2,124,2,124,0,0,963.660069,5.999999984851456e-06,0,0
"147.32.84.165",1560,"205.188.190.2",25,2,124,2,124,0,0,964.86167,8.999999977277184e-06,0,0
"147.32.84.165",1564,"1.22.16.143",6667,4,248,4,248,0,0,967.265422,2.9040600000000723,683.1814769667124,0
"147.32.84.165",1563,"174.133.57.141",80,17,4638,12,1428,5,3210,969.668406,214.80640500000004,53.18277171483782,119.54950784637914
"147.32.84.165",1561,"74.125.93.27",25,6,372,6,372,0,0,969.829144,8.952340999999933,332.42701545886405,0
"147.32.84.165",1567,"74.222.3.26",443,9,552,6,372,3,180,975.076169,1.38011599999993,2156.340481524851,1043.3905555765407
"147.32.84.165",1562,"65.54.188.72",25,6,372,6,372,0,0,976.177705,9.013712000000055,330.1636440125868,0
"147.32.84.165",1571,"59.48.7.173",6667,9,552,6,372,3,180,976.456544,1.9656989999999723,1513.965261212445,732.563836070538
"147.32.84.165",1565,"204.127.217.16",25,6,372,6,372,0,0,977.479663,9.013652000000093,330.165841769792,0
"147.32.84.165",1566,"209.85.225.27",25,6,372,6,372,0,0,977.980346,9.013128999999935,330.1850001259298,0
"147.32.84.165",1568,"74.125.159.27",25,6,372,6,372,0,0,978.422508,8.971480000000042,331.71784365567174,0
"147.32.84.165",1576,"222.88.205.195",443,6,372,6,372,0,0,978.681353,9.0131090000001,330.1857328031834,0
"147.32.84.165",1569,"205.188.190.2",25,6,372,6,372,0,0,978.681487,9.013112000000092,330.18562290138743,0
"147.32.84.165",1570,"65.55.92.136",25,6,372,6,372,0,0,980.384317,9.01249699999994,330.20815429952654,0
"147.32.84.165",1578,"209.127.193.138",6667,9,552,6,372,3,180,982.186399,1.606538999999998,1852.4293527888235,896.3367836074952
"147.32.84.165",1572,"206.136.167.21",25,2,124,2,124,0,0,982.787347,9.000000090964022e-06,0,0
"147.32.84.165",1573,"74.125.113.27",25,6,372,6,372,0,0,983.793247,9.008787000000098,330.34414067065495,0
"147.32.84.165",1574,"204.127.217.16",25,6,372,6,372,0,0,985.290828,9.013510999999994,330.17100661440384,0
"147.32.84.165",1575,"64.12.90.97",25,2,124,2,124,0,0,985.290961,5.999999984851456e-06,0,0
"147.32.84.165",1582,"218.57.210.214",6667,4,248,4,248,0,0,990.799135,3.0039780000000746,660.4575666000053,0
"147.32.84.165",1577,"205.188.190.1",25,6,372,6,372,0,0,996.106335,9.013098000000014,330.18613577706526,0
"147.32.84.165",1579,"207.115.37.21",25,6,372,6,372,0,0,997.20816,9.012879999999996,330.19412218957774,0
"147.32.84.165",1592,"212.117.171.138",65500,24,1475,18,1092,6,383,998.510125,75.23084900000003,116.12257625857707,40.72797317494049
"147.32.84.165",1580,"66.94.237.64",25,6,372,6,372,0,0,998.510259,9.012513000000013,330.20756807784863,0
"147.32.84.165",1594,"88.154.15.50",6667,9,552,6,372,3,180,998.510326,7.538099999999986,394.79444422334615,191.02956978549008
"147.32.84.165",1581,"66.94.238.147",25,6,372,6,372,0,0,999.011023,9.012433999999985,330.2104625676044,0
"147.32.84.165",1596,"64.12.175.136",587,72,28720,46,26278,26,2442,999.41139,21.667744999999968,9702.163284642695,901.6166656936394
"147.32.84.165",1583,"64.12.90.97",25,6,372,6,372,0,0,999.529139,8.996123000000011,330.8091719066087,0
"147.32.84.165",1584,"207.69.189.220",25,6,372,6,372,0,0,999.711823,9.013449000000037,330.1732777319745,0
"147.32.84.165",1598,"74.222.8.74",443,6,372,6,372,0,0,1004.819587,9.012914000000023,330.1928765768754,0
"147.32.84.165",1602,"174.133.57.141",80,16,3429,12,1428,4,2001,1005.7203,0.5399240000000418,21158.533423220888,29648.617212790614
"147.32.84.165",1585,"66.94.238.147",25,6,372,6,372,0,0,1005.720434,9.01498700000002,330.1169485879451,0
"147.32.84.165",1586,"173.236.81.226",3817,11,666,8,484,3,182,1005.720495,0.4457360000000108,8686.756286232,3266.507529120297
"147.32.84.165",1587,"69.175.10.98",4190,11,666,8,484,3,182,1005.853953,0.4116839999999229,9405.272004743263,3536.693191866268
"147.32.84.165",1588,"84.203.225.34",25,6,372,6,372,0,0,1005.979694,8.954713999999967,332.3389222704389,0
"147.32.84.165",1603,"95.111.235.248",6667,9,552,6,372,3,180,1008.123612,1.3534720000000107,2198.7894836390974,1063.9303953092408
"147.32.84.165",1589,"74.125.244.10",25,6,372,6,372,0,0,1009.477365,8.961107000000084,332.10182625873927,0
"147.32.84.165",1609,"41.223.57.74",6667,4,248,4,248,0,0,1015.33451,3.004040000000032,660.4439355001861,0
"147.32.84.165",1611,"174.133.57.141",80,16,3429,12,1428,4,2001,1017.137037,0.4650320000000647,24566.051368504555,34423.43752687508
"147.32.84.165",1590,"207.69.189.220",25,6,372,6,372,0,0,1017.137175,9.012600000000134,330.2043805339143,0
"147.32.84.165",1593,"193.204.201.219",25,6,372,6,372,0,0,1017.137235,9.012683000000038,330.2013396010919,0
"147.32.84.165",1595,"64.12.90.97",25,6,372,6,372,0,0,1018.238651,9.01475599999992,330.12540772041154,0
"147.32.84.165",1597,"66.94.238.147",25,6,372,6,372,0,0,1018.238791,9.014740000000074,330.12599365039654,0
"147.32.84.165",1599,"64.12.90.97",25,6,372,6,372,0,0,1018.23886,9.014720000000011,330.12672606581197,0
"147.32.84.165",1600,"199.239.254.18",25,6,372,6,372,0,0,1018.238929,9.014700999999945,330.127421863467,0
"147.32.84.165",1601,"66.94.238.147",25,6,372,6,372,0,0,1019.540053,9.01311099999998,330.18565953531544,0
"147.32.84.165",1604,"64.12.90.33",25,6,372,6,372,0,0,1019.540197,9.0130979999999,330.18613577706947,0
"147.32.84.165",1605,"74.125.113.27",25,6,372,6,372,0,0,1020.044744,9.008962999999994,330.3376870345679,0
"147.32.84.165",1606,"168.95.5.38",25,6,372,6,372,0,0,1020.541829,9.01262900000006,330.2033180329491,0
"147.32.84.165",1607,"76.75.56.61",25,6,372,6,372,0,0,1020.741948,9.012839999999983,330.1955876283176,0
"147.32.84.165",1616,"116.111.222.15",6667,4,248,4,248,0,0,1025.849485,3.0039540000000216,660.4628433058515,0
"147.32.84.165",1608,"64.12.90.97",25,6,372,6,372,0,0,1026.952303,9.011508000000049,330.24439416798873,0
"147.32.84.165",1623,"74.222.3.26",443,9,552,6,372,3,180,1030.455722,1.3752630000001318,2163.949731796547,1047.072450869297
"147.32.84.165",1622,"174.133.57.141",80,17,2284,12,1428,5,856,1030.957795,213.46341899999993,53.51736636430434,32.08043810073145
"147.32.84.165",1610,"66.94.238.147",25,6,372,6,372,0,0,1030.957926,8.911875000000009,333.93646118241077,0
"147.32.84.165",1612,"66.97.46.122",25,6,372,6,372,0,0,1031.831268,8.83927400000016,336.67923406378696,0
"147.32.84.165",1632,"31.192.109.167",80,15,1540,10,1050,5,490,1038.066842,0.23778200000015204,35326.47551115992,16485.68857187463
"147.32.84.165",1630,"222.88.205.195",443,23,2790,20,2608,3,182,1038.144394,93.25758600000017,223.72442709379118,15.612670909152605
"147.32.84.165",1628,"92.47.176.195",6667,2,124,2,124,0,0,1038.144456,7.999999979801942e-06,0,0
"147.32.84.165",1613,"64.12.90.33",25,6,372,6,372,0,0,1039.169095,9.012500000000045,330.2080443828,0
"147.32.84.165",1614,"65.55.92.152",25,6,372,6,372,0,0,1039.169228,9.01249400000006,330.2082642163179,0
"147.32.84.165",1615,"66.94.238.147",25,6,372,6,372,0,0,1040.470264,9.0129629999999,330.19108144569475,0
"147.32.84.165",1617,"216.204.99.3",25,6,372,6,372,0,0,1040.470399,9.012962000000016,330.1911180808257,0
"147.32.84.165",1618,"209.191.88.254",25,6,372,6,372,0,0,1041.171096,9.012956000000031,330.19133789180705,0
"147.32.84.165",1619,"206.46.232.11",25,6,372,6,372,0,0,1041.472202,9.014127000000144,330.14844365959704,0
"147.32.84.165",1620,"65.55.88.22",25,6,372,6,372,0,0,1041.672189,9.013060000000223,330.187527876207,0
"147.32.84.165",1621,"66.94.238.147",25,6,372,6,372,0,0,1041.772675,9.012599000000137,330.20441717200055,0
"147.32.84.165",1624,"64.12.90.97",25,6,372,6,372,0,0,1041.772805,9.012588999999934,330.20478355331875,0
"147.32.84.165",1625,"74.125.113.27",25,6,372,6,372,0,0,1041.772862,9.012586000000056,330.2048934678661,0
"147.32.84.165",1634,"101.0.32.121",6667,2,124,2,124,0,0,1047.881143,8.999999863590347e-06,0,0
"147.32.84.165",1626,"207.115.37.21",25,6,372,6,372,0,0,1051.386324,9.013058000000001,330.1876011449166,0
"147.32.84.165",1627,"203.252.3.229",25,6,372,6,372,0,0,1051.886872,9.01273100000003,330.1995810148988,0
"147.32.84.165",1643,"212.117.171.138",65500,22,1355,16,972,6,383,1052.688253,52.19805900000006,148.97105656744807,58.69950068449857
"147.32.84.165",1629,"209.191.88.254",25,6,372,6,372,0,0,1052.688366,9.012307999999848,330.21507920058326,0
"147.32.84.165",1645,"66.94.237.64",25,6,372,6,372,0,0,1052.688397,9.012401000000182,330.21167167327997,0
"147.32.84.165",1631,"66.94.238.147",25,6,372,6,372,0,0,1060.199186,9.012847999999849,330.195294539534,0
"147.32.84.165",1646,"58.42.247.143",6667,7,426,6,364,1,62,1060.999727,0.5406910000001517,5385.700890155714,917.3446571144348
"147.32.84.165",1633,"64.131.63.177",25,6,372,6,372,0,0,1061.500394,9.013070000000198,330.18716153318843,0
"147.32.84.165",1635,"66.94.238.147",25,6,372,6,372,0,0,1061.540049,8.973545000000058,331.6415084562434,0
"147.32.84.165",1636,"205.188.156.193",25,6,372,6,372,0,0,1061.540121,8.973525000000109,331.64224761172045,0
"147.32.84.165",1637,"207.115.37.21",25,6,372,6,372,0,0,1062.201367,9.013027000000193,330.1887368139401,0
"147.32.84.165",1638,"65.54.188.94",25,6,372,6,372,0,0,1062.201502,9.013088000000153,330.1865021178035,0
"147.32.84.165",1639,"74.125.113.27",25,6,372,6,372,0,0,1062.50176,9.013099999999895,330.1860625090185,0
"147.32.84.165",1640,"66.94.238.147",25,6,372,6,372,0,0,1062.501891,9.013119000000188,330.1853664641439,0
"147.32.84.165",1641,"212.27.48.7",25,6,372,6,372,0,0,1062.501949,9.01316399999996,330.1837179485487,0
"147.32.84.165",1655,"188.129.211.240",6667,4,248,4,248,0,0,1062.702766,3.003810999999814,660.4942854261212,0
"147.32.84.165",1644,"64.12.90.97",25,6,372,6,372,0,0,1062.802743,9.012449999999944,330.20987633773484,0
"147.32.84.165",1660,"74.222.3.26",443,9,552,6,372,3,180,1072.416338,1.3798099999999067,2156.8186924288134,1043.621947949426
"147.32.84.165",1663,"59.99.153.96",6667,4,248,4,248,0,0,1072.916852,3.0043510000000424,660.3755686336157,0
"147.32.84.165",1658,"174.133.57.141",80,17,2284,12,1428,5,856,1073.718123,129.1146349999999,88.47951279883964,53.03813932479463
"147.32.84.165",1647,"66.94.238.147",25,6,372,6,372,0,0,1073.71822,9.013343999999961,330.1771240507422,0
"147.32.84.165",1648,"205.188.59.193",25,6,372,6,372,0,0,1073.718249,9.013441000000057,330.1735707816783,0
"147.32.84.165",1649,"24.113.32.75",25,6,372,6,372,0,0,1073.796365,8.935379000000012,333.05806054785097,0
"147.32.84.165",1666,"222.88.205.195",443,6,372,6,372,0,0,1081.229281,9.016343000000006,330.0673011219735,0
"147.32.84.165",1650,"85.13.145.7",25,6,372,6,372,0,0,1081.22939,9.01635699999997,330.066788615403,0
"147.32.84.165",1651,"65.54.188.110",25,6,372,6,372,0,0,1081.429132,9.013099000000011,330.18609914303573,0
"147.32.84.165",1670,"83.229.32.202",6667,6,385,4,248,2,137,1082.531324,122.74136499999986,16.1640698716362,8.929345050057096
"147.32.84.165",1652,"64.12.90.33",25,6,372,6,372,0,0,1082.531463,9.012234000000035,330.2177906166205,0
"147.32.84.165",1653,"74.125.113.27",25,6,372,6,372,0,0,1083.231733,9.013189999999895,330.18276548037204,0
"147.32.84.165",1672,"212.117.171.138",65500,74,7584,48,4920,26,2664,1083.532207,52.827150000000074,745.0714263404318,403.4289186526241
"147.32.84.165",1654,"209.191.88.254",25,6,372,6,372,0,0,1083.532339,9.01291900000001,330.19269339933004,0
"147.32.84.165",1673,"209.191.88.254",25,6,372,6,372,0,0,1083.832713,9.013071999999966,330.1870882646906,0
"147.32.84.165",1656,"66.94.238.147",25,6,372,6,372,0,0,1083.832845,9.013075000000072,330.18697836198817,0
"147.32.84.165",1657,"205.188.59.193",25,6,372,6,372,0,0,1091.043046,9.012899999999945,330.1933894750877,0
"147.32.84.165",1659,"66.94.238.147",25,6,372,6,372,0,0,1091.043179,9.01289399999996,330.1936092890933,0
"147.32.84.165",1661,"64.12.90.33",25,6,372,6,372,0,0,1091.043233,9.01289399999996,330.1936092890933,0
"147.32.84.165",1662,"194.177.250.245",25,6,372,6,372,0,0,1091.043289,9.012887999999975,330.1938291033915,0
"147.32.84.165",1680,"62.209.146.67",6667,4,248,4,248,0,0,1094.749105,3.0034709999999905,660.5690549367736,0
"147.32.84.165",1664,"66.94.238.147",25,6,372,6,372,0,0,1094.749221,9.011862000000065,330.23142165292575,0
"147.32.84.165",1665,"213.246.53.125",5296,11,666,8,484,3,182,1094.749254,0.28541999999993095,13565.972952143988,5101.254291921912
"147.32.84.165",1667,"74.125.67.27",25,6,372,6,372,0,0,1094.847615,8.913592999999992,333.87209849047434,0
"147.32.84.165",1687,"173.192.170.88",80,6,372,6,372,0,0,1101.257787,8.912593000000015,333.909559204599,0
"147.32.84.165",1668,"216.32.181.178",25,6,372,6,372,0,0,1102.259423,8.91249199999993,333.91334320412557,0
"147.32.84.165",1685,"212.117.171.138",65500,133,54190,88,6798,45,47392,1102.45961,122.36136799999986,444.4540044697773,3098.494289472151
"147.32.84.165",1669,"66.94.238.147",25,6,372,6,372,0,0,1102.459708,8.91243099999997,333.9156286315159,0
"147.32.84.165",1689,"64.12.168.40",587,48,5845,30,3952,18,1893,1102.459737,33.994042000000036,930.0453297080696,445.4898302473117
"147.32.84.165",1674,"64.136.52.37",25,6,372,6,372,0,0,1102.577635,8.895000999999866,334.5699455233389,0
"147.32.84.165",1692,"77.123.72.98",6667,4,248,4,248,0,0,1103.560811,3.0045430000000124,660.3333685022953,0
"147.32.84.165",1675,"66.94.238.147",25,6,372,6,372,0,0,1104.262427,8.915865000000167,333.78701898244805,0
"147.32.84.165",1676,"178.208.34.4",25,6,372,6,372,0,0,1104.262488,8.915940999999975,333.7841737624787,0
"147.32.84.165",1693,"74.222.8.74",443,6,372,6,372,0,0,1104.56263,8.91273799999999,333.9041268799782,0
"147.32.84.165",1677,"205.188.156.193",25,6,372,6,372,0,0,1104.862985,8.912710999999945,333.90513840289657,0
"147.32.84.165",1698,"174.133.57.141",80,17,2362,12,1428,5,934,1111.472442,111.13079900000002,102.79778515765011,67.23608637061989
"147.32.84.165",1678,"66.94.237.64",25,6,372,6,372,0,0,1111.472575,9.012766000000056,330.19829872427414,0
"147.32.84.165",1679,"64.12.90.97",25,6,372,6,372,0,0,1111.97309,9.01295099999993,330.1915210678526,0
"147.32.84.165",1701,"61.17.216.3",6667,4,248,4,248,0,0,1115.678598,3.004018999999971,660.4485524226109,0
"147.32.84.165",1681,"66.94.238.147",25,6,372,6,372,0,0,1121.086223,9.012797000000091,330.19716298946594,0
"147.32.84.165",1682,"207.115.37.21",25,6,372,6,372,0,0,1122.1886,9.014169000000038,330.14690538861515,0
"147.32.84.165",1708,"79.136.165.190",6667,4,248,4,248,0,0,1123.189737,3.003600000000006,660.5406845119178,0
"147.32.84.165",1707,"173.192.170.88",80,16,4630,12,1170,4,3460,1123.490829,7.855024999999841,1191.593915996472,3523.8589310664906
"147.32.84.165",1683,"216.203.30.54",25,6,372,6,372,0,0,1125.192116,9.01276299999995,330.1984086345127,0
"147.32.84.165",1686,"205.188.59.193",25,6,372,6,372,0,0,1125.492352,9.01293899999996,330.1919606911811,0
"147.32.84.165",1688,"167.127.98.30",25,6,372,6,372,0,0,1125.792856,9.013414000000012,330.1745598282733,0
"147.32.84.165",1690,"165.21.74.122",25,6,372,6,372,0,0,1126.697086,9.010424000000057,330.28412425430605,0
"147.32.84.165",1713,"74.222.3.26",443,9,552,6,372,3,180,1131.302756,1.3732569999999669,2167.110744747758,1048.601973265044
"147.32.84.165",1691,"66.94.238.147",25,6,372,6,372,0,0,1132.50287,9.014480999999932,330.13547868147066,0
"147.32.84.165",1694,"212.123.93.197",25,6,372,6,372,0,0,1132.50293,9.014471999999842,330.13580828694705,0
"147.32.84.165",1718,"117.204.65.177",6667,4,248,4,248,0,0,1132.676342,2.931100000000015,676.8789874108662,0
"147.32.84.165",1695,"118.103.34.98",25,6,372,6,372,0,0,1133.003478,9.012932999999975,330.19218050328436,0
"147.32.84.165",1720,"222.88.205.195",443,6,372,6,372,0,0,1141.517103,9.011527000000115,330.24369787717023,0
"147.32.84.165",1696,"66.94.238.147",25,6,372,6,372,0,0,1141.517235,9.011457000000064,330.24626317364425,0
"147.32.84.165",1697,"65.55.88.22",25,6,372,6,372,0,0,1141.517293,9.011433999999781,330.24710606547995,0
"147.32.84.165",1699,"205.188.156.193",25,6,372,6,372,0,0,1142.116568,9.012900000000172,330.1933894750794,0
"147.32.84.165",1726,"220.143.177.200",6667,4,248,4,248,0,0,1143.218402,3.0039050000000316,660.4736168420703,0
"147.32.84.165",1700,"66.94.238.147",25,6,372,6,372,0,0,1146.222439,9.013045000000147,330.18807739226327,0
"147.32.84.165",1702,"64.12.90.97",25,6,372,6,372,0,0,1146.522716,9.013210999999956,330.18199618315987,0
"147.32.84.165",1703,"65.55.92.168",25,6,372,6,372,0,0,1146.823143,9.01298399999996,330.19031210973117,0
"147.32.84.165",1731,"174.133.57.141",80,16,3429,12,1428,4,2001,1147.725877,0.5091989999998532,22435.236518538517,31437.61083585124
"147.32.84.165",1704,"66.94.238.147",25,6,372,6,372,0,0,1147.726009,9.01169200000004,330.2376512646002,0
"147.32.84.165",1705,"64.12.90.97",25,6,372,6,372,0,0,1147.726066,9.01174200000014,330.23581900147093,0
"147.32.84.165",1706,"207.115.37.21",25,6,372,6,372,0,0,1147.726124,9.011710999999877,330.2369550022233,0
"147.32.84.165",1709,"66.94.238.147",25,6,372,6,372,0,0,1151.129265,9.012942000000066,330.1918507852351,0
"147.32.84.165",1710,"173.236.81.226",3817,14,846,10,604,4,242,1151.129407,0.40379600000005667,11966.438498646154,4794.500193166174
"147.32.84.165",1711,"203.30.98.150",25,6,372,6,372,0,0,1151.256617,8.985664000000043,331.19422226337264,0
"147.32.84.165",1735,"79.113.190.202",6667,4,248,4,248,0,0,1153.532913,3.0057389999999486,660.0706182406502,0
"147.32.84.165",1712,"165.21.74.121",25,6,372,6,372,0,0,1154.033474,9.013193000000001,330.18265558054725,0
"147.32.84.165",1741,"31.192.109.167",80,15,1540,10,1050,5,490,1161.344149,0.24135299999989002,34803.79361351973,16241.770352975875
"147.32.84.165",1740,"174.133.57.141",80,16,3429,12,1428,4,2001,1161.422037,0.48211799999990035,23695.44385399915,33203.48960213746
"147.32.84.165",1714,"69.175.10.98",4190,11,666,8,484,3,182,1161.4221,0.4131760000000213,9371.309078939243,3523.9220090226077
"147.32.84.165",1715,"209.85.225.27",25,6,372,6,372,0,0,1161.55836,8.999013000000105,330.70293375506463,0
"147.32.84.165",1716,"205.188.156.193",25,6,372,6,372,0,0,1162.545614,9.013111000000208,330.1856595353071,0
"147.32.84.165",1717,"195.110.124.132",25,6,372,6,372,0,0,1162.545715,9.013095000000021,330.18624567920267,0
"147.32.84.165",1747,"221.208.241.38",6667,4,248,4,248,0,0,1163.14692,3.0042060000000674,660.407442099495,0
"147.32.84.165",1719,"66.94.238.147",25,6,372,6,372,0,0,1167.253045,9.012356000000182,330.2133204680263,0
"147.32.84.165",1748,"74.222.8.74",443,6,372,6,372,0,0,1167.552918,9.01304499999992,330.18807739227157,0
"147.32.84.165",1721,"74.125.67.27",25,6,372,6,372,0,0,1167.853282,9.01339699999994,330.1751825643561,0
"147.32.84.165",1722,"209.86.93.229",25,6,372,6,372,0,0,1168.75459,8.912960999999996,333.8957726842967,0
"147.32.84.165",1723,"205.188.59.193",25,6,372,6,372,0,0,1171.558641,8.91566499999999,333.79450663523176,0
"147.32.84.165",1751,"174.133.57.141",80,16,3429,12,1428,4,2001,1172.259615,0.46307999999999083,24669.603524229562,34568.541072817476
"147.32.84.165",1724,"66.94.238.147",25,6,372,6,372,0,0,1172.259745,8.91301099999987,333.8938996036293,0
"147.32.84.165",1725,"205.188.59.193",25,6,372,6,372,0,0,1172.2598,8.913027000000056,333.8933002222456,0
"147.32.84.165",1727,"209.86.93.229",25,6,372,6,372,0,0,1172.259858,8.913045000000011,333.8926259207708,0
"147.32.84.165",1728,"205.178.149.7",25,6,372,6,372,0,0,1172.259915,8.91305599999987,333.89221384899224,0
"147.32.84.165",1753,"115.240.73.24",6667,4,248,4,248,0,0,1175.063625,2.9043719999999666,683.1080867051544,0
"147.32.84.165",1729,"66.94.238.147",25,6,372,6,372,0,0,1181.172527,9.012846000000081,330.1953678116738,0
"147.32.84.165",1730,"205.188.156.193",25,6,372,6,372,0,0,1181.172675,9.01283699999999,330.1956975367471,0
"147.32.84.165",1732,"209.240.204.25",25,6,372,6,372,0,0,1182.474282,9.013112000000092,330.18562290138743,0
"147.32.84.165",1760,"86.126.237.212",6667,9,552,6,372,3,180,1183.47624,2.529565000000048,1176.4868663188904,569.2678385413985
"147.32.84.165",1761,"174.133.57.141",80,16,3429,12,1428,4,2001,1186.006012,0.4609309999998459,24784.620691608547,34729.7100867708
"147.32.84.165",1733,"209.191.88.254",25,6,372,6,372,0,0,1186.006075,8.986317999999983,331.1701188406648,0
"147.32.84.165",1734,"64.12.90.33",25,6,372,6,372,0,0,1188.182684,9.012988999999834,330.1901289350353,0
"147.32.84.165",1736,"188.220.34.98",25,6,372,6,372,0,0,1188.483114,9.012895000000071,330.1935726534012,0
"147.32.84.165",1737,"66.94.238.147",25,6,372,6,372,0,0,1188.783634,9.012845000000198,330.19540444775595,0
"147.32.84.165",1767,"213.111.249.148",6667,4,248,4,248,0,0,1189.684687,3.0046440000000985,660.3111716396136,0
"147.32.84.165",1738,"209.202.254.15",25,6,372,6,372,0,0,1191.387123,9.013241999999991,330.18086056049566,0
"147.32.84.165",1769,"74.222.3.26",443,9,552,6,372,3,180,1192.488655,1.3817609999998695,2153.773337067902,1042.1483889038234
"147.32.84.165",1739,"64.12.90.33",25,6,372,6,372,0,0,1193.191425,9.012703000000101,330.2006068545659,0
"147.32.84.165",1742,"206.46.232.11",25,6,372,6,372,0,0,1193.191584,9.012668000000076,330.2018891631174,0
"147.32.84.165",1743,"74.125.113.27",25,6,372,6,372,0,0,1193.870644,8.933010999999851,333.1463489746122,0
"147.32.84.165",1774,"222.88.205.195",443,6,372,6,372,0,0,1202.204317,9.01163100000008,330.2398866531457,0
"147.32.84.165",1777,"61.17.216.84",6667,4,248,4,248,0,0,1202.204375,3.002952999999934,660.6830010326647,0
"147.32.84.165",1776,"174.133.57.141",80,17,2284,12,1428,5,856,1203.504743,117.59273800000005,97.14885624994967,58.23488862041801
"147.32.84.165",1744,"65.55.88.22",25,6,372,6,372,0,0,1203.504877,9.013030999999955,330.1885902755704,0
"147.32.84.165",1745,"64.12.90.97",25,6,372,6,372,0,0,1207.01014,9.012539999999944,330.20657883349406,0
"147.32.84.165",1746,"66.94.238.147",25,6,372,6,372,0,0,1207.610852,9.01382999999987,330.1593218421074,0
"147.32.84.165",1749,"205.188.156.193",25,6,372,6,372,0,0,1207.610986,9.013852000000043,330.1585160262212,0
"147.32.84.165",1750,"66.94.238.147",25,6,372,6,372,0,0,1209.213332,9.01279099999988,330.197382808504,0
"147.32.84.165",1786,"212.117.171.138",65500,66,6566,42,4168,24,2398,1209.21348,108.95612300000016,306.0314471725462,176.07087579648893
"147.32.84.165",1752,"64.12.90.33",25,6,372,6,372,0,0,1209.213538,9.012760999999955,330.19848190804294,0
"147.32.84.165",1787,"99.236.68.164",6667,4,248,4,248,0,0,1209.51345,3.004376000000093,660.3700735194059,0
"147.32.84.165",1754,"167.138.239.95",25,6,372,6,372,0,0,1209.813858,9.012652000000116,330.20247536462756,0
"147.32.84.165",1789,"205.188.186.167",587,63,24096,40,21834,23,2262,1212.417884,12.447764000000006,14032.399714519002,1453.755067978473
"147.32.84.165",1755,"66.94.238.147",25,6,372,6,372,0,0,1212.535478,8.995055000000093,330.84844950919916,0
"147.32.84.165",1756,"74.125.113.27",25,6,372,6,372,0,0,1214.220036,9.013335000000097,330.1774537393726,0
"147.32.84.165",1757,"117.53.114.19",25,6,372,6,372,0,0,1214.220169,9.013329000000113,330.1776735321614,0
"147.32.84.165",1758,"74.125.113.27",25,6,372,6,372,0,0,1214.820825,9.013155000000097,330.1840476503475,0
"147.32.84.165",1759,"66.94.238.147",25,6,372,6,372,0,0,1217.825459,9.013238000000001,330.18100709201286,0
"147.32.84.165",1762,"65.55.92.136",25,6,372,6,372,0,0,1217.825537,9.013284999999996,330.17928535489574,0
"147.32.84.165",1798,"117.198.86.115",6667,6,368,4,248,2,120,1224.535312,1.1378420000000915,1743.6515790415897,843.7023769556079
"147.32.84.165",1763,"151.189.21.118",25,6,372,6,372,0,0,1228.040434,9.012549000000035,330.20624908668884,0
"147.32.84.165",1805,"74.222.8.74",443,6,372,6,372,0,0,1228.040574,9.01253399999996,330.2067986650606,0
"147.32.84.165",1764,"64.12.90.33",25,6,372,6,372,0,0,1228.641844,9.012056999999913,330.22427621130544,0
"147.32.84.165",1765,"209.85.225.27",25,6,372,6,372,0,0,1228.641977,9.011977000000115,330.22720763712135,0
"147.32.84.165",1808,"119.154.131.100",6667,9,552,6,372,3,180,1230.243153,1.7536510000002181,1697.0309371702979,821.1440018565957
"147.32.84.165",1766,"66.94.238.147",25,6,372,6,372,0,0,1230.843832,9.013058000000001,330.1876011449166,0
"147.32.84.165",1768,"74.125.113.27",25,6,372,6,372,0,0,1230.843963,9.0130529999999,330.1877843168162,0
"147.32.84.165",1770,"66.94.237.64",25,6,372,6,372,0,0,1230.844019,9.013046000000031,330.188040757807,0
"147.32.84.165",1771,"74.125.113.27",25,6,372,6,372,0,0,1231.997011,8.961537000000135,332.08589106979696,0
"147.32.84.165",1772,"76.96.62.116",25,6,372,6,372,0,0,1231.997076,8.961570999999822,332.0846311433631,0
"147.32.84.165",1773,"66.94.238.147",25,6,372,6,372,0,0,1233.548186,9.013012000000117,330.1892863340203,0
"147.32.84.165",1811,"14.97.39.52",6667,4,248,4,248,0,0,1235.250336,3.004275000000007,660.3922743423939,0
"147.32.84.165",1775,"205.188.190.2",25,6,372,6,372,0,0,1235.851079,9.013007000000016,330.1894695077897,0
"147.32.84.165",1813,"174.133.57.141",80,16,3429,12,1428,4,2001,1237.653708,0.4615369999999075,24752.078381586503,34684.10983302142
"147.32.84.165",1778,"74.125.113.27",25,6,372,6,372,0,0,1237.653843,8.91264000000001,333.90779836277426,0
"147.32.84.165",1779,"205.188.156.193",25,6,372,6,372,0,0,1238.85558,8.912811000000147,333.90139205240087,0
"147.32.84.165",1821,"199.255.211.81",6667,4,248,4,248,0,0,1248.969827,3.004716000000144,660.2953490446035,0
"147.32.84.165",1824,"174.133.57.141",80,16,3429,12,1428,4,2001,1248.969908,0.49642900000003465,23012.354233937185,32246.3030967145
"147.32.84.165",1780,"204.174.64.46",25,6,372,6,372,0,0,1248.969941,9.01344999999992,330.1732411008023,0
"147.32.84.165",1781,"98.139.175.224",25,6,372,6,372,0,0,1249.5711,9.012618000000202,330.2037210497475,0
"147.32.84.165",1830,"74.222.3.26",443,9,552,6,372,3,180,1251.773922,1.3760979999999563,2162.6366726789042,1046.4370996833406
"147.32.84.165",1782,"66.94.238.147",25,6,372,6,372,0,0,1252.875701,9.013022000000092,330.1889199870997,0
"147.32.84.165",1783,"65.55.88.22",25,6,372,6,372,0,0,1252.875836,9.013016000000107,330.1891397951546,0
"147.32.84.165",1784,"66.94.237.64",25,6,372,6,372,0,0,1253.150235,8.938850000000002,332.9287324432113,0
"147.32.84.165",1788,"65.54.188.94",25,6,372,6,372,0,0,1253.877548,9.012717000000066,330.2000939339356,0
"147.32.84.165",1790,"66.94.238.147",25,6,372,6,372,0,0,1254.477883,9.013699999999972,330.16408356169046,0
"147.32.84.165",1835,"222.88.205.195",443,23,2790,20,2608,3,182,1256.781519,93.33383000000003,223.54166758184027,15.599916986156032
"147.32.84.165",1834,"113.193.156.31",6667,5,308,4,248,1,60,1257.10622,0.6770610000000943,2930.3120398305673,708.9464612493308
"147.32.84.165",1791,"74.125.113.27",25,6,372,6,372,0,0,1258.583857,9.013104999999996,330.18587933902927,0
"147.32.84.165",1838,"174.133.57.141",80,17,3489,12,1428,5,2061,1259.785841,1.2492870000000948,9144.415974871372,13197.928098186205
"147.32.84.165",1792,"63.110.113.2",25,6,372,6,372,0,0,1259.785977,9.012447000000066,330.2099862556727,0
"147.32.84.165",1793,"65.55.92.152",25,6,372,6,372,0,0,1263.491437,9.012807000000066,330.1967966250668,0
"147.32.84.165",1844,"201.160.226.207",6667,2,124,2,124,0,0,1270.000821,8.999999863590347e-06,0,0
"147.32.84.165",1794,"74.125.113.27",25,6,372,6,372,0,0,1270.601406,9.012834000000112,330.19580744524563,0
"147.32.84.165",1795,"213.246.53.125",5296,11,666,8,484,3,182,1270.60154,0.1569609999999102,24668.548238111474,9276.189626727868
"147.32.84.165",1796,"66.94.238.147",25,6,372,6,372,0,0,1270.644196,8.970166999999947,331.76639855200216,0
"147.32.84.165",1797,"64.12.90.97",25,6,372,6,372,0,0,1270.644262,8.970154999999977,331.7668423789787,0
"147.32.84.165",1849,"174.133.57.141",80,16,3429,12,1428,4,2001,1273.705673,0.4800230000000738,23798.859637972022,33348.402055729704
"147.32.84.165",1799,"74.125.113.27",25,6,372,6,372,0,0,1273.705882,9.013257000000067,330.18031106846036,0
"147.32.84.165",1800,"65.55.92.136",25,6,372,6,372,0,0,1273.705995,9.013206999999966,330.182142715685,0
"147.32.84.165",1801,"74.125.67.27",25,6,372,6,372,0,0,1273.9064,9.012422999999899,330.2108656018513,0
"147.32.84.165",1802,"66.94.238.147",25,6,372,6,372,0,0,1274.106204,9.013094000000137,330.1862823132605,0
"147.32.84.165",1803,"81.169.145.102",25,6,372,6,372,0,0,1274.106336,9.013130000000046,330.1849634921481,0
"147.32.84.165",1804,"74.125.113.27",25,6,372,6,372,0,0,1274.907242,9.013103000000001,330.1859526069989,0
"147.32.84.165",1806,"205.188.59.193",25,6,372,6,372,0,0,1274.907375,9.013022000000092,330.1889199870997,0
"147.32.84.165",1853,"168.187.75.100",6667,4,248,4,248,0,0,1275.508478,3.004284000000098,660.3902959906371,0
"147.32.84.165",1807,"66.94.238.147",25,6,372,6,372,0,0,1279.614479,9.01272199999994,330.19991074838657,0
"147.32.84.165",1809,"74.125.113.27",25,6,372,6,372,0,0,1280.815685,9.013245999999981,330.1807140291085,0
"147.32.84.165",1857,"31.192.109.167",80,15,1540,10,1050,5,490,1283.920211,0.23637299999995776,35537.0537244165,16583.9584047277
"147.32.84.165",1860,"195.113.232.75",80,13,2187,10,1000,3,1187,1283.996418,60.01076699999999,133.30941095953668,158.23827080897004
"147.32.84.165",1810,"205.188.190.2",25,6,372,6,372,0,0,1283.997198,8.936245999999983,333.02574705306967,0
"147.32.84.165",1861,"174.133.57.141",80,17,2283,12,1428,5,855,1284.521045,105.45086300000003,108.33481751590783,64.86433401687759
"147.32.84.165",1812,"74.125.113.27",25,6,372,6,372,0,0,1284.521225,9.01297599999998,330.19060518967393,0
"147.32.84.165",1814,"74.125.67.27",25,6,372,6,372,0,0,1284.521302,9.01297099999988,330.1907883649065,0
"147.32.84.165",1815,"207.115.37.21",25,6,372,6,372,0,0,1284.521378,9.012991000000056,330.1900556652039,0
"147.32.84.165",1866,"74.222.3.26",443,9,552,6,372,3,180,1291.631454,1.3752499999998236,2163.9701872389614,1047.0823486640136
"147.32.84.165",1864,"59.94.194.59",6667,6,372,6,372,0,0,1293.006912,8.939346999999998,332.9102226370674,0
"147.32.84.165",1816,"74.125.113.27",25,6,372,6,372,0,0,1293.533949,9.012957000000142,330.191301256619,0
"147.32.84.165",1817,"66.94.238.147",25,6,372,6,372,0,0,1293.534079,9.012958000000026,330.19126462144743,0
"147.32.84.165",1818,"65.55.92.152",25,6,372,6,372,0,0,1293.534138,9.012950000000046,330.1915577030811,0
"147.32.84.165",1819,"205.188.190.2",25,6,372,6,372,0,0,1294.736031,9.012597000000142,330.2044904481975,0
"147.32.84.165",1820,"209.191.88.254",25,6,372,6,372,0,0,1294.736181,9.012549000000035,330.20624908668884,0
"147.32.84.165",1822,"200.91.27.32",25,6,372,6,372,0,0,1294.936763,9.01560500000005,330.0943197932899,0
"147.32.84.165",1869,"222.88.205.195",443,6,372,6,372,0,0,1295.136979,9.014130999999907,330.1482971569895,0
"147.32.84.165",1870,"115.60.169.243",6667,4,248,4,248,0,0,1295.137127,3.003693999999996,660.5200130239641,0
"147.32.84.165",1823,"74.125.113.27",25,6,372,6,372,0,0,1295.937681,9.01301199999989,330.1892863340287,0
"147.32.84.165",1825,"205.188.190.2",25,6,372,6,372,0,0,1295.93772,9.013098000000127,330.1861357770611,0
"147.32.84.165",1826,"65.55.92.184",25,6,372,6,372,0,0,1295.93776,9.01310699999999,330.18580607109214,0
"147.32.84.165",1827,"98.139.54.60",25,6,372,6,372,0,0,1300.644422,9.013054000000011,330.18774768241667,0
"147.32.84.165",1828,"66.94.238.147",25,6,372,6,372,0,0,1301.846401,9.012676000000056,330.2015960631428,0
"147.32.84.165",1829,"207.115.37.21",25,6,372,6,372,0,0,1304.950928,9.013044000000036,330.18811402673595,0
"147.32.84.165",1831,"65.54.188.72",25,6,372,6,372,0,0,1304.950988,9.013056000000006,330.18767441365037,0
"147.32.84.165",1879,"79.113.153.241",6667,4,248,4,248,0,0,1305.551447,3.00420599999984,660.4074420995449,0
"147.32.84.165",1832,"67.195.168.230",25,6,372,6,372,0,0,1313.963831,8.912710000000061,333.9051758668216,0
"147.32.84.165",1833,"198.136.202.22",25,6,372,6,372,0,0,1313.964126,8.912539999999808,333.91154485702884,0
"147.32.84.165",1881,"212.117.171.138",65500,348,335990,260,329252,88,6738,1314.564415,116.78258000000005,22554.87076925342,461.57569048397437
"147.32.84.165",1836,"74.125.113.27",25,6,372,6,372,0,0,1314.564547,8.913139000000001,333.8891046128642,0
"147.32.84.165",1885,"205.188.186.137",587,40,5110,26,3450,14,1660,1315.766393,2.4989349999998467,11044.70504434957,5314.263876411677
"147.32.84.165",1837,"205.188.190.2",25,6,372,6,372,0,0,1315.884114,8.895453000000089,334.5529451957051,0
"147.32.84.165",1887,"78.227.180.250",6667,4,248,4,248,0,0,1315.966816,2.903614999999945,683.2861794693985,0
"147.32.84.165",1839,"67.195.168.230",25,6,372,6,372,0,0,1316.867802,9.012717000000066,330.2000939339356,0
"147.32.84.165",1840,"98.139.175.225",25,6,372,6,372,0,0,1316.867832,9.012812000000167,330.1966134431679,0
"147.32.84.165",1888,"74.222.8.74",443,6,372,6,372,0,0,1321.574517,9.012903000000051,330.1932795681905,0
"147.32.84.165",1841,"74.125.113.27",25,6,372,6,372,0,0,1322.776254,9.012854999999945,330.1950380872674,0
"147.32.84.165",1842,"64.12.139.193",25,6,372,6,372,0,0,1322.77639,9.012844000000086,330.1954410838545,0
"147.32.84.165",1843,"67.195.168.230",25,6,372,6,372,0,0,1323.577442,9.012749999999869,330.19888491304465,0
"147.32.84.165",1845,"208.97.132.72",25,6,372,6,372,0,0,1323.577576,9.012742000000117,330.1991780081979,0
"147.32.84.165",1899,"59.99.153.96",6667,4,248,4,248,0,0,1325.880713,3.004513999999972,660.3397421346742,0
"147.32.84.165",1897,"174.133.57.141",80,17,2362,12,1428,5,934,1333.791872,192.71070299999997,59.28056834497668,38.773144841882505
"147.32.84.165",1846,"74.125.113.27",25,6,372,6,372,0,0,1333.792002,9.012914000000137,330.19287657687124,0
"147.32.84.165",1847,"65.55.37.72",25,6,372,6,372,0,0,1333.792059,9.01298399999996,330.19031210973117,0
"147.32.84.165",1848,"184.173.117.72",25,6,372,6,372,0,0,1334.893977,9.013008000000127,330.1894328730162,0
"147.32.84.165",1850,"173.236.81.226",3817,11,666,8,484,3,182,1334.894115,0.43684699999994336,8863.515143747129,3332.974702814003
"147.32.84.165",1851,"67.195.168.230",25,6,372,6,372,0,0,1335.023903,8.983087000000069,331.28923275484,0
"147.32.84.165",1905,"201.65.242.60",6667,4,248,4,248,0,0,1335.494532,3.004532000000154,660.3357860724726,0
"147.32.84.165",1852,"205.188.190.1",25,6,372,6,372,0,0,1336.796228,9.012940000000071,330.1919240558548,0
"147.32.84.165",1854,"74.125.67.27",25,6,372,6,372,0,0,1337.898034,9.014885999999933,330.1206471163387,0
"147.32.84.165",1855,"67.195.168.230",25,6,372,6,372,0,0,1342.60474,9.012817999999925,330.1963936251708,0
"147.32.84.165",1856,"65.55.37.72",25,6,372,6,372,0,0,1342.604871,9.01281199999994,330.1966134431762,0
"147.32.84.165",1858,"69.175.10.98",4190,20,1210,16,968,4,242,1342.604929,42.99477400000001,180.11491350088266,45.028728375220666
"147.32.84.165",1859,"64.12.90.65",25,6,372,6,372,0,0,1343.33245,8.986357999999882,331.16864473906327,0
"147.32.84.165",1862,"77.238.177.9",25,6,372,6,372,0,0,1343.806771,9.012541000000056,330.2065421949239,0
"147.32.84.165",1863,"218.219.70.208",25,6,372,6,372,0,0,1344.006857,9.012633999999935,330.20313484382274,0
"147.32.84.165",1865,"67.195.168.230",25,6,372,6,372,0,0,1344.607653,9.015331999999944,330.1043156258714,0
"147.32.84.165",1867,"64.18.7.13",25,6,372,6,372,0,0,1344.607785,9.015248000000156,330.1073913884508,0
"147.32.84.165",1913,"74.222.3.26",443,9,552,6,372,3,180,1353.622853,1.3724359999998796,2168.407124266823,1049.2292536774949
"147.32.84.165",1914,"95.59.69.146",6667,9,552,6,372,3,180,1354.822408,1.4856099999999515,2003.2175335384773,969.2988065508761
"147.32.84.165",1868,"67.195.168.230",25,6,372,6,372,0,0,1354.995574,8.939617999999882,332.90013063198444,0
"147.32.84.165",1871,"74.125.113.27",25,6,372,6,372,0,0,1354.995637,8.939691000000039,332.8974122259916,0
"147.32.84.165",1919,"58.42.247.143",6667,9,552,6,372,3,180,1355.92368,2.538860999999997,1172.1791779857201,567.1834732188968
"147.32.84.165",1872,"207.115.20.21",25,6,372,6,372,0,0,1356.023874,9.013036000000056,330.18840710277664,0
"147.32.84.165",1873,"64.12.139.193",25,6,372,6,372,0,0,1356.308329,8.92868999999996,333.30757367542304,0
"147.32.84.165",1922,"222.88.205.195",443,6,372,6,372,0,0,1357.826497,9.01302499999997,330.18881008318624,0
"147.32.84.165",1874,"64.12.139.193",25,6,372,6,372,0,0,1357.826606,9.01304099999993,330.1882239301944,0
"147.32.84.165",1875,"67.195.168.230",25,6,372,6,372,0,0,1357.826635,9.013061000000107,330.18749124187275,0
"147.32.84.165",1876,"209.191.88.254",25,6,372,6,372,0,0,1358.462875,8.97757200000001,331.4927465911715,0
"147.32.84.165",1877,"205.188.103.1",25,6,372,6,372,0,0,1358.928259,9.01296699999989,330.19093490523557,0
"147.32.84.165",1925,"119.154.24.194",6667,9,552,6,372,3,180,1364.336298,1.8786159999999654,1584.144923709824,766.5217372789471
"147.32.84.165",1928,"174.133.57.141",80,17,2283,12,1428,5,855,1364.836669,206.36514199999988,55.358186413091055,33.14513262128351
"147.32.84.165",1878,"67.195.168.230",25,6,372,6,372,0,0,1364.8368,9.013005000000021,330.18954277735264,0
"147.32.84.165",1882,"213.188.37.84",25,6,372,6,372,0,0,1364.836861,9.013069000000087,330.1871981674579,0
"147.32.84.165",1883,"67.195.168.230",25,6,372,6,372,0,0,1365.036979,9.012911999999915,330.1929498479546,0
"147.32.84.165",1884,"205.188.190.1",25,6,372,6,372,0,0,1365.037047,9.012969999999996,330.1908249999724,0
"147.32.84.165",1886,"67.195.168.230",25,6,372,6,372,0,0,1365.638168,9.013046000000031,330.188040757807,0
"147.32.84.165",1889,"85.115.60.190",25,6,372,6,372,0,0,1365.638308,9.013029999999844,330.1886269101569,0
"147.32.84.165",1890,"64.12.139.193",25,6,372,6,372,0,0,1366.215124,8.936228000000028,333.0264178577349,0
"147.32.84.165",1891,"93.17.128.7",25,6,372,6,372,0,0,1366.215187,8.936292999999978,333.02399552029095,0
"147.32.84.165",1932,"109.200.240.44",6667,2,124,2,124,0,0,1375.954728,7.999999979801942e-06,0,0
"147.32.84.165",1892,"203.188.197.119",25,6,372,6,372,0,0,1377.054255,8.91274199999998,333.9039770252529,0
"147.32.84.165",1893,"67.195.168.230",25,6,372,6,372,0,0,1377.254459,8.912759000000051,333.9033401441667,0
"147.32.84.165",1894,"64.12.90.65",25,6,372,6,372,0,0,1377.254591,8.912724000000026,333.90465137257604,0
"147.32.84.165",1895,"74.125.113.27",25,6,372,6,372,0,0,1378.856961,8.912541000000147,333.91150739165755,0
"147.32.84.165",1938,"109.200.239.148",6667,4,248,4,248,0,0,1379.457695,3.00410399999987,660.4298652776621,0
"147.32.84.165",1896,"64.18.6.11",25,6,372,6,372,0,0,1379.958242,8.915560000000141,333.79843778741355,0
"147.32.84.165",1939,"74.222.8.74",443,6,372,6,372,0,0,1385.766658,9.012891000000081,330.19371919620164,0
"147.32.84.165",1898,"67.195.168.230",25,6,372,6,372,0,0,1385.967135,9.012651000000005,330.20251200229524,0
"147.32.84.165",1900,"74.125.113.27",25,6,372,6,372,0,0,1386.567856,9.013368000000128,330.17624488426054,0
"147.32.84.165",1901,"205.188.190.1",25,6,372,6,372,0,0,1386.567989,9.013643000000002,330.1661714358999,0
"147.32.84.165",1902,"67.195.168.230",25,6,372,6,372,0,0,1387.06907,9.012518999999884,330.20734824526176,0
"147.32.84.165",1903,"74.125.113.27",25,6,372,6,372,0,0,1387.0692,9.01255100000003,330.20617580971134,0
"147.32.84.165",1904,"67.195.168.230",25,6,372,6,372,0,0,1387.069254,9.012568999999985,330.2055163183777,0
"147.32.84.165",1906,"205.188.190.1",25,6,372,6,372,0,0,1387.06931,9.012580999999955,330.20507665895207,0
"147.32.84.165",1907,"82.147.38.106",25,6,372,6,372,0,0,1387.069369,9.01259200000004,330.20467363883625,0
"147.32.84.165",1908,"67.195.168.230",25,6,372,6,372,0,0,1387.869628,9.016270000000077,330.0699735034526,0
"147.32.84.165",1909,"65.55.92.184",25,6,372,6,372,0,0,1387.869761,9.016277000000173,330.0697172458148,0
"147.32.84.165",1950,"121.31.253.12",6667,6,372,6,372,0,0,1397.984259,9.013132000000041,330.1848902246174,0
"147.32.84.165",1956,"173.192.170.88",80,25,5757,18,1530,7,4227,1398.084781,40.359020999999984,303.27792143421925,837.8795907859117
"147.32.84.165",1910,"74.125.113.27",25,6,372,6,372,0,0,1398.18449,9.013133999999809,330.18481695712757,0
"147.32.84.165",1911,"216.32.181.178",25,6,372,6,372,0,0,1398.184623,9.013128999999935,330.1850001259298,0
"147.32.84.165",1958,"201.65.242.60",6667,4,248,4,248,0,0,1399.786872,3.004460999999992,660.3513908151929,0
"147.32.84.165",1912,"67.195.168.230",25,6,372,6,372,0,0,1400.888348,9.015961999999945,330.0812492333062,0
"147.32.84.165",1915,"65.54.188.72",25,6,372,6,372,0,0,1400.888486,9.01595999999995,330.0813224548486,0
"147.32.84.165",1916,"205.188.190.1",25,6,372,6,372,0,0,1401.289513,9.012527999999975,330.2070184969199,0
"147.32.84.165",1917,"74.125.113.27",25,6,372,6,372,0,0,1401.289575,9.01259099999993,330.20471027699176,0
"147.32.84.165",1963,"31.192.109.167",80,15,1540,10,1050,5,490,1406.797406,0.23693600000001425,35452.61167572465,16544.552115338167
"147.32.84.165",1962,"174.133.57.141",80,16,3429,12,1428,4,2001,1406.875214,0.4844020000000455,23583.71765599425,33046.932093588584
"147.32.84.165",1918,"67.195.168.230",25,6,372,6,372,0,0,1406.875249,8.934609000000137,333.08676406543975,0
"147.32.84.165",1920,"74.125.67.27",25,6,372,6,372,0,0,1406.875276,8.934706000000006,333.083147895409,0
"147.32.84.165",1921,"205.188.190.1",25,6,372,6,372,0,0,1406.997508,9.012558000000126,330.2059193405422,0
"147.32.84.165",1923,"209.85.225.27",25,6,372,6,372,0,0,1406.99756,9.01263199999994,330.20320811945055,0
"147.32.84.165",1924,"210.72.21.22",25,6,372,6,372,0,0,1407.598071,9.012811000000056,330.1966500795347,0
"147.32.84.165",1926,"67.195.168.230",25,6,372,6,372,0,0,1408.099409,9.01269400000001,330.2009365901024,0
"147.32.84.165",1967,"74.222.3.26",443,9,552,6,372,3,180,1408.899911,1.3755800000001273,2163.4510533736493,1046.8311548582174
"147.32.84.165",1969,"150.186.92.225",6667,9,552,6,372,3,180,1410.275783,2.133197999999993,1395.088500926782,675.0428230290881
"147.32.84.165",1927,"74.125.113.27",25,6,372,6,372,0,0,1412.409456,9.009128999999803,330.33160031342265,0
"147.32.84.165",1974,"222.88.205.195",443,1151,727726,754,48358,397,679368,1412.409541,159.15443000000005,2430.7460370408785,34148.870377029394
"147.32.84.165",1929,"66.135.37.96",25,6,372,6,372,0,0,1412.409616,9.00910399999998,330.3325169739418,0
"147.32.84.165",1978,"208.73.210.29",80,66,35628,40,4028,26,31600,1417.912937,16.764374999999973,1922.17127092421,15079.595869216742
"147.32.84.165",1979,"84.25.41.150",6667,4,248,4,248,0,0,1418.098738,2.91849000000002,679.8035970656013,0
"147.32.84.165",1983,"174.133.57.141",80,17,4638,12,1428,5,3210,1419.014367,235.272833,48.55639239911733,109.14987367028475
"147.32.84.165",1930,"67.195.168.230",25,6,372,6,372,0,0,1419.014498,10.217413999999962,291.26743812084067,0
"147.32.84.165",1985,"74.125.232.217",80,13,2936,10,2062,3,874,1419.014556,15.662874999999985,1053.1910648587832,446.4059120691448
"147.32.84.165",1931,"65.54.188.110",25,6,372,6,372,0,0,1419.022669,10.212443000000121,291.409215209325,0
"147.32.84.165",1987,"208.73.210.29",80,13,3922,10,2952,3,970,1419.214714,15.462817000000086,1527.2766922094381,501.8490485918547
"147.32.84.165",1981,"212.117.171.138",65500,66,6706,42,4168,24,2538,1419.214845,26.76825800000006,1245.6544613399917,758.5103221883155
"147.32.84.165",1933,"205.188.103.1",25,6,372,6,372,0,0,1419.214904,10.026611000000003,296.8101584872495,0
"147.32.84.165",1988,"67.214.158.5",80,17,2699,12,1844,5,855,1421.919101,0.3238129999999728,45557.157989337175,21123.30264689983
"147.32.84.165",1986,"65.55.196.251",443,193,171682,130,10708,63,160974,1422.022547,9.406398000000081,9106.992921201001,136905.9654928474
"147.32.84.165",1934,"67.195.168.230",25,6,372,6,372,0,0,1422.122938,9.192226000000119,323.7518311668971,0
"147.32.84.165",1989,"94.127.76.180",80,7,424,6,364,1,60,1422.12298,0.016559999999799402,175845.41063014942,28985.507246727924
"147.32.84.165",1935,"209.191.88.254",25,6,372,6,372,0,0,1422.137057,9.181276000000025,324.1379520667924,0
"147.32.84.165",1990,"50.22.198.84",80,13,3349,10,2320,3,1029,1422.319219,0.47543500000006134,39037.93368178112,17314.669723514126
"147.32.84.165",1936,"74.125.113.27",25,6,372,6,372,0,0,1422.54706,8.985333999999966,331.2063858728024,0
"147.32.84.165",1991,"195.113.232.83",80,16,2314,12,1664,4,650,1427.827761,6.849868999999899,1943.3948298865564,759.1386054244362
"147.32.84.165",1995,"118.96.124.137",6667,9,552,6,372,3,180,1428.028104,4.3374619999999595,686.1155210120637,331.9913811348695
"147.32.84.165",1937,"205.188.190.1",25,6,372,6,372,0,0,1428.62821,9.013046000000031,330.188040757807,0
"147.32.84.165",1992,"67.214.158.5",80,15,2652,10,1756,5,896,1428.798719,2.64640600000007,5308.331374702003,2708.5791069094503
"147.32.84.165",1940,"74.125.113.27",25,6,372,6,372,0,0,1429.129554,9.01283199999989,330.1958807176298,0
"147.32.84.165",1993,"50.22.198.84",80,14,3004,10,2424,4,580,1429.129643,2.3810510000000704,8144.3026629834585,1948.719284047197
"147.32.84.165",1941,"195.130.132.34",25,6,372,6,372,0,0,1430.210082,8.933352000000014,333.1336322580813,0
"147.32.84.165",1942,"65.55.37.104",25,6,372,6,372,0,0,1430.269959,8.973562000000129,331.6408801766742,0
"147.32.84.165",2001,"68.67.185.216",80,13,2050,10,1168,3,882,1432.36578,2.3119560000000092,4041.5994076011666,3051.9611964933465
"147.32.84.165",1943,"71.74.56.243",25,6,372,6,372,0,0,1432.39477,8.951823999999988,332.4462143134186,0
"147.32.84.165",2002,"68.67.185.216",80,13,2078,10,1168,3,910,1433.435538,1.242298000000119,7521.544750131696,5860.107639229318
"147.32.84.165",1944,"205.188.190.1",25,6,372,6,372,0,0,1433.435669,9.013167000000067,330.18360804808987,0
"147.32.84.165",2004,"217.163.21.41",80,15,2143,10,1186,5,957,1433.435726,0.14259900000001835,66536.23096935307,53689.01605199907
"147.32.84.165",1945,"67.195.168.230",25,6,372,6,372,0,0,1433.481599,8.967435000000023,331.8674738093995,0
"147.32.84.165",2006,"94.245.121.179",80,13,2296,10,1212,3,1084,1434.136117,0.112920000000031,85866.0998937065,76797.73290823255
"147.32.84.165",1946,"65.55.92.152",25,6,372,6,372,0,0,1434.17205,8.977382000000034,331.4997624028908,0
"147.32.84.165",2013,"173.192.170.88",80,17,1641,12,1084,5,557,1440.048711,51.400133000000096,168.7155167477871,86.69238268313414
"147.32.84.165",1947,"65.54.188.126",25,6,372,6,372,0,0,1440.245236,9.012670999999955,330.2017792505701,0
"147.32.84.165",2008,"212.117.171.138",65500,28,1714,20,1212,8,502,1440.250981,104.01926700000013,93.21350053351162,38.608232069160756
"147.32.84.165",1948,"74.125.113.27",25,6,372,6,372,0,0,1440.251042,9.00698999999986,330.4100481959063,0
"147.32.84.165",2009,"78.227.180.250",6667,2,124,2,124,0,0,1440.251104,5.999999984851456e-06,0,0
"147.32.84.165",1949,"24.222.10.228",25,6,372,6,372,0,0,1443.149592,9.012709000000086,330.2003870312435,0
"147.32.84.165",2015,"64.12.168.40",587,40,5390,26,3730,14,1660,1443.550158,2.5291879999999765,11798.253036152424,5250.69706166569
"147.32.84.165",1951,"205.188.190.1",25,6,372,6,372,0,0,1443.667939,8.994937000000164,330.8527897416008,0
"147.32.84.165",1952,"213.246.53.125",5296,11,666,8,484,3,182,1443.668005,0.1261500000000524,30693.618707874688,11541.815299242135
"147.32.84.165",1953,"74.125.113.27",25,6,372,6,372,0,0,1443.701107,8.961895999999797,332.0725882112521,0
"147.32.84.165",2017,"180.241.97.224",6667,2,124,2,124,0,0,1449.6586,9.000000090964022e-06,0,0
"147.32.84.165",1954,"209.85.225.27",25,6,372,6,372,0,0,1451.160861,8.912977999999839,333.8951358345161,0
"147.32.84.165",1955,"74.125.113.27",25,6,372,6,372,0,0,1451.260821,8.913066999999955,333.8918017782223,0
"147.32.84.165",1957,"64.12.139.193",25,6,372,6,372,0,0,1451.260958,8.91310199999998,333.8904906507304,0
"147.32.84.165",1959,"67.195.168.230",25,6,372,6,372,0,0,1453.363798,8.912777000000006,333.9026658021398,0
"147.32.84.165",1960,"64.12.139.193",25,6,372,6,372,0,0,1453.363929,8.912771999999904,333.90285311910054,0
"147.32.84.165",1961,"217.109.101.113",25,6,372,6,372,0,0,1453.363988,8.912763999999925,333.903152826668,0
"147.32.84.165",1965,"74.125.113.27",25,6,372,6,372,0,0,1453.964837,8.912743000000091,333.90393956158834,0
"147.32.84.165",1966,"67.195.168.230",25,6,372,6,372,0,0,1453.964967,8.912707000000182,333.9052882586558,0
"147.32.84.165",1968,"206.46.232.11",25,6,372,6,372,0,0,1453.965025,8.912673999999924,333.9065245738849,0
"147.32.84.165",1970,"207.115.36.20",25,6,372,6,372,0,0,1454.46545,8.913101000000097,333.8905281113686,0
"147.32.84.165",1971,"64.12.139.193",25,6,372,6,372,0,0,1455.166916,9.012838000000102,330.19566090059163,0
"147.32.84.165",1972,"209.85.225.27",25,6,372,6,372,0,0,1455.167056,9.012727999999925,330.199690925991,0
"147.32.84.165",1973,"216.32.181.178",25,6,372,6,372,0,0,1455.167126,9.01268200000004,330.2013762385033,0
"147.32.84.165",2026,"117.224.242.30",6667,2,124,2,124,0,0,1461.176963,1.0000000202126103e-05,0,0
"147.32.84.165",2028,"174.133.57.141",80,16,3429,12,1428,4,2001,1464.079746,0.4726730000002135,24168.928625063923,33866.96511117151
"147.32.84.165",1975,"74.125.113.27",25,6,372,6,372,0,0,1464.079813,9.004277000000002,330.5096011595378,0
"147.32.84.165",1976,"67.195.168.230",25,6,372,6,372,0,0,1464.079848,9.004367999999886,330.50626096135096,0
"147.32.84.165",1982,"205.188.103.1",25,6,372,6,372,0,0,1464.179673,9.004485999999815,330.50192981587855,0
"147.32.84.165",1984,"67.195.168.230",25,6,372,6,372,0,0,1464.580293,9.005797999999913,330.4537809975339,0
"147.32.84.165",1994,"74.125.113.27",25,6,372,6,372,0,0,1464.580424,9.005763000000115,330.4550652731992,0
"147.32.84.165",2036,"77.120.37.254",6667,2,124,2,124,0,0,1472.091106,8.999999863590347e-06,0,0
"147.32.84.165",2039,"98.126.71.122",80,15,4683,12,1310,3,3373,1472.191305,15.32149000000004,684.006581605312,1761.186412026502
"147.32.84.165",1996,"205.188.103.1",25,6,372,6,372,0,0,1472.366638,8.944758000000093,332.708833486604,0
"147.32.84.165",1997,"65.55.37.104",25,6,372,6,372,0,0,1472.366704,8.944831000000022,332.70611820390934,0
"147.32.84.165",2043,"195.113.232.98",80,17,5783,12,2556,5,3227,1474.088438,13.424600999999939,1523.1737613654286,1923.0366697676986
"147.32.84.165",1998,"212.82.111.207",25,6,372,6,372,0,0,1474.088582,9.02853099999993,329.6217291605936,0
"147.32.84.165",1999,"125.206.187.30",25,6,372,6,372,0,0,1474.288939,9.028728000000001,329.6145370643572,0
"147.32.84.165",2044,"174.133.57.141",80,16,3429,12,1428,4,2001,1474.890868,0.47111199999994824,24249.010850925588,33979.18117136001
"147.32.84.165",2000,"64.12.139.193",25,6,372,6,372,0,0,1474.89099,9.02896799999985,329.6057755437886,0
"147.32.84.165",2045,"178.122.240.223",6667,8,492,6,372,2,120,1475.392487,3.785667999999987,786.1228190110729,253.58800613260416
"147.32.84.165",2003,"67.195.168.230",25,6,372,6,372,0,0,1476.19517,9.028553999999986,329.62088945804663,0
"147.32.84.165",2005,"66.196.94.104",25,6,372,6,372,0,0,1476.195288,9.028576000000157,329.620086268305,0
"147.32.84.165",2010,"64.12.139.193",25,6,372,6,372,0,0,1479.178405,8.965106999999989,331.9536509714835,0
"147.32.84.165",2011,"74.125.113.27",25,6,372,6,372,0,0,1479.178516,8.96509900000001,331.9539471900976,0
"147.32.84.165",2012,"77.238.14.101",25,6,372,6,372,0,0,1479.178577,8.965115000000196,331.95335475338965,0
"147.32.84.165",2014,"67.195.168.230",25,6,372,6,372,0,0,1482.11407,9.033075999999937,329.4558797025532,0
"147.32.84.165",2016,"205.188.103.1",25,6,372,6,372,0,0,1482.114293,9.032989999999927,329.4590163390001,0
"147.32.84.165",2018,"67.195.168.230",25,6,372,6,372,0,0,1482.114363,9.032986000000164,329.4591622305122,0
"147.32.84.165",2019,"74.125.113.27",25,6,372,6,372,0,0,1482.114426,9.033059999999978,329.45646325829864,0
"147.32.84.165",2020,"205.188.103.1",25,6,372,6,372,0,0,1482.114488,9.033162000000175,329.4527431258227,0
"147.32.84.165",2021,"85.158.136.35",25,6,372,6,372,0,0,1482.114552,9.033163999999942,329.45267018289707,0
"147.32.84.165",2052,"82.103.123.207",6667,4,248,4,248,0,0,1485.123952,3.019414000000097,657.0811422348629,0
"147.32.84.165",2055,"174.133.57.141",80,17,2284,12,1428,5,856,1485.223932,63.81836199999998,179.00804160407634,107.30454034530065
"147.32.84.165",2022,"205.188.103.1",25,6,372,6,372,0,0,1485.224,9.027901000000156,329.6447313722147,0
"147.32.84.165",2023,"67.195.168.230",25,6,372,6,372,0,0,1485.626674,9.025396,329.7362243163624,0
"147.32.84.165",2061,"95.58.159.249",6667,4,248,4,248,0,0,1493.350419,3.0041959999998653,660.409640383014,0
"147.32.84.165",2059,"173.192.170.88",80,17,1643,12,1086,5,557,1495.152719,61.61981100000003,140.9936164848022,72.31440550831937
"147.32.84.165",2024,"74.125.113.27",25,6,372,6,372,0,0,1495.353139,9.012924999999996,330.19247358654394,0
"147.32.84.165",2025,"173.236.81.226",3817,11,666,8,484,3,182,1495.353324,0.6283950000001823,6161.729485433329,2317.0139800596403
"147.32.84.165",2027,"98.139.175.225",25,6,372,6,372,0,0,1495.491729,8.974381999999878,331.6105777534365,0
"147.32.84.165",2030,"32.97.110.150",25,6,372,6,372,0,0,1495.954352,9.012707000000091,330.20046030565175,0
"147.32.84.165",2031,"205.188.190.1",25,6,372,6,372,0,0,1497.256062,8.91274599999997,333.9038271706621,0
"147.32.84.165",2032,"99.49.210.97",25,6,372,6,372,0,0,1500.160018,8.91272600000002,333.9045764449612,0
"147.32.84.165",2033,"67.195.168.230",25,6,372,6,372,0,0,1500.860929,8.915479000000005,333.8014704538027,0
"147.32.84.165",2034,"69.175.10.98",4190,11,666,8,484,3,182,1500.861062,0.40455199999996694,9571.081097115615,3599.0428918905827
"147.32.84.165",2035,"67.195.168.230",25,6,372,6,372,0,0,1500.993302,8.881853999999976,335.06517895925873,0
"147.32.84.165",2037,"209.85.225.27",25,6,372,6,372,0,0,1500.993367,8.881922999999915,335.06257597594896,0
"147.32.84.165",2068,"68.41.173.2",6667,4,248,4,248,0,0,1503.164636,3.0040550000001076,660.4406377379671,0
"147.32.84.165",2040,"74.125.113.27",25,6,372,6,372,0,0,1506.168843,9.01264500000002,330.20273182844693,0
"147.32.84.165",2041,"205.188.103.1",25,6,372,6,372,0,0,1506.168873,9.01273900000001,330.1992879190218,0
"147.32.84.165",2042,"98.139.54.60",25,6,372,6,372,0,0,1506.569217,9.015415000000075,330.1012765357973,0
"147.32.84.165",2046,"67.195.168.230",25,6,372,6,372,0,0,1511.07574,9.013173000000052,330.1833882474,0
"147.32.84.165",2074,"59.48.7.168",6667,9,552,6,372,3,180,1516.283256,1.9374790000001667,1536.01664843838,743.2338621476032
"147.32.84.165",2078,"78.129.227.128",5231,2859,1662300,1912,601836,947,1060464,1516.383279,8568.610333,561.8983490773708,990.0919367668017
"147.32.84.165",2076,"78.129.163.119",6251,3088,1804410,2106,686844,982,1117566,1516.412372,9655.166320999999,569.0996734099658,925.9838414750392
"147.32.84.165",2047,"74.125.113.27",25,6,372,6,372,0,0,1516.438639,8.957675999999992,332.2290290472666,0
"147.32.84.165",2048,"64.12.139.193",25,6,372,6,372,0,0,1516.884174,9.012819000000036,330.1963569888609,0
"147.32.84.165",2049,"65.55.88.22",25,6,372,6,372,0,0,1518.185887,9.012904999999819,330.1932062969775,0
"147.32.84.165",2050,"67.195.168.230",25,6,372,6,372,0,0,1518.220973,8.977945999999974,331.4789373872385,0
"147.32.84.165",2051,"65.55.37.88",25,6,372,6,372,0,0,1518.221036,8.97798499999999,331.4774974562782,0
"147.32.84.165",2053,"74.208.5.21",25,6,372,6,372,0,0,1520.689733,9.013378000000102,330.1758785662785,0
"147.32.84.165",2084,"212.117.171.138",65500,344,333190,252,326294,92,6896,1521.089956,28.138701999999967,92767.32096597785,1960.5737322211971
"147.32.84.165",2054,"74.125.113.27",25,6,372,6,372,0,0,1521.090087,9.012882999999874,330.19401228220113,0
"147.32.84.165",2086,"74.125.39.27",25,6,372,6,372,0,0,1521.090146,9.012948000000051,330.1916309735708,0
"147.32.84.165",2056,"205.188.190.1",25,6,372,6,372,0,0,1521.891708,9.01249699999994,330.20815429952654,0
"147.32.84.165",2098,"31.192.109.167",80,15,1540,10,1050,5,490,1527.199101,0.2374250000000302,35379.593555855245,16510.47699273245
"147.32.84.165",2087,"93.115.96.73",6667,2,124,2,124,0,0,1527.276893,7.999999979801942e-06,0,0
"147.32.84.165",2095,"67.195.168.31",25,6,372,6,372,0,0,1527.603525,9.00939100000005,330.32199401712984,0
"147.32.84.165",2094,"67.195.168.31",25,6,372,6,372,0,0,1532.108592,9.818093999999974,303.1138222958558,0
"147.32.84.165",2097,"174.133.57.141",80,17,3489,12,1428,5,2061,1532.108724,2.6047580000001744,4385.8201030572645,6329.954644538531
"147.32.84.165",2057,"74.125.113.27",25,6,372,6,372,0,0,1532.10878,9.821103999999877,303.02092310600085,0
"147.32.84.165",2058,"67.195.168.230",25,6,372,6,372,0,0,1532.108843,9.82424600000013,302.92401065689523,0
"147.32.84.165",2089,"212.117.171.138",65500,72,7053,48,4514,24,2539,1537.415605,85.39930000000004,422.86060892770763,237.8473828239809
"147.32.84.165",2107,"173.192.170.88",80,24,8428,18,1664,6,6764,1537.415737,15.210401000000047,875.190601483811,3557.565642089241
"147.32.84.165",2060,"64.12.139.193",25,6,372,6,372,0,0,1537.415793,9.547292000000198,311.711425606333,0
"147.32.84.165",2103,"61.178.56.36",6667,2,124,2,124,0,0,1537.415846,8.999999863590347e-06,0,0
"147.32.84.165",2062,"32.97.182.146",25,6,372,6,372,0,0,1537.914263,9.508424000000105,312.98562201264554,0
"147.32.84.165",2104,"65.55.196.251",443,234,172607,152,11864,82,160743,1539.216732,10.090551999999889,9406.026548399042,127440.40167475617
"147.32.84.165",2111,"174.36.246.56",80,28,14171,22,2068,6,12103,1539.216831,0.406505000000152,40698.14639424808,238186.49217097895
"147.32.84.165",2063,"64.12.139.193",25,6,372,6,372,0,0,1539.317192,9.702708999999913,306.71846388467657,0
"147.32.84.165",2064,"67.195.168.230",25,6,372,6,372,0,0,1539.337682,9.685420000000022,307.2659729779393,0
"147.32.84.165",2065,"74.125.113.27",25,6,372,6,372,0,0,1539.337745,9.688556999999946,307.1664851638914,0
"147.32.84.165",2112,"195.113.232.82",80,7,426,6,364,1,62,1539.80908,0.0008789999999407883,0,0
"147.32.84.165",2066,"199.228.142.103",25,6,372,6,372,0,0,1539.809812,9.235691000000088,322.22819061399645,0
"147.32.84.165",2118,"89.200.164.105",6667,4,248,4,248,0,0,1541.714808,3.902278000000024,508.42097872063135,0
"147.32.84.165",2113,"195.113.232.82",80,70,52466,54,3662,16,48804,1542.116332,10.509923999999955,2787.4606895349693,37148.88899291771
"147.32.84.165",2067,"195.3.86.220",25,6,372,6,372,0,0,1542.901105,8.949348999999984,332.538154451235,0
"147.32.84.165",2114,"74.125.232.201",80,34,15200,22,1832,12,13368,1542.919095,9.707256000000143,1509.7984435560145,11016.91353354629
"147.32.84.165",2069,"81.19.185.30",25,6,372,6,372,0,0,1543.815625,8.950063,332.5116258958177,0
"147.32.84.165",2115,"195.113.232.82",80,13,1616,10,1104,3,512,1548.336761,4.289686999999958,2058.8914762312697,954.8482208608787
"147.32.84.165",2121,"174.133.57.141",80,17,4638,12,1428,5,3210,1548.336902,269.5384899999999,42.38355716840294,95.27396254241837
"147.32.84.165",2070,"67.195.168.230",25,6,372,6,372,0,0,1548.336958,9.035133999999971,329.38083707447055,0
"147.32.84.165",2116,"195.113.232.89",80,13,3806,10,1108,3,2698,1548.337014,4.289520000000039,2066.431675338947,5031.798429661082
"147.32.84.165",2071,"205.188.190.1",25,6,372,6,372,0,0,1548.638618,9.034220000000005,329.4141608240665,0
"147.32.84.165",2125,"65.54.188.72",25,6,372,6,372,0,0,1549.01749,8.855211999999938,336.07326397154816,0
"147.32.84.165",2072,"74.125.113.27",25,6,372,6,372,0,0,1553.168652,8.910967000000028,333.9704882758505,0
"147.32.84.165",2129,"218.200.225.22",6667,4,248,4,248,0,0,1553.168809,3.0018259999999373,660.9310466362946,0
"147.32.84.165",2132,"65.54.188.72",25,6,372,6,372,0,0,1558.874489,9.013326000000006,330.1777834286697,0
"147.32.84.165",2135,"173.192.170.88",80,24,2789,18,2170,6,619,1558.874623,56.28219800000011,308.44566518173235,87.98519204953564
"147.32.84.165",2073,"186.202.4.42",25,6,372,6,372,0,0,1558.87469,9.013225999999804,330.18144668735306,0
"147.32.84.165",2075,"67.195.168.230",25,6,372,6,372,0,0,1559.075563,9.01248899999996,330.20844741114394,0
"147.32.84.165",2080,"64.12.139.193",25,6,372,6,372,0,0,1560.276467,9.012928000000102,330.19236368025645,0
"147.32.84.165",2081,"74.125.113.27",25,6,372,6,372,0,0,1560.276607,9.01291399999991,330.19287657687954,0
"147.32.84.165",2082,"67.195.168.230",25,6,372,6,372,0,0,1560.777161,9.012842999999975,330.19547771996116,0
"147.32.84.165",2085,"193.74.71.108",25,6,372,6,372,0,0,1560.777303,9.01282500000002,330.19613717119694,0
"147.32.84.165",2139,"122.218.153.19",6667,4,248,4,248,0,0,1563.781366,3.004519999999957,660.3384234420236,0
"147.32.84.165",2090,"200.72.136.190",25,6,372,6,372,0,0,1564.682856,9.015787000000046,330.0876562412117,0
"147.32.84.165",2092,"74.125.113.27",25,6,372,6,372,0,0,1569.589676,9.012876000000006,330.19426873286596,0
"147.32.84.165",2093,"205.188.190.1",25,6,372,6,372,0,0,1569.589811,9.012866000000031,330.19463509165564,0
"147.32.84.165",2096,"64.136.44.37",25,6,372,6,372,0,0,1569.689928,9.012731999999914,330.1995443778899,0
"147.32.84.165",2099,"193.74.71.108",25,6,372,6,372,0,0,1569.890135,9.012883999999985,330.1939756464196,0
"147.32.84.165",2100,"89.221.166.185",25,6,372,6,372,0,0,1569.890268,9.012876000000006,330.19426873286596,0
"147.32.84.165",2147,"212.117.174.7",4506,6,372,6,372,0,0,1579.904654,9.012985999999955,330.19023883982675,0
"147.32.84.165",2145,"111.253.202.95",6667,6,372,6,372,0,0,1579.904802,9.01293099999998,330.19225377405047,0
"147.32.84.165",2146,"212.117.174.7",4506,6,372,6,372,0,0,1580.105013,9.013033999999834,330.18848037187644,0
"147.32.84.165",2144,"74.125.127.27",25,6,372,6,372,0,0,1580.105343,9.012768000000051,330.19822545082525,0
"147.32.84.165",2155,"74.125.127.27",25,6,372,6,372,0,0,1581.306549,9.012930000000097,330.19229040944157,0
"147.32.84.165",2101,"72.4.117.21",25,6,372,6,372,0,0,1581.306683,9.01301199999989,330.1892863340287,0
"147.32.84.165",2102,"67.195.168.230",25,6,372,6,372,0,0,1581.306759,9.01299999999992,330.18972595140644,0
"147.32.84.165",2151,"212.117.171.138",65500,24,1475,18,1092,6,383,1581.807199,82.34255899999994,106.09337511601997,37.210405374941075
"147.32.84.165",2105,"64.12.90.65",25,6,372,6,372,0,0,1581.807307,9.013386999999966,330.17554888079377,0
"147.32.84.165",2158,"183.83.68.80",6667,2,124,2,124,0,0,1585.713188,1.1000000085914508e-05,0,0
"147.32.84.165",2162,"174.133.57.141",80,17,3489,12,1428,5,2061,1590.62057,0.626790999999912,18226.171084143843,26305.419190770634
"147.32.84.165",2108,"67.195.168.230",25,6,372,6,372,0,0,1590.620709,9.012128999999959,330.2216379725605,0
"147.32.84.165",2159,"64.12.175.136",587,44,5625,28,3852,16,1773,1590.620785,32.28931899999998,954.3713201260151,439.2783880019275
"147.32.84.165",2109,"212.175.77.212",25,6,372,6,372,0,0,1590.7203260000001,9.012873999999783,330.1943420045672,0
"147.32.84.165",2110,"205.188.190.1",25,6,372,6,372,0,0,1590.739118,8.994132000000036,330.88240199276464,0
"147.32.84.165",2117,"74.125.113.27",25,6,372,6,372,0,0,1590.920418,9.012820000000147,330.1963203525591,0
"147.32.84.165",2169,"173.192.170.88",80,16,3233,12,1418,4,1815,1599.733001,10.979853000000048,1033.1650159615024,1322.4220761425436
"147.32.84.165",2170,"210.211.186.4",6667,6,372,6,372,0,0,1599.733134,9.012805999999955,330.1968332614743,0
"147.32.84.165",2119,"205.188.103.1",25,6,372,6,372,0,0,1600.934867,9.012815000000046,330.1965035341328,0
"147.32.84.165",2177,"69.16.175.10",80,13,1946,10,1250,3,696,1600.935006,9.884855000000016,1011.648628128585,563.2859561419962
"147.32.84.165",2120,"67.195.168.230",25,6,372,6,372,0,0,1600.952,8.995807999999897,330.8207556230673,0
"147.32.84.165",2122,"212.50.215.90",25,6,372,6,372,0,0,1600.952032,8.995829000000185,330.81998335005466,0
"147.32.84.165",2178,"68.67.185.207",80,13,2380,10,1408,3,972,1601.135818,9.684150999999929,1163.1375842859206,802.9614573337464
"147.32.84.165",2180,"64.12.90.1",25,6,372,6,372,0,0,1601.160214,8.988546000000042,331.08803136791937,0
"147.32.84.165",2179,"174.133.57.141",80,17,3489,12,1428,5,2061,1602.337366,1.0447340000000622,10934.840830296822,15782.0076689368
"147.32.84.165",2123,"80.84.34.78",25,6,372,6,372,0,0,1602.337533,9.012620000000197,330.20364777389204,0
"147.32.84.165",2181,"68.67.179.211",80,13,2606,10,1784,3,822,1602.337638,8.482418999999936,1682.5389078280743,775.250550579976
"147.32.84.165",2182,"61.17.216.20",6667,4,248,4,248,0,0,1602.367386,2.9738040000002,667.1589654193305,0
"147.32.84.165",2183,"64.12.90.1",25,6,372,6,372,0,0,1602.837571,9.012768000000051,330.19822545082525,0
"147.32.84.165",2124,"67.195.168.230",25,6,372,6,372,0,0,1602.837681,9.012789000000112,330.19745608157064,0
"147.32.84.165",2187,"212.117.174.7",4506,6,372,6,372,0,0,1611.750492,9.012804000000187,330.196906534297,0
"147.32.84.165",2193,"113.21.74.83",6667,9,552,6,372,3,180,1611.750586,1.6109999999998763,1847.2998137804025,893.8547486034206
"147.32.84.165",2189,"212.117.174.7",4506,6,372,6,372,0,0,1611.950557,9.013138000000026,330.18467042222045,0
"147.32.84.165",2128,"64.12.90.65",25,6,372,6,372,0,0,1611.950707,9.013112999999976,330.18558626747586,0
"147.32.84.165",2196,"174.133.57.141",80,17,3489,12,1428,5,2061,1613.361894,2.991241000000173,3819.1506468383322,5512.093475583895
"147.32.84.165",2130,"209.85.225.27",25,6,372,6,372,0,0,1613.361956,9.003825000000006,330.5261930346267,0
"147.32.84.165",2202,"178.165.97.227",6667,9,552,6,372,3,180,1620.162699,1.0667230000001382,2789.8526609059845,1349.9287068899926
"147.32.84.165",2198,"173.192.170.88",80,15,3217,10,966,5,2251,1620.763448,3.0524350000000595,2531.74924281757,5899.55232461941
"147.32.84.165",2131,"67.195.168.230",25,6,372,6,372,0,0,1620.964566,8.912092999999913,333.92829271418384,0
"147.32.84.165",2133,"64.12.139.193",25,6,372,6,372,0,0,1620.964629,8.91215299999999,333.9260445820447,0
"147.32.84.165",2134,"146.141.15.6",25,6,372,6,372,0,0,1621.229716,8.846984999999904,336.38578566596783,0
"147.32.84.165",2136,"74.125.113.27",25,6,372,6,372,0,0,1621.964816,8.913304000000153,333.8829237732662,0
"147.32.84.165",2137,"67.195.168.230",25,6,372,6,372,0,0,1621.964891,8.91330099999982,333.8830361501379,0
"147.32.84.165",2138,"222.127.143.18",25,6,372,6,372,0,0,1621.964923,8.91329399999995,333.88329836309856,0
"147.32.84.165",2140,"74.125.113.27",25,6,372,6,372,0,0,1622.168901,8.909272000000101,334.0340265736601,0
"147.32.84.165",2141,"213.246.53.125",5296,11,666,8,484,3,182,1622.169071,0.1581389999998919,24484.788698566746,9207.08996516353
"147.32.84.165",2208,"217.72.192.149",25,6,372,6,372,0,0,1622.208725,8.869548000000123,335.53006308776486,0
"147.32.84.165",2142,"209.85.143.27",25,6,372,6,372,0,0,1623.368609,8.911750999999867,333.9411076454048,0
"147.32.84.165",2143,"74.125.113.27",25,6,372,6,372,0,0,1623.867883,8.912843000000066,333.9001932380025,0
"147.32.84.165",2148,"67.195.168.230",25,6,372,6,372,0,0,1623.868031,8.91278699999998,333.90229116885735,0
"147.32.84.165",2214,"143.107.171.10",6667,6,372,6,372,0,0,1632.680953,9.012433999999985,330.2104625676044,0
"147.32.84.165",2213,"217.72.192.149",25,6,372,6,372,0,0,1632.880526,9.013038000000051,330.18833383371765,0
"147.32.84.165",2215,"174.133.57.141",80,16,3429,12,1428,4,2001,1632.880757,0.4900230000000647,23313.19142162407,32667.85436601524
"147.32.84.165",2149,"74.125.113.27",25,6,372,6,372,0,0,1632.880787,9.012905000000046,330.19320629696915,0
"147.32.84.165",2152,"65.54.188.94",25,6,372,6,372,0,0,1632.880818,9.012928999999986,330.1923270448491,0
"147.32.84.165",2222,"41.93.130.4",6667,4,248,4,248,0,0,1634.282783,3.0041309999999157,660.423929582317,0
"147.32.84.165",2224,"212.117.174.7",4506,6,372,6,372,0,0,1641.893815,9.012783000000127,330.19767590099065,0
"147.32.84.165",2153,"65.55.88.22",25,6,372,6,372,0,0,1642.094271,9.012519999999995,330.2073116065209,0
"147.32.84.165",2223,"212.117.174.7",4506,6,372,6,372,0,0,1642.898783,9.009285999999975,330.3258438016074,0
"147.32.84.165",2154,"67.195.168.230",25,6,372,6,372,0,0,1642.898922,9.009290999999848,330.325660476507,0
"147.32.84.165",2227,"212.117.171.138",65500,78,7349,52,4754,26,2595,1642.899037,52.79483300000015,720.3735259471299,393.22029866066515
"147.32.84.165",2156,"98.139.175.225",25,6,372,6,372,0,0,1642.899098,9.009172999999919,330.3299870032495,0
"147.32.84.165",2160,"207.115.37.21",25,6,372,6,372,0,0,1642.899169,9.00915800000007,330.33053699357663,0
"147.32.84.165",2230,"98.139.54.60",25,6,372,6,372,0,0,1643.095342,9.013202999999976,330.1822892483402,0
"147.32.84.165",2231,"174.133.57.141",80,16,3429,12,1428,4,2001,1644.298548,0.4681279999999788,24403.581926311857,34195.77551439078
"147.32.84.165",2161,"98.139.54.60",25,6,372,6,372,0,0,1644.29868,9.011913999999933,330.22951617159487,0
"147.32.84.165",2232,"61.177.120.254",6667,15,1706,10,1148,5,558,1644.298746,1.5672739999999976,5859.856030279335,2848.257547818701
"147.32.84.165",2163,"67.195.168.230",25,6,372,6,372,0,0,1644.584445,8.926458000000139,333.39091496313023,0
"147.32.84.165",2164,"205.188.190.1",25,6,372,6,372,0,0,1644.58451,8.926517999999987,333.3886740608157,0
"147.32.84.165",2165,"74.125.113.27",25,6,372,6,372,0,0,1644.797763,9.013165000000072,330.1836813150515,0
"147.32.84.165",2235,"31.192.109.167",80,15,1540,10,1050,5,490,1653.21076,0.23718600000006518,35415.24373275696,16527.113741953246
"147.32.84.165",2236,"119.178.199.146",6667,2,124,2,124,0,0,1653.28857,7.999999979801942e-06,0,0
"147.32.84.165",2166,"77.238.177.9",25,6,372,6,372,0,0,1653.710994,9.01288899999986,330.19379246765897,0
"147.32.84.165",2167,"80.12.242.142",25,6,372,6,372,0,0,1653.911466,9.017092000000048,330.03988425536573,0
"147.32.84.165",2238,"212.117.171.138",65500,391,361374,270,352436,121,8938,1662.928694,75.57599600000003,37306.66017289404,946.1205115973592
"147.32.84.165",2242,"174.133.57.141",80,16,3429,12,1428,4,2001,1662.928752,0.4716049999999541,24223.661750831972,33943.660478581776
"147.32.84.165",2171,"216.237.219.199",25,6,372,6,372,0,0,1662.928814,9.008099999999786,330.3693342658353,0
"147.32.84.165",2240,"205.188.186.137",587,44,5497,28,3724,16,1773,1663.124499,32.66373900000008,912.0817429994751,434.2429995537243
"147.32.84.165",2172,"67.195.168.230",25,6,372,6,372,0,0,1663.242117,8.995386999999937,330.83623861875213,0
"147.32.84.165",2246,"88.250.200.14",6667,15,1704,10,1146,5,558,1663.925268,6.7811900000001515,1351.9750958164857,658.2915388006973
"147.32.84.165",2173,"205.188.103.1",25,6,372,6,372,0,0,1663.925378,9.013057000000117,330.18763777927524,0
"147.32.84.165",2174,"74.125.113.27",25,6,372,6,372,0,0,1664.126093,9.012514999999894,330.2074948002899,0
"147.32.84.165",2175,"67.195.168.230",25,6,372,6,372,0,0,1664.126222,9.012479999999869,330.2087771623397,0
"147.32.84.165",2176,"161.58.16.34",25,6,372,6,372,0,0,1664.126278,9.01244900000006,330.20991297703654,0
"147.32.84.165",2185,"64.12.139.193",25,6,372,6,372,0,0,1665.28763,8.952583999999888,332.4179923919214,0
"147.32.84.165",2186,"66.196.94.104",25,6,372,6,372,0,0,1665.527936,9.01265699999999,330.20229217643623,0
"147.32.84.165",2188,"67.195.168.230",25,6,372,6,372,0,0,1665.828199,9.01283199999989,330.1958807176298,0
"147.32.84.165",2190,"64.12.90.98",25,6,372,6,372,0,0,1665.828332,9.012823000000026,330.19621044371905,0
"147.32.84.165",2191,"74.125.113.27",25,6,372,6,372,0,0,1667.02977,9.015339999999924,330.1040226990912,0
"147.32.84.165",2256,"212.117.174.7",4506,6,372,6,372,0,0,1674.741085,9.012833,330.1958440814336,0
"147.32.84.165",2259,"61.17.216.84",6667,4,248,4,248,0,0,1674.941268,3.004466999999977,660.3500720760172,0
"147.32.84.165",2255,"212.117.174.7",4506,6,372,6,372,0,0,1683.954429,9.013220000000047,330.1816664854497,0
"147.32.84.165",2260,"174.133.57.141",80,17,3489,12,1428,5,2061,1683.954571,0.7579080000000431,15073.069554615271,21754.619294161115
"147.32.84.165",2192,"68.142.202.129",25,6,372,6,372,0,0,1683.954633,9.0130979999999,330.18613577706947,0
"147.32.84.165",2267,"119.154.129.1",6667,4,248,4,248,0,0,1684.254822,3.0043759999998656,660.3700735194559,0
"147.32.84.165",2194,"67.195.168.230",25,6,372,6,372,0,0,1684.955475,9.01327399999991,330.17968831304023,0
"147.32.84.165",2195,"64.12.90.65",25,6,372,6,372,0,0,1685.155719,9.01337599999988,330.1759518298182,0
"147.32.84.165",2197,"74.125.113.27",25,6,372,6,372,0,0,1686.257607,9.013613000000078,330.1672703276671,0
"147.32.84.165",2199,"173.236.81.226",3817,11,666,8,484,3,182,1686.257939,0.4236479999999574,9139.663116550508,3436.8154694466784
"147.32.84.165",2200,"76.96.30.116",25,6,372,6,372,0,0,1686.391894,8.97886399999993,331.44504694580775,0
"147.32.84.165",2201,"67.195.168.230",25,6,372,6,372,0,0,1686.557755,9.013054000000011,330.18774768241667,0
"147.32.84.165",2203,"98.139.54.60",25,6,372,6,372,0,0,1686.557887,9.013047000000142,330.18800412335065,0
"147.32.84.165",2204,"77.238.177.9",25,6,372,6,372,0,0,1686.858897,9.01255100000003,330.20617580971134,0
"147.32.84.165",2205,"205.188.190.1",25,6,372,6,372,0,0,1688.063798,8.908914000000095,334.0474495544539,0
"147.32.84.165",2206,"76.96.30.116",25,6,372,6,372,0,0,1691.064355,8.912947000000031,333.89629715064945,0
"147.32.84.165",2207,"69.175.10.98",4190,11,666,8,484,3,182,1691.06449,0.42562199999997574,9097.274107072051,3420.8758005932095
"147.32.84.165",2209,"67.195.168.230",25,6,372,6,372,0,0,1691.204809,8.87241999999992,335.42145209537273,0
"147.32.84.165",2210,"74.125.113.27",25,6,372,6,372,0,0,1691.20484,8.872479999999996,335.41918381331953,0
"147.32.84.165",2275,"94.95.56.138",6667,8,492,6,372,2,120,1695.771534,1.101034000000027,2702.9138064763915,871.9076795085134
"147.32.84.165",2278,"173.192.170.88",80,39,6035,24,1886,15,4149,1701.279332,38.55694900000003,391.3172694239886,860.856495673451
"147.32.84.165",2277,"174.133.57.141",80,16,3429,12,1428,4,2001,1701.480345,0.4676240000001144,24429.88383829146,34232.63134483278
"147.32.84.165",2211,"133.106.3.1",25,6,372,6,372,0,0,1701.635201,8.957245999999941,332.24497797649184,0
"147.32.84.165",2282,"212.117.174.7",4506,6,372,6,372,0,0,1704.884064,9.013284999999996,330.17928535489574,0
"147.32.84.165",2285,"210.212.249.136",6667,4,248,4,248,0,0,1705.885603,3.0045959999999923,660.321720457594,0
"147.32.84.165",2212,"168.95.6.55",25,6,372,6,372,0,0,1706.086012,9.012850999999955,330.1951846313686,0
"147.32.84.165",2216,"64.12.139.193",25,6,372,6,372,0,0,1707.28809,9.01589899999999,330.08355572749906,0
"147.32.84.165",2217,"67.195.168.230",25,6,372,6,372,0,0,1707.488551,9.01236700000004,330.2129174277952,0
"147.32.84.165",2218,"74.125.113.27",25,6,372,6,372,0,0,1707.788454,9.012913000000026,330.1929132124088,0
"147.32.84.165",2219,"209.85.143.27",25,6,372,6,372,0,0,1707.788591,9.012932000000092,330.1922171386592,0
"147.32.84.165",2220,"64.12.139.193",25,6,372,6,372,0,0,1708.990317,9.012703999999985,330.2005702173293,0
"147.32.84.165",2221,"94.245.120.86",25,6,372,6,372,0,0,1708.99045,9.012711000000081,330.20031375686773,0
"147.32.84.165",2294,"212.117.174.7",4506,6,372,6,372,0,0,1710.893016,9.013247999999976,330.1806407634637,0
"147.32.84.165",2225,"205.188.103.1",25,6,372,6,372,0,0,1710.893159,9.013239999999996,330.180933826238,0
"147.32.84.165",2295,"174.133.57.141",80,16,3429,12,1428,4,2001,1712.09465,0.4973649999999452,22969.04687704454,32185.618207959473
"147.32.84.165",2228,"80.72.43.190",25,6,372,6,372,0,0,1712.259465,8.94809199999986,332.58486837194414,0
"147.32.84.165",2296,"190.204.173.239",6667,6,372,6,372,0,0,1721.107739,9.713375999999926,306.381632915273,0
"147.32.84.165",2300,"208.73.210.29",80,72,39221,44,6656,28,32565,1722.610035,12.770280000000184,4169.681479184421,20400.49239327534
"147.32.84.165",2308,"174.133.57.141",80,17,4638,12,1428,5,3210,1722.79301,283.3471089999998,40.31803973690802,90.63088764388988
"147.32.84.165",2229,"67.195.168.230",25,6,372,6,372,0,0,1722.954267,9.135266000000001,325.77048112227925,0
"147.32.84.165",2233,"74.125.113.27",25,6,372,6,372,0,0,1722.954339,9.138377000000219,325.6595782817812,0
"147.32.84.165",2302,"212.117.171.138",65500,346,336392,254,329336,92,7056,1725.914643,27.265060999999832,96632.38970930658,2070.3419662255787
"147.32.84.165",2310,"74.125.232.217",80,13,2942,10,2068,3,874,1725.914702,9.468824999999924,1747.2072828466185,738.4231940077101
"147.32.84.165",2234,"205.188.190.1",25,6,372,6,372,0,0,1725.922964,9.22299699999985,322.67168687142026,0
"147.32.84.165",2307,"111.88.1.3",6667,2,124,2,124,0,0,1727.116286,9.999999974752427e-06,0,0
"147.32.84.165",2314,"67.214.158.5",80,15,2573,10,1718,5,855,1728.318151,0.31584399999997004,43515.15305024412,21656.260685657
"147.32.84.165",2239,"67.195.168.230",25,6,372,6,372,0,0,1728.422153,9.628574999999955,309.08000405044504,0
"147.32.84.165",2309,"65.55.196.251",443,239,174646,156,12388,83,162258,1728.42219,10.164113000000043,9750.38353076157,127710.50459592436
"147.32.84.165",2315,"195.113.232.83",80,13,2138,10,1550,3,588,1728.518706,6.868003999999928,1805.4736135855671,684.9151514763313
"147.32.84.165",2241,"207.115.37.23",25,6,372,6,372,0,0,1728.519499,9.610415999999987,309.66401454422,0
"147.32.84.165",2316,"50.22.198.84",80,14,3424,10,2332,4,1092,1728.522608,0.43921399999999267,42475.877362744155,19890.07636368637
"147.32.84.165",2243,"74.125.113.27",25,6,372,6,372,0,0,1728.643455,9.537279000000126,312.03868524764357,0
"147.32.84.165",2321,"67.214.158.5",80,15,2658,10,1762,5,896,1728.64352,0.39184499999987565,35973.40785260619,18292.947466478516
"147.32.84.165",2244,"205.188.190.1",25,6,372,6,372,0,0,1728.747179,9.588751000000002,310.36367510221083,0
"147.32.84.165",2245,"165.21.74.121",25,6,372,6,372,0,0,1728.747237,9.591874999999845,310.26259203753676,0
"147.32.84.165",2322,"50.22.198.84",80,13,2956,10,2436,3,520,1728.819136,0.41626899999982925,46815.881076918995,9993.537832511445
"147.32.84.165",2247,"67.195.168.230",25,6,372,6,372,0,0,1728.819262,9.656670000000076,308.1807703897903,0
"147.32.84.165",2324,"68.67.185.218",80,13,2078,10,1168,3,910,1730.020686,5.372459999999819,1739.2404969046424,1355.0589487870072
"147.32.84.165",2248,"74.125.113.27",25,6,372,6,372,0,0,1730.842313,8.992119999999886,330.95643741409566,0
"147.32.84.165",2323,"68.67.185.218",80,13,2050,10,1168,3,882,1730.842369,4.5475810000000365,2054.718761468993,1551.5941332325788
"147.32.84.165",2249,"205.188.190.1",25,6,372,6,372,0,0,1730.84242,8.992148000000043,330.9554068727501,0
"147.32.84.165",2250,"94.124.93.172",25,6,372,6,372,0,0,1730.842475,8.992155000000139,330.9551492384144,0
"147.32.84.165",2325,"212.117.174.7",4506,6,372,6,372,0,0,1731.92313,9.013214000000062,330.1818862838472,0
"147.32.84.165",2328,"202.78.166.103",6667,4,248,4,248,0,0,1733.224826,3.457503000000088,573.8245201811682,0
"147.32.84.165",2336,"212.117.174.7",4506,6,372,6,372,0,0,1740.936128,10.25282500000003,290.26146452319153,0
"147.32.84.165",2338,"173.192.170.88",80,17,1641,12,1084,5,557,1740.936273,88.35452199999986,98.15004148853879,50.43318552501486
"147.32.84.165",2251,"67.195.168.230",25,6,372,6,372,0,0,1741.136993,10.055108000000018,295.96897417710426,0
"147.32.84.165",2252,"64.12.139.193",25,6,372,6,372,0,0,1741.137074,10.058248999999932,295.87654869152874,0
"147.32.84.165",2332,"212.117.171.138",65500,385,362788,270,354188,115,8600,1742.13799,33.24474000000009,85231.64867585043,2069.5003179450287
"147.32.84.165",2253,"209.191.88.254",25,6,372,6,372,0,0,1742.138133,9.142785000000003,325.5025684187038,0
"147.32.84.165",2340,"65.55.196.251",443,203,170990,132,10828,71,160162,1743.940585,9.320650999999998,9293.771432918153,137468.509442098
"147.32.84.165",2254,"74.125.113.27",25,6,372,6,372,0,0,1744.041491,9.109429000000091,326.6944613103599,0
"147.32.84.165",2341,"41.221.75.228",6667,2,124,2,124,0,0,1746.948639,1.1638600000001134,852.3361916380866,0
"147.32.84.165",2257,"208.89.132.27",25,6,372,6,372,0,0,1749.548954,9.012531999999965,330.20687194231454,0
"147.32.84.165",2258,"67.195.168.230",25,6,372,6,372,0,0,1749.748567,9.013139999999794,330.18459715482817,0
"147.32.84.165",2261,"67.195.168.230",25,6,372,6,372,0,0,1749.748691,9.013220000000047,330.1816664854497,0
"147.32.84.165",2262,"205.188.190.1",25,6,372,6,372,0,0,1749.748743,9.01326499999982,330.1800180067999,0
"147.32.84.165",2263,"74.125.113.27",25,6,372,6,372,0,0,1749.849345,9.013070999999854,330.18712489894375,0
"147.32.84.165",2264,"67.195.168.230",25,6,372,6,372,0,0,1749.849424,9.013196000000107,330.18254568079567,0
"147.32.84.165",2265,"205.188.103.1",25,6,372,6,372,0,0,1751.150811,9.013233000000128,330.181190256588,0
"147.32.84.165",2266,"64.238.126.26",25,6,372,6,372,0,0,1751.851616,9.012985000000072,330.1902754747707,0
"147.32.84.165",2349,"119.154.75.69",6667,4,248,4,248,0,0,1752.953374,3.0043440000001738,660.3771072819508,0
"147.32.84.165",2268,"98.139.175.225",25,6,372,6,372,0,0,1761.365748,9.589036000000078,310.35445064550555,0
"147.32.84.165",2354,"212.117.174.7",4506,6,372,6,372,0,0,1762.16648,9.251107999999931,321.69119634102447,0
"147.32.84.165",2359,"174.133.57.141",80,16,3429,12,1428,4,2001,1763.168032,0.4763980000000174,23979.949537990466,33602.15618033538
"147.32.84.165",2269,"67.195.168.230",25,6,372,6,372,0,0,1763.168164,9.110998999999993,326.63816558425725,0
"147.32.84.165",2353,"212.117.171.138",65500,70,6874,46,4394,24,2480,1763.168305,57.27863700000012,613.7017541112217,346.3769572589508
"147.32.84.165",2270,"205.188.190.1",25,6,372,6,372,0,0,1763.168362,9.113994000000048,326.53082720923277,0
"147.32.84.165",2358,"59.48.7.168",6667,9,552,6,372,3,180,1763.16842,1.93663800000013,1536.6836755241818,743.5566171891202
"147.32.84.165",2271,"66.94.9.228",25,6,372,6,372,0,0,1765.070702,9.067653999999948,328.1995541514947,0
"147.32.84.165",2360,"65.55.196.251",443,230,172632,146,11764,84,160868,1765.105323,10.358850999999959,9085.177497002358,124236.17252531242
"147.32.84.165",2272,"74.125.113.27",25,6,372,6,372,0,0,1765.205738,9.163802999999916,324.7559992287075,0
"147.32.84.165",2364,"61.17.216.7",6667,4,248,4,248,0,0,1770.478904,3.0986639999998715,640.2759382753607,0
"147.32.84.165",2363,"212.117.174.7",4506,6,372,6,372,0,0,1770.679239,9.012383,330.21233118920935,0
"147.32.84.165",2273,"98.139.54.60",25,6,372,6,372,0,0,1770.679388,9.01235799999995,330.21324718791874,0
"147.32.84.165",2274,"67.195.168.230",25,6,372,6,372,0,0,1770.779079,9.01762900000017,330.0202303731883,0
"147.32.84.165",2276,"74.125.113.27",25,6,372,6,372,0,0,1770.979424,9.01665899999989,330.05573350395485,0
"147.32.84.165",2279,"98.139.54.60",25,6,372,6,372,0,0,1770.979523,9.016683000000057,330.0548549838096,0
"147.32.84.165",2280,"74.125.113.27",25,6,372,6,372,0,0,1770.979552,9.016701999999896,330.05415949202205,0
"147.32.84.165",2281,"67.195.168.230",25,6,372,6,372,0,0,1770.979579,9.01672799999983,330.05320777116225,0
"147.32.84.165",2283,"64.12.139.193",25,6,372,6,372,0,0,1770.979607,9.016750000000002,330.0524024731749,0
"147.32.84.165",2284,"166.119.78.9",25,6,372,6,372,0,0,1772.08454,9.009213000000045,330.3285203713116,0
"147.32.84.165",2287,"76.96.62.116",25,6,372,6,372,0,0,1772.782031,9.01281599999993,330.1964668978068,0
"147.32.84.165",2367,"31.192.109.167",80,17,1664,12,1174,5,490,1782.295481,3.2434249999998883,2895.7043865667692,1208.5989347680722
"147.32.84.165",2372,"80.75.1.194",6667,2,124,2,124,0,0,1783.096849,1.3000000080864993e-05,0,0
"147.32.84.165",2368,"174.133.57.141",80,17,4638,12,1428,5,3210,1785.379948,124.10944199999994,92.0477911745023,206.9141524300787
"147.32.84.165",2288,"74.125.113.27",25,6,372,6,372,0,0,1785.380028,8.932792999999947,333.1544792317495,0
"147.32.84.165",2289,"98.139.54.60",25,6,372,6,372,0,0,1785.3801,8.932816999999886,333.1535841381322,0
"147.32.84.165",2290,"98.139.175.225",25,6,372,6,372,0,0,1785.380171,8.932774999999992,333.15515055511895,0
"147.32.84.165",2291,"64.12.139.193",25,6,372,6,372,0,0,1786.000966,9.013067999999976,330.1872348017354,0
"147.32.84.165",2376,"212.117.171.138",65500,49,15238,34,10950,15,4288,1786.001099,22.716038000000026,3856.3062801708597,1510.1224958331184
"147.32.84.165",2292,"168.95.5.7",25,6,372,6,372,0,0,1786.001157,9.012930000000097,330.19229040944157,0
"147.32.84.165",2293,"67.195.168.230",25,6,372,6,372,0,0,1786.101008,9.013218999999935,330.18170311849974,0
"147.32.84.165",2297,"168.95.5.51",25,6,372,6,372,0,0,1786.10114,9.013181999999915,330.18305854691806,0
"147.32.84.165",2378,"205.188.186.137",587,49,5807,32,3974,17,1833,1786.601574,33.93993299999988,936.7136935715256,432.05742333080184
"147.32.84.165",2298,"67.195.168.230",25,6,372,6,372,0,0,1786.719145,8.995681999999988,330.8253893367956,0
"147.32.84.165",2303,"74.125.113.27",25,6,372,6,372,0,0,1786.719211,8.995745999999826,330.82303568820834,0
"147.32.84.165",2380,"212.117.174.7",4506,6,372,6,372,0,0,1791.712139,9.010559000000057,330.279175798081,0
"147.32.84.165",2381,"217.34.4.225",6667,15,1764,10,1206,5,558,1791.8093,0.5316590000002179,18146.970144389627,8396.359320538484
"147.32.84.165",2304,"76.96.30.116",25,6,372,6,372,0,0,1791.893958,8.927955999999995,333.3349761132337,0
"147.32.84.165",2305,"67.195.168.230",25,6,372,6,372,0,0,1792.009575,9.01306999999997,330.1871615331968,0
"147.32.84.165",2306,"205.188.190.1",25,6,372,6,372,0,0,1793.117061,9.007001000000173,330.4096446752857,0
"147.32.84.165",2311,"74.125.113.27",25,6,372,6,372,0,0,1793.812238,9.013283000000001,330.17935861993897,0
"147.32.84.165",2312,"207.115.36.22",25,6,372,6,372,0,0,1793.812372,9.013275999999905,330.1796150478507,0
"147.32.84.165",2383,"59.48.7.172",6667,9,552,6,372,3,180,1796.816537,1.9407760000001417,1533.4072556543272,741.9712527359649
"147.32.84.165",2384,"212.117.174.7",4506,6,372,6,372,0,0,1798.757604,9.056651000000102,328.5982864968482,0
"147.32.84.165",2313,"94.245.120.86",25,6,372,6,372,0,0,1798.757669,9.059790999999905,328.48439881229393,0
"147.32.84.165",2389,"98.126.71.122",80,18,4863,14,1430,4,3433,1806.330832,17.82171399999993,641.9135667871253,1541.0414508952456
"147.32.84.165",2385,"125.114.134.15",6667,2,124,2,124,0,0,1806.505427,1.4999999848441803e-05,0,0
"147.32.84.165",2317,"76.96.30.116",25,6,372,6,372,0,0,1807.022474,9.030034999999998,329.5668289214827,0
"147.32.84.165",2318,"208.20.216.138",25,6,372,6,372,0,0,1807.022545,9.030088999999862,329.5648581093769,0
"147.32.84.165",2391,"195.113.232.88",80,17,5706,12,2574,5,3132,1807.123204,17.14002299999993,1201.3986212270595,1461.8416789755827
"147.32.84.165",2387,"212.117.171.138",65500,344,333178,258,326642,86,6536,1807.124071,57.95317,45090.47563748454,902.2457270240782
"147.32.84.165",2319,"67.195.168.230",25,6,372,6,372,0,0,1807.12413,9.028870000000097,329.6093531084142,0
"147.32.84.165",2392,"65.55.16.187",443,32,13127,22,8076,10,5051,1807.124189,1.7351300000000265,37235.25038469683,23288.16860984444
"147.32.84.165",2320,"64.12.139.193",25,6,372,6,372,0,0,1807.290178,8.962482000000136,332.05087608543647,0
"147.32.84.165",2393,"195.113.232.83",80,13,3379,10,1524,3,1855,1807.725277,16.538052000000107,737.208953025418,897.3245458413061
"147.32.84.165",2329,"74.125.113.27",25,6,372,6,372,0,0,1807.821491,8.933215000000018,333.13874120347424,0
"147.32.84.165",2394,"77.238.175.247",80,14,2274,10,1276,4,998,1812.741982,0.13886299999990115,73511.3025068396,57495.517164440374
"147.32.84.165",2399,"119.154.24.194",6667,9,552,6,372,3,180,1812.788079,1.829589000000169,1626.5948253950614,787.0620122879329
"147.32.84.165",2330,"205.188.190.1",25,6,372,6,372,0,0,1812.842439,8.929497999999967,333.2774138031064,0
"147.32.84.165",2395,"74.125.232.217",80,13,1871,10,1156,3,715,1812.842572,11.420849999999973,809.7470853745581,500.8383789297656
"147.32.84.165",2333,"67.195.168.230",25,6,372,6,372,0,0,1812.850585,8.921445000000176,333.57824881506764,0
"147.32.84.165",2396,"68.67.185.205",80,16,2169,12,1370,4,799,1812.850616,11.30181000000016,969.7561717990168,565.5731250127112
"147.32.84.165",2334,"209.86.93.227",25,6,372,6,372,0,0,1812.874403,8.897650999999996,334.4703000825725,0
"147.32.84.165",2397,"64.236.79.229",80,14,2814,10,2100,4,714,1813.0424,0.35542199999986224,47267.754950471586,16071.036683160339
"147.32.84.165",2335,"167.230.202.13",25,6,372,6,372,0,0,1813.159913,8.91263600000002,333.9079482209296,0
"147.32.84.165",2398,"64.236.79.229",80,14,2618,10,1918,4,700,1814.14633,0.35536099999990256,43178.626804866624,15758.622921484168
"147.32.84.165",2406,"174.133.57.141",80,16,3429,12,1428,4,2001,1814.264132,0.4846439999998893,23571.941466318804,33030.43058410639
"147.32.84.165",2337,"209.85.225.27",25,6,372,6,372,0,0,1814.264195,8.912074000000075,333.92900462899826,0
"147.32.84.165",2402,"64.236.79.229",80,14,2601,10,1944,4,657,1814.617908,0.35617400000001,43664.05183982987,14756.832334757317
"147.32.84.165",2339,"64.12.90.65",25,6,372,6,372,0,0,1814.735721,8.841953999999987,336.57718644544,0
"147.32.84.165",2403,"64.236.79.229",80,14,2583,10,1926,4,657,1814.848717,0.35639500000002045,43232.9297549043,14747.68164536455
"147.32.84.165",2342,"67.195.168.230",25,6,372,6,372,0,0,1814.848817,8.929043999999976,333.2943593961468,0
"147.32.84.165",2404,"77.238.167.32",80,13,2342,10,1390,3,952,1818.561256,0.1407249999999749,79019.36400783077,54119.73707586682
"147.32.84.165",2410,"212.117.174.7",4506,6,372,6,372,0,0,1818.607261,8.890253999999914,334.7485909851427,0
"147.32.84.165",2409,"109.200.240.44",6667,4,248,4,248,0,0,1819.765843,2.9088000000001557,682.0682068206455,0
"147.32.84.165",2413,"212.117.174.7",4506,6,372,6,372,0,0,1827.997907,9.020021000000042,329.9327130169637,0
"147.32.84.165",2412,"174.133.57.141",80,17,3489,12,1428,5,2061,1827.998006,4.230963999999858,2700.093879314592,3896.984233380514
"147.32.84.165",2343,"213.246.53.125",5296,52540,3207123,34986,2099164,17554,1107959,1827.998042,15424.073062,1088.7728508867979,574.6648089885714
"147.32.84.165",2416,"27.255.59.64",6667,8,492,6,372,2,120,1828.029895,1.3698370000001887,2172.5212561783555,700.8133084446308
"147.32.84.165",2344,"64.12.139.193",25,6,372,6,372,0,0,1828.198685,9.012561000000005,330.2058094253119,0
"147.32.84.165",2345,"67.195.168.230",25,6,372,6,372,0,0,1828.699322,9.012426000000005,330.2107556833197,0
"147.32.84.165",2346,"64.18.5.10",25,6,372,6,372,0,0,1828.699383,9.012576000000081,330.20525985023295,0
"147.32.84.165",2418,"173.192.170.88",80,17,1643,12,1086,5,557,1833.806517,85.2859390000001,101.86907832485716,52.24776853309893
"147.32.84.165",2347,"98.139.175.225",25,6,372,6,372,0,0,1834.007594,9.01754700000015,330.0232313732272,0
"147.32.84.165",2348,"64.12.139.193",25,6,372,6,372,0,0,1834.106822,9.013040000000046,330.18826056469123,0
"147.32.84.165",2350,"67.195.168.230",25,6,372,6,372,0,0,1834.10697,9.013018999999986,330.1890298910947,0
"147.32.84.165",2351,"64.12.90.65",25,6,372,6,372,0,0,1834.107158,9.012886999999864,330.1938657391405,0
"147.32.84.165",2355,"67.195.168.230",25,6,372,6,372,0,0,1834.107236,9.0128729999999,330.1943786404217,0
"147.32.84.165",2356,"204.232.236.146",25,6,372,6,372,0,0,1834.107312,9.012859999999819,330.19485490732797,0
"147.32.84.165",2357,"64.12.90.65",25,6,372,6,372,0,0,1835.208505,9.018643999999995,329.9830883667214,0
"147.32.84.165",2361,"67.195.168.230",25,6,372,6,372,0,0,1835.208604,9.01868300000001,329.98166140222435,0
"147.32.84.165",2362,"205.188.190.1",25,6,372,6,372,0,0,1835.208636,9.018711999999823,329.9806003340675,0
"147.32.84.165",2365,"159.134.198.135",25,6,372,6,372,0,0,1835.608803,9.013520999999855,330.1706403080492,0
"147.32.84.165",2366,"64.12.139.193",25,6,372,6,372,0,0,1835.809029,9.01304499999992,330.18807739227157,0
"147.32.84.165",2369,"65.55.37.88",25,6,372,6,372,0,0,1835.809163,9.012997000000041,330.18983585592963,0
"147.32.84.165",2370,"64.12.139.193",25,6,372,6,372,0,0,1836.610239,9.013435999999956,330.1737539380115,0
"147.32.84.165",2371,"67.195.168.230",25,6,372,6,372,0,0,1836.610373,9.013427999999976,330.17404698856063,0
"147.32.84.165",2424,"117.196.25.55",6667,4,248,4,248,0,0,1839.517665,3.001011999999946,661.1103187858081,0
"147.32.84.165",2425,"174.133.57.141",80,16,3429,12,1428,4,2001,1846.224049,0.4801760000000286,23791.276531936874,33337.77614874348
"147.32.84.165",2373,"64.12.139.193",25,6,372,6,372,0,0,1846.224203,9.013012000000117,330.1892863340203,0
"147.32.84.165",2428,"212.117.174.7",4506,6,372,6,372,0,0,1846.224278,9.013039000000163,330.1882971991962,0
"147.32.84.165",2433,"61.17.216.16",6667,4,248,4,248,0,0,1849.229233,3.0036059999999907,660.5393650165854,0
"147.32.84.165",2374,"67.195.168.230",25,6,372,6,372,0,0,1849.729278,10.169822999999951,292.63046171010194,0
"147.32.84.165",2377,"64.12.139.193",25,6,372,6,372,0,0,1849.729417,10.172880999999961,292.5424960736306,0
"147.32.84.165",2436,"212.117.171.138",65500,343,332778,252,325942,91,6836,1855.036674,32.36451099999999,80567.75521805351,1689.7520867841943
"147.32.84.165",2442,"212.117.174.7",4506,6,372,6,372,0,0,1855.03677,9.792725000000019,303.8990679305295,0
"147.32.84.165",2379,"32.97.182.144",25,6,372,6,372,0,0,1855.036799,9.79591900000014,303.79998037958023,0
"147.32.84.165",2438,"65.55.16.187",443,194,170351,136,10904,58,159447,1855.13866,10.082433999999921,8651.879099828542,126514.68881422978
"147.32.84.165",2390,"173.236.81.226",3817,11,666,8,484,3,182,1855.304582,0.40796000000000276,9491.126581037292,3568.9773507206346
"147.32.84.165",2400,"165.21.74.121",25,6,372,6,372,0,0,1855.437255,9.398657999999841,316.64095022928274,0
"147.32.84.165",2401,"69.175.10.98",4190,17,1034,12,732,5,302,1856.239117,6.441332999999986,909.128591861345,375.0776430903363
"147.32.84.165",2408,"207.115.36.22",25,6,372,6,372,0,0,1856.438875,9.016924999999901,330.0459968337357,0
"147.32.84.165",2444,"174.133.57.141",80,16,3429,12,1428,4,2001,1856.639115,2.468309999999974,4628.2679242073,6485.409045055187
"147.32.84.165",2414,"170.202.119.16",25,6,372,6,372,0,0,1856.639241,9.012958000000026,330.19126462144743,0
"147.32.84.165",2415,"203.188.197.119",25,6,372,6,372,0,0,1856.839977,9.012825999999905,330.1961005349522,0
"147.32.84.165",2417,"92.103.13.126",25,6,372,6,372,0,0,1857.640882,9.012671000000182,330.2017792505618,0
"147.32.84.165",2449,"180.242.10.201",6667,4,248,4,248,0,0,1859.581256,4.262243000000126,465.4826109163512,0
"147.32.84.165",2419,"204.127.217.21",25,6,372,6,372,0,0,1866.653418,9.013041999999814,330.18818729570563,0
"147.32.84.165",2420,"209.85.225.27",25,6,372,6,372,0,0,1867.255402,9.011923999999908,330.2291497353984,0
"147.32.84.165",2457,"212.117.171.138",65500,352,333662,260,326762,92,6900,1870.761327,23.74910100000011,110071.36649088266,2324.2985071308485
"147.32.84.165",2468,"174.133.57.141",80,16,3429,12,1428,4,2001,1870.761533,0.48697999999990316,23458.8689473947,32871.98652922745
"147.32.84.165",2421,"207.115.21.20",25,6,372,6,372,0,0,1870.761608,9.875178000000005,301.36165646836935,0
"147.32.84.165",2476,"212.117.174.7",4506,6,372,6,372,0,0,1876.066962,9.61662699999988,309.46401477358296,0
"147.32.84.165",2465,"65.55.196.251",443,230,172299,150,11852,80,160447,1876.267192,11.603186999999934,8171.548041068419,110622.71081212492
"147.32.84.165",2422,"209.191.88.254",25,6,372,6,372,0,0,1876.367412,9.59937100000002,310.0203127892436,0
"147.32.84.165",2467,"80.98.120.34",6667,6,372,6,372,0,0,1876.368599,9.601387000000159,309.9552179284046,0
"147.32.84.165",2423,"209.85.225.27",25,6,372,6,372,0,0,1877.468939,9.495046999999886,313.4265686099327,0
"147.32.84.165",2426,"209.85.225.27",25,6,372,6,372,0,0,1877.469253,9.497929999999997,313.3314311644749,0
"147.32.84.165",2474,"212.117.171.138",65500,69,6757,44,4274,25,2483,1877.469312,51.81241100000011,659.9191070263055,383.38304696918965
"147.32.84.165",2427,"80.54.122.3",25,6,372,6,372,0,0,1877.469366,9.501021000000037,313.22949396701557,0
"147.32.84.165",2429,"66.94.237.64",25,6,372,6,372,0,0,1877.669189,9.735194999999976,305.69495526283833,0
"147.32.84.165",2484,"186.92.63.171",6667,4,248,4,248,0,0,1877.869479,3.6573459999999614,542.4698674940847,0
"147.32.84.165",2430,"209.85.225.27",25,6,372,6,372,0,0,1878.671148,9.687636999999995,307.1956556588569,0
"147.32.84.165",2486,"65.55.16.187",443,220,171803,140,11180,80,160623,1878.671276,15.983169999999973,5595.88617276799,80396.06661256823
"147.32.84.165",2431,"66.36.236.47",25,6,372,6,372,0,0,1879.481796,9.744985000000042,305.3878482111555,0
"147.32.84.165",2492,"212.117.174.7",4506,6,372,6,372,0,0,1887.583873,9.012850000000071,330.19522126741003,0
"147.32.84.165",2493,"174.133.57.141",80,16,3429,12,1428,4,2001,1887.583946,2.7132839999999305,4210.39596297339,5899.8615699648135
"147.32.84.165",2432,"216.32.180.22",25,6,372,6,372,0,0,1887.583982,9.01289799999995,330.19346274639037,0
"147.32.84.165",2495,"212.117.171.138",65500,348,333078,256,326182,92,6896,1888.184466,20.247337000000016,128878.97307186609,2724.7039944067683
"147.32.84.165",2434,"81.2.195.200",25,6,372,6,372,0,0,1888.184594,9.01266899999996,330.2018525255963,0
"147.32.84.165",2507,"195.70.198.9",6667,2,124,2,124,0,0,1891.689396,0.609367999999904,1627.9161360625374,0
"147.32.84.165",2437,"98.139.175.225",25,6,372,6,372,0,0,1896.098715,9.60630399999991,309.7965669210581,0
"147.32.84.165",2521,"173.192.170.88",80,16,2047,12,1518,4,529,1896.997042,12.305294000000004,986.8923083024263,343.91701652963343
"147.32.84.165",2510,"64.12.175.136",587,48,5633,30,3740,18,1893,1896.997122,32.37907599999994,924.0535461851986,467.70945532849754
"147.32.84.165",2439,"209.85.225.27",25,6,372,6,372,0,0,1897.114707,9.892309999999952,300.8397431944626,0
"147.32.84.165",2440,"66.94.237.64",25,6,372,6,372,0,0,1897.298582,9.711618000000044,306.4370942102528,0
"147.32.84.165",2528,"212.117.171.138",65500,348,335828,258,329498,90,6330,1897.298712,76.00657299999989,34681.00054978145,666.2581669088024
"147.32.84.165",2441,"216.69.186.201",25,6,372,6,372,0,0,1897.298771,9.714648000000125,306.34151643991237,0
"147.32.84.165",2443,"24.71.223.11",25,6,372,6,372,0,0,1897.298836,9.717816000000084,306.2416493582482,0
"147.32.84.165",2531,"174.36.246.56",80,28,14195,22,2092,6,12103,1898.403367,0.4067520000000968,41145.46455824684,238041.85351264887
"147.32.84.165",2530,"65.55.16.187",443,236,172731,152,12068,84,160663,1898.524394,10.051108999999997,9605.308230166445,127876.83428763934
"147.32.84.165",2445,"205.188.159.42",25,6,372,6,372,0,0,1898.599258,9.56214100000011,311.2273705229787,0
"147.32.84.165",2532,"202.86.18.246",6667,4,248,4,248,0,0,1898.691043,3.5515559999998914,558.628387106964,0
"147.32.84.165",2544,"174.133.57.141",80,16,3429,12,1428,4,2001,1900.39582,2.873162000000093,3976.107159985977,5571.561923761863
"147.32.84.165",2446,"208.65.144.3",25,6,372,6,372,0,0,1900.395882,9.030534999999873,329.5485815624481,0
"147.32.84.165",2538,"195.113.232.82",80,7,426,6,364,1,62,1905.01188,1.561138999999912,1865.3047550539472,317.71674399270535
"147.32.84.165",2547,"212.117.174.7",4506,6,372,6,372,0,0,1905.702675,8.949076000000105,332.54829884112786,0
"147.32.84.165",2559,"115.137.250.215",6667,9,552,6,372,3,180,1908.62372,1.9228900000000522,1547.6704335661007,748.8727904352099
"147.32.84.165",2447,"209.85.225.27",25,6,372,6,372,0,0,1909.225163,9.03141800000003,329.51636166103594,0
"147.32.84.165",2555,"31.192.109.167",80,15,1540,10,1050,5,490,1909.225297,0.23229700000001685,36160.60474306336,16874.94888009624
"147.32.84.165",2539,"195.113.232.82",80,13,1479,10,1122,3,357,1909.301364,4.459787000000006,2012.6521737473088,640.3893280105073
"147.32.84.165",2448,"66.94.237.64",25,6,372,6,372,0,0,1909.302159,8.954522999999881,332.34601106056004,0
"147.32.84.165",2540,"195.113.232.82",80,13,1565,10,1228,3,337,1910.546822,3.214537000000064,3056.1166351483294,838.6899886359829
"147.32.84.165",2450,"167.138.239.94",25,6,372,6,372,0,0,1910.546904,9.011477000000014,330.2455302277302,0
"147.32.84.165",2573,"117.204.67.227",6667,4,248,4,248,0,0,1914.651612,3.0044000000000324,660.3647982958256,0
"147.32.84.165",2574,"212.117.174.7",4506,6,372,6,372,0,0,1917.154928,9.013118000000077,330.185403098015,0
"147.32.84.165",2569,"174.133.57.141",80,16,3429,12,1428,4,2001,1917.155074,0.5021039999999175,22752.25849625153,31881.841212184387
"147.32.84.165",2451,"203.188.197.119",25,6,372,6,372,0,0,1917.320218,8.94800999999984,332.58791619589755,0
"147.32.84.165",2452,"209.85.225.27",25,6,372,6,372,0,0,1918.157001,9.014591999999993,330.13141360141447,0
"147.32.84.165",2453,"209.85.225.27",25,6,372,6,372,0,0,1918.356656,9.013042000000041,330.18818729569733,0
"147.32.84.165",2454,"66.94.237.64",25,6,372,6,372,0,0,1918.356797,9.012961000000132,330.19115471596473,0
"147.32.84.165",2455,"203.188.197.119",25,6,372,6,372,0,0,1918.35683,9.012954000000036,330.19141116219924,0
"147.32.84.165",2458,"209.85.225.27",25,6,372,6,372,0,0,1918.356861,9.012948999999935,330.19159433832607,0
"147.32.84.165",2459,"64.12.90.98",25,6,372,6,372,0,0,1918.356893,9.012941000000183,330.1918874205367,0
"147.32.84.165",2460,"94.245.120.86",25,6,372,6,372,0,0,1918.356927,9.012931999999864,330.1922171386675,0
"147.32.84.165",2583,"173.192.170.88",80,17,1643,12,1086,5,557,1919.661147,43.26033099999995,200.83064089361707,103.00429740123822
"147.32.84.165",2461,"209.85.225.27",25,6,372,6,372,0,0,1919.862147,9.009898999999905,330.3033696604181,0
"147.32.84.165",2462,"216.8.158.53",25,6,372,6,372,0,0,1919.862209,9.009861,330.3047627482821,0
"147.32.84.165",2463,"66.94.237.64",25,6,372,6,372,0,0,1921.461306,9.012830000000122,330.19595399002975,0
"147.32.84.165",2464,"217.46.153.81",25,6,372,6,372,0,0,1921.461439,9.012762000000066,330.1984452712696,0
"147.32.84.165",2590,"203.84.189.77",6667,9,552,6,372,3,180,1926.668918,2.593016000000034,1147.6982787610877,555.3378768198812
"147.32.84.165",2598,"174.133.57.141",80,17,3489,12,1428,5,2061,1929.26216,6.504885000000058,1756.2185957168954,2534.7104522216537
"147.32.84.165",2466,"64.12.90.97",25,6,372,6,372,0,0,1929.428006,8.957508999999845,332.2352229844314,0
"147.32.84.165",2469,"210.172.144.10",25,6,372,6,372,0,0,1930.273861,8.912807000000157,333.9015419048059,0
"147.32.84.165",2470,"216.69.186.201",25,6,372,6,372,0,0,1931.575787,8.9127739999999,333.9027781922927,0
"147.32.84.165",2608,"212.117.174.7",4506,6,372,6,372,0,0,1932.076385,8.912918999999874,333.8973460883064,0
"147.32.84.165",2610,"61.153.193.110",6667,2,124,2,124,0,0,1938.18526,7.999999979801942e-06,0,0
"147.32.84.165",2623,"173.192.170.88",80,16,2030,12,1502,4,528,1939.08674,18.2427560000001,658.6724067350314,231.54396188821343
"147.32.84.165",2471,"203.188.197.119",25,6,372,6,372,0,0,1939.086847,9.013392999999951,330.17532909083366,0
"147.32.84.165",2472,"209.85.225.27",25,6,372,6,372,0,0,1939.286938,9.013006000000132,330.1895061425629,0
"147.32.84.165",2475,"209.85.225.27",25,6,372,6,372,0,0,1939.287042,9.013011000000006,330.1893229687613,0
"147.32.84.165",2477,"66.94.237.64",25,6,372,6,372,0,0,1939.28707,9.013011000000006,330.1893229687613,0
"147.32.84.165",2625,"68.67.185.217",80,16,2456,12,1424,4,1032,1940.789093,10.461481999999933,1088.9470535818991,789.1807298430617
"147.32.84.165",2478,"205.188.59.193",25,6,372,6,372,0,0,1940.812977,8.989039999999932,331.0698361560325,0
"147.32.84.165",2631,"61.17.216.4",6667,15,1788,10,1230,5,558,1942.396402,1.0272609999999531,9578.870413653833,4345.536333999055
"147.32.84.165",2628,"68.67.185.214",80,16,2682,12,1800,4,882,1942.580525,14.748828000000003,976.3487647967687,478.4108947504167
"147.32.84.165",2479,"205.188.59.194",25,6,372,6,372,0,0,1942.610178,8.986508000000185,331.1631169749071,0
"147.32.84.165",2642,"46.148.34.36",6667,2,124,2,124,0,0,1950.402753,8.999999863590347e-06,0,0
"147.32.84.165",2633,"212.117.174.7",4506,6,372,6,372,0,0,1951.204138,9.029485999999906,329.58686684934565,0
"147.32.84.165",2632,"217.163.21.38",80,21,6659,14,1570,7,5089,1951.20427,0.1872600000001512,67072.51949156178,217408.95012264836
"147.32.84.165",2638,"174.133.57.141",80,16,3429,12,1428,4,2001,1951.250246,0.4756539999998495,24017.4580682673,33654.715402382964
"147.32.84.165",2480,"207.115.11.16",25,6,372,6,372,0,0,1951.306742,9.026667999999972,329.68975927773226,0
"147.32.84.165",2653,"217.163.21.38",80,15,2336,10,1450,5,886,1951.407886,0.13980900000001384,82970.33810411957,50697.73762775857
"147.32.84.165",2481,"209.85.225.27",25,6,372,6,372,0,0,1951.453823,8.979996000000028,331.4032656584692,0
"147.32.84.165",2654,"195.113.232.96",80,13,1747,10,1128,3,619,1951.453885,5.985970000000179,1507.5250961831966,827.2677611147152
"147.32.84.165",2482,"66.94.237.64",25,6,372,6,372,0,0,1951.454725,8.979184000000032,331.4332349131045,0
"147.32.84.165",2483,"209.85.225.27",25,6,372,6,372,0,0,1951.454784,8.979151000000002,331.4344529900432,0
"147.32.84.165",2485,"208.68.169.20",25,6,372,6,372,0,0,1951.45484,8.979121999999961,331.4355234286841,0
"147.32.84.165",2655,"77.238.167.32",80,13,2615,10,1564,3,1051,1952.498835,0.1402259999999842,89227.39007032511,59960.349721171166
"147.32.84.165",2487,"205.188.190.2",25,6,372,6,372,0,0,1952.544578,8.991354000000001,330.98463257035587,0
"147.32.84.165",2657,"217.163.21.38",80,17,3694,12,1662,5,2032,1953.001313,0.25333599999999024,52483.65806675921,64167.74560268034
"147.32.84.165",2488,"206.46.232.11",25,6,372,6,372,0,0,1953.04729,8.988297999999986,331.09716656034374,0
"147.32.84.165",2676,"212.117.174.7",4506,6,372,6,372,0,0,1960.133522,9.80642899999998,303.47438399849796,0
"147.32.84.165",2489,"205.178.149.7",25,6,372,6,372,0,0,1960.333564,9.612791000000016,309.58750689575953,0
"147.32.84.165",2670,"212.117.171.138",65500,343,333128,256,326548,87,6580,1960.333628,77.38033499999983,33760.308739940265,680.2761967882423
"147.32.84.165",2490,"64.12.90.98",25,6,372,6,372,0,0,1960.333687,9.61584599999992,309.4891494726543,0
"147.32.84.165",2671,"93.116.154.250",6667,2,124,2,124,0,0,1961.835422,9.999999974752427e-06,0,0
"147.32.84.165",2687,"173.192.170.88",80,11,1283,8,846,3,437,1963.637894,11.309594999999945,598.4299172516817,309.1180541831973
"147.32.84.165",2683,"174.133.57.141",80,17,3489,12,1428,5,2061,1963.838076,0.6666459999999006,17136.531232470763,24732.766715771875
"147.32.84.165",2491,"66.175.58.43",25,6,372,6,372,0,0,1963.838776,9.431176999999934,315.5491621035233,0
"147.32.84.165",2681,"65.55.16.187",443,228,172939,148,10888,80,162051,1964.00525,9.447119000000157,9220.165428211347,137227.8680939637
"147.32.84.165",2496,"209.85.225.27",25,6,372,6,372,0,0,1964.171359,9.101795000000038,326.9684716036768,0
"147.32.84.165",2695,"61.17.216.23",6667,2,124,2,124,0,0,1972.350313,0.6148200000000088,1613.4803682378351,0
"147.32.84.165",2497,"209.85.225.27",25,6,372,6,372,0,0,1972.450854,9.012497000000167,330.2081542995182,0
"147.32.84.165",2498,"64.141.104.249",25,6,372,6,372,0,0,1972.45098,9.012508000000025,330.2077512718981,0
"147.32.84.165",2499,"207.115.11.16",25,6,372,6,372,0,0,1973.552242,9.012826000000132,330.1961005349439,0
"147.32.84.165",2500,"24.113.32.85",25,6,372,6,372,0,0,1974.052933,9.013206999999966,330.182142715685,0
"147.32.84.165",2711,"174.133.57.141",80,16,3429,12,1428,4,2001,1975.254932,0.48730000000000473,23443.46398522448,32850.400164169594
"147.32.84.165",2501,"219.94.133.86",25,6,372,6,372,0,0,1975.411775,8.956541000000016,332.2711301159672,0
"147.32.84.165",2715,"61.17.216.93",6667,2,124,2,124,0,0,1981.162977,1.1000000085914508e-05,0,0
"147.32.84.165",2717,"212.117.174.7",4506,6,372,6,372,0,0,1981.363211,9.013234999999895,330.18111699074024,0
"147.32.84.165",2503,"205.188.59.194",25,6,372,6,372,0,0,1981.36336,9.013210999999956,330.18199618315987,0
"147.32.84.165",2504,"66.94.237.64",25,6,372,6,372,0,0,1984.868302,8.91291000000001,333.89768324823166,0
"147.32.84.165",2505,"74.208.5.21",25,6,372,6,372,0,0,1984.868445,8.912890999999945,333.89839503254535,0
"147.32.84.165",2506,"216.32.180.22",25,6,372,6,372,0,0,1985.169168,8.912408000000141,333.91649035815607,0
"147.32.84.165",2735,"212.117.174.7",4506,6,372,6,372,0,0,1993.380885,9.01268899999991,330.201119776798,0
"147.32.84.165",2736,"58.252.109.240",6667,6,372,6,372,0,0,1993.381017,9.012689000000137,330.2011197767897,0
"147.32.84.165",2731,"174.133.57.141",80,16,3429,12,1428,4,2001,1994.482232,0.5030739999999696,22708.388825502192,31820.368375231013
"147.32.84.165",2508,"195.50.106.142",25,6,372,6,372,0,0,1994.649179,8.946333000000095,332.6502601680452,0
"147.32.84.165",2509,"209.85.225.27",25,6,372,6,372,0,0,1994.98277,9.01308199999994,330.1867219226475,0
"147.32.84.165",2511,"205.188.146.193",25,6,372,6,372,0,0,1995.086664,9.00926000000004,330.32679709543146,0
"147.32.84.165",2752,"27.251.19.95",6667,4,248,4,248,0,0,1996.284875,3.0042469999998502,660.398429290301,0
"147.32.84.165",2512,"193.252.22.143",25,6,372,6,372,0,0,2002.293597,9.012802999999849,330.1969431707372,0
"147.32.84.165",2754,"173.192.170.88",80,29,5698,20,1650,9,4048,2002.293783,41.691092000000026,316.61439810691434,776.7606566889632
"147.32.84.165",2765,"174.133.57.141",80,16,3429,12,1428,4,2001,2005.498732,0.46797700000001896,24411.45611856894,34206.80930900312
"147.32.84.165",2513,"12.42.129.211",25,6,372,6,372,0,0,2005.654592,8.956438999999818,332.27491417069444,0
"147.32.84.165",2514,"207.115.36.22",25,6,372,6,372,0,0,2005.798361,9.013180999999804,330.18309518027706,0
"147.32.84.165",2515,"209.85.225.27",25,6,372,6,372,0,0,2005.798499,9.01318399999991,330.1829852802328,0
"147.32.84.165",2516,"209.85.225.27",25,6,372,6,372,0,0,2005.798557,9.013226000000031,330.18144668734476,0
"147.32.84.165",2517,"64.12.90.97",25,6,372,6,372,0,0,2005.798615,9.013243999999986,330.18078729478583,0
"147.32.84.165",2518,"64.18.4.10",25,6,372,6,372,0,0,2006.099192,9.013065000000097,330.18734470460026,0
"147.32.84.165",2768,"27.255.59.70",6667,9,552,6,372,3,180,2014.410778,1.3619000000001051,2185.182465672788,1057.3463543578007
"147.32.84.165",2770,"212.117.174.7",4506,6,372,6,372,0,0,2014.911937,9.012506999999914,330.20778791073656,0
"147.32.84.165",2519,"209.85.225.27",25,6,372,6,372,0,0,2015.612811,9.012689000000137,330.2011197767897,0
"147.32.84.165",2522,"66.94.237.64",25,6,372,6,372,0,0,2015.612923,9.012721000000056,330.1999473854768,0
"147.32.84.165",2523,"205.188.159.42",25,6,372,6,372,0,0,2015.773018,8.952570999999807,332.4184750950385,0
"147.32.84.165",2784,"174.133.57.141",80,17,3489,12,1428,5,2061,2016.013112,5.076891999999816,2250.195592106433,3247.656243229243
"147.32.84.165",2524,"209.85.225.27",25,6,372,6,372,0,0,2016.113273,9.013022999999976,330.18888335245657,0
"147.32.84.165",2525,"64.12.90.65",25,6,372,6,372,0,0,2016.167284,8.959135999999944,332.1748882928017,0
"147.32.84.165",2791,"208.73.210.29",80,69,38523,42,6538,27,31985,2023.323567,14.932385000000068,3502.7224385119835,17135.90963533279
"147.32.84.165",2795,"212.117.174.7",4506,6,372,6,372,0,0,2023.507927,9.465422999999873,314.40750191513257,0
"147.32.84.165",2785,"111.88.79.41",6667,6,372,6,372,0,0,2023.507996,9.468537999999853,314.3040667946885,0
"147.32.84.165",2526,"195.228.66.7",25,6,372,6,372,0,0,2026.628774,9.787755999999945,304.0533499200447,0
"147.32.84.165",2803,"74.125.232.217",80,13,2944,10,2070,3,874,2026.829051,11.427136000000019,1449.1820172613657,611.8768517325766
"147.32.84.165",2529,"64.12.90.97",25,6,372,6,372,0,0,2026.829232,9.59373299999993,310.2025040721919,0
"147.32.84.165",2794,"212.117.171.138",65500,24,1476,18,1092,6,384,2026.837252,43.57772099999988,200.46940958661017,70.49473743704974
"147.32.84.165",2533,"205.236.148.151",25,6,372,6,372,0,0,2026.837316,9.58885199999986,310.36040602149694,0
"147.32.84.165",2811,"67.214.158.5",80,15,2575,10,1720,5,855,2027.129137,0.31513700000004974,43663.54950385968,21704.845828953505
"147.32.84.165",2809,"91.214.134.197",6667,9,552,6,372,3,180,2027.232706,1.0494590000000699,2835.7467990648533,1372.1355479346064
"147.32.84.165",2534,"209.85.225.27",25,6,372,6,372,0,0,2028.282433,9.359698999999864,317.95894291045505,0
"147.32.84.165",2812,"195.113.232.88",80,13,2140,10,1552,3,588,2028.282497,9.973895999999968,1244.8495552791046,471.6311459433721
"147.32.84.165",2810,"65.55.16.187",443,229,172384,150,11796,79,160588,2028.283398,9.577653999999939,9852.934758344853,134135.5617983285
"147.32.84.165",2535,"74.63.154.242",25,6,372,6,372,0,0,2028.449294,9.205627999999933,323.2804975391165,0
"147.32.84.165",2813,"50.22.198.84",80,13,3369,10,2336,3,1033,2035.942385,1.8302639999999428,10210.548860711124,4515.195622052479
"147.32.84.165",2823,"118.136.111.104",6667,2,124,2,124,0,0,2036.550266,0.7374730000001364,1345.133991345875,0
"147.32.84.165",2817,"174.133.57.141",80,16,3429,12,1428,4,2001,2036.642947,1.3507649999999103,8457.429678738166,11851.0621758789
"147.32.84.165",2536,"66.94.237.64",25,6,372,6,372,0,0,2036.743539,9.012985999999955,330.19023883982675,0
"147.32.84.165",2814,"67.214.158.5",80,15,2660,10,1764,5,896,2037.143578,0.8304689999999937,16992.80767855285,8631.267392280814
"147.32.84.165",2537,"207.115.36.22",25,6,372,6,372,0,0,2037.143724,9.01296699999989,330.19093490523557,0
"147.32.84.165",2816,"31.192.109.167",80,15,1540,10,1050,5,490,2037.499486,0.3917370000001483,21442.9579028706,10006.713688006279
"147.32.84.165",2543,"209.85.225.27",25,6,372,6,372,0,0,2037.734423,8.9227649999998,333.52890051459013,0
"147.32.84.165",2832,"50.22.198.84",80,10,2442,8,2320,2,122,2037.739245,0.40968199999997523,45303.43046558336,2382.335567586711
"147.32.84.165",2545,"64.12.90.65",25,6,372,6,372,0,0,2037.739331,8.917985000000044,333.70767051076956,0
"147.32.84.165",2846,"173.192.170.88",80,17,1641,12,1084,5,557,2044.454199,71.60648699999979,121.1063461331377,62.22899888944438
"147.32.84.165",2841,"202.95.138.19",6667,9,552,6,372,3,180,2044.655275,1.662934999999834,1789.6069299162607,865.9388370562552
"147.32.84.165",2839,"212.117.174.7",4506,6,372,6,372,0,0,2046.318485,8.95112899999981,332.4720267130619,0
"147.32.84.165",2546,"216.163.188.54",25,6,372,6,372,0,0,2047.659177,9.012755000000197,330.1987017288204,0
"147.32.84.165",2852,"174.133.57.141",80,17,4638,12,1428,5,3210,2047.859194,224.53649100000007,50.878144345811464,114.36893792020643
"147.32.84.165",2548,"64.12.90.98",25,6,372,6,372,0,0,2047.859428,9.012641999999914,330.20284174163675,0
"147.32.84.165",2844,"212.117.171.138",65500,43,14818,30,10710,13,4108,2048.022714,23.012841999999637,3723.138584969269,1428.0722042066998
"147.32.84.165",2549,"205.188.156.193",25,6,372,6,372,0,0,2048.022778,8.94944200000009,332.53469881138625,0
"147.32.84.165",2853,"64.12.90.34",25,6,372,6,372,0,0,2049.461194,9.012880000000223,330.19412218956944,0
"147.32.84.165",2550,"216.32.181.178",25,6,372,6,372,0,0,2049.761557,9.01707400000032,330.04054308525076,0
"147.32.84.165",2857,"212.117.174.7",4506,6,372,6,372,0,0,2057.773237,8.913076000000274,333.8914646301578,0
"147.32.84.165",2856,"117.204.73.246",6667,6,372,6,372,0,0,2057.773371,8.913048999999774,333.89247607637697,0
"147.32.84.165",2551,"66.94.237.64",25,6,372,6,372,0,0,2058.173695,8.912994000000253,333.8945364486855,0
"147.32.84.165",2552,"212.182.100.195",25,6,372,6,372,0,0,2058.678343,8.909458000000086,334.0270530485661,0
"147.32.84.165",2553,"209.85.225.27",25,6,372,6,372,0,0,2058.678483,8.909376000000066,334.03012736245256,0
"147.32.84.165",2873,"213.111.249.148",6667,6,372,6,372,0,0,2067.186802,9.013001999999688,330.18965268177055,0
"147.32.84.165",2554,"67.231.144.94",25,6,372,6,372,0,0,2068.589115,9.012561000000005,330.2058094253119,0
"147.32.84.165",2556,"209.85.225.27",25,6,372,6,372,0,0,2068.789242,9.012650000000122,330.2025486399627,0
"147.32.84.165",2882,"212.117.171.138",65500,74,7110,50,4634,24,2476,2068.78938,133.60726999999997,277.46993108982775,148.25540556288595
"147.32.84.165",2557,"207.115.36.22",25,6,372,6,372,0,0,2068.789437,9.01258000000007,330.2051132971887,0
"147.32.84.165",2887,"65.55.196.251",443,30,12875,20,7824,10,5051,2068.88929,2.224804999999833,28133.70160531134,18162.490645248923
"147.32.84.165",2558,"205.188.190.2",25,6,372,6,372,0,0,2068.989821,9.012394999999742,330.21189151164424,0
"147.32.84.165",2889,"61.17.216.14",6667,4,248,4,248,0,0,2070.391834,3.0037600000000566,660.5054997736046,0
"147.32.84.165",2560,"64.12.90.98",25,6,372,6,372,0,0,2070.691927,9.013162000000193,330.1837912155508,0
"147.32.84.165",2893,"212.117.174.7",4506,6,372,6,372,0,0,2078.703202,9.013302999999723,330.1786259709777,0
"147.32.84.165",2561,"209.85.225.27",25,6,372,6,372,0,0,2079.105469,9.011662999999771,330.2387139865389,0
"147.32.84.165",2562,"216.200.145.235",25,6,372,6,372,0,0,2079.105611,9.011647000000266,330.23930031878876,0
"147.32.84.165",2904,"61.177.181.139",6667,4,248,4,248,0,0,2079.604762,3.0043500000001586,660.3757884400603,0
"147.32.84.165",2563,"207.115.37.23",25,6,372,6,372,0,0,2079.604903,9.012622000000192,330.2035744980691,0
"147.32.84.165",2912,"212.117.174.7",4506,6,372,6,372,0,0,2088.217253,9.016035000000102,330.0785766692306,0
"147.32.84.165",2919,"174.133.57.141",80,16,3429,12,1428,4,2001,2088.217392,0.48188699999991513,23706.802632156527,33219.40620934538
"147.32.84.165",2564,"66.94.237.64",25,6,372,6,372,0,0,2088.217451,9.015960000000177,330.08132245484023,0
"147.32.84.165",2565,"209.85.225.27",25,6,372,6,372,0,0,2088.217518,9.015941000000112,330.08201806111674,0
"147.32.84.165",2922,"117.96.96.152",6667,4,248,4,248,0,0,2089.619137,2.9993509999999333,661.476432734963,0
"147.32.84.165",2566,"207.115.20.21",25,6,372,6,372,0,0,2089.819255,9.019162999999935,329.96409977289704,0
"147.32.84.165",2924,"98.126.71.122",80,18,4863,14,1430,4,3433,2090.019845,16.95512800000006,674.7221253652559,1619.8049345307156
"147.32.84.165",2567,"76.96.62.116",25,6,372,6,372,0,0,2090.194923,8.944266999999854,332.7270977040431,0
"147.32.84.165",2927,"195.113.232.88",80,17,5707,12,2574,5,3133,2091.715395,18.376350000000002,1120.5707335787574,1363.9270040024269
"147.32.84.165",2568,"205.188.156.193",25,6,372,6,372,0,0,2091.716258,9.029951999999867,329.569858178653,0
"147.32.84.165",2570,"71.254.168.5",25,6,372,6,372,0,0,2096.630823,9.03275399999984,329.46762415981357,0
"147.32.84.165",2942,"212.42.113.170",6667,4,248,4,248,0,0,2099.742245,3.0099530000002233,659.1465049453772,0
"147.32.84.165",2941,"174.133.57.141",80,16,3429,12,1428,4,2001,2100.142871,0.5396900000000642,21167.70738757183,29661.472326702544
"147.32.84.165",2571,"209.85.225.27",25,6,372,6,372,0,0,2100.142971,8.931538999999702,333.2012545654337,0
"147.32.84.165",2572,"66.94.237.64",25,6,372,6,372,0,0,2100.143,8.931533999999829,333.20144109623914,0
"147.32.84.165",2575,"198.103.111.124",25,6,372,6,372,0,0,2100.143027,8.931529999999839,333.20159032103726,0
"147.32.84.165",2576,"205.188.103.1",25,6,372,6,372,0,0,2100.644834,8.93149799999992,333.2027841242339,0
"147.32.84.165",2950,"212.117.174.7",4506,6,372,6,372,0,0,2106.165459,8.932475999999951,333.1663023779763,0
"147.32.84.165",2577,"205.188.159.42",25,6,372,6,372,0,0,2109.175344,9.026729999999588,329.68749480710466,0
"147.32.84.165",2578,"121.189.61.157",25,6,372,6,372,0,0,2109.175481,9.02673199999981,329.6874217601744,0
"147.32.84.165",2958,"119.154.130.96",6667,4,248,4,248,0,0,2110.791576,3.004319000000123,660.3826025132214,0
"147.32.84.165",2959,"174.133.57.141",80,16,3429,12,1428,4,2001,2111.091924,0.4871000000002823,23453.08971462406,32863.88831860136
"147.32.84.165",2579,"205.188.59.193",25,6,372,6,372,0,0,2111.092057,9.012918000000354,330.1927300348104,0
"147.32.84.165",2580,"209.85.225.27",25,6,372,6,372,0,0,2112.697482,9.009827999999743,330.3059725446573,0
"147.32.84.165",2967,"173.192.170.88",80,17,1643,12,1086,5,557,2117.40144,47.49173100000007,182.93710962019867,93.82686009065438
"147.32.84.165",2965,"212.117.174.7",4506,6,372,6,372,0,0,2117.601558,9.012716000000182,330.20013057106644,0
"147.32.84.165",2581,"77.238.184.241",25,6,372,6,372,0,0,2117.601692,9.012704999999642,330.2005335801092,0
"147.32.84.165",2582,"66.94.237.64",25,6,372,6,372,0,0,2117.602096,9.012350999999853,330.213503668471,0
"147.32.84.165",2972,"178.137.128.94",6667,4,248,4,248,0,0,2121.106459,3.004251999999724,660.3973301840799,0
"147.32.84.165",2977,"174.123.157.154",80,14,1948,10,1308,4,640,2121.607221,0.46412999999984095,22545.407536689258,11031.392066881595
"147.32.84.165",2584,"74.6.140.64",25,6,372,6,372,0,0,2121.759625,8.960491999999704,332.1246199427552,0
"147.32.84.165",2979,"174.133.57.141",80,17,3489,12,1428,5,2061,2127.11772,6.685806999999841,1708.6942533639203,2466.1196471870026
"147.32.84.165",2585,"205.188.159.42",25,6,372,6,372,0,0,2127.11785,9.010344999999688,330.2870200863677,0
"147.32.84.165",2586,"65.54.188.94",25,6,372,6,372,0,0,2127.117909,9.010421999999835,330.2841975658914,0
"147.32.84.165",2587,"66.39.2.5",25,6,372,6,372,0,0,2128.216673,9.013378999999986,330.17584193452916,0
"147.32.84.165",2993,"111.88.31.68",6667,4,248,4,248,0,0,2130.219871,3.0038680000002387,660.4817521941185,0
"147.32.84.165",2588,"209.85.225.27",25,6,372,6,372,0,0,2130.220009,9.013228999999683,330.1813367884145,0
"147.32.84.165",2589,"66.180.96.27",25,6,372,6,372,0,0,2130.220067,9.013292999999976,330.17899229504775,0
"147.32.84.165",2591,"66.94.237.64",25,6,372,6,372,0,0,2132.122735,9.012474999999995,330.20896035772654,0
"147.32.84.165",2592,"74.6.140.64",25,6,372,6,372,0,0,2132.122865,9.012406000000283,330.2114884748764,0
"147.32.84.165",2593,"64.12.90.97",25,6,372,6,372,0,0,2132.122923,9.012377000000015,330.21255102843514,0
"147.32.84.165",2999,"212.117.174.7",4506,6,372,6,372,0,0,2133.724581,9.012928999999986,330.1923270448491,0
"147.32.84.165",2594,"209.85.225.27",25,6,372,6,372,0,0,2137.830754,9.01277600000003,330.1979323573547,0
"147.32.84.165",2595,"74.125.67.27",25,6,372,6,372,0,0,2138.632883,9.011683999999605,330.237944428603,0
"147.32.84.165",2596,"209.85.225.27",25,6,372,6,372,0,0,2138.633021,9.011743000000024,330.2357823564201,0
"147.32.84.165",2599,"66.94.237.64",25,6,372,6,372,0,0,2138.633078,9.01175000000012,330.2355258412584,0
"147.32.84.165",3010,"173.192.170.88",80,16,2023,12,1494,4,529,2142.737654,13.929361999999855,858.0436060172838,303.81865300076515
"147.32.84.165",3014,"117.197.22.127",6667,4,248,4,248,0,0,2142.73773,3.0040090000002238,660.4507509797248,0
"147.32.84.165",3023,"174.133.57.141",80,16,3429,12,1428,4,2001,2148.045064,0.4856039999999666,23525.341636396704,32965.13208293404
"147.32.84.165",2600,"66.94.237.64",25,6,372,6,372,0,0,2148.045214,9.022029999999631,329.85924453810526,0
"147.32.84.165",3021,"174.36.246.56",80,28,14171,22,2068,6,12103,2148.045288,0.46367099999997663,35680.47171378161,208820.47831329732
"147.32.84.165",3022,"212.117.174.7",4506,6,372,6,372,0,0,2148.145198,9.022972999999638,329.82477061608404,0
"147.32.84.165",2601,"64.71.138.87",25,6,372,6,372,0,0,2148.145286,9.022981999999956,329.82444163138246,0
"147.32.84.165",2602,"209.85.225.27",25,6,372,6,372,0,0,2148.166386,9.001908000000185,330.59658019165926,0
"147.32.84.165",2603,"65.55.92.152",25,6,372,6,372,0,0,2148.166433,9.001890000000003,330.5972412460049,0
"147.32.84.165",3031,"195.113.232.97",80,7,426,6,364,1,62,2149.240058,0.0011130000002594898,0,0
"147.32.84.165",3036,"67.195.168.31",25,6,372,6,372,0,0,2149.241013,9.030285000000276,329.5577049893673,0
"147.32.84.165",2604,"205.188.156.193",25,6,372,6,372,0,0,2151.247149,9.037675000000036,329.2882295501872,0
"147.32.84.165",3032,"195.113.232.97",80,13,1479,10,1122,3,357,2153.153235,5.610085999999683,1599.9754727468542,509.0831049649081
"147.32.84.165",3039,"211.157.110.34",6667,4,248,4,248,0,0,2153.154213,3.010359000000335,659.0576074148562,0
"147.32.84.165",3046,"67.195.168.31",25,6,372,6,372,0,0,2154.760417,8.929347000000234,333.283049701162,0
"147.32.84.165",2605,"66.94.237.139",25,6,372,6,372,0,0,2154.760559,8.929329000000052,333.2837215427926,0
"147.32.84.165",3033,"195.113.232.97",80,13,1541,10,1204,3,337,2156.665911,2.097527999999784,4592.072191647021,1285.3225320473805
"147.32.84.165",2606,"209.85.225.27",25,6,372,6,372,0,0,2156.666044,8.926375000000007,333.39401492767195,0
"147.32.84.165",3034,"95.172.94.27",80,13,2062,10,1486,3,576,2156.666108,0.07366400000000795,161381.40747174626,62554.30060816006
"147.32.84.165",2607,"216.163.188.58",25,6,372,6,372,0,0,2156.691276,8.901310000000194,334.3328116872612,0
"147.32.84.165",3056,"31.192.109.167",80,15,1540,10,1050,5,490,2158.887661,0.2734009999999216,30724.101228607095,14337.91390668331
"147.32.84.165",3057,"174.133.57.141",80,17,3489,12,1428,5,2061,2158.965673,9.937130999999681,1149.6275937189885,1659.2314220271958
"147.32.84.165",2609,"98.137.54.237",25,6,372,6,372,0,0,2158.965736,8.829878999999892,337.03746110224574,0
"147.32.84.165",3059,"220.194.21.2",6667,4,248,4,248,0,0,2159.684368,2.903762999999799,683.251353502382,0
"147.32.84.165",2611,"96.53.9.174",25,6,372,6,372,0,0,2159.684443,8.912710999999945,333.90513840289657,0
"147.32.84.165",3065,"173.192.170.88",80,17,1643,12,1086,5,557,2167.695733,54.702894000000015,158.82157898264026,81.45821316144624
"147.32.84.165",3060,"212.117.174.7",4506,6,372,6,372,0,0,2167.896582,9.012850000000071,330.19522126741003,0
"147.32.84.165",2612,"77.238.184.241",25,6,372,6,372,0,0,2169.097516,9.012958000000253,330.1912646214391,0
"147.32.84.165",3069,"212.117.171.138",65500,68,6752,44,4274,24,2478,2169.097676,171.14821100000017,199.78006080355678,115.82943160299806
"147.32.84.165",2613,"64.12.90.97",25,6,372,6,372,0,0,2169.09778,9.012834999999995,330.19577080907413,0
"147.32.84.165",3074,"205.188.186.137",587,44,5499,28,3726,16,1773,2170.199353,32.29162300000007,923.0876998656876,439.2470455882619
"147.32.84.165",3078,"65.54.188.72",25,6,372,6,372,0,0,2170.316637,8.995464999999967,330.8333699258472,0
"147.32.84.165",2614,"194.2.0.80",25,6,372,6,372,0,0,2172.201993,9.012898999999834,330.19342611073915,0
"147.32.84.165",3086,"212.117.174.7",4506,6,372,6,372,0,0,2175.707042,9.01310999999987,330.18569616925157,0
"147.32.84.165",3077,"61.167.116.133",6667,15,1818,10,1260,5,558,2175.707118,1.9370330000001559,5203.834937246391,2304.555472209116
"147.32.84.165",2615,"64.12.90.98",25,6,372,6,372,0,0,2176.155891,8.970122000000174,331.7680629092829,0
"147.32.84.165",2616,"209.85.225.27",25,6,372,6,372,0,0,2177.610109,9.013271999999688,330.1797615782707,0
"147.32.84.165",2617,"66.94.237.64",25,6,372,6,372,0,0,2177.911163,9.012238999999681,330.2176074114441,0
"147.32.84.165",3091,"174.133.57.141",80,16,3429,12,1428,4,2001,2179.812921,0.46237199999995937,24707.378474477267,34621.47361864777
"147.32.84.165",2618,"209.85.225.27",25,6,372,6,372,0,0,2179.813053,9.012962000000243,330.1911180808173,0
"147.32.84.165",2619,"96.53.9.174",25,6,372,6,372,0,0,2179.813108,9.013003000000026,330.1896160469481,0
"147.32.84.165",2620,"207.115.36.22",25,6,372,6,372,0,0,2179.813165,9.012971000000107,330.1907883648982,0
"147.32.84.165",3094,"203.84.189.77",6667,9,552,6,372,3,180,2180.614212,1.993970999999874,1492.499138653565,722.1770025743057
"147.32.84.165",3096,"65.54.188.72",25,6,372,6,372,0,0,2182.608457,8.921226000000388,333.58643755912817,0
"147.32.84.165",2621,"209.85.225.27",25,6,372,6,372,0,0,2182.608535,8.92127500000015,333.5846053394778,0
"147.32.84.165",2624,"88.47.188.76",25,6,372,6,372,0,0,2182.608601,8.921264000000065,333.5850166523464,0
"147.32.84.165",3105,"183.83.108.230",6667,4,248,4,248,0,0,2188.92638,3.0045939999999973,660.3221599989888,0
"147.32.84.165",3111,"174.133.57.141",80,17,3489,12,1428,5,2061,2190.127803,0.881434000000354,12960.698135079214,18705.88155209962
"147.32.84.165",2626,"205.188.156.193",25,6,372,6,372,0,0,2190.1279,9.012851999999839,330.1951479953352,0
"147.32.84.165",2627,"74.6.140.64",25,6,372,6,372,0,0,2190.127932,9.012944000000061,330.1917775146478,0
"147.32.84.165",2629,"64.12.90.1",25,6,372,6,372,0,0,2191.329624,9.013410999999905,330.17466972270887,0
"147.32.84.165",3116,"173.192.170.88",80,18,2258,14,1730,4,528,2193.232171,18.74154099999987,738.46649002876,225.3816801937487
"147.32.84.165",2630,"66.94.237.64",25,6,372,6,372,0,0,2193.232306,9.013003000000026,330.1896160469481,0
"147.32.84.165",2634,"209.85.225.27",25,6,372,6,372,0,0,2193.232362,9.01308199999994,330.1867219226475,0
"147.32.84.165",2635,"209.85.225.27",25,6,372,6,372,0,0,2193.232417,9.013101000000006,330.18602587500106,0
"147.32.84.165",2636,"65.61.209.5",25,6,372,6,372,0,0,2193.23248,9.013108999999986,330.18573280318753,0
"147.32.84.165",3125,"98.154.67.160",6667,4,248,4,248,0,0,2197.138276,3.004106999999749,660.4292057507158,0
"147.32.84.165",3119,"212.117.174.7",4506,6,372,6,372,0,0,2198.640372,9.009082000000035,330.3333236394106,0
"147.32.84.165",3127,"68.67.179.213",80,16,2560,12,1528,4,1032,2198.940809,12.266921999999795,996.5009967455735,673.0294690061727
"147.32.84.165",2637,"207.115.36.22",25,6,372,6,372,0,0,2198.970204,8.980898999999681,331.3699441448017,0
"147.32.84.165",2639,"207.115.21.20",25,6,372,6,372,0,0,2198.970268,8.980993000000126,331.3664758451497,0
"147.32.84.165",3132,"68.67.179.212",80,16,2786,12,1904,4,882,2200.843144,10.364366000000246,1469.6509173836237,680.7941749644727
"147.32.84.165",2640,"66.94.237.64",25,6,372,6,372,0,0,2200.867131,8.989349999999831,331.05841912930924,0
"147.32.84.165",3138,"212.117.174.7",4506,6,372,6,372,0,0,2203.547113,9.026679999999942,329.68932099066535,0
"147.32.84.165",3137,"74.125.127.27",25,6,372,6,372,0,0,2203.547216,9.02671700000019,329.68796961286563,0
"147.32.84.165",3141,"74.125.127.27",25,6,372,6,372,0,0,2204.348474,9.026322000000164,329.70239705607065,0
"147.32.84.165",3135,"174.133.57.141",80,17,3489,12,1428,5,2061,2204.348586,3.407083000000057,3353.014881058022,4839.330301022817
"147.32.84.165",3136,"217.163.21.36",80,21,6763,14,1674,7,5089,2204.509373,0.1886540000000423,70987.09807370635,215802.4743710225
"147.32.84.165",2641,"74.125.43.27",25,6,372,6,372,0,0,2204.555355,9.019855000000007,329.93878504698773,0
"147.32.84.165",3147,"92.47.5.149",6667,9,552,6,372,3,180,2211.160971,1.3934300000000803,2135.736994323237,1033.4211262854374
"147.32.84.165",3144,"217.163.21.36",80,15,2440,10,1554,5,886,2211.161128,0.14343799999960538,86671.59330187399,49415.078291802034
"147.32.84.165",2643,"165.212.65.113",25,6,372,6,372,0,0,2211.20715,8.97751799999969,331.4947405285183,0
"147.32.84.165",2644,"72.4.117.21",25,6,372,6,372,0,0,2212.373829,8.912754999999834,333.90348999832884,0
"147.32.84.165",2645,"64.12.90.97",25,6,372,6,372,0,0,2212.554713,8.831763000000137,336.96556395364706,0
"147.32.84.165",2646,"65.55.92.136",25,6,372,6,372,0,0,2212.974327,8.912823000000117,333.9009424959927,0
"147.32.84.165",2647,"209.85.225.27",25,6,372,6,372,0,0,2214.27628,8.912884999999733,333.89861980717683,0
"147.32.84.165",3161,"196.218.117.248",6667,2,124,2,124,0,0,2219.683925,9.000000318337698e-06,0,0
"147.32.84.165",3163,"174.133.57.141",80,17,3489,12,1428,5,2061,2219.984325,1.041349000000082,10970.38552876999,15833.308525766772
"147.32.84.165",2648,"64.12.90.1",25,6,372,6,372,0,0,2220.143233,8.854223000000275,336.1108027209059,0
"147.32.84.165",2649,"98.137.54.237",25,6,372,6,372,0,0,2221.78695,9.013132000000041,330.1848902246174,0
"147.32.84.165",3168,"173.192.170.88",80,11,1283,8,846,3,437,2224.491359,28.955255999999736,233.73994690290638,120.73801039783699
"147.32.84.165",3173,"212.117.174.7",4506,6,372,6,372,0,0,2224.692415,9.011716999999862,330.2367351305024,0
"147.32.84.165",3172,"64.12.90.1",25,6,372,6,372,0,0,2225.492212,9.013198999999986,330.1824357811255,0
"147.32.84.165",3175,"64.12.90.1",25,6,372,6,372,0,0,2225.492342,9.013192999999774,330.1826555805556,0
"147.32.84.165",2650,"209.85.225.27",25,6,372,6,372,0,0,2225.492399,9.0131879999999,330.18283874695976,0
"147.32.84.165",2651,"74.6.140.64",25,6,372,6,372,0,0,2225.492458,9.013181999999688,330.18305854692636,0
"147.32.84.165",3180,"212.117.174.7",4506,6,372,6,372,0,0,2232.101897,9.012968999999885,330.1908616350548,0
"147.32.84.165",3176,"183.83.70.111",6667,2,124,2,124,0,0,2232.102036,5.999999757477781e-06,0,0
"147.32.84.165",3187,"147.32.84.171",139,33,4810,22,3278,11,1532,2233.303511,0.017479000000093947,1500314.663302194,701184.2782730205
"147.32.84.165",3186,"174.133.57.141",80,17,3489,12,1428,5,2061,2233.303816,4.700804000000062,2430.2225746914464,3507.485102548369
"147.32.84.165",2652,"209.191.88.254",25,6,372,6,372,0,0,2233.403844,9.013261000000057,330.180164537561,0
"147.32.84.165",2656,"98.137.34.115",25,6,372,6,372,0,0,2233.463018,8.954176000000189,332.3588904216242,0
"147.32.84.165",2658,"66.94.237.64",25,6,372,6,372,0,0,2233.904389,9.013147000000117,330.1843407191696,0
"147.32.84.165",2659,"205.188.156.193",25,6,372,6,372,0,0,2234.004985,9.01283199999989,330.1958807176298,0
"147.32.84.165",2662,"64.136.52.37",25,6,372,6,372,0,0,2235.206797,9.013081000000057,330.18675855681107,0
"147.32.84.165",3197,"222.23.80.7",6667,2,124,2,124,0,0,2241.015088,8.999999863590347e-06,0,0
"147.32.84.165",2664,"209.85.225.27",25,6,372,6,372,0,0,2242.817727,9.01244799999995,330.2099496163547,0
"147.32.84.165",2665,"209.85.225.27",25,6,372,6,372,0,0,2244.219662,9.012541000000056,330.2065421949239,0
"147.32.84.165",2666,"207.115.21.20",25,6,372,6,372,0,0,2244.219806,9.012521000000106,330.2072749677881,0
"147.32.84.165",3209,"217.219.211.243",6667,4,248,4,248,0,0,2245.721405,3.004721000000245,660.2942502814199,0
"147.32.84.165",2667,"205.188.159.42",25,6,372,6,372,0,0,2246.524983,9.011906000000181,330.2298093211292,0
"147.32.84.165",3218,"212.117.174.7",4506,6,372,6,372,0,0,2254.43396,9.013202000000092,330.18232588152017,0
"147.32.84.165",3211,"217.72.192.149",25,6,372,6,372,0,0,2254.434102,9.01319199999989,330.18269221381684,0
"147.32.84.165",3212,"174.133.57.141",80,16,3441,12,1440,4,2001,2254.434167,0.4873219999999492,23639.40064269867,32848.91714308336
"147.32.84.165",2668,"206.67.236.192",25,6,372,6,372,0,0,2254.59552,8.951629000000139,332.4534562368429,0
"147.32.84.165",2672,"98.137.34.115",25,6,372,6,372,0,0,2254.934602,9.012911000000258,330.19298648349184,0
"147.32.84.165",2673,"66.94.237.64",25,6,372,6,372,0,0,2255.034669,9.012945999999829,330.19170424410135,0
"147.32.84.165",3226,"180.177.137.11",6667,9,552,6,372,3,180,2256.236697,1.944213000000218,1530.6964823296964,740.6595882240467
"147.32.84.165",3227,"217.72.192.149",25,6,372,6,372,0,0,2258.181182,8.971288000000186,331.72494295132856,0
"147.32.84.165",2674,"74.125.113.27",25,6,372,6,372,0,0,2258.181244,8.971360000000004,331.7222806798522,0
"147.32.84.165",3229,"212.117.174.7",4506,6,372,6,372,0,0,2263.847476,9.012970000000223,330.1908249999641,0
"147.32.84.165",3235,"202.44.45.5",6667,9,552,6,372,3,180,2263.847586,2.085132000000158,1427.2477713640071,690.6037603374227
"147.32.84.165",2675,"205.188.190.2",25,6,372,6,372,0,0,2264.047538,9.013178000000153,330.18320508037783,0
"147.32.84.165",3239,"174.133.57.141",80,16,3429,12,1428,4,2001,2265.249422,0.4948570000001382,23085.45701080678,32348.73913068933
"147.32.84.165",2677,"64.136.52.37",25,6,372,6,372,0,0,2265.413464,8.94923899999958,332.54224185991006,0
"147.32.84.165",2678,"209.85.225.27",25,6,372,6,372,0,0,2265.932929,8.930453999999827,333.24173664631803,0
"147.32.84.165",2679,"75.180.132.243",25,6,372,6,372,0,0,2267.552968,9.013052000000243,330.1878209512072,0
"147.32.84.165",3243,"84.247.61.206",6667,2,124,2,124,0,0,2275.464228,1.0000000202126103e-05,0,0
"147.32.84.165",2680,"205.188.159.42",25,6,372,6,372,0,0,2275.464376,9.013044000000264,330.1881140267276,0
"147.32.84.165",2682,"62.211.72.32",25,6,372,6,372,0,0,2275.564259,9.013389999999617,330.17543898578964,0
"147.32.84.165",3249,"174.133.57.141",80,17,3489,12,1428,5,2061,2275.964763,14.54570300000023,785.3865846153891,1133.5306378797738
"147.32.84.165",2684,"66.94.237.64",25,6,372,6,372,0,0,2276.064906,9.013067999999748,330.1872348017438,0
"147.32.84.165",2685,"206.46.232.11",25,6,372,6,372,0,0,2276.117122,8.960963999999876,332.10712597439755,0
"147.32.84.165",3258,"210.211.186.109",6667,4,248,4,248,0,0,2279.169561,3.004261999999926,660.3951319825131,0
"147.32.84.165",3260,"212.117.174.7",4506,6,372,6,372,0,0,2285.078125,8.913109000000077,333.89022842646426,0
"147.32.84.165",2686,"209.85.225.27",25,6,372,6,372,0,0,2286.379894,8.912812999999915,333.90131712625725,0
"147.32.84.165",3259,"31.192.109.167",80,15,1540,10,1050,5,490,2286.380028,0.2337240000001657,35939.82646195532,16771.919015579148
"147.32.84.165",2688,"205.188.156.193",25,6,372,6,372,0,0,2286.457008,8.835823000000346,336.81073059067427,0
"147.32.84.165",2689,"209.85.225.27",25,6,372,6,372,0,0,2286.880538,8.915238000000045,333.8104938981982,0
"147.32.84.165",2690,"209.191.88.254",25,6,372,6,372,0,0,2287.481688,9.012990000000173,330.19009230010715,0
"147.32.84.165",2691,"153.2.232.129",25,6,372,6,372,0,0,2288.583212,8.912628999999924,333.9082104730294,0
"147.32.84.165",3273,"212.117.174.7",4506,6,372,6,372,0,0,2296.394519,9.012724000000162,330.19983747421384,0
"147.32.84.165",3271,"89.37.108.104",6667,6,372,6,372,0,0,2296.394652,9.01272199999994,330.19991074838657,0
"147.32.84.165",2692,"205.188.146.193",25,6,372,6,372,0,0,2296.494812,9.012555000000248,330.2060292558457,0
"147.32.84.165",2693,"203.188.197.119",25,6,372,6,372,0,0,2296.995517,9.012704000000213,330.200570217321,0
"147.32.84.165",2694,"74.125.113.27",25,6,372,6,372,0,0,2296.995655,9.012690999999904,330.20104650209703,0
"147.32.84.165",3285,"173.192.170.88",80,41,5314,26,2006,15,3308,2297.696136,39.50801199999978,406.19609004877515,669.8388164912005
"147.32.84.165",2696,"195.50.106.142",25,6,372,6,372,0,0,2297.896927,9.012465000000248,330.20932674911006,0
"147.32.84.165",3287,"61.17.216.94",6667,7,426,6,364,1,62,2306.008412,0.1981860000000779,14693.267940212,2502.699484321824
"147.32.84.165",3289,"174.133.57.141",80,17,4638,12,1428,5,3210,2306.203554,223.70909299999994,51.066319418674695,114.79193650836538
"147.32.84.165",2697,"66.94.237.64",25,6,372,6,372,0,0,2306.364183,8.957352999999785,332.24100914634846,0
"147.32.84.165",2698,"66.94.237.64",25,6,372,6,372,0,0,2307.309934,9.012842000000092,330.1955143560677,0
"147.32.84.165",3293,"212.117.171.138",65500,339,332744,252,326692,87,6052,2307.310068,20.705948000000262,126221.50891135083,2338.2653139088047
"147.32.84.165",2699,"64.12.90.97",25,6,372,6,372,0,0,2307.310125,9.012773999999808,330.1980056306819,0
"147.32.84.165",3299,"205.188.186.167",587,44,5503,28,3730,16,1773,2307.811174,32.52895699999999,917.3365134332469,436.0422622834173
"147.32.84.165",2700,"209.85.225.27",25,6,372,6,372,0,0,2307.92882,8.995073999999931,330.8477506688686,0
"147.32.84.165",2701,"209.85.225.27",25,6,372,6,372,0,0,2308.512079,9.01278400000001,330.1976392644045,0
"147.32.84.165",2702,"205.188.146.193",25,6,372,6,372,0,0,2308.512278,9.012708999999631,330.20038703126016,0
"147.32.84.165",2703,"81.255.54.24",25,6,372,6,372,0,0,2308.512338,9.012698,330.20079004089564,0
"147.32.84.165",3301,"61.17.216.10",6667,4,248,4,248,0,0,2309.51341,3.0041909999999916,660.4107395302115,0
"147.32.84.165",3304,"208.73.210.29",80,72,39355,44,6646,28,32709,2317.424497,13.089798999999857,4061.7888785000123,19990.528502385932
"147.32.84.165",3306,"212.117.174.7",4506,6,372,6,372,0,0,2317.525092,9.710625000000164,306.4684301988749,0
"147.32.84.165",2704,"64.136.52.37",25,6,372,6,372,0,0,2317.604481,9.634438000000046,308.8919146088216,0
"147.32.84.165",2705,"67.231.144.128",25,6,372,6,372,0,0,2318.028322,9.64140099999986,308.6688335025214,0
"147.32.84.165",3313,"212.117.171.138",65500,92,53416,62,50544,30,2872,2318.028459,37.539858000000095,10771.271431021369,612.0428052764595
"147.32.84.165",2706,"205.188.156.193",25,6,372,6,372,0,0,2318.028515,9.644385000000057,308.57333049230016,0
"147.32.84.165",3320,"65.55.196.251",443,226,171334,148,10608,78,160726,2318.926648,9.170792999999776,9253.725386670714,140206.85016007136
"147.32.84.165",3321,"74.125.232.218",80,13,2936,10,2062,3,874,2319.027391,11.487122,1436.0429009111247,608.6816175539878
"147.32.84.165",2707,"64.136.52.37",25,6,372,6,372,0,0,2319.03578,9.004271999999673,330.5097846888797,0
"147.32.84.165",3323,"221.158.173.198",6667,4,248,4,248,0,0,2319.035848,3.8918570000000727,509.78234811812536,0
"147.32.84.165",3324,"67.214.158.5",80,15,2567,10,1712,5,855,2327.339169,0.9502900000002228,14412.442517543896,7197.802775993009
"147.32.84.165",2708,"209.85.225.27",25,6,372,6,372,0,0,2327.739878,9.012594000000263,330.2046003625497,0
"147.32.84.165",3331,"212.117.174.7",4506,6,372,6,372,0,0,2327.740003,9.012594000000263,330.2046003625497,0
"147.32.84.165",3325,"50.22.198.84",80,13,3349,10,2320,3,1029,2327.740058,0.6147800000003372,30189.66134225222,13390.155828093766
"147.32.84.165",2709,"205.188.59.194",25,6,372,6,372,0,0,2328.078021,8.974926000000323,331.5904777376318,0
"147.32.84.165",3326,"195.113.232.83",80,13,2132,10,1544,3,588,2328.108289,2.4064110000003893,5132.955259927752,1954.7782984698952
"147.32.84.165",2710,"209.85.225.27",25,6,372,6,372,0,0,2328.109154,8.943916999999601,332.74011822785616,0
"147.32.84.165",3327,"94.127.76.180",80,7,424,6,364,1,60,2328.109185,0.03291200000012395,88478.36655289964,14584.346135093347
"147.32.84.165",2712,"66.94.237.64",25,6,372,6,372,0,0,2328.123694,8.929431000000022,333.27991447607275,0
"147.32.84.165",3341,"67.214.158.5",80,15,2652,10,1756,5,896,2328.340037,0.3245320000000902,43286.9485905738,22087.190169222165
"147.32.84.165",2713,"173.236.81.226",3817,11,666,8,484,3,182,2328.443708,0.47712400000000343,8115.290783947092,3051.6176088396087
"147.32.84.165",3342,"50.22.198.84",80,14,3004,10,2424,4,580,2328.594655,0.37026300000025003,52373.58310170583,12531.632920375157
"147.32.84.165",2714,"209.85.143.27",25,6,372,6,372,0,0,2328.715605,8.937953000000107,332.96214468793517,0
"147.32.84.165",3344,"68.67.185.207",80,13,2050,10,1168,3,882,2328.940995,1.5738850000002458,5936.901361915604,4483.1738024054475
"147.32.84.165",2716,"207.115.11.16",25,6,372,6,372,0,0,2328.965058,8.989540999999917,331.05138515971254,0
"147.32.84.165",3346,"117.198.86.115",6667,9,552,6,372,3,180,2329.542292,1.6278809999998884,1828.1434576607282,884.5855440293847
"147.32.84.165",2718,"209.85.225.27",25,6,372,6,372,0,0,2331.170469,8.986687999999958,331.1564839015234,0
"147.32.84.165",3357,"173.192.170.88",80,17,1641,12,1084,5,557,2337.954463,57.51333999999997,150.7824097852777,77.47767735276724
"147.32.84.165",3352,"122.121.68.110",6667,4,248,4,248,0,0,2338.155184,3.003424999999879,660.5791721118655,0
"147.32.84.165",2719,"69.73.177.176",25,6,372,6,372,0,0,2338.554982,9.013171000000057,330.1834615142641,0
"147.32.84.165",2720,"205.188.146.193",25,6,372,6,372,0,0,2338.55506,9.013218000000052,330.1817397515497,0
"147.32.84.165",2721,"209.85.225.27",25,6,372,6,372,0,0,2339.055557,9.013328999999885,330.17767353216976,0
"147.32.84.165",2722,"168.95.6.57",25,6,372,6,372,0,0,2339.055633,9.013318000000254,330.1780764863634,0
"147.32.84.165",2723,"66.94.237.64",25,6,372,6,372,0,0,2339.055678,9.013336999999865,330.177380475183,0
"147.32.84.165",2724,"205.188.156.193",25,6,372,6,372,0,0,2339.055717,9.013350999999602,330.17686762671633,0
"147.32.84.165",3369,"209.236.119.101",6667,2,124,2,124,0,0,2349.070023,9.999999747378752e-06,0,0
"147.32.84.165",3367,"212.117.174.7",4506,6,372,6,372,0,0,2349.070166,9.012987000000066,330.1902022048826,0
"147.32.84.165",3360,"174.133.57.141",80,17,3489,12,1428,5,2061,2349.670821,1.1545149999997193,9895.064161143664,14281.321593919532
"147.32.84.165",2725,"207.115.21.20",25,6,372,6,372,0,0,2349.670955,9.013136000000031,330.1847436896536,0
"147.32.84.165",2726,"69.175.10.98",4190,14,850,10,608,4,242,2349.971203,1.2285980000001473,3958.9841429006206,1575.7798726676813
"147.32.84.165",2727,"209.85.143.27",25,6,372,6,372,0,0,2350.715622,8.969685000000027,331.7842265363824,0
"147.32.84.165",3376,"212.117.171.138",65500,46,8854,32,7112,14,1742,2352.174455,12.322611000000052,4617.203285894504,1130.9291512975572
"147.32.84.165",2728,"65.55.92.152",25,6,372,6,372,0,0,2352.174588,8.912823000000117,333.9009424959927,0
"147.32.84.165",3378,"65.54.234.75",443,61,33154,44,4776,17,28378,2352.975929,2.7482929999996486,13902.4478103335,82605.45727840118
"147.32.84.165",2729,"98.139.175.224",25,6,372,6,372,0,0,2353.14223,8.846567999999934,336.4016418570481,0
"147.32.84.165",3383,"212.117.174.7",4506,6,372,6,372,0,0,2359.58527,8.912628999999924,333.9082104730294,0
"147.32.84.165",3384,"61.17.216.90",6667,2,124,2,124,0,0,2359.585403,5.999999757477781e-06,0,0
"147.32.84.165",2730,"209.85.225.27",25,6,372,6,372,0,0,2359.585471,8.912555000000339,333.9109828775123,0
"147.32.84.165",2732,"209.85.225.27",25,6,372,6,372,0,0,2360.085993,9.012867999999798,330.194561819841,0
"147.32.84.165",3391,"212.117.171.138",65500,286,168189,192,13038,94,155151,2360.086126,26.76609099999996,3896.870857982219,46372.40454723112
"147.32.84.165",2733,"205.251.134.191",25,6,372,6,372,0,0,2360.086184,9.01283900000044,330.19562426443593,0
"147.32.84.165",2734,"205.188.146.193",25,6,372,6,372,0,0,2360.086251,9.012827000000016,330.19606389870734,0
"147.32.84.165",3396,"74.125.224.242",443,27,6008,18,2876,9,3132,2363.190184,1.4462119999998322,15909.147483220075,17325.260750154823
"147.32.84.165",3397,"174.133.57.141",80,16,3429,12,1428,4,2001,2363.353073,0.47040599999991173,24285.40452290605,34030.17818650911
"147.32.84.165",2737,"207.115.21.20",25,6,372,6,372,0,0,2363.353135,8.945576000000074,332.6784099760569,0
"147.32.84.165",2738,"205.188.156.193",25,6,372,6,372,0,0,2363.353203,8.94561799999974,332.6768480389042,0
"147.32.84.165",3400,"212.117.171.138",65500,56,17846,38,15798,18,2048,2369.99996,5.479702999999972,23064.023725373554,2989.943068082355
"147.32.84.165",3413,"98.126.71.122",80,18,4863,14,1430,4,3433,2370.000096,18.48036699999966,619.0353254348364,1486.1176728795756
"147.32.84.165",2739,"161.53.209.3",25,6,372,6,372,0,0,2370.175501,8.947170999999798,332.61910384858714,0
"147.32.84.165",3404,"205.188.186.137",587,68,24406,42,21964,26,2442,2370.591928,16.150440000000344,10879.703587022785,1209.6264869563668
"147.32.84.165",3417,"195.113.232.88",80,17,5888,12,2556,5,3332,2370.709566,17.8776670000002,1143.7734017531354,1491.022290548297
"147.32.84.165",2740,"209.85.225.27",25,6,372,6,372,0,0,2370.710417,9.013377000000219,330.17591519803597,0
"147.32.84.165",3405,"117.207.7.56",6667,3,184,2,124,1,60,2370.710496,0.21408100000007835,4633.7601188318295,2242.1419929831436
"147.32.84.165",3418,"195.113.232.99",80,36,23942,28,2586,8,21356,2371.595847,16.99157699999978,1217.5444339274848,10054.864242442136
"147.32.84.165",2741,"174.143.82.84",25,6,372,6,372,0,0,2371.597131,9.02758700000004,329.6561971654205,0
"147.32.84.165",3420,"195.113.232.81",80,13,3471,10,1616,3,1855,2372.39917,16.18845199999987,798.5939606825967,916.7028447191936
"147.32.84.165",2742,"65.54.188.110",25,6,372,6,372,0,0,2372.399992,9.025964999999815,329.71543762911347,0
"147.32.84.165",3422,"74.125.232.218",80,13,1871,10,1156,3,715,2373.114073,15.473735000000033,597.6579022453195,369.65865061021066
"147.32.84.165",2743,"205.188.156.193",25,6,372,6,372,0,0,2373.12222,9.005115999999816,330.478807824359,0
"147.32.84.165",3429,"212.117.171.138",65500,44,8514,30,6742,14,1772,2373.122252,150.59907299999986,358.1429747578861,94.13072549257998
"147.32.84.165",3423,"77.238.175.247",80,14,2274,10,1276,4,998,2373.12228,0.13859199999978955,73655.04502435567,57607.94273848508
"147.32.84.165",2744,"66.94.237.64",25,6,372,6,372,0,0,2373.168148,8.959311999999954,332.16836292786934,0
"147.32.84.165",3432,"74.125.224.240",443,34,10723,22,3248,12,7475,2374.015292,1.404924999999821,18494.937452179518,42564.549709064624
"147.32.84.165",3424,"68.67.185.210",80,16,2170,12,1370,4,800,2374.177829,14.302408999999898,766.3044736030188,447.4770648776752
"147.32.84.165",3433,"174.133.57.141",80,17,3489,12,1428,5,2061,2374.207097,11.736754000000019,973.3525981715201,1404.8177204702401
"147.32.84.165",2745,"194.116.198.20",25,6,372,6,372,0,0,2374.207132,8.921523999999863,333.5752949832389,0
"147.32.84.165",3435,"61.17.216.4",6667,15,1766,10,1208,5,558,2380.52467,1.0568250000001171,9144.371111583212,4223.972748562444
"147.32.84.165",3437,"212.117.174.7",4506,6,372,6,372,0,0,2380.716008,8.921820999999909,333.56419053913214,0
"147.32.84.165",3425,"64.236.79.229",80,14,2366,10,1652,4,714,2381.125743,0.35775199999989127,36941.79207944055,15966.367763148035
"147.32.84.165",2746,"109.199.195.150",25,6,372,6,372,0,0,2381.125854,9.012815000000046,330.1965035341328,0
"147.32.84.165",3426,"64.236.79.229",80,14,2710,10,2010,4,700,2381.243938,0.3554989999997815,45232.19474600458,15752.505632936918
"147.32.84.165",2747,"209.85.225.27",25,6,372,6,372,0,0,2381.243972,8.994872999999643,330.8551438136056,0
"147.32.84.165",3430,"77.238.167.32",80,13,2342,10,1390,3,952,2382.527542,0.16072500000018408,69186.49867778667,47385.28542536181
"147.32.84.165",2748,"209.85.225.27",25,6,372,6,372,0,0,2382.573373,8.967302999999902,331.87235894672375,0
"147.32.84.165",3431,"64.236.79.229",80,14,2675,10,2018,4,657,2382.573472,0.356851000000006,45240.17026714155,14728.836405110007
"147.32.84.165",2749,"66.94.237.64",25,6,372,6,372,0,0,2382.691148,8.949633000000176,332.5276019698172,0
"147.32.84.165",3436,"64.236.79.229",80,14,2693,10,2036,4,657,2382.691227,0.36140300000033676,45068.80131040645,14543.321444468094
"147.32.84.165",2750,"98.137.54.237",25,6,372,6,372,0,0,2382.691303,8.94960200000014,332.5287537926215,0
"147.32.84.165",3442,"195.113.232.96",80,13,1965,10,1306,3,659,2384.330282,4.257706000000326,2453.9035809422257,1238.2254669532365
"147.32.84.165",2751,"74.6.140.64",25,6,372,6,372,0,0,2384.33113,9.012009000000035,330.2260350605496,0
"147.32.84.165",3451,"212.117.174.7",4506,6,372,6,372,0,0,2391.145387,9.012587000000167,330.20485682967,0
"147.32.84.165",3448,"117.197.27.8",6667,2,124,2,124,0,0,2391.145521,6.000000212225132e-06,0,0
"147.32.84.165",2753,"205.188.156.193",25,6,372,6,372,0,0,2392.642473,9.012654000000111,330.202402089325,0
"147.32.84.165",2755,"62.149.128.74",25,6,372,6,372,0,0,2393.443228,9.01293399999986,330.19214386791765,0
"147.32.84.165",2756,"209.85.225.27",25,6,372,6,372,0,0,2394.144623,9.012713000000076,330.2002404825245,0
"147.32.84.165",2757,"66.94.237.64",25,6,372,6,372,0,0,2394.144655,9.012780999999904,330.197749174204,0
"147.32.84.165",3463,"61.89.186.155",6667,9,552,6,372,3,180,2395.145652,1.9143890000000283,1554.5429899565636,752.1982209467244
"147.32.84.165",3466,"174.133.57.141",80,16,3429,12,1428,4,2001,2397.060312,0.4957810000000791,23042.432041563065,32288.449940593622
"147.32.84.165",2758,"66.94.237.139",25,6,372,6,372,0,0,2397.060351,9.001667999999881,330.6053944668965,0
"147.32.84.165",3465,"173.192.170.88",80,11,1283,8,846,3,437,2401.655195,22.36299800000006,302.6427851936481,156.32966563785368
"147.32.84.165",3472,"61.17.216.7",6667,4,248,4,248,0,0,2401.856293,3.0034300000002077,660.5780724038392,0
"147.32.84.165",2759,"66.94.237.64",25,6,372,6,372,0,0,2402.155845,9.012904999999591,330.1932062969858,0
"147.32.84.165",2760,"65.55.37.88",25,6,372,6,372,0,0,2402.155981,9.012931000000208,330.1922537740421,0
"147.32.84.165",2761,"205.188.156.193",25,6,372,6,372,0,0,2402.255919,9.013494999999693,330.1715927062811,0
"147.32.84.165",2762,"98.137.54.237",25,6,372,6,372,0,0,2402.256026,9.013476000000082,330.1722886930606,0
"147.32.84.165",2763,"65.55.37.72",25,6,372,6,372,0,0,2402.256057,9.013468999999986,330.1725451099909,0
"147.32.84.165",2764,"209.85.225.27",25,6,372,6,372,0,0,2402.957483,9.012570999999753,330.20544304173376,0
"147.32.84.165",2766,"66.94.237.139",25,6,372,6,372,0,0,2403.657904,9.013060999999652,330.1874912418894,0
"147.32.84.165",2767,"66.94.237.64",25,6,372,6,372,0,0,2403.658037,9.012988999999834,330.1901289350353,0
"147.32.84.165",2769,"66.94.237.64",25,6,372,6,372,0,0,2403.6581,9.012952000000041,330.1914844326239,0
"147.32.84.165",2771,"205.188.156.193",25,6,372,6,372,0,0,2403.658131,9.012946999999713,330.19166760884036,0
"147.32.84.165",2772,"209.85.225.27",25,6,372,6,372,0,0,2403.658161,9.012942000000294,330.19185078522673,0
"147.32.84.165",2774,"65.54.188.126",25,6,372,6,372,0,0,2403.658192,9.012936000000082,330.19207059719196,0
"147.32.84.165",2775,"130.75.31.192",25,6,372,6,372,0,0,2405.360838,9.012400999999954,330.21167167328827,0
"147.32.84.165",3480,"31.192.109.167",80,15,1540,10,1050,5,490,2413.67301,0.23270000000002256,36097.98023205494,16845.724108292306
"147.32.84.165",3486,"218.189.208.34",6667,15,1710,10,1152,5,558,2413.749765,1.4918170000000828,6177.701420482196,2992.324125546064
"147.32.84.165",3481,"212.117.174.7",4506,6,372,6,372,0,0,2414.090387,8.995479999999588,330.8328182598523,0
"147.32.84.165",3483,"174.133.57.141",80,16,3429,12,1428,4,2001,2414.473392,0.48547099999996135,23531.786656671375,32974.163235293716
"147.32.84.165",2776,"207.115.37.23",25,6,372,6,372,0,0,2414.473521,9.015138000000206,330.1114192594647,0
"147.32.84.165",2777,"209.85.225.27",25,6,372,6,372,0,0,2415.174434,8.912940000000162,333.89655938443946,0
"147.32.84.165",2778,"66.94.237.64",25,6,372,6,372,0,0,2415.174527,8.912942999999814,333.89644699849,0
"147.32.84.165",3495,"212.117.174.7",4506,6,372,6,372,0,0,2418.078874,8.912470000000212,333.9141674530101,0
"147.32.84.165",3497,"117.199.114.136",6667,4,248,4,248,0,0,2418.079061,3.0076389999999265,659.6536352933475,0
"147.32.84.165",2779,"66.94.237.64",25,6,372,6,372,0,0,2418.579388,8.913058999999976,333.89210146595104,0
"147.32.84.165",2780,"205.188.156.193",25,6,372,6,372,0,0,2418.579461,8.913130000000365,333.8894417561371,0
"147.32.84.165",2781,"64.65.187.19",25,6,372,6,372,0,0,2423.185957,8.913201999999728,333.88674462893255,0
"147.32.84.165",2782,"202.3.225.23",25,6,372,6,372,0,0,2423.286094,8.912735999999768,333.90420180739983,0
"147.32.84.165",2783,"208.24.22.136",25,6,372,6,372,0,0,2423.887262,9.012649999999667,330.20254863997934,0
"147.32.84.165",2787,"65.54.188.126",25,6,372,6,372,0,0,2424.58919,9.011975999999777,330.2272442802859,0
"147.32.84.165",3505,"174.133.57.141",80,17,3489,12,1428,5,2061,2426.290728,7.9986079999998765,1428.248515241674,2061.358676409727
"147.32.84.165",2786,"66.94.237.64",25,6,372,6,372,0,0,2426.290826,9.013507000000118,330.1711531371708,0
"147.32.84.165",2788,"209.85.225.27",25,6,372,6,372,0,0,2426.290858,9.013638000000356,330.1663545840073,0
"147.32.84.165",3509,"95.58.159.249",6667,6,372,6,372,0,0,2435.002911,9.013472000000093,330.17243521696963,0
"147.32.84.165",2789,"209.85.225.27",25,6,372,6,372,0,0,2435.403935,9.01260400000001,330.2042339816546,0
"147.32.84.165",2792,"205.188.156.193",25,6,372,6,372,0,0,2435.404083,9.01254999999992,330.2062124482002,0
"147.32.84.165",2796,"209.85.225.27",25,6,372,6,372,0,0,2435.404158,9.012499000000389,330.20808102168684,0
"147.32.84.165",2797,"124.108.116.109",25,6,372,6,372,0,0,2435.404236,9.01244799999995,330.2099496163547,0
"147.32.84.165",2798,"66.94.237.64",25,6,372,6,372,0,0,2436.104524,9.013408000000254,330.17477961720095,0
"147.32.84.165",2799,"64.184.32.12",25,6,372,6,372,0,0,2436.605342,9.012901000000056,330.1933528394444,0
"147.32.84.165",3521,"95.155.98.55",6667,9,552,6,372,3,180,2439.50945,1.1355180000000473,2620.8303170886556,1268.1437018170914
"147.32.84.165",3525,"212.117.174.7",4506,6,372,6,372,0,0,2440.64525,8.979101999999784,331.43626166626365,0
"147.32.84.165",3533,"174.133.57.141",80,18,4265,14,2264,4,2001,2444.116279,3.430587000000287,5279.562943600756,4666.256824269042
"147.32.84.165",2800,"64.114.34.90",25,6,372,6,372,0,0,2444.116379,9.013300000000072,330.1787358681034,0
"147.32.84.165",3532,"212.117.174.7",4506,6,372,6,372,0,0,2444.216471,9.012596999999914,330.20449044820583,0
"147.32.84.165",3531,"123.27.93.41",6667,4,248,4,248,0,0,2444.216577,3.003983000000062,660.4564672969052,0
"147.32.84.165",2801,"62.211.72.32",25,6,372,6,372,0,0,2444.917766,9.012573999999859,330.20533312681226,0
"147.32.84.165",2802,"205.188.156.193",25,6,372,6,372,0,0,2445.618339,9.013039999999819,330.1882605646996,0
"147.32.84.165",2804,"205.188.159.42",25,6,372,6,372,0,0,2447.321739,9.012348000000202,330.2136135888154,0
"147.32.84.165",3544,"178.133.29.206",6667,4,248,4,248,0,0,2456.03322,3.004327999999987,660.3806242194623,0
"147.32.84.165",2805,"216.32.180.22",25,6,372,6,372,0,0,2456.433885,9.013026999999965,330.1887368139485,0
"147.32.84.165",2806,"209.85.225.27",25,6,372,6,372,0,0,2457.134683,9.01301999999987,330.1889932564272,0
"147.32.84.165",3549,"174.133.57.141",80,17,3489,12,1428,5,2061,2457.635661,3.974837000000207,2874.080119511669,4148.094626269994
"147.32.84.165",2807,"66.94.237.64",25,6,372,6,372,0,0,2457.796188,8.952416000000085,332.4242305093923,0
"147.32.84.165",2808,"75.147.97.180",25,6,372,6,372,0,0,2461.641901,9.01243599999998,330.21038928875686,0
"147.32.84.165",2815,"65.54.188.94",25,6,372,6,372,0,0,2462.442576,9.01279999999997,330.197053080065,0
"147.32.84.165",3558,"117.198.168.149",6667,4,248,4,248,0,0,2465.146702,3.0046990000000733,660.2990848667209,0
"147.32.84.165",2818,"209.25.170.16",25,6,372,6,372,0,0,2465.947603,9.01326199999994,330.18012790486057,0
"147.32.84.165",2819,"64.12.90.97",25,6,372,6,372,0,0,2466.648877,9.012519999999768,330.20731160652923,0
"147.32.84.165",3560,"212.117.174.7",4506,6,372,6,372,0,0,2468.351554,9.012241000000358,330.2175341294004,0
"147.32.84.165",3570,"174.133.57.141",80,17,3489,12,1428,5,2061,2472.657214,6.298686999999973,1813.7113338065615,2617.688416649386
"147.32.84.165",2820,"209.85.143.27",25,6,372,6,372,0,0,2472.819569,8.950933000000077,332.47930690576885,0
"147.32.84.165",3568,"212.117.174.7",4506,6,372,6,372,0,0,2477.466803,9.010526000000027,330.28038540702187,0
"147.32.84.165",3575,"78.96.25.166",6667,9,552,6,372,3,180,2477.466941,1.030069999999796,2889.124040114351,1397.9632452166213
"147.32.84.165",2821,"66.94.237.64",25,6,372,6,372,0,0,2478.165061,9.012878999999884,330.19415882539175,0
"147.32.84.165",2822,"209.85.225.27",25,6,372,6,372,0,0,2478.165195,9.012840999999753,330.19555099219895,0
"147.32.84.165",2824,"207.115.36.22",25,6,372,6,372,0,0,2478.497255,8.981166999999914,331.3600559927266,0
"147.32.84.165",2825,"66.94.237.64",25,6,372,6,372,0,0,2478.765867,9.0135879999998,330.16818607640664,0
"147.32.84.165",3586,"89.176.63.137",6667,4,248,4,248,0,0,2482.270941,3.0042609999995875,660.3953518020812,0
"147.32.84.165",2826,"66.94.237.64",25,6,372,6,372,0,0,2482.671815,9.012727999999697,330.19969092599933,0
"147.32.84.165",2827,"205.188.156.193",25,6,372,6,372,0,0,2482.67196,9.012709000000086,330.2003870312435,0
"147.32.84.165",2828,"24.113.32.75",25,6,372,6,372,0,0,2483.472613,9.013150000000223,330.18423081829616,0
"147.32.84.165",2829,"209.85.225.27",25,6,372,6,372,0,0,2486.978523,8.912784999999985,333.9023660954466,0
"147.32.84.165",2830,"66.94.237.139",25,6,372,6,372,0,0,2486.978657,8.912789999999859,333.9021787790408,0
"147.32.84.165",2831,"65.55.37.72",25,6,372,6,372,0,0,2487.678703,8.913044999999784,333.89262592077927,0
"147.32.84.165",3595,"174.133.57.141",80,17,3489,12,1428,5,2061,2489.381708,2.1074330000001282,5420.8129036601895,7823.736270618803
"147.32.84.165",2833,"65.55.92.168",25,6,372,6,372,0,0,2489.536696,8.857516000000032,335.98584524148635,0
"147.32.84.165",3600,"200.53.110.7",6667,4,248,4,248,0,0,2493.687449,3.0041989999999714,660.4089808964117,0
"147.32.84.165",3605,"212.117.174.7",4506,6,372,6,372,0,0,2499.095217,9.012861000000157,330.19481827135115,0
"147.32.84.165",2836,"209.85.225.27",25,6,372,6,372,0,0,2499.395523,9.013106999999764,330.18580607110044,0
"147.32.84.165",2837,"205.217.164.10",25,6,372,6,372,0,0,2499.695992,9.013226999999915,330.1814100543599,0
"147.32.84.165",2838,"205.188.190.2",25,6,372,6,372,0,0,2500.296831,9.0136779999998,330.1648894047542,0
"147.32.84.165",3621,"212.117.174.7",4506,6,372,6,372,0,0,2503.60164,9.012912000000142,330.19294984794624,0
"147.32.84.165",3617,"92.47.5.149",6667,9,552,6,372,3,180,2503.601774,1.3850229999998191,2148.700779698524,1039.693925660576
"147.32.84.165",3616,"174.133.57.141",80,17,3489,12,1428,5,2061,2504.402745,4.181806999999935,2731.8333916415027,3942.7931513817484
"147.32.84.165",2840,"65.55.37.88",25,6,372,6,372,0,0,2504.565046,8.951184999999896,332.4699467165559,0
"147.32.84.165",2842,"209.85.225.27",25,6,372,6,372,0,0,2504.987032,8.929658000000018,333.27144219856956,0
"147.32.84.165",2845,"64.136.52.37",25,6,372,6,372,0,0,2504.987103,8.929711000000225,333.26946415174297,0
"147.32.84.165",2847,"205.188.156.193",25,6,372,6,372,0,0,2507.908085,9.013097000000016,330.1861724111029,0
"147.32.84.165",3625,"77.239.2.219",6667,4,248,4,248,0,0,2508.609249,3.003950999999688,660.4635029000826,0
"147.32.84.165",2848,"208.65.144.13",25,6,372,6,372,0,0,2510.411731,9.014419999999973,330.1377126870069,0
"147.32.84.165",2849,"66.94.237.64",25,6,372,6,372,0,0,2510.511526,9.0148650000001,330.1214161276921,0
"147.32.84.165",3632,"174.133.57.141",80,16,3429,12,1428,4,2001,2520.125618,0.4891619999998511,23354.226207275868,32725.354790447484
"147.32.84.165",2850,"200.147.36.15",25,6,372,6,372,0,0,2520.287846,8.950619999999617,332.4909335889723,0
"147.32.84.165",3631,"212.117.171.138",65500,54,16364,36,11664,18,4700,2520.426056,13.465679000000364,6929.61713998956,2792.2839984525835
"147.32.84.165",2851,"209.85.225.27",25,6,372,6,372,0,0,2520.426124,9.013082999999824,330.1866852884921,0
"147.32.84.165",3633,"115.99.115.251",6667,9,552,6,372,3,180,2520.726428,1.6691799999998693,1782.9113696547006,862.6990498329196
"147.32.84.165",2854,"202.67.240.41",25,6,372,6,372,0,0,2521.328526,9.011451000000307,330.2464830580446,0
"147.32.84.165",3637,"74.125.224.243",443,27,5943,18,2936,9,3007,2522.395868,1.4642650000000685,16040.812284660837,16428.720211163192
"147.32.84.165",2855,"65.55.92.136",25,6,372,6,372,0,0,2522.55829,8.983727000000272,331.265631736128,0
"147.32.84.165",3642,"212.117.174.7",4506,6,372,6,372,0,0,2525.533591,9.012888000000203,330.19382910338317,0
"147.32.84.165",2858,"65.55.37.72",25,6,372,6,372,0,0,2525.933928,9.012817000000268,330.19643026147224,0
"147.32.84.165",3641,"212.117.171.138",65500,24,1475,18,1092,6,383,2526.735008,40.781946999999946,214.21243080915218,75.13128296694623
"147.32.84.165",2859,"64.12.90.97",25,6,372,6,372,0,0,2526.735157,9.01321999999982,330.181666485458,0
"147.32.84.165",3644,"117.242.61.2",6667,4,248,4,248,0,0,2528.938246,3.0044920000000275,660.3445773861212,0
"147.32.84.165",3651,"174.133.57.141",80,17,4638,12,1428,5,3210,2531.441948,158.9378710000001,71.87714248418487,161.5725681892391
"147.32.84.165",2860,"200.147.36.15",25,6,372,6,372,0,0,2531.542149,9.012669000000187,330.2018525255879,0
"147.32.84.165",3648,"212.117.174.7",4506,6,372,6,372,0,0,2531.542205,9.012755999999627,330.19866509202325,0
"147.32.84.165",3645,"65.55.16.187",443,36,14140,26,8792,10,5348,2531.542267,2.4932940000003327,28210.070693624824,17159.628988797267
"147.32.84.165",2861,"218.102.53.138",25,6,372,6,372,0,0,2531.611623,8.943409000000429,332.7590184011329,0
"147.32.84.165",2862,"82.119.197.148",25,6,372,6,372,0,0,2531.7084,8.946472000000085,332.6450918306089,0
"147.32.84.165",3652,"31.192.109.167",80,15,1540,10,1050,5,490,2541.255712,0.23741299999983312,35381.38181146738,16511.31151201811
"147.32.84.165",3655,"61.150.114.216",6667,15,1710,10,1152,5,558,2541.333735,1.6106629999999313,5721.867330410143,2771.529488167413
"147.32.84.165",2863,"209.85.225.27",25,6,372,6,372,0,0,2541.456015,9.012957999999799,330.19126462145573,0
"147.32.84.165",2864,"64.12.90.1",25,6,372,6,372,0,0,2541.679791,8.993926999999985,330.88994384766573,0
"147.32.84.165",2865,"65.54.188.126",25,6,372,6,372,0,0,2542.357363,9.012938999999733,330.1919606911894,0
"147.32.84.165",2866,"62.142.5.93",25,6,372,6,372,0,0,2543.559646,9.012338,330.2139799905419,0
"147.32.84.165",3662,"212.117.171.138",65500,128,49429,82,6438,46,42991,2544.160037,136.10883699999977,378.40305695948376,2526.860177344698
"147.32.84.165",2867,"77.238.177.9",25,6,372,6,372,0,0,2544.160169,9.012779999999566,330.1977858108312,0
"147.32.84.165",3663,"93.17.128.16",25,6,372,6,372,0,0,2546.567459,9.009151000000202,330.33079365635376,0
"147.32.84.165",2868,"205.188.156.193",25,6,372,6,372,0,0,2546.964189,9.01279599999998,330.19719962595474,0
"147.32.84.165",3664,"27.255.59.65",6667,9,552,6,372,3,180,2547.765417,1.3860429999999724,2147.1195338096,1038.9288066820645
"147.32.84.165",2869,"165.21.74.122",25,6,372,6,372,0,0,2549.151805,8.928197000000182,333.3259783582216,0
"147.32.84.165",3670,"84.111.18.150",6667,4,248,4,248,0,0,2552.57213,3.0043390000000727,660.3782063209085,0
"147.32.84.165",3668,"212.117.174.7",4506,6,372,6,372,0,0,2552.675823,9.009703000000172,330.31055518699594,0
"147.32.84.165",2870,"207.115.36.22",25,6,372,6,372,0,0,2562.486842,8.912375000000338,333.9177267563233,0
"147.32.84.165",3674,"212.117.174.7",4506,6,372,6,372,0,0,2562.687747,8.911646000000019,333.9450422514532,0
"147.32.84.165",3676,"60.243.195.59",6667,4,248,4,248,0,0,2562.687881,2.9028980000002775,683.4549474352217,0
"147.32.84.165",2871,"202.131.27.71",25,6,372,6,372,0,0,2563.287756,9.012582999999722,330.2050033825033,0
"147.32.84.165",2872,"209.85.225.27",25,6,372,6,372,0,0,2564.489732,9.01281199999994,330.1966134431762,0
"147.32.84.165",2874,"85.158.139.83",25,6,372,6,372,0,0,2565.090055,9.013013999999657,330.1892130645879,0
"147.32.84.165",2875,"66.94.237.64",25,6,372,6,372,0,0,2567.493671,9.012997999999698,330.18979922109156,0
"147.32.84.165",2876,"205.188.59.193",25,6,372,6,372,0,0,2567.89411,9.012891999999738,330.1936825605018,0
"147.32.84.165",2877,"65.54.188.94",25,6,372,6,372,0,0,2569.997117,9.0132550000003,330.18038433395054,0
"147.32.84.165",3682,"174.133.57.141",80,16,4584,12,1428,4,3156,2570.598481,107.54282899999998,106.22744543943513,234.771581097239
"147.32.84.165",2878,"64.12.90.1",25,6,372,6,372,0,0,2570.598614,9.012471000000005,330.2091069141857,0
"147.32.84.165",3685,"199.255.211.81",6667,4,248,4,248,0,0,2573.602834,3.0039960000003703,660.4536091258962,0
"147.32.84.165",3689,"212.117.174.7",4506,6,372,6,372,0,0,2580.81263,9.012987000000066,330.1902022048826,0
"147.32.84.165",2879,"209.85.225.27",25,6,372,6,372,0,0,2583.416323,9.013220000000274,330.1816664854413,0
"147.32.84.165",3692,"99.236.68.164",6667,4,248,4,248,0,0,2583.416424,3.0044330000000627,660.3575450009897,0
"147.32.84.165",2881,"159.53.46.182",25,6,372,6,372,0,0,2584.318239,9.01270199999999,330.2006434918189,0
"147.32.84.165",2883,"64.12.90.97",25,6,372,6,372,0,0,2585.519612,9.012756999999965,330.19862845520095,0
"147.32.84.165",2884,"205.188.59.194",25,6,372,6,372,0,0,2586.120211,9.012967000000117,330.19093490522727,0
"147.32.84.165",2885,"66.175.58.41",25,6,372,6,372,0,0,2588.523795,9.012882999999874,330.19401228220113,0
"147.32.84.165",3695,"212.117.174.7",4506,6,372,6,372,0,0,2588.92683,9.0105980000003,330.2777462716571,0
"147.32.84.165",2886,"66.94.237.139",25,6,372,6,372,0,0,2588.926963,9.010588999999982,330.2780761612816,0
"147.32.84.165",2888,"209.85.225.27",25,6,372,6,372,0,0,2591.027294,9.013064000000213,330.187381338902,0
"147.32.84.165",2890,"205.188.156.193",25,6,372,6,372,0,0,2591.027437,9.012981999999738,330.1903853796764,0
"147.32.84.165",2891,"65.55.92.152",25,6,372,6,372,0,0,2591.628296,9.013330000000224,330.17763690000544,0
"147.32.84.165",3699,"92.87.4.97",6667,9,552,6,372,3,180,2600.641492,1.065099999999802,2794.103840015541,1351.985729039778
"147.32.84.165",3701,"173.192.170.88",80,63,7805,38,2726,25,5079,2601.706805,42.70867100000032,510.6223043091141,951.3758927314711
"147.32.84.165",2892,"81.22.163.206",25,6,372,6,372,0,0,2601.842812,9.013163000000077,330.1837545820457,0
"147.32.84.165",2894,"66.94.237.64",25,6,372,6,372,0,0,2601.907546,8.948554000000058,332.56769752967693,0
"147.32.84.165",3704,"218.94.106.74",6667,9,552,6,372,3,180,2605.347821,1.9389670000000478,1534.8378801701765,742.6634904049241
"147.32.84.165",2895,"200.16.5.222",25,6,372,6,372,0,0,2606.549712,9.012785999999778,330.19756599125657,0
"147.32.84.165",3708,"212.117.174.7",4506,6,372,6,372,0,0,2607.151132,9.012508000000253,330.2077512718898,0
"147.32.84.165",2896,"209.85.229.27",25,6,372,6,372,0,0,2607.28706,8.976678999999876,331.5257234886132,0
"147.32.84.165",2897,"64.12.90.1",25,6,372,6,372,0,0,2609.554142,9.012827000000016,330.19606389870734,0
"147.32.84.165",2898,"64.18.7.11",25,6,372,6,372,0,0,2609.954676,9.012787000000117,330.1975293546781,0
"147.32.84.165",3712,"89.236.212.138",6667,4,248,4,248,0,0,2612.057587,3.004236000000219,660.4008473368455,0
"147.32.84.165",3713,"174.133.57.141",80,17,3489,12,1428,5,2061,2612.057674,0.8552429999999731,13357.607136217846,19278.731307944665
"147.32.84.165",2899,"89.146.30.18",25,6,372,6,372,0,0,2612.057704,9.013472999999976,330.1723985859843,0
"147.32.84.165",2900,"66.94.237.64",25,6,372,6,372,0,0,2612.658551,9.012869000000137,330.1945251839292,0
"147.32.84.165",2901,"205.188.156.193",25,6,372,6,372,0,0,2612.658686,9.012862999999925,330.1947449994552,0
"147.32.84.165",3717,"212.117.174.7",4506,6,372,6,372,0,0,2622.873014,9.013404000000264,330.1749261433209,0
"147.32.84.165",3723,"89.176.63.137",6667,4,248,4,248,0,0,2622.873149,3.004530000000159,660.3362256325931,0
"147.32.84.165",3720,"208.73.210.29",80,72,39789,44,6766,28,33023,2622.873212,13.850386000000071,3908.0499272727648,19074.125443146397
"147.32.84.165",3725,"174.133.57.141",80,17,3489,12,1428,5,2061,2623.056061,7.5275049999995645,1517.6343290373984,2190.3671933796063
"147.32.84.165",2902,"209.85.225.27",25,6,372,6,372,0,0,2623.056127,8.932626000000255,333.16070772468424,0
"147.32.84.165",3726,"74.125.232.217",80,13,2942,10,2068,3,874,2627.580099,9.14371600000004,1809.3300360597298,764.678168044586
"147.32.84.165",2903,"66.94.237.64",25,6,372,6,372,0,0,2627.591039,8.902406000000155,334.29165104354354,0
"147.32.84.165",3730,"94.127.76.180",80,22,7214,16,5208,6,2006,2628.180656,8.543348000000151,4876.776645408716,1878.4204974442944
"147.32.84.165",2906,"200.16.5.222",25,6,372,6,372,0,0,2628.194686,8.89889600000015,334.4235060169205,0
"147.32.84.165",3731,"94.127.76.180",80,22,7234,16,5228,6,2006,2628.285611,8.43857300000036,4956.288225509006,1901.7433397802347
"147.32.84.165",2907,"64.12.90.97",25,6,372,6,372,0,0,2628.285758,8.90795399999979,334.083449465508,0
"147.32.84.165",3732,"67.214.158.5",80,15,2573,10,1718,5,855,2628.881756,0.31523299999980736,43599.49624566083,21698.23590805588
"147.32.84.165",2908,"205.188.59.194",25,6,372,6,372,0,0,2628.985202,8.909430000000157,334.0281028079179,0
"147.32.84.165",3737,"112.110.18.151",6667,4,248,4,248,0,0,2630.5845,2.904359000000113,683.1111443178762,0
"147.32.84.165",3733,"208.73.211.25",80,9,1586,6,1406,3,180,2630.985376,0.3696740000000318,30426.80848531147,3895.323988162208
"147.32.84.165",2909,"94.245.120.86",25,6,372,6,372,0,0,2631.169059,8.829580999999962,337.04883617920405,0
"147.32.84.165",3734,"50.22.198.84",80,13,3364,10,2332,3,1032,2632.987972,0.3691630000002988,50535.94211766862,22364.104745040317
"147.32.84.165",2910,"209.85.225.27",25,6,372,6,372,0,0,2633.108915,8.99214000000029,330.9557013124689,0
"147.32.84.165",3735,"67.214.158.5",80,15,2658,10,1762,5,896,2633.108947,0.3215879999997924,43832.48131152002,22289.388907560693
"147.32.84.165",2911,"66.94.237.64",25,6,372,6,372,0,0,2633.212587,8.988314000000173,331.0965771778715,0
"147.32.84.165",3740,"212.117.174.7",4506,6,372,6,372,0,0,2633.212618,8.988408000000163,331.09311459826324,0
"147.32.84.165",3741,"50.22.198.84",80,14,3016,10,2436,4,580,2633.588532,0.3714509999999791,52464.52425757663,12491.553394661101
"147.32.84.165",2913,"199.91.36.34",25,6,372,6,372,0,0,2633.709107,8.99239099999977,330.94646351566297,0
"147.32.84.165",2914,"74.125.67.27",25,6,372,6,372,0,0,2639.096478,9.01283599999988,330.1957341729107,0
"147.32.84.165",3748,"207.232.61.93",6667,4,248,4,248,0,0,2643.903381,3.004163999999946,660.4166749884612,0
"147.32.84.165",3754,"173.192.170.88",80,17,1641,12,1084,5,557,2648.509843,71.81761400000005,120.75032178039213,62.0460601768251
"147.32.84.165",3747,"174.133.57.141",80,16,3429,12,1428,4,2001,2648.710675,0.4887260000000424,23375.060872552327,32754.54958401765
"147.32.84.165",2915,"64.12.90.1",25,6,372,6,372,0,0,2648.710742,9.012941999999839,330.1918507852434,0
"147.32.84.165",3758,"212.117.174.7",4506,6,372,6,372,0,0,2649.111217,9.012619000000086,330.2036844118199,0
"147.32.84.165",2916,"205.188.156.193",25,6,372,6,372,0,0,2649.111356,9.012609000000339,330.2040507914954,0
"147.32.84.165",3753,"212.117.171.138",65500,24,1475,18,1092,6,383,2649.211112,42.78766499999983,204.17099180336282,71.60942294934794
"147.32.84.165",2917,"209.85.225.27",25,6,372,6,372,0,0,2649.211242,9.012708000000202,330.2004236684394,0
"147.32.84.165",3759,"205.188.186.137",587,72,28558,46,26116,26,2442,2649.311193,30.99144800000022,6741.472679817946,630.3674484651334
"147.32.84.165",2918,"66.94.237.64",25,6,372,6,372,0,0,2649.429166,8.995061999999962,330.8481920413681,0
"147.32.84.165",2920,"207.115.37.23",25,6,372,6,372,0,0,2649.912011,9.013096000000132,330.18620904514455,0
"147.32.84.165",3761,"117.224.216.244",6667,4,248,4,248,0,0,2652.014892,3.0050360000000182,660.2250355736131,0
"147.32.84.165",2921,"66.94.9.212",25,6,372,6,372,0,0,2654.218096,9.012959000000137,330.19122798627563,0
"147.32.84.165",2925,"205.188.156.193",25,6,372,6,372,0,0,2654.719136,9.012750999999753,330.19884827619023,0
"147.32.84.165",2926,"98.137.54.237",25,6,372,6,372,0,0,2654.719271,9.012741000000005,330.19921464513385,0
"147.32.84.165",2928,"209.85.225.27",25,6,372,6,372,0,0,2658.924858,9.013228000000254,330.18137342136646,0
"147.32.84.165",2929,"66.94.237.64",25,6,372,6,372,0,0,2658.92499,9.01319199999989,330.18269221381684,0
"147.32.84.165",2930,"62.239.224.236",25,6,372,6,372,0,0,2658.925048,9.01315999999997,330.1838644826021,0
"147.32.84.165",3768,"212.117.174.7",4506,6,372,6,372,0,0,2660.126692,9.013848000000053,330.1586625379064,0
"147.32.84.165",3767,"174.133.57.141",80,17,3489,12,1428,5,2061,2669.140348,9.431135000000268,1211.3070165997703,1748.2519336219375
"147.32.84.165",2931,"64.71.138.82",25,6,372,6,372,0,0,2669.140483,9.012073999999757,330.2236532900285,0
"147.32.84.165",3771,"31.192.109.167",80,15,1540,10,1050,5,490,2669.740435,0.2371219999999994,35424.80242238182,16531.574463778183
"147.32.84.165",3770,"196.192.41.18",6667,6,372,6,372,0,0,2669.81824,8.935439999999744,333.05578684430594,0
"147.32.84.165",2932,"205.188.59.194",25,6,372,6,372,0,0,2670.140936,9.013079000000289,330.1868318251626,0
"147.32.84.165",2933,"162.130.196.144",25,6,372,6,372,0,0,2670.241456,9.01272599999993,330.1997642000903,0
"147.32.84.165",3777,"212.117.171.138",65500,344,333046,252,326678,92,6368,2670.441479,51.5606429999998,50686.4121147599,988.0404323119127
"147.32.84.165",2934,"205.188.156.193",25,6,372,6,372,0,0,2670.44161,9.01278100000036,330.1977491741873,0
"147.32.84.165",3779,"67.195.168.31",25,6,372,6,372,0,0,2670.942183,9.275542999999743,320.8437500640213,0
"147.32.84.165",2935,"77.238.184.241",25,6,372,6,372,0,0,2675.248554,9.013075000000299,330.1869783619798,0
"147.32.84.165",3784,"212.117.174.7",4506,6,372,6,372,0,0,2675.749162,9.012965999999778,330.19097154034233,0
"147.32.84.165",3780,"187.106.81.34",6667,2,124,2,124,0,0,2675.7493,6.000000212225132e-06,0,0
"147.32.84.165",2936,"209.85.225.27",25,6,372,6,372,0,0,2679.955259,9.013222000000042,330.1815932193822,0
"147.32.84.165",3788,"61.26.131.206",6667,4,248,4,248,0,0,2681.15869,3.0028449999999793,660.7067630863444,0
"147.32.84.165",3795,"212.117.174.7",4506,6,372,6,372,0,0,2688.968361,8.913722999999663,333.86722921501064,0
"147.32.84.165",3798,"174.133.57.141",80,17,2011,12,1428,5,583,2690.169875,142.82810100000006,79.98426024021698,32.65463845941632
"147.32.84.165",2937,"65.55.37.72",25,6,372,6,372,0,0,2690.330257,8.855739000000085,336.0532644424109,0
"147.32.84.165",3799,"84.247.61.206",6667,4,248,4,248,0,0,2690.77076,2.9981010000001334,661.7522224901402,0
"147.32.84.165",2938,"66.94.237.64",25,6,372,6,372,0,0,2691.171257,8.917663000000175,333.71972006566534,0
"147.32.84.165",2939,"65.54.188.110",25,6,372,6,372,0,0,2691.271445,8.918129000000135,333.7022821715132,0
"147.32.84.165",2940,"216.17.3.48",25,6,372,6,372,0,0,2691.471654,8.91816400000016,333.70097253200845,0
"147.32.84.165",3801,"98.126.71.122",80,18,4863,14,1430,4,3433,2691.975386,16.56373799999983,690.665355851446,1658.0798368097999
"147.32.84.165",2943,"205.188.59.193",25,6,372,6,372,0,0,2692.150601,8.84144600000036,336.59652504803836,0
"147.32.84.165",3803,"195.113.232.98",80,17,5749,12,2574,5,3175,2696.276856,15.40106999999989,1337.0499582171983,1649.236059572496
"147.32.84.165",2944,"65.55.92.136",25,6,372,6,372,0,0,2696.276991,8.928373999999621,333.31937035793146,0
"147.32.84.165",3806,"195.113.232.83",80,13,3379,10,1524,3,1855,2698.083173,13.594856000000163,896.8097933512391,1091.5893482063966
"147.32.84.165",2945,"66.94.237.64",25,6,372,6,372,0,0,2698.084243,9.028726000000006,329.61461007898544,0
"147.32.84.165",2946,"94.245.120.86",25,6,372,6,372,0,0,2698.084307,9.028714000000036,329.6150481674343,0
"147.32.84.165",3814,"178.165.97.227",6667,9,552,6,372,3,180,2700.89165,1.070929999999862,2778.893111594953,1344.6256991588484
"147.32.84.165",3807,"74.125.232.218",80,13,1871,10,1156,3,715,2701.962883,9.715241999999762,951.9062932246286,588.7655706363403
"147.32.84.165",2947,"209.85.225.27",25,6,372,6,372,0,0,2701.971013,8.953318000000309,332.390740505352,0
"147.32.84.165",3816,"212.117.174.7",4506,6,372,6,372,0,0,2707.112775,9.555550999999923,311.4420089432858,0
"147.32.84.165",3820,"92.47.5.149",6667,9,552,6,372,3,180,2707.112912,1.3796809999998914,2157.0203547053516,1043.7195264703314
"147.32.84.165",3808,"77.238.175.247",80,14,2274,10,1276,4,998,2708.492907,0.13902499999994689,73425.64287001546,57428.520050372594
"147.32.84.165",2948,"192.135.120.61",25,6,372,6,372,0,0,2708.538734,9.84643799999958,302.24127750564486,0
"147.32.84.165",3810,"64.236.79.229",80,14,2814,10,2100,4,714,2709.921809,0.3568719999998393,47075.7022125792,16005.738752276928
"147.32.84.165",2949,"207.115.20.23",25,6,372,6,372,0,0,2710.039483,9.645661999999902,308.53247812332944,0
"147.32.84.165",3824,"212.117.171.138",65500,72,6913,48,4514,24,2399,2711.225713,185.80899,194.35012267167482,103.28886670122904
"147.32.84.165",3811,"68.67.185.207",80,13,1990,10,1250,3,740,2711.225785,0.45243200000004435,22102.769034902525,13084.839268662296
"147.32.84.165",2951,"74.6.140.64",25,6,372,6,372,0,0,2711.249765,9.748164000000088,305.2882573579982,0
"147.32.84.165",3827,"65.55.196.251",443,222,171029,142,10208,80,160821,2712.13861,9.943098000000191,8213.134377233175,129393.07246091463
"147.32.84.165",2952,"205.188.156.193",25,6,372,6,372,0,0,2712.238835,9.491493999999875,313.5438951971143,0
"147.32.84.165",3830,"209.127.193.138",6667,9,552,6,372,3,180,2712.24002,5.416212999999971,549.4614041212958,265.8684213490141
"147.32.84.165",2953,"206.46.232.11",25,6,372,6,372,0,0,2712.438865,9.299066999999923,320.0321064468107,0
"147.32.84.165",2954,"66.94.237.64",25,6,372,6,372,0,0,2713.040076,9.012794999999642,330.19723626246,0
"147.32.84.165",3834,"212.117.174.7",4506,6,372,6,372,0,0,2717.245775,9.013372000000345,330.17609835696186,0
"147.32.84.165",2955,"77.75.72.42",25,6,372,6,372,0,0,2717.656568,9.002514000000247,330.57432623819506,0
"147.32.84.165",2956,"205.188.159.42",25,6,372,6,372,0,0,2719.148528,9.013068999999632,330.18719816747455,0
"147.32.84.165",3840,"91.214.134.197",6667,9,552,6,372,3,180,2722.954041,1.0527609999999186,2826.852438492906,1367.8318250772127
"147.32.84.165",3837,"173.192.170.88",80,17,1643,12,1086,5,557,2724.007079,51.986725000000206,167.1195867791242,85.71418953588598
"147.32.84.165",2957,"209.85.225.27",25,6,372,6,372,0,0,2724.208335,8.960497000000032,332.1244346156234,0
"147.32.84.165",3843,"188.129.211.240",6667,4,248,4,248,0,0,2729.563209,3.004319000000123,660.3826025132214,0
"147.32.84.165",3845,"174.133.57.141",80,16,3429,12,1428,4,2001,2731.065517,0.5024800000001051,22735.2332431094,31857.98439738229
"147.32.84.165",2960,"64.12.90.97",25,6,372,6,372,0,0,2731.065642,9.012850000000071,330.19522126741003,0
"147.32.84.165",2961,"65.54.188.94",25,6,372,6,372,0,0,2732.267312,9.013154000000213,330.1840842839177,0
"147.32.84.165",3848,"212.117.174.7",4506,6,372,6,372,0,0,2733.268599,9.013017000000218,330.18910316045424,0
"147.32.84.165",2962,"74.125.93.27",25,6,372,6,372,0,0,2733.268732,9.013012999999773,330.1892496993042,0
"147.32.84.165",2963,"74.125.67.27",25,6,372,6,372,0,0,2733.469017,9.012986000000183,330.19023883981845,0
"147.32.84.165",2964,"64.12.90.1",25,6,372,6,372,0,0,2734.069856,9.01279199999999,330.1973461719746,0
"147.32.84.165",3849,"213.33.174.74",6667,6,368,4,248,2,120,2738.276267,18.221164999999928,108.88436606550722,52.68598358008414
"147.32.84.165",2966,"209.85.225.27",25,6,372,6,372,0,0,2738.676632,8.912679000000026,333.90633725280486,0
"147.32.84.165",2968,"209.85.225.27",25,6,372,6,372,0,0,2738.676768,8.912680000000364,333.90629978860215,0
"147.32.84.165",2969,"65.55.92.152",25,6,372,6,372,0,0,2738.676828,8.912698999999975,333.90558797060334,0
"147.32.84.165",2970,"216.32.180.22",25,6,372,6,372,0,0,2740.178841,8.915250000000015,333.81004458652257,0
"147.32.84.165",3856,"212.117.174.7",4506,6,372,6,372,0,0,2745.18589,8.912938999999824,333.8965968464565,0
"147.32.84.165",3854,"174.133.57.141",80,17,3489,12,1428,5,2061,2745.886714,2.9366469999999936,3890.150910204742,5614.5665447702895
"147.32.84.165",2971,"205.188.156.193",25,6,372,6,372,0,0,2745.886813,8.912890000000061,333.89843249495726,0
"147.32.84.165",3861,"175.100.132.205",6667,2,124,2,124,0,0,2751.995602,7.000000096013537e-06,0,0
"147.32.84.165",2973,"66.94.237.64",25,6,372,6,372,0,0,2753.197286,9.017433999999867,330.0273669871101,0
"147.32.84.165",3868,"173.192.170.88",80,16,2023,12,1494,4,529,2754.198687,6.759755000000041,1768.1114182392598,626.0581929374621
"147.32.84.165",2974,"216.200.145.235",25,6,372,6,372,0,0,2754.19876,9.018721999999798,329.9802344500769,0
"147.32.84.165",2975,"65.55.92.184",25,6,372,6,372,0,0,2754.39955,9.018516999999974,329.98773523407544,0
"147.32.84.165",3874,"174.36.246.56",80,28,14171,22,2068,6,12103,2755.000587,0.48428199999989374,34161.913926191,199933.09683205496
"147.32.84.165",2976,"209.85.225.27",25,6,372,6,372,0,0,2755.12164,8.998915000000125,330.70653517673617,0
"147.32.84.165",3878,"195.113.232.97",80,7,426,6,364,1,62,2755.492247,0.0011810000000878063,0,0
"147.32.84.165",2978,"205.188.146.193",25,6,372,6,372,0,0,2755.493133,9.029039000000012,329.60318368322436,0
"147.32.84.165",3888,"212.117.174.7",4506,6,372,6,372,0,0,2759.606552,9.028136999999788,329.6361142946845,0
"147.32.84.165",3883,"95.111.235.248",6667,9,552,6,372,3,180,2759.606684,1.3501599999999598,2204.1832079161645,1066.5402618949183
"147.32.84.165",3879,"195.113.232.97",80,65,42931,50,3940,15,38991,2760.957069,12.90298299999995,2442.8459682540174,24174.874910708728
"147.32.84.165",3884,"174.133.57.141",80,17,3489,12,1428,5,2061,2760.95793,3.662999000000127,3118.7559701762416,4501.22973006529
"147.32.84.165",2980,"209.85.225.27",25,6,372,6,372,0,0,2760.95799,8.981537000000117,331.3464054092258,0
"147.32.84.165",3880,"195.113.232.97",80,13,1541,10,1204,3,337,2760.958044,12.902206000000206,746.5390027100673,208.95651487815007
"147.32.84.165",2981,"151.151.26.141",25,6,372,6,372,0,0,2760.958105,8.981543999999758,331.3461471657969,0
"147.32.84.165",3881,"174.36.246.56",80,20,8258,14,2010,6,6248,2761.111354,0.43231299999979456,37195.2728694433,115619.93278023967
"147.32.84.165",2982,"65.54.188.72",25,6,372,6,372,0,0,2761.232251,9.0083810000001,330.35902899754876,0
"147.32.84.165",3897,"119.154.54.142",6667,4,248,4,248,0,0,2764.020541,3.009480000000167,659.2501030077921,0
"147.32.84.165",3882,"95.172.94.15",80,13,2062,10,1486,3,576,2766.127363,0.054513000000042666,218076.422137668,84530.29552577171
"147.32.84.165",2983,"64.12.90.97",25,6,372,6,372,0,0,2766.145096,9.026110999999673,329.7101043849458,0
"147.32.84.165",3894,"74.125.232.205",80,13,2374,10,1868,3,506,2766.829125,7.031340999999884,2125.3413822484567,575.70810461334
"147.32.84.165",2984,"98.139.175.224",25,6,372,6,372,0,0,2766.837254,9.034877999999935,329.3901699613455,0
"147.32.84.165",3918,"77.127.115.2",6667,4,248,4,248,0,0,2774.270049,3.004304999999931,660.3856798827168,0
"147.32.84.165",3909,"212.117.174.7",4506,6,372,6,372,0,0,2775.271313,9.013506999999663,330.17115313718745,0
"147.32.84.165",3910,"67.195.168.31",25,6,372,6,372,0,0,2775.471923,9.012999000000036,330.1897625862366,0
"147.32.84.165",3921,"173.192.170.88",80,17,1643,12,1086,5,557,2776.172521,60.44918099999995,143.72403159606094,73.71481178545667
"147.32.84.165",3919,"174.133.57.141",80,17,3489,12,1428,5,2061,2776.37349,1.1424090000000433,9999.921219107664,14432.659406569253
"147.32.84.165",2985,"212.82.111.207",25,6,372,6,372,0,0,2776.373555,9.012392999999975,330.2119647911502,0
"147.32.84.165",2986,"205.188.59.194",25,6,372,6,372,0,0,2776.573437,9.013303000000178,330.17862597096104,0
"147.32.84.165",3927,"67.195.168.31",25,6,372,6,372,0,0,2781.880955,8.912586999999803,333.9097839942618,0
"147.32.84.165",2987,"207.115.21.22",25,6,372,6,372,0,0,2781.88109,8.91257799999994,333.9101211793064,0
"147.32.84.165",2988,"209.85.225.27",25,6,372,6,372,0,0,2781.981085,8.912733000000117,333.90431419856975,0
"147.32.84.165",2989,"66.94.237.64",25,6,372,6,372,0,0,2782.281452,8.915956999999707,333.78357477499026,0
"147.32.84.165",3937,"212.117.174.7",4506,6,372,6,372,0,0,2787.188507,8.912642000000233,333.9077234337385,0
"147.32.84.165",3933,"180.241.97.224",6667,4,248,4,248,0,0,2787.188642,2.9046109999999317,683.0518785476081,0
"147.32.84.165",3939,"174.133.57.141",80,17,2011,12,1428,5,583,2787.889677,224.76260899999988,50.82695938985121,20.75078243997427
"147.32.84.165",2990,"209.198.87.210",25,6,372,6,372,0,0,2787.889811,9.012690999999904,330.20104650209703,0
"147.32.84.165",3942,"31.192.109.167",80,15,1540,10,1050,5,490,2792.696344,0.23900099999991653,35146.29645902291,16401.60501421069
"147.32.84.165",2992,"205.188.156.193",25,6,372,6,372,0,0,2792.773957,8.935331000000133,333.05984971345276,0
"147.32.84.165",3945,"61.17.216.14",6667,4,248,4,248,0,0,2796.201297,3.0044920000000275,660.3445773861212,0
"147.32.84.165",2994,"65.55.37.88",25,6,372,6,372,0,0,2796.404753,9.010318999999981,330.287973156112,0
"147.32.84.165",3949,"65.54.188.72",25,6,372,6,372,0,0,2797.303007,9.012962000000243,330.1911180808173,0
"147.32.84.165",2995,"209.85.225.27",25,6,372,6,372,0,0,2797.503399,9.012711999999738,330.20027711970454,0
"147.32.84.165",2996,"64.12.90.98",25,6,372,6,372,0,0,2797.503535,9.01270199999999,330.2006434918189,0
"147.32.84.165",3960,"212.117.174.7",4506,6,372,6,372,0,0,2802.810806,9.01306599999998,330.18730807030664,0
"147.32.84.165",2997,"66.180.96.27",25,6,372,6,372,0,0,2802.911097,9.012964999999895,330.19100817544887,0
"147.32.84.165",2998,"216.139.226.17",25,6,372,6,372,0,0,2802.911259,9.012927000000218,330.19240031567193,0
"147.32.84.165",3000,"74.125.67.27",25,6,372,6,372,0,0,2803.211928,9.012461999999687,330.209436666707,0
"147.32.84.165",3964,"190.136.214.243",6667,2,124,2,124,0,0,2808.919651,8.999999863590347e-06,0,0
"147.32.84.165",3970,"65.54.188.72",25,6,372,6,372,0,0,2812.52478,9.013172999999824,330.18338824740835,0
"147.32.84.165",3001,"209.85.225.27",25,6,372,6,372,0,0,2812.52492,9.01306599999998,330.18730807030664,0
"147.32.84.165",3977,"212.117.174.7",4506,6,372,6,372,0,0,2813.726763,9.012934999999743,330.19210723255907,0
"147.32.84.165",3002,"65.54.188.72",25,6,372,6,372,0,0,2813.726907,9.012853999999606,330.195074723293,0
"147.32.84.165",3003,"94.245.120.86",25,6,372,6,372,0,0,2813.72698,9.012844000000314,330.19544108384616,0
"147.32.84.165",3980,"173.192.170.88",80,16,2030,12,1502,4,528,2817.432013,16.743789000000106,717.6392392426782,252.27264868184693
"147.32.84.165",3978,"222.23.80.7",6667,4,248,4,248,0,0,2817.432157,3.0040859999999157,660.4338224671517,0
"147.32.84.165",3004,"64.12.90.97",25,6,372,6,372,0,0,2818.333723,9.01082099999985,330.2695725506088,0
"147.32.84.165",3984,"68.67.185.205",80,16,2456,12,1424,4,1032,2818.53376,15.641837000000123,728.3032037733107,527.8152431840285
"147.32.84.165",3005,"209.85.225.27",25,6,372,6,372,0,0,2818.562926,8.982540999999856,331.30937003238256,0
"147.32.84.165",3006,"216.40.42.4",25,6,372,6,372,0,0,2818.563,8.982500999999957,331.31084538704914,0
"147.32.84.165",3986,"68.67.179.209",80,16,2682,12,1800,4,882,2822.739541,11.435821999999916,1259.2011313222702,617.0085543479123
"147.32.84.165",3007,"209.85.225.27",25,6,372,6,372,0,0,2822.765421,8.993521999999757,330.90484462039234,0
"147.32.84.165",3008,"66.111.46.54",25,6,372,6,372,0,0,2822.765495,8.993643999999676,330.900355851322,0
"147.32.84.165",3992,"217.163.21.39",80,22,6719,14,1570,8,5149,2823.841259,0.19324200000028213,64996.22235322374,213162.76999792934
"147.32.84.165",3011,"68.1.17.3",25,6,372,6,372,0,0,2823.887167,8.975476000000072,331.57015850746814,0
"147.32.84.165",3012,"64.12.90.98",25,6,372,6,372,0,0,2823.941398,9.021191000000272,329.8899225168728,0
"147.32.84.165",3013,"65.55.37.72",25,6,372,6,372,0,0,2823.941477,9.021242000000257,329.88805754239996,0
"147.32.84.165",3995,"217.163.21.39",80,15,2336,10,1450,5,886,2824.234182,0.14015999999992346,82762.55707767078,50570.77625573538
"147.32.84.165",3994,"190.246.180.21",6667,4,248,4,248,0,0,2824.280214,2.9645650000002206,669.2381512970207,0
"147.32.84.165",4007,"212.117.174.7",4506,6,372,6,372,0,0,2831.458218,9.027290999999877,329.6670064142211,0
"147.32.84.165",4005,"74.125.127.27",25,6,372,6,372,0,0,2833.564704,9.024025000000165,329.7863204057996,0
"147.32.84.165",4012,"74.125.127.27",25,6,372,6,372,0,0,2834.777353,9.0133679999999,330.1762448842689,0
"147.32.84.165",4002,"174.133.57.141",80,17,2011,12,1428,5,583,2834.777449,265.2034429999999,43.07636383137004,17.586498679053733
"147.32.84.165",3015,"205.188.156.193",25,6,372,6,372,0,0,2834.777478,9.013366000000133,330.17631814795453,0
"147.32.84.165",4013,"61.17.216.70",6667,2,124,2,124,0,0,2839.384936,7.999999979801942e-06,0,0
"147.32.84.165",4017,"173.192.170.88",80,11,1283,8,846,3,437,2839.584289,44.672156000000086,151.50376892487543,78.25903903093446
"147.32.84.165",3016,"209.85.225.27",25,6,372,6,372,0,0,2839.785256,8.911957999999686,333.9333511221782,0
"147.32.84.165",4021,"212.117.174.7",4506,6,372,6,372,0,0,2842.288065,8.912970999999743,333.8953980664905,0
"147.32.84.165",3017,"216.32.181.178",25,6,372,6,372,0,0,2842.288197,8.912978000000294,333.89513583449906,0
"147.32.84.165",3018,"66.94.237.64",25,6,372,6,372,0,0,2843.790912,8.9120640000001,333.9293793222273,0
"147.32.84.165",4027,"222.85.179.42",6667,4,248,4,248,0,0,2844.891879,3.00419600000032,660.409640382914,0
"147.32.84.165",3019,"77.238.177.9",25,6,372,6,372,0,0,2844.991874,9.013042000000041,330.18818729569733,0
"147.32.84.165",3020,"209.85.225.27",25,6,372,6,372,0,0,2844.992024,9.013017999999647,330.1890665257871,0
"147.32.84.165",3024,"205.188.59.194",25,6,372,6,372,0,0,2844.992096,9.012995000000046,330.1899091256552,0
"147.32.84.165",3025,"216.32.180.22",25,6,372,6,372,0,0,2852.402599,9.012988999999834,330.1901289350353,0
"147.32.84.165",3026,"209.85.225.27",25,6,372,6,372,0,0,2852.502757,9.012965999999778,330.19097154034233,0
"147.32.84.165",3027,"205.188.59.193",25,6,372,6,372,0,0,2852.502905,9.012942000000294,330.19185078522673,0
"147.32.84.165",4036,"123.192.69.237",6667,4,248,4,248,0,0,2854.505601,3.0043009999999413,660.3865591363978,0
"147.32.84.165",4041,"64.12.90.1",25,6,372,6,372,0,0,2855.707369,9.013080999999602,330.1867585568277,0
"147.32.84.165",4045,"64.12.90.1",25,6,372,6,372,0,0,2860.714874,9.012836000000334,330.19573417289405,0
"147.32.84.165",3028,"173.186.244.141",25,6,372,6,372,0,0,2860.715011,9.012789000000339,330.19745608156234,0
"147.32.84.165",4049,"212.117.174.7",4506,6,372,6,372,0,0,2862.717874,9.012635000000046,330.2030982060169,0
"147.32.84.165",3029,"66.94.237.64",25,6,372,6,372,0,0,2863.218751,9.012567000000217,330.2055895950541,0
"147.32.84.165",4040,"212.117.171.138",65500,49,4421,32,3334,17,1087,2863.218886,30.71381799999972,868.4039216485636,283.1298928710224
"147.32.84.165",3030,"209.85.225.27",25,6,372,6,372,0,0,2863.218943,9.01250200000004,330.20797110502576,0
"147.32.84.165",4057,"64.12.175.136",587,44,5345,28,3572,16,1773,2864.720585,32.40882699999975,881.7350902579789,437.6585428408165
"147.32.84.165",3037,"209.85.225.27",25,6,372,6,372,0,0,2864.838442,8.995260999999573,330.8408727662423,0
"147.32.84.165",4059,"95.58.236.6",6667,4,248,4,248,0,0,2864.838505,2.986546999999973,664.3123312641716,0
"147.32.84.165",3038,"64.12.90.98",25,6,372,6,372,0,0,2866.022273,9.016369999999824,330.06631271787404,0
"147.32.84.165",3040,"216.32.180.22",25,6,372,6,372,0,0,2866.022412,9.016352999999981,330.0669350456893,0
"147.32.84.165",3041,"205.188.190.2",25,6,372,6,372,0,0,2866.022471,9.016347999999653,330.0671180837424,0
"147.32.84.165",4065,"212.117.174.7",4506,6,372,6,372,0,0,2872.932212,9.013075999999728,330.18694172778413,0
"147.32.84.165",4063,"174.133.57.141",80,16,3429,12,1428,4,2001,2872.932346,0.4717329999998583,24217.088904111926,33934.450208072805
"147.32.84.165",3042,"207.115.37.20",25,6,372,6,372,0,0,2872.932409,9.013002000000142,330.1896526817539,0
"147.32.84.165",3043,"98.139.175.225",25,6,372,6,372,0,0,2873.432791,9.015857999999753,330.0850567966001,0
"147.32.84.165",3044,"207.115.36.22",25,6,372,6,372,0,0,2873.535648,9.010830000000169,330.2692426779713,0
"147.32.84.165",4073,"210.212.249.136",6667,4,248,4,248,0,0,2876.738074,3.0038320000003296,660.4896678641755,0
"147.32.84.165",4078,"217.72.192.149",25,6,372,6,372,0,0,2881.745013,9.0126479999999,330.2026219153387,0
"147.32.84.165",4085,"217.72.192.149",25,6,372,6,372,0,0,2882.546334,9.01288199999999,330.1940489179824,0
"147.32.84.165",3045,"66.94.237.64",25,6,372,6,372,0,0,2882.546448,9.012893000000076,330.1936459247852,0
"147.32.84.165",4087,"174.133.57.141",80,17,3489,12,1428,5,2061,2883.748149,7.133898000000045,1601.3685645631504,2311.2189156615214
"147.32.84.165",3047,"208.65.144.13",25,6,372,6,372,0,0,2883.748287,9.012723000000278,330.1998741112878,0
"147.32.84.165",4091,"116.111.222.15",6667,4,248,4,248,0,0,2884.248884,3.003707999999733,660.5169344024706,0
"147.32.84.165",3048,"213.154.78.2",25,6,372,6,372,0,0,2887.052374,9.013284000000112,330.17932198740914,0
"147.32.84.165",3049,"207.115.37.20",25,6,372,6,372,0,0,2887.052519,9.013275000000249,330.1796516804289,0
"147.32.84.165",4096,"212.117.171.138",65500,24,1471,18,1092,6,379,2887.052575,225.73545299999978,38.70016820087188,13.431651784002236
"147.32.84.165",3050,"208.65.145.12",25,6,372,6,372,0,0,2887.052628,9.013229000000138,330.18133678839786,0
"147.32.84.165",4099,"64.12.175.136",587,24,2251,16,1068,8,1183,2892.760818,1.2675689999996393,6740.461466004952,7466.260219366908
"147.32.84.165",4101,"212.117.174.7",4506,6,372,6,372,0,0,2892.760949,9.012631000000056,330.2032447572725,0
"147.32.84.165",3051,"209.85.225.27",25,6,372,6,372,0,0,2893.962789,9.012992999999824,330.1899823954216,0
"147.32.84.165",4110,"210.75.13.174",6667,4,248,4,248,0,0,2894.463058,3.0054770000001554,660.128159357033,0
"147.32.84.165",3052,"205.188.156.193",25,6,372,6,372,0,0,2894.563287,9.01298799999995,330.1901655699549,0
"147.32.84.165",4123,"212.117.174.7",4506,6,372,6,372,0,0,2902.775298,9.01282399999991,330.19617380745814,0
"147.32.84.165",4119,"173.192.170.88",80,38,6049,24,1886,14,4163,2902.775432,36.383628000000044,414.6920147710388,915.3567643116833
"147.32.84.165",4125,"174.133.57.141",80,16,3429,12,1428,4,2001,2902.975643,0.47027299999990646,24292.27278623751,34039.802412647936
"147.32.84.165",3053,"205.188.159.42",25,6,372,6,372,0,0,2902.975745,9.012677999999596,330.20152278824713,0
"147.32.84.165",3054,"208.65.145.12",25,6,372,6,372,0,0,2902.976147,9.012369999999919,330.212807507906,0
"147.32.84.165",3055,"209.85.225.27",25,6,372,6,372,0,0,2902.976182,9.01236199999994,330.2131006277844,0
"147.32.84.165",3058,"94.245.120.86",25,6,372,6,372,0,0,2902.976219,9.012351999999737,330.21346702837246,0
"147.32.84.165",3061,"205.188.59.193",25,6,372,6,372,0,0,2903.576457,9.013077000000067,330.18690509356327,0
"147.32.84.165",4129,"202.112.126.218",6667,15,1712,10,1154,5,558,2904.777946,1.1969709999998486,7712.801730368712,3729.4136616514224
"147.32.84.165",3062,"193.92.150.20",25,6,372,6,372,0,0,2904.990727,9.000418000000082,330.6513097502775,0
"147.32.84.165",3063,"65.254.254.55",25,6,372,6,372,0,0,2908.082664,8.913382000000183,333.8800020014781,0
"147.32.84.165",3064,"64.12.90.1",25,6,372,6,372,0,0,2908.082808,8.913379999999961,333.8800769180729,0
"147.32.84.165",4134,"62.209.146.67",6667,4,248,4,248,0,0,2912.589394,2.9038869999999406,683.2221777224943,0
"147.32.84.165",4139,"174.133.57.141",80,17,3489,12,1428,5,2061,2913.791412,1.7591919999999845,6493.890376945837,9372.48464067603
"147.32.84.165",3066,"69.36.48.22",25,6,372,6,372,0,0,2913.791548,8.91225600000007,333.9221853591253,0
"147.32.84.165",4140,"31.192.109.167",80,15,1540,10,1050,5,490,2914.893015,0.23311199999989185,36034.18099456011,16815.951130794718
"147.32.84.165",3067,"209.85.225.27",25,6,372,6,372,0,0,2914.969092,8.936697999999978,333.00890328844133,0
"147.32.84.165",3070,"207.115.36.22",25,6,372,6,372,0,0,2915.493429,9.013516999999865,330.17078683049516,0
"147.32.84.165",4144,"208.73.210.29",80,75,40000,46,6752,29,33248,2923.905928,12.588279000000057,4290.975756098173,21129.49673263508
"147.32.84.165",4145,"200.168.146.138",6667,2,124,2,124,0,0,2923.905999,7.000000096013537e-06,0,0
"147.32.84.165",4146,"212.117.174.7",4506,6,372,6,372,0,0,2924.087191,8.931377999999768,333.2072609624268,0
"147.32.84.165",3071,"74.6.140.64",25,6,372,6,372,0,0,2924.507083,9.012177999999949,330.2198425286337,0
"147.32.84.165",4155,"74.125.232.217",80,13,2934,10,2060,3,874,2925.9089,10.585524000000078,1556.8431000675903,660.5246939121719
"147.32.84.165",4157,"174.133.57.141",80,17,3489,12,1428,5,2061,2925.917243,9.109635000000253,1254.0568310365545,1809.951770844775
"147.32.84.165",3072,"62.201.162.100",25,6,372,6,372,0,0,2925.917312,9.004950000000008,330.48489997168195,0
"147.32.84.165",4158,"67.214.158.5",80,15,2565,10,1710,5,855,2927.611247,0.31832500000018626,42974.9469881159,21487.47349405795
"147.32.84.165",3073,"66.94.237.64",25,6,372,6,372,0,0,2927.715654,9.008362000000034,330.35972577478447,0
"147.32.84.165",4165,"212.117.174.7",4506,6,372,6,372,0,0,2929.012703,9.013091000000259,330.1863922154913,0
"147.32.84.165",4159,"50.22.198.84",80,14,3404,10,2316,4,1088,2929.012842,0.3714230000000498,49883.825180447944,23434.197666808013
"147.32.84.165",4166,"186.90.182.143",6667,4,248,4,248,0,0,2929.012906,3.0042480000001888,660.3982094686842,0
"147.32.84.165",3075,"205.188.156.193",25,6,372,6,372,0,0,2929.133967,8.991971999999805,330.9618846677975,0
"147.32.84.165",4160,"94.127.76.180",80,7,424,6,364,1,60,2934.720934,0.014779000000089582,197036.33533949178,32478.516814201943
"147.32.84.165",3076,"77.238.184.241",25,6,372,6,372,0,0,2934.735417,8.998553000000356,330.71983906744583,0
"147.32.84.165",4161,"195.113.232.88",80,13,2130,10,1542,3,588,2935.922816,0.5717940000004091,21574.203296976135,8226.739000403351
"147.32.84.165",3079,"66.94.237.64",25,6,372,6,372,0,0,2935.923588,9.012406999999712,330.2114518352417,0
"147.32.84.165",4164,"67.214.158.5",80,15,2650,10,1754,5,896,2935.923649,0.32447799999999916,43244.84248546908,22090.8659446866
"147.32.84.165",3080,"209.85.225.27",25,6,372,6,372,0,0,2936.027188,9.008820999999898,330.3428939258571,0
"147.32.84.165",3081,"66.94.237.64",25,6,372,6,372,0,0,2936.523687,9.012904000000162,330.1932429325716,0
"147.32.84.165",3082,"209.85.225.27",25,6,372,6,372,0,0,2936.523818,9.01290999999992,330.19302311906216,0
"147.32.84.165",3083,"205.188.159.42",25,6,372,6,372,0,0,2936.523877,9.01292199999989,330.1925834929046,0
"147.32.84.165",3084,"74.6.140.64",25,6,372,6,372,0,0,2937.22461,9.013158999999632,330.1839011161482,0
"147.32.84.165",3085,"64.12.90.97",25,6,372,6,372,0,0,2937.224755,9.013152999999875,330.1841209175126,0
"147.32.84.165",4182,"217.219.211.243",6667,2,124,2,124,0,0,2945.036147,7.999999979801942e-06,0,0
"147.32.84.165",4183,"173.192.170.88",80,21,3571,14,1204,7,2367,2945.536886,38.80344000000014,248.22541506629221,487.9979713138818
"147.32.84.165",4191,"174.133.57.141",80,16,3429,12,1428,4,2001,2945.738325,0.46559300000035364,24536.45136415565,34381.96020985676
"147.32.84.165",3087,"209.85.225.27",25,6,372,6,372,0,0,2945.738401,9.011422999999922,330.24750918917306,0
"147.32.84.165",3088,"66.94.237.64",25,6,372,6,372,0,0,2945.738471,9.011478999999781,330.24545693332607,0
"147.32.84.165",3089,"64.20.45.186",25,6,372,6,372,0,0,2945.738567,9.01143200000024,330.2471793606078,0
"147.32.84.165",3090,"77.238.177.9",25,6,372,6,372,0,0,2946.938944,9.012902999999824,330.1932795681989,0
"147.32.84.165",3092,"74.55.28.130",25,6,372,6,372,0,0,2947.439917,9.012570999999753,330.20544304173376,0
"147.32.84.165",3093,"65.55.37.72",25,6,372,6,372,0,0,2948.741656,9.014126999999917,330.14844365960533,0
"147.32.84.165",4197,"27.255.33.216",6667,4,248,4,248,0,0,2950.14307,3.004529999999704,660.3362256326931,0
"147.32.84.165",4200,"212.117.174.7",4506,6,372,6,372,0,0,2955.751555,9.012564999999995,330.20566287177974,0
"147.32.84.165",4210,"174.133.57.141",80,17,3489,12,1428,5,2061,2957.053111,3.022364999999809,3779.821431230418,5455.330511040541
"147.32.84.165",3095,"205.188.156.193",25,6,372,6,372,0,0,2957.053247,9.012841000000208,330.1955509921823,0
"147.32.84.165",4208,"212.117.174.7",4506,6,372,6,372,0,0,2957.553812,9.013235999999779,330.18108035782853,0
"147.32.84.165",3097,"64.12.90.98",25,6,372,6,372,0,0,2957.554063,9.013090999999804,330.18639221550796,0
"147.32.84.165",3098,"66.94.237.64",25,6,372,6,372,0,0,2957.654337,9.012576999999965,330.20522321196387,0
"147.32.84.165",3099,"209.85.225.27",25,6,372,6,372,0,0,2958.255046,9.01283599999988,330.1957341729107,0
"147.32.84.165",4214,"61.177.120.254",6667,7,426,6,364,1,62,2966.767281,0.2862430000000131,10173.174540512315,1732.793465691658
"147.32.84.165",4221,"98.126.71.122",80,15,4683,12,1310,3,3373,2967.053226,14.473313999999846,724.0912482103347,1864.3967787888998
"147.32.84.165",3101,"151.193.220.18",25,6,372,6,372,0,0,2967.228449,8.858570999999756,335.9458314439295,0
"147.32.84.165",3102,"202.54.110.181",25,6,372,6,372,0,0,2967.267765,8.919495999999981,333.6511390329685,0
"147.32.84.165",4229,"195.113.232.98",80,23,7904,16,3984,7,3920,2967.960748,13.566037000000051,2349.3965113024447,2311.655201883931
"147.32.84.165",3103,"218.102.53.145",25,6,372,6,372,0,0,2967.960896,8.928238999999849,333.3244103344512,0
"147.32.84.165",4230,"195.113.232.89",80,13,2792,10,1770,3,1022,2968.462542,13.064448999999968,1083.8574210056647,625.8204995863216
"147.32.84.165",3104,"205.188.156.193",25,6,372,6,372,0,0,2968.463408,8.92771700000003,333.34389967782244,0
"147.32.84.165",3106,"64.12.90.98",25,6,372,6,372,0,0,2968.463528,8.927719999999681,333.3437876636035,0
"147.32.84.165",3107,"66.94.237.64",25,6,372,6,372,0,0,2968.463598,8.927706000000398,333.34431039730333,0
"147.32.84.165",3108,"209.85.225.27",25,6,372,6,372,0,0,2968.463668,8.9276890000001,333.3449451476151,0
"147.32.84.165",3109,"62.129.144.89",25,6,372,6,372,0,0,2968.463737,8.927670000000035,333.34565457728485,0
"147.32.84.165",4231,"112.205.111.114",6667,4,248,4,248,0,0,2969.766524,3.0094859999999244,659.2487886635956,0
"147.32.84.165",4233,"174.133.57.141",80,17,3489,12,1428,5,2061,2976.688494,5.647943999999825,2022.6829444485204,2919.292400916247
"147.32.84.165",3110,"192.118.82.172",25,6,372,6,372,0,0,2976.688591,9.032526999999845,329.4759041406741,0
"147.32.84.165",3112,"205.188.156.193",25,6,372,6,372,0,0,2977.992376,9.030507999999827,329.5495668682268,0
"147.32.84.165",3113,"64.12.90.98",25,6,372,6,372,0,0,2978.494465,9.032754999999725,329.46758768505185,0
"147.32.84.165",3114,"66.94.237.64",25,6,372,6,372,0,0,2978.59491,9.032600000000002,329.47324137014806,0
"147.32.84.165",4245,"91.214.162.182",6667,4,248,4,248,0,0,2979.197453,3.0186139999996158,657.2552833851074,0
"147.32.84.165",4252,"212.117.174.7",4506,6,372,6,372,0,0,2986.021497,9.013410999999905,330.17466972270887,0
"147.32.84.165",4257,"173.192.170.88",80,17,3287,12,1086,5,2201,2988.124857,33.53908000000001,259.04109474678484,524.9994931286127
"147.32.84.165",3117,"209.85.225.27",25,6,372,6,372,0,0,2988.224929,9.012876000000233,330.19426873285767,0
"147.32.84.165",4254,"212.117.174.7",4506,6,372,6,372,0,0,2988.325644,9.012147999999797,330.2209417777057,0
"147.32.84.165",3118,"68.1.17.3",25,6,372,6,372,0,0,2988.325706,9.012209999999868,330.2186700043656,0
"147.32.84.165",4263,"59.94.130.46",6667,4,248,4,248,0,0,2988.925876,3.0042630000002646,660.3949121630914,0
"147.32.84.165",3120,"67.69.240.24",25,6,372,6,372,0,0,2989.426514,9.01281199999994,330.1966134431762,0
"147.32.84.165",4269,"174.133.57.141",80,14,1831,10,1308,4,523,2997.437795,42.361495000000104,247.0167778545109,98.76894099228532
"147.32.84.165",3121,"77.238.184.241",25,6,372,6,372,0,0,2997.59751,8.95370099999991,332.3765222895013,0
"147.32.84.165",3122,"207.115.36.22",25,6,372,6,372,0,0,2997.738765,9.012991000000056,330.1900556652039,0
"147.32.84.165",4281,"61.28.22.201",6667,4,248,4,248,0,0,2999.04024,3.004370000000108,660.3713923384698,0
"147.32.84.165",4280,"173.192.170.88",80,18,2147,14,1618,4,529,2999.540973,19.04661299999998,679.5958945561615,222.19173561199594
"147.32.84.165",3123,"205.188.156.193",25,6,372,6,372,0,0,2999.541105,9.006227000000308,330.43804025813455,0
"147.32.84.165",3124,"207.130.95.53",25,6,372,6,372,0,0,2999.640987,9.00706799999989,330.4071868892337,0
"147.32.84.165",4289,"174.36.246.56",80,26,14051,20,1948,6,12103,3007.051822,0.4619990000001053,33731.67474387704,209576.21120387258
"147.32.84.165",3126,"64.12.90.98",25,6,372,6,372,0,0,3007.172646,8.998916000000008,330.7064984271436,0
"147.32.84.165",4294,"195.113.232.82",80,7,426,6,364,1,62,3007.644336,0.0016680000003361783,0,0
"147.32.84.165",3129,"209.85.225.27",25,6,372,6,372,0,0,3007.645554,9.02777100000003,329.6494782599149,0
"147.32.84.165",4295,"195.113.232.82",80,63,45498,48,3954,15,41544,3007.645637,11.083658999999898,2853.931179225226,29985.76553104016
"147.32.84.165",3130,"94.100.245.171",25,6,372,6,372,0,0,3007.645709,9.027745000000323,329.6504276538486,0
"147.32.84.165",4299,"61.17.216.89",6667,4,248,4,248,0,0,3009.249677,3.008821000000353,659.394493723544,0
"147.32.84.165",4296,"195.113.232.82",80,13,1541,10,1204,3,337,3009.350094,9.379398000000037,1026.9315791908991,287.4384901888148
"147.32.84.165",3131,"209.85.225.27",25,6,372,6,372,0,0,3009.350224,9.028275000000122,329.631075703826,0
"147.32.84.165",4297,"95.172.94.15",80,13,2062,10,1486,3,576,3010.453189,0.05476100000032602,217088.80407460098,84147.47721868787
"147.32.84.165",3133,"205.188.156.193",25,6,372,6,372,0,0,3010.47104,9.018344999999954,329.99402883788713,0
"147.32.84.165",4298,"174.36.246.56",80,17,7117,12,1890,5,5227,3010.471103,0.40457800000012867,37372.2743203911,103357.0782395155
"147.32.84.165",3134,"66.94.237.64",25,6,372,6,372,0,0,3010.591975,8.9975000000004,330.7585440399964,0
"147.32.84.165",4310,"212.117.174.7",4506,6,372,6,372,0,0,3015.669763,8.926940000000286,333.37291389881693,0
"147.32.84.165",4307,"212.117.174.7",4506,6,372,6,372,0,0,3018.579331,8.921478000000207,333.5770149295813,0
"147.32.84.165",4303,"74.125.232.202",80,11,2254,8,1748,3,506,3018.579433,0.15024700000003577,93073.40579177401,26942.301676566163
"147.32.84.165",3139,"66.94.237.64",25,6,372,6,372,0,0,3018.587386,8.91354599999977,333.8738589558047,0
"147.32.84.165",4304,"174.36.246.56",80,5,304,4,244,1,60,3018.587418,0.1208729999998468,16149.181372204497,3971.110173492909
"147.32.84.165",3140,"209.85.225.27",25,6,372,6,372,0,0,3018.78907,9.01450900000009,330.13445324642424,0
"147.32.84.165",3142,"64.12.90.1",25,6,372,6,372,0,0,3018.789199,9.014504000000215,330.13463635935256,0
"147.32.84.165",4316,"14.97.39.52",6667,4,248,4,248,0,0,3020.590979,2.9046589999998105,683.0405909954076,0
"147.32.84.165",3143,"209.85.229.27",25,6,372,6,372,0,0,3020.691649,8.912354999999934,333.91847609302164,0
"147.32.84.165",4320,"173.192.170.88",80,17,1643,12,1086,5,557,3027.100316,44.22598400000015,196.44560084858642,100.75524831736891
"147.32.84.165",3146,"64.12.90.97",25,6,372,6,372,0,0,3027.301231,9.012552000000142,330.2061391712307,0
"147.32.84.165",3148,"129.104.30.35",25,6,372,6,372,0,0,3028.102225,9.012570999999753,330.20544304173376,0
"147.32.84.165",3149,"209.85.225.27",25,6,372,6,372,0,0,3028.602808,9.01591099999996,330.08311639278753,0
"147.32.84.165",3150,"64.12.90.1",25,6,372,6,372,0,0,3028.60294,9.015903999999864,330.0833726712313,0
"147.32.84.165",3151,"124.108.110.37",25,6,372,6,372,0,0,3028.602999,9.015892999999778,330.08377539530176,0
"147.32.84.165",4331,"95.155.98.55",6667,9,552,6,372,3,180,3030.104994,1.0488330000002861,2837.439325420909,1372.9545123004398
"147.32.84.165",3152,"205.188.59.193",25,6,372,6,372,0,0,3030.30545,9.01261999999997,330.20364777390034,0
"147.32.84.165",3153,"207.115.20.23",25,6,372,6,372,0,0,3031.154049,8.965173999999934,331.9511701613401,0
"147.32.84.165",3155,"216.99.131.14",25,6,372,6,372,0,0,3031.507244,9.012853000000177,330.1951113592934,0
"147.32.84.165",4341,"31.192.109.167",80,15,1540,10,1050,5,490,3036.614213,0.2371339999999691,35423.0097750685,16530.73789503197
"147.32.84.165",4338,"85.185.8.55",6667,4,248,4,248,0,0,3036.692019,2.9264969999999266,677.9436302173041,0
"147.32.84.165",4334,"174.133.57.141",80,16,3429,12,1428,4,2001,3037.31504,0.5002469999999448,22836.718660983996,32000.191905202362
"147.32.84.165",3156,"66.94.237.64",25,6,372,6,372,0,0,3037.315173,9.012847999999849,330.195294539534,0
"147.32.84.165",3157,"68.190.16.163",25,6,372,6,372,0,0,3039.818574,9.012962000000243,330.1911180808173,0
"147.32.84.165",3158,"209.85.225.27",25,6,372,6,372,0,0,3041.625557,9.008735000000343,330.3460474750214,0
"147.32.84.165",4363,"173.192.170.88",80,16,2030,12,1502,4,528,3048.330984,10.01866999999993,1199.360793398733,421.61284881127233
"147.32.84.165",4350,"212.117.174.7",4506,6,372,6,372,0,0,3048.331094,9.013228999999683,330.1813367884145,0
"147.32.84.165",4355,"111.88.1.3",6667,2,124,2,124,0,0,3049.132002,9.000000318337698e-06,0,0
"147.32.84.165",4356,"212.117.174.7",4506,6,372,6,372,0,0,3049.632666,9.016877999999906,330.0477171810499,0
"147.32.84.165",4361,"174.133.57.141",80,16,3429,12,1428,4,2001,3049.632797,0.5702809999997953,20032.229725353114,28070.3723252322
"147.32.84.165",3159,"64.12.90.1",25,6,372,6,372,0,0,3049.78854,8.960853000000043,332.11123985629337,0
"147.32.84.165",4367,"68.67.179.210",80,16,2456,12,1424,4,1032,3051.335267,16.785143999999946,678.6953987406981,491.863519312079
"147.32.84.165",3160,"205.188.156.193",25,6,372,6,372,0,0,3051.359396,8.996241000000282,330.80483281849683,0
"147.32.84.165",4370,"68.67.185.208",80,16,2682,12,1800,4,882,3052.136882,15.983296000000337,900.9405819675552,441.460885164102
"147.32.84.165",3162,"65.55.37.120",25,6,372,6,372,0,0,3052.166324,8.991391000000021,330.98327055290923,0
"147.32.84.165",4373,"217.163.21.39",80,19,6539,12,1450,7,5089,3052.537231,0.1870850000000246,62003.90196968477,217612.31525774192
"147.32.84.165",3164,"124.108.110.37",25,6,372,6,372,0,0,3052.583223,8.975680999999895,331.5625856132849,0
"147.32.84.165",4374,"217.163.21.39",80,15,2336,10,1450,5,886,3052.929551,0.1418559999997342,81773.06564418662,49966.1628694823
"147.32.84.165",3165,"64.12.90.98",25,6,372,6,372,0,0,3052.975511,8.984743999999864,331.22813515889214,0
"147.32.84.165",4375,"195.113.232.88",80,13,1772,10,1228,3,544,3058.348421,9.883371999999781,993.9927385107246,440.3355453988878
"147.32.84.165",4378,"61.17.216.82",6667,2,124,2,124,0,0,3058.349218,9.000000318337698e-06,0,0
"147.32.84.165",4383,"174.133.57.141",80,17,3489,12,1428,5,2061,3060.856238,11.255963000000065,1014.9287093427665,1464.8235784001693
"147.32.84.165",3166,"205.188.156.193",25,6,372,6,372,0,0,3061.011093,8.892549000000145,334.6621986564203,0
"147.32.84.165",4376,"77.238.167.32",80,13,2615,10,1564,3,1051,3061.011178,0.14051599999993414,89043.24062744359,59836.60223749567
"147.32.84.165",3167,"66.94.237.64",25,6,372,6,372,0,0,3061.057014,8.946240000000216,332.65371821010035,0
"147.32.84.165",4384,"217.163.21.39",80,17,3594,12,1662,5,1932,3061.458813,0.26363599999967846,50433.17301133463,58626.28776046841
"147.32.84.165",3169,"24.123.86.246",25,6,372,6,372,0,0,3061.504651,8.899140999999872,334.41429908797295,0
"147.32.84.165",4385,"195.113.232.96",80,49,34513,40,3040,9,31473,3062.662934,5.568644999999833,4367.310180483893,45214.58990472683
"147.32.84.165",3170,"207.115.36.22",25,6,372,6,372,0,0,3062.664096,8.941568000000188,332.82753092074427,0
"147.32.84.165",4391,"93.180.230.38",6667,2,124,2,124,0,0,3069.302247,8.999999863590347e-06,0,0
"147.32.84.165",3171,"209.85.225.27",25,6,372,6,372,0,0,3070.704121,9.014432999999826,330.1372365849363,0
"147.32.84.165",4401,"173.192.170.88",80,11,1283,8,846,3,437,3071.506113,8.323663000000124,813.1035578927089,420.00739337956713
"147.32.84.165",3174,"64.12.90.97",25,6,372,6,372,0,0,3071.70704,9.01210600000013,330.2224807386816,0
"147.32.84.165",3177,"64.12.90.1",25,6,372,6,372,0,0,3072.306573,9.0131650000003,330.1836813150432,0
"147.32.84.165",3178,"66.94.237.64",25,6,372,6,372,0,0,3073.108499,9.012428999999884,330.21064576486964,0
"147.32.84.165",3179,"65.55.92.136",25,6,372,6,372,0,0,3073.108647,9.012605999999778,330.20416070557985,0
"147.32.84.165",3181,"204.232.236.151",25,6,372,6,372,0,0,3073.508463,9.012848999999733,330.19525790347626,0
"147.32.84.165",3182,"65.254.254.54",25,6,372,6,372,0,0,3073.909149,9.012889000000087,330.19379246765067,0
"147.32.84.165",4409,"212.117.174.7",4506,6,372,6,372,0,0,3082.02058,9.012911000000258,330.19298648349184,0
"147.32.84.165",4408,"60.190.222.152",6667,8,490,6,364,2,126,3082.421142,0.6557499999998981,4440.716736561879,1537.1711780406506
"147.32.84.165",4411,"212.117.174.7",4506,6,372,6,372,0,0,3082.749101,8.985310000000027,331.2072705337925,0
"147.32.84.165",4418,"174.133.57.141",80,15,1891,10,1308,5,583,3082.749165,11.629717999999684,899.7638635778,401.04153858245974
"147.32.84.165",3183,"205.188.156.193",25,6,372,6,372,0,0,3082.917134,8.917356000000382,333.7312091162305,0
"147.32.84.165",3184,"66.94.237.64",25,6,372,6,372,0,0,3082.921897,9.012774999999692,330.1979689940226,0
"147.32.84.165",4414,"212.117.171.138",65500,125,49350,86,6678,39,42672,3083.626652,42.45338200000015,1258.4156428338222,8041.1968120702095
"147.32.84.165",3185,"193.252.22.92",25,6,372,6,372,0,0,3083.626877,9.00930100000005,330.32529382689995,0
"147.32.84.165",4425,"76.96.62.116",25,6,372,6,372,0,0,3091.734546,9.012794999999642,330.19723626246,0
"147.32.84.165",3188,"209.85.225.27",25,6,372,6,372,0,0,3092.736006,9.01283199999989,330.1958807176298,0
"147.32.84.165",4426,"61.177.181.139",6667,6,372,6,372,0,0,3093.336792,9.01326999999992,330.17983484351697,0
"147.32.84.165",3189,"67.69.240.22",25,6,372,6,372,0,0,3094.138109,9.0130079999999,330.18943287302454,0
"147.32.84.165",4439,"41.251.251.106",6667,9,552,6,372,3,180,3094.538568,1.4183659999998781,2098.189042884739,1015.252762686164
"147.32.84.165",3190,"69.210.160.130",25,6,372,6,372,0,0,3094.939405,9.015363999999863,330.10314392186996,0
"147.32.84.165",3191,"207.115.11.16",25,6,372,6,372,0,0,3095.957206,8.99654099999998,330.79380175114045,0
"147.32.84.165",4443,"59.48.7.167",6667,9,552,6,372,3,180,3103.050652,1.9403919999999744,1533.7107141237643,742.1180874792408
"147.32.84.165",3192,"205.188.156.193",25,6,372,6,372,0,0,3103.854605,9.010229999999865,330.2912356288402,0
"147.32.84.165",3193,"207.115.20.23",25,6,372,6,372,0,0,3103.954908,9.010076000000026,330.2968809586058,0
"147.32.84.165",4449,"212.117.171.138",65500,344,333190,252,326294,92,6896,3104.65314,73.9430870000001,35302.17774110508,746.0873252424519
"147.32.84.165",3194,"209.85.225.27",25,6,372,6,372,0,0,3104.653199,9.01288599999998,330.1939023748893,0
"147.32.84.165",4452,"205.188.186.167",587,72,28700,46,26258,26,2442,3104.653256,21.45078199999989,9792.83645696465,910.7360281783713
"147.32.84.165",3195,"66.94.237.64",25,6,372,6,372,0,0,3104.770938,8.995253000000048,330.84116700219374,0
"147.32.84.165",3196,"216.82.254.163",25,6,372,6,372,0,0,3104.99127,8.975483000000168,331.56989991512927,0
"147.32.84.165",4461,"212.117.174.7",4506,6,372,6,372,0,0,3112.764685,9.013004999999794,330.18954277736094,0
"147.32.84.165",4460,"178.123.29.226",6667,2,124,2,124,0,0,3113.766326,6.000000212225132e-06,0,0
"147.32.84.165",4462,"212.117.174.7",4506,6,372,6,372,0,0,3114.367041,9.012799000000086,330.1970897165211,0
"147.32.84.165",3198,"209.85.225.27",25,6,372,6,372,0,0,3114.367174,9.012790000000223,330.19741944502493,0
"147.32.84.165",3199,"114.147.37.227",25,6,372,6,372,0,0,3115.168178,9.013280000000123,330.1794685175607,0
"147.32.84.165",3200,"193.222.78.6",25,6,372,6,372,0,0,3115.969715,9.012653999999657,330.20240208934166,0
"147.32.84.165",3201,"205.188.156.193",25,6,372,6,372,0,0,3116.970987,9.07069999999976,328.08934260862765,0
"147.32.84.165",3202,"209.191.88.254",25,6,372,6,372,0,0,3116.971119,9.073765999999978,327.97848214291696,0
"147.32.84.165",4475,"62.24.74.140",6667,3,184,2,124,1,60,3124.882196,0.008229000000028464,120549.27694696424,58330.29529691818
"147.32.84.165",3203,"64.12.90.1",25,6,372,6,372,0,0,3124.982502,9.01267800000005,330.2015227882304,0
"147.32.84.165",3204,"209.85.225.27",25,6,372,6,372,0,0,3125.783381,9.013050999999905,330.18785758563126,0
"147.32.84.165",3205,"207.115.11.16",25,6,372,6,372,0,0,3125.783506,9.013052999999672,330.1877843168245,0
"147.32.84.165",3206,"64.136.44.37",25,6,372,6,372,0,0,3125.98379,9.012796999999864,330.1971629894743,0
"147.32.84.165",3207,"66.94.237.64",25,6,372,6,372,0,0,3126.785003,8.912805999999819,333.901579367941,0
"147.32.84.165",4486,"117.204.67.227",6667,2,124,2,124,0,0,3133.795139,9.000000318337698e-06,0,0
"147.32.84.165",3208,"64.12.90.97",25,6,372,6,372,0,0,3135.297182,9.01373300000023,330.1628748044705,0
"147.32.84.165",3210,"64.12.90.1",25,6,372,6,372,0,0,3136.098565,9.013189000000239,330.18280211364936,0
"147.32.84.165",3213,"65.55.37.120",25,6,372,6,372,0,0,3136.098702,9.013176000000385,330.1832783471523,0
"147.32.84.165",3214,"77.238.177.9",25,6,372,6,372,0,0,3136.90006,9.013894000000164,330.1569776613688,0
"147.32.84.165",3215,"209.191.88.254",25,6,372,6,372,0,0,3136.999634,9.01322300000038,330.1815565863481,0
"147.32.84.165",3216,"66.94.237.64",25,6,372,6,372,0,0,3136.999764,9.013220999999703,330.18162985242435,0
"147.32.84.165",3217,"205.188.156.193",25,6,372,6,372,0,0,3136.999822,9.013213999999607,330.1818862838639,0
"147.32.84.165",3219,"205.188.59.194",25,6,372,6,372,0,0,3137.901073,9.012666000000081,330.20196243819237,0
"147.32.84.165",4500,"212.117.174.7",4506,6,372,6,372,0,0,3145.914115,9.01130000000012,330.25201691209486,0
"147.32.84.165",4498,"58.42.247.165",6667,7,426,6,364,1,62,3146.613416,0.5670369999998002,5135.467350456895,874.7224607921084
"147.32.84.165",4504,"212.117.174.7",4506,6,372,6,372,0,0,3146.713473,9.013084000000163,330.1866486543281,0
"147.32.84.165",3220,"209.85.225.27",25,6,372,6,372,0,0,3146.713622,9.013058999999885,330.18756451056606,0
"147.32.84.165",3221,"79.132.135.186",25,6,372,6,372,0,0,3147.014425,9.012344000000212,330.21376014940506,0
"147.32.84.165",3222,"63.90.69.60",25,6,372,6,372,0,0,3147.18016,8.948476000000028,332.5705963786449,0
"147.32.84.165",3223,"66.94.237.64",25,6,372,6,372,0,0,3147.714886,9.013204999999743,330.1822159820047,0
"147.32.84.165",4517,"61.17.129.5",6667,6,372,6,372,0,0,3156.327849,9.012340000000222,330.21390671012483,0
"147.32.84.165",3224,"64.12.90.97",25,6,372,6,372,0,0,3157.128793,9.012876000000233,330.19426873285767,0
"147.32.84.165",4531,"31.192.109.167",80,15,1540,10,1050,5,490,3157.929731,0.233553000000029,35966.140447773985,16784.19887562786
"147.32.84.165",3225,"207.115.36.22",25,6,372,6,372,0,0,3158.005823,8.936954000000242,332.99936421289846,0
"147.32.84.165",4532,"117.207.7.56",6667,9,552,6,372,3,180,3158.029863,1.6026029999998173,1856.9789274076857,898.5381906811383
"147.32.84.165",3228,"209.85.225.27",25,6,372,6,372,0,0,3158.931098,9.01293799999985,330.1919973265155,0
"147.32.84.165",3230,"74.125.67.27",25,6,372,6,372,0,0,3158.931232,9.01292999999987,330.19229040944987,0
"147.32.84.165",3231,"65.55.92.152",25,6,372,6,372,0,0,3159.632772,9.012537000000066,330.20668874923655,0
"147.32.84.165",4541,"109.87.192.82",6667,2,124,2,124,0,0,3166.942914,5.999999757477781e-06,0,0
"147.32.84.165",3232,"166.70.12.20",25,6,372,6,372,0,0,3167.744207,9.850446999999804,302.1182693536709,0
"147.32.84.165",3233,"122.1.235.148",25,6,372,6,372,0,0,3168.044166,9.55369299999984,311.5025781129925,0
"147.32.84.165",4548,"212.117.171.138",65500,338,332844,252,326308,86,6536,3168.144343,21.584611000000223,120940.97966370452,2422.4666360676806
"147.32.84.165",3234,"205.188.156.193",25,6,372,6,372,0,0,3168.144476,9.887379000000237,300.98977696717486,0
"147.32.84.165",4553,"65.55.196.251",443,236,172703,150,11744,86,160959,3168.745618,9.929529999999886,9461.877853231832,129681.06244706595
"147.32.84.165",3236,"66.94.237.64",25,6,372,6,372,0,0,3168.846261,9.480802999999923,313.8974620609693,0
"147.32.84.165",4558,"212.117.174.7",4506,6,372,6,372,0,0,3177.357671,9.874177999999574,301.3921766449955,0
"147.32.84.165",4559,"82.239.165.28",6667,2,124,2,124,0,0,3178.159127,0.17433000000028187,5690.357368200516,0
"147.32.84.165",4560,"212.117.174.7",4506,6,372,6,372,0,0,3178.960231,9.567218000000139,311.06221265157296,0
"147.32.84.165",3237,"66.94.237.64",25,6,372,6,372,0,0,3178.960364,9.570283999999901,310.96255868687183,0
"147.32.84.165",3238,"208.38.59.82",25,6,372,6,372,0,0,3178.960428,9.573448999999982,310.8597538880716,0
"147.32.84.165",4564,"212.117.171.138",65500,344,333176,256,326536,88,6640,3179.961458,31.032584999999926,84178.87198246637,1711.7491179030083
"147.32.84.165",3240,"209.85.225.27",25,6,372,6,372,0,0,3179.961592,9.725858999999673,305.9883965005148,0
"147.32.84.165",4573,"65.55.196.251",443,236,172776,150,11816,86,160960,3180.664095,9.14608300000009,10335.35339663975,140790.3252135354
"147.32.84.165",3241,"68.142.202.129",25,6,372,6,372,0,0,3180.76487,9.01047699999981,330.2821815093766,0
"147.32.84.165",3242,"205.188.156.193",25,6,372,6,372,0,0,3181.463441,9.013126000000284,330.18511002729866,0
"147.32.84.165",3244,"98.137.54.237",25,6,372,6,372,0,0,3181.463575,9.013092999999571,330.18631894735154,0
"147.32.84.165",4576,"59.113.50.63",6667,2,124,2,124,0,0,3188.774038,0.6214169999998376,1596.3515642479354,0
"147.32.84.165",3245,"209.85.225.27",25,6,372,6,372,0,0,3189.074448,9.012860000000273,330.1948549073113,0
"147.32.84.165",3246,"66.94.237.64",25,6,372,6,372,0,0,3189.074587,9.012816999999814,330.1964302614889,0
"147.32.84.165",3247,"64.12.90.33",25,6,372,6,372,0,0,3189.074655,9.01277600000003,330.1979323573547,0
"147.32.84.165",3248,"74.125.67.27",25,6,372,6,372,0,0,3189.174547,9.01283999999987,330.19558762832173,0
"147.32.84.165",3250,"199.249.25.205",25,6,372,6,372,0,0,3189.876097,9.012559000000238,330.2058827021184,0
"147.32.84.165",3251,"209.85.225.27",25,6,372,6,372,0,0,3191.077684,9.012685000000147,330.20126632628916,0
"147.32.84.165",3252,"66.94.237.64",25,6,372,6,372,0,0,3191.077815,9.01267800000005,330.2015227882304,0
"147.32.84.165",4589,"61.178.56.36",6667,2,124,2,124,0,0,3198.388169,1.0000000202126103e-05,0,0
"147.32.84.165",4597,"173.192.170.88",80,48,7019,30,2246,18,4773,3199.9904,36.85441899999978,487.53990667985045,1036.0765692711159
"147.32.84.165",3253,"67.195.168.31",25,6,372,6,372,0,0,3200.191467,10.186733000000004,292.14469447662947,0
"147.32.84.165",3254,"205.188.156.193",25,6,372,6,372,0,0,3200.99154,9.820670999999948,303.03428350262584,0
"147.32.84.165",4592,"212.117.171.138",65500,70,6868,46,4394,24,2474,3201.292099,103.10543100000041,340.9325741531487,191.95885035386664
"147.32.84.165",3255,"94.245.120.86",25,6,372,6,372,0,0,3201.292438,9.653761000000031,308.27363552919843,0
"147.32.84.165",4602,"65.55.16.187",443,203,170860,138,11028,65,159832,3201.792937,9.348281000000043,9437.45700412724,136779.79940910998
"147.32.84.165",3256,"66.94.237.64",25,6,372,6,372,0,0,3201.959063,8.990337000000181,331.02207403348064,0
"147.32.84.165",3257,"209.85.225.27",25,6,372,6,372,0,0,3201.959128,8.993459000000257,330.9071626389707,0
"147.32.84.165",3261,"209.85.225.27",25,6,372,6,372,0,0,3202.493656,8.914412999999968,333.84138697635063,0
"147.32.84.165",3262,"65.54.188.94",25,6,372,6,372,0,0,3202.493789,8.914401999999882,333.84179892269157,0
"147.32.84.165",4608,"212.117.174.7",4506,6,372,6,372,0,0,3210.004876,9.012463000000025,330.2094000274943,0
"147.32.84.165",4604,"61.17.216.26",6667,6,372,6,372,0,0,3210.104647,9.013461000000007,330.1728381583942,0
"147.32.84.165",4611,"212.117.174.7",4506,6,372,6,372,0,0,3210.806187,9.012977999999748,330.19053191964775,0
"147.32.84.165",3263,"66.94.237.64",25,6,372,6,372,0,0,3210.806258,9.013030999999955,330.1885902755704,0
"147.32.84.165",3264,"205.188.156.193",25,6,372,6,372,0,0,3210.806319,9.013021000000208,330.18895662175106,0
"147.32.84.165",3265,"212.135.6.129",25,6,372,6,372,0,0,3210.806383,9.013008999999784,330.18939623826753,0
"147.32.84.165",3266,"66.94.237.64",25,6,372,6,372,0,0,3211.507111,9.012572000000091,330.2054064034074,0
"147.32.84.165",3267,"209.85.225.27",25,6,372,6,372,0,0,3211.507207,9.012601999999788,330.2043072577786,0
"147.32.84.165",3268,"66.94.237.64",25,6,372,6,372,0,0,3211.507236,9.012623000000076,330.203537860174,0
"147.32.84.165",3269,"209.85.225.27",25,6,372,6,372,0,0,3211.507261,9.012648999999783,330.202585277655,0
"147.32.84.165",3270,"205.188.59.193",25,6,372,6,372,0,0,3211.507295,9.012665000000197,330.20199907573783,0
"147.32.84.165",3272,"66.94.237.64",25,6,372,6,372,0,0,3212.007624,9.012630000000172,330.2032813951026,0
"147.32.84.165",4620,"77.239.2.219",6667,6,372,6,372,0,0,3221.120399,9.013558999999987,330.1692483512899,0
"147.32.84.165",4622,"208.73.210.29",80,69,38908,42,6652,27,32256,3221.921785,11.28677400000015,4714.899049099352,22862.865864063246
"147.32.84.165",3274,"216.33.127.20",25,6,372,6,372,0,0,3222.100987,8.93393100000003,333.1120421682225,0
"147.32.84.165",3275,"66.94.237.64",25,6,372,6,372,0,0,3222.222024,9.013126999999713,330.18507339351754,0
"147.32.84.165",3276,"203.209.228.250",25,6,372,6,372,0,0,3222.222128,9.013115000000198,330.18551299966043,0
"147.32.84.165",4637,"85.185.226.13",6667,4,248,4,248,0,0,3222.823257,3.004342000000179,660.3775468970849,0
"147.32.84.165",4638,"74.125.232.217",80,13,2950,10,2076,3,874,3223.424048,9.784626000000117,1697.3566490941812,714.5904197053537
"147.32.84.165",3277,"205.188.156.193",25,6,372,6,372,0,0,3223.432272,9.004955999999765,330.4846797696821,0
"147.32.84.165",4640,"67.214.158.5",80,15,2581,10,1726,5,855,3231.035054,0.31498000000010506,43837.703981190534,21715.66448662683
"147.32.84.165",3278,"98.137.54.237",25,6,372,6,372,0,0,3231.134885,9.01282399999991,330.19617380745814,0
"147.32.84.165",4641,"50.22.198.84",80,13,3384,10,2348,3,1036,3231.138448,0.36798999999973603,51044.86534963851,22522.351150862647
"147.32.84.165",3279,"65.38.111.161",25,6,372,6,372,0,0,3231.25936,8.989306999999826,331.06000273436626,0
"147.32.84.165",4642,"195.113.232.83",80,13,2146,10,1558,3,588,3231.83596,1.3728100000002996,9079.187942976288,3426.5484662837343
"147.32.84.165",3280,"118.23.100.198",25,6,372,6,372,0,0,3231.836831,9.012179999999717,330.2197692456313,0
"147.32.84.165",4643,"94.127.76.180",80,7,424,6,364,1,60,3232.537249,0.01443299999982628,201759.8558882457,33257.11910245808
"147.32.84.165",3281,"208.84.244.133",25,6,372,6,372,0,0,3232.55138,8.998595999999907,330.71825871502966,0
"147.32.84.165",4655,"117.96.96.152",6667,4,248,4,248,0,0,3233.037544,3.0068420000002334,659.8284845029589,0
"147.32.84.165",4666,"212.117.174.7",4506,6,372,6,372,0,0,3241.54983,9.013440000000173,330.1736074129237,0
"147.32.84.165",4665,"173.192.170.88",80,17,1641,12,1084,5,557,3242.150753,50.738740000000234,170.9147684786804,87.82244099873152
"147.32.84.165",3282,"207.115.36.22",25,6,372,6,372,0,0,3242.351742,9.012793000000329,330.19730953544496,0
"147.32.84.165",4663,"212.117.174.7",4506,6,372,6,372,0,0,3243.051955,9.013296999999966,330.17884576531884,0
"147.32.84.165",4671,"61.17.216.20",6667,4,248,4,248,0,0,3243.052089,3.0043319999999767,660.3797449815851,0
"147.32.84.165",3283,"209.85.225.27",25,6,372,6,372,0,0,3243.252216,9.013041000000158,330.18822393018604,0
"147.32.84.165",3284,"205.188.156.193",25,6,372,6,372,0,0,3244.45417,9.012924999999996,330.19247358654394,0
"147.32.84.165",3286,"209.85.225.27",25,6,372,6,372,0,0,3251.163765,9.012955000000147,330.19137452699493,0
"147.32.84.165",3288,"66.94.237.64",25,6,372,6,372,0,0,3251.163908,9.012936000000082,330.19207059719196,0
"147.32.84.165",3291,"85.158.137.35",25,6,372,6,372,0,0,3252.1651,9.013152999999875,330.1841209175126,0
"147.32.84.165",3294,"209.85.225.27",25,6,372,6,372,0,0,3252.265388,9.013355000000047,330.1767210988566,0
"147.32.84.165",3295,"66.94.237.64",25,6,372,6,372,0,0,3252.265444,9.013425000000097,330.17415688264646,0
"147.32.84.165",3296,"205.188.190.2",25,6,372,6,372,0,0,3252.265499,9.013423999999759,330.17419351403856,0
"147.32.84.165",4678,"190.53.151.16",6667,4,248,4,248,0,0,3252.86624,3.0042210000001432,660.4041447017065,0
"147.32.84.165",3297,"77.238.184.241",25,6,372,6,372,0,0,3253.567116,9.013721999999689,330.16327772257705,0
"147.32.84.165",3298,"77.238.184.241",25,6,372,6,372,0,0,3261.378845,9.012902999999824,330.1932795681989,0
"147.32.84.165",3300,"209.85.225.27",25,6,372,6,372,0,0,3261.379006,9.013063999999758,330.18738133891867,0
"147.32.84.165",3302,"205.188.156.193",25,6,372,6,372,0,0,3261.379067,9.01305500000035,330.187711048017,0
"147.32.84.165",3305,"204.127.217.21",25,6,372,6,372,0,0,3261.379125,9.013054000000011,330.18774768241667,0
"147.32.84.165",3307,"63.235.3.11",25,6,372,6,372,0,0,3262.580979,9.012651000000005,330.20251200229524,0
"147.32.84.165",4688,"59.48.7.168",6667,9,552,6,372,3,180,3263.381576,1.9373329999998532,1536.1324047028702,743.2898732433242
"147.32.84.165",3308,"66.94.237.64",25,6,372,6,372,0,0,3264.285224,9.002629999999954,330.57006674716337,0
"147.32.84.165",3309,"209.85.225.27",25,6,372,6,372,0,0,3264.285354,9.002625999999964,330.57021362433716,0
"147.32.84.165",3310,"216.8.161.238",25,6,372,6,372,0,0,3265.319224,8.871204000000034,335.46742922381094,0
"147.32.84.165",4693,"212.117.171.138",65500,24,1471,18,1092,6,379,3265.48457,334.027908,26.153503317453342,9.077085858346901
"147.32.84.165",3311,"132.181.2.71",25,6,372,6,372,0,0,3265.484702,8.906266999999843,334.14673061115866,0
"147.32.84.165",4699,"212.117.174.7",4506,6,372,6,372,0,0,3271.593495,8.91820400000006,333.6994758137378,0
"147.32.84.165",4694,"205.188.186.137",587,46,5615,30,3842,16,1773,3272.194277,32.297415999999885,951.6550797748064,439.16826039581775
"147.32.84.165",4700,"98.126.71.122",80,18,4863,14,1430,4,3433,3272.312161,16.229761000000053,704.8779091694549,1692.1999036214957
"147.32.84.165",4696,"212.117.174.7",4506,6,372,6,372,0,0,3272.487287,8.828808000000208,337.07834625013135,0
"147.32.84.165",3314,"216.32.180.22",25,6,372,6,372,0,0,3272.487324,8.828894999999648,337.0750246775071,0
"147.32.84.165",4697,"117.240.58.150",6667,2,124,2,124,0,0,3273.187241,7.000000096013537e-06,0,0
"147.32.84.165",4704,"195.113.232.88",80,17,5762,12,2556,5,3206,3273.288049,15.785664000000452,1295.3525426614563,1624.765356718556
"147.32.84.165",3315,"64.12.90.33",25,6,372,6,372,0,0,3273.288905,8.928843000000143,333.30186229055124,0
"147.32.84.165",3316,"62.211.72.32",25,6,372,6,372,0,0,3274.491596,9.030912000000171,329.5348243898228,0
"147.32.84.165",4707,"31.192.109.167",80,15,1540,10,1050,5,490,3282.318051,0.24343999999973676,34505.422280681414,16102.530397651326
"147.32.84.165",4709,"82.239.165.28",6667,2,124,2,124,0,0,3282.395564,4.999999873689376e-06,0,0
"147.32.84.165",3317,"204.127.217.21",25,6,372,6,372,0,0,3283.522622,9.034881000000041,329.39006058851095,0
"147.32.84.165",3318,"207.115.21.20",25,6,372,6,372,0,0,3285.227642,9.032172000000173,329.4888538437867,0
"147.32.84.165",3319,"209.85.225.27",25,6,372,6,372,0,0,3285.32788,9.032075000000077,329.4923923904501,0
"147.32.84.165",3322,"64.12.90.1",25,6,372,6,372,0,0,3286.230822,9.034814000000097,329.39250326569737,0
"147.32.84.165",3328,"209.85.225.27",25,6,372,6,372,0,0,3286.431378,9.030467999999928,329.5510265913155,0
"147.32.84.165",3329,"62.211.72.32",25,6,372,6,372,0,0,3286.431509,9.03046200000017,329.5512455508859,0
"147.32.84.165",3330,"64.12.90.33",25,6,372,6,372,0,0,3286.431566,9.03045899999961,329.55135503080504,0
"147.32.84.165",3332,"209.85.225.27",25,6,372,6,372,0,0,3286.43162,9.03045400000019,329.55153749744335,0
"147.32.84.165",3333,"207.115.21.24",25,6,372,6,372,0,0,3286.43168,9.03044699999964,329.5517929511262,0
"147.32.84.165",4730,"83.17.186.77",6667,2,124,2,124,0,0,3292.55764,8.999999863590347e-06,0,0
"147.32.84.165",4739,"173.192.170.88",80,17,1643,12,1086,5,557,3293.359135,36.35744599999998,238.9606794712699,122.56086414870842
"147.32.84.165",3334,"203.175.185.16",25,6,372,6,372,0,0,3293.560144,9.011666999999761,330.2385674037976,0
"147.32.84.165",3335,"66.94.237.64",25,6,372,6,372,0,0,3294.259949,9.018073000000186,330.0039820036873,0
"147.32.84.165",3336,"94.245.120.86",25,6,372,6,372,0,0,3295.561908,9.01278000000002,330.19778581081454,0
"147.32.84.165",3337,"64.12.90.1",25,6,372,6,372,0,0,3295.962547,9.01290999999992,330.19302311906216,0
"147.32.84.165",3338,"205.188.156.193",25,6,372,6,372,0,0,3295.96268,9.01287000000002,330.1944885480422,0
"147.32.84.165",4751,"212.117.174.7",4506,6,372,6,372,0,0,3304.574786,9.017033999999967,330.04200716111427,0
"147.32.84.165",4752,"195.70.198.9",6667,6,372,6,372,0,0,3306.278588,8.918875999999727,333.674332954073,0
"147.32.84.165",4753,"212.117.174.7",4506,6,372,6,372,0,0,3306.377535,8.92017799999985,333.62562944372297,0
"147.32.84.165",4759,"173.192.170.88",80,16,2127,12,1598,4,529,3306.377682,10.12646100000029,1262.4351192385607,417.9150050545673
"147.32.84.165",3339,"66.94.237.64",25,6,372,6,372,0,0,3306.377741,8.920096000000285,333.6286963727638,0
"147.32.84.165",3340,"65.55.92.136",25,6,372,6,372,0,0,3306.3778,8.920090999999957,333.6288833824694,0
"147.32.84.165",3343,"209.85.225.27",25,6,372,6,372,0,0,3306.777958,8.922696000000087,333.5314797231656,0
"147.32.84.165",4760,"174.36.246.56",80,26,14155,20,2052,6,12103,3307.278592,0.4098669999998492,40052.016873781104,236232.7291536904
"147.32.84.165",3347,"209.85.225.27",25,6,372,6,372,0,0,3307.399514,8.902332999999999,334.2943922677348,0
"147.32.84.165",3349,"64.12.90.97",25,6,372,6,372,0,0,3307.399579,8.90241100000003,334.2914632901121,0
"147.32.84.165",3350,"66.94.237.64",25,6,372,6,372,0,0,3307.479154,8.923651999999947,333.4957481533365,0
"147.32.84.165",3351,"209.85.225.27",25,6,372,6,372,0,0,3307.479226,8.92367400000012,333.49492596882857,0
"147.32.84.165",3353,"67.231.144.184",25,6,372,6,372,0,0,3307.479259,8.923667999999907,333.49515020057123,0
"147.32.84.165",4768,"190.55.176.74",6667,2,124,2,124,0,0,3314.494568,8.999999863590347e-06,0,0
"147.32.84.165",4762,"195.113.232.82",80,7,426,6,364,1,62,3315.197605,0.0011170000002493907,0,0
"147.32.84.165",3354,"64.12.90.1",25,6,372,6,372,0,0,3315.198427,9.029340000000047,329.59219610735494,0
"147.32.84.165",4763,"195.113.232.82",80,13,1479,10,1122,3,357,3316.502816,9.276937999999973,967.5606326139106,307.86020128624426
"147.32.84.165",3355,"64.12.90.33",25,6,372,6,372,0,0,3316.503964,9.027690999999777,329.65239948953433,0
"147.32.84.165",4764,"195.113.232.82",80,13,1645,10,1308,3,337,3316.904126,8.87583399999994,1178.9314671725576,303.74610430974917
"147.32.84.165",3356,"65.55.37.72",25,6,372,6,372,0,0,3316.904233,9.045035999999982,329.0202493389751,0
"147.32.84.165",4777,"218.57.210.214",6667,2,124,2,124,0,0,3324.929445,8.999999863590347e-06,0,0
"147.32.84.165",4765,"174.36.246.56",80,12,1994,10,1874,2,120,3325.531791,0.2426500000001397,61784.463218592085,3956.3156810197706
"147.32.84.165",3358,"66.94.237.64",25,6,372,6,372,0,0,3325.652723,9.008976000000075,330.337210355536,0
"147.32.84.165",3359,"209.85.225.27",25,6,372,6,372,0,0,3327.251198,9.013085000000046,330.18661202018893,0
"147.32.84.165",3361,"205.188.146.193",25,6,372,6,372,0,0,3327.251332,9.013078000000405,330.18686845935053,0
"147.32.84.165",3362,"69.84.129.233",25,6,372,6,372,0,0,3327.351505,9.012948999999935,330.19159433832607,0
"147.32.84.165",3363,"66.117.140.5",25,6,372,6,372,0,0,3327.752043,9.013476999999966,330.1722520621078,0
"147.32.84.165",3364,"205.188.59.193",25,6,372,6,372,0,0,3328.35287,9.01300399999991,330.18957941215047,0
"147.32.84.165",4785,"117.96.96.152",6667,4,248,4,248,0,0,3328.452918,3.0041190000001734,660.4265676559036,0
"147.32.84.165",4791,"212.117.174.7",4506,6,372,6,372,0,0,3336.264471,9.013093000000026,330.1863189473349,0
"147.32.84.165",4787,"173.192.170.88",80,17,1643,12,1086,5,557,3336.765385,40.02410499999996,217.0691886801718,111.33290800631279
"147.32.84.165",3365,"167.127.98.30",25,6,372,6,372,0,0,3336.966265,9.011693999999807,330.23757797369325,0
"147.32.84.165",4788,"212.117.174.7",4506,6,372,6,372,0,0,3337.566039,9.012805000000299,330.1968698978732,0
"147.32.84.165",3366,"66.94.237.64",25,6,372,6,372,0,0,3337.566179,9.012760999999955,330.19848190804294,0
"147.32.84.165",3368,"209.85.225.27",25,6,372,6,372,0,0,3337.566237,9.012827000000016,330.19606389870734,0
"147.32.84.165",3370,"205.188.59.194",25,6,372,6,372,0,0,3337.967047,9.012731999999687,330.19954437789823,0
"147.32.84.165",4796,"201.67.253.254",6667,6,372,6,372,0,0,3346.679427,9.012510999999904,330.2076413554482,0
"147.32.84.165",3371,"205.188.156.193",25,6,372,6,372,0,0,3346.979643,9.012789999999768,330.1974194450416,0
"147.32.84.165",3372,"62.211.72.32",25,6,372,6,372,0,0,3348.28123,9.013148999999885,330.18426745192363,0
"147.32.84.165",4805,"119.178.199.146",6667,4,248,4,248,0,0,3348.381382,3.0045129999998608,660.3399619173197,0
"147.32.84.165",3373,"66.11.225.135",25,6,372,6,372,0,0,3348.783185,9.011867000000166,330.23123843260726,0
"147.32.84.165",3374,"209.85.225.27",25,6,372,6,372,0,0,3349.38296,9.01288999999997,330.19375583192624,0
"147.32.84.165",3377,"205.188.146.193",25,6,372,6,372,0,0,3349.383093,9.012854000000061,330.1950747232763,0
"147.32.84.165",4809,"173.192.170.88",80,16,2030,12,1502,4,528,3357.294519,10.361194000000069,1159.7119019294419,407.67502278212066
"147.32.84.165",3379,"64.12.90.97",25,6,372,6,372,0,0,3357.294579,8.912756000000172,333.90345253476505,0
"147.32.84.165",4814,"68.67.185.208",80,16,2456,12,1424,4,1032,3357.995718,14.696927999999843,775.1279723218431,561.7500473568414
"147.32.84.165",3380,"66.94.237.64",25,6,372,6,372,0,0,3358.019425,8.888602999999875,334.8107683513418,0
"147.32.84.165",4817,"60.243.38.64",6667,4,248,4,248,0,0,3358.596121,3.0044819999998253,660.3467752511466,0
"147.32.84.165",4815,"68.67.179.210",80,16,2682,12,1800,4,882,3358.996912,13.69594700000016,1051.4059378296245,515.188909536516
"147.32.84.165",3381,"148.87.41.220",25,6,372,6,372,0,0,3359.026636,8.87444800000003,335.34480116396986,0
"147.32.84.165",4825,"212.117.174.7",4506,6,372,6,372,0,0,3366.807956,9.028659999999945,329.6170195798732,0
"147.32.84.165",4823,"212.117.174.7",4506,6,372,6,372,0,0,3367.609257,9.029054000000087,329.6026361122628,0
"147.32.84.165",4819,"217.163.21.39",80,21,6659,14,1570,7,5089,3367.609391,0.18751100000008591,66982.73701273123,217117.9290813944
"147.32.84.165",3382,"206.125.40.130",25,6,372,6,372,0,0,3367.655379,8.98304700000017,331.2907079301649,0
"147.32.84.165",4828,"217.163.21.39",80,15,2336,10,1450,5,886,3367.901216,0.13983399999960966,82955.50438400089,50688.673713258475
"147.32.84.165",3385,"209.85.225.27",25,6,372,6,372,0,0,3367.947124,8.991068000000269,330.9951609753047,0
"147.32.84.165",4832,"84.229.67.56",6667,9,552,6,372,3,180,3369.204909,1.3182550000001356,2257.52984058448,1092.3531486699098
"147.32.84.165",4829,"195.113.232.88",80,13,1772,10,1228,3,544,3369.707044,2.9860419999999976,3289.9738181847433,1457.4476849287462
"147.32.84.165",3386,"205.188.59.194",25,6,372,6,372,0,0,3369.707912,9.03281300000026,329.4654721624276,0
"147.32.84.165",4831,"77.238.167.32",80,13,2615,10,1564,3,1051,3370.308488,0.14016799999990326,89264.31139781288,59985.16066438704
"147.32.84.165",3387,"209.85.225.27",25,6,372,6,372,0,0,3370.354177,8.987314999999853,331.13338077056926,0
"147.32.84.165",3388,"205.188.59.193",25,6,372,6,372,0,0,3370.354243,8.987348999999995,331.1321280613451,0
"147.32.84.165",4834,"217.163.21.39",80,17,3688,12,1662,5,2026,3370.523453,0.24889800000028117,53419.4730370874,65119.04474918115
"147.32.84.165",3393,"218.102.53.147",25,6,372,6,372,0,0,3370.569424,8.972536000000218,331.6788029604927,0
"147.32.84.165",4841,"24.14.193.250",6667,4,248,4,248,0,0,3376.036812,3.0043500000001586,660.3757884400603,0
"147.32.84.165",4843,"173.192.170.88",80,11,1283,8,846,3,437,3378.240091,2.532922999999755,2672.0117429549396,1380.2235598951638
"147.32.84.165",3394,"209.85.225.27",25,6,372,6,372,0,0,3378.441005,9.012132999999722,330.2214914049861,0
"147.32.84.165",3395,"174.143.82.84",25,6,372,6,372,0,0,3378.441068,9.012212999999974,330.2185600806382,0
"147.32.84.165",3398,"209.204.203.108",25,6,372,6,372,0,0,3378.941211,9.013085000000046,330.18661202018893,0
"147.32.84.165",3401,"74.125.43.27",25,6,372,6,372,0,0,3379.942764,9.012846000000081,330.1953678116738,0
"147.32.84.165",4848,"95.57.240.37",6667,2,124,2,124,0,0,3387.853699,1.0000000202126103e-05,0,0
"147.32.84.165",3402,"205.188.146.193",25,6,372,6,372,0,0,3388.655118,9.012816999999814,330.1964302614889,0
"147.32.84.165",3403,"64.12.90.33",25,6,372,6,372,0,0,3388.955746,9.012580999999955,330.20507665895207,0
"147.32.84.165",3406,"65.54.188.72",25,6,372,6,372,0,0,3390.757981,9.013189999999668,330.1827654803804,0
"147.32.84.165",3407,"218.102.23.149",25,6,372,6,372,0,0,3391.359452,9.012459000000035,330.2095465843438,0
"147.32.84.165",3408,"209.85.225.27",25,6,372,6,372,0,0,3391.559741,9.01235399999996,330.21339374818314,0
"147.32.84.165",3409,"66.94.237.64",25,6,372,6,372,0,0,3392.260582,9.012404999999944,330.2115251145525,0
"147.32.84.165",4857,"212.117.174.7",4506,6,372,6,372,0,0,3399.470913,9.012490999999955,330.20837413319083,0
"147.32.84.165",4859,"117.204.73.246",6667,2,124,2,124,0,0,3399.971202,8.999999863590347e-06,0,0
"147.32.84.165",4860,"212.117.174.7",4506,6,372,6,372,0,0,3400.972627,9.013204999999743,330.1822159820047,0
"147.32.84.165",4865,"67.195.168.31",25,6,372,6,372,0,0,3400.972759,9.01319599999988,330.18254568080397,0
"147.32.84.165",3410,"74.125.67.27",25,6,372,6,372,0,0,3402.475029,9.013108999999986,330.18573280318753,0
"147.32.84.165",4868,"31.192.109.167",80,15,1540,10,1050,5,490,3409.685338,0.23542000000043117,35680.91071270332,16651.091665928216
"147.32.84.165",4870,"61.17.216.21",6667,2,124,2,124,0,0,3409.761516,9.999999747378752e-06,0,0
"147.32.84.165",4871,"67.195.168.31",25,6,372,6,372,0,0,3409.986015,9.01268200000004,330.2013762385033,0
"147.32.84.165",3411,"64.12.90.97",25,6,372,6,372,0,0,3409.986077,9.012683999999808,330.2013029636969,0
"147.32.84.165",3414,"212.67.202.20",25,6,372,6,372,0,0,3411.78851,9.01288599999998,330.1939023748893,0
"147.32.84.165",3415,"66.94.237.64",25,6,372,6,372,0,0,3412.089158,9.012509999999565,330.20767799427057,0
"147.32.84.165",3416,"216.117.176.59",25,6,372,6,372,0,0,3412.089225,9.012586999999712,330.20485682968666,0
"147.32.84.165",3419,"209.85.225.27",25,6,372,6,372,0,0,3412.389345,9.01280799999995,330.19675998867575,0
"147.32.84.165",3421,"205.188.146.193",25,6,372,6,372,0,0,3412.389477,9.01281999999992,330.1963203525674,0
"147.32.84.165",3427,"64.12.90.33",25,6,372,6,372,0,0,3412.589485,9.012874999999894,330.1943053687125,0
"147.32.84.165",3434,"122.28.30.180",25,6,372,6,372,0,0,3413.290579,8.912506000000121,333.9128186842129,0
"147.32.84.165",4885,"178.122.240.223",6667,3,184,2,124,1,60,3420.501026,0.18422199999986333,5384.807460567879,2605.551997048974
"147.32.84.165",3438,"64.12.90.33",25,6,372,6,372,0,0,3422.002842,9.012905000000046,330.19320629696915,0
"147.32.84.165",3439,"66.94.237.64",25,6,372,6,372,0,0,3422.002974,9.012897000000066,330.19349938204977,0
"147.32.84.165",4902,"65.54.188.72",25,6,372,6,372,0,0,3422.30322,9.012950000000274,330.19155770307276,0
"147.32.84.165",3440,"205.188.146.193",25,6,372,6,372,0,0,3423.404988,9.01287500000035,330.19430536869584,0
"147.32.84.165",3441,"209.191.88.254",25,6,372,6,372,0,0,3423.405124,9.0128279999999,330.1960272624789,0
"147.32.84.165",4913,"212.117.174.7",4506,6,372,6,372,0,0,3430.915725,9.013536000000386,330.1700908500141,0
"147.32.84.165",4906,"117.207.7.56",6667,9,552,6,372,3,180,3432.517907,1.3973320000000058,2129.773024592572,1030.5353344802768
"147.32.84.165",4915,"212.117.174.7",4506,6,372,6,372,0,0,3432.718579,9.01260400000001,330.2042339816546,0
"147.32.84.165",3444,"74.6.140.31",25,6,372,6,372,0,0,3432.718714,9.012594999999692,330.2045637244436,0
"147.32.84.165",3445,"209.85.225.27",25,6,372,6,372,0,0,3433.01887,9.012768999999935,330.19818881411715,0
"147.32.84.165",3447,"205.188.156.193",25,6,372,6,372,0,0,3433.319316,9.015624000000116,330.09362413516374,0
"147.32.84.165",3449,"209.85.225.27",25,6,372,6,372,0,0,3433.519452,9.013081000000057,330.18675855681107,0
"147.32.84.165",3450,"205.188.146.193",25,6,372,6,372,0,0,3433.519585,9.01308599999993,330.1865753860579,0
"147.32.84.165",4926,"222.23.80.7",6667,4,248,4,248,0,0,3433.915509,2.9085869999998977,682.1181556542988,0
"147.32.84.165",3452,"66.94.237.64",25,6,372,6,372,0,0,3434.220354,9.013170000000173,330.1834981477042,0
"147.32.84.165",3453,"216.32.180.22",25,6,372,6,372,0,0,3434.220486,9.01316399999996,330.1837179485487,0
"147.32.84.165",4932,"65.54.188.72",25,6,372,6,372,0,0,3443.03364,9.01310999999987,330.18569616925157,0
"147.32.84.165",3454,"64.78.17.131",25,6,372,6,372,0,0,3443.033775,9.013102000000345,330.1859892409834,0
"147.32.84.165",3455,"64.12.90.33",25,6,372,6,372,0,0,3443.333601,9.013300999999956,330.17869923572005,0
"147.32.84.165",4948,"117.197.27.8",6667,4,248,4,248,0,0,3444.435318,3.004232000000229,660.4017266309155,0
"147.32.84.165",3456,"81.169.145.101",25,6,372,6,372,0,0,3451.946407,9.012614000000212,330.203867601556,0
"147.32.84.165",3457,"209.85.225.27",25,6,372,6,372,0,0,3452.346709,9.01316399999996,330.1837179485487,0
"147.32.84.165",3458,"74.125.67.27",25,6,372,6,372,0,0,3452.346842,9.013156999999865,330.1839743832316,0
"147.32.84.165",4965,"92.112.3.72",6667,4,248,4,248,0,0,3453.748636,3.0043640000003506,660.3727111627514,0
"147.32.84.165",3459,"64.30.236.67",25,6,372,6,372,0,0,3454.049538,9.012597999999798,330.20445381010745,0
"147.32.84.165",3460,"66.94.237.64",25,6,372,6,372,0,0,3454.349458,9.01302399999986,330.1888467178215,0
"147.32.84.165",3461,"205.188.146.193",25,6,372,6,372,0,0,3454.549736,9.012994000000162,330.18994576052603,0
"147.32.84.165",3462,"66.94.237.64",25,6,372,6,372,0,0,3455.252424,9.011428000000251,330.24732595099437,0
"147.32.84.165",3464,"65.55.37.120",25,6,372,6,372,0,0,3455.252558,9.011423999999806,330.2474725415277,0
"147.32.84.165",4971,"212.117.174.7",4506,6,372,6,372,0,0,3462.563195,9.011079999999765,330.26007981286125,0
"147.32.84.165",4989,"61.178.56.36",6667,4,248,4,248,0,0,3464.063604,3.004142000000229,660.4215113665895,0
"147.32.84.165",4979,"212.117.174.7",4506,6,372,6,372,0,0,3464.363912,9.01329700000042,330.1788457653022,0
"147.32.84.165",4977,"74.125.127.27",25,6,372,6,372,0,0,3464.364044,9.013268000000153,330.17990810879576,0
"147.32.84.165",4990,"74.125.127.27",25,6,372,6,372,0,0,3472.175201,9.012787000000117,330.1975293546781,0
"147.32.84.165",3467,"209.85.225.27",25,6,372,6,372,0,0,3472.175333,9.01272199999994,330.19991074838657,0
"147.32.84.165",3468,"64.12.90.33",25,6,372,6,372,0,0,3472.976078,9.01321599999983,330.1818130176905,0
"147.32.84.165",3469,"65.55.92.168",25,6,372,6,372,0,0,3473.377351,9.012852999999723,330.19511135931003,0
"147.32.84.165",1028,"85.185.226.13",6667,4,248,4,248,0,0,3475.079539,3.0042060000000674,660.407442099495,0
"147.32.84.165",3470,"65.18.214.30",25,6,372,6,372,0,0,3475.379766,9.013809999999921,330.1600544054097,0
"147.32.84.165",3471,"66.94.237.64",25,6,372,6,372,0,0,3475.58006,9.014318000000003,330.14144830479677,0
"147.32.84.165",3473,"205.188.159.42",25,6,372,6,372,0,0,3476.281438,9.012808999999834,330.1967233522928,0
"147.32.84.165",3474,"205.188.156.193",25,6,372,6,372,0,0,3482.390048,9.012692999999672,330.2009732274369,0
"147.32.84.165",3475,"65.55.37.104",25,6,372,6,372,0,0,3483.591642,8.912968999999975,333.89547298997763,0
"147.32.84.165",1044,"91.214.134.197",6667,9,552,6,372,3,180,3485.39447,1.0582719999997607,2812.1314747065717,1360.7087780838249
"147.32.84.165",1049,"64.12.90.1",25,6,372,6,372,0,0,3486.452965,8.85591999999997,336.04639608307326,0
"147.32.84.165",3476,"65.55.92.184",25,6,372,6,372,0,0,3492.604873,9.012508999999682,330.20771463308444,0
"147.32.84.165",1055,"212.117.174.7",4506,6,372,6,372,0,0,3493.105228,9.012846000000081,330.1953678116738,0
"147.32.84.165",1058,"27.255.59.70",6667,9,552,6,372,3,180,3493.906353,1.3748420000001715,2164.612370002974,1047.3930822595034
"147.32.84.165",1060,"212.117.174.7",4506,6,372,6,372,0,0,3494.306831,9.01314900000034,330.184267451907,0
"147.32.84.165",1065,"64.12.90.1",25,6,372,6,372,0,0,3494.306962,9.013156999999865,330.1839743832316,0
"147.32.84.165",3477,"207.115.21.22",25,6,372,6,372,0,0,3494.307021,9.013198000000102,330.182472414338,0
"147.32.84.165",3478,"94.228.131.140",25,6,372,6,372,0,0,3495.281413,8.939624999999978,332.8998699609891,0
"147.32.84.165",3479,"64.12.90.33",25,6,372,6,372,0,0,3496.310111,9.012689000000137,330.2011197767897,0
"147.32.84.165",3482,"66.94.237.64",25,6,372,6,372,0,0,3496.510316,9.012978000000203,330.1905319196311,0
"147.32.84.165",3484,"209.85.225.27",25,6,372,6,372,0,0,3497.211409,9.012561999999889,330.2057727869208,0
"147.32.84.165",1079,"109.87.192.82",6667,2,124,2,124,0,0,3503.320294,8.999999863590347e-06,0,0
"147.32.84.165",1076,"173.192.170.88",80,40,6616,24,1886,16,4730,3504.521437,36.70424600000024,411.0696075870868,1030.9433954861722
"147.32.84.165",3485,"203.99.196.252",25,6,372,6,372,0,0,3504.722224,9.01283199999989,330.1958807176298,0
"147.32.84.165",3487,"205.188.156.193",25,6,372,6,372,0,0,3507.326122,9.012340000000222,330.21390671012483,0
"147.32.84.165",1095,"41.223.57.75",6667,2,124,2,124,0,0,3513.634669,7.999999979801942e-06,0,0
"147.32.84.165",1093,"217.72.192.149",25,6,372,6,372,0,0,3514.135361,9.01367399999981,330.165035922096,0
"147.32.84.165",3488,"69.167.181.201",25,6,372,6,372,0,0,3515.337137,9.013034999999945,330.1884437373225,0
"147.32.84.165",1106,"217.72.192.149",25,6,372,6,372,0,0,3516.238942,9.01269400000001,330.2009365901024,0
"147.32.84.165",3489,"66.94.237.64",25,6,372,6,372,0,0,3516.239114,9.012649000000238,330.2025852776383,0
"147.32.84.165",3490,"216.32.181.178",25,6,372,6,372,0,0,3516.239174,9.012638000000152,330.20298829265636,0
"147.32.84.165",1110,"208.73.210.29",80,72,39123,44,6744,28,32379,3517.240403,19.358054000000266,2787.057004800134,13381.097087547976
"147.32.84.165",3491,"209.85.225.27",25,6,372,6,372,0,0,3517.340025,9.012889000000087,330.19379246765067,0
"147.32.84.165",3492,"205.188.59.193",25,6,372,6,372,0,0,3517.340157,9.012898999999834,330.19342611073915,0
"147.32.84.165",3493,"194.25.134.72",25,6,372,6,372,0,0,3517.431629,8.921480999999858,333.5769027586392,0
"147.32.84.165",3494,"65.55.37.120",25,6,372,6,372,0,0,3517.540218,9.01299599999993,330.18987249079254,0
"147.32.84.165",3496,"209.191.88.254",25,6,372,6,372,0,0,3518.241694,9.012460000000374,330.20950994510673,0
"147.32.84.165",1117,"212.117.174.7",4506,6,372,6,372,0,0,3525.752282,9.012951000000157,330.1915210678443,0
"147.32.84.165",1113,"124.123.106.96",6667,6,372,6,372,0,0,3526.8536,9.015003999999863,330.1163260715187,0
"147.32.84.165",1122,"212.117.174.7",4506,6,372,6,372,0,0,3528.355981,9.013160999999855,330.18382784908067,0
"147.32.84.165",1114,"74.125.232.217",80,13,2940,10,2066,3,874,3528.356115,8.242455000000064,2005.2278113741443,848.2909521495654
"147.32.84.165",3498,"69.48.99.86",25,6,372,6,372,0,0,3528.364283,9.004981999999927,330.4837255643625,0
"147.32.84.165",1146,"31.192.109.167",80,15,1540,10,1050,5,490,3535.165563,0.23681500000020606,35470.7260941777,16553.005510616258
"147.32.84.165",1137,"201.65.242.60",6667,2,124,2,124,0,0,3535.243336,7.999999979801942e-06,0,0
"147.32.84.165",1139,"67.214.158.5",80,18,2751,14,1956,4,795,3536.367641,0.21112500000026557,74117.22912956928,30124.333925361752
"147.32.84.165",3499,"209.85.225.27",25,6,372,6,372,0,0,3536.471367,9.009588999999778,330.31473466770495,0
"147.32.84.165",3500,"64.12.90.33",25,6,372,6,372,0,0,3537.26915,9.012547999999697,330.20628572520224,0
"147.32.84.165",1155,"61.89.186.155",6667,9,552,6,372,3,180,3538.370328,1.9270419999998012,1544.3358266194027,747.2592709448722
"147.32.84.165",3501,"66.94.237.64",25,6,372,6,372,0,0,3538.370467,9.014392999999927,330.1387015187849,0
"147.32.84.165",3502,"66.94.237.64",25,6,372,6,372,0,0,3538.570597,9.014584000000013,330.1317065768088,0
"147.32.84.165",3503,"217.10.138.227",25,6,372,6,372,0,0,3538.570731,9.014584000000013,330.1317065768088,0
"147.32.84.165",3504,"65.54.188.94",25,6,372,6,372,0,0,3539.27177,9.012711000000309,330.20031375685943,0
"147.32.84.165",3506,"209.85.225.27",25,6,372,6,372,0,0,3540.297678,8.988245000000006,331.099118904747,0
"147.32.84.165",3507,"205.188.59.193",25,6,372,6,372,0,0,3540.297794,8.988252999999986,331.09882420977743,0
"147.32.84.165",1165,"61.17.216.66",6667,4,248,4,248,0,0,3546.783017,3.003566999999748,660.5479418305523,0
"147.32.84.165",1160,"173.192.170.88",80,17,1641,12,1084,5,557,3547.283824,57.19268899999997,151.6277718643375,77.91205620704426
"147.32.84.165",3508,"124.108.116.109",25,6,372,6,372,0,0,3547.484845,9.011422999999922,330.24750918917306,0
"147.32.84.165",3510,"98.139.54.60",25,6,372,6,372,0,0,3547.883954,9.013144000000011,330.1844506201162,0
"147.32.84.165",3511,"209.85.225.27",25,6,372,6,372,0,0,3549.386068,9.013414000000012,330.1745598282733,0
"147.32.84.165",3512,"209.191.88.254",25,6,372,6,372,0,0,3549.386201,9.013374000000113,330.17602509337377,0
"147.32.84.165",1178,"212.117.174.7",4506,6,372,6,372,0,0,3557.497925,8.915813999999955,333.7889283020053,0
"147.32.84.165",1179,"201.87.153.17",6667,2,124,2,124,0,0,3558.29884,7.999999979801942e-06,0,0
"147.32.84.165",1182,"212.117.174.7",4506,6,372,6,372,0,0,3559.402453,8.911211999999978,333.9613062734909,0
"147.32.84.165",3513,"64.12.90.97",25,6,372,6,372,0,0,3559.402588,8.911207999999988,333.9614561796789,0
"147.32.84.165",3514,"65.55.37.88",25,6,372,6,372,0,0,3559.60112,8.913043000000016,333.8927008430224,0
"147.32.84.165",3515,"66.94.237.139",25,6,372,6,372,0,0,3560.30192,8.912851000000046,333.89989353574794,0
"147.32.84.165",3516,"207.69.189.219",25,6,372,6,372,0,0,3561.203051,9.013078999999834,330.18683182517924,0
"147.32.84.165",3517,"77.238.184.241",25,6,372,6,372,0,0,3562.304525,9.013900999999805,330.1567212686343,0
"147.32.84.165",3518,"64.12.90.33",25,6,372,6,372,0,0,3568.413861,9.012940000000071,330.1919240558548,0
"147.32.84.165",1193,"212.117.171.138",65500,348,335876,254,328860,94,7016,3568.814212,24.241507999999612,108527.90181205072,2315.3675093150514
"147.32.84.165",3519,"209.85.225.27",25,6,372,6,372,0,0,3568.814343,9.012892000000193,330.1936825604852,0
"147.32.84.165",1194,"122.121.68.110",6667,2,124,2,124,0,0,3570.316252,8.999999863590347e-06,0,0
"147.32.84.165",3520,"207.115.11.16",25,6,372,6,372,0,0,3571.918818,9.01248600000008,330.2085573281305,0
"147.32.84.165",1200,"76.96.30.116",25,6,372,6,372,0,0,3578.427659,9.873505999999907,301.41268967680054,0
"147.32.84.165",3522,"66.94.237.64",25,6,372,6,372,0,0,3580.330521,9.690644000000248,307.100333063512,0
"147.32.84.165",1213,"98.126.71.122",80,18,4973,14,1540,4,3433,3580.530773,18.991672000000108,648.7053904469249,1446.1075359768136
"147.32.84.165",1206,"92.46.218.192",6667,6,372,6,372,0,0,3580.705527,9.752849999999853,305.14157400145035,0
"147.32.84.165",3523,"195.128.174.71",25,6,372,6,372,0,0,3581.225113,9.670494999999846,307.74019323726935,0
"147.32.84.165",1217,"195.113.232.88",80,17,5969,12,2776,5,3193,3581.928504,17.7054720000001,1254.3014950406223,1442.7178219253267
"147.32.84.165",3524,"98.137.54.237",25,6,372,6,372,0,0,3581.92975,9.824206000000231,302.9252440349816,0
"147.32.84.165",1220,"195.113.232.81",80,16,3561,12,1644,4,1917,3582.229424,17.404759000000013,755.655392872719,881.1383139519478
"147.32.84.165",1210,"212.117.171.138",65500,70,6844,44,4274,26,2570,3582.230207,52.317849000000024,653.5436883118032,392.98251730494485
"147.32.84.165",3526,"64.12.90.97",25,6,372,6,372,0,0,3582.230284,9.530077999999776,312.2744640705008,0
"147.32.84.165",1221,"77.238.175.247",80,14,2274,10,1276,4,998,3583.33396,0.13887999999997191,73502.3041474803,57488.479262684436
"147.32.84.165",1219,"65.55.196.251",443,220,173038,146,11504,74,161534,3583.379769,9.755241999999726,9434.107324042046,132469.49691253548
"147.32.84.165",3527,"209.85.225.27",25,6,372,6,372,0,0,3583.481701,9.429077999999663,315.6194062664564,0
"147.32.84.165",1222,"74.125.232.218",80,13,1871,10,1156,3,715,3583.481768,16.152599999999893,572.539405420803,354.12255612099835
"147.32.84.165",1227,"117.204.66.49",6667,4,248,4,248,0,0,3583.489926,3.5220369999997274,563.3103797603925,0
"147.32.84.165",1231,"212.117.174.7",4506,6,372,6,372,0,0,3589.455521,9.028798000000279,329.6119815727307,0
"147.32.84.165",3528,"209.85.225.27",25,6,372,6,372,0,0,3589.85583,9.030814000000191,329.5384004143964,0
"147.32.84.165",1223,"68.67.185.209",80,13,1990,10,1250,3,740,3592.965779,6.668772999999874,1499.5262246893378,887.719525016088
"147.32.84.165",3529,"64.29.145.43",25,6,372,6,372,0,0,3592.994895,9.011228000000301,330.2546556362685,0
"147.32.84.165",1224,"64.236.79.229",80,5,306,4,244,1,62,3599.488692,0.11794300000019575,16550.36755039943,4205.421262806413
"147.32.84.165",1239,"111.88.31.68",6667,2,124,2,124,0,0,3600.003476,9.000000318337698e-06,0,0
"147.32.84.165",3530,"66.94.237.64",25,6,372,6,372,0,0,3601.405141,8.913596999999754,333.8719486645046,0
"147.32.84.165",1228,"212.117.174.7",4506,6,372,6,372,0,0,3601.705652,9.013421999999991,330.17426677681385,0
"147.32.84.165",3534,"66.94.237.64",25,6,372,6,372,0,0,3601.70579,9.013410000000022,330.1747063541981,0
"147.32.84.165",1241,"212.117.171.138",65500,113,36953,78,6198,35,30755,3601.705849,63.60648600000013,779.5431428172262,3868.158979887672
"147.32.84.165",3535,"205.188.59.193",25,6,372,6,372,0,0,3601.705922,9.013331000000107,330.17760026786596,0
"147.32.84.165",1242,"205.188.186.167",587,44,5447,28,3674,16,1773,3602.30728,32.335301999999956,908.9755834041705,438.6537042394105
"147.32.84.165",3536,"209.85.225.27",25,6,372,6,372,0,0,3602.425234,8.89446100000032,334.5902579144361,0
"147.32.84.165",3537,"66.94.237.64",25,6,372,6,372,0,0,3602.425272,8.894568000000163,334.5862328558223,0
"147.32.84.165",3538,"208.65.144.13",25,6,372,6,372,0,0,3602.425301,8.894607999999607,334.58472818589996,0
"147.32.84.165",3539,"173.236.81.226",3817,11,666,8,484,3,182,3603.007731,0.42024499999979525,9213.672976482496,3464.645623388046
"147.32.84.165",3540,"66.94.237.64",25,6,372,6,372,0,0,3603.135404,8.888261000000057,334.82365110565286,0
"147.32.84.165",3541,"205.188.146.193",25,6,372,6,372,0,0,3603.135443,8.888270999999804,334.8232744028693,0
"147.32.84.165",3542,"64.12.90.33",25,6,372,6,372,0,0,3603.307986,8.913394000000153,333.8795525026661,0
"147.32.84.165",1243,"200.206.208.45",6667,6,372,6,372,0,0,3610.418564,9.017125999999735,330.03863980608537,0
"147.32.84.165",1244,"173.192.170.88",80,19,2123,14,1568,5,555,3610.818901,58.57549399999971,214.15098949058907,75.79961681586539
"147.32.84.165",3543,"66.94.237.64",25,6,372,6,372,0,0,3611.01966,9.012655999999879,330.20232881406326,0
"147.32.84.165",3545,"213.199.180.150",25,6,372,6,372,0,0,3611.019694,9.012748000000101,330.19895818677793,0
"147.32.84.165",3546,"151.151.26.141",25,6,372,6,372,0,0,3611.419767,9.012872000000243,330.19441527627595,0
"147.32.84.165",3547,"64.12.90.98",25,6,372,6,372,0,0,3612.023531,9.009987000000365,330.30014360729706,0
"147.32.84.165",1245,"210.212.69.248",6667,9,552,6,372,3,180,3613.923875,1.9806360000002314,1502.5476665069464,727.0391934711031
"147.32.84.165",1246,"212.117.174.7",4506,6,372,6,372,0,0,3615.904803,8.934414000000288,333.094033923199,0
"147.32.84.165",3548,"209.85.225.27",25,6,372,6,372,0,0,3622.335315,9.013262000000395,330.1801279048439,0
"147.32.84.165",1248,"117.206.80.51",6667,4,248,4,248,0,0,3622.736096,3.0049049999997806,660.2538183403951,0
"147.32.84.165",3550,"205.188.156.193",25,6,372,6,372,0,0,3623.336748,9.013320000000022,330.1780032218975,0
"147.32.84.165",3551,"24.105.221.37",25,6,372,6,372,0,0,3624.037752,9.01290599999993,330.19316966137484,0
"147.32.84.165",3552,"205.188.159.42",25,6,372,6,372,0,0,3624.23866,9.0146450000002,330.1294726525486,0
"147.32.84.165",1251,"212.117.174.7",4506,6,372,6,372,0,0,3631.449045,9.012402000000293,330.2116350335796,0
"147.32.84.165",1253,"184.164.142.139",6667,9,552,6,372,3,180,3631.44913,1.362141000000065,2184.795847125854,1057.1592808673486
"147.32.84.165",3553,"72.167.238.201",25,6,372,6,372,0,0,3632.04994,9.01760800000011,330.02099891678193,0
"147.32.84.165",3554,"66.94.237.64",25,6,372,6,372,0,0,3632.450201,9.013062999999875,330.18741797322855,0
"147.32.84.165",1258,"212.117.171.138",65500,24,1483,18,1092,6,391,3632.811545,75.47064599999976,115.75361366325164,41.446577786017755
"147.32.84.165",3555,"209.85.225.27",25,6,372,6,372,0,0,3632.81161,8.952068999999938,332.4371159337602,0
"147.32.84.165",1259,"64.12.175.136",587,63,24058,40,21796,23,2262,3632.811682,32.55852999999979,5355.524343390231,555.7990486671271
"147.32.84.165",3556,"200.72.134.139",25,6,372,6,372,0,0,3632.929863,8.934008000000176,333.10917115811196,0
"147.32.84.165",3557,"209.85.225.27",25,6,372,6,372,0,0,3633.050815,9.01316399999996,330.1837179485487,0
"147.32.84.165",3559,"64.12.90.33",25,6,372,6,372,0,0,3633.050895,9.013208000000304,330.18210608252906,0
"147.32.84.165",1262,"82.227.106.170",6667,4,248,4,248,0,0,3636.856149,3.0049369999996998,660.2467872039241,0
"147.32.84.165",3561,"209.85.225.27",25,6,372,6,372,0,0,3637.858576,9.012093999999706,330.2229204444713,0
"147.32.84.165",3562,"68.1.17.3",25,6,372,6,372,0,0,3637.858712,9.012084999999843,330.22325022456533,0
"147.32.84.165",1269,"212.117.174.7",4506,6,372,6,372,0,0,3643.365648,9.012939000000188,330.19196069117277,0
"147.32.84.165",1267,"173.192.170.88",80,6,372,6,372,0,0,3644.367107,9.013046000000031,330.188040757807,0
"147.32.84.165",3563,"98.137.54.237",25,6,372,6,372,0,0,3644.36724,9.013132000000041,330.1848902246174,0
"147.32.84.165",3564,"66.94.237.64",25,6,372,6,372,0,0,3645.06824,9.012912000000142,330.19294984794624,0
"147.32.84.165",3565,"205.188.190.2",25,6,372,6,372,0,0,3645.068343,9.012870999999905,330.19445191216334,0
"147.32.84.165",3566,"205.178.149.7",25,6,372,6,372,0,0,3645.268359,9.012905000000046,330.19320629696915,0
"147.32.84.165",1274,"109.86.241.24",6667,9,552,6,372,3,180,3653.079624,1.0471170000000711,2842.089279421304,1375.2044900425665
"147.32.84.165",3567,"207.115.11.16",25,6,372,6,372,0,0,3653.480311,9.01267100000041,330.20177925055344,0
"147.32.84.165",3569,"212.82.111.207",25,6,372,6,372,0,0,3653.88076,9.013025000000198,330.18881008317794,0
"147.32.84.165",3571,"69.175.10.98",4190,11,666,8,484,3,182,3654.081287,0.40320299999984854,9603.103151517857,3611.084242926136
"147.32.84.165",3572,"209.85.225.27",25,6,372,6,372,0,0,3654.126972,8.96715899999981,331.8776883514682,0
"147.32.84.165",3573,"209.85.225.27",25,6,372,6,372,0,0,3654.211753,8.982571999999891,331.3082266415494,0
"147.32.84.165",3574,"66.94.237.64",25,6,372,6,372,0,0,3654.211814,8.982624000000214,331.306308713348,0
"147.32.84.165",3576,"205.188.59.193",25,6,372,6,372,0,0,3654.68218,9.012615000000096,330.2038309635958,0
"147.32.84.165",1282,"31.192.109.167",80,15,1540,10,1050,5,490,3658.888353,0.23920600000019476,35116.17601562319,16387.548807290823
"147.32.84.165",1286,"212.117.174.7",4506,6,372,6,372,0,0,3658.965947,8.934976000000006,333.0730826809158,0
"147.32.84.165",1283,"114.59.51.188",6667,4,248,4,248,0,0,3658.966035,2.9265880000002653,677.9225500821503,0
"147.32.84.165",3577,"66.94.237.64",25,6,372,6,372,0,0,3664.396106,9.013035999999829,330.18840710278494,0
"147.32.84.165",3578,"207.115.11.16",25,6,372,6,372,0,0,3664.396236,9.013030000000072,330.18862691014857,0
"147.32.84.165",3579,"205.188.159.42",25,6,372,6,372,0,0,3664.396295,9.013022999999976,330.18888335245657,0
"147.32.84.165",3580,"209.85.225.27",25,6,372,6,372,0,0,3665.397256,8.912868999999773,333.89921920765084,0
"147.32.84.165",3581,"205.188.156.193",25,6,372,6,372,0,0,3665.397345,8.91291100000035,333.89764578597084,0
"147.32.84.165",1302,"80.98.191.57",6667,4,248,4,248,0,0,3666.09858,3.006742000000031,659.8504294681684,0
"147.32.84.165",3582,"205.188.159.42",25,6,372,6,372,0,0,3666.298594,8.916525000000092,333.76231211149735,0
"147.32.84.165",3583,"64.98.36.4",25,6,372,6,372,0,0,3666.298692,8.916549000000032,333.76141374874845,0
"147.32.84.165",1308,"212.117.174.7",4506,6,372,6,372,0,0,3674.410187,9.012927000000218,330.19240031567193,0
"147.32.84.165",1307,"173.192.170.88",80,6,372,6,372,0,0,3674.510331,9.012865000000147,330.19467172757516,0
"147.32.84.165",3584,"212.247.156.1",25,6,372,6,372,0,0,3674.810698,9.013444000000163,330.1734608879742,0
"147.32.84.165",3585,"66.94.237.64",25,6,372,6,372,0,0,3675.010954,9.013226000000031,330.18144668734476,0
"147.32.84.165",3587,"209.85.225.27",25,6,372,6,372,0,0,3675.011084,9.013220999999703,330.18162985242435,0
"147.32.84.165",3588,"209.85.225.27",25,6,372,6,372,0,0,3675.11571,9.008854000000156,330.34168385900676,0
"147.32.84.165",3589,"205.188.59.193",25,6,372,6,372,0,0,3675.11584,9.00881500000014,330.34311393895354,0
"147.32.84.165",3590,"66.94.237.64",25,6,372,6,372,0,0,3675.115898,9.008780999999999,330.34436068542465,0
"147.32.84.165",3591,"64.136.44.37",25,6,372,6,372,0,0,3675.612091,9.012994000000162,330.18994576052603,0
"147.32.84.165",1318,"41.212.41.40",6667,6,372,6,372,0,0,3684.72512,9.012991000000056,330.1900556652039,0
"147.32.84.165",3592,"209.85.225.27",25,6,372,6,372,0,0,3685.326217,9.013018000000102,330.18906652577044,0
"147.32.84.165",1337,"212.117.174.7",4506,6,372,6,372,0,0,3685.326349,9.013011000000006,330.1893229687613,0
"147.32.84.165",3593,"205.188.159.42",25,6,372,6,372,0,0,3685.326412,9.013002000000142,330.1896526817539,0
"147.32.84.165",1322,"212.117.171.138",65500,69,6788,44,4274,25,2514,3686.327268,272.27880700000014,125.57716252958308,73.86546247060642
"147.32.84.165",3594,"65.55.37.120",25,6,372,6,372,0,0,3686.327372,9.012931999999637,330.19221713867586,0
"147.32.84.165",1338,"75.180.132.243",25,6,372,6,372,0,0,3687.229264,9.012267999999949,330.2165448253444,0
"147.32.84.165",3596,"74.125.159.27",25,6,372,6,372,0,0,3695.440513,9.012832999999773,330.195844081442,0
"147.32.84.165",1340,"117.224.242.30",6667,6,372,6,372,0,0,3695.540588,9.012928999999986,330.1923270448491,0
"147.32.84.165",1359,"173.192.170.88",80,6,372,6,372,0,0,3695.840965,9.012919000000238,330.19269339932174,0
"147.32.84.165",3597,"205.188.59.193",25,6,372,6,372,0,0,3696.041265,9.012935000000198,330.1921072325424,0
"147.32.84.165",1360,"203.200.75.221",6667,4,248,4,248,0,0,3696.141372,3.004342000000179,660.3775468970849,0
"147.32.84.165",3598,"183.79.29.240",25,6,372,6,372,0,0,3696.642796,9.01288199999999,330.1940489179824,0
"147.32.84.165",1369,"212.117.174.7",4506,6,372,6,372,0,0,3705.755633,9.013091999999688,330.1863555814257,0
"147.32.84.165",3599,"65.55.88.22",25,6,372,6,372,0,0,3706.35638,9.013330999999653,330.1776002678826,0
"147.32.84.165",1380,"210.211.186.4",6667,4,248,4,248,0,0,3707.357938,3.0040279999998347,660.4465737337033,0
"147.32.84.165",3601,"209.85.225.27",25,6,372,6,372,0,0,3708.258945,9.012953999999809,330.19141116220754,0
"147.32.84.165",1391,"212.117.174.7",4506,6,372,6,372,0,0,3714.768587,9.012592999999924,330.20463700069723,0
"147.32.84.165",3602,"217.153.37.162",25,6,372,6,372,0,0,3714.768689,9.01261599999998,330.2037943256438,0
"147.32.84.165",1403,"210.212.164.162",6667,8,492,6,372,2,120,3716.471186,3.0041259999998147,990.637543165694,319.5604977953852
"147.32.84.165",3603,"205.188.159.42",25,6,372,6,372,0,0,3716.570806,9.012905000000046,330.19320629696915,0
"147.32.84.165",3604,"195.238.5.129",25,6,372,6,372,0,0,3716.87167,9.012626000000182,330.2034279465208,0
"147.32.84.165",3606,"66.94.237.64",25,6,372,6,372,0,0,3717.071553,9.013103999999657,330.18591597302253,0
"147.32.84.165",3607,"205.188.190.2",25,6,372,6,372,0,0,3717.672829,9.012620999999854,330.203611135989,0
"147.32.84.165",3608,"209.85.225.27",25,6,372,6,372,0,0,3724.382618,9.012568999999985,330.2055163183777,0
"147.32.84.165",3609,"209.85.225.27",25,6,372,6,372,0,0,3724.382749,9.012559000000238,330.2058827021184,0
"147.32.84.165",3610,"208.100.38.50",25,6,372,6,372,0,0,3724.382808,9.012555000000248,330.2060292558457,0
"147.32.84.165",1422,"46.24.73.184",6667,4,248,4,248,0,0,3726.785535,3.0043839999998454,660.3683151022313,0
"147.32.84.165",1427,"173.192.170.88",80,16,2030,12,1502,4,528,3727.386641,8.441285999999764,1423.4797873215452,500.39768821955784
"147.32.84.165",3611,"205.188.146.193",25,6,372,6,372,0,0,3727.587385,8.912117000000308,333.92739345768206,0
"147.32.84.165",1433,"68.67.179.210",80,16,2456,12,1424,4,1032,3729.289187,14.469323000000259,787.3208718887398,570.586474571053
"147.32.84.165",3612,"202.179.178.24",25,6,372,6,372,0,0,3729.319059,8.975018000000091,331.58707871114797,0
"147.32.84.165",1439,"212.117.174.7",4506,6,372,6,372,0,0,3734.598338,8.913715000000138,333.86752885861324,0
"147.32.84.165",1434,"68.67.185.214",80,16,2682,12,1800,4,882,3735.798705,11.215791999999965,1283.9039811009375,629.1129507394593
"147.32.84.165",3613,"74.125.93.27",25,6,372,6,372,0,0,3735.82776,8.887218999999732,334.8629081830986,0
"147.32.84.165",1448,"83.148.82.159",6667,4,248,4,248,0,0,3737.601234,3.000974999999926,661.1184698306547,0
"147.32.84.165",1449,"217.163.21.40",80,21,6659,14,1570,7,5089,3737.901449,0.18794200000002093,66829.12813526833,216620.0210703061
"147.32.84.165",3614,"205.188.156.193",25,6,372,6,372,0,0,3737.9479,8.873928999999862,335.3644141169088,0
"147.32.84.165",1454,"217.163.21.40",80,15,2336,10,1450,5,886,3738.093281,0.139611000000059,83088.00882448445,50769.63849551257
"147.32.84.165",3615,"216.32.181.178",25,6,372,6,372,0,0,3738.139369,8.8944019999999,334.5924773807203,0
"147.32.84.165",1455,"195.113.232.96",80,13,1772,10,1228,3,544,3738.694975,8.319300000000112,1180.8685826932394,523.120935655637
"147.32.84.165",3618,"209.85.225.27",25,6,372,6,372,0,0,3738.695808,8.938400999999885,332.94545635176115,0
"147.32.84.165",1460,"212.117.174.7",4506,6,372,6,372,0,0,3743.711818,9.030195999999705,329.5609530513066,0
"147.32.84.165",1456,"77.238.167.32",80,13,2615,10,1564,3,1051,3743.712005,0.14083500000015192,88841.55217088439,59701.068626342385
"147.32.84.165",3619,"205.188.146.193",25,6,372,6,372,0,0,3743.758069,8.984070999999858,331.2529475780019,0
"147.32.84.165",3620,"66.94.237.64",25,6,372,6,372,0,0,3743.758137,8.984056000000237,331.25350064602463,0
"147.32.84.165",1467,"217.163.21.40",80,17,3694,12,1662,5,2032,3745.317221,0.2501350000002276,53155.29614003599,64988.905990705854
"147.32.84.165",3622,"64.12.90.33",25,6,372,6,372,0,0,3745.363129,8.980563000000075,331.38234206474306,0
"147.32.84.165",1473,"68.202.89.226",6667,4,248,4,248,0,0,3748.43525,3.004367999999886,660.3718319460451,0
"147.32.84.165",3623,"213.199.180.150",25,6,372,6,372,0,0,3750.237845,9.013030999999955,330.1885902755704,0
"147.32.84.165",1486,"173.192.170.88",80,22,2782,18,2536,4,246,3753.843092,45.46620200000007,446.2215691559187,43.284899847143535
"147.32.84.165",3624,"209.85.225.27",25,6,372,6,372,0,0,3755.5454,9.01355999999987,330.1692117210118,0
"147.32.84.165",3626,"205.188.59.193",25,6,372,6,372,0,0,3755.545533,9.013554999999997,330.1693948725005,0
"147.32.84.165",1496,"178.125.252.68",6667,9,552,6,372,3,180,3756.747274,1.0665140000000974,2790.3993759104223,1350.1932464082688
"147.32.84.165",3627,"216.82.254.35",25,6,372,6,372,0,0,3757.048678,9.011887999999999,330.23046890951156,0
"147.32.84.165",3628,"209.85.225.27",25,6,372,6,372,0,0,3757.814062,8.952146999999968,332.4342194112776,0
"147.32.84.165",3629,"64.12.90.97",25,6,372,6,372,0,0,3757.814096,8.952236000000084,332.43091446650556,0
"147.32.84.165",3634,"205.178.149.7",25,6,372,6,372,0,0,3758.850676,9.012549000000035,330.20624908668884,0
"147.32.84.165",3635,"209.85.225.27",25,6,372,6,372,0,0,3759.051175,9.012278000000151,330.2161784179261,0
"147.32.84.165",3636,"64.12.90.33",25,6,372,6,372,0,0,3759.051311,9.01226699999961,330.2165814661426,0
"147.32.84.165",3638,"209.85.225.27",25,6,372,6,372,0,0,3759.051367,9.01225999999997,330.2168379518578,0
"147.32.84.165",3639,"165.212.8.32",25,6,372,6,372,0,0,3759.051426,9.01225599999998,330.21698451530966,0
"147.32.84.165",3643,"64.12.90.33",25,6,372,6,372,0,0,3759.65139,9.01289799999995,330.19346274639037,0
"147.32.84.165",3646,"209.85.225.27",25,6,372,6,372,0,0,3759.651524,9.012891000000309,330.19371919619334,0
"147.32.84.165",1505,"118.98.202.90",6667,4,248,4,248,0,0,3764.659124,3.004182000000128,660.412718004407,0
"147.32.84.165",1504,"212.117.174.7",4506,6,372,6,372,0,0,3764.759169,9.012556000000131,330.20599261740585,0
"147.32.84.165",3647,"174.120.98.200",25,6,372,6,372,0,0,3766.361073,9.012855999999829,330.19500145126653,0
"147.32.84.165",1516,"212.117.174.7",4506,6,372,6,372,0,0,3771.26878,9.012402000000293,330.2116350335796,0
"147.32.84.165",1518,"220.194.21.2",6667,4,248,4,248,0,0,3771.268911,3.003639000000021,660.5321078864624,0
"147.32.84.165",3649,"65.55.92.152",25,6,372,6,372,0,0,3776.575701,9.013378999999986,330.17584193452916,0
"147.32.84.165",3650,"205.188.59.193",25,6,372,6,372,0,0,3778.077829,9.01305500000035,330.187711048017,0
"147.32.84.165",3653,"66.94.237.64",25,6,372,6,372,0,0,3778.778847,9.013078999999834,330.18683182517924,0
"147.32.84.165",1533,"31.192.109.167",80,15,1540,10,1050,5,490,3779.680185,0.23294499999974505,36060.0141664736,16828.006611021014
"147.32.84.165",3654,"64.12.90.33",25,6,372,6,372,0,0,3779.756467,8.9367629999997,333.00648120579,0
"147.32.84.165",3656,"209.85.225.27",25,6,372,6,372,0,0,3779.884134,9.009500000000116,330.31799766912275,0
"147.32.84.165",3657,"64.12.90.33",25,6,372,6,372,0,0,3779.884264,9.009494000000359,330.31821764905794,0
"147.32.84.165",3658,"168.95.5.35",25,6,372,6,372,0,0,3779.884321,9.00948900000003,330.31840096591384,0
"147.32.84.165",3659,"200.52.193.188",25,6,372,6,372,0,0,3780.083804,9.009855000000243,330.3049827105896,0
"147.32.84.165",3660,"209.85.225.27",25,6,372,6,372,0,0,3780.682302,9.012210999999752,330.21863336312055,0
"147.32.84.165",1537,"84.234.53.214",6667,2,124,2,124,0,0,3785.78893,7.999999979801942e-06,0,0
"147.32.84.165",3665,"64.12.90.34",25,6,372,6,372,0,0,3787.392517,9.01173499999959,330.2360755171047,0
"147.32.84.165",3666,"209.85.225.27",25,6,372,6,372,0,0,3789.293973,9.013102000000345,330.1859892409834,0
"147.32.84.165",3667,"64.12.90.33",25,6,372,6,372,0,0,3789.294052,9.013128999999935,330.1850001259298,0
"147.32.84.165",3669,"209.85.225.27",25,6,372,6,372,0,0,3789.294082,9.013128000000052,330.1850367597113,0
"147.32.84.165",3671,"205.188.190.2",25,6,372,6,372,0,0,3789.294115,9.013120999999956,330.1852931964427,0
"147.32.84.165",1563,"173.192.170.88",80,6,372,6,372,0,0,3797.60628,8.912858000000142,333.8996312967123,0
"147.32.84.165",1562,"212.117.174.7",4506,6,372,6,372,0,0,3797.606385,8.912841999999728,333.9002307008349,0
"147.32.84.165",1552,"89.46.59.46",6667,6,372,6,372,0,0,3799.108367,8.912473000000318,333.9140550551899,0
"147.32.84.165",1551,"212.117.174.7",4506,6,372,6,372,0,0,3799.509229,8.91701600000033,333.74393406941175,0
"147.32.84.165",1567,"173.192.170.88",80,22,3140,18,2894,4,246,3799.509294,45.36545299999989,510.3442921643493,43.38102829040426
"147.32.84.165",3672,"212.227.15.186",25,6,372,6,372,0,0,3799.509324,8.917042999999921,333.742923522969,0
"147.32.84.165",3673,"209.85.225.27",25,6,372,6,372,0,0,3799.809148,8.91335300000037,333.88108829526624,0
"147.32.84.165",3675,"64.12.90.97",25,6,372,6,372,0,0,3799.809282,8.913344000000052,333.881425422376,0
"147.32.84.165",3677,"193.235.142.173",25,6,372,6,372,0,0,3800.710514,8.91291500000034,333.8974959370629,0
"147.32.84.165",1569,"109.200.239.148",6667,4,248,4,248,0,0,3800.910895,2.9038909999999305,683.2212366097926,0
"147.32.84.165",3678,"209.85.225.27",25,6,372,6,372,0,0,3801.111532,8.912250000000313,333.92241016577134,0
"147.32.84.165",3679,"74.125.45.27",25,6,372,6,372,0,0,3801.111664,8.9122440000001,333.9226349727371,0
"147.32.84.165",3680,"184.172.33.106",25,6,372,6,372,0,0,3801.611729,9.012874999999894,330.1943053687125,0
"147.32.84.165",3681,"64.12.90.33",25,6,372,6,372,0,0,3808.321296,9.01303199999984,330.1885536410004,0
"147.32.84.165",3683,"209.85.225.27",25,6,372,6,372,0,0,3810.224064,9.014144000000215,330.14782102437334,0
"147.32.84.165",1586,"61.177.120.254",6667,7,426,6,364,1,62,3818.5361,0.2914010000004055,9993.102288584967,1702.1218183853516
"147.32.84.165",3684,"65.55.37.104",25,6,372,6,372,0,0,3818.827358,8.922281000000112,333.5469931960182,0
"147.32.84.165",1600,"173.192.170.88",80,30,5575,22,2650,8,2925,3819.338782,107.97329300000001,196.34484983244883,216.7202587773256
"147.32.84.165",3686,"64.12.90.34",25,6,372,6,372,0,0,3819.338914,9.013570000000072,330.16884541862726,0
"147.32.84.165",3687,"209.85.225.27",25,6,372,6,372,0,0,3820.038674,9.013028000000304,330.18870017932926,0
"147.32.84.165",3688,"205.188.190.2",25,6,372,6,372,0,0,3820.038806,9.013020999999753,330.1889566217677,0
"147.32.84.165",3690,"67.128.48.9",25,6,372,6,372,0,0,3820.438839,9.012952999999925,330.1914477974117,0
"147.32.84.165",3691,"209.85.225.27",25,6,372,6,372,0,0,3820.73987,9.012793000000329,330.19730953544496,0
"147.32.84.165",3693,"64.12.90.33",25,6,372,6,372,0,0,3820.739999,9.012788,330.1974927181245,0
"147.32.84.165",3694,"209.85.225.27",25,6,372,6,372,0,0,3820.740056,9.012780999999904,330.197749174204,0
"147.32.84.165",3696,"205.188.190.2",25,6,372,6,372,0,0,3820.74011,9.012780999999904,330.197749174204,0
"147.32.84.165",3697,"66.94.237.64",25,6,372,6,372,0,0,3820.740169,9.01277200000004,330.1980789040249,0
"147.32.84.165",1606,"78.96.25.166",6667,9,552,6,372,3,180,3821.640733,1.0295189999997092,2890.67030331722,1398.7114370889772
"147.32.84.165",3698,"209.85.225.27",25,6,372,6,372,0,0,3822.046696,9.007485000000088,330.39189074419454,0
"147.32.84.165",3700,"64.12.90.33",25,6,372,6,372,0,0,3822.046828,9.007509000000027,330.39101043362723,0
"147.32.84.165",3702,"128.121.85.2",25,6,372,6,372,0,0,3822.04689,9.007474000000002,330.39229422144314,0
"147.32.84.165",3703,"209.85.225.27",25,6,372,6,372,0,0,3822.642743,9.012238000000252,330.21764405244477,0
"147.32.84.165",3705,"200.147.36.15",25,6,372,6,372,0,0,3822.642806,9.01226399999996,330.21669138853605,0
"147.32.84.165",3706,"209.85.225.27",25,6,372,6,372,0,0,3822.670577,8.984518000000207,331.23646699799934,0
"147.32.84.165",3709,"64.12.90.33",25,6,372,6,372,0,0,3822.670642,8.984478999999737,331.23790483567126,0
"147.32.84.165",3710,"165.212.8.32",25,6,372,6,372,0,0,3822.670701,8.98444500000005,331.23915834533835,0
"147.32.84.165",1612,"212.117.174.7",4506,6,372,6,372,0,0,3829.351557,9.013057000000117,330.18763777927524,0
"147.32.84.165",1617,"61.17.216.17",6667,2,124,2,124,0,0,3831.254423,1.5000000075815478e-05,0,0
"147.32.84.165",1616,"212.117.174.7",4506,6,372,6,372,0,0,3839.767094,9.012312000000293,330.21493263880603,0
"147.32.84.165",3711,"209.85.225.27",25,6,372,6,372,0,0,3839.767181,9.012348999999631,330.21357694870915,0
"147.32.84.165",1632,"218.94.106.74",6667,9,552,6,372,3,180,3840.367623,1.934150000000045,1538.6603934544532,744.5130936069935
"147.32.84.165",3714,"12.96.117.26",25,6,372,6,372,0,0,3841.068422,9.012966000000233,330.1909715403257,0
"147.32.84.165",3715,"205.188.190.2",25,6,372,6,372,0,0,3841.469268,9.013041000000158,330.18822393018604,0
"147.32.84.165",3716,"66.94.237.64",25,6,372,6,372,0,0,3841.769934,9.012578000000303,330.2051865736862,0
"147.32.84.165",3718,"209.85.225.27",25,6,372,6,372,0,0,3842.302004,8.98146399999996,331.3490985434015,0
"147.32.84.165",3721,"64.12.90.33",25,6,372,6,372,0,0,3842.302083,8.981556000000182,331.34570446367417,0
"147.32.84.165",3722,"209.85.225.27",25,6,372,6,372,0,0,3843.071278,9.017381000000114,330.02930673551026,0
"147.32.84.165",3724,"12.102.252.75",25,6,372,6,372,0,0,3843.071507,9.017291999999998,330.0325641001756,0
"147.32.84.165",3727,"209.85.225.27",25,6,372,6,372,0,0,3843.672634,9.012777999999798,330.1978590840767,0
"147.32.84.165",3728,"205.188.190.2",25,6,372,6,372,0,0,3843.672766,9.012769999999819,330.19815217741717,0
"147.32.84.165",3729,"212.118.156.90",25,6,372,6,372,0,0,3843.672826,9.012763000000177,330.19840863450435,0
"147.32.84.165",3736,"209.85.225.27",25,6,372,6,372,0,0,3843.672908,9.012733000000026,330.1995077408808,0
"147.32.84.165",3738,"64.12.90.33",25,6,372,6,372,0,0,3843.672977,9.012718999999834,330.2000206596982,0
"147.32.84.165",3739,"208.65.145.12",25,6,372,6,372,0,0,3843.673053,9.012694999999894,330.20089995279267,0
"147.32.84.165",3744,"209.85.225.27",25,6,372,6,372,0,0,3844.573472,9.01321999999982,330.181666485458,0
"147.32.84.165",3745,"168.95.5.68",25,6,372,6,372,0,0,3844.573613,9.013252000000193,330.18049423226336,0
"147.32.84.165",1646,"117.199.114.136",6667,2,124,2,124,0,0,3850.386321,1.0000000202126103e-05,0,0
"147.32.84.165",1653,"98.126.71.122",80,15,4683,12,1310,3,3373,3860.797277,8.891189999999824,1178.6948653667514,3034.9143365511854
"147.32.84.165",3746,"205.188.59.193",25,6,372,6,372,0,0,3860.972488,8.856172000000242,336.0368339729534,0
"147.32.84.165",1662,"212.117.174.7",4506,6,372,6,372,0,0,3862.091222,8.939213000000109,332.9152130058836,0
"147.32.84.165",1661,"85.185.8.55",6667,6,372,6,372,0,0,3862.492688,8.938246000000163,332.95123002879376,0
"147.32.84.165",1672,"195.113.232.98",80,17,5761,12,2556,5,3205,3862.793877,6.894710999999916,2965.7515739238743,3718.792564329428
"147.32.84.165",3749,"65.54.188.126",25,6,372,6,372,0,0,3862.794008,8.937155999999959,332.9918376718515,0
"147.32.84.165",3750,"209.85.225.27",25,6,372,6,372,0,0,3863.295317,8.936482000000069,333.0169523085233,0
"147.32.84.165",3752,"66.94.238.147",25,6,372,6,372,0,0,3863.395612,8.936249000000316,333.02563525254214,0
"147.32.84.165",3755,"209.85.225.27",25,6,372,6,372,0,0,3864.097878,8.934914999999819,333.0753566206349,0
"147.32.84.165",3756,"65.54.188.126",25,6,372,6,372,0,0,3864.098011,8.934905999999955,333.0756921225601,0
"147.32.84.165",3757,"64.12.90.33",25,6,372,6,372,0,0,3864.098071,8.934893999999986,333.0761394595173,0
"147.32.84.165",3760,"66.94.237.64",25,6,372,6,372,0,0,3864.699459,8.934545000000071,333.0891500350579,0
"147.32.84.165",3762,"209.85.225.27",25,6,372,6,372,0,0,3864.699601,8.934528000000228,333.08978381397696,0
"147.32.84.165",3763,"213.165.64.102",25,6,372,6,372,0,0,3864.69966,8.934520999999677,333.09004478249113,0
"147.32.84.165",1679,"202.95.138.19",6667,9,552,6,372,3,180,3865.603512,1.9439840000000004,1530.8767973398956,740.7468374225301
"147.32.84.165",1683,"212.117.174.7",4506,6,372,6,372,0,0,3867.547786,8.990802999999687,331.0049169134396,0
"147.32.84.165",3764,"64.12.90.33",25,6,372,6,372,0,0,3867.547863,8.99085100000002,331.00314975745823,0
"147.32.84.165",3765,"209.85.225.27",25,6,372,6,372,0,0,3867.547921,8.990843999999925,331.00340746653205,0
"147.32.84.165",3766,"67.69.240.20",25,6,372,6,372,0,0,3867.547981,8.99083900000005,331.00359154468043,0
"147.32.84.165",1697,"173.192.170.88",80,22,2782,18,2536,4,246,3881.84592,45.46572799999967,446.226221209966,43.285351111061374
"147.32.84.165",1689,"27.255.59.54",6667,9,552,6,372,3,180,3881.846044,1.3604620000000978,2187.4921901528937,1058.4639629772066
"147.32.84.165",3769,"64.12.90.33",25,6,372,6,372,0,0,3883.047851,9.012367000000268,330.2129174277869,0
"147.32.84.165",1705,"49.114.102.212",6667,4,248,4,248,0,0,3883.047886,3.003961000000345,660.461304257869,0
"147.32.84.165",3772,"209.85.225.27",25,6,372,6,372,0,0,3883.206767,8.953559000000041,332.3817936532262,0
"147.32.84.165",3773,"207.115.36.21",25,6,372,6,372,0,0,3883.2068,8.953649999999925,332.37841550652803,0
"147.32.84.165",3774,"64.12.90.33",25,6,372,6,372,0,0,3883.447964,9.012779000000137,330.1978224474332,0
"147.32.84.165",3775,"209.85.225.27",25,6,372,6,372,0,0,3883.448047,9.012825000000248,330.19613717118864,0
"147.32.84.165",3778,"168.95.5.40",25,6,372,6,372,0,0,3883.448077,9.012849000000188,330.1952579034596,0
"147.32.84.165",3781,"64.12.90.33",25,6,372,6,372,0,0,3883.748722,9.017215000000306,330.03538232147054,0
"147.32.84.165",3782,"165.246.16.8",25,6,372,6,372,0,0,3883.748835,9.017227000000275,330.03494311498525,0
"147.32.84.165",3783,"209.85.225.27",25,6,372,6,372,0,0,3884.24927,9.012918000000354,330.1927300348104,0
"147.32.84.165",3785,"64.12.90.33",25,6,372,6,372,0,0,3884.349388,9.012796999999864,330.1971629894743,0
"147.32.84.165",3786,"66.94.237.64",25,6,372,6,372,0,0,3884.34952,9.012848999999733,330.19525790347626,0
"147.32.84.165",3787,"209.85.225.27",25,6,372,6,372,0,0,3884.349578,9.012844000000314,330.19544108384616,0
"147.32.84.165",3789,"205.188.59.193",25,6,372,6,372,0,0,3884.349636,9.012838000000102,330.19566090059163,0
"147.32.84.165",3791,"66.94.237.64",25,6,372,6,372,0,0,3885.05076,9.012319999999818,330.2146395156919,0
"147.32.84.165",3792,"209.85.225.27",25,6,372,6,372,0,0,3885.050821,9.012384000000111,330.2122945493627,0
"147.32.84.165",3793,"204.211.252.146",25,6,372,6,372,0,0,3885.050882,9.012372000000141,330.21273422800937,0
"147.32.84.165",3794,"64.12.90.97",25,6,372,6,372,0,0,3885.651152,9.01552700000002,330.09717568368364,0
"147.32.84.165",3796,"62.24.139.61",25,6,372,6,372,0,0,3885.651294,9.015509000000293,330.0978347423205,0
"147.32.84.165",1713,"212.117.174.7",4506,6,372,6,372,0,0,3888.555614,9.01291399999991,330.19287657687954,0
"147.32.84.165",1721,"207.232.61.93",6667,6,372,6,372,0,0,3899.371062,9.015848000000005,330.08542291307464,0
"147.32.84.165",1724,"212.117.174.7",4506,6,372,6,372,0,0,3904.178089,9.012440999999853,330.2102060917845,0
"147.32.84.165",3797,"209.85.225.27",25,6,372,6,372,0,0,3904.178186,9.012468999999783,330.20918019247245,0
"147.32.84.165",1731,"31.192.109.167",80,15,1540,10,1050,5,490,3904.178215,0.23676000000023123,35478.96604152642,16556.850819378997
"147.32.84.165",1733,"178.137.128.94",6667,4,248,4,248,0,0,3904.255575,2.9266469999997753,677.9088834424351,0
"147.32.84.165",3802,"76.162.254.116",25,6,372,6,372,0,0,3904.478501,9.016356000000087,330.0668252229583,0
"147.32.84.165",3804,"209.85.225.27",25,6,372,6,372,0,0,3904.779096,9.01253399999996,330.2067986650606,0
"147.32.84.165",3805,"64.12.90.33",25,6,372,6,372,0,0,3904.779229,9.012539999999717,330.20657883350236,0
"147.32.84.165",3809,"209.85.225.27",25,6,372,6,372,0,0,3905.279153,9.013092000000142,330.18635558140903,0
"147.32.84.165",3813,"64.12.90.33",25,6,372,6,372,0,0,3905.379291,9.013136000000031,330.1847436896536,0
"147.32.84.165",3815,"74.125.93.27",25,6,372,6,372,0,0,3905.379424,9.013128999999935,330.1850001259298,0
"147.32.84.165",3818,"209.85.225.27",25,6,372,6,372,0,0,3906.080598,9.01281599999993,330.1964668978068,0
"147.32.84.165",3819,"114.147.58.7",25,6,372,6,372,0,0,3906.080734,9.012804999999844,330.1968698978899,0
"147.32.84.165",3821,"64.12.90.33",25,6,372,6,372,0,0,3906.681385,9.014656000000286,330.1290698169631,0
"147.32.84.165",3822,"200.175.8.148",25,6,372,6,372,0,0,3906.68153,9.01456700000017,330.13232915124416,0
"147.32.84.165",3825,"209.85.225.27",25,6,372,6,372,0,0,3906.681599,9.01455100000021,330.1329151058029,0
"147.32.84.165",3831,"64.12.90.33",25,6,372,6,372,0,0,3906.681657,9.014542999999776,330.1332080838789,0
"147.32.84.165",3832,"209.85.225.27",25,6,372,6,372,0,0,3906.681712,9.014538999999786,330.1333545731036,0
"147.32.84.165",3833,"77.238.177.9",25,6,372,6,372,0,0,3906.681771,9.014530999999806,330.13364755194294,0
"147.32.84.165",3835,"98.139.175.224",25,6,372,6,372,0,0,3909.585343,9.013768999999684,330.16155617035497,0
"147.32.84.165",1751,"212.117.174.7",4506,6,372,6,372,0,0,3919.199354,9.012951000000157,330.1915210678443,0
"147.32.84.165",1746,"117.196.25.55",6667,6,372,6,372,0,0,3920.401388,8.91240099999959,333.916752623691,0
"147.32.84.165",3836,"64.12.90.33",25,6,372,6,372,0,0,3925.508915,8.91236600000002,333.9180639574265,0
"147.32.84.165",3838,"209.85.225.27",25,6,372,6,372,0,0,3925.50909,8.912315999999919,333.9199373092277,0
"147.32.84.165",1756,"212.117.171.138",65500,11,666,8,484,3,182,3925.509149,307.5292949999998,12.590670427023879,4.734508301070963
"147.32.84.165",3839,"66.94.237.64",25,6,372,6,372,0,0,3925.509206,8.912253999999848,333.9222602946517,0
"147.32.84.165",1761,"41.223.57.76",6667,2,124,2,124,0,0,3925.808771,1.0000000202126103e-05,0,0
"147.32.84.165",3841,"209.85.225.27",25,6,372,6,372,0,0,3926.309862,8.91234600000007,333.9188132956212,0
"147.32.84.165",1769,"64.12.168.40",587,46,5575,30,3802,16,1773,3926.410147,32.287812999999915,942.0272596350852,439.2988772574977
"147.32.84.165",3842,"64.12.90.33",25,6,372,6,372,0,0,3926.52785,8.898360000000139,334.44365029061015,0
"147.32.84.165",3844,"83.137.128.231",25,6,372,6,372,0,0,3927.11078,8.912800000000061,333.9018041468427,0
"147.32.84.165",1772,"173.192.170.88",80,18,2071,14,1572,4,499,3927.71526,56.72447800000009,221.70323012932758,70.37526198125602
"147.32.84.165",3846,"209.85.225.27",25,6,372,6,372,0,0,3927.715415,8.908998999999767,334.04426243622635,0
"147.32.84.165",3847,"64.12.90.33",25,6,372,6,372,0,0,3927.715474,8.909063999999944,334.0418252691886,0
"147.32.84.165",3850,"209.85.225.27",25,6,372,6,372,0,0,3927.715525,8.909064999999828,334.04178777459333,0
"147.32.84.165",3851,"66.39.2.3",25,6,372,6,372,0,0,3927.715587,8.909053999999742,334.0422002156555,0
"147.32.84.165",1776,"212.117.174.7",4506,6,372,6,372,0,0,3930.517051,9.011655000000246,330.2390071523953,0
"147.32.84.165",3852,"205.188.59.193",25,6,372,6,372,0,0,3930.517183,9.011647000000266,330.23930031878876,0
"147.32.84.165",1778,"41.233.20.42",6667,4,248,4,248,0,0,3930.81664,3.003794000000198,660.4980234995705,0
"147.32.84.165",3853,"65.55.88.22",25,6,372,6,372,0,0,3939.028724,9.011955000000398,330.22801378833657,0
"147.32.84.165",3855,"74.6.140.31",25,6,372,6,372,0,0,3940.229433,9.013425999999981,330.1741202512792,0
"147.32.84.165",1789,"190.114.77.46",6667,4,248,4,248,0,0,3941.331228,3.0043390000000727,660.3782063209085,0
"147.32.84.165",3858,"209.85.225.27",25,6,372,6,372,0,0,3946.438835,9.012654000000111,330.202402089325,0
"147.32.84.165",1796,"212.117.174.7",4506,6,372,6,372,0,0,3946.438933,9.01268200000004,330.2013762385033,0
"147.32.84.165",3859,"64.12.90.33",25,6,372,6,372,0,0,3947.239622,9.013235999999779,330.18108035782853,0
"147.32.84.165",3860,"85.158.141.190",25,6,372,6,372,0,0,3947.239773,9.013216000000284,330.18181301767385,0
"147.32.84.165",3862,"213.199.180.150",25,6,372,6,372,0,0,3947.440279,9.012650000000122,330.2025486399627,0
"147.32.84.165",3863,"209.85.225.27",25,6,372,6,372,0,0,3948.040823,9.013001000000259,330.18968931656775,0
"147.32.84.165",3864,"64.12.90.33",25,6,372,6,372,0,0,3948.64178,9.01270599999998,330.2004969428723,0
"147.32.84.165",3865,"64.12.138.161",25,6,372,6,372,0,0,3949.24271,9.013127000000168,330.1850733935009,0
"147.32.84.165",1804,"178.137.128.94",6667,4,248,4,248,0,0,3951.5468,3.0032129999999597,660.625803098224,0
"147.32.84.165",1810,"212.117.174.7",4506,6,372,6,372,0,0,3959.457398,9.013022999999976,330.18888335245657,0
"147.32.84.165",3866,"184.154.22.10",25,6,372,6,372,0,0,3959.457534,9.013016999999763,330.1891031604709,0
"147.32.84.165",3869,"205.188.146.193",25,6,372,6,372,0,0,3960.058483,9.01277200000004,330.1980789040249,0
"147.32.84.165",1815,"119.152.220.218",6667,4,248,4,248,0,0,3961.259766,3.0044659999998657,660.350291865539,0
"147.32.84.165",3870,"66.94.237.64",25,6,372,6,372,0,0,3967.469163,9.012878,330.1941954612056,0
"147.32.84.165",3871,"209.191.88.254",25,6,372,6,372,0,0,3968.270212,9.012928999999986,330.1923270448491,0
"147.32.84.165",3872,"209.85.225.27",25,6,372,6,372,0,0,3968.470748,9.012236999999914,330.2176806934869,0
"147.32.84.165",3873,"209.85.225.27",25,6,372,6,372,0,0,3968.470805,9.012314999999944,330.2148227175835,0
"147.32.84.165",3875,"64.12.90.98",25,6,372,6,372,0,0,3968.470864,9.012313000000177,330.2148959983904,0
"147.32.84.165",3876,"161.58.16.34",25,6,372,6,372,0,0,3969.071121,9.013245000000097,330.18075066193893,0
"147.32.84.165",3877,"205.188.156.193",25,6,372,6,372,0,0,3969.071313,9.013178000000153,330.18320508037783,0
"147.32.84.165",3885,"65.55.37.88",25,6,372,6,372,0,0,3969.671902,9.012850999999955,330.1951846313686,0
"147.32.84.165",3886,"72.4.117.21",25,6,372,6,372,0,0,3970.272676,9.01338399999986,330.17565877588777,0
"147.32.84.165",1832,"212.117.174.7",4506,6,372,6,372,0,0,3979.285915,9.012815000000046,330.1965035341328,0
"147.32.84.165",1828,"85.130.81.228",6667,6,372,6,372,0,0,3980.487672,9.013367000000017,330.1762815161076,0
"147.32.84.165",3887,"97.64.187.45",25,6,372,6,372,0,0,3981.088258,9.01353999999992,330.16994432820246,0
"147.32.84.165",1843,"190.77.235.75",6667,6,372,6,372,0,0,3988.499277,9.013209000000188,330.1820694493979,0
"147.32.84.165",1849,"212.117.174.7",4506,6,372,6,372,0,0,3989.300103,8.912807000000157,333.9015419048059,0
"147.32.84.165",3889,"209.85.225.27",25,6,372,6,372,0,0,3989.300236,8.912797999999839,333.9018790732219,0
"147.32.84.165",3890,"64.12.90.98",25,6,372,6,372,0,0,3989.501175,8.911935000000085,333.93421294028417,0
"147.32.84.165",3891,"65.55.37.88",25,6,372,6,372,0,0,3990.10193,8.912144000000353,333.9263817999218,0
"147.32.84.165",3892,"64.12.90.33",25,6,372,6,372,0,0,3990.101994,8.91220599999997,333.9240587571708,0
"147.32.84.165",3893,"66.94.237.64",25,6,372,6,372,0,0,3990.102055,8.912195000000338,333.9244709075471,0
"147.32.84.165",1859,"119.154.117.193",6667,4,248,4,248,0,0,3990.702788,3.003820999999789,660.4920865791069,0
"147.32.84.165",3896,"66.94.237.64",25,6,372,6,372,0,0,3991.303274,8.91242800000009,333.915741030387,0
"147.32.84.165",3898,"124.108.110.37",25,6,372,6,372,0,0,3991.303433,8.912396000000172,333.91693995643175,0
"147.32.84.165",3899,"209.85.225.27",25,6,372,6,372,0,0,4000.215893,9.012800999999854,330.19701644361703,0
"147.32.84.165",3900,"209.85.225.27",25,6,372,6,372,0,0,4000.21595,9.012816000000385,330.1964668977901,0
"147.32.84.165",3901,"64.12.90.98",25,6,372,6,372,0,0,4000.216005,9.012789999999768,330.1974194450416,0
"147.32.84.165",3902,"205.188.59.193",25,6,372,6,372,0,0,4000.216063,9.012756999999965,330.19862845520095,0
"147.32.84.165",1871,"194.67.211.76",6667,4,248,4,248,0,0,4001.417505,3.0048170000000027,660.2731547378753,0
"147.32.84.165",3903,"66.94.237.64",25,6,372,6,372,0,0,4002.018616,9.01325799999995,330.1802744357275,0
"147.32.84.165",3904,"206.46.232.11",25,6,372,6,372,0,0,4002.018754,9.013246999999865,330.1806773962862,0
"147.32.84.165",1878,"212.117.174.7",4506,6,372,6,372,0,0,4009.329068,9.013452000000143,330.17316783846553,0
"147.32.84.165",3905,"173.247.244.100",25,6,372,6,372,0,0,4009.429214,9.012901000000056,330.1933528394444,0
"147.32.84.165",3906,"209.85.225.27",25,6,372,6,372,0,0,4010.230054,9.012997999999698,330.18979922109156,0
"147.32.84.165",3907,"64.12.90.98",25,6,372,6,372,0,0,4010.433251,9.01006200000029,330.29739417996285,0
"147.32.84.165",1885,"117.204.65.119",6667,4,248,4,248,0,0,4011.03207,3.0036969999996472,660.5193533170067,0
"147.32.84.165",3908,"98.137.54.237",25,6,372,6,372,0,0,4011.032134,9.012439000000086,330.21027937054237,0
"147.32.84.165",3911,"66.94.237.64",25,6,372,6,372,0,0,4012.2331,9.01280799999995,330.19675998867575,0
"147.32.84.165",1892,"212.117.174.7",4506,6,372,6,372,0,0,4019.545805,9.010606999999709,330.27741638272494,0
"147.32.84.165",3912,"209.191.88.254",25,6,372,6,372,0,0,4019.54594,9.010596999999962,330.2777829260384,0
"147.32.84.165",1899,"213.111.249.148",6667,9,552,6,372,3,180,4021.246051,1.0803710000000137,2754.609296250975,1332.8754659278911
"147.32.84.165",3913,"64.12.90.33",25,6,372,6,372,0,0,4022.326765,8.933831000000282,333.11577082663706,0
"147.32.84.165",3914,"209.85.225.27",25,6,372,6,372,0,0,4023.048808,9.012859999999819,330.19485490732797,0
"147.32.84.165",3915,"65.55.37.72",25,6,372,6,372,0,0,4023.048912,9.012825999999677,330.1961005349606,0
"147.32.84.165",1904,"31.192.109.167",80,15,1540,10,1050,5,490,4029.157977,0.2357719999999972,35627.64026262703,16626.23212255928
"147.32.84.165",1906,"94.248.9.208",6667,9,552,6,372,3,180,4029.235521,1.436055000000124,2072.344025820559,1002.7471092680125
"147.32.84.165",1907,"67.195.168.31",25,6,372,6,372,0,0,4030.360919,9.011270999999851,330.25307972649466,0
"147.32.84.165",3916,"203.150.228.170",25,6,372,6,372,0,0,4030.461024,9.011446999999862,330.24662964782965,0
"147.32.84.165",3917,"208.87.233.190",25,6,372,6,372,0,0,4030.671934,9.001154999999926,330.6242365563113,0
"147.32.84.165",3920,"209.226.94.98",25,6,372,6,372,0,0,4031.26075,9.012607000000116,330.20412406753803,0
"147.32.84.165",3922,"64.12.90.1",25,6,372,6,372,0,0,4031.461131,9.012564000000111,330.2056995101464,0
"147.32.84.165",3923,"209.85.225.27",25,6,372,6,372,0,0,4032.061778,9.012712000000192,330.2002771196879,0
"147.32.84.165",1915,"67.195.168.31",25,6,372,6,372,0,0,4033.263554,9.012660999999753,330.2021456260345,0
"147.32.84.165",3924,"64.12.90.33",25,6,372,6,372,0,0,4033.263648,9.012698,330.20079004089564,0
"147.32.84.165",3925,"212.82.111.207",25,6,372,6,372,0,0,4033.263697,9.012703000000329,330.2006068545576,0
"147.32.84.165",1920,"212.117.174.7",4506,6,372,6,372,0,0,4040.573788,9.012931999999637,330.19221713867586,0
"147.32.84.165",1916,"88.156.111.111",6667,6,372,6,372,0,0,4043.277913,9.01287000000002,330.1944885480422,0
"147.32.84.165",3926,"209.191.88.254",25,6,372,6,372,0,0,4044.079409,9.012940000000071,330.1919240558548,0
"147.32.84.165",1931,"49.128.164.249",6667,6,372,6,372,0,0,4051.389595,9.012650000000122,330.2025486399627,0
"147.32.84.165",1934,"212.117.174.7",4506,6,372,6,372,0,0,4051.489988,9.012456000000384,330.20965650205375,0
"147.32.84.165",1941,"65.54.188.72",25,6,372,6,372,0,0,4051.490139,9.012430000000222,330.21060912538866,0
"147.32.84.165",3928,"64.18.6.13",25,6,372,6,372,0,0,4051.690027,9.013235999999779,330.18108035782853,0
"147.32.84.165",3929,"216.32.181.178",25,6,372,6,372,0,0,4052.290937,9.015246999999817,330.1074280050297,0
"147.32.84.165",3930,"209.85.225.27",25,6,372,6,372,0,0,4052.491049,9.012997999999698,330.18979922109156,0
"147.32.84.165",3931,"64.12.90.33",25,6,372,6,372,0,0,4052.491209,9.012978000000203,330.1905319196311,0
"147.32.84.165",3932,"64.12.90.1",25,6,372,6,372,0,0,4053.092486,9.012643000000025,330.2028051038959,0
"147.32.84.165",1947,"123.236.248.177",6667,9,552,6,372,3,180,4054.29372,1.6045389999999315,1854.7383391741348,897.4540350842587
"147.32.84.165",3934,"71.74.56.243",25,6,372,6,372,0,0,4055.898528,9.010857999999644,330.2682164118131,0
"147.32.84.165",1953,"79.136.165.190",6667,4,248,4,248,0,0,4061.604398,3.003928999999971,660.4683399641001,0
"147.32.84.165",3935,"74.125.67.27",25,6,372,6,372,0,0,4064.308112,9.012696999999662,330.20082667819764,0
"147.32.84.165",1959,"65.54.188.72",25,6,372,6,372,0,0,4065.109124,8.913012999999864,333.8938246808397,0
"147.32.84.165",3936,"209.191.88.254",25,6,372,6,372,0,0,4065.109259,8.913018000000193,333.8936373740001,0
"147.32.84.165",1961,"212.117.174.7",4506,6,372,6,372,0,0,4072.319346,9.013035999999829,330.18840710278494,0
"147.32.84.165",1967,"190.37.39.215",6667,4,248,4,248,0,0,4072.419488,3.0047199999999066,660.294470033834,0
"147.32.84.165",3938,"65.247.121.133",25,6,372,6,372,0,0,4072.619771,9.012993999999708,330.1899457605427,0
"147.32.84.165",3940,"64.12.90.33",25,6,372,6,372,0,0,4073.220643,9.012928999999986,330.1923270448491,0
"147.32.84.165",3941,"64.12.90.1",25,6,372,6,372,0,0,4073.220776,9.01292199999989,330.1925834929046,0
"147.32.84.165",3943,"209.85.225.27",25,6,372,6,372,0,0,4073.220832,9.012915000000248,330.19283994134173,0
"147.32.84.165",3944,"65.54.188.110",25,6,372,6,372,0,0,4073.420955,9.01597700000002,330.08070007277007,0
"147.32.84.165",3946,"64.12.90.33",25,6,372,6,372,0,0,4074.022339,9.012879999999768,330.1941221895861,0
"147.32.84.165",1974,"94.63.149.150",65520,415,26211,214,13564,201,12647,4076.825981,9310.321984,11.655021189007249,10.86707851499371
"147.32.84.165",3947,"180.222.96.138",25,6,372,6,372,0,0,4076.861798,8.977554999999938,331.4933743095999,0
"147.32.84.165",1978,"212.117.174.7",4506,6,372,6,372,0,0,4077.827715,9.012489000000187,330.20844741113564,0
"147.32.84.165",3948,"207.109.18.206",25,6,372,6,372,0,0,4077.827848,9.012480000000323,330.20877716232303,0
"147.32.84.165",1979,"209.236.119.101",6667,2,124,2,124,0,0,4085.338494,8.999999863590347e-06,0,0
"147.32.84.165",3950,"203.188.197.119",25,6,372,6,372,0,0,4086.039097,9.013116999999966,330.18543973189423,0
"147.32.84.165",3951,"209.85.225.27",25,6,372,6,372,0,0,4087.443013,9.01301599999988,330.1891397951629,0
"147.32.84.165",3952,"66.94.237.64",25,6,372,6,372,0,0,4087.443164,9.012928999999986,330.1923270448491,0
"147.32.84.165",1993,"218.93.203.210",6667,2,124,2,124,0,0,4093.349752,1.2999999853491317e-05,0,0
"147.32.84.165",1996,"94.63.149.152",80,41,28388,32,2092,9,26296,4093.650295,0.21814100000028702,76721.01989070362,964367.0836739687
"147.32.84.165",1991,"74.125.127.27",25,6,372,6,372,0,0,4093.685831,8.977584000000206,331.4923034972362,0
"147.32.84.165",3953,"205.188.59.194",25,6,372,6,372,0,0,4094.251103,9.01297300000033,330.1907150947741,0
"147.32.84.165",3954,"77.238.177.9",25,6,372,6,372,0,0,4094.451509,9.01270599999998,330.2004969428723,0
"147.32.84.165",3955,"64.12.90.33",25,6,372,6,372,0,0,4095.052351,9.013290999999754,330.17906555996933,0
"147.32.84.165",2004,"74.125.127.27",25,6,372,6,372,0,0,4097.658399,9.01057899999978,330.27844270607613,0
"147.32.84.165",3956,"209.85.225.27",25,6,372,6,372,0,0,4097.658468,9.010658000000149,330.2755470244183,0
"147.32.84.165",3957,"168.61.70.72",25,6,372,6,372,0,0,4097.85625,9.013652999999977,330.16580514026975,0
"147.32.84.165",2010,"212.117.174.7",4506,6,372,6,372,0,0,4098.857987,9.013316999999915,330.1781131186252,0
"147.32.84.165",2011,"173.192.170.88",80,23,5099,16,1406,7,3693,4107.069838,39.00942499999928,288.34057410485303,757.3554339752648
"147.32.84.165",2012,"61.17.216.11",6667,6,372,6,372,0,0,4107.270611,9.012179000000287,330.21980588711176,0
"147.32.84.165",2022,"212.117.174.7",4506,6,372,6,372,0,0,4107.871101,9.012604999999894,330.2041973436132,0
"147.32.84.165",2018,"60.190.223.75",2012,92,61647,62,3914,30,57733,4107.871237,2.627911999999924,11915.163064821389,175753.2215690683
"147.32.84.165",3958,"207.150.182.107",25,6,372,6,372,0,0,4108.198565,8.985451000000467,331.20207321812177,0
"147.32.84.165",3959,"216.82.254.163",25,6,372,6,372,0,0,4108.471596,9.012856999999713,330.19496481527386,0
"147.32.84.165",2026,"220.143.177.200",6667,2,124,2,124,0,0,4114.680493,1.1000000085914508e-05,0,0
"147.32.84.165",2036,"64.12.90.1",25,6,372,6,372,0,0,4115.281439,9.012707999999293,330.20042366847275,0
"147.32.84.165",3961,"65.55.37.104",25,6,372,6,372,0,0,4115.482103,9.01230200000009,330.2152990434597,0
"147.32.84.165",2038,"195.88.191.59",80,111,48545,68,4400,43,44145,4116.08251,22.124259000000166,1591.0137374544267,15962.568509074015
"147.32.84.165",3962,"209.85.225.27",25,6,372,6,372,0,0,4116.673025,8.923103999999512,333.516229330081,0
"147.32.84.165",3963,"205.188.59.194",25,6,372,6,372,0,0,4116.673093,8.923163999999815,333.5139867428259,0
"147.32.84.165",3966,"64.12.90.33",25,6,372,6,372,0,0,4118.686064,9.013208999999733,330.18206944941454,0
"147.32.84.165",2043,"64.12.90.1",25,6,372,6,372,0,0,4118.886441,9.013612000000649,330.16730695749783,0
"147.32.84.165",3967,"216.92.131.211",25,6,372,6,372,0,0,4118.886574,9.013601999999992,330.16767325648533,0
"147.32.84.165",2044,"221.130.69.202",6667,9,552,6,372,3,180,4119.887865,1.9824590000007447,1501.1659761936473,726.3706336420875
"147.32.84.165",2047,"208.73.210.29",80,72,39106,44,6632,28,32474,4121.870584,17.616439999999784,3011.732222855506,14747.133927172754
"147.32.84.165",3968,"74.125.47.27",25,6,372,6,372,0,0,4122.051555,8.952494999999544,332.42129707976954,0
"147.32.84.165",2054,"212.117.174.7",4506,6,372,6,372,0,0,4127.69914,9.01524900000004,330.10735477189667,0
"147.32.84.165",2053,"180.251.135.144",6667,4,248,4,248,0,0,4128.300496,3.00378499999988,660.5000024968763,0
"147.32.84.165",2051,"74.125.232.218",80,13,2936,10,2062,3,874,4129.201269,10.285971999999674,1603.7375952414145,679.7607459946636
"147.32.84.165",3969,"209.85.225.27",25,6,372,6,372,0,0,4129.209351,8.904928999999356,334.1969374489359,0
"147.32.84.165",2060,"50.22.198.84",80,14,3409,10,2320,4,1089,4129.501986,0.3677689999994982,50466.46128419014,23688.78290451856
"147.32.84.165",3971,"194.247.64.1",25,6,372,6,372,0,0,4129.623027,8.891778000000158,334.6912169871928,0
"147.32.84.165",2074,"178.125.252.68",6667,9,552,6,372,3,180,4136.31158,1.0669120000002295,2789.358447556462,1349.689571398288
"147.32.84.165",2071,"212.117.174.7",4506,6,372,6,372,0,0,4136.511662,8.913244999999733,333.88513386539796,0
"147.32.84.165",2077,"217.72.192.149",25,6,372,6,372,0,0,4136.511794,8.91323900000043,333.8853586221413,0
"147.32.84.165",2061,"195.113.232.88",80,13,2132,10,1544,3,588,4137.378773,2.108654999999999,5857.762412533111,2230.805892855874
"147.32.84.165",3972,"205.188.156.193",25,6,372,6,372,0,0,4137.379637,8.94649599999957,332.64419947207745,0
"147.32.84.165",2062,"67.214.158.5",80,15,2567,10,1712,5,855,4137.513178,0.31710800000018935,43190.332631128265,21569.93831753193
"147.32.84.165",3973,"203.188.197.119",25,6,372,6,372,0,0,4137.61703,9.009135999999671,330.33134364939195,0
"147.32.84.165",3974,"66.94.237.64",25,6,372,6,372,0,0,4139.616298,9.013302000000294,330.1786626033281,0
"147.32.84.165",3975,"64.12.90.1",25,6,372,6,372,0,0,4139.816529,9.013938000000053,330.155366056432,0
"147.32.84.165",2083,"41.223.57.76",6667,4,248,4,248,0,0,4142.920956,3.0043940000005023,660.3661170937195,0
"147.32.84.165",2082,"217.72.192.149",25,6,372,6,372,0,0,4143.32154,9.012966999999662,330.1909349052439,0
"147.32.84.165",3976,"77.238.177.9",25,6,372,6,372,0,0,4143.321674,9.012958000000253,330.1912646214391,0
"147.32.84.165",2091,"173.192.170.88",80,17,1641,12,1084,5,557,4148.629743,68.1607899999999,127.2285723214184,65.37482913563657
"147.32.84.165",3981,"209.85.225.27",25,6,372,6,372,0,0,4148.830608,9.012002999999822,330.22625491803086,0
"147.32.84.165",3982,"203.188.197.119",25,6,372,6,372,0,0,4148.830665,9.012073999999302,330.22365329004515,0
"147.32.84.165",3983,"206.46.232.11",25,6,372,6,372,0,0,4148.830723,9.012064999999893,330.2239830715863,0
"147.32.84.165",2096,"31.192.109.167",80,15,1540,10,1050,5,490,4150.131431,0.23699200000010023,35444.23440452187,16540.642722110206
"147.32.84.165",3985,"66.148.175.178",25,6,372,6,372,0,0,4150.209131,8.935286000000815,333.06152707364134,0
"147.32.84.165",2098,"58.252.109.240",6667,4,248,4,248,0,0,4150.531967,3.005960999999843,660.0218698779205,0
"147.32.84.165",2104,"147.32.84.171",139,33,4810,22,3278,11,1532,4157.441982,0.01659399999971356,1580330.2398730065,738580.2097271037
"147.32.84.165",3987,"64.12.90.33",25,6,372,6,372,0,0,4157.442204,9.012542000000394,330.20650555635353,0
"147.32.84.165",2105,"212.117.174.7",4506,6,372,6,372,0,0,4158.343151,9.013450999999804,330.17320446963816,0
"147.32.84.165",3988,"209.85.225.27",25,6,372,6,372,0,0,4158.643663,9.012832999999773,330.195844081442,0
"147.32.84.165",3989,"75.180.132.243",25,6,372,6,372,0,0,4158.944114,9.012869000000137,330.1945251839292,0
"147.32.84.165",2112,"93.180.203.85",6667,4,248,4,248,0,0,4160.646411,3.004312000000027,660.3841411943839,0
"147.32.84.165",3990,"64.12.90.1",25,6,372,6,372,0,0,4160.846671,9.01364199999989,330.1662080655118,0
"147.32.84.165",2115,"212.117.174.7",4506,6,372,6,372,0,0,4164.351776,9.012895999999273,330.19353601775055,0
"147.32.84.165",3991,"64.98.36.4",25,6,372,6,372,0,0,4164.351912,9.012886999999864,330.1938657391405,0
"147.32.84.165",3993,"66.94.237.64",25,6,372,6,372,0,0,4169.158839,9.012813000000278,330.19657680680916,0
"147.32.84.165",3998,"205.188.59.193",25,6,372,6,372,0,0,4169.860454,9.012319000000389,330.21467615603393,0
"147.32.84.165",2127,"212.12.200.158",6667,9,552,6,372,3,180,4171.162286,1.061825000000681,2802.7217290966887,1356.1556753693653
"147.32.84.165",3999,"209.85.225.27",25,6,372,6,372,0,0,4172.224351,8.951614000000518,332.45401332093047,0
"147.32.84.165",4000,"203.188.197.119",25,6,372,6,372,0,0,4172.224414,8.951645999999528,332.4528248771407,0
"147.32.84.165",2132,"213.174.1.227",6667,4,248,4,248,0,0,4178.472569,3.0038280000007944,660.4905473946828,0
"147.32.84.165",4001,"209.191.88.254",25,6,372,6,372,0,0,4179.373445,9.012969999999768,330.19082499998075,0
"147.32.84.165",4003,"212.27.48.7",25,6,372,6,372,0,0,4179.373599,9.012865000000602,330.19467172755844,0
"147.32.84.165",4004,"66.94.237.64",25,6,372,6,372,0,0,4179.673793,9.014724999999999,330.1265429616545,0
"147.32.84.165",4006,"184.172.33.106",25,6,372,6,372,0,0,4179.673937,9.014704000000165,330.1273120004767,0
"147.32.84.165",4008,"38.113.116.218",25,6,372,6,372,0,0,4179.976446,9.011084000000665,330.2599332111187,0
"147.32.84.165",4009,"64.12.90.33",25,6,372,6,372,0,0,4181.876883,9.013656000000083,330.165695251735,0
"147.32.84.165",2146,"212.117.174.7",4506,6,372,6,372,0,0,4185.381993,9.013205000000198,330.18221598198807,0
"147.32.84.165",2148,"61.17.216.6",6667,2,124,2,124,0,0,4190.189135,9.000000318337698e-06,0,0
"147.32.84.165",2157,"212.117.174.7",4506,6,372,6,372,0,0,4190.890677,8.922622999999476,333.53420849453966,0
"147.32.84.165",2156,"98.126.71.122",80,18,4973,14,1540,4,3433,4190.890738,18.968203999999787,649.5079871557759,1447.8967012375188
"147.32.84.165",4010,"114.108.154.243",25,6,372,6,372,0,0,4191.065511,8.848504999999932,336.32800117082184,0
"147.32.84.165",2159,"195.113.232.88",80,18,6035,12,2776,6,3259,4193.189145,16.780839999999444,1323.4140841579288,1553.6766931810841
"147.32.84.165",4011,"209.85.225.27",25,6,372,6,372,0,0,4193.190026,8.930741999999555,333.2309902133718,0
"147.32.84.165",4014,"131.173.17.11",25,6,372,6,372,0,0,4193.390898,8.930311000000074,333.2470728063082,0
"147.32.84.165",2166,"61.17.216.28",6667,2,124,2,124,0,0,4200.315076,9.999999747378752e-06,0,0
"147.32.84.165",2162,"195.113.232.83",80,13,3379,10,1524,3,1855,4200.315217,9.65487099999973,1262.7822784996652,1537.0479833444087
"147.32.84.165",4015,"64.12.90.97",25,6,372,6,372,0,0,4200.31606,9.028126000000157,329.63651592810606,0
"147.32.84.165",2174,"74.125.232.218",80,13,1871,10,1156,3,715,4200.616187,9.353993000000628,988.6686894034857,611.5035578922943
"147.32.84.165",4016,"64.12.90.1",25,6,372,6,372,0,0,4200.624306,9.020463000000746,329.91654641227996,0
"147.32.84.165",2175,"77.238.175.247",80,14,2274,10,1276,4,998,4200.916873,0.1390639999999621,73405.05091183039,57412.41442790496
"147.32.84.165",4018,"209.85.225.27",25,6,372,6,372,0,0,4200.962779,8.99677199999951,330.7853083306059,0
"147.32.84.165",2176,"68.67.185.214",80,13,1989,10,1250,3,739,4200.962842,9.007429999999658,1110.1945838047457,656.3470379453656
"147.32.84.165",4019,"66.94.237.64",25,6,372,6,372,0,0,4200.98672,8.972929000000477,331.66427595714197,0
"147.32.84.165",2177,"64.236.79.229",80,14,2274,10,1560,4,714,4201.919677,0.3572910000002594,34929.51123871282,15986.968605410864
"147.32.84.165",4020,"76.96.62.116",25,6,372,6,372,0,0,4202.037644,9.023208999999952,329.81614412345056,0
"147.32.84.165",2178,"64.236.79.229",80,14,2618,10,1918,4,700,4202.823146,0.3558730000004289,43116.505045287246,15735.950746455199
"147.32.84.165",4022,"209.85.225.27",25,6,372,6,372,0,0,4202.940776,9.02212899999995,329.8556249860777,0
"147.32.84.165",2180,"64.236.79.229",80,14,2583,10,1926,4,657,4202.940806,0.3560910000005606,43269.83832777504,14760.271952932608
"147.32.84.165",4023,"124.254.72.89",25,6,372,6,372,0,0,4202.940833,9.022195000000465,329.8532119955118,0
"147.32.84.165",2189,"143.107.171.10",6667,4,248,4,248,0,0,4206.334058,3.0099929999996675,659.1377455031354,0
"147.32.84.165",4024,"64.12.90.33",25,6,372,6,372,0,0,4211.963087,9.012236999999914,330.2176806934869,0
"147.32.84.165",2198,"212.117.174.7",4506,6,372,6,372,0,0,4212.36301,9.012797000000319,330.19716298945764,0
"147.32.84.165",4025,"205.166.218.186",25,6,372,6,372,0,0,4214.167643,9.010812999999871,330.2698657712731,0
"147.32.84.165",4026,"205.188.159.42",25,6,372,6,372,0,0,4214.366874,9.01229499999954,330.2155555272161,0
"147.32.84.165",2206,"173.192.170.88",80,21,1891,16,1334,5,557,4221.375943,100.85896299999968,105.81112161543872,44.18050580194855
"147.32.84.165",2204,"78.96.25.166",6667,6,368,4,248,2,120,4221.676733,0.5281519999998636,3756.494342538724,1817.6585528413182
"147.32.84.165",2207,"212.117.174.7",4506,6,372,6,372,0,0,4221.976689,9.012878999999884,330.19415882539175,0
"147.32.84.165",4028,"64.12.90.33",25,6,372,6,372,0,0,4221.976822,9.012870000000476,330.19448854802556,0
"147.32.84.165",4029,"124.254.72.89",25,6,372,6,372,0,0,4221.976878,9.012867999999798,330.194561819841,0
"147.32.84.165",4030,"209.85.225.27",25,6,372,6,372,0,0,4221.976936,9.012861000000157,330.19481827135115,0
"147.32.84.165",4031,"64.12.90.98",25,6,372,6,372,0,0,4223.078315,9.013029000000643,330.18866354471817,0
"147.32.84.165",4032,"209.85.225.27",25,6,372,6,372,0,0,4223.780884,9.011363999999958,330.24967141489503,0
"147.32.84.165",4033,"209.85.225.27",25,6,372,6,372,0,0,4223.781031,9.011341999999786,330.250477675808,0
"147.32.84.165",4034,"64.12.90.33",25,6,372,6,372,0,0,4223.781103,9.011317999999847,330.25135723764834,0
"147.32.84.165",4035,"168.95.6.65",25,6,372,6,372,0,0,4223.78117,9.011303999999654,330.2518703175605,0
"147.32.84.165",4037,"207.115.37.20",25,6,372,6,372,0,0,4223.979777,9.01283500000045,330.1957708090575,0
"147.32.84.165",2216,"27.255.59.70",6667,9,552,6,372,3,180,4230.590107,1.354204999999638,2197.599329496491,1063.3545142724956
"147.32.84.165",4039,"212.113.174.24",25,6,372,6,372,0,0,4231.9446,8.959340999999768,332.16728775030185,0
"147.32.84.165",2220,"212.117.171.138",65500,24,1476,18,1092,6,384,4232.992748,168.56685000000016,51.82513643696843,18.224223802010876
"147.32.84.165",4042,"207.115.36.22",25,6,372,6,372,0,0,4232.992806,9.015892999999778,330.08377539530176,0
"147.32.84.165",4043,"187.16.23.22",25,6,372,6,372,0,0,4233.393001,9.013198999999986,330.1824357811255,0
"147.32.84.165",4044,"209.85.225.27",25,6,372,6,372,0,0,4233.997415,9.009454000000005,330.31968418951897,0
"147.32.84.165",4046,"66.94.237.64",25,6,372,6,372,0,0,4233.997547,9.009446000000025,330.3199774991705,0
"147.32.84.165",2230,"210.72.66.210",6667,4,248,4,248,0,0,4235.195775,3.0042469999998502,660.398429290301,0
"147.32.84.165",4047,"205.188.146.193",25,6,372,6,372,0,0,4235.39598,9.013146999999663,330.18434071918625,0
"147.32.84.165",2235,"212.117.174.7",4506,6,372,6,372,0,0,4243.007067,8.913190000000213,333.8871941470931,0
"147.32.84.165",4048,"64.12.90.33",25,6,372,6,372,0,0,4244.108485,8.912995000000592,333.8944989871309,0
"147.32.84.165",4050,"77.238.177.9",25,6,372,6,372,0,0,4244.80975,8.91261299999951,333.90880990795443,0
"147.32.84.165",2243,"41.239.162.145",6667,4,248,4,248,0,0,4245.009923,3.004095000000234,660.4318438664042,0
"147.32.84.165",2246,"212.117.174.7",4506,6,372,6,372,0,0,4252.821323,9.012630999999601,330.20324475728916,0
"147.32.84.165",4051,"141.146.126.228",25,6,372,6,372,0,0,4252.821458,9.012621999999283,330.2035744981024,0
"147.32.84.165",4052,"209.85.225.27",25,6,372,6,372,0,0,4253.822356,9.013061000000562,330.1874912418561,0
"147.32.84.165",4053,"209.191.88.254",25,6,372,6,372,0,0,4253.922449,9.013119000000188,330.1853664641439,0
"147.32.84.165",4054,"64.12.90.98",25,6,372,6,372,0,0,4254.324807,9.011257000000114,330.2535928117423,0
"147.32.84.165",4055,"209.85.225.27",25,6,372,6,372,0,0,4254.924176,9.012896999999612,330.1934993820664,0
"147.32.84.165",4056,"64.12.90.33",25,6,372,6,372,0,0,4254.924307,9.0128909999994,330.19371919622665,0
"147.32.84.165",4058,"66.94.237.64",25,6,372,6,372,0,0,4254.924367,9.012887000000774,330.1938657391072,0
"147.32.84.165",2258,"93.177.150.210",6667,4,248,4,248,0,0,4256.326089,3.004433999999492,660.3573252067896,0
"147.32.84.165",4060,"209.85.225.27",25,6,372,6,372,0,0,4263.436201,9.013389999999163,330.1754389858063,0
"147.32.84.165",4061,"205.188.59.193",25,6,372,6,372,0,0,4263.436335,9.013380999999754,330.17576867105487,0
"147.32.84.165",4062,"207.115.36.22",25,6,372,6,372,0,0,4263.937318,9.013216999999713,330.18177638462436,0
"147.32.84.165",2269,"78.153.48.99",6667,4,248,4,248,0,0,4265.039222,3.0035799999996016,660.5450828678654,0
"147.32.84.165",4064,"199.239.254.18",25,6,372,6,372,0,0,4265.739853,9.012643000000025,330.2028051038959,0
"147.32.84.165",2275,"31.192.109.167",80,15,1540,10,1050,5,490,4273.651554,0.2324189999999362,36141.62353336993,16866.0909822393
"147.32.84.165",2272,"212.117.174.7",4506,6,372,6,372,0,0,4273.727799,8.935989999999947,333.03528764020746,0
"147.32.84.165",4066,"209.85.225.27",25,6,372,6,372,0,0,4273.851441,9.01437900000019,330.13921424869505,0
"147.32.84.165",4067,"66.94.237.64",25,6,372,6,372,0,0,4273.851582,9.014525999999933,330.1338306639775,0
"147.32.84.165",4068,"64.90.188.132",25,6,372,6,372,0,0,4273.85165,9.014573000000382,330.1321094188126,0
"147.32.84.165",4069,"205.188.146.193",25,6,372,6,372,0,0,4274.852695,9.013159000000087,330.18390111613155,0
"147.32.84.165",4070,"209.85.225.27",25,6,372,6,372,0,0,4274.952766,9.013073000000077,330.1870516304455,0
"147.32.84.165",2282,"111.88.31.68",6667,4,248,4,248,0,0,4275.35331,3.004934999999932,660.2472266455164,0
"147.32.84.165",4071,"64.12.90.33",25,6,372,6,372,0,0,4275.955657,9.01283599999988,330.1957341729107,0
"147.32.84.165",2286,"212.117.174.7",4506,6,372,6,372,0,0,4283.865643,9.013151999999536,330.1841575511157,0
"147.32.84.165",4072,"66.94.237.64",25,6,372,6,372,0,0,4283.865783,9.013148000000001,330.1843040855425,0
"147.32.84.165",4074,"66.94.237.64",25,6,372,6,372,0,0,4284.466524,9.013328000000001,330.1777101643255,0
"147.32.84.165",4075,"205.188.59.194",25,6,372,6,372,0,0,4284.466668,9.013245000000097,330.18075066193893,0
"147.32.84.165",4076,"209.85.225.27",25,6,372,6,372,0,0,4284.968562,9.011757000000216,330.2352693264952,0
"147.32.84.165",4077,"66.199.31.140",25,6,372,6,372,0,0,4284.968592,9.011867000000166,330.23123843260726,0
"147.32.84.165",2296,"93.116.166.52",6667,4,248,4,248,0,0,4286.770469,3.003703000000314,660.5180339067452,0
"147.32.84.165",4079,"64.12.90.97",25,6,372,6,372,0,0,4293.479704,9.012673999999606,330.2016693381043,0
"147.32.84.165",4080,"67.72.106.4",25,6,372,6,372,0,0,4294.68111,9.013220999999248,330.181629852441,0
"147.32.84.165",4081,"66.94.237.64",25,6,372,6,372,0,0,4294.884447,9.009936999999809,330.301976584305,0
"147.32.84.165",4082,"207.115.11.16",25,6,372,6,372,0,0,4294.884581,9.009927000000062,330.3023431821345,0
"147.32.84.165",2313,"111.92.142.42",6667,8,492,6,372,2,120,4295.883109,3.751641999999265,793.2526611016144,255.88795519406918
"147.32.84.165",2312,"173.192.170.88",80,19,2710,16,2524,3,186,4295.983109,18.963991000000533,1064.7547765657257,78.46449621284667
"147.32.84.165",4083,"209.85.225.27",25,6,372,6,372,0,0,4295.98324,9.012881000000561,330.1940855537552,0
"147.32.84.165",4084,"209.85.225.27",25,6,372,6,372,0,0,4296.984488,9.013154000000213,330.1840842839177,0
"147.32.84.165",4086,"205.188.59.193",25,6,372,6,372,0,0,4296.984621,9.013123000000633,330.1852199287407,0
"147.32.84.165",4088,"153.45.88.198",25,6,372,6,372,0,0,4299.635039,8.966562000000522,331.8997850011885,0
"147.32.84.165",2319,"212.117.174.7",4506,6,372,6,372,0,0,4303.694196,9.012917999999445,330.1927300348437,0
"147.32.84.165",2324,"60.243.38.64",6667,4,248,4,248,0,0,4304.89609,3.004562000000078,660.3291927408882,0
"147.32.84.165",4089,"150.244.9.241",25,6,372,6,372,0,0,4305.496739,9.014960999999857,330.1179006764474,0
"147.32.84.165",4090,"64.12.90.1",25,6,372,6,372,0,0,4305.997781,9.014828000000307,330.1227710611782,0
"147.32.84.165",2335,"117.96.96.152",6667,4,248,4,248,0,0,4314.511837,3.0020720000002257,660.8768876961815,0
"147.32.84.165",2331,"212.117.174.7",4506,6,372,6,372,0,0,4315.711615,8.914197999999487,333.8494388390488,0
"147.32.84.165",4092,"77.238.177.9",25,6,372,6,372,0,0,4315.71175,8.914184999999634,333.849925708309,0
"147.32.84.165",4093,"209.85.225.27",25,6,372,6,372,0,0,4315.912443,8.913990999999442,333.85719146454,0
"147.32.84.165",4094,"209.85.225.27",25,6,372,6,372,0,0,4315.912577,8.913978999999927,333.8576409031281,0
"147.32.84.165",4097,"64.12.90.97",25,6,372,6,372,0,0,4315.912635,8.913977000000159,333.8577158096714,0
"147.32.84.165",4098,"66.94.237.64",25,6,372,6,372,0,0,4317.013244,8.913097000000562,333.89067795400547,0
"147.32.84.165",4100,"207.115.11.16",25,6,372,6,372,0,0,4318.015225,8.912341999999626,333.91896316368076,0
"147.32.84.165",4102,"74.125.113.27",25,6,372,6,372,0,0,4320.518398,9.015054999999847,330.1144585363096,0
"147.32.84.165",4103,"205.188.59.194",25,6,372,6,372,0,0,4321.119165,9.013154000000213,330.1840842839177,0
"147.32.84.165",2348,"173.192.170.88",80,13,1407,10,970,3,437,4324.625999,53.44290400000045,145.20169038718282,65.41560690639061
"147.32.84.165",2349,"180.177.137.11",6667,9,552,6,372,3,180,4326.427088,1.9543039999998655,1522.7927691905686,736.8352108986622
"147.32.84.165",4104,"209.85.225.27",25,6,372,6,372,0,0,4326.927686,9.013492000000042,330.1717025987249,0
"147.32.84.165",4105,"98.137.54.237",25,6,372,6,372,0,0,4327.829353,9.012805999999728,330.1968332614826,0
"147.32.84.165",4106,"205.188.190.2",25,6,372,6,372,0,0,4328.381624,8.96115700000064,332.0999732511982,0
"147.32.84.165",2358,"212.117.174.7",4506,6,372,6,372,0,0,4331.333792,9.012974999999642,330.19064182471584,0
"147.32.84.165",2361,"221.207.141.60",6667,15,1756,10,1198,5,558,4336.641493,1.8907890000000407,5068.783454949121,2360.9191718377374
"147.32.84.165",4107,"66.94.237.64",25,6,372,6,372,0,0,4336.842297,9.012526999999864,330.20705513559574,0
"147.32.84.165",4108,"195.50.106.142",25,6,372,6,372,0,0,4336.842355,9.012603000000126,330.20427061970423,0
"147.32.84.165",4109,"76.96.30.116",25,6,372,6,372,0,0,4337.072467,8.982675999999628,331.3043908073856,0
"147.32.84.165",4111,"66.94.237.64",25,6,372,6,372,0,0,4337.943333,9.013463999999658,330.1727282651945,0
"147.32.84.165",4112,"205.188.159.42",25,6,372,6,372,0,0,4338.944949,9.01287400000001,330.19434200455885,0
"147.32.84.165",2376,"89.236.212.138",6667,4,248,4,248,0,0,4341.548483,3.004373000000669,660.3707329281544,0
"147.32.84.165",2377,"212.117.174.7",4506,6,372,6,372,0,0,4342.150056,9.012519999999313,330.2073116065459,0
"147.32.84.165",4113,"209.85.225.27",25,6,372,6,372,0,0,4342.150189,9.01251400000001,330.20753143906313,0
"147.32.84.165",4114,"209.85.225.27",25,6,372,6,372,0,0,4342.150246,9.012510999999904,330.2076413554482,0
"147.32.84.165",4115,"77.238.177.9",25,6,372,6,372,0,0,4342.150307,9.012502999999924,330.20793446615494,0
"147.32.84.165",4116,"205.188.156.193",25,6,372,6,372,0,0,4347.95793,9.012676000000283,330.20159606313445,0
"147.32.84.165",4117,"66.94.237.64",25,6,372,6,372,0,0,4348.859079,9.012907000000268,330.19313302577194,0
"147.32.84.165",4118,"208.77.218.115",25,6,372,6,372,0,0,4348.859214,9.012896999999612,330.1934993820664,0
"147.32.84.165",4120,"207.115.11.16",25,6,372,6,372,0,0,4349.359805,9.012805999999728,330.1968332614826,0
"147.32.84.165",2390,"93.178.250.214",6667,9,552,6,372,3,180,4352.364432,1.0700109999997949,2781.2798186192204,1345.780557396397
"147.32.84.165",4121,"209.85.225.27",25,6,372,6,372,0,0,4353.434719,8.94387000000006,332.74186677578945,0
"147.32.84.165",2400,"212.117.174.7",4506,6,372,6,372,0,0,4357.872174,9.012952000000041,330.1914844326239,0
"147.32.84.165",2397,"42.201.161.145",6667,4,248,4,248,0,0,4358.072949,3.003922999999304,660.4696591758376,0
"147.32.84.165",4122,"206.46.232.11",25,6,372,6,372,0,0,4358.974111,9.012405999999828,330.21148847489303,0
"147.32.84.165",4124,"64.12.90.1",25,6,372,6,372,0,0,4359.57485,9.012555000000248,330.2060292558457,0
"147.32.84.165",4126,"209.85.225.27",25,6,372,6,372,0,0,4359.975248,9.012988000000405,330.1901655699382,0
"147.32.84.165",4127,"205.188.59.193",25,6,372,6,372,0,0,4359.97538,9.012953999999809,330.19141116220754,0
"147.32.84.165",4128,"62.177.218.114",25,6,372,6,372,0,0,4363.179618,9.012885999999526,330.193902374906,0
"147.32.84.165",2411,"61.167.116.133",6667,15,1710,10,1152,5,558,4368.988372,1.965581999999813,4688.687625345001,2271.0830685264846
"147.32.84.165",2412,"212.117.174.7",4506,6,372,6,372,0,0,4369.447397,8.954098000000158,332.36178563155636,0
"147.32.84.165",4130,"205.188.159.42",25,6,372,6,372,0,0,4369.447446,8.954173999999512,332.3589646571713,0
"147.32.84.165",4132,"209.85.225.27",25,6,372,6,372,0,0,4369.889236,9.013292999999976,330.17899229504775,0
"147.32.84.165",4133,"209.85.225.27",25,6,372,6,372,0,0,4369.889367,9.013284999999996,330.17928535489574,0
"147.32.84.165",4135,"64.12.90.98",25,6,372,6,372,0,0,4369.889426,9.013278000000355,330.17954178267695,0
"147.32.84.165",4136,"64.12.90.33",25,6,372,6,372,0,0,4370.390619,9.012512000000243,330.2076047166339,0
"147.32.84.165",2417,"221.130.69.202",6667,9,552,6,372,3,180,4374.395864,1.9838639999998122,1500.1028296295924,725.8562078852866
"147.32.84.165",4137,"66.94.237.64",25,6,372,6,372,0,0,4375.196871,9.013334999999643,330.17745373938925,0
"147.32.84.165",4138,"65.54.188.110",25,6,372,6,372,0,0,4376.379949,8.93141199999991,333.2059925127214,0
"147.32.84.165",4141,"209.85.225.27",25,6,372,6,372,0,0,4378.902772,9.012342999999419,330.213796789602,0
"147.32.84.165",2423,"212.117.171.138",65500,340,332938,252,326282,88,6656,4380.003958,74.82781900000009,34883.4970053049,711.6070027378446
"147.32.84.165",4142,"205.188.190.2",25,6,372,6,372,0,0,4380.004092,9.012668000000303,330.20188916310906,0
"147.32.84.165",2427,"205.188.103.1",25,6,372,6,372,0,0,4380.60472,8.912913999999546,333.89753339930706,0
"147.32.84.165",4147,"165.199.8.51",25,6,372,6,372,0,0,4381.006333,8.912325999999666,333.9195626371961,0
"147.32.84.165",2435,"212.117.174.7",4506,6,372,6,372,0,0,4384.210343,8.912698000000091,333.90562543462926,0
"147.32.84.165",2428,"184.164.142.139",6667,9,552,6,372,3,180,4390.318713,1.3625810000003185,2184.0903403168727,1056.8179066049383
"147.32.84.165",4148,"66.94.237.64",25,6,372,6,372,0,0,4390.819593,9.012727000000268,330.1997275630241,0
"147.32.84.165",2441,"61.17.216.69",6667,4,248,4,248,0,0,4390.819719,3.0045689999997194,660.327654315872,0
"147.32.84.165",4149,"64.12.90.33",25,6,372,6,372,0,0,4391.320063,9.013090999999804,330.18639221550796,0
"147.32.84.165",4150,"209.85.225.27",25,6,372,6,372,0,0,4391.681501,8.951936000000387,332.4420549923359,0
"147.32.84.165",4151,"68.6.19.3",25,6,372,6,372,0,0,4391.681564,8.951998999999887,332.4397154199903,0
"147.32.84.165",2451,"31.192.109.167",80,15,1540,10,1050,5,490,4396.126976,0.23293100000046252,36062.1815043224,16829.01803535045
"147.32.84.165",2453,"212.117.174.7",4506,6,372,6,372,0,0,4396.203167,8.937284000000545,332.98706855458755,0
"147.32.84.165",4152,"209.85.225.27",25,6,372,6,372,0,0,4396.203199,8.937377000000197,332.98360357853704,0
"147.32.84.165",4153,"74.125.113.27",25,6,372,6,372,0,0,4396.203227,8.93739800000003,332.9828211745734,0
"147.32.84.165",4154,"64.12.90.1",25,6,372,6,372,0,0,4397.22856,9.012975000000552,330.19064182468253,0
"147.32.84.165",2461,"190.136.214.243",6667,4,248,4,248,0,0,4399.832478,3.004175999999461,660.4140369939564,0
"147.32.84.165",2458,"173.192.170.88",80,38,6007,24,1886,14,4121,4401.034041,43.84447300000011,344.1254727819391,751.9305797106952
"147.32.84.165",4156,"71.216.14.137",25,6,372,6,372,0,0,4401.235226,9.01274900000044,330.1989215498906,0
"147.32.84.165",4162,"209.85.225.27",25,6,372,6,372,0,0,4401.536008,9.011919999999918,330.2292963097794,0
"147.32.84.165",4163,"205.188.59.193",25,6,372,6,372,0,0,4401.935524,9.012996999999814,330.189835855938,0
"147.32.84.165",4168,"66.96.142.52",25,6,372,6,372,0,0,4405.140689,9.012810000000172,330.19668671590136,0
"147.32.84.165",4169,"65.55.37.88",25,6,372,6,372,0,0,4408.244337,9.013672999999471,330.1650725514643,0
"147.32.84.165",2476,"212.117.174.7",4506,6,372,6,372,0,0,4412.350626,9.012739999999212,330.1992512821029,0
"147.32.84.165",2475,"117.224.41.27",6667,5,308,4,248,1,60,4412.651132,1.502226999999948,1320.7058587018264,319.52561097624834
"147.32.84.165",4170,"205.188.159.42",25,6,372,6,372,0,0,4417.15749,9.012716000000182,330.20013057106644,0
"147.32.84.165",2489,"208.73.210.29",80,69,38864,42,6506,27,32358,4417.858524,19.447911000000204,2676.277159022347,13310.632694688766
"147.32.84.165",4171,"80.67.18.126",25,6,372,6,372,0,0,4418.038796,8.932593000000452,333.1619385322772,0
"147.32.84.165",4172,"66.94.237.64",25,6,372,6,372,0,0,4418.259135,9.012590999999702,330.20471027700006,0
"147.32.84.165",2494,"209.127.193.138",6667,9,552,6,372,3,180,4422.264719,1.6064930000002278,1852.48239488101,896.3624491359725
"147.32.84.165",2497,"212.117.174.7",4506,6,372,6,372,0,0,4422.565038,9.013090000000375,330.1864288495817,0
"147.32.84.165",2493,"74.125.232.218",80,13,2934,10,2060,3,874,4422.565169,14.741378999999142,1117.9415440035127,474.311121096636
"147.32.84.165",4173,"64.12.90.97",25,6,372,6,372,0,0,4422.573295,9.00492899999972,330.485670681034,0
"147.32.84.165",2498,"67.214.158.5",80,15,2565,10,1710,5,855,4422.965718,0.3158449999991717,43312.38423921821,21656.192119609106
"147.32.84.165",4174,"168.95.5.12",25,6,372,6,372,0,0,4423.069328,9.009793000000172,330.3072556716834,0
"147.32.84.165",2499,"50.22.198.84",80,13,3344,10,2316,3,1028,4423.871454,0.36876699999993434,50243.107436411876,22301.344751567965
"147.32.84.165",4175,"209.85.225.27",25,6,372,6,372,0,0,4423.992462,8.98786199999995,331.11322804021876,0
"147.32.84.165",2500,"195.113.232.88",80,13,2130,10,1542,3,588,4426.170356,11.136289000000033,1107.729873030411,422.40283096101274
"147.32.84.165",4176,"205.188.146.193",25,6,372,6,372,0,0,4426.171305,9.011838999999782,330.23226446900264,0
"147.32.84.165",2507,"59.48.7.172",6667,9,552,6,372,3,180,4428.073147,1.945448999999826,1529.7239865965473,740.1890257725229
"147.32.84.165",2502,"67.214.158.5",80,15,2650,10,1754,5,896,4429.274649,0.3209500000002663,43720.20563947144,22333.6968374951
"147.32.84.165",4179,"209.85.225.27",25,6,372,6,372,0,0,4429.378016,9.009814000000006,330.30648579426816,0
"147.32.84.165",2505,"50.22.198.84",80,13,2940,10,2420,3,520,4429.378078,0.3904179999999542,49587.877608107905,10655.246428188475
"147.32.84.165",4180,"205.188.190.2",25,6,372,6,372,0,0,4429.499011,8.98884999999973,331.0768340777841,0
"147.32.84.165",2515,"68.67.185.212",80,13,2050,10,1168,3,882,4430.019088,7.287647000000106,1282.1696769890011,968.2137458084752
"147.32.84.165",4181,"209.85.225.27",25,6,372,6,372,0,0,4430.048391,8.94077500000003,332.8570509827157,0
"147.32.84.165",2516,"68.67.185.212",80,13,2078,10,1168,3,910,4430.04847,7.258360000000721,1287.343146385557,1002.9813897353228
"147.32.84.165",4184,"213.199.180.150",25,6,372,6,372,0,0,4430.04855,8.94074399999954,332.85820508898956,0
"147.32.84.165",2522,"221.130.69.202",6667,9,552,6,372,3,180,4433.380486,1.9837280000001556,1500.2056733583267,725.9059709798355
"147.32.84.165",2517,"217.163.21.41",80,15,2143,10,1186,5,957,4435.364467,0.14285199999994802,66418.3910621024,53593.92938147723
"147.32.84.165",4185,"94.245.120.86",25,6,372,6,372,0,0,4435.410443,8.98640400000022,331.16694953842796,0
"147.32.84.165",4186,"205.188.190.2",25,6,372,6,372,0,0,4438.187599,10.053364999999758,296.02028773451195,0
"147.32.84.165",4187,"64.12.90.98",25,6,372,6,372,0,0,4438.187699,10.056461999999556,295.92912497458167,0
"147.32.84.165",2531,"212.117.174.7",4506,6,372,6,372,0,0,4438.989355,10.19000700000015,292.050829798248,0
"147.32.84.165",2530,"221.226.242.228",6667,4,248,4,248,0,0,4439.28931,3.004305999999815,660.3854600696874,0
"147.32.84.165",4188,"66.94.237.64",25,6,372,6,372,0,0,4443.595349,9.959211999999752,298.8188222120459,0
"147.32.84.165",4189,"209.85.225.27",25,6,372,6,372,0,0,4444.096647,10.319496999999501,288.3861490535967,0
"147.32.84.165",2539,"212.117.171.138",65500,24,1475,18,1092,6,383,4444.096775,277.0089280000002,31.53688967021306,11.061015333050918
"147.32.84.165",4190,"165.21.74.121",25,6,372,6,372,0,0,4444.096831,10.322533999999905,288.3013027615145,0
"147.32.84.165",2541,"65.55.196.251",443,196,170465,136,10904,60,159561,4444.997177,9.913209999999708,8799.57148088284,128766.36326679628
"147.32.84.165",2543,"173.192.170.88",80,20,3462,14,1204,6,2258,4445.097794,53.646146000000044,179.54691470287526,336.7250277401099
"147.32.84.165",4192,"209.191.88.254",25,6,372,6,372,0,0,4445.29865,9.257896000000073,321.45532851092474,0
"147.32.84.165",4193,"209.85.225.27",25,6,372,6,372,0,0,4447.201221,9.01210699999956,330.22244409660755,0
"147.32.84.165",2545,"212.52.133.252",6667,4,248,4,248,0,0,4450.505478,3.9202649999997448,506.0882363820122,0
"147.32.84.165",2546,"212.117.174.7",4506,6,372,6,372,0,0,4451.005978,8.912766999999803,333.90304043627145,0
"147.32.84.165",4194,"64.136.44.37",25,6,372,6,372,0,0,4451.006158,8.912653999999748,333.90727386029846,0
"147.32.84.165",4195,"66.94.237.64",25,6,372,6,372,0,0,4456.413631,8.912822999999662,333.90094249600975,0
"147.32.84.165",4196,"64.12.90.33",25,6,372,6,372,0,0,4456.413765,8.912864999999329,333.89936905812266,0
"147.32.84.165",4198,"209.85.225.27",25,6,372,6,372,0,0,4456.914505,8.912898000000496,333.8981327958465,0
"147.32.84.165",4199,"65.55.92.136",25,6,372,6,372,0,0,4456.91464,8.912889000000177,333.89846995737753,0
"147.32.84.165",2564,"62.178.214.33",6667,4,248,4,248,0,0,4459.118241,3.003686000000016,660.5217722491597,0
"147.32.84.165",4201,"209.191.88.254",25,6,372,6,372,0,0,4459.918848,9.012941999999384,330.19185078526004,0
"147.32.84.165",4202,"213.199.180.150",25,6,372,6,372,0,0,4459.91888,9.013036999999713,330.1883704682556,0
"147.32.84.165",4204,"205.188.59.194",25,6,372,6,372,0,0,4464.525321,9.008452000000034,330.3564252770608,0
"147.32.84.165",2571,"212.117.174.7",4506,6,372,6,372,0,0,4465.026132,9.008996999999908,330.3364403384783,0
"147.32.84.165",4205,"64.12.90.33",25,6,372,6,372,0,0,4466.227692,9.011443999999756,330.24673959024557,0
"147.32.84.165",4206,"66.94.237.64",25,6,372,6,372,0,0,4466.227758,9.011435999999776,330.247032770368,0
"147.32.84.165",4207,"65.55.37.72",25,6,372,6,372,0,0,4467.129588,9.012040000000525,330.2248991349158,0
"147.32.84.165",4209,"209.85.225.27",25,6,372,6,372,0,0,4468.130475,9.014549999999872,330.13295172804436,0
"147.32.84.165",2580,"98.126.71.122",80,18,4863,14,1430,4,3433,4471.936139,19.066469999999754,600.0061888750329,1440.4344380475438
"147.32.84.165",2576,"111.92.142.42",6667,9,552,6,372,3,180,4472.110821,1.3685269999996308,2174.600866479655,1052.226225715962
"147.32.84.165",4211,"207.115.36.21",25,6,372,6,372,0,0,4473.479582,8.982554000000164,331.3088905449325,0
"147.32.84.165",2583,"195.113.232.98",80,17,5760,12,2556,5,3204,4476.54307,14.45965299999989,1414.1418193092293,1772.6566467397383
"147.32.84.165",2588,"59.94.194.59",6667,4,248,4,248,0,0,4476.543206,3.0101779999995415,659.0972361103902,0
"147.32.84.165",2591,"212.117.174.7",4506,6,372,6,372,0,0,4477.345454,9.02919699999984,329.59741602714536,0
"147.32.84.165",4212,"205.188.190.2",25,6,372,6,372,0,0,4477.345587,9.029132000000573,329.5997887725876,0
"147.32.84.165",4213,"66.94.237.64",25,6,372,6,372,0,0,4477.84714,9.028905000000123,329.60807539784275,0
"147.32.84.165",4215,"65.55.37.104",25,6,372,6,372,0,0,4477.847279,9.02889099999993,329.6085864808893,0
"147.32.84.165",4216,"98.137.54.237",25,6,372,6,372,0,0,4480.957162,9.028936000000613,329.606943719592,0
"147.32.84.165",4217,"209.85.225.27",25,6,372,6,372,0,0,4485.571792,9.035326000000168,329.37383775637363,0
"147.32.84.165",4218,"64.12.90.98",25,6,372,6,372,0,0,4485.571919,9.035326999999597,329.3738013023914,0
"147.32.84.165",4219,"209.85.225.27",25,6,372,6,372,0,0,4486.073225,9.034733999999844,329.3954199426404,0
"147.32.84.165",4222,"203.26.121.13",25,6,372,6,372,0,0,4486.073371,9.03471300000001,329.3961855788885,0
"147.32.84.165",2602,"178.122.22.89",6667,4,248,4,248,0,0,4487.277319,3.009812000000238,659.1773838365463,0
"147.32.84.165",4223,"64.12.90.33",25,6,372,6,372,0,0,4488.180515,9.03026200000022,329.5585443700224,0
"147.32.84.165",4224,"209.85.225.27",25,6,372,6,372,0,0,4489.182981,9.029142999999749,329.59938722867525,0
"147.32.84.165",2609,"212.117.174.7",4506,6,372,6,372,0,0,4493.505612,8.91276199999993,333.903227753644,0
"147.32.84.165",4225,"64.12.90.98",25,6,372,6,372,0,0,4494.506819,8.912785999999869,333.90232863215203,0
"147.32.84.165",4226,"66.94.237.64",25,6,372,6,372,0,0,4494.506955,8.912790000000314,333.90217877902376,0
"147.32.84.165",2616,"178.137.7.22",6667,4,248,4,248,0,0,4498.412339,3.004678999999669,660.3034800057573,0
"147.32.84.165",2620,"173.192.170.88",80,17,1643,12,1086,5,557,4498.913401,65.34769700000015,132.95036242822727,68.18909012202816
"147.32.84.165",4227,"209.85.225.27",25,6,372,6,372,0,0,4499.11444,8.912042999999358,333.93016618077525,0
"147.32.84.165",4228,"65.54.188.72",25,6,372,6,372,0,0,4499.114503,8.912075000000186,333.92896715971733,0
"147.32.84.165",4232,"205.188.156.193",25,6,372,6,372,0,0,4502.017549,8.913445999999567,333.87760468848353,0
"147.32.84.165",2625,"212.117.174.7",4506,6,372,6,372,0,0,4505.522598,9.015440000000126,330.1003611581862,0
"147.32.84.165",4234,"64.12.90.98",25,6,372,6,372,0,0,4505.522732,9.015456999999515,330.09973870433413,0
"147.32.84.165",4235,"216.32.180.22",25,6,372,6,372,0,0,4505.52279,9.015446999999767,330.1001048533785,0
"147.32.84.165",2627,"196.0.35.154",6667,4,248,4,248,0,0,4506.524366,3.003983999999946,660.4562474367492,0
"147.32.84.165",4236,"66.94.237.64",25,6,372,6,372,0,0,4507.024964,9.013017999999647,330.1890665257871,0
"147.32.84.165",4237,"209.85.225.27",25,6,372,6,372,0,0,4507.02511,9.012998000000152,330.1897992210749,0
"147.32.84.165",4238,"76.73.3.98",25,6,372,6,372,0,0,4507.025183,9.012980999999854,330.1904220146529,0
"147.32.84.165",4239,"205.188.156.193",25,6,372,6,372,0,0,4509.128006,9.012867999999798,330.194561819841,0
"147.32.84.165",4240,"64.12.90.98",25,6,372,6,372,0,0,4509.128138,9.012784999999894,330.1976026278265,0
"147.32.84.165",4241,"66.94.237.64",25,6,372,6,372,0,0,4510.129245,9.013425000000097,330.17415688264646,0
"147.32.84.165",4242,"64.12.90.65",25,6,372,6,372,0,0,4510.129377,9.013420000000224,330.1743400396216,0
"147.32.84.165",4243,"209.85.225.27",25,6,372,6,372,0,0,4514.435382,9.013449000000037,330.1732777319745,0
"147.32.84.165",4244,"209.216.39.163",25,6,372,6,372,0,0,4515.136645,9.013121000000865,330.18529319640936,0
"147.32.84.165",4246,"209.85.225.27",25,6,372,6,372,0,0,4515.436951,9.012884000000668,330.1939756463946,0
"147.32.84.165",4247,"64.12.90.33",25,6,372,6,372,0,0,4515.437088,9.012870999999905,330.19445191216334,0
"147.32.84.165",2636,"31.192.109.167",80,15,1540,10,1050,5,490,4520.043952,0.23287299999992683,36071.16325208435,16833.209517639363
"147.32.84.165",2640,"212.117.174.7",4506,6,372,6,372,0,0,4520.120248,8.93623899999966,333.0260079212422,0
"147.32.84.165",2637,"117.203.229.154",6667,2,124,2,124,0,0,4522.947618,9.999999747378752e-06,0,0
"147.32.84.165",4248,"74.125.67.27",25,6,372,6,372,0,0,4525.351448,9.012656999999308,330.20229217646124,0
"147.32.84.165",2653,"210.212.164.162",6667,8,492,6,372,2,120,4526.552897,5.571832000000541,534.1151707373286,172.2952163668802
"147.32.84.165",4249,"66.94.237.64",25,6,372,6,372,0,0,4528.055189,9.01285100000041,330.19518463135194,0
"147.32.84.165",4250,"64.12.90.98",25,6,372,6,372,0,0,4530.158597,9.01249800000005,330.2081176606068,0
"147.32.84.165",4251,"66.94.237.64",25,6,372,6,372,0,0,4531.160067,9.012762000000293,330.1984452712613,0
"147.32.84.165",4253,"209.85.225.27",25,6,372,6,372,0,0,4531.160197,9.012759000000187,330.1985551815973,0
"147.32.84.165",4255,"216.32.180.22",25,6,372,6,372,0,0,4531.160254,9.012750999999298,330.1988482762069,0
"147.32.84.165",2661,"212.117.174.7",4506,6,372,6,372,0,0,4532.124935,8.948809000000438,332.5582208760802,0
"147.32.84.165",4256,"139.174.2.44",25,6,372,6,372,0,0,4532.124997,8.948871999999938,332.55587966841193,0
"147.32.84.165",4258,"205.188.59.193",25,6,372,6,372,0,0,4534.965466,9.009587999999894,330.31477133028,0
"147.32.84.165",2664,"117.242.61.2",6667,4,248,4,248,0,0,4535.465878,3.0045170000003054,660.3390827876156,0
"147.32.84.165",4259,"64.12.90.98",25,6,372,6,372,0,0,4536.166658,9.012977999999748,330.19053191964775,0
"147.32.84.165",4260,"98.137.54.237",25,6,372,6,372,0,0,4536.166758,9.013044999999693,330.1880773922799,0
"147.32.84.165",2670,"173.192.170.88",80,16,2023,12,1494,4,529,4536.468624,15.634393999999702,764.4683893728294,270.68525969091485
"147.32.84.165",4261,"209.85.225.27",25,6,372,6,372,0,0,4536.468758,9.01137000000017,330.2494515262323,0
"147.32.84.165",2674,"174.36.246.56",80,29,14225,22,2068,7,12157,4541.073936,0.47012700000050245,35190.49108003225,206871.7601837292
"147.32.84.165",4264,"205.188.59.193",25,6,372,6,372,0,0,4541.194875,9.000460000000203,330.64976678969,0
"147.32.84.165",4265,"211.49.162.253",25,6,372,6,372,0,0,4541.194938,9.000527000000147,330.6473054299988,0
"147.32.84.165",2690,"212.117.174.7",4506,6,372,6,372,0,0,4546.383641,8.928006999999525,333.33307198349627,0
"147.32.84.165",2688,"178.148.4.76",6667,4,248,4,248,0,0,4549.091913,3.009838999999374,659.1714706336161,0
"147.32.84.165",2681,"195.113.232.82",80,7,426,6,364,1,62,4551.199175,0.0011770000000979053,0,0
"147.32.84.165",4266,"66.94.237.64",25,6,372,6,372,0,0,4551.20006,8.933415999999852,333.13124565116516,0
"147.32.84.165",2682,"195.113.232.82",80,37,22137,30,2874,7,19263,4552.101616,4.206543000000238,5465.770824165757,36634.35747595859
"147.32.84.165",4267,"66.94.237.64",25,6,372,6,372,0,0,4552.102536,9.032053999999334,329.4931584775976,0
"147.32.84.165",2683,"195.113.232.82",80,13,1541,10,1204,3,337,4552.102596,4.205668000000514,2290.242596419599,641.0396636157848
"147.32.84.165",4268,"64.12.90.98",25,6,372,6,372,0,0,4552.102654,9.032061999999314,329.49286663446577,0
"147.32.84.165",2684,"174.36.246.56",80,18,7221,14,2010,4,5211,4552.202195,0.5031779999999344,31956.882057645795,82849.40915541902
"147.32.84.165",4270,"209.85.225.27",25,6,372,6,372,0,0,4552.323217,8.91139800000019,333.95433578434455,0
"147.32.84.165",2685,"95.172.94.49",80,13,2064,10,1488,3,576,4552.323286,0.05524100000002363,215492.11636275426,83416.30310816293
"147.32.84.165",4271,"74.6.136.244",25,6,372,6,372,0,0,4552.341546,8.893198000000666,334.63777597212805,0
"147.32.84.165",2699,"74.125.232.207",80,13,2376,10,1870,3,506,4553.104473,3.2038889999994353,4669.325310584304,1263.4644958051647
"147.32.84.165",4272,"205.188.190.2",25,6,372,6,372,0,0,4553.112689,8.923588000000564,333.4981399858232,0
"147.32.84.165",2703,"117.197.21.10",6667,4,248,4,248,0,0,4555.914615,3.0166980000003605,657.6727269351334,0
"147.32.84.165",4273,"209.85.225.27",25,6,372,6,372,0,0,4557.128747,9.013155000000552,330.18404765033085,0
"147.32.84.165",4274,"220.156.142.32",25,6,372,6,372,0,0,4557.128883,9.013143999999556,330.18445062013285,0
"147.32.84.165",4275,"66.94.237.64",25,6,372,6,372,0,0,4557.429382,9.012957999999344,330.1912646214724,0
"147.32.84.165",4276,"68.6.19.3",25,6,372,6,372,0,0,4557.429517,9.012954000000718,330.19141116217423,0
"147.32.84.165",2707,"212.117.174.7",4506,6,372,6,372,0,0,4562.136288,9.012763000000632,330.1984086344877,0
"147.32.84.165",4277,"205.188.159.42",25,6,372,6,372,0,0,4562.136396,9.012783000000127,330.19767590099065,0
"147.32.84.165",4278,"209.85.225.27",25,6,372,6,372,0,0,4563.237498,9.013052999999672,330.1877843168245,0
"147.32.84.165",2719,"178.151.76.180",6667,9,552,6,372,3,180,4567.346616,1.0462029999998776,2844.5722292904416,1376.4059173986009
"147.32.84.165",2716,"173.192.170.88",80,21,3571,14,1206,7,2365,4568.393046,38.44582300000002,250.95053889209225,492.12108165820746
"147.32.84.165",4282,"205.188.190.2",25,6,372,6,372,0,0,4568.593906,8.964399999999841,331.9798313328335,0
"147.32.84.165",4283,"209.85.225.27",25,6,372,6,372,0,0,4568.59397,8.964447000000291,331.97809078461876,0
"147.32.84.165",4284,"193.251.214.113",25,6,372,6,372,0,0,4568.594029,8.964415999999801,331.9792388037398,0
"147.32.84.165",2727,"58.60.63.116",6667,4,248,4,248,0,0,4572.150495,3.0044440000001487,660.3551272714359,0
"147.32.84.165",4285,"139.142.139.89",25,6,372,6,372,0,0,4573.152653,9.015900999999758,330.08348250497426,0
"147.32.84.165",2730,"212.117.174.7",4506,6,372,6,372,0,0,4573.25237,9.012815000000046,330.1965035341328,0
"147.32.84.165",4286,"66.94.237.64",25,6,372,6,372,0,0,4574.053121,9.012998000000152,330.1897992210749,0
"147.32.84.165",4287,"216.32.181.178",25,6,372,6,372,0,0,4574.053264,9.013030000000072,330.18862691014857,0
"147.32.84.165",4288,"209.85.225.27",25,6,372,6,372,0,0,4578.159472,9.012609999999768,330.2040141535112,0
"147.32.84.165",4290,"64.12.90.98",25,6,372,6,372,0,0,4578.159571,9.01263899999958,330.202951654908,0
"147.32.84.165",4291,"205.188.190.2",25,6,372,6,372,0,0,4578.460665,9.011814000000413,330.2331805782791,0
"147.32.84.165",2744,"82.226.248.139",6667,4,248,4,248,0,0,4583.166215,3.004308999999921,660.3848006313772,0
"147.32.84.165",2743,"173.192.170.88",80,18,2154,14,1626,4,528,4584.267951,10.061112000000321,1292.898836629548,419.83430857343257
"147.32.84.165",4292,"84.234.64.223",25,6,372,6,372,0,0,4584.26804,9.013073000000077,330.1870516304455,0
"147.32.84.165",2756,"68.67.185.216",80,16,2456,12,1424,4,1032,4589.575436,10.933898000000227,1041.8974093228019,755.0829539474238
"147.32.84.165",2755,"212.117.174.7",4506,6,372,6,372,0,0,4589.599319,8.988613000000441,331.08556347902106,0
"147.32.84.165",4293,"209.85.225.27",25,6,372,6,372,0,0,4589.599382,8.988695999999436,331.08250629459343,0
"147.32.84.165",2759,"68.67.185.205",80,16,2682,12,1800,4,882,4590.276719,10.232380999999805,1407.297089504415,689.5755738571634
"147.32.84.165",4300,"216.32.181.178",25,6,372,6,372,0,0,4590.305994,8.98428899999999,331.24490986432016,0
"147.32.84.165",4301,"205.188.159.42",25,6,372,6,372,0,0,4590.306058,8.984357999999702,331.2423658986094,0
"147.32.84.165",2764,"61.167.116.133",6667,15,1710,10,1152,5,558,4594.182118,1.991797000000588,4626.977548413457,2241.1922500127685
"147.32.84.165",2761,"217.163.21.41",80,21,6659,14,1570,7,5089,4594.282704,0.18740100000013626,67022.05431129433,217245.37222304256
"147.32.84.165",4302,"205.188.156.193",25,6,372,6,372,0,0,4594.328684,8.98440599999958,331.2405962063757,0
"147.32.84.165",2767,"217.163.21.41",80,15,2336,10,1450,5,886,4594.639042,0.14056799999980285,82522.3379433176,50423.994081227174
"147.32.84.165",4305,"66.94.237.64",25,6,372,6,372,0,0,4594.684902,9.02865600000041,329.6171656113451,0
"147.32.84.165",2768,"195.113.232.96",80,13,1772,10,1228,3,544,4594.684934,5.935188999999809,1655.2126646683562,733.2538188758841
"147.32.84.165",4306,"209.85.225.27",25,6,372,6,372,0,0,4594.686893,9.026788999999553,329.6853399365098,0
"147.32.84.165",4308,"209.85.225.27",25,6,372,6,372,0,0,4594.686927,9.026808000000528,329.68464600109206,0
"147.32.84.165",4309,"66.94.237.64",25,6,372,6,372,0,0,4594.686954,9.026829000000362,329.683879023285,0
"147.32.84.165",4311,"205.188.59.193",25,6,372,6,372,0,0,4594.686982,9.026855000000069,329.68292943666177,0
"147.32.84.165",4312,"162.119.233.131",25,6,372,6,372,0,0,4595.076975,9.037188999999671,329.30593794155556,0
"147.32.84.165",4313,"65.55.92.136",25,6,372,6,372,0,0,4595.077088,9.037170999999944,329.30659384446955,0
"147.32.84.165",2774,"61.17.216.6",6667,4,248,4,248,0,0,4598.989082,3.02189399999952,656.5418906157248,0
"147.32.84.165",2769,"77.238.167.32",80,13,2615,10,1564,3,1051,4599.189424,0.14067900000009104,88940.06923557818,59767.27158989301
"147.32.84.165",4314,"65.55.92.184",25,6,372,6,372,0,0,4599.235115,8.985148999999183,331.2132052568378,0
"147.32.84.165",2775,"212.117.174.7",4506,6,372,6,372,0,0,4599.490571,9.029817999999977,329.5747489041316,0
"147.32.84.165",4315,"209.85.225.27",25,6,372,6,372,0,0,4605.315606,8.9135610000003,333.87329710313304,0
"147.32.84.165",4317,"209.85.225.27",25,6,372,6,372,0,0,4605.315749,8.913539000000128,333.87412115434256,0
"147.32.84.165",4318,"94.245.120.86",25,6,372,6,372,0,0,4605.31581,8.913532999999916,333.8743458962937,0
"147.32.84.165",2787,"210.211.186.114",6667,4,248,4,248,0,0,4610.523383,3.0040560000006735,660.4404178882002,0
"147.32.84.165",2784,"173.192.170.88",80,11,1283,8,846,3,437,4611.224173,42.452533000000585,159.42511604666575,82.35079871441245
"147.32.84.165",4319,"98.137.34.115",25,6,372,6,372,0,0,4611.425217,9.013377000000219,330.17591519803597,0
"147.32.84.165",4321,"205.188.59.194",25,6,372,6,372,0,0,4615.230105,9.01282700000047,330.1960638986907,0
"147.32.84.165",2798,"212.117.174.7",4506,6,372,6,372,0,0,4615.630686,9.01276499999949,330.19833536103164,0
"147.32.84.165",4322,"65.55.92.184",25,6,372,6,372,0,0,4615.630763,9.012810999999601,330.1966500795514,0
"147.32.84.165",4323,"66.94.237.64",25,6,372,6,372,0,0,4615.630793,9.01283599999988,330.1957341729107,0
"147.32.84.165",4324,"205.188.190.2",25,6,372,6,372,0,0,4616.031679,9.01239600000008,330.2118548718868,0
"147.32.84.165",4325,"209.85.225.27",25,6,372,6,372,0,0,4616.031784,9.012415000000146,330.2111587182738,0
"147.32.84.165",4326,"209.85.225.27",25,6,372,6,372,0,0,4617.233166,9.01278000000002,330.19778581081454,0
"147.32.84.165",4327,"205.188.59.194",25,6,372,6,372,0,0,4617.2333,9.012770999999702,330.1981155407253,0
"147.32.84.165",4328,"68.1.17.3",25,6,372,6,372,0,0,4617.23336,9.012767999999596,330.1982254508419,0
"147.32.84.165",2802,"222.23.80.7",6667,4,248,4,248,0,0,4620.137067,3.004621000000043,660.3162262395064,0
"147.32.84.165",4329,"65.55.37.120",25,6,372,6,372,0,0,4620.438729,9.011919999999918,330.2292963097794,0
"147.32.84.165",2810,"212.117.174.7",4506,6,372,6,372,0,0,4626.246197,9.012428,330.2106824043421,0
"147.32.84.165",4330,"64.12.90.33",25,6,372,6,372,0,0,4627.447797,9.01578900000004,330.08758301685924,0
"147.32.84.165",2815,"89.43.210.7",6667,4,248,4,248,0,0,4632.45478,3.0048440000000483,660.2672218590942,0
"147.32.84.165",4332,"67.231.144.94",25,6,372,6,372,0,0,4636.260277,9.012856999999713,330.19496481527386,0
"147.32.84.165",4333,"209.85.225.27",25,6,372,6,372,0,0,4636.66076,9.012864000000263,330.1947083635028,0
"147.32.84.165",4335,"205.188.190.2",25,6,372,6,372,0,0,4636.660911,9.012837000000218,330.19569753673875,0
"147.32.84.165",4336,"66.94.237.64",25,6,372,6,372,0,0,4636.660984,9.012818999999581,330.19635698887754,0
"147.32.84.165",4337,"130.113.196.54",25,6,372,6,372,0,0,4637.062177,9.01536699999997,330.1030340750421,0
"147.32.84.165",4339,"207.115.21.20",25,6,372,6,372,0,0,4637.062326,9.015340999999353,330.1039860833011,0
"147.32.84.165",4340,"209.85.225.27",25,6,372,6,372,0,0,4637.662566,9.012681000000157,330.2014128759187,0
"147.32.84.165",4342,"209.85.225.27",25,6,372,6,372,0,0,4638.263068,9.012968,330.190898270137,0
"147.32.84.165",4343,"205.188.59.194",25,6,372,6,372,0,0,4638.263215,9.012846999999965,330.19533117559985,0
"147.32.84.165",2828,"31.192.109.167",80,15,1540,10,1050,5,490,4641.4678,0.23286999999982072,36071.627946950946,16833.426375243776
"147.32.84.165",2827,"178.165.97.227",6667,9,552,6,372,3,180,4641.543788,1.0944159999999101,2719.258490373171,1315.7702372773408
"147.32.84.165",2832,"212.117.174.7",4506,6,372,6,372,0,0,4642.638484,8.943866999999955,332.74197838586093,0
"147.32.84.165",4345,"66.94.237.64",25,6,372,6,372,0,0,4642.638549,8.94398000000001,332.7377744583504,0
"147.32.84.165",4346,"64.12.90.97",25,6,372,6,372,0,0,4642.638606,8.944024999999783,332.7361003575093,0
"147.32.84.165",2839,"61.17.216.70",6667,4,248,4,248,0,0,4647.275943,3.0092860000004293,659.2926029628679,0
"147.32.84.165",4347,"66.94.237.64",25,6,372,6,372,0,0,4647.276094,9.01354900000024,330.1696146545518,0
"147.32.84.165",4348,"68.1.17.3",25,6,372,6,372,0,0,4647.276127,9.013640000000123,330.1662813247433,0
"147.32.84.165",4349,"209.85.225.27",25,6,372,6,372,0,0,4648.477715,9.013009999999667,330.18935960351865,0
"147.32.84.165",4351,"64.12.90.33",25,6,372,6,372,0,0,4648.477827,9.01302300000043,330.1888833524399,0
"147.32.84.165",2847,"212.117.174.7",4506,6,372,6,372,0,0,4657.290479,9.01298499999939,330.1902754747957,0
"147.32.84.165",2855,"221.130.69.202",6667,9,552,6,372,3,180,4657.690993,1.982890999999654,1500.8389265978408,726.2123838376649
"147.32.84.165",2848,"67.195.168.31",25,6,372,6,372,0,0,4658.092054,9.012628999999833,330.20331803295744,0
"147.32.84.165",2851,"67.195.168.31",25,6,372,6,372,0,0,4658.09219,9.012546999999358,330.2063223637238,0
"147.32.84.165",4352,"205.188.146.193",25,6,372,6,372,0,0,4658.092249,9.012541999999485,330.2065055563869,0
"147.32.84.165",4353,"66.94.237.64",25,6,372,6,372,0,0,4658.692615,9.012687999999798,330.20115641416487,0
"147.32.84.165",4354,"209.86.93.228",25,6,372,6,372,0,0,4659.293627,9.013071999999738,330.1870882646989,0
"147.32.84.165",4357,"64.136.44.37",25,6,372,6,372,0,0,4659.674074,8.932852000000821,333.15227880185705,0
"147.32.84.165",2865,"117.201.114.47",6667,4,248,4,248,0,0,4663.599554,3.004320000000007,660.3823827022405,0
"147.32.84.165",4358,"65.55.37.88",25,6,372,6,372,0,0,4664.100192,9.013324999999895,330.1778200608582,0
"147.32.84.165",4359,"218.102.53.137",25,6,372,6,372,0,0,4668.30686,9.01238100000046,330.2124044689021,0
"147.32.84.165",2873,"212.117.174.7",4506,6,372,6,372,0,0,4669.507899,9.013076000000183,330.1869417277675,0
"147.32.84.165",4360,"74.208.5.3",25,6,372,6,372,0,0,4669.507999,9.013112999999976,330.18558626747586,0
"147.32.84.165",2881,"178.122.115.200",6667,2,124,2,124,0,0,4678.320801,4.000000444648322e-06,0,0
"147.32.84.165",4364,"81.169.145.101",25,6,372,6,372,0,0,4679.022205,9.014502999999422,330.13467298199254,0
"147.32.84.165",4365,"66.94.237.64",25,6,372,6,372,0,0,4679.022365,9.014404999999897,330.13826203726524,0
"147.32.84.165",4366,"209.85.225.27",25,6,372,6,372,0,0,4679.022436,9.01439500000015,330.13862827177536,0
"147.32.84.165",2891,"65.54.188.72",25,6,372,6,372,0,0,4679.622532,9.012896999999612,330.1934993820664,0
"147.32.84.165",4368,"193.191.180.219",25,6,372,6,372,0,0,4680.223297,9.013465000000906,330.1726916340942,0
"147.32.84.165",4369,"205.188.59.194",25,6,372,6,372,0,0,4680.525305,9.011602999999923,330.2409127432739,0
"147.32.84.165",4371,"64.12.90.97",25,6,372,6,372,0,0,4681.525575,9.012884000000668,330.1939756463946,0
"147.32.84.165",2899,"212.117.174.7",4506,6,372,6,372,0,0,4685.030458,9.012845999999627,330.19536781169046,0
"147.32.84.165",2898,"212.12.200.158",6667,3,184,2,124,1,60,4689.236907,0.0583729999998468,16994.15825814338,8222.979802327442
"147.32.84.165",2908,"65.54.188.72",25,6,372,6,372,0,0,4690.538555,9.012904999999591,330.1932062969858,0
"147.32.84.165",4372,"66.94.237.139",25,6,372,6,372,0,0,4690.538592,9.013112000000547,330.1856229013707,0
"147.32.84.165",4377,"209.85.225.27",25,6,372,6,372,0,0,4691.139082,9.012892000000647,330.1936825604685,0
"147.32.84.165",2901,"212.117.171.138",65500,11,666,8,484,3,182,4691.139151,302.8673119999994,12.784476391430475,4.807385750496583
"147.32.84.165",4379,"64.12.90.98",25,6,372,6,372,0,0,4691.139183,9.012931999999637,330.19221713867586,0
"147.32.84.165",2911,"66.94.236.34",25,6,372,6,372,0,0,4700.051834,9.013329999999769,330.1776369000221,0
"147.32.84.165",2920,"212.117.174.7",4506,6,372,6,372,0,0,4700.051996,9.01323499999944,330.1811169907569,0
"147.32.84.165",2922,"173.192.170.88",80,49,6905,30,2246,19,4659,4700.052112,41.27083499999935,435.36797837989667,903.1074849830536
"147.32.84.165",4380,"205.188.190.1",25,6,372,6,372,0,0,4700.253211,9.012039999999615,330.22489913494917,0
"147.32.84.165",2912,"117.197.27.8",6667,6,372,6,372,0,0,4700.652815,9.012925999999425,330.19243695112885,0
"147.32.84.165",4381,"205.188.59.193",25,6,372,6,372,0,0,4701.253679,9.013296999999511,330.17884576533555,0
"147.32.84.165",4382,"209.85.225.27",25,6,372,6,372,0,0,4701.353877,9.012881000000561,330.1940855537552,0
"147.32.84.165",4387,"66.94.237.64",25,6,372,6,372,0,0,4701.554128,9.012918999999783,330.1926933993384,0
"147.32.84.165",4388,"205.188.59.193",25,6,372,6,372,0,0,4702.55546,9.013364000000365,330.1763914116726,0
"147.32.84.165",4389,"150.228.43.61",25,6,372,6,372,0,0,4702.555604,9.013439999999719,330.1736074129403,0
"147.32.84.165",2931,"220.134.142.48",6667,4,248,4,248,0,0,4706.061976,3.0030470000001515,660.6623206363071,0
"147.32.84.165",4390,"209.85.225.27",25,6,372,6,372,0,0,4711.569179,9.01325100000031,330.180530865045,0
"147.32.84.165",2946,"212.117.174.7",4506,6,372,6,372,0,0,4711.569298,9.01325799999995,330.1802744357275,0
"147.32.84.165",4392,"216.32.181.178",25,6,372,6,372,0,0,4712.169671,9.013408000000709,330.1747796171843,0
"147.32.84.165",2949,"62.152.241.162",6667,6,372,6,372,0,0,4721.08237,9.01274099999955,330.1992146451505,0
"147.32.84.165",2958,"208.73.210.29",80,66,35576,40,4052,26,31524,4721.182946,17.58511400000043,1843.3773019611476,14341.220648327548
"147.32.84.165",2951,"74.125.127.27",25,6,372,6,372,0,0,4721.282622,9.012712000000647,330.2002771196712,0
"147.32.84.165",4393,"74.208.5.90",25,6,372,6,372,0,0,4721.359323,8.93613600000026,333.0298464571167,0
"147.32.84.165",2961,"74.125.127.27",25,6,372,6,372,0,0,4721.683044,9.014070999999603,330.15049470989646,0
"147.32.84.165",4394,"205.188.159.42",25,6,372,6,372,0,0,4721.68319,9.014049000000341,330.1513004865946,0
"147.32.84.165",2963,"74.125.232.218",80,13,2940,10,2066,3,874,4722.284212,16.48397400000067,1002.6708365348869,424.1695600830064
"147.32.84.165",4395,"205.188.190.1",25,6,372,6,372,0,0,4722.292402,9.004845999999816,330.4887168531323,0
"147.32.84.165",2964,"94.127.76.180",80,32,15340,24,6620,8,8720,4722.384081,16.384304999999586,3232.361702251108,4257.733239218982
"147.32.84.165",4396,"205.188.59.193",25,6,372,6,372,0,0,4722.397987,8.999453999999787,330.68672832819306,0
"147.32.84.165",2965,"94.127.76.180",80,22,7218,16,5212,6,2006,4722.584279,16.184197999999924,2576.3402054275534,991.5845073076883
"147.32.84.165",4397,"202.172.247.36",25,6,372,6,372,0,0,4722.584416,9.012910000000375,330.1930231190455,0
"147.32.84.165",2968,"117.196.25.55",6667,4,248,4,248,0,0,4723.585759,3.0048780000006445,660.2597509781011,0
"147.32.84.165",2975,"212.117.174.7",4506,6,372,6,372,0,0,4732.599215,9.012729999999465,330.19961765194086,0
"147.32.84.165",2966,"208.73.210.29",80,13,3928,10,2958,3,970,4733.199645,5.568639000000076,4249.512313511376,1393.5182366822296
"147.32.84.165",4398,"209.85.225.27",25,6,372,6,372,0,0,4733.199779,9.012899000000289,330.1934261107225,0
"147.32.84.165",2991,"212.117.174.7",4506,6,372,6,372,0,0,4741.61175,8.913053999999647,333.89228877106746,0
"147.32.84.165",2985,"94.95.56.138",6667,9,552,6,372,3,180,4741.611884,1.2839530000001105,2317.841852466363,1121.5363802256595
"147.32.84.165",2997,"173.192.170.88",80,17,1641,12,1084,5,557,4742.112428,54.73414999999932,158.43856166579928,81.41169635410536
"147.32.84.165",4399,"65.55.88.22",25,6,372,6,372,0,0,4742.312583,8.913133000000016,333.889329374979,0
"147.32.84.165",4400,"74.6.136.65",25,6,372,6,372,0,0,4742.312721,8.913120000000163,333.8898163605949,0
"147.32.84.165",4402,"205.188.59.194",25,6,372,6,372,0,0,4742.313146,8.912754999999379,333.9034899983459,0
"147.32.84.165",3001,"64.12.90.1",25,6,372,6,372,0,0,4742.713282,8.91287900000043,333.89884458207683,0
"147.32.84.165",3002,"64.12.90.1",25,6,372,6,372,0,0,4742.896068,8.830192000000352,337.02551428098974,0
"147.32.84.165",4403,"65.54.188.72",25,6,372,6,372,0,0,4742.896135,8.830251000000317,337.02326241914227,0
"147.32.84.165",3003,"95.59.1.63",6667,4,248,4,248,0,0,4743.314619,3.004112999999961,660.4278867006752,0
"147.32.84.165",4404,"24.71.223.11",25,6,372,6,372,0,0,4743.414507,8.912556999999651,333.91090794708145,0
"147.32.84.165",4405,"205.188.103.1",25,6,372,6,372,0,0,4743.614756,8.912599999999657,333.90929695039773,0
"147.32.84.165",3019,"211.140.47.197",6667,4,248,4,248,0,0,4753.529241,3.005551999999625,660.1116866386766,0
"147.32.84.165",4406,"66.94.237.64",25,6,372,6,372,0,0,4754.129856,9.012841000000662,330.19555099216564,0
"147.32.84.165",3028,"212.117.174.7",4506,6,372,6,372,0,0,4761.44166,9.011641999999483,330.2394835480782,0
"147.32.84.165",4407,"209.191.88.254",25,6,372,6,372,0,0,4763.242721,9.013042000000496,330.1881872956807,0
"147.32.84.165",3034,"31.192.109.167",80,15,1540,10,1050,5,490,4763.242858,0.24091600000065228,34866.92457112544,16271.231466525207
"147.32.84.165",3036,"119.154.131.100",6667,4,248,4,248,0,0,4763.24292,3.0044320000006337,660.3577647953362,0
"147.32.84.165",4410,"209.85.225.27",25,6,372,6,372,0,0,4763.32202,8.933867000000646,333.11442849997485,0
"147.32.84.165",4412,"64.12.90.65",25,6,372,6,372,0,0,4763.643438,9.012831000000006,330.1959173538257,0
"147.32.84.165",3039,"217.72.192.149",25,6,372,6,372,0,0,4763.743633,9.013224000000264,330.18151995333886,0
"147.32.84.165",4415,"68.236.174.86",25,6,372,6,372,0,0,4764.344393,9.013306999999259,330.17847944159064,0
"147.32.84.165",4416,"84.20.139.21",25,6,372,6,372,0,0,4764.544583,9.013042000000496,330.1881872956807,0
"147.32.84.165",3046,"212.117.174.7",4506,6,372,6,372,0,0,4771.654959,9.016200999999455,330.0724994928773,0
"147.32.84.165",3050,"217.72.192.149",25,6,372,6,372,0,0,4771.655089,9.016198999999688,330.07257271052947,0
"147.32.84.165",4417,"209.191.88.254",25,6,372,6,372,0,0,4771.655146,9.016193000000385,330.0727923636809,0
"147.32.84.165",4419,"74.6.136.65",25,6,372,6,372,0,0,4771.655204,9.016188000000511,330.07297540821367,0
"147.32.84.165",3061,"98.126.71.122",80,18,4863,14,1430,4,3433,4775.160317,17.719301000000087,645.6236620169127,1549.948273918924
"147.32.84.165",3056,"114.27.11.170",6667,9,552,6,372,3,180,4775.334962,1.9786510000003545,1504.0550354759212,727.7685655528651
"147.32.84.165",4420,"205.188.159.42",25,6,372,6,372,0,0,4777.313836,8.976732000000084,331.52376610997993,0
"147.32.84.165",3062,"195.113.232.98",80,23,7855,16,4002,7,3853,4780.369927,13.741708000000472,2329.8413850737406,2243.0981650897356
"147.32.84.165",3071,"210.211.186.114",6667,4,248,4,248,0,0,4780.370059,3.010483000000022,659.030461224988,0
"147.32.84.165",4421,"209.85.225.27",25,6,372,6,372,0,0,4782.477805,9.029954999999973,329.56974868645625,0
"147.32.84.165",3072,"195.113.232.89",80,13,2800,10,1778,3,1022,4782.477904,11.633834999999635,1222.640685552137,702.7777168921732
"147.32.84.165",4422,"216.32.180.22",25,6,372,6,372,0,0,4782.478788,9.029109999999491,329.600591863447,0
"147.32.84.165",4423,"64.12.90.65",25,6,372,6,372,0,0,4784.283741,9.0299100000002,329.5713910769802,0
"147.32.84.165",4424,"195.186.19.144",25,6,372,6,372,0,0,4784.283884,9.029906999999184,329.5715005703014,0
"147.32.84.165",4427,"209.85.225.27",25,6,372,6,372,0,0,4784.283948,9.029899999999543,329.571756054901,0
"147.32.84.165",4428,"66.94.237.64",25,6,372,6,372,0,0,4784.684842,9.029708000000028,329.5787637872665,0
"147.32.84.165",4429,"207.115.36.22",25,6,372,6,372,0,0,4784.784675,9.029856000000109,329.57336196723,0
"147.32.84.165",4430,"205.188.159.42",25,6,372,6,372,0,0,4785.387125,8.94712999999956,332.6206280673407,0
"147.32.84.165",4431,"24.113.32.85",25,6,372,6,372,0,0,4785.387276,8.947102999999515,332.6216318287787,0
"147.32.84.165",4432,"64.12.139.193",25,6,372,6,372,0,0,4785.588292,8.943989999999758,332.73740243449294,0
"147.32.84.165",3085,"218.248.255.243",6667,4,248,4,248,0,0,4792.710835,2.9229230000000825,678.7725848405668,0
"147.32.84.165",3080,"212.117.174.7",4506,6,372,6,372,0,0,4797.436049,9.013576000000285,330.1686256375834,0
"147.32.84.165",3095,"173.192.170.88",80,17,1643,12,1086,5,557,4798.237372,55.066295999999966,157.77345910464007,80.92064154814413
"147.32.84.165",4433,"209.151.129.150",25,6,372,6,372,0,0,4798.438202,9.01263999999992,330.20291501713444,0
"147.32.84.165",3098,"212.117.174.7",4506,6,372,6,372,0,0,4803.444718,9.013011000000006,330.1893229687613,0
"147.32.84.165",3103,"67.197.150.10",6667,4,248,4,248,0,0,4803.444851,3.0047429999995074,660.289415767114,0
"147.32.84.165",4434,"209.85.225.27",25,6,372,6,372,0,0,4805.247568,9.012808000000405,330.1967599886591,0
"147.32.84.165",4435,"65.54.188.72",25,6,372,6,372,0,0,4805.247701,9.012799999999515,330.1970530800817,0
"147.32.84.165",4436,"75.180.132.243",25,6,372,6,372,0,0,4805.247764,9.012787000000571,330.19752935466147,0
"147.32.84.165",4437,"205.188.190.1",25,6,372,6,372,0,0,4805.648557,9.012297999999646,330.2154456055622,0
"147.32.84.165",4438,"78.66.98.217",25,6,372,6,372,0,0,4805.749084,9.01191000000017,330.22966274629283,0
"147.32.84.165",4440,"209.85.225.27",25,6,372,6,372,0,0,4806.348885,9.015456999999515,330.09973870433413,0
"147.32.84.165",4441,"65.54.188.72",25,6,372,6,372,0,0,4806.549576,9.013017999999647,330.1890665257871,0
"147.32.84.165",4442,"77.238.177.9",25,6,372,6,372,0,0,4806.549711,9.013013000000683,330.1892496992709,0
"147.32.84.165",4444,"205.188.103.1",25,6,372,6,372,0,0,4808.852782,9.012695999999778,330.2008633154911,0
"147.32.84.165",3118,"79.119.209.87",6667,6,372,6,372,0,0,4818.468557,9.01091600000018,330.26609059500066,0
"147.32.84.165",4445,"205.188.159.42",25,6,372,6,372,0,0,4819.067434,9.012918000000354,330.1927300348104,0
"147.32.84.165",4446,"38.113.83.4",25,6,372,6,372,0,0,4819.467873,9.013026999999965,330.1887368139485,0
"147.32.84.165",3133,"59.99.153.96",6667,2,124,2,124,0,0,4826.277872,1.0000000656873453e-05,0,0
"147.32.84.165",3137,"212.117.174.7",4506,6,372,6,372,0,0,4826.277972,9.017614000000322,330.02077933252565,0
"147.32.84.165",3145,"173.192.170.88",80,16,2127,12,1598,4,529,4826.678441,13.43514099999993,951.5344870589796,314.99483332553206
"147.32.84.165",4447,"207.115.36.22",25,6,372,6,372,0,0,4826.678581,9.018175999999585,330.0002129033784,0
"147.32.84.165",4450,"209.85.225.27",25,6,372,6,372,0,0,4826.778902,9.018211999999949,329.99889556821427,0
"147.32.84.165",4451,"98.136.59.15",25,6,372,6,372,0,0,4826.779074,9.018165999999837,330.0005788316664,0
"147.32.84.165",4453,"205.188.190.1",25,6,372,6,372,0,0,4827.379475,9.019252000000051,329.9608437595471,0
"147.32.84.165",4454,"205.188.159.42",25,6,372,6,372,0,0,4827.579604,9.019736000000194,329.9431380253187,0
"147.32.84.165",4455,"64.12.139.193",25,6,372,6,372,0,0,4827.579793,9.019672999999784,329.94544258977805,0
"147.32.84.165",3148,"212.117.174.7",4506,6,372,6,372,0,0,4829.885401,9.023439000000508,329.8077373825913,0
"147.32.84.165",3147,"174.36.246.56",80,27,14221,22,2172,5,12049,4829.885545,0.4032200000001467,43093.100540632106,239055.6024005876
"147.32.84.165",4456,"205.188.103.1",25,6,372,6,372,0,0,4830.006432,9.00281300000006,330.5633472560165,0
"147.32.84.165",3158,"117.196.25.55",6667,6,372,6,372,0,0,4837.401675,8.940016999999898,332.8852730369566,0
"147.32.84.165",3153,"195.113.232.97",80,7,426,6,364,1,62,4839.511028,0.0010970000002998859,0,0
"147.32.84.165",4457,"218.102.53.148",25,6,372,6,372,0,0,4839.51183,8.933090999999877,333.1433654935387,0
"147.32.84.165",3154,"195.113.232.97",80,13,1479,10,1122,3,357,4840.112541,6.1696609999999055,1454.8611341855149,462.91036087720926
"147.32.84.165",4458,"209.85.225.27",25,6,372,6,372,0,0,4840.113385,8.932145000000673,333.1786485776681,0
"147.32.84.165",3171,"119.154.130.96",6667,4,248,4,248,0,0,4840.513899,2.910242000000835,681.7302478623533,0
"147.32.84.165",4459,"66.196.94.104",25,6,372,6,372,0,0,4847.2429,9.013018999999986,330.1890298910947,0
"147.32.84.165",4463,"209.191.88.254",25,6,372,6,372,0,0,4847.643565,9.01284299999952,330.1954777199779,0
"147.32.84.165",4464,"205.188.190.1",25,6,372,6,372,0,0,4847.743659,9.01293700000042,330.19203396183303,0
"147.32.84.165",4465,"209.85.225.27",25,6,372,6,372,0,0,4847.74381,9.012926999999763,330.1924003156886,0
"147.32.84.165",4466,"207.115.37.23",25,6,372,6,372,0,0,4847.743872,9.01292199999989,330.1925834929046,0
"147.32.84.165",4467,"65.55.37.88",25,6,372,6,372,0,0,4848.344614,9.013425000000097,330.17415688264646,0
"147.32.84.165",4468,"65.55.37.88",25,6,372,6,372,0,0,4848.544898,9.013049000000137,330.1879308544705,0
"147.32.84.165",4469,"207.173.161.49",25,6,372,6,372,0,0,4848.545032,9.013006000000132,330.1895061425629,0
"147.32.84.165",3187,"190.246.180.21",6667,4,248,4,248,0,0,4850.948456,3.0055019999999786,660.1226683595665,0
"147.32.84.165",3190,"212.117.174.7",4506,6,372,6,372,0,0,4858.35917,9.015285000000404,330.10603658119146,0
"147.32.84.165",3191,"173.192.170.88",80,17,1643,12,1086,5,557,4859.059905,77.3796940000002,112.27751818196616,57.58616724434176
"147.32.84.165",4470,"205.188.59.194",25,6,372,6,372,0,0,4859.260788,8.912454000000253,333.9147669093064,0
"147.32.84.165",3195,"212.117.174.7",4506,6,372,6,372,0,0,4860.4621,9.012808000000405,330.1967599886591,0
"147.32.84.165",3203,"202.80.173.5",6667,4,248,4,248,0,0,4860.462232,3.003958000000239,660.461963848976,0
"147.32.84.165",4471,"64.12.90.65",25,6,372,6,372,0,0,4861.062778,9.014656999999715,330.1290331956162,0
"147.32.84.165",4472,"183.79.29.234",25,6,372,6,372,0,0,4868.273353,9.012948000000506,330.19163097355414,0
"147.32.84.165",4473,"64.98.36.4",25,6,372,6,372,0,0,4868.673949,9.012805000000299,330.1968698978732,0
"147.32.84.165",4474,"168.95.5.33",25,6,372,6,372,0,0,4868.774022,9.012838999999985,330.1956242644526,0
"147.32.84.165",4476,"209.85.225.27",25,6,372,6,372,0,0,4869.274708,9.01341500000035,330.17452319679995,0
"147.32.84.165",4477,"69.84.129.233",25,6,372,6,372,0,0,4869.374937,9.013072000000648,330.1870882646656,0
"147.32.84.165",4478,"205.188.190.1",25,6,372,6,372,0,0,4869.575653,9.012612000000445,330.20394087750066,0
"147.32.84.165",3217,"122.121.68.110",6667,6,372,6,372,0,0,4878.888836,9.01266299999952,330.20207235088657,0
"147.32.84.165",4479,"124.108.110.37",25,6,372,6,372,0,0,4879.390227,9.01258400000006,330.20496674427443,0
"147.32.84.165",4480,"209.85.225.27",25,6,372,6,372,0,0,4880.190468,9.012956000000486,330.1913378917904,0
"147.32.84.165",4481,"128.121.85.2",25,6,372,6,372,0,0,4880.190601,9.012957999999344,330.1912646214724,0
"147.32.84.165",3233,"117.205.55.134",6667,4,248,4,248,0,0,4882.093026,3.004945000000589,660.2450294430051,0
"147.32.84.165",3239,"212.117.174.7",4506,6,372,6,372,0,0,4889.303456,9.01345500000025,330.1730579450297,0
"147.32.84.165",4482,"38.102.228.16",25,6,372,6,372,0,0,4889.704021,9.01293700000042,330.19203396183303,0
"147.32.84.165",3237,"31.192.109.167",80,15,1540,10,1050,5,490,4889.804167,0.24187199999960285,34729.11291928703,16206.919362333947
"147.32.84.165",3243,"212.117.174.7",4506,6,372,6,372,0,0,4889.882655,8.93474199999946,333.08180583168263,0
"147.32.84.165",4483,"205.188.159.42",25,6,372,6,372,0,0,4889.88272,8.934755000000223,333.08132120018126,0
"147.32.84.165",4484,"205.188.190.1",25,6,372,6,372,0,0,4890.304806,9.013879999999517,330.1574904480822,0
"147.32.84.165",4485,"80.12.242.82",25,6,372,6,372,0,0,4890.304945,9.013778000000457,330.1612265134386,0
"147.32.84.165",3249,"91.214.134.197",6667,9,552,6,372,3,180,4890.404951,1.0544169999993755,2822.4127645910135,1365.6835957698452
"147.32.84.165",4487,"209.85.225.27",25,6,372,6,372,0,0,4890.605243,9.013334999999643,330.17745373938925,0
"147.32.84.165",4488,"194.242.61.17",25,6,372,6,372,0,0,4891.459631,8.960023000000547,332.14200454617344,0
"147.32.84.165",3254,"62.178.214.33",6667,2,124,2,124,0,0,4899.318541,9.000000318337698e-06,0,0
"147.32.84.165",3259,"174.133.57.141",80,17,3489,12,1428,5,2061,4899.918716,0.7013399999996182,16288.81854736108,23509.2822311703
"147.32.84.165",4489,"74.63.255.2",25,6,372,6,372,0,0,4900.086309,8.945952999999463,332.6643902555914,0
"147.32.84.165",4490,"205.188.190.1",25,6,372,6,372,0,0,4900.419789,9.01419800000076,330.1458432574644,0
"147.32.84.165",4491,"76.96.62.116",25,6,372,6,372,0,0,4901.221214,8.912446000000273,333.9150666382617,0
"147.32.84.165",3271,"58.252.109.240",6667,2,124,2,124,0,0,4910.233878,9.000000318337698e-06,0,0
"147.32.84.165",3281,"174.133.57.141",80,17,3489,12,1428,5,2061,4910.634267,2.660114999999678,4294.551175419628,6198.2282720867315
"147.32.84.165",4492,"74.6.136.65",25,6,372,6,372,0,0,4910.734386,9.013488999999936,330.1718124912585,0
"147.32.84.165",4493,"209.85.225.27",25,6,372,6,372,0,0,4910.795004,8.952939000000697,332.4048114255853,0
"147.32.84.165",4494,"66.94.237.64",25,6,372,6,372,0,0,4910.795041,8.95292999999947,332.40514557805955,0
"147.32.84.165",4495,"66.94.237.139",25,6,372,6,372,0,0,4911.235033,9.012869000000137,330.1945251839292,0
"147.32.84.165",4496,"69.39.82.252",25,6,372,6,372,0,0,4911.535506,9.013288999999531,330.17913882492337,0
"147.32.84.165",4497,"205.188.146.193",25,6,372,6,372,0,0,4912.336607,9.013394999999946,330.1752558275786,0
"147.32.84.165",4499,"205.188.190.1",25,6,372,6,372,0,0,4913.139088,9.011859000000186,330.23153158520773,0
"147.32.84.165",4501,"213.199.180.150",25,6,372,6,372,0,0,4913.139194,9.011892999999873,330.23028569025865,0
"147.32.84.165",3295,"212.117.174.7",4506,6,372,6,372,0,0,4920.948944,9.013644000000568,330.1661348062795,0
"147.32.84.165",3290,"116.72.72.149",6667,2,124,2,124,0,0,4921.450045,1.0000000656873453e-05,0,0
"147.32.84.165",3292,"212.117.174.7",4506,6,372,6,372,0,0,4922.151153,9.012948999999935,330.19159433832607,0
"147.32.84.165",3287,"173.192.170.88",80,16,2030,12,1502,4,528,4922.151219,11.102527999999438,1082.276036592802,380.4538930233019
"147.32.84.165",4502,"209.85.225.27",25,6,372,6,372,0,0,4922.151273,9.01296899999943,330.1908616350714,0
"147.32.84.165",3301,"174.133.57.141",80,17,3489,12,1428,5,2061,4923.352505,3.3288460000003397,3431.8199159705296,4953.0678198986425
"147.32.84.165",3302,"68.67.185.217",80,13,2276,10,1304,3,972,4923.511284,9.7426660000001,1070.754144707403,798.1388256561315
"147.32.84.165",4503,"65.55.92.168",25,6,372,6,372,0,0,4923.535566,8.921618000000308,333.5717803653886,0
"147.32.84.165",3307,"201.217.51.159",6667,9,552,6,372,3,180,4931.764986,1.6962000000003172,1754.5100813580023,848.9564909796785
"147.32.84.165",3304,"68.67.185.217",80,13,2501,10,1680,3,821,4931.765143,1.4889929999999367,9026.234508826146,4411.034840325159
"147.32.84.165",4505,"76.96.62.116",25,6,372,6,372,0,0,4931.765217,9.020692000000054,329.9081711247854,0
"147.32.84.165",3315,"217.163.21.37",80,21,6659,14,1570,7,5089,4932.265821,0.19006199999967066,66083.69900359759,214203.78613331728
"147.32.84.165",4506,"74.53.248.194",25,6,372,6,372,0,0,4932.311861,8.974693999999545,331.59904950521445,0
"147.32.84.165",3317,"217.163.21.37",80,15,2336,10,1450,5,886,4932.557575,0.14070300000003044,82443.1604158937,50375.61388171159
"147.32.84.165",4507,"65.55.37.88",25,6,372,6,372,0,0,4932.60403,8.9830579999998,331.2903022556535,0
"147.32.84.165",3318,"195.113.232.88",80,13,1772,10,1228,3,544,4932.858161,0.3961570000001302,24798.249178978967,10985.543610231725
"147.32.84.165",4508,"64.12.90.65",25,6,372,6,372,0,0,4932.859594,9.025614000000132,329.728260038592,0
"147.32.84.165",4509,"205.188.146.193",25,6,372,6,372,0,0,4933.372997,9.013135999999577,330.18474368967026,0
"147.32.84.165",4510,"71.74.56.243",25,6,372,6,372,0,0,4933.461482,8.924776000000747,333.4537471864561,0
"147.32.84.165",4511,"98.137.54.237",25,6,372,6,372,0,0,4934.173906,9.01302399999986,330.1888467178215,0
"147.32.84.165",3323,"118.98.202.90",6667,6,372,6,372,0,0,4941.985727,9.013022000000092,330.1889199870997,0
"147.32.84.165",3327,"173.192.170.88",80,11,1283,8,846,3,437,4943.187072,13.410589000000073,504.67581998076025,260.68951930448253
"147.32.84.165",3326,"174.133.57.141",80,16,3429,12,1428,4,2001,4943.388368,0.49552500000027067,23054.336309961676,32305.130921732012
"147.32.84.165",4512,"74.6.136.65",25,6,372,6,372,0,0,4943.552072,8.948150999999598,332.5826754600066,0
"147.32.84.165",4513,"209.85.225.27",25,6,372,6,372,0,0,4944.489317,9.012344000000667,330.2137601493884,0
"147.32.84.165",3345,"212.117.174.7",4506,6,372,6,372,0,0,4952.8009,9.012738999999783,330.1992879190301,0
"147.32.84.165",3341,"84.247.61.206",6667,6,372,6,372,0,0,4953.301459,9.014831999999842,330.1226245813624,0
"147.32.84.165",3347,"212.117.174.7",4506,6,372,6,372,0,0,4953.601834,9.01360300000033,330.16763662654,0
"147.32.84.165",4514,"204.127.217.21",25,6,372,6,372,0,0,4953.601969,9.013589000000138,330.16814944634757,0
"147.32.84.165",3352,"174.133.57.141",80,16,3429,12,1428,4,2001,4953.90219,0.5131430000001274,22262.800038190457,31195.982406455954
"147.32.84.165",4515,"74.6.136.244",25,6,372,6,372,0,0,4954.059892,8.956131999999343,332.28630395356146,0
"147.32.84.165",4516,"65.55.92.152",25,6,372,6,372,0,0,4954.402952,9.013537999999244,330.17001758912534,0
"147.32.84.165",4518,"205.188.190.1",25,6,372,6,372,0,0,4954.40309,9.013528000000406,330.1703838940608,0
"147.32.84.165",3354,"99.236.68.164",6667,4,248,4,248,0,0,4955.204563,3.0039409999999407,660.4657015567346,0
"147.32.84.165",4519,"74.6.136.65",25,6,372,6,372,0,0,4963.016159,9.012510000000475,330.20767799423726,0
"147.32.84.165",4520,"66.94.237.64",25,6,372,6,372,0,0,4963.016219,9.012520000000222,330.2073116065126,0
"147.32.84.165",3366,"78.153.48.99",6667,4,248,4,248,0,0,4964.517795,3.0046290000000226,660.314468109036,0
"147.32.84.165",3365,"174.133.57.141",80,17,3489,12,1428,5,2061,4965.519481,6.791991999999482,1681.9807797183612,2427.564696778391
"147.32.84.165",4521,"209.85.225.27",25,6,372,6,372,0,0,4965.67973,8.95265500000005,332.4153561150277,0
"147.32.84.165",4522,"205.188.59.194",25,6,372,6,372,0,0,4973.029892,8.913222000000133,333.88599543464255,0
"147.32.84.165",4523,"207.115.36.22",25,6,372,6,372,0,0,4973.83091,8.91292599999997,333.8970838532722,0
"147.32.84.165",4524,"66.94.237.139",25,6,372,6,372,0,0,4974.33381,8.910804000000098,333.97659739794153,0
"147.32.84.165",3379,"82.227.106.170",6667,4,248,4,248,0,0,4974.63254,2.903682000000117,683.2704132201529,0
"147.32.84.165",4525,"74.6.136.244",25,6,372,6,372,0,0,4975.032937,8.913430999999946,333.87816655561903,0
"147.32.84.165",4526,"62.149.225.190",25,6,372,6,372,0,0,4975.333346,9.01283499999954,330.1957708090908,0
"147.32.84.165",4527,"64.12.90.65",25,6,372,6,372,0,0,4975.333486,9.012839999999414,330.1955876283384,0
"147.32.84.165",3385,"212.117.174.7",4506,6,372,6,372,0,0,4983.244453,9.013081999999486,330.18672192266416,0
"147.32.84.165",3386,"212.117.174.7",4506,6,372,6,372,0,0,4983.946513,9.012611000000106,330.2039775155019,0
"147.32.84.165",3390,"174.133.57.141",80,17,3489,12,1428,5,2061,4983.946651,0.9451859999999215,12086.509956771417,17444.185588869674
"147.32.84.165",4528,"195.28.226.86",25,6,372,6,372,0,0,4984.106638,8.95198100000016,332.44038386586686,0
"147.32.84.165",3394,"202.141.255.46",6667,4,248,4,248,0,0,4986.549507,3.004081000000042,660.4349216948452,0
"147.32.84.165",4529,"66.94.237.64",25,6,372,6,372,0,0,4993.459561,9.012536000000182,330.2067253878309,0
"147.32.84.165",3403,"212.117.171.138",65500,24,1471,18,1092,6,379,4993.960165,107.17731999999978,81.5097821068862,28.28956723306765
"147.32.84.165",4530,"209.85.225.27",25,6,372,6,372,0,0,4993.960304,9.014752999999473,330.1255175821427,0
"147.32.84.165",3406,"89.34.230.250",6667,4,248,4,248,0,0,4994.761061,3.0042590000002747,660.3957914413567,0
"147.32.84.165",3407,"174.133.57.141",80,16,3429,12,1428,4,2001,4995.2641,0.5771310000000085,19794.466074426484,27737.20351185392
"147.32.84.165",4533,"205.188.190.1",25,6,372,6,372,0,0,4995.425695,8.94922200000019,332.5428735592811,0
"147.32.84.165",4534,"203.188.197.119",25,6,372,6,372,0,0,4995.962962,9.01576600000044,330.0884250988607,0
"147.32.84.165",4535,"165.160.10.151",25,6,372,6,372,0,0,4996.363827,9.012786000000233,330.1975659912399,0
"147.32.84.165",4536,"74.125.43.27",25,6,372,6,372,0,0,4996.363922,9.012817000000723,330.1964302614556,0
"147.32.84.165",3413,"173.192.170.88",80,35,5343,24,2328,11,3015,5003.073268,43.70430699999997,426.1364903921257,551.8906866547504
"147.32.84.165",4537,"209.85.225.27",25,6,372,6,372,0,0,5003.274393,9.012370000000374,330.21280750788935,0
"147.32.84.165",4538,"207.5.74.239",25,6,372,6,372,0,0,5003.274467,9.012426000000232,330.2107556833114,0
"147.32.84.165",4539,"216.33.127.20",25,6,372,6,372,0,0,5004.274847,9.01328199999989,330.179395252477,0
"147.32.84.165",3423,"222.23.100.200",6667,4,248,4,248,0,0,5005.076269,3.0072250000002896,659.7444487857772,0
"147.32.84.165",3435,"212.117.174.7",4506,6,372,6,372,0,0,5013.288005,9.01314099999945,330.18456052115255,0
"147.32.84.165",3426,"174.133.57.141",80,17,3489,12,1428,5,2061,5014.489325,3.3216440000005605,3439.2607997720625,4963.8070786626195
"147.32.84.165",4540,"74.6.136.65",25,6,372,6,372,0,0,5014.644771,8.95770899999934,332.22780512296384,0
"147.32.84.165",3434,"31.192.109.167",80,15,1540,10,1050,5,490,5014.990158,0.24242700000013429,34649.60586071414,16169.816068333266
"147.32.84.165",3432,"212.117.174.7",4506,6,372,6,372,0,0,5015.071695,8.931478000000425,333.20353025555886,0
"147.32.84.165",3439,"77.127.110.198",6667,4,248,4,248,0,0,5015.071765,2.923131000000467,678.7242857058692,0
"147.32.84.165",4542,"64.12.139.193",25,6,372,6,372,0,0,5016.392313,9.01270199999999,330.2006434918189,0
"147.32.84.165",4543,"199.228.142.102",25,6,372,6,372,0,0,5016.993206,9.012910999999804,330.1929864835085,0
"147.32.84.165",4544,"213.95.23.130",25,6,372,6,372,0,0,5017.393601,9.012832000000344,330.1958807176131,0
"147.32.84.165",4545,"98.137.54.238",25,6,372,6,372,0,0,5017.39374,9.012778999999682,330.1978224474499,0
"147.32.84.165",3451,"208.73.210.29",80,69,38407,42,6524,27,31883,5023.502422,19.734506000000692,2644.7077013226562,12924.772477202674
"147.32.84.165",4546,"209.85.225.27",25,6,372,6,372,0,0,5023.687762,8.928122000000258,333.3287784373818,0
"147.32.84.165",4549,"165.21.74.116",25,6,372,6,372,0,0,5024.303913,9.012988999999834,330.1901289350353,0
"147.32.84.165",3454,"74.125.232.217",80,13,2940,10,2066,3,874,5025.304966,17.932182000000466,921.6948612276839,389.91350857357
"147.32.84.165",3453,"89.228.163.103",6667,4,248,4,248,0,0,5025.31337,2.995856999999887,662.2478976800544,0
"147.32.84.165",3480,"174.133.57.141",80,19,4313,14,2252,5,2061,5033.116239,3.7663439999996626,4783.418614975588,4377.720144522507
"147.32.84.165",4550,"74.6.136.65",25,6,372,6,372,0,0,5033.275923,8.953975999999784,332.3663141379954,0
"147.32.84.165",3463,"67.214.158.5",80,15,2571,10,1716,5,855,5033.275993,0.3152329999993526,43548.74013833638,21698.235908087183
"147.32.84.165",4551,"203.5.59.236",25,6,372,6,372,0,0,5033.379661,8.950275000000147,332.5037498847746,0
"147.32.84.165",3465,"195.113.232.88",80,13,2136,10,1548,3,588,5034.317976,8.919363999999405,1388.4398035555928,527.3918633660779
"147.32.84.165",4552,"65.55.92.184",25,6,372,6,372,0,0,5034.319159,9.011776000000282,330.23457307415396,0
"147.32.84.165",3466,"50.22.198.84",80,13,3359,10,2328,3,1031,5035.624641,0.36722699999972974,50715.225187727774,22460.222151437858
"147.32.84.165",3532,"178.123.23.184",6667,4,248,4,248,0,0,5035.745564,2.9787080000005517,666.0605873417712,0
"147.32.84.165",4554,"205.188.103.1",25,6,372,6,372,0,0,5037.422347,8.913194000000658,333.88704430754905,0
"147.32.84.165",3525,"67.214.158.5",80,15,2656,10,1760,5,896,5038.024076,0.32985200000075565,42685.81060587095,21730.95812662521
"147.32.84.165",4555,"216.32.181.178",25,6,372,6,372,0,0,5038.127857,8.908423999999286,334.06582353963375,0
"147.32.84.165",3544,"50.22.198.84",80,14,3012,10,2432,4,580,5038.424375,0.3694900000000416,52656.36417764434,12557.850009471102
"147.32.84.165",4556,"209.85.225.27",25,6,372,6,372,0,0,5038.424515,8.912057000000459,333.9296416079752,0
"147.32.84.165",3570,"68.67.185.208",80,13,2050,10,1168,3,882,5038.424573,4.8129509999998845,1941.4284500299761,1466.0444288753758
"147.32.84.165",4557,"74.125.93.27",25,6,372,6,372,0,0,5038.453838,8.882862999999816,335.0271190718648,0
"147.32.84.165",3575,"68.67.185.208",80,13,2078,10,1168,3,910,5038.545128,4.692576999999801,1991.2299787516317,1551.386370431494
"147.32.84.165",4561,"77.238.177.9",25,6,372,6,372,0,0,5038.54518,8.891598000000158,334.6979924193544,0
"147.32.84.165",3617,"212.117.174.7",4506,6,372,6,372,0,0,5043.330849,8.91297399999985,333.8952856813057,0
"147.32.84.165",3631,"210.212.164.162",6667,4,248,4,248,0,0,5044.632824,2.904026999999587,683.1892403205211,0
"147.32.84.165",3605,"212.117.174.7",4506,6,372,6,372,0,0,5045.234031,9.012872999999672,330.19437864043,0
"147.32.84.165",4562,"65.55.92.168",25,6,372,6,372,0,0,5045.23417,9.012806000000637,330.1968332614493,0
"147.32.84.165",3637,"173.192.170.88",80,17,1641,12,1084,5,557,5053.545543,90.44959500000004,95.87660398037156,49.26500776482192
"147.32.84.165",3641,"174.133.57.141",80,17,3489,12,1428,5,2061,5053.746668,3.867518000000018,2953.8324062098604,4263.199292155828
"147.32.84.165",4565,"205.188.190.1",25,6,372,6,372,0,0,5053.907857,8.951524000000063,332.4573558647644,0
"147.32.84.165",4566,"65.111.161.189",25,6,372,6,372,0,0,5054.247014,9.012473000000682,330.20903363591486,0
"147.32.84.165",3668,"194.67.211.76",6667,4,248,4,248,0,0,5055.248525,3.0044330000000627,660.3575450009897,0
"147.32.84.165",4567,"98.137.54.238",25,6,372,6,372,0,0,5058.352622,9.012770999999702,330.1981155407253,0
"147.32.84.165",4568,"65.55.92.136",25,6,372,6,372,0,0,5059.053703,9.013471000000209,330.17247184796304,0
"147.32.84.165",4569,"209.85.225.27",25,6,372,6,372,0,0,5059.355048,9.011913999999706,330.22951617160317,0
"147.32.84.165",4570,"173.160.140.70",25,6,372,6,372,0,0,5059.454113,9.013026000000536,330.18877344854246,0
"147.32.84.165",4571,"124.108.110.37",25,6,372,6,372,0,0,5063.15972,9.012688000000708,330.20115641413156,0
"147.32.84.165",4572,"74.6.136.65",25,6,372,6,372,0,0,5064.261225,9.012710999999399,330.20031375689274,0
"147.32.84.165",3712,"184.106.213.57",6667,15,1780,10,1222,5,558,5066.26415,0.44616599999972095,21911.12724861624,10005.244684720019
"147.32.84.165",4574,"71.74.56.243",25,6,372,6,372,0,0,5066.394064,8.982834000000366,331.29856346002595,0
"147.32.84.165",3726,"212.117.174.7",4506,6,372,6,372,0,0,5073.374065,9.013054000000011,330.18774768241667,0
"147.32.84.165",3731,"178.125.53.75",6667,2,124,2,124,0,0,5074.876289,9.999999747378752e-06,0,0
"147.32.84.165",3735,"212.117.174.7",4506,6,372,6,372,0,0,5075.276766,9.01317199999994,330.18342488083215,0
"147.32.84.165",3723,"174.133.57.141",80,14,1831,10,1308,4,523,5075.276917,215.75713900000028,48.498974580859574,19.392174086995077
"147.32.84.165",4575,"65.54.188.94",25,6,372,6,372,0,0,5075.437248,8.952787000000171,332.4104549789851,0
"147.32.84.165",4577,"209.85.225.27",25,6,372,6,372,0,0,5079.382627,9.01347799999985,330.1722154311631,0
"147.32.84.165",3740,"212.117.171.138",65500,344,333178,256,326522,88,6656,5079.382777,135.72467099999994,19246.139856179878,392.32366236496546
"147.32.84.165",4578,"205.188.190.1",25,6,372,6,372,0,0,5079.382863,9.013300000000527,330.17873586808673,0
"147.32.84.165",3753,"65.55.92.136",25,6,372,6,372,0,0,5080.083638,9.013098000000355,330.1861357770528,0
"147.32.84.165",4579,"195.83.247.29",25,6,372,6,372,0,0,5080.384313,9.01339900000039,330.17510930114946,0
"147.32.84.165",3754,"117.206.80.51",6667,4,248,4,248,0,0,5080.484664,3.0042990000001737,660.3869987640662,0
"147.32.84.165",4580,"62.128.158.226",25,6,372,6,372,0,0,5084.189841,9.012816999999814,330.1964302614889,0
"147.32.84.165",4581,"94.245.120.86",25,6,372,6,372,0,0,5085.29124,9.012848000000304,330.1952945395173,0
"147.32.84.165",4582,"209.85.227.27",25,6,372,6,372,0,0,5087.394305,9.01327399999991,330.17968831304023,0
"147.32.84.165",4583,"62.44.29.54",25,6,372,6,372,0,0,5088.395938,9.013154000000213,330.1840842839177,0
"147.32.84.165",3779,"85.221.145.247",6667,2,124,2,124,0,0,5094.404212,1.0999999176419806e-05,0,0
"147.32.84.165",4584,"209.85.225.27",25,6,372,6,372,0,0,5096.407674,9.012749999999869,330.19888491304465,0
"147.32.84.165",4585,"74.6.136.65",25,6,372,6,372,0,0,5098.010121,9.012366999999358,330.21291742782023,0
"147.32.84.165",3803,"212.117.174.7",4506,6,372,6,372,0,0,5100.413279,9.012621999999283,330.2035744981024,0
"147.32.84.165",3807,"121.245.3.131",6667,4,248,4,248,0,0,5101.113897,3.0045499999996537,660.3318300578219,0
"147.32.84.165",3808,"212.117.174.7",4506,6,372,6,372,0,0,5101.414458,9.01328199999989,330.179395252477,0
"147.32.84.165",4586,"64.12.139.193",25,6,372,6,372,0,0,5101.414596,9.013268000000608,330.1799081087791,0
"147.32.84.165",4587,"193.251.214.113",25,6,372,6,372,0,0,5105.220048,9.012891999999738,330.1936825605018,0
"147.32.84.165",4588,"207.69.189.217",25,6,372,6,372,0,0,5106.321908,8.912921000000097,333.8972711639616,0
"147.32.84.165",3816,"174.133.57.141",80,17,3489,12,1428,5,2061,5108.22466,2.1031650000004447,5431.813481109463,7839.613154458406
"147.32.84.165",4590,"74.6.136.65",25,6,372,6,372,0,0,5108.224791,8.912700000000768,333.9055505065517,0
"147.32.84.165",4593,"77.238.184.241",25,6,372,6,372,0,0,5108.224848,8.912739000000329,333.9040894162715,0
"147.32.84.165",4594,"205.188.190.1",25,6,372,6,372,0,0,5108.424768,8.912795000000187,333.90199146282816,0
"147.32.84.165",4595,"209.85.225.27",25,6,372,6,372,0,0,5109.426033,8.912510000000111,333.91266882168577,0
"147.32.84.165",4596,"200.91.27.33",25,6,372,6,372,0,0,5109.426094,8.912563999999293,333.9106456907615,0
"147.32.84.165",3828,"201.217.51.159",6667,9,552,6,372,3,180,5117.337698,1.6906099999996513,1760.3113669034335,851.7635646306936
"147.32.84.165",4598,"212.79.242.245",25,6,372,6,372,0,0,5118.439155,9.011981999999989,330.2270244214873,0
"147.32.84.165",4599,"67.231.152.39",25,6,372,6,372,0,0,5118.939721,9.012649000000238,330.2025852776383,0
"147.32.84.165",4600,"74.6.136.65",25,6,372,6,372,0,0,5119.028522,8.923980000000483,333.48349055016246,0
"147.32.84.165",3848,"109.86.117.4",6667,4,248,4,248,0,0,5121.3471,2.99420900000041,662.6123961285696,0
"147.32.84.165",3856,"98.126.71.122",80,18,4863,14,1430,4,3433,5122.344535,17.784111999999368,643.2708026130518,1544.2997659934315
"147.32.84.165",3854,"174.133.57.141",80,16,3429,12,1428,4,2001,5122.519277,0.46291699999983393,24678.29006064607,34580.71317321624
"147.32.84.165",4601,"94.245.120.86",25,6,372,6,372,0,0,5122.519341,8.944241000000147,332.72806490790566,0
"147.32.84.165",3868,"195.113.232.88",80,23,7760,16,3996,7,3764,5126.147167,13.981596999999965,2286.4340890386184,2153.688165951291
"147.32.84.165",4603,"205.188.103.1",25,6,372,6,372,0,0,5126.148175,9.029982000000018,329.5687632599925,0
"147.32.84.165",3883,"212.117.174.7",4506,6,372,6,372,0,0,5127.250597,9.031012999999803,329.53113897633244,0
"147.32.84.165",3884,"212.117.174.7",4506,6,372,6,372,0,0,5129.156998,9.030156999999235,329.5623763795305,0
"147.32.84.165",3881,"195.113.232.89",80,13,2789,10,1768,3,1021,5129.157059,10.971797000000151,1289.1233769636647,744.4541673528855
"147.32.84.165",4605,"212.74.114.145",25,6,372,6,372,0,0,5129.157947,9.029333000000406,329.592451624042,0
"147.32.84.165",4607,"209.85.225.27",25,6,372,6,372,0,0,5129.357875,9.030332000000271,329.55598974654646,0
"147.32.84.165",3895,"117.204.74.3",6667,4,248,4,248,0,0,5130.360723,3.0112239999998565,658.8682874472622,0
"147.32.84.165",3897,"195.113.232.83",80,30,19129,24,2264,6,16865,5136.181021,3.9479389999996783,4587.71019511737,34174.79348085444
"147.32.84.165",3919,"174.133.57.141",80,16,3429,12,1428,4,2001,5136.181936,0.5028760000004695,22717.329918288673,31832.89717541711
"147.32.84.165",4609,"74.6.136.65",25,6,372,6,372,0,0,5136.181997,9.033374999999978,329.444974884803,0
"147.32.84.165",3937,"31.192.109.167",80,15,1540,10,1050,5,490,5136.182056,0.2401850000005652,34973.04161367376,16320.752753047756
"147.32.84.165",4610,"65.55.37.88",25,6,372,6,372,0,0,5136.260828,8.954671999999846,332.3404810360504,0
"147.32.84.165",4612,"68.1.17.3",25,6,372,6,372,0,0,5139.491324,9.029155000000173,329.59894918183846,0
"147.32.84.165",3960,"213.111.249.148",6667,4,248,4,248,0,0,5139.99306,3.01911199999995,657.1468696755976,0
"147.32.84.165",4613,"207.115.21.24",25,6,372,6,372,0,0,5139.9932,9.028175000000374,329.6347268412361,0
"147.32.84.165",4614,"12.1.218.11",25,6,372,6,372,0,0,5143.51552,9.01129200000014,330.2523101015874,0
"147.32.84.165",3978,"173.192.170.88",80,15,3217,10,966,5,2251,5147.218794,1.191965999999411,6483.40640589062,15107.813477908681
"147.32.84.165",3984,"174.133.57.141",80,17,3489,12,1428,5,2061,5147.418573,6.099275999999918,1873.009189943225,2703.27166699789
"147.32.84.165",4615,"64.12.139.193",25,6,372,6,372,0,0,5147.41871,9.013108000000102,330.1857694371316,0
"147.32.84.165",4616,"209.85.225.27",25,6,372,6,372,0,0,5147.419788,9.012154999999439,330.2206852856154,0
"147.32.84.165",4617,"209.84.253.95",25,6,372,6,372,0,0,5147.419849,9.012142999999924,330.2211249865903,0
"147.32.84.165",4618,"205.188.190.1",25,6,372,6,372,0,0,5148.323808,9.008993999999802,330.3365503407001,0
"147.32.84.165",3996,"220.181.65.141",6667,9,552,6,372,3,180,5150.223503,1.9197319999993852,1550.216384370815,750.1047021149104
"147.32.84.165",4619,"66.39.2.13",25,6,372,6,372,0,0,5150.423642,8.914507999999842,333.83782930028815,0
"147.32.84.165",4623,"212.52.84.177",25,6,372,6,372,0,0,5152.143495,8.895029999999679,334.56885474249185,0
"147.32.84.165",4005,"212.117.174.7",4506,6,372,6,372,0,0,5157.232864,8.912591000000248,333.90963413444166,0
"147.32.84.165",4017,"82.205.135.35",6667,4,248,4,248,0,0,5158.234252,3.0043019999993703,660.3863393228829,0
"147.32.84.165",4021,"212.117.174.7",4506,6,372,6,372,0,0,5160.437358,9.013079999999718,330.1867951909994,0
"147.32.84.165",4624,"165.21.74.117",25,6,372,6,372,0,0,5160.437468,9.013095000000249,330.1862456791943,0
"147.32.84.165",4625,"209.85.225.27",25,6,372,6,372,0,0,5160.938517,9.012746000000334,330.1990314605437,0
"147.32.84.165",4078,"174.133.57.141",80,17,2011,12,1428,5,583,5164.443368,164.1441509999995,69.59736262548907,28.414049307184964
"147.32.84.165",4626,"66.94.237.64",25,6,372,6,372,0,0,5164.443503,9.012658999999985,330.20221890121496,0
"147.32.84.165",4095,"190.204.173.239",6667,4,248,4,248,0,0,5168.348565,3.004351999999926,660.3753488273175,0
"147.32.84.165",4627,"186.202.4.42",25,6,372,6,372,0,0,5168.348707,9.012885999999526,330.193902374906,0
"147.32.84.165",4628,"205.188.190.1",25,6,372,6,372,0,0,5169.250195,9.012703000000329,330.2006068545576,0
"147.32.84.165",4629,"74.6.136.65",25,6,372,6,372,0,0,5171.353105,9.01293699999951,330.19203396186634,0
"147.32.84.165",4630,"143.19.70.13",25,6,372,6,372,0,0,5173.055613,9.012962999999218,330.1910814457197,0
"147.32.84.165",4631,"207.115.21.22",25,6,372,6,372,0,0,5173.856578,9.013050999999905,330.18785758563126,0
"147.32.84.165",4134,"77.127.110.198",6667,4,248,4,248,0,0,5178.163028,3.0043400000004112,660.3779865127543,0
"147.32.84.165",4632,"207.115.36.22",25,6,372,6,372,0,0,5181.467685,9.012830000000577,330.1959539900131,0
"147.32.84.165",4633,"165.21.74.113",25,6,372,6,372,0,0,5181.968703,9.013119000000188,330.1853664641439,0
"147.32.84.165",4155,"212.117.174.7",4506,6,372,6,372,0,0,5184.073272,9.011465000000499,330.2459699948716,0
"147.32.84.165",4161,"190.151.53.33",6667,4,248,4,248,0,0,5185.473549,3.004222999999911,660.4037050512092,0
"147.32.84.165",4165,"212.117.174.7",4506,6,372,6,372,0,0,5189.379169,9.012807000000066,330.1967966250668,0
"147.32.84.165",4634,"209.85.225.27",25,6,372,6,372,0,0,5189.379307,9.01280399999996,330.1969065343053,0
"147.32.84.165",4635,"205.188.190.1",25,6,372,6,372,0,0,5190.280151,9.015773000000081,330.08816881258804,0
"147.32.84.165",4636,"74.6.136.65",25,6,372,6,372,0,0,5192.383517,9.015040000000226,330.11500780916396,0
"147.32.84.165",4639,"210.87.250.224",25,6,372,6,372,0,0,5193.685496,9.013098999999784,330.1860991430441,0
"147.32.84.165",4644,"207.115.36.22",25,6,372,6,372,0,0,5194.086297,9.01281999999992,330.1963203525674,0
"147.32.84.165",4645,"66.94.237.64",25,6,372,6,372,0,0,5194.08637,9.01287400000001,330.19434200455885,0
"147.32.84.165",4646,"205.188.146.193",25,6,372,6,372,0,0,5194.886885,9.013128999999935,330.1850001259298,0
"147.32.84.165",4214,"178.90.6.143",6667,6,372,6,372,0,0,5202.497779,10.006594999999834,297.4038621529151,0
"147.32.84.165",4647,"209.85.225.27",25,6,372,6,372,0,0,5202.998556,9.943022000000383,299.30538220672605,0
"147.32.84.165",4648,"205.188.103.1",25,6,372,6,372,0,0,5202.998684,9.946092999999564,299.21296734306935,0
"147.32.84.165",4231,"212.117.171.138",65500,11,666,8,484,3,182,5203.899763,315.3530269999992,12.278302944591713,4.6170478014787015
"147.32.84.165",4252,"174.133.57.141",80,16,3429,12,1428,4,2001,5203.899898,0.48456200000055105,23575.93042786477,33036.02015837353
"147.32.84.165",4649,"77.238.177.9",25,6,372,6,372,0,0,5203.899955,9.906418000000485,300.411309112926,0
"147.32.84.165",4254,"65.55.16.187",443,199,170627,136,10904,63,159723,5205.10157,10.150407000000087,8593.941109947538,125885.00145856114
"147.32.84.165",4650,"205.188.59.194",25,6,372,6,372,0,0,5205.26753,9.531245000000126,312.2362293698211,0
"147.32.84.165",4294,"212.117.174.7",4506,6,372,6,372,0,0,5210.409431,9.012633000000278,330.2031714816201,0
"147.32.84.165",4263,"41.201.54.29",6667,3,184,2,124,1,60,5211.310369,1.264933999999812,784.2306397014765,379.4664385652306
"147.32.84.165",4651,"192.100.176.132",25,6,372,6,372,0,0,5213.413589,9.012961999999789,330.19111808083403,0
"147.32.84.165",4304,"174.133.57.141",80,17,2011,12,1428,5,583,5214.715345,105.63418700000057,108.14680667727332,44.15237275409688
"147.32.84.165",4652,"71.74.56.243",25,6,372,6,372,0,0,5214.715471,9.012891999999738,330.1936825605018,0
"147.32.84.165",4656,"68.1.17.3",25,6,372,6,372,0,0,5215.116097,9.012979999999516,330.19045864965415,0
"147.32.84.165",4310,"82.99.253.2",6667,5,308,4,248,1,60,5215.917088,0.8016920000000027,2474.765870184551,598.7336782704559
"147.32.84.165",4316,"212.117.174.7",4506,6,372,6,372,0,0,5223.528129,8.912786999999298,333.9022911688829,0
"147.32.84.165",4657,"65.55.37.88",25,6,372,6,372,0,0,5223.528227,8.912817999999788,333.9011298110284,0
"147.32.84.165",4658,"209.85.225.27",25,6,372,6,372,0,0,5223.728228,8.912996000000021,333.8944615256187,0
"147.32.84.165",4659,"209.85.225.27",25,6,372,6,372,0,0,5224.029127,8.91267599999992,333.90644964542935,0
"147.32.84.165",4660,"74.125.67.27",25,6,372,6,372,0,0,5224.029218,8.912710000000516,333.9051758668046,0
"147.32.84.165",4661,"205.188.190.1",25,6,372,6,372,0,0,5224.930083,8.912781999999424,333.9024784854148,0
"147.32.84.165",4370,"61.17.216.4",6667,15,1750,10,1192,5,558,5226.234885,1.0645220000005793,8958.011201266681,4193.4314180426245
"147.32.84.165",4662,"98.137.54.238",25,6,372,6,372,0,0,5226.429441,8.815700000000106,337.57954558344363,0
"147.32.84.165",4383,"58.252.109.240",6667,4,248,4,248,0,0,5231.339348,3.0061869999999544,659.9722505619345,0
"147.32.84.165",4664,"64.26.60.153",25,6,372,6,372,0,0,5233.943005,9.012998999999581,330.18976258625327,0
"147.32.84.165",4667,"209.85.225.27",25,6,372,6,372,0,0,5234.345667,9.010807999999997,330.2700490344485,0
"147.32.84.165",4668,"205.188.190.1",25,6,372,6,372,0,0,5234.345723,9.010840999999346,330.26883950124255,0
"147.32.84.165",4669,"216.82.250.19",25,6,372,6,372,0,0,5234.345778,9.010812000000442,330.2699024238719,0
"147.32.84.165",4670,"209.85.225.27",25,6,372,6,372,0,0,5235.645407,9.013670999999704,330.16514581019186,0
"147.32.84.165",4672,"209.85.225.27",25,6,372,6,372,0,0,5235.645541,9.013641000000462,330.16624469510685,0
"147.32.84.165",4673,"205.188.190.1",25,6,372,6,372,0,0,5235.645599,9.013606999999865,330.16749010690666,0
"147.32.84.165",4674,"216.32.181.178",25,6,372,6,372,0,0,5235.645658,9.013570999999502,330.1688087884552,0
"147.32.84.165",4675,"199.246.162.3",25,6,372,6,372,0,0,5236.046401,9.263895000000048,321.2471643946725,0
"147.32.84.165",4409,"212.117.174.7",4506,6,372,6,372,0,0,5244.458096,9.013372999999774,330.17606172518043,0
"147.32.84.165",4418,"61.167.116.133",6667,17,1892,12,1334,5,558,5244.659262,5.263299000000188,2027.6256393565363,848.1372614399904
"147.32.84.165",4676,"209.85.225.27",25,6,372,6,372,0,0,5244.95939,9.012633999999707,330.2031348438311,0
"147.32.84.165",4677,"64.12.90.65",25,6,372,6,372,0,0,5245.117104,8.955474999999751,332.31068145465014,0
"147.32.84.165",4679,"180.222.96.138",25,6,372,6,372,0,0,5245.860304,9.012634000000617,330.2031348437978,0
"147.32.84.165",4452,"81.211.26.66",25,6,372,6,372,0,0,5247.262131,9.013011999999435,330.18928633404533,0
"147.32.84.165",4680,"65.54.188.72",25,6,372,6,372,0,0,5248.964638,9.013322999999218,330.17789332527616,0
"147.32.84.165",4671,"118.86.12.94",6667,2,124,2,124,0,0,5254.974118,4.999999873689376e-06,0,0
"147.32.84.165",4678,"212.117.174.7",4506,6,372,6,372,0,0,5255.374134,9.012552000000142,330.2061391712307,0
"147.32.84.165",4460,"62.231.15.143",25,6,372,6,372,0,0,5255.374266,9.012513000000581,330.20756807782783,0
"147.32.84.165",1137,"174.133.57.141",80,16,3429,12,1428,4,2001,5256.675606,0.4787670000005164,23861.29369816148,33435.88843839014
"147.32.84.165",4681,"64.12.139.193",25,6,372,6,372,0,0,5256.67571,9.013475999999173,330.1722886930939,0
"147.32.84.165",1179,"31.192.109.167",80,15,1540,10,1050,5,490,5257.078286,0.26646600000003673,31523.721600500034,14711.070080233349
"147.32.84.165",4461,"94.245.160.209",25,6,372,6,372,0,0,5257.161368,8.92795500000011,333.3350134493244,0
"147.32.84.165",4682,"205.188.103.1",25,6,372,6,372,0,0,5265.488272,9.01319500000045,330.18258231402416,0
"147.32.84.165",1193,"210.212.249.136",6667,2,124,2,124,0,0,5265.989415,9.000000318337698e-06,0,0
"147.32.84.165",4462,"91.206.222.71",25,6,372,6,372,0,0,5266.089457,9.013277000000016,330.1795784152639,0
"147.32.84.165",4683,"209.85.225.27",25,6,372,6,372,0,0,5266.890429,9.01329799999985,330.1788091329111,0
"147.32.84.165",4475,"95.163.16.202",25,6,372,6,372,0,0,5268.192799,9.014976999999817,330.11731477518583,0
"147.32.84.165",1221,"174.133.57.141",80,16,3429,12,1428,4,2001,5268.29241,0.48382000000037806,23612.08713982695,33086.68513080793
"147.32.84.165",4685,"64.12.90.65",25,6,372,6,372,0,0,5268.29254,9.013395999999375,330.1752191959841,0
"147.32.84.165",1224,"41.240.106.5",6667,4,248,4,248,0,0,5269.996791,3.002422000000479,660.7998475896072,0
"147.32.84.165",4486,"178.162.163.199",25,6,372,6,372,0,0,5276.404988,9.014129999999568,330.14833378264376,0
"147.32.84.165",4686,"65.55.92.168",25,6,372,6,372,0,0,5277.706562,9.012956999999915,330.19130125662736,0
"147.32.84.165",1228,"212.117.174.7",4506,6,372,6,372,0,0,5278.106922,9.01260000000002,330.2043805339184,0
"147.32.84.165",4498,"93.170.48.61",25,6,372,6,372,0,0,5278.407419,9.012549999999464,330.20621244821683,0
"147.32.84.165",1246,"174.133.57.141",80,17,3489,12,1428,5,2061,5286.519098,11.237009999999827,1016.6405476189997,1467.2942357442284
"147.32.84.165",4687,"165.212.8.32",25,6,372,6,372,0,0,5286.51917,9.01256900000044,330.20551631836105,0
"147.32.84.165",1248,"114.58.187.40",6667,6,372,6,372,0,0,5287.119667,9.013270000000375,330.1798348435003,0
"147.32.84.165",1258,"212.117.174.7",4506,6,372,6,372,0,0,5287.920601,9.01479400000062,330.124016144994,0
"147.32.84.165",1253,"67.195.168.31",25,6,372,6,372,0,0,5287.920749,9.014769999999771,330.1248950333814,0
"147.32.84.165",4500,"78.24.218.162",25,6,372,6,372,0,0,5288.020724,9.014646999999968,330.12939940965083,0
"147.32.84.165",4689,"209.85.225.27",25,6,372,6,372,0,0,5289.222536,8.91281600000002,333.90120473708794,0
"147.32.84.165",4504,"193.104.248.2",25,6,372,6,372,0,0,5289.322794,8.91327100000035,333.8841599228704,0
"147.32.84.165",4690,"67.231.144.94",25,6,372,6,372,0,0,5297.334147,9.01358700000037,330.1682227064406,0
"147.32.84.165",1337,"61.89.186.155",6667,9,552,6,372,3,180,5298.636001,1.91370999999981,1555.0945545564873,752.4651070434617
"147.32.84.165",1433,"173.192.170.88",80,35,5666,22,1766,13,3900,5299.036748,40.32949499999995,350.31432950003506,773.6273414779937
"147.32.84.165",4517,"74.54.79.106",25,6,372,6,372,0,0,5299.237917,9.012343999999757,330.2137601494218,0
"147.32.84.165",4691,"205.188.190.1",25,6,372,6,372,0,0,5299.337683,9.012671999999839,330.2017426130734,0
"147.32.84.165",1454,"117.204.73.246",6667,9,552,6,372,3,180,5300.549946,2.2000660000003336,1352.6866921263038,654.5258187707922
"147.32.84.165",4531,"178.162.190.126",25,6,372,6,372,0,0,5302.750416,9.004501999999775,330.50134255065683,0
"147.32.84.165",4695,"32.97.182.141",25,6,372,6,372,0,0,5307.449121,9.012580000000526,330.205113297172,0
"147.32.84.165",1470,"212.117.174.7",4506,6,372,6,372,0,0,5308.049583,9.013009000000238,330.1893962382509,0
"147.32.84.165",1486,"61.17.216.4",6667,15,1704,10,1146,5,558,5308.851371,1.1492189999999027,7977.591738389964,3884.3771291637
"147.32.84.165",1518,"65.54.188.72",25,6,372,6,372,0,0,5308.950781,9.0136820000007,330.16474288750914,0
"147.32.84.165",4532,"178.63.49.46",25,6,372,6,372,0,0,5309.049739,8.91486199999963,333.82457294348734,0
"147.32.84.165",1504,"174.133.57.141",80,16,3429,12,1428,4,2001,5310.15256,0.47933199999988574,23833.167825229117,33396.47676350382
"147.32.84.165",4701,"205.188.190.1",25,6,372,6,372,0,0,5310.152692,9.013813000000482,330.1599445206863,0
"147.32.84.165",4541,"72.14.213.27",25,6,372,6,372,0,0,5310.152753,9.013820000000123,330.15968812334387,0
"147.32.84.165",4702,"216.32.181.178",25,6,372,6,372,0,0,5310.252727,9.012931000000208,330.1922537740421,0
"147.32.84.165",1606,"113.36.206.49",6667,2,124,2,124,0,0,5318.364323,1.0000000656873453e-05,0,0
"147.32.84.165",1617,"212.117.174.7",4506,6,372,6,372,0,0,5320.266995,9.0133679999999,330.1762448842689,0
"147.32.84.165",4547,"74.125.39.27",25,6,372,6,372,0,0,5320.267074,9.013382999999521,330.1756954076131,0
"147.32.84.165",1632,"208.73.210.29",80,72,38935,44,6634,28,32301,5320.367508,14.501044999999976,3659.8741676893,17819.95711343565
"147.32.84.165",1672,"174.133.57.141",80,17,3489,12,1428,5,2061,5320.560443,3.582329999999274,3188.9859393194693,4602.591051076629
"147.32.84.165",4703,"212.184.64.202",25,6,372,6,372,0,0,5320.714354,8.966656999999941,331.89626858705753,0
"147.32.84.165",1697,"41.223.57.76",6667,4,248,4,248,0,0,5323.772332,3.0043350000005375,660.3790855545886,0
"147.32.84.165",4548,"74.125.127.27",25,6,372,6,372,0,0,5328.479535,9.012371999999232,330.2127342280427,0
"147.32.84.165",1689,"74.125.232.217",80,13,2936,10,2062,3,874,5329.081654,5.78701700000056,2850.518669635566,1208.2217833469858
"147.32.84.165",4705,"209.85.225.27",25,6,372,6,372,0,0,5329.089938,9.003098999999565,330.5528463032722,0
"147.32.84.165",4553,"74.125.157.27",25,6,372,6,372,0,0,5329.983276,9.011169999999765,330.25678130587676,0
"147.32.84.165",1756,"67.214.158.5",80,15,2567,10,1712,5,855,5329.983417,0.31613799999922776,43322.85267836659,21636.120934581442
"147.32.84.165",4706,"89.108.129.67",25,6,372,6,372,0,0,5330.087022,9.007321000000047,330.39790632530855,0
"147.32.84.165",4558,"209.85.229.27",25,6,372,6,372,0,0,5331.182972,9.013416000000689,330.1744865653347,0
"147.32.84.165",1761,"50.22.198.84",80,13,3349,10,2320,3,1029,5331.283063,0.3792300000004616,48941.27574289325,21707.14342217119
"147.32.84.165",4708,"205.188.103.1",25,6,372,6,372,0,0,5331.283206,9.012880999999652,330.1940855537885,0
"147.32.84.165",4559,"188.64.112.2",25,6,372,6,372,0,0,5331.403962,8.992322999999487,330.9489661347985,0
"147.32.84.165",1828,"174.133.57.141",80,17,3489,12,1428,5,2061,5341.297478,6.020019999999931,1897.6681140594433,2738.8613326866334
"147.32.84.165",4710,"77.238.184.241",25,6,372,6,372,0,0,5341.452591,8.958326999999372,332.2048860239427,0
"147.32.84.165",1843,"212.117.174.7",4506,6,372,6,372,0,0,5341.49764,9.013413000000583,330.1745964597215,0
"147.32.84.165",1810,"93.123.109.154",6667,9,552,6,372,3,180,5341.697912,1.0927040000005945,2723.518903562521,1317.831727530252
"147.32.84.165",1885,"173.192.170.88",80,21,3571,14,1204,7,2367,5342.790899,45.67081600000074,210.9005453285495,414.6192614557115
"147.32.84.165",4560,"188.64.112.5",25,6,372,6,372,0,0,5342.991752,8.923217000000477,333.5120058158219,0
"147.32.84.165",4711,"209.85.225.27",25,6,372,6,372,0,0,5349.50966,9.012432000000445,330.2105358464678,0
"147.32.84.165",1907,"115.240.199.38",6667,2,124,2,124,0,0,5349.509763,3.000000106112566e-06,0,0
"147.32.84.165",1934,"212.117.174.7",4506,6,372,6,372,0,0,5350.110762,9.012476999999308,330.20888707957073,0
"147.32.84.165",1920,"74.125.127.27",25,6,372,6,372,0,0,5350.110868,9.012463000000025,330.2094000274943,0
"147.32.84.165",4563,"62.118.120.61",25,6,372,6,372,0,0,5351.011873,9.012305999999626,330.21515248152065,0
"147.32.84.165",4712,"64.12.90.1",25,6,372,6,372,0,0,5351.111469,9.012982999999622,330.19034874470805,0
"147.32.84.165",4564,"195.128.50.36",25,6,372,6,372,0,0,5352.213082,9.013586999999461,330.1682227064739,0
"147.32.84.165",4713,"75.180.132.243",25,6,372,6,372,0,0,5352.313583,9.013025000000198,330.18881008317794,0
"147.32.84.165",4573,"89.208.153.2",25,6,372,6,372,0,0,5352.413643,9.012964999999895,330.19100817544887,0
"147.32.84.165",2026,"174.133.57.141",80,16,3429,12,1428,4,2001,5361.326474,0.48397899999963556,23604.329939953186,33075.81527300162
"147.32.84.165",4714,"80.12.242.142",25,6,372,6,372,0,0,5361.486864,8.854730000000018,336.0915578453543,0
"147.32.84.165",2004,"27.251.19.95",6667,6,372,6,372,0,0,5362.427813,8.91573100000005,333.792035672676,0
"147.32.84.165",4576,"81.3.168.250",25,6,372,6,372,0,0,5362.527905,9.016362999999728,330.06656897022555,0
"147.32.84.165",2060,"98.126.71.122",80,19,4917,14,1430,5,3487,5363.930338,19.53748600000017,585.5410465809111,1427.819321278068
"147.32.84.165",4715,"209.85.225.27",25,6,372,6,372,0,0,5364.105091,8.843751999999768,336.50875782134983,0
"147.32.84.165",2105,"212.117.174.7",4506,6,372,6,372,0,0,5371.043267,9.028048000000126,329.63936390235835,0
"147.32.84.165",2051,"117.196.25.55",6667,6,372,6,372,0,0,5371.945964,9.028644000000895,329.61760370657043,0
"147.32.84.165",2132,"64.12.90.1",25,6,372,6,372,0,0,5372.046178,9.028945000000022,329.6066151693241,0
"147.32.84.165",4589,"81.9.80.10",25,6,372,6,372,0,0,5373.149886,9.02864799999952,329.61745767474355,0
"147.32.84.165",2062,"95.100.248.96",80,17,5761,12,2556,5,3205,5373.24963,10.553844999999455,1937.4929231953904,2429.4463297500884
"147.32.84.165",2148,"174.133.57.141",80,16,3429,12,1428,4,2001,5373.25033,0.5120349999997416,22310.974835715853,31263.487847526205
"147.32.84.165",4716,"207.115.36.22",25,6,372,6,372,0,0,5373.350314,9.028749000000062,329.6137704127094,0
"147.32.84.165",2156,"190.107.110.169",6667,4,248,4,248,0,0,5373.41996,2.940372000000025,674.7445561309872,0
"147.32.84.165",2176,"212.117.174.7",4506,6,372,6,372,0,0,5382.379195,9.02458200000001,329.76596589182714,0
"147.32.84.165",2178,"91.218.38.36",25,6,372,6,372,0,0,5382.379254,9.024658999999701,329.7631522698086,0
"147.32.84.165",4591,"78.110.50.88",25,6,372,6,372,0,0,5383.382262,9.022452999999587,329.8437797348611,0
"147.32.84.165",4717,"98.137.54.238",25,6,372,6,372,0,0,5383.583168,9.021700999999666,329.87127372101,0
"147.32.84.165",2275,"31.192.109.167",80,15,1540,10,1050,5,490,5384.993978,0.27309599999989587,30758.41462344085,14353.926824272397
"147.32.84.165",2609,"60.243.195.59",6667,4,248,4,248,0,0,5385.085629,2.9126049999995303,681.1771592784878,0
"147.32.84.165",2180,"85.233.144.10",25,6,372,6,372,0,0,5390.502487,9.01225599999998,330.21698451530966,0
"147.32.84.165",2787,"173.192.170.88",80,21,3571,14,1206,7,2365,5392.10424,36.07362900000044,267.4529917685821,524.4828569922857
"147.32.84.165",4592,"69.50.196.9",25,6,372,6,372,0,0,5392.305176,9.012432000000445,330.2105358464678,0
"147.32.84.165",2683,"174.133.57.141",80,16,3429,12,1428,4,2001,5393.00561,0.5038880000001882,22671.7048232856,31768.964531788853
"147.32.84.165",4718,"205.188.190.1",25,6,372,6,372,0,0,5393.105601,9.013144999999895,330.18441398646473,0
"147.32.84.165",2815,"178.125.172.9",6667,9,552,6,372,3,180,5393.172258,1.1073790000000372,2687.42679787128,1300.367805421587
"147.32.84.165",2181,"88.212.221.10",25,6,372,6,372,0,0,5394.207285,9.013254999999845,330.1803843339672,0
"147.32.84.165",4597,"81.211.26.66",25,6,372,6,372,0,0,5394.279856,8.940808000000288,332.8558224267766,0
"147.32.84.165",4719,"208.65.144.13",25,6,372,6,372,0,0,5394.407577,9.012953999999809,330.19141116220754,0
"147.32.84.165",2839,"212.117.174.7",4506,6,372,6,372,0,0,5401.317469,9.012927000000673,330.1924003156553,0
"147.32.84.165",2847,"78.153.48.99",6667,2,124,2,124,0,0,5403.42064,3.99999953515362e-06,0,0
"147.32.84.165",2182,"74.52.75.130",25,6,372,6,372,0,0,5404.422107,8.912825999999768,333.9008301070926,0
"147.32.84.165",4602,"88.198.234.174",25,6,372,6,372,0,0,5404.622074,8.913004,333.89416183365336,0
"147.32.84.165",2855,"174.133.57.141",80,17,2011,12,1428,5,583,5411.532191,110.58712699999978,103.30316294409224,42.174890753785554
"147.32.84.165",4720,"77.238.184.241",25,6,372,6,372,0,0,5411.687,8.858071999999993,335.9647562133162,0
"147.32.84.165",2851,"173.192.170.88",80,16,2023,12,1494,4,529,5413.23469,10.044159000000036,1189.9453204593792,421.3394073112527
"147.32.84.165",2891,"79.132.91.208",6667,2,124,2,124,0,0,5413.234825,5.000000783184078e-06,0,0
"147.32.84.165",2898,"212.117.174.7",4506,6,372,6,372,0,0,5414.035714,9.0174190000007,330.02791597016494,0
"147.32.84.165",2183,"64.202.126.109",25,6,372,6,372,0,0,5414.035849,9.017375000000357,330.0295263310977,0
"147.32.84.165",4604,"178.162.163.199",25,6,372,6,372,0,0,5415.137719,9.032988999999361,329.4590528118888,0
"147.32.84.165",4721,"67.231.152.47",25,6,372,6,372,0,0,5415.137858,9.032975999999508,329.4595269599036,0
"147.32.84.165",2901,"174.36.246.56",80,27,14117,22,2068,5,12049,5415.3378,0.41341299999930925,40018.09328692529,233161.51161226438
"147.32.84.165",2185,"195.19.204.76",25,6,372,6,372,0,0,5415.459064,9.012048000000505,330.2246059940907,0
"147.32.84.165",4606,"93.170.48.61",25,6,372,6,372,0,0,5415.729757,9.04173400000036,329.1404060327235,0
"147.32.84.165",4722,"74.6.136.65",25,6,372,6,372,0,0,5422.250284,9.031262000000424,329.52205350701377,0
"147.32.84.165",2949,"210.75.13.174",6667,6,372,6,372,0,0,5424.370891,9.013005000000703,330.18954277732763,0
"147.32.84.165",2189,"92.53.104.16",25,6,372,6,372,0,0,5425.374263,9.011250999999902,330.2538127059198,0
"147.32.84.165",4608,"195.16.88.67",25,6,372,6,372,0,0,5425.572988,9.012926999999763,330.1924003156886,0
"147.32.84.165",4723,"66.94.237.64",25,6,372,6,372,0,0,5432.582732,9.013160999999855,330.18382784908067,0
"147.32.84.165",2965,"212.117.174.7",4506,6,372,6,372,0,0,5435.086504,9.013308999999936,330.1784061769125,0
"147.32.84.165",2966,"118.34.142.43",6667,6,372,6,372,0,0,5436.188498,9.012823999999455,330.1961738074748,0
"147.32.84.165",2198,"213.171.1.198",25,6,372,6,372,0,0,5436.188637,9.012810999999601,330.1966500795514,0
"147.32.84.165",2968,"173.192.170.88",80,17,1643,12,1086,5,557,5436.488841,53.157186999999794,163.43979977721608,83.82685863343403
"147.32.84.165",4611,"193.104.248.2",25,6,372,6,372,0,0,5436.690068,9.011664999999994,330.2386406951437,0
"147.32.84.165",4724,"209.85.225.27",25,6,372,6,372,0,0,5436.788794,9.013073999999506,330.1870149962336,0
"147.32.84.165",3003,"190.114.77.46",6667,2,124,2,124,0,0,5443.298659,9.000000318337698e-06,0,0
"147.32.84.165",3118,"212.117.174.7",4506,6,372,6,372,0,0,5445.401549,9.012778999999682,330.1978224474499,0
"147.32.84.165",2204,"212.192.128.3",25,6,372,6,372,0,0,5445.401683,9.01278100000036,330.1977491741873,0
"147.32.84.165",4620,"88.198.12.76",25,6,372,6,372,0,0,5446.402651,9.012971000000107,330.1907883648982,0
"147.32.84.165",3144,"174.133.57.141",80,17,3489,12,1428,5,2061,5446.602875,9.81949700000041,1163.3997138549482,1679.1084105427508
"147.32.84.165",4725,"205.188.146.193",25,6,372,6,372,0,0,5446.603015,9.01287500000035,330.19430536869584,0
"147.32.84.165",3154,"94.137.182.140",6667,2,124,2,124,0,0,5453.613356,9.000000318337698e-06,0,0
"147.32.84.165",2206,"95.169.189.196",25,6,372,6,372,0,0,5456.116531,9.0131879999999,330.18283874695976,0
"147.32.84.165",4621,"178.63.49.46",25,6,372,6,372,0,0,5456.216648,9.013126000000739,330.185110027282,0
"147.32.84.165",4726,"209.85.225.27",25,6,372,6,372,0,0,5457.218148,9.012944000000061,330.1917775146478,0
"147.32.84.165",2207,"81.26.143.243",25,6,372,6,372,0,0,5457.218218,9.013017000000218,330.18910316045424,0
"147.32.84.165",4622,"74.125.39.27",25,6,372,6,372,0,0,5457.218256,9.013047999999799,330.187967488919,0
"147.32.84.165",4727,"207.115.36.22",25,6,372,6,372,0,0,5457.718795,9.013214999999946,330.1818496507648,0
"147.32.84.165",3217,"117.207.5.248",6667,9,552,6,372,3,180,5457.821525,1.398033999999825,2128.7035937612195,1030.017867948977
"147.32.84.165",2216,"62.183.66.246",25,6,372,6,372,0,0,5459.219838,8.913988999999674,333.85726637088163,0
"147.32.84.165",4637,"74.125.43.27",25,6,372,6,372,0,0,5465.831091,8.91428199999973,333.846292948786,0
"147.32.84.165",3304,"174.133.57.141",80,16,3429,12,1428,4,2001,5466.431972,0.49024499999995896,23302.63439708912,32653.06122449253
"147.32.84.165",3290,"173.192.170.88",80,16,2030,12,1502,4,528,5466.432144,11.741313999999875,1023.3948261668266,359.7553050706288
"147.32.84.165",4728,"209.85.225.27",25,6,372,6,372,0,0,5466.432222,8.912209999999504,333.92390888457135,0
"147.32.84.165",3268,"212.117.174.7",4506,6,372,6,372,0,0,5467.433063,8.913077999999587,333.89138970848654,0
"147.32.84.165",3281,"111.88.77.58",6667,2,124,2,124,0,0,5467.633309,1.1000000085914508e-05,0,0
"147.32.84.165",3341,"212.117.174.7",4506,6,372,6,372,0,0,5477.046639,9.013304999999491,330.1785527062679,0
"147.32.84.165",2220,"195.225.38.43",25,6,372,6,372,0,0,5477.046772,9.0133050000004,330.1785527062346,0
"147.32.84.165",4641,"85.214.220.206",25,6,372,6,372,0,0,5477.148559,9.011626999999862,330.2400332370665,0
"147.32.84.165",3403,"174.133.57.141",80,16,3429,12,1428,4,2001,5478.148227,0.5105800000001182,22374.554428292053,31352.579419476468
"147.32.84.165",3318,"68.67.185.209",80,13,2276,10,1304,3,972,5478.148333,6.499687999999878,1605.0001169287195,1196.3651178333707
"147.32.84.165",4729,"64.12.139.193",25,6,372,6,372,0,0,5478.148382,9.012838999999985,330.1956242644526,0
"147.32.84.165",3352,"111.88.79.41",6667,2,124,2,124,0,0,5478.173044,1.2999999853491317e-05,0,0
"147.32.84.165",2230,"217.151.130.35",25,6,372,6,372,0,0,5478.649126,9.01357199999984,330.16877215825787,0
"147.32.84.165",4642,"109.70.26.36",25,6,372,6,372,0,0,5480.052599,9.01136200000019,330.24974471116985,0
"147.32.84.165",3435,"68.67.179.213",80,13,2502,10,1680,3,822,5480.852323,3.7958019999996395,3540.753706331699,1732.4402063122957
"147.32.84.165",4731,"200.40.13.162",25,6,372,6,372,0,0,5480.876381,8.988725000000159,331.08143813499106,0
"147.32.84.165",3461,"117.204.64.132",6667,2,124,2,124,0,0,5486.760704,8.999999408842996e-06,0,0
"147.32.84.165",2235,"89.108.79.57",25,6,372,6,372,0,0,5487.361777,9.012778999999682,330.1978224474499,0
"147.32.84.165",4643,"109.70.26.36",25,6,372,6,372,0,0,5488.363047,9.01291399999991,330.19287657687954,0
"147.32.84.165",4732,"93.17.128.86",25,6,372,6,372,0,0,5488.363184,9.012900000000627,330.19338947506276,0
"147.32.84.165",2243,"88.212.221.10",25,6,372,6,372,0,0,5491.066845,9.01299999999992,330.18972595140644,0
"147.32.84.165",3477,"173.192.170.88",80,11,1283,8,846,3,437,5498.076945,16.69077500000003,405.49345371919446,209.45702041996213
"147.32.84.165",4655,"86.111.9.178",25,6,372,6,372,0,0,5498.177065,9.01532700000007,330.1044987053688,0
"147.32.84.165",3475,"174.133.57.141",80,17,3489,12,1428,5,2061,5498.277951,1.2326990000001388,9267.469187529732,13375.528008052366
"147.32.84.165",4733,"65.55.88.22",25,6,372,6,372,0,0,5498.278026,9.014557000000423,330.1326953725913,0
"147.32.84.165",3490,"212.117.174.7",4506,6,372,6,372,0,0,5499.178933,9.013141999999789,330.1845238874601,0
"147.32.84.165",3488,"116.90.164.27",6667,6,372,6,372,0,0,5499.679311,9.012979000000087,330.19049528463023,0
"147.32.84.165",2246,"209.85.229.27",25,6,372,6,372,0,0,5500.68248,9.011120999999548,330.25857715151636,0
"147.32.84.165",4663,"67.228.59.198",25,6,372,6,372,0,0,5501.081363,9.014726999999766,330.12646972005666,0
"147.32.84.165",4734,"74.6.136.65",25,6,372,6,372,0,0,5501.882431,9.013159000000087,330.18390111613155,0
"147.32.84.165",3526,"31.192.109.167",80,15,1540,10,1050,5,490,5508.392376,0.24896300000000338,33739.953326397444,15745.311552318806
"147.32.84.165",3519,"202.80.173.5",6667,2,124,2,124,0,0,5508.473702,8.999999408842996e-06,0,0
"147.32.84.165",3524,"212.117.174.7",4506,6,372,6,372,0,0,5509.393215,9.012869000000137,330.1945251839292,0
"147.32.84.165",2258,"92.53.104.16",25,6,372,6,372,0,0,5509.393348,9.01280399999996,330.1969065343053,0
"147.32.84.165",4665,"67.228.59.198",25,6,372,6,372,0,0,5512.097081,9.013050999999905,330.18785758563126,0
"147.32.84.165",3539,"174.133.57.141",80,16,3429,12,1428,4,2001,5512.097218,0.49593499999991764,23035.276800390973,32278.423583741132
"147.32.84.165",4735,"64.12.90.34",25,6,372,6,372,0,0,5512.097289,9.012894999999844,330.19357265340955,0
"147.32.84.165",3527,"212.117.171.138",65500,24,1471,18,1092,6,379,5519.207341,107.87863299999935,80.9798915416369,28.105658328095593
"147.32.84.165",2269,"74.125.43.27",25,6,372,6,372,0,0,5519.207451,9.012815000000046,330.1965035341328,0
"147.32.84.165",4666,"64.191.120.172",25,6,372,6,372,0,0,5519.307654,9.01271799999995,330.2000572968129,0
"147.32.84.165",4736,"64.26.60.153",25,6,372,6,372,0,0,5520.209378,9.012282000000596,330.2160318551731,0
"147.32.84.165",3547,"93.180.203.85",6667,6,372,6,372,0,0,5520.709433,9.013482000000295,330.1720689074325,0
"147.32.84.165",2272,"195.19.204.76",25,6,372,6,372,0,0,5521.109988,9.01323499999944,330.1811169907569,0
"147.32.84.165",4694,"89.145.85.120",25,6,372,6,372,0,0,5521.712242,9.011906000000636,330.22980932111255,0
"147.32.84.165",4737,"209.85.225.27",25,6,372,6,372,0,0,5522.112017,9.012546999999358,330.2063223637238,0
"147.32.84.165",3574,"178.95.10.210",6667,9,552,6,372,3,180,5522.912761,1.0941310000007434,2719.966804704353,1316.112970018235
"147.32.84.165",2282,"46.4.54.212",25,6,372,6,372,0,0,5524.007121,8.920211000000563,333.6243952076708,0
"147.32.84.165",4692,"89.145.85.120",25,6,372,6,372,0,0,5530.423582,8.912786999999298,333.9022911688829,0
"147.32.84.165",3575,"174.133.57.141",80,16,3429,12,1428,4,2001,5530.423715,0.48280400000021473,23661.775793064928,33156.31187809728
"147.32.84.165",4738,"207.69.189.218",25,6,372,6,372,0,0,5530.582215,8.854298999999628,336.10791774708815,0
"147.32.84.165",3582,"212.117.174.7",4506,6,372,6,372,0,0,5533.12747,8.91602199999943,333.7811414103947,0
"147.32.84.165",3583,"27.251.19.95",6667,6,372,6,372,0,0,5540.137385,9.013458999999784,330.1729114205846,0
"147.32.84.165",3603,"212.117.174.7",4506,6,372,6,372,0,0,5540.237523,9.013432000000648,330.17390046319605,0
"147.32.84.165",2286,"92.38.225.40",25,6,372,6,372,0,0,5540.237656,9.01346999999987,330.17250847898123,0
"147.32.84.165",4696,"188.40.117.142",25,6,372,6,372,0,0,5541.139227,9.012613000000783,330.2039042395076,0
"147.32.84.165",3615,"174.133.57.141",80,17,2011,12,1428,5,583,5541.639528,160.5712480000002,71.14598748089686,29.046296009357754
"147.32.84.165",4740,"209.85.225.27",25,6,372,6,372,0,0,5541.793861,8.961489999999685,332.0876327485836,0
"147.32.84.165",3606,"61.167.116.133",6667,15,1710,10,1152,5,558,5541.793923,1.9618719999998575,4697.554172749634,2275.377802425604
"147.32.84.165",2296,"74.125.39.27",25,6,372,6,372,0,0,5542.043628,9.009697999999844,330.3107384953471,0
"147.32.84.165",4697,"188.40.117.142",25,6,372,6,372,0,0,5542.248417,9.005278999999973,330.47282599462034,0
"147.32.84.165",4741,"193.252.22.92",25,6,372,6,372,0,0,5542.248485,9.00533600000017,330.4707342402264,0
"147.32.84.165",2297,"74.125.127.27",25,6,372,6,372,0,0,5542.641649,9.012893999999505,330.19360928910993,0
"147.32.84.165",4698,"87.118.92.232",25,6,372,6,372,0,0,5543.041595,9.013058000000456,330.18760114489993,0
"147.32.84.165",4742,"77.238.184.241",25,6,372,6,372,0,0,5544.847071,9.010344999999688,330.2870200863677,0
"147.32.84.165",3637,"117.96.96.152",6667,2,124,2,124,0,0,5551.453933,7.999999979801942e-06,0,0
"147.32.84.165",2311,"209.85.225.27",25,6,372,6,372,0,0,5554.05793,9.012542000000394,330.20650555635353,0
"147.32.84.165",4699,"64.191.120.172",25,6,372,6,372,0,0,5561.168157,9.013656000000083,330.165695251735,0
"147.32.84.165",4743,"209.85.229.27",25,6,372,6,372,0,0,5561.268073,9.01397199999974,330.15412073612896,0
"147.32.84.165",3673,"212.117.174.7",4506,6,372,6,372,0,0,5562.16918,9.013087999999698,330.18650211782017,0
"147.32.84.165",3666,"222.85.179.42",6667,2,124,2,124,0,0,5563.070609,6.999999641266186e-06,0,0
"147.32.84.165",2312,"72.14.213.27",25,6,372,6,372,0,0,5563.270826,9.012870999999905,330.19445191216334,0
"147.32.84.165",4700,"86.111.9.178",25,6,372,6,372,0,0,5563.671299,9.012940000000526,330.1919240558382,0
"147.32.84.165",4744,"74.6.136.65",25,6,372,6,372,0,0,5564.071975,9.012826000000132,330.1961005349439,0
"147.32.84.165",2324,"74.125.157.27",25,6,372,6,372,0,0,5564.973332,9.013116000000082,330.1854763657733,0
"147.32.84.165",4704,"95.163.15.194",25,6,372,6,372,0,0,5565.874357,9.012966000000233,330.1909715403257,0
"147.32.84.165",4745,"209.85.227.27",25,6,372,6,372,0,0,5575.087607,9.014878999999382,330.1209034530806,0
"147.32.84.165",3702,"83.99.172.192",6667,6,372,6,372,0,0,5575.188503,9.013656999999512,330.1656586222619,0
"147.32.84.165",3700,"212.117.174.7",4506,6,372,6,372,0,0,5582.198752,9.01253799999995,330.2066521106504,0
"147.32.84.165",2331,"89.111.176.226",25,6,372,6,372,0,0,5582.198901,9.012515000000349,330.20749480027325,0
"147.32.84.165",4709,"82.138.17.133",25,6,372,6,372,0,0,5582.298089,9.01329799999985,330.1788091329111,0
"147.32.84.165",3740,"174.133.57.141",80,17,3489,12,1428,5,2061,5583.199358,5.7866320000002816,1974.205375423812,2849.325825454115
"147.32.84.165",4746,"207.115.21.22",25,6,372,6,372,0,0,5583.199509,9.012700000000223,330.2007167663327,0
"147.32.84.165",3729,"83.152.81.217",6667,6,372,6,372,0,0,5584.302758,9.011269999999968,330.2531163753845,0
"147.32.84.165",2335,"188.40.60.12",25,6,372,6,372,0,0,5584.701604,9.012877000000117,330.19423209702757,0
"147.32.84.165",4730,"85.214.220.206",25,6,372,6,372,0,0,5585.102184,9.012775999999576,330.19793235737137,0
"147.32.84.165",4748,"216.99.131.20",25,6,372,6,372,0,0,5586.003392,9.012854999999945,330.1950380872674,0
"147.32.84.165",2348,"188.40.60.12",25,6,372,6,372,0,0,5586.904638,9.013046000000031,330.188040757807,0
"147.32.84.165",4739,"94.245.160.209",25,6,372,6,372,0,0,5586.904771,9.013008999999329,330.1893962382842,0
"147.32.84.165",4749,"205.188.190.1",25,6,372,6,372,0,0,5596.11793,9.013035999999374,330.1884071028016,0
"147.32.84.165",3779,"212.117.174.7",4506,6,372,6,372,0,0,5596.218585,9.012692000000243,330.20100986474625,0
"147.32.84.165",3756,"212.117.171.138",65500,24,1475,18,1092,6,383,5603.228574,126.13166300000012,69.2609594785093,24.292076447132843
"147.32.84.165",3804,"173.192.170.88",80,23,5772,16,1406,7,4366,5603.228689,37.1641980000004,302.6568742314816,939.8292410346007
"147.32.84.165",2349,"188.40.54.222",25,6,372,6,372,0,0,5603.328318,8.912664999999834,333.90686175235527,0
"147.32.84.165",4747,"195.9.14.110",25,6,372,6,372,0,0,5603.429441,8.912201000000096,333.9242460981264,0
"147.32.84.165",3805,"174.133.57.141",80,16,3429,12,1428,4,2001,5604.229993,0.5369730000002164,21274.812700071318,29811.554770898256
"147.32.84.165",4750,"209.85.225.27",25,6,372,6,372,0,0,5604.230129,8.912708000000748,333.90525079467994,0
"147.32.84.165",3766,"82.206.239.241",6667,6,372,6,372,0,0,5605.331548,8.91244000000006,333.9152914353398,0
"147.32.84.165",2358,"188.40.54.222",25,6,372,6,372,0,0,5605.732266,8.912225000000035,333.9233468634363,0
"147.32.84.165",4751,"195.9.14.110",25,6,372,6,372,0,0,5605.732398,8.912218999999823,333.9235716716633,0
"147.32.84.165",4754,"64.12.139.193",25,6,372,6,372,0,0,5605.732463,8.912202999999863,333.9241711617257,0
"147.32.84.165",3775,"65.55.37.88",25,6,372,6,372,0,0,5606.132209,8.913332999999511,333.8818374675515,0
"147.32.84.165",2361,"94.229.67.92",25,6,372,6,372,0,0,5607.034464,8.912357999999585,333.9183636923178,0
"147.32.84.165",4752,"88.198.234.174",25,6,372,6,372,0,0,5607.835142,9.012510999999904,330.2076413554482,0
"147.32.84.165",3864,"174.133.57.141",80,17,3489,12,1428,5,2061,5617.04818,3.703081999999995,3084.997847738726,4452.507397891816
"147.32.84.165",3866,"208.73.210.29",80,72,39293,44,6650,28,32643,5617.048291,17.87894099999994,2975.567736366498,14606.234228302497
"147.32.84.165",4755,"209.85.225.27",25,6,372,6,372,0,0,5617.148319,9.012985000000299,330.1902754747624,0
"147.32.84.165",3796,"178.122.22.89",6667,6,372,6,372,0,0,5617.148451,9.012990999999602,330.19005566522054,0
"147.32.84.165",3850,"212.117.174.7",4506,6,372,6,372,0,0,5617.227913,8.93359000000055,333.12475723643206,0
"147.32.84.165",2376,"77.246.107.36",25,6,372,6,372,0,0,5624.259019,9.012225999999828,330.218083745354,0
"147.32.84.165",4753,"91.206.222.72",25,6,372,6,372,0,0,5624.358994,9.013508000000002,330.17111650647,0
"147.32.84.165",3873,"74.125.232.218",80,13,2936,10,2062,3,874,5625.159726,9.767724000000271,1688.8274074901728,715.8269418750782
"147.32.84.165",4756,"209.85.225.27",25,6,372,6,372,0,0,5625.167889,9.00508499999978,330.47994549746863,0
"147.32.84.165",3885,"212.117.174.7",4506,6,372,6,372,0,0,5626.261555,9.012676000000283,330.20159606313445,0
"147.32.84.165",3836,"178.137.128.94",6667,6,372,6,372,0,0,5626.26169,9.012666999999965,330.201925800655,0
"147.32.84.165",2377,"89.111.176.149",25,6,372,6,372,0,0,5626.661979,9.01270199999999,330.2006434918189,0
"147.32.84.165",4758,"64.120.170.149",25,6,372,6,372,0,0,5627.062687,9.01307799999995,330.1868684593672,0
"147.32.84.165",3891,"67.214.158.5",80,15,2567,10,1712,5,855,5627.964904,0.316103999999541,43327.51246431519,21638.44810571816
"147.32.84.165",4757,"203.188.197.119",25,6,372,6,372,0,0,5628.06846,9.008409999999458,330.35796550114605,0
"147.32.84.165",3907,"31.192.109.167",80,15,1540,10,1050,5,490,5628.864904,0.25198399999953836,33335.44986989408,15556.543272617237
"147.32.84.165",3870,"119.154.75.69",6667,6,372,6,372,0,0,5628.94667,8.931540999999925,333.20117995315985,0
"147.32.84.165",2390,"194.85.88.229",25,6,372,6,372,0,0,5638.178747,9.012752999999975,330.19877500248907,0
"147.32.84.165",4759,"77.222.41.36",25,6,372,6,372,0,0,5638.178821,9.012804999999389,330.19686989790654,0
"147.32.84.165",3912,"174.133.57.141",80,16,3429,12,1428,4,2001,5645.289178,0.4994640000004438,22872.519340712945,32050.35798373011
"147.32.84.165",4761,"209.85.225.27",25,6,372,6,372,0,0,5645.289311,9.012437999999747,330.2103160099502,0
"147.32.84.165",3899,"95.58.159.249",6667,6,372,6,372,0,0,5645.289369,9.012475999999879,330.20892371863624,0
"147.32.84.165",3937,"173.192.170.88",80,17,1641,12,1084,5,557,5645.38876,83.69957599999998,103.6086491047458,53.238023571350006
"147.32.84.165",3943,"212.117.174.7",4506,6,372,6,372,0,0,5645.589764,9.01216899999963,330.22017230259684,0
"147.32.84.165",2397,"89.111.176.149",25,6,372,6,372,0,0,5646.189857,9.015432999999575,330.10061746342524,0
"147.32.84.165",4760,"195.239.166.118",25,6,372,6,372,0,0,5646.189994,9.015434999999343,330.1005442333306,0
"147.32.84.165",4767,"168.95.5.16",25,6,372,6,372,0,0,5647.291594,9.012834000000112,330.19580744524563,0
"147.32.84.165",3930,"187.38.130.143",6667,6,372,6,372,0,0,5647.692168,9.012912000000142,330.19294984794624,0
"147.32.84.165",2400,"195.225.241.72",25,6,372,6,372,0,0,5648.092715,9.012978000000658,330.19053191961444,0
"147.32.84.165",4762,"195.16.88.67",25,6,372,6,372,0,0,5649.093984,9.013089000000036,330.18646548369685,0
"147.32.84.165",4769,"205.188.190.1",25,6,372,6,372,0,0,5649.895462,9.013252999999168,330.18045759952315,0
"147.32.84.165",3969,"212.117.174.7",4506,6,372,6,372,0,0,5659.208598,9.012915000000248,330.19283994134173,0
"147.32.84.165",3955,"178.121.31.113",6667,6,372,6,372,0,0,5659.208744,9.012895000000753,330.19357265337624,0
"147.32.84.165",2411,"85.17.228.47",25,6,372,6,372,0,0,5659.208866,9.01282700000047,330.1960638986907,0
"147.32.84.165",4763,"88.198.12.76",25,6,372,6,372,0,0,5666.319121,9.012653999999202,330.2024020893583,0
"147.32.84.165",3975,"174.133.57.141",80,17,3489,12,1428,5,2061,5666.619203,2.4585989999995945,4646.548705177983,6706.258320288392
"147.32.84.165",4770,"66.94.237.64",25,6,372,6,372,0,0,5666.619337,9.013479000000189,330.17217880020996,0
"147.32.84.165",3981,"80.72.108.202",6667,6,372,6,372,0,0,5667.220102,9.013299999999617,330.17873586812004,0
"147.32.84.165",2412,"77.246.107.36",25,6,372,6,372,0,0,5668.321619,8.91313799999989,333.8891420731999,0
"147.32.84.165",4764,"83.136.235.194",25,6,372,6,372,0,0,5668.725042,8.910197999999582,333.9993117998208,0
"147.32.84.165",4771,"209.85.225.27",25,6,372,6,372,0,0,5669.123461,8.912201000000096,333.9242460981264,0
"147.32.84.165",4006,"119.154.24.194",6667,9,552,6,372,3,180,5670.124248,1.663155999999617,1789.3691271297973,865.8237711918374
"147.32.84.165",2417,"94.229.67.92",25,6,372,6,372,0,0,5670.925424,8.913246000000072,333.8850964059531,0
"147.32.84.165",4765,"46.4.116.200",25,6,372,6,372,0,0,5671.787597,8.851925000000847,336.198058614337,0
"147.32.84.165",4043,"174.133.57.141",80,17,3489,12,1428,5,2061,5680.139101,3.6938200000004144,3092.7332679986353,4463.671754443409
"147.32.84.165",4772,"98.136.59.15",25,6,372,6,372,0,0,5680.139237,9.012389999999868,330.2120747104867,0
"147.32.84.165",4029,"58.252.109.242",6667,2,124,2,124,0,0,5680.139301,4.999999873689376e-06,0,0
"147.32.84.165",4021,"212.117.174.7",4506,6,372,6,372,0,0,5687.249355,9.012636000000384,330.2030615682108,0
"147.32.84.165",2420,"173.241.196.95",25,6,372,6,372,0,0,5687.549394,9.013171000000511,330.1834615142474,0
"147.32.84.165",4766,"74.125.43.27",25,6,372,6,372,0,0,5688.150267,9.01287400000001,330.19434200455885,0
"147.32.84.165",4773,"64.12.139.193",25,6,372,6,372,0,0,5689.25174,9.012923000000228,330.1925468574318,0
"147.32.84.165",4058,"212.117.174.7",4506,6,372,6,372,0,0,5689.652295,9.013565000000199,330.1690285697096,0
"147.32.84.165",4056,"92.112.3.72",6667,2,124,2,124,0,0,5689.652458,1.1000000085914508e-05,0,0
"147.32.84.165",2423,"173.241.196.95",25,6,372,6,372,0,0,5690.053184,9.012878999999884,330.19415882539175,0
"147.32.84.165",4768,"209.85.225.27",25,6,372,6,372,0,0,5690.053316,9.012869999999566,330.19448854805887,0
"147.32.84.165",4774,"66.94.237.64",25,6,372,6,372,0,0,5691.855542,9.013654999999744,330.16573188124954,0
"147.32.84.165",2427,"89.111.176.226",25,6,372,6,372,0,0,5692.657196,9.012555999999677,330.2059926174225,0
"147.32.84.165",4777,"62.213.75.149",25,6,372,6,372,0,0,5693.557899,9.013051999999334,330.1878209512405,0
"147.32.84.165",4084,"174.133.57.141",80,16,3429,12,1428,4,2001,5701.169197,0.49263599999994767,23189.53547853022,32494.58017684802
"147.32.84.165",4775,"209.85.225.27",25,6,372,6,372,0,0,5701.329071,8.947227999999996,332.61698483597394,0
"147.32.84.165",4080,"212.117.171.138",65500,11,666,8,484,3,182,5701.329166,306.0275069999998,12.652457414555231,4.757742250927794
"147.32.84.165",2428,"209.212.156.210",25,6,372,6,372,0,0,5701.32923,8.94719299999997,332.61828598086686,0
"147.32.84.165",4785,"92.53.96.75",25,6,372,6,372,0,0,5703.772702,9.012131999999838,330.22152804686544,0
"147.32.84.165",4776,"209.85.225.27",25,6,372,6,372,0,0,5708.279522,9.019498000000567,329.9518443265704,0
"147.32.84.165",4111,"98.126.71.122",80,15,4787,12,1414,3,3373,5708.279663,15.03955599999972,752.1498639986586,1794.2019033009021
"147.32.84.165",4086,"74.6.136.244",25,6,372,6,372,0,0,5708.454378,8.945639999999912,332.6760298871885,0
"147.32.84.165",2435,"209.212.156.210",25,6,372,6,372,0,0,5708.57969,9.0202790000003,329.923276209073,0
"147.32.84.165",4787,"69.50.196.9",25,6,372,6,372,0,0,5708.579825,9.02023199999985,329.9249952772888,0
"147.32.84.165",4778,"72.54.113.238",25,6,372,6,372,0,0,5709.172479,9.029352000000472,329.59175807963237,0
"147.32.84.165",4121,"195.113.232.88",80,18,6024,12,2764,6,3260,5710.276488,13.04296499999964,1695.3200441771185,1999.5453487761963
"147.32.84.165",4094,"89.200.164.105",6667,6,372,6,372,0,0,5710.277274,9.029177000000345,329.59814609901724,0
"147.32.84.165",2441,"89.108.122.90",25,6,372,6,372,0,0,5711.079049,9.02963600000021,329.58139176373567,0
"147.32.84.165",4788,"95.163.16.202",25,6,372,6,372,0,0,5712.885511,9.028450999999222,329.624649898444,0
"147.32.84.165",4134,"174.133.57.141",80,17,2011,12,1428,5,583,5713.687651,103.50598199999968,110.37043250311886,45.06019758355623
"147.32.84.165",4779,"64.12.139.193",25,6,372,6,372,0,0,5713.847116,8.969818999999916,331.7792700164884,0
"147.32.84.165",4128,"195.113.232.81",80,13,3379,10,1524,3,1855,5714.590965,8.728701000000001,1396.7714096289928,1700.1384283869959
"147.32.84.165",4113,"202.112.126.217",6667,9,552,6,372,3,180,5714.591802,1.6147639999999228,1842.9937749418134,891.7711814234581
"147.32.84.165",4137,"212.117.174.7",4506,6,372,6,372,0,0,5716.20676,9.024545000000217,329.76731790909446,0
"147.32.84.165",2451,"89.108.122.90",25,6,372,6,372,0,0,5722.315616,8.924705000000358,333.456399959425,0
"147.32.84.165",4791,"64.120.170.149",25,6,372,6,372,0,0,5722.315752,8.924626999999418,333.45931432206567,0
"147.32.84.165",4780,"64.98.36.4",25,6,372,6,372,0,0,5724.831351,8.912285000000338,333.9210987978826,0
"147.32.84.165",4155,"212.117.174.7",4506,6,372,6,372,0,0,5729.337144,9.012754999999743,330.1987017288371,0
"147.32.84.165",4154,"61.17.216.28",6667,6,372,6,372,0,0,5729.337294,9.012668000000303,330.20188916310906,0
"147.32.84.165",4196,"173.192.170.88",80,17,1643,12,1086,5,557,5729.537432,51.15448500000002,169.83848043822542,87.10868655993698
"147.32.84.165",2458,"85.233.128.67",25,6,372,6,372,0,0,5729.738436,9.013443000000734,330.17349751917857,0
"147.32.84.165",4796,"78.24.218.162",25,6,372,6,372,0,0,5730.138434,9.014571999999134,330.13214604090865,0
"147.32.84.165",4781,"62.209.51.127",25,6,372,6,372,0,0,5731.240412,9.012598000000253,330.2044538100908,0
"147.32.84.165",4187,"201.132.220.14",6667,6,372,6,372,0,0,5732.04155,9.012378000000353,330.21251438853136,0
"147.32.84.165",2461,"81.177.1.85",25,6,372,6,372,0,0,5733.8438,9.01270999999997,330.2003503940557,0
"147.32.84.165",4800,"74.54.79.106",25,6,372,6,372,0,0,5734.744969,9.01294499999949,330.19174087938717,0
"147.32.84.165",4782,"66.43.210.221",25,6,372,6,372,0,0,5737.149029,9.012442000000192,330.2101694524011,0
"147.32.84.165",4214,"82.103.123.207",6667,6,372,6,372,0,0,5743.257488,9.013042999999925,330.1881506612167,0
"147.32.84.165",4230,"212.117.174.7",4506,6,372,6,372,0,0,5745.761155,9.012995999999475,330.1898724908092,0
"147.32.84.165",2471,"209.85.229.27",25,6,372,6,372,0,0,5750.367327,9.013377000000219,330.17591519803597,0
"147.32.84.165",4805,"83.136.235.194",25,6,372,6,372,0,0,5750.768595,9.012203000000227,330.2189264933252,0
"147.32.84.165",4783,"64.12.90.65",25,6,372,6,372,0,0,5751.168907,9.01268600000003,330.20122968890627,0
"147.32.84.165",4254,"31.192.109.167",80,15,1540,10,1050,5,490,5752.270671,0.24665300000015122,34055.940937247266,15892.772437382058
"147.32.84.165",4243,"217.34.4.225",6667,7,426,6,364,1,62,5752.351779,0.08509500000036496,34220.577002027276,5828.779599246403
"147.32.84.165",2475,"74.125.43.27",25,6,372,6,372,0,0,5752.436579,8.946552999999767,332.64208013970045,0
"147.32.84.165",4808,"178.162.190.126",25,6,372,6,372,0,0,5753.071161,9.013434999999845,330.1737905693058,0
"147.32.84.165",4263,"174.133.57.141",80,16,3429,12,1428,4,2001,5754.874089,0.4855310000002646,23528.878691564027,32970.08841864119
"147.32.84.165",4784,"209.85.225.27",25,6,372,6,372,0,0,5754.874221,9.012509000000136,330.2077146330678,0
"147.32.84.165",4272,"173.192.170.88",80,16,2125,12,1596,4,529,5755.775654,18.97696300000007,672.8157714171626,223.00723250606458
"147.32.84.165",4275,"212.117.174.7",4506,6,372,6,372,0,0,5755.775735,9.012823000000026,330.19621044371905,0
"147.32.84.165",4270,"199.255.211.81",6667,4,248,4,248,0,0,5755.775768,3.0043139999997948,660.3837015705201,0
"147.32.84.165",2476,"83.221.6.50",25,6,372,6,372,0,0,5758.178654,9.013019999999415,330.18899325644384,0
"147.32.84.165",4809,"46.4.116.200",25,6,372,6,372,0,0,5764.287366,9.00704400000086,330.4080672859726,0
"147.32.84.165",4306,"174.133.57.141",80,17,3489,12,1428,5,2061,5766.791187,5.970852000000377,1913.2947860706106,2761.414953845608
"147.32.84.165",4786,"210.104.236.29",25,6,372,6,372,0,0,5766.791326,9.022368000000824,329.84688720297464,0
"147.32.84.165",4278,"174.36.246.56",80,29,14325,22,2168,7,12157,5771.398308,0.4176560000005338,41526.99829519469,232861.49366913366
"147.32.84.165",4302,"119.154.54.142",6667,2,124,2,124,0,0,5771.519188,6.000000212225132e-06,0,0
"147.32.84.165",4323,"212.117.174.7",4506,6,372,6,372,0,0,5771.789485,9.031501999999819,329.513296902338,0
"147.32.84.165",2488,"92.53.96.75",25,6,372,6,372,0,0,5772.190677,9.030551000000742,329.54799768029164,0
"147.32.84.165",4814,"72.14.213.27",25,6,372,6,372,0,0,5773.193897,9.030846999999994,329.5371962341962,0
"147.32.84.165",4789,"205.188.190.1",25,6,372,6,372,0,0,5773.394471,9.028571000000738,329.62026881106175,0
"147.32.84.165",4318,"195.113.232.97",80,7,426,6,364,1,62,5774.097201,0.0009260000006179325,0,0
"147.32.84.165",2489,"92.53.116.6",25,6,372,6,372,0,0,5774.097964,9.026301000000785,329.7031641200245,0
"147.32.84.165",4815,"62.118.120.61",25,6,372,6,372,0,0,5775.913995,9.01271799999995,330.2000572968129,0
"147.32.84.165",4790,"77.238.184.241",25,6,372,6,372,0,0,5779.218562,9.013318999999683,330.17803985414304,0
"147.32.84.165",4354,"212.117.174.7",4506,6,372,6,372,0,0,5783.124073,8.913150999999743,333.8886550895509,0
"147.32.84.165",4337,"77.89.69.181",6667,6,372,6,372,0,0,5783.124208,8.913078999999925,333.891352247638,0
"147.32.84.165",4353,"173.192.170.88",80,17,1643,12,1086,5,557,5785.32726,60.017979000000196,144.7566236777145,74.24441932641527
"147.32.84.165",2493,"81.177.24.21",25,6,372,6,372,0,0,5785.52797,8.912105999999767,333.92780561632435,0
"147.32.84.165",4817,"195.128.50.36",25,6,372,6,372,0,0,5787.830951,9.012858000000051,330.19492817927267,0
"147.32.84.165",4358,"174.133.57.141",80,16,3429,12,1428,4,2001,5792.73839,0.48864899999989575,23378.744252014098,32759.71095817942
"147.32.84.165",4792,"209.85.225.27",25,6,372,6,372,0,0,5792.738474,9.012708000000202,330.2004236684394,0
"147.32.84.165",4365,"78.249.161.87",6667,6,372,6,372,0,0,5793.139015,9.012880000000223,330.19412218956944,0
"147.32.84.165",2494,"188.120.239.168",25,6,372,6,372,0,0,5794.139955,9.013179000000491,330.1831684469861,0
"147.32.84.165",4819,"89.208.153.2",25,6,372,6,372,0,0,5794.34021,9.013073000000077,330.1870516304455,0
"147.32.84.165",4793,"204.127.217.21",25,6,372,6,372,0,0,5795.041163,9.013369000000239,330.1762082524216,0
"147.32.84.165",4394,"41.251.251.106",6667,9,552,6,372,3,180,5796.844155,1.9644130000006044,1514.9563762808964,733.043407877853
"147.32.84.165",4399,"212.117.174.7",4506,6,372,6,372,0,0,5798.808726,8.950955999999678,332.478452580943,0
"147.32.84.165",2497,"77.222.41.36",25,6,372,6,372,0,0,5800.149151,9.01412000000073,330.14870003946686,0
"147.32.84.165",4707,"95.163.15.194",25,6,372,6,372,0,0,5804.054615,9.012531000000308,330.20690858094116,0
"147.32.84.165",4415,"174.133.57.141",80,17,3489,12,1428,5,2061,5806.45758,0.6497140000001309,17583.121188704103,25377.319866890168
"147.32.84.165",4794,"64.12.90.65",25,6,372,6,372,0,0,5806.457669,9.013392999999269,330.1753290908586,0
"147.32.84.165",4410,"79.113.190.202",6667,6,372,6,372,0,0,5808.861612,9.015575000000354,330.09541820681244,0
"147.32.84.165",2498,"77.222.41.41",25,6,372,6,372,0,0,5813.768726,9.012826999999561,330.196063898724,0
"147.32.84.165",4823,"74.125.127.27",25,6,372,6,372,0,0,5814.168653,9.013262000000395,330.1801279048439,0
"147.32.84.165",4795,"66.94.237.64",25,6,372,6,372,0,0,5815.170198,9.01279599999998,330.19719962595474,0
"147.32.84.165",4427,"212.117.174.7",4506,6,372,6,372,0,0,5815.370356,9.01306299999942,330.1874179732452,0
"147.32.84.165",4434,"58.252.109.240",6667,4,248,4,248,0,0,5815.370432,3.004399000000376,660.3650180950506,0
"147.32.84.165",2499,"46.38.56.73",25,6,372,6,372,0,0,5816.071399,9.012958999999682,330.1912279862923,0
"147.32.84.165",4825,"74.125.157.27",25,6,372,6,372,0,0,5819.776704,9.01349300000038,330.17166596788553,0
"147.32.84.165",4450,"173.192.170.88",80,16,2010,12,1482,4,528,5821.178717,13.644100999999864,868.9469537054964,309.58433978171536
"147.32.84.165",4445,"174.133.57.141",80,17,3489,12,1428,5,2061,5821.178791,1.2370700000001307,9234.723984898828,13328.267600053561
"147.32.84.165",4797,"209.85.225.27",25,6,372,6,372,0,0,5821.332566,8.959630999999717,332.15653635736714,0
"147.32.84.165",4458,"210.211.247.235",6667,4,248,4,248,0,0,5825.084439,3.0041049999999814,660.429645435167,0
"147.32.84.165",4464,"212.117.174.7",4506,6,372,6,372,0,0,5827.487734,9.013535000000047,330.170127480504,0
"147.32.84.165",2500,"62.183.66.244",25,6,372,6,372,0,0,5829.891427,9.015681000000768,330.0915371783614,0
"147.32.84.165",4828,"62.213.110.35",25,6,372,6,372,0,0,5830.592244,9.013018999999986,330.1890298910947,0
"147.32.84.165",4456,"68.67.185.209",80,13,2256,10,1284,3,972,5834.798741,4.386513000000377,2341.7233688807296,1772.706475507842
"147.32.84.165",4474,"174.133.57.141",80,16,3429,12,1428,4,2001,5834.822639,0.6096090000000913,18739.880808843518,26259.45483087947
"147.32.84.165",4798,"65.54.188.94",25,6,372,6,372,0,0,5834.976524,8.935602000000472,333.04974863471347,0
"147.32.84.165",4473,"203.200.75.221",6667,4,248,4,248,0,0,5835.199149,3.0039630000001125,660.4608645312628,0
"147.32.84.165",2502,"194.54.148.122",25,6,372,6,372,0,0,5836.200895,9.012271999999939,330.21639826228284,0
"147.32.84.165",4829,"62.213.110.35",25,6,372,6,372,0,0,5837.101845,9.014887000000272,330.1206104968271,0
"147.32.84.165",4478,"68.67.179.210",80,13,2481,10,1660,3,821,5837.101916,2.083229000000756,6374.719245937523,3152.797892117293
"147.32.84.165",4799,"64.12.90.65",25,6,372,6,372,0,0,5837.131751,8.985106000000087,331.2147903430378,0
"147.32.84.165",2505,"89.108.79.57",25,6,372,6,372,0,0,5840.80692,9.012896999999612,330.1934993820664,0
"147.32.84.165",4831,"77.88.21.89",25,6,372,6,372,0,0,5840.80706,9.012834000000112,330.19580744524563,0
"147.32.84.165",4801,"209.85.225.27",25,6,372,6,372,0,0,5842.309572,9.012896000000183,330.19353601771724,0
"147.32.84.165",4493,"212.117.174.7",4506,6,372,6,372,0,0,5848.518567,9.012912999999571,330.1929132124255,0
"147.32.84.165",4495,"61.26.131.206",6667,6,372,6,372,0,0,5850.421228,9.012335999999777,330.21405327099137,0
"147.32.84.165",4506,"173.192.170.88",80,15,3217,10,966,5,2251,5850.921812,0.6679190000004382,11570.26525670767,26961.35309818733
"147.32.84.165",2507,"91.218.38.36",25,6,372,6,372,0,0,5851.122817,9.012408999999934,330.2113785559468,0
"147.32.84.165",4832,"77.88.21.89",25,6,372,6,372,0,0,5851.622899,8.912247000000207,333.92252256921637,0
"147.32.84.165",4507,"174.133.57.141",80,16,3429,12,1428,4,2001,5851.622973,0.551513000000341,20713.926960911052,29025.607737243008
"147.32.84.165",4802,"199.217.10.203",25,6,372,6,372,0,0,5851.77806,8.857406000000083,335.99001784495056,0
"147.32.84.165",4519,"202.95.154.126",6667,3,184,2,124,1,60,5855.928925,4.181720999999925,237.22290415836395,114.78527620565997
"147.32.84.165",4521,"212.117.174.7",4506,6,372,6,372,0,0,5857.231136,8.91225200000008,333.9223352301947,0
"147.32.84.165",2515,"74.52.75.130",25,6,372,6,372,0,0,5857.231273,8.91220599999997,333.9240587571708,0
"147.32.84.165",4834,"89.108.70.32",25,6,372,6,372,0,0,5858.133463,8.91129699999965,333.95812079881495,0
"147.32.84.165",4803,"205.188.103.1",25,6,372,6,372,0,0,5861.73741,9.012464000000364,330.20936338828983,0
"147.32.84.165",2516,"64.202.126.109",25,6,372,6,372,0,0,5861.737509,9.01249000000007,330.20841077215914,0
"147.32.84.165",4835,"89.108.70.32",25,6,372,6,372,0,0,5863.239572,9.012885999999526,330.193902374906,0
"147.32.84.165",4540,"174.133.57.141",80,19,4313,14,2252,5,2061,5863.239656,8.171041000000514,2204.8598214106214,2017.8579449055467
"147.32.84.165",4804,"98.137.54.238",25,6,372,6,372,0,0,5863.399155,8.953362999999626,332.38906989475623,0
"147.32.84.165",4539,"70.38.78.73",6667,6,372,6,372,0,0,5869.448518,9.012471000000005,330.2091069141857,0
"147.32.84.165",2517,"213.171.1.198",25,6,372,6,372,0,0,5870.850343,9.012711999999738,330.20027711970454,0
"147.32.84.165",4836,"188.93.212.21",25,6,372,6,372,0,0,5871.3513,9.012483999999858,330.20863060617324,0
"147.32.84.165",4806,"165.21.74.118",25,6,372,6,372,0,0,5872.052093,9.013318999999683,330.17803985414304,0
"147.32.84.165",4565,"31.192.109.167",80,15,1540,10,1050,5,490,5872.652826,0.27651500000047236,30378.09883726254,14176.44612405585
"147.32.84.165",4557,"122.127.64.127",6667,9,552,6,372,3,180,5872.732508,1.9759839999996984,1506.0850695149627,728.7508400878852
"147.32.84.165",2518,"83.221.6.50",25,6,372,6,372,0,0,5874.708764,8.9597389999999,332.15253256819574,0
"147.32.84.165",4837,"188.93.212.21",25,6,372,6,372,0,0,5878.160832,9.013335999999981,330.17741710727375,0
"147.32.84.165",4807,"64.12.139.193",25,6,372,6,372,0,0,5878.16091,9.013323000000128,330.17789332524285,0
"147.32.84.165",4570,"212.117.174.7",4506,6,372,6,372,0,0,5879.062283,9.013235999999779,330.18108035782853,0
"147.32.84.165",4578,"61.17.216.28",6667,2,124,2,124,0,0,5882.767301,1.1000000085914508e-05,0,0
"147.32.84.165",2522,"46.4.54.212",25,6,372,6,372,0,0,5882.767382,9.01328999999987,330.17910219243396,0
"147.32.84.165",4841,"94.229.67.92",25,6,372,6,372,0,0,5884.370232,9.012240999999449,330.2175341294337,0
"147.32.84.165",4583,"174.133.57.141",80,16,3429,12,1428,4,2001,5890.47902,0.5954099999999016,19186.778858268903,26885.67541694403
"147.32.84.165",4810,"209.85.225.27",25,6,372,6,372,0,0,5890.638842,8.953189999999267,332.3954925563116,0
"147.32.84.165",4600,"31.42.162.114",6667,2,124,2,124,0,0,5891.880308,9.000000318337698e-06,0,0
"147.32.84.165",4593,"212.117.174.7",4506,6,372,6,372,0,0,5892.381313,9.012915000000248,330.19283994134173,0
"147.32.84.165",2530,"92.38.225.40",25,6,372,6,372,0,0,5892.381389,9.012907000000268,330.19313302577194,0
"147.32.84.165",4843,"94.229.67.92",25,6,372,6,372,0,0,5893.082284,9.013014999999541,330.18917642987964,0
"147.32.84.165",4811,"200.217.210.248",25,6,372,6,372,0,0,5893.082372,9.012993000000279,330.18998239540497,0
"147.32.84.165",2531,"74.125.39.27",25,6,372,6,372,0,0,5895.685815,9.012942000000294,330.19185078522673,0
"147.32.84.165",4848,"194.87.0.16",25,6,372,6,372,0,0,5896.68824,9.011909999999261,330.22966274632614,0
"147.32.84.165",4812,"62.24.139.61",25,6,372,6,372,0,0,5899.191265,9.012923999999657,330.19251022200046,0
"147.32.84.165",4632,"220.178.26.99",6667,4,248,4,248,0,0,5900.092291,3.0044239999997444,660.3595231565747,0
"147.32.84.165",4631,"173.192.170.88",80,42,6266,26,2006,16,4260,5903.797559,43.093534000000545,372.3992559997469,790.8379015747366
"147.32.84.165",2538,"74.125.127.27",25,6,372,6,372,0,0,5903.998215,9.01260000000002,330.2043805339184,0
"147.32.84.165",4857,"194.87.0.16",25,6,372,6,372,0,0,5905.400251,9.012995000000046,330.1899091256552,0
"147.32.84.165",4644,"174.133.57.141",80,17,3489,12,1428,5,2061,5905.400359,8.112610000000132,1408.178132561508,2032.3915484658737
"147.32.84.165",4813,"205.188.103.1",25,6,372,6,372,0,0,5905.554693,8.958220999999867,332.20881690684394,0
"147.32.84.165",4657,"212.117.174.7",4506,6,372,6,372,0,0,5906.301158,9.013315000000148,330.17818638314,0
"147.32.84.165",4693,"178.122.89.175",6667,4,248,4,248,0,0,5911.60921,3.0039820000001782,660.4566871572074,0
"147.32.84.165",2539,"209.85.225.27",25,6,372,6,372,0,0,5913.411323,9.012867999999798,330.194561819841,0
"147.32.84.165",4859,"78.46.250.193",25,6,372,6,372,0,0,5914.112316,9.012849000000642,330.19525790344295,0
"147.32.84.165",4816,"209.85.225.27",25,6,372,6,372,0,0,5916.515897,9.013245999999526,330.18071402912517,0
"147.32.84.165",2541,"72.14.213.27",25,6,372,6,372,0,0,5916.515972,9.013235999999779,330.18108035782853,0
"147.32.84.165",4860,"78.46.250.193",25,6,372,6,372,0,0,5916.716694,9.012197000000015,330.2191463413411,0
"147.32.84.165",4818,"205.173.240.3",25,6,372,6,372,0,0,5916.71683,9.01213800000005,330.22130819567826,0
"147.32.84.165",2453,"74.125.157.27",25,6,372,6,372,0,0,5917.717932,9.013170000000173,330.1834981477042,0
"147.32.84.165",4865,"209.190.61.35",25,6,372,6,372,0,0,5920.221299,9.012730000000374,330.1996176519075,0
"147.32.84.165",1761,"174.133.57.141",80,19,3609,14,1548,5,2061,5925.028525,3.5565090000000055,3482.06626216888,4636.006825794613
"147.32.84.165",4820,"65.55.37.120",25,6,372,6,372,0,0,5925.18099,8.860306000000492,335.8800474836687,0
"147.32.84.165",1518,"208.73.210.29",80,72,39217,44,6636,28,32581,5926.530169,13.880848000000697,3824.5502003910233,18777.52713666967
"147.32.84.165",1470,"118.136.111.104",6667,6,372,6,372,0,0,5926.710285,8.832934000000023,336.92089174446363,0
"147.32.84.165",1472,"212.117.174.7",4506,6,372,6,372,0,0,5926.730963,8.912234000000353,333.92300965166334,0
"147.32.84.165",4868,"209.190.61.35",25,6,372,6,372,0,0,5926.731037,8.912227000000712,333.92327192740515,0
"147.32.84.165",4821,"98.137.54.238",25,6,372,6,372,0,0,5926.73107,8.912223000000267,333.92342179946695,0
"147.32.84.165",2545,"78.138.172.217",25,6,372,6,372,0,0,5927.331264,8.913164999999935,333.88813064719676,0
"147.32.84.165",4870,"77.243.96.10",25,6,372,6,372,0,0,5934.341805,9.012474000000111,330.20899699682496,0
"147.32.84.165",4822,"205.188.190.1",25,6,372,6,372,0,0,5935.042446,9.013111999999637,330.1856229014041,0
"147.32.84.165",2054,"212.117.174.7",4506,6,372,6,372,0,0,5937.446441,9.012872999999672,330.19437864043,0
"147.32.84.165",1920,"74.125.232.217",80,13,2932,10,2058,3,874,5937.646384,2.764754000000721,5954.960188138151,2528.9772616291275
"147.32.84.165",2004,"119.154.131.100",6667,6,372,6,372,0,0,5937.654478,9.004877999999735,330.48754241868545,0
"147.32.84.165",2546,"78.138.172.217",25,6,372,6,372,0,0,5938.647666,9.013208999999733,330.18206944941454,0
"147.32.84.165",4871,"77.243.96.10",25,6,372,6,372,0,0,5938.647769,9.013229999999567,330.18130015545404,0
"147.32.84.165",2148,"174.133.57.141",80,17,3489,12,1428,5,2061,5938.647799,8.743728999999803,1306.5363759558716,1885.6943073144619
"147.32.84.165",4824,"209.85.225.27",25,6,372,6,372,0,0,5938.817437,8.943833000000268,332.74324330518147,0
"147.32.84.165",2181,"119.154.70.142",6667,4,248,4,248,0,0,5941.154237,3.0011990000002697,661.0691260392335,0
"147.32.84.165",2564,"91.121.49.79",25,6,372,6,372,0,0,5946.05921,9.012305999999626,330.21515248152065,0
"147.32.84.165",4902,"62.213.110.156",25,6,372,6,372,0,0,5947.561053,9.012554999999338,330.206029255879,0
"147.32.84.165",4826,"98.137.54.238",25,6,372,6,372,0,0,5947.661069,9.012353000000076,330.2134303882654,0
"147.32.84.165",2296,"180.251.135.144",6667,4,248,4,248,0,0,5948.261572,3.004331999999522,660.379744981685,0
"147.32.84.165",2349,"212.117.174.7",4506,6,372,6,372,0,0,5955.37174,9.012742000000799,330.1991780081729,0
"147.32.84.165",2269,"173.192.170.88",80,17,1641,12,1084,5,557,5955.371877,70.68287300000065,122.68884429754178,63.04214600897672
"147.32.84.165",2565,"91.121.49.79",25,6,372,6,372,0,0,5955.57269,9.012501999999586,330.2079711050424,0
"147.32.84.165",4906,"62.213.110.156",25,6,372,6,372,0,0,5955.572765,9.012580999999955,330.20507665895207,0
"147.32.84.165",4827,"205.188.190.1",25,6,372,6,372,0,0,5955.572832,9.012588000000505,330.20482019147363,0
"147.32.84.165",2571,"77.221.128.102",25,6,372,6,372,0,0,5955.572901,9.012595000000147,330.2045637244269,0
"147.32.84.165",4913,"64.120.247.194",25,6,372,6,372,0,0,5956.075819,9.009969000000638,330.3008034766589,0
"147.32.84.165",4830,"216.32.181.178",25,6,372,6,372,0,0,5956.174049,9.01172200000019,330.23655190427945,0
"147.32.84.165",2417,"61.17.216.10",6667,4,248,4,248,0,0,5958.476547,3.003762999999708,660.5048400956376,0
"147.32.84.165",2576,"77.221.128.102",25,6,372,6,372,0,0,5958.676663,9.01268600000003,330.20122968890627,0
"147.32.84.165",4915,"64.120.247.194",25,6,372,6,372,0,0,5958.676795,9.012738999999783,330.1992879190301,0
"147.32.84.165",2412,"174.133.57.141",80,16,3429,12,1428,4,2001,5958.676854,0.46898699999928795,24358.884148211666,34133.142283313406
"147.32.84.165",4833,"209.85.225.27",25,6,372,6,372,0,0,5958.832919,8.95709799999986,332.2504677296203,0
"147.32.84.165",2579,"87.118.116.14",25,6,372,6,372,0,0,5958.832986,8.957172999999784,332.2476857374611,0
"147.32.84.165",4926,"174.142.90.173",25,6,372,6,372,0,0,5959.778417,9.012966999999662,330.1909349052439,0
"147.32.84.165",4838,"196.46.139.51",25,6,372,6,372,0,0,5966.387482,9.013334999999643,330.17745373938925,0
"147.32.84.165",2471,"212.117.174.7",4506,6,372,6,372,0,0,5967.088636,9.012945999999829,330.19170424410135,0
"147.32.84.165",2500,"58.252.109.242",6667,4,248,4,248,0,0,5968.59428,3.000884999999471,661.1382975356769,0
"147.32.84.165",2580,"87.118.116.14",25,6,372,6,372,0,0,5968.693777,9.010329999999158,330.2875699336515,0
"147.32.84.165",4932,"174.142.90.173",25,6,372,6,372,0,0,5968.69391,9.010325999999623,330.28771655988083,0
"147.32.84.165",4839,"205.188.103.1",25,6,372,6,372,0,0,5968.693969,9.010315999999875,330.28808312605696,0
"147.32.84.165",2583,"199.124.61.3",25,6,372,6,372,0,0,5976.602048,9.013557000000219,330.1693216118706,0
"147.32.84.165",4948,"89.238.159.206",25,6,372,6,372,0,0,5976.602202,9.013543000000027,330.1698344369124,0
"147.32.84.165",2505,"174.133.57.141",80,16,3429,12,1428,4,2001,5977.106055,0.4722439999995913,24190.884373353365,33897.73083408969
"147.32.84.165",4840,"66.94.237.64",25,6,372,6,372,0,0,5977.204789,9.011274999999841,330.252933131,0
"147.32.84.165",2588,"199.124.61.3",25,6,372,6,372,0,0,5977.261422,8.95470000000023,332.33944185734015,0
"147.32.84.165",4965,"89.238.159.206",25,6,372,6,372,0,0,5977.261485,8.954689000000144,332.3398501053417,0
"147.32.84.165",4842,"209.85.225.27",25,6,372,6,372,0,0,5977.261542,8.954689000000144,332.3398501053417,0
"147.32.84.165",2898,"82.205.135.35",6667,4,248,4,248,0,0,5979.806964,3.0042649999995774,660.3944725249867,0
"147.32.84.165",2591,"178.208.82.126",25,6,372,6,372,0,0,5980.809094,9.012286000000131,330.21588529258355,0
"147.32.84.165",1028,"81.26.144.245",25,6,372,6,372,0,0,5986.21591,9.013025000000198,330.18881008317794,0
"147.32.84.165",4844,"205.188.190.1",25,6,372,6,372,0,0,5987.417717,9.01330599999983,330.17851607390855,0
"147.32.84.165",3352,"60.249.196.250",6667,4,248,4,248,0,0,5988.119477,3.0038290000002235,660.4903275119364,0
"147.32.84.165",2968,"212.117.174.7",4506,6,372,6,372,0,0,5989.721597,9.012512000000243,330.2076047166339,0
"147.32.84.165",2602,"178.208.82.126",25,6,372,6,372,0,0,5996.430873,9.00944999999956,330.3198308442963,0
"147.32.84.165",1039,"81.26.144.245",25,6,372,6,372,0,0,5996.430955,9.009532000000036,330.31682444770587,0
"147.32.84.165",3341,"174.133.57.141",80,16,3441,12,1440,4,2001,5996.430989,0.4608559999996942,24996.962174752298,34735.36202199954
"147.32.84.165",4845,"65.54.188.126",25,6,372,6,372,0,0,5996.583753,8.957178999999996,332.2474631800929,0
"147.32.84.165",3539,"31.192.109.167",80,15,1540,10,1050,5,490,5997.635077,0.2480070000001433,33870.01173352021,15806.005475642763
"147.32.84.165",3527,"212.117.174.7",4506,6,372,6,372,0,0,5997.635214,8.909096999999747,334.04058795185244,0
"147.32.84.165",2627,"87.242.79.74",25,6,372,6,372,0,0,5997.635274,8.909201999999823,334.0366510940103,0
"147.32.84.165",1044,"194.28.172.37",25,6,372,6,372,0,0,5997.713355,8.831221000000369,336.9862445974204,0
"147.32.84.165",4846,"209.85.225.27",25,6,372,6,372,0,0,5998.233526,8.91208800000004,333.9284800598902,0
"147.32.84.165",3615,"27.255.33.216",6667,4,248,4,248,0,0,5998.233662,2.9040570000006483,683.1821827187129,0
"147.32.84.165",2636,"87.242.79.74",25,6,372,6,372,0,0,5998.233733,8.911959000000024,333.93331365191335,0
"147.32.84.165",1049,"194.28.172.37",25,6,372,6,372,0,0,5998.23379,8.911933999999746,333.93425041075085,0
"147.32.84.165",4847,"65.55.37.88",25,6,372,6,372,0,0,5998.233849,8.911904999999933,333.9353370575676,0
"147.32.84.165",3702,"98.126.71.122",80,18,4863,14,1430,4,3433,6001.738437,16.84627400000045,679.0819144933589,1630.271477241749
"147.32.84.165",2637,"88.198.27.35",25,6,372,6,372,0,0,6001.913083,8.945326000000023,332.6877075245768,0
"147.32.84.165",1055,"78.46.183.235",25,6,372,6,372,0,0,6005.942202,9.028876999999738,329.60909756552076,0
"147.32.84.165",3866,"174.133.57.141",80,16,3429,12,1428,4,2001,6007.145797,0.5027600000003076,22722.57140582586,31840.241864886237
"147.32.84.165",4849,"205.188.190.1",25,6,372,6,372,0,0,6007.310959,8.965073999999731,331.9548728766867,0
"147.32.84.165",3796,"212.117.171.138",65500,83,46314,56,43762,27,2552,6007.311022,35.15418800000043,9958.870334311112,580.755840527443
"147.32.84.165",3779,"195.113.232.98",80,23,7769,16,4002,7,3767,6007.311078,12.010224000000562,2665.7287990630734,2509.195498768265
"147.32.84.165",2640,"88.198.27.35",25,6,372,6,372,0,0,6007.311135,8.964993999999933,331.9578351084253,0
"147.32.84.165",1060,"78.46.183.235",25,6,372,6,372,0,0,6007.311192,8.964962999999443,331.9589829874574,0
"147.32.84.165",4850,"209.85.225.27",25,6,372,6,372,0,0,6007.311247,8.96493400000054,331.96005681690696,0
"147.32.84.165",3892,"118.96.124.137",6667,9,552,6,372,3,180,6008.349844,1.9422489999997197,1532.2443208880168,741.4085423651694
"147.32.84.165",3885,"195.113.232.89",80,13,2800,10,1778,3,1022,6010.292368,9.029042999999547,1575.360755287212,905.5223239052478
"147.32.84.165",2652,"46.4.74.165",25,6,372,6,372,0,0,6010.293267,9.007539000000179,330.38991005200654,0
"147.32.84.165",1065,"89.188.104.6",25,6,372,6,372,0,0,6010.657399,9.043951000000561,329.0597217963493,0
"147.32.84.165",4851,"216.82.249.99",25,6,372,6,372,0,0,6014.469103,9.037405000000035,329.29806731024985,0
"147.32.84.165",3969,"89.38.42.156",6667,2,124,2,124,0,0,6017.580207,1.4999999621068127e-05,0,0
"147.32.84.165",4021,"212.117.174.7",4506,6,372,6,372,0,0,6018.583228,9.029045999999653,329.60292814989697,0
"147.32.84.165",3912,"195.113.232.99",80,13,1970,10,1598,3,372,6018.583409,0.7381030000005921,17320.075924348967,4031.9575994103975
"147.32.84.165",2653,"46.4.74.165",25,6,372,6,372,0,0,6018.584242,9.028097000000344,329.6375747845738,0
"147.32.84.165",1076,"79.174.66.33",25,6,372,6,372,0,0,6018.584316,9.028049999999894,329.63929087677127,0
"147.32.84.165",4078,"174.133.57.141",80,16,3429,12,1428,4,2001,6019.184968,0.46231299999999464,24710.53160953755,34625.89198227215
"147.32.84.165",4852,"205.188.103.1",25,6,372,6,372,0,0,6019.337829,8.975698000000193,331.5619576327029,0
"147.32.84.165",2661,"212.72.165.79",25,6,372,6,372,0,0,6022.905548,9.013381000000663,330.17576867102156,0
"147.32.84.165",1079,"79.174.66.33",25,6,372,6,372,0,0,6027.01164,9.012762000000293,330.1984452712613,0
"147.32.84.165",4853,"62.193.206.40",25,6,372,6,372,0,0,6027.011716,9.012810000000172,330.19668671590136,0
"147.32.84.165",4152,"212.117.174.7",4506,6,372,6,372,0,0,6028.313648,9.012627000000066,330.2033913086582,0
"147.32.84.165",4151,"117.197.182.9",6667,2,124,2,124,0,0,6028.313685,3.99999953515362e-06,0,0
"147.32.84.165",4196,"173.192.170.88",80,17,1643,12,1086,5,557,6031.317808,57.063740999999936,152.25079617545597,78.08811553382041
"147.32.84.165",2664,"212.72.165.79",25,6,372,6,372,0,0,6031.518715,9.012197000000015,330.2191463413411,0
"147.32.84.165",1058,"89.188.104.6",25,6,372,6,372,0,0,6031.518773,9.012260999999853,330.21680131101937,0
"147.32.84.165",4272,"174.133.57.141",80,17,2011,12,1428,5,583,6031.518832,177.49581100000069,64.36208232542432,26.276676467592704
"147.32.84.165",4854,"205.188.190.1",25,6,372,6,372,0,0,6031.67454,8.956527999999707,332.27161239267014,0
"147.32.84.165",2669,"89.108.67.8",25,6,372,6,372,0,0,6031.718912,9.012296999999307,330.2154822461165,0
"147.32.84.165",1095,"94.75.243.11",25,6,372,6,372,0,0,6032.118865,9.012993999999708,330.1899457605427,0
"147.32.84.165",4855,"209.85.225.27",25,6,372,6,372,0,0,6035.523725,8.913524999999936,333.8746455526878,0
"147.32.84.165",4187,"212.117.171.138",65500,24,1475,18,1092,6,383,6039.63027,50.39521599999989,173.34978780525554,60.79942191338175
"147.32.84.165",2670,"89.108.67.8",25,6,372,6,372,0,0,6039.630404,8.912042999999358,333.93016618077525,0
"147.32.84.165",1106,"94.75.243.11",25,6,372,6,372,0,0,6039.630459,8.912113000000318,333.9275433334265,0
"147.32.84.165",4856,"193.200.71.212",25,6,372,6,372,0,0,6039.630514,8.912109999999302,333.9276557403615,0
"147.32.84.165",4306,"65.54.186.47",443,45,24779,34,3874,11,20905,6039.630583,2.40060799999992,12910.062784095126,69665.68469321338
"147.32.84.165",2674,"65.54.188.78",25,6,372,6,372,0,0,6039.794397,8.848184000000401,336.3402026901639,0
"147.32.84.165",1109,"89.111.176.244",25,6,372,6,372,0,0,6040.330626,8.915702000000238,333.7931213941337,0
"147.32.84.165",4858,"80.121.155.228",25,6,372,6,372,0,0,6042.333496,8.915020999999797,333.81861915973815,0
"147.32.84.165",4319,"41.220.18.106",6667,6,372,6,372,0,0,6043.835909,9.01293699999951,330.19203396186634,0
"147.32.84.165",4456,"212.117.174.7",4506,6,372,6,372,0,0,6047.941882,9.012805000000299,330.1968698978732,0
"147.32.84.165",2681,"188.93.23.170",25,6,372,6,372,0,0,6052.548526,9.012815000000046,330.1965035341328,0
"147.32.84.165",1110,"89.111.176.244",25,6,372,6,372,0,0,6052.648782,9.012544000000162,330.2064322792706,0
"147.32.84.165",4861,"205.188.190.1",25,6,372,6,372,0,0,6052.648861,9.012574000000313,330.20533312679555,0
"147.32.84.165",1113,"178.162.137.203",25,6,372,6,372,0,0,6053.049396,9.012729000000036,330.1996542889494,0
"147.32.84.165",4862,"209.85.225.27",25,6,372,6,372,0,0,6056.453958,9.013001999999688,330.18965268177055,0
"147.32.84.165",4521,"212.117.174.7",4506,6,372,6,372,0,0,6060.560472,9.012392999999975,330.2119647911502,0
"147.32.84.165",4429,"212.117.171.138",65500,136,85312,86,5164,50,80148,6060.560603,21.781659999999647,1896.6414864615767,29436.874875469104
"147.32.84.165",2685,"81.177.26.77",25,6,372,6,372,0,0,6060.560661,9.012346999999863,330.2136502289631,0
"147.32.84.165",1114,"178.162.137.203",25,6,372,6,372,0,0,6060.659925,9.013026999999965,330.1887368139485,0
"147.32.84.165",4863,"98.137.54.238",25,6,372,6,372,0,0,6060.660056,9.013021000000663,330.1889566217344,0
"147.32.84.165",4447,"117.204.67.233",6667,6,372,6,372,0,0,6061.26077,9.015006999999969,330.1162162159176,0
"147.32.84.165",2688,"81.177.26.77",25,6,372,6,372,0,0,6063.263597,9.0130079999999,330.18943287302454,0
"147.32.84.165",1117,"174.142.184.181",25,6,372,6,372,0,0,6063.263731,9.013057000000117,330.18763777927524,0
"147.32.84.165",4573,"173.192.170.88",80,16,2030,12,1502,4,528,6064.865923,16.467719999999645,729.6699239482004,256.5018108153461
"147.32.84.165",4864,"66.94.237.64",25,6,372,6,372,0,0,6064.866014,9.01288199999999,330.1940489179824,0
"147.32.84.165",4506,"98.139.175.224",25,6,372,6,372,0,0,6068.976665,9.008818000000247,330.3430039323603,0
"147.32.84.165",2690,"206.123.66.59",25,6,372,6,372,0,0,6073.579141,9.01251499999944,330.2074948003066,0
"147.32.84.165",1122,"174.142.184.181",25,6,372,6,372,0,0,6073.679259,9.01241200000004,330.2112686370737,0
"147.32.84.165",4602,"68.67.179.209",80,13,2276,10,1304,3,972,6073.679394,7.7609080000001995,1344.1726148537944,1001.9446178204664
"147.32.84.165",4611,"174.133.57.141",80,16,3429,12,1428,4,2001,6073.703349,0.476278000000093,23985.99137478063,33610.62236760227
"147.32.84.165",4866,"205.188.190.1",25,6,372,6,372,0,0,6073.703415,8.988381000000118,331.0941091615899,0
"147.32.84.165",4517,"62.152.241.162",6667,6,372,6,372,0,0,6074.079153,9.013127000000168,330.1850733935009,0
"147.32.84.165",4664,"212.117.174.7",4506,6,372,6,372,0,0,6077.484327,9.012956999999915,330.19130125662736,0
"147.32.84.165",2699,"206.123.66.59",25,6,372,6,372,0,0,6081.590528,9.012335000000348,330.21408991120336,0
"147.32.84.165",1140,"78.140.170.176",25,6,372,6,372,0,0,6081.590662,9.012328000000707,330.2143463930481,0
"147.32.84.165",4670,"147.32.84.171",139,33,4810,22,3278,11,1532,6081.690118,0.015625,1678336,784384
"147.32.84.165",4867,"209.85.225.27",25,6,372,6,372,0,0,6081.690345,9.012658999999985,330.20221890121496,0
"147.32.84.165",2700,"195.54.162.79",25,6,372,6,372,0,0,6082.291827,9.012235000000146,330.2177539755623,0
"147.32.84.165",1141,"78.140.170.176",25,6,372,6,372,0,0,6084.293806,9.013168000000405,330.1835714146087,0
"147.32.84.165",4682,"174.133.57.141",80,16,3429,12,1428,4,2001,6084.293939,0.4838270000000193,23611.745520608696,33086.20643328992
"147.32.84.165",4869,"98.137.54.238",25,6,372,6,372,0,0,6084.293999,9.01310999999987,330.18569616925157,0
"147.32.84.165",4565,"212.117.171.138",65500,24,1475,18,1092,6,383,6085.896211,51.19675699999971,170.63580804542073,59.84754073387925
"147.32.84.165",2703,"195.54.162.79",25,6,372,6,372,0,0,6085.896357,9.013142000000698,330.18452388742674,0
"147.32.84.165",1146,"91.219.194.11",25,6,372,6,372,0,0,6085.896429,9.013151999999536,330.1841575511157,0
"147.32.84.165",4872,"207.115.36.22",25,6,372,6,372,0,0,6090.00204,9.013068999999632,330.18719816747455,0
"147.32.84.165",4692,"212.117.174.7",4506,6,372,6,372,0,0,6094.60876,9.013213999999607,330.1818862838639,0
"147.32.84.165",4591,"183.83.108.230",6667,6,372,6,372,0,0,6094.608894,9.013181000000259,330.1830951802604,0
"147.32.84.165",4695,"173.192.170.88",80,11,1283,8,846,3,437,6094.708822,3.284659000000829,2060.4878619053884,1064.3418388329253
"147.32.84.165",2707,"77.88.21.89",25,6,372,6,372,0,0,6094.90968,9.012322999999924,330.2145295946478,0
"147.32.84.165",1155,"91.219.194.11",25,6,372,6,372,0,0,6095.109847,9.012885000000097,330.1939390106462,0
"147.32.84.165",4710,"174.133.57.141",80,17,2011,12,1428,5,583,6095.109978,178.16108499999973,64.12174690112612,26.178556332882724
"147.32.84.165",4873,"205.188.190.1",25,6,372,6,372,0,0,6095.110036,9.01281999999992,330.1963203525674,0
"147.32.84.165",4686,"187.38.130.143",6667,6,372,6,372,0,0,6098.514423,9.014225000000806,330.1448543829041,0
"147.32.84.165",2716,"77.88.21.89",25,6,372,6,372,0,0,6102.620578,9.01264699999956,330.2026585530472,0
"147.32.84.165",1160,"194.85.217.2",25,6,372,6,372,0,0,6102.620656,9.01269400000001,330.2009365901024,0
"147.32.84.165",4874,"209.85.225.27",25,6,372,6,372,0,0,6102.720884,9.012315999999373,330.2147860772089,0
"147.32.84.165",2719,"81.177.3.190",25,6,372,6,372,0,0,6103.321209,9.012883000000329,330.1940122821844,0
"147.32.84.165",1165,"194.85.217.2",25,6,372,6,372,0,0,6105.324116,8.913002000000233,333.8942367565857,0
"147.32.84.165",4875,"98.137.54.238",25,6,372,6,372,0,0,6105.32422,8.912956999999551,333.89592253167496,0
"147.32.84.165",4690,"212.117.171.138",65500,127,84796,82,4924,45,79872,6106.926649,20.9763810000004,1877.9216491157006,30461.689268515278
"147.32.84.165",4726,"212.117.174.7",4506,6,372,6,372,0,0,6106.926743,8.912408000000141,333.91649035815607,0
"147.32.84.165",2725,"208.101.60.120",25,6,372,6,372,0,0,6111.032492,8.913039000000026,333.89285068762644,0
"147.32.84.165",1217,"89.111.177.177",25,6,372,6,372,0,0,6115.539392,9.012456000000384,330.20965650205375,0
"147.32.84.165",4876,"68.6.19.3",25,6,372,6,372,0,0,6115.839287,9.013037000000622,330.1883704682223,0
"147.32.84.165",4725,"67.195.168.31",25,6,372,6,372,0,0,6116.039423,9.013184999999794,330.1829486469065,0
"147.32.84.165",2727,"208.101.60.120",25,6,372,6,372,0,0,6119.444916,9.012955999999576,330.1913378918237,0
"147.32.84.165",1219,"89.111.177.177",25,6,372,6,372,0,0,6119.445047,9.012950000000274,330.19155770307276,0
"147.32.84.165",4877,"62.73.4.12",25,6,372,6,372,0,0,6119.445106,9.012944000000061,330.1917775146478,0
"147.32.84.165",4752,"31.192.109.167",80,15,1540,10,1050,5,490,6123.55026,0.24705300000005082,34000.8014474557,15867.040675479326
"147.32.84.165",4758,"212.117.174.7",4506,6,372,6,372,0,0,6123.63237,8.931023999999525,333.22046833601144,0
"147.32.84.165",4730,"62.152.241.162",6667,6,372,6,372,0,0,6123.632433,8.931089000000611,333.21804317477927,0
"147.32.84.165",2742,"194.85.217.2",25,6,372,6,372,0,0,6123.650435,9.01304700000037,330.1880041233423,0
"147.32.84.165",1223,"81.211.26.66",25,6,372,6,372,0,0,6124.251534,9.012743999999657,330.1991047343754,0
"147.32.84.165",4878,"205.188.59.194",25,6,372,6,372,0,0,6126.254154,9.014458999999988,330.1362843848981,0
"147.32.84.165",2743,"194.85.217.2",25,6,372,6,372,0,0,6127.856533,9.012872999999672,330.19437864043,0
"147.32.84.165",1243,"62.231.15.143",25,6,372,6,372,0,0,6127.856633,9.012896999999612,330.1934993820664,0
"147.32.84.165",4879,"74.6.136.65",25,6,372,6,372,0,0,6131.962772,9.012502000000495,330.20797110500905,0
"147.32.84.165",4741,"212.117.171.138",65500,121,84454,80,4804,41,79650,6136.569344,10.76116600000023,3571.360203903478,59212.91428828311
"147.32.84.165",4784,"212.117.174.7",4506,6,372,6,372,0,0,6136.569475,9.012431999999535,330.2105358465011,0
"147.32.84.165",2744,"62.109.21.242",25,6,372,6,372,0,0,6136.869593,9.015956999999617,330.0814322872355,0
"147.32.84.165",1245,"94.245.160.209",25,6,372,6,372,0,0,6137.06969,9.013151000000107,330.1841941846935,0
"147.32.84.165",4786,"174.133.57.141",80,17,3489,12,1428,5,2061,6140.474662,0.7282150000000911,15687.67465652118,22641.664892920275
"147.32.84.165",4880,"207.115.37.23",25,6,372,6,372,0,0,6140.474796,9.012810999999601,330.1966500795514,0
"147.32.84.165",4773,"124.123.78.67",6667,6,372,6,372,0,0,6144.580724,9.015047999999297,330.1147148634408,0
"147.32.84.165",2755,"62.109.21.242",25,6,372,6,372,0,0,6144.680898,9.012831000000006,330.1959173538257,0
"147.32.84.165",1269,"67.195.168.31",25,6,372,6,372,0,0,6144.681029,9.012824999999793,330.1961371712053,0
"147.32.84.165",4881,"64.207.35.180",25,6,372,6,372,0,0,6145.28174,9.013003999999455,330.1895794121671,0
"147.32.84.165",2756,"194.28.172.37",25,6,372,6,372,0,0,6147.284528,9.012915000000248,330.19283994134173,0
"147.32.84.165",1286,"92.63.96.236",25,6,372,6,372,0,0,6148.886811,9.012955999999576,330.1913378918237,0
"147.32.84.165",4828,"174.133.57.141",80,17,3489,12,1428,5,2061,6152.992575,6.103783999999905,1871.6258635626978,2701.275143419272
"147.32.84.165",4882,"205.188.190.1",25,6,372,6,372,0,0,6152.992716,9.013232000000244,330.18122688952417,0
"147.32.84.165",4825,"212.117.174.7",4506,6,372,6,372,0,0,6157.599279,9.013192999999774,330.1826555805556,0
"147.32.84.165",4792,"212.117.171.138",65500,294,217130,190,11412,104,205718,6157.899901,105.44057900000007,865.8526050013434,15608.260269511598
"147.32.84.165",2759,"194.28.172.37",25,6,372,6,372,0,0,6157.92335,8.989430999999968,331.0554361004618,0
"147.32.84.165",1302,"92.63.96.236",25,6,372,6,372,0,0,6157.923411,8.989504000000125,331.05274773780167,0
"147.32.84.165",4883,"207.115.36.22",25,6,372,6,372,0,0,6157.923467,8.989511000000675,331.0524899518757,0
"147.32.84.165",4809,"220.181.65.141",6667,3,184,2,124,1,60,6158.099894,0.3171860000002198,3127.502474886384,1513.307649138573
"147.32.84.165",2761,"66.230.175.168",25,6,372,6,372,0,0,6161.504891,9.013119000000188,330.1853664641439,0
"147.32.84.165",1308,"91.206.222.71",25,6,372,6,372,0,0,6165.610789,9.013073999999506,330.1870149962336,0
"147.32.84.165",4884,"209.85.225.27",25,6,372,6,372,0,0,6165.711008,9.01279599999998,330.19719962595474,0
"147.32.84.165",1060,"212.117.174.7",4506,6,372,6,372,0,0,6166.312034,9.012691000000814,330.2010465020637,0
"147.32.84.165",2764,"66.230.175.168",25,6,372,6,372,0,0,6166.312165,9.012684999999692,330.2012663263058,0
"147.32.84.165",1322,"95.163.16.202",25,6,372,6,372,0,0,6166.312223,9.012676000000283,330.20159606313445,0
"147.32.84.165",4886,"65.55.92.152",25,6,372,6,372,0,0,6168.318053,9.009627999999793,330.3133048334591,0
"147.32.84.165",1113,"178.150.146.54",6667,6,372,6,372,0,0,6169.916989,9.013127999999597,330.18503675972795,0
"147.32.84.165",2767,"195.137.160.20",25,6,372,6,372,0,0,6170.317721,9.013055999999779,330.1876744136587,0
"147.32.84.165",1427,"178.162.163.199",25,6,372,6,372,0,0,6174.026511,8.909262999999555,334.03436400969963,0
"147.32.84.165",1114,"174.133.57.141",80,16,3429,12,1428,4,2001,6178.629752,0.490219000000252,23303.870311012277,32654.79306185964
"147.32.84.165",4887,"64.12.90.1",25,6,372,6,372,0,0,6178.629849,8.91268300000047,333.9061873960785,0
"147.32.84.165",2768,"195.137.160.20",25,6,372,6,372,0,0,6178.930236,8.912792000000081,333.9021038525271,0
"147.32.84.165",1449,"93.170.48.61",25,6,372,6,372,0,0,6178.930273,8.91287900000043,333.89884458207683,0
"147.32.84.165",4888,"209.85.225.27",25,6,372,6,372,0,0,6182.535239,9.013834999999744,330.1591387017939,0
"147.32.84.165",2769,"178.218.212.130",25,6,372,6,372,0,0,6182.535375,9.013821999999891,330.1596148670382,0
"147.32.84.165",1533,"78.24.218.162",25,6,372,6,372,0,0,6186.540919,9.012877000000117,330.19423209702757,0
"147.32.84.165",4889,"98.137.54.238",25,6,372,6,372,0,0,6186.641015,9.012907999999697,330.19309639021054,0
"147.32.84.165",2182,"212.117.174.7",4506,6,372,6,372,0,0,6187.242171,9.01291399999991,330.19287657687954,0
"147.32.84.165",2774,"79.175.59.70",25,6,372,6,372,0,0,6189.244803,9.01290600000084,330.1931696613415,0
"147.32.84.165",1537,"209.85.225.27",25,6,372,6,372,0,0,6191.24767,9.013150000000678,330.1842308182795,0
"147.32.84.165",2530,"174.133.57.141",80,17,3489,12,1428,5,2061,6191.347805,1.16261299999951,9826.141630968184,14181.847269905762
"147.32.84.165",4890,"203.188.197.119",25,6,372,6,372,0,0,6191.347923,9.012907999999697,330.19309639021054,0
"147.32.84.165",2531,"217.19.6.21",6667,4,248,4,248,0,0,6194.95361,3.003950000000259,660.4637227649691,0
"147.32.84.165",2545,"212.117.174.7",4506,6,372,6,372,0,0,6199.560066,9.012756000000081,330.1986650920066,0
"147.32.84.165",2827,"217.72.192.149",25,6,372,6,372,0,0,6199.560201,9.012748000000101,330.19895818677793,0
"147.32.84.165",1551,"174.122.29.35",25,6,372,6,372,0,0,6199.860409,9.01280399999996,330.1969065343053,0
"147.32.84.165",2652,"174.133.57.141",80,17,3489,12,1428,5,2061,6203.565375,0.7734860000000481,14769.498090462257,21316.481487704983
"147.32.84.165",4891,"74.6.136.65",25,6,372,6,372,0,0,6203.56551,9.012863999999354,330.1947083635361,0
"147.32.84.165",2583,"173.192.170.88",80,26,4581,18,1526,8,3055,6207.573308,53.164544000000205,229.62672265184767,459.70487398518657
"147.32.84.165",2848,"89.111.177.200",25,6,372,6,372,0,0,6207.673678,9.010706999999456,330.27375099425376,0
"147.32.84.165",1552,"93.170.24.242",25,6,372,6,372,0,0,6207.774398,9.010089000000335,330.296404397325,0
"147.32.84.165",4892,"186.215.209.178",25,6,372,6,372,0,0,6208.272352,9.012703000000329,330.2006068545576,0
"147.32.84.165",2865,"91.218.38.36",25,6,372,6,372,0,0,6210.274973,9.01349300000038,330.17166596788553,0
"147.32.84.165",1562,"195.88.207.18",25,6,372,6,372,0,0,6212.278615,9.012471000000005,330.2091069141857,0
"147.32.84.165",4893,"64.12.139.193",25,6,372,6,372,0,0,6212.37869,9.012570000000778,330.20547968001836,0
"147.32.84.165",2707,"114.57.53.106",6667,6,372,6,372,0,0,6212.378796,9.012587000000167,330.20485682967,0
"147.32.84.165",2881,"81.30.112.202",25,6,372,6,372,0,0,6220.589759,9.013402999999926,330.1749627748836,0
"147.32.84.165",1563,"195.88.207.18",25,6,372,6,372,0,0,6220.892033,9.011257999999543,330.2535561627634,0
"147.32.84.165",2743,"174.133.57.141",80,17,3489,12,1428,5,2061,6220.892163,1.0921299999999974,10460.29318853985,15097.103824636297
"147.32.84.165",4894,"209.85.225.27",25,6,372,6,372,0,0,6220.892219,9.01119800000015,330.25575511712765,0
"147.32.84.165",2742,"212.117.174.7",4506,6,372,6,372,0,0,6224.595628,9.013082000000395,330.18672192263085,0
"147.32.84.165",3912,"212.117.174.7",4506,6,372,6,372,0,0,6228.701503,9.011214000000109,330.25516872642953,0
"147.32.84.165",2899,"85.233.144.10",25,6,372,6,372,0,0,6228.701638,9.011435000000347,330.24706941789907,0
"147.32.84.165",1569,"193.104.248.2",25,6,372,6,372,0,0,6228.801625,9.010932000000139,330.2655041675993,0
"147.32.84.165",4895,"64.207.35.180",25,6,372,6,372,0,0,6229.30263,9.011631000000307,330.2398866531373,0
"147.32.84.165",2911,"88.212.221.10",25,6,372,6,372,0,0,6231.305184,9.01579000000038,330.08754640468277,0
"147.32.84.165",1661,"212.59.98.21",25,6,372,6,372,0,0,6233.308677,8.918864999999641,333.67474448824146,0
"147.32.84.165",4447,"98.126.71.122",80,19,5027,14,1540,5,3487,6233.408862,17.15572400000019,718.1276639796644,1626.0462105825256
"147.32.84.165",4427,"174.133.57.141",80,16,3429,12,1428,4,2001,6233.409029,0.4880439999997179,23407.72553295728,32800.321282526274
"147.32.84.165",4896,"64.12.90.1",25,6,372,6,372,0,0,6233.409088,8.919323000000077,333.6576105607987,0
"147.32.84.165",4410,"207.232.61.93",6667,4,248,4,248,0,0,6233.583735,2.9248569999999745,678.3237607855759,0
"147.32.84.165",2951,"195.24.65.155",25,6,372,6,372,0,0,6241.626062,8.930358999999953,333.24528162865744,0
"147.32.84.165",1662,"74.54.79.106",25,6,372,6,372,0,0,6241.926969,8.930575000000317,333.2372215674684,0
"147.32.84.165",4564,"195.113.232.98",80,23,8093,16,4332,7,3761,6245.539072,7.697398000000248,4502.300647569332,3908.853355380484
"147.32.84.165",4690,"174.133.57.141",80,17,2011,12,1428,5,583,6245.539211,135.77120299999933,84.14155393467388,34.35190892431014
"147.32.84.165",4897,"207.115.37.23",25,6,372,6,372,0,0,6245.704284,8.973708999999872,331.63544750560135,0
"147.32.84.165",4689,"31.192.109.167",80,15,1540,10,1050,5,490,6249.653315,0.24954200000047422,33661.66817603464,15708.7784821495
"147.32.84.165",2963,"74.52.75.130",25,6,372,6,372,0,0,6249.734987,8.94861899999978,332.5652818608182,0
"147.32.84.165",1724,"178.162.190.126",25,6,372,6,372,0,0,6249.753629,9.029958000000079,329.56963919433224,0
"147.32.84.165",4726,"195.113.232.96",80,13,2906,10,1884,3,1022,6250.255108,2.981463000000076,5055.236305129265,2742.277868281374
"147.32.84.165",4898,"62.149.205.244",25,6,372,6,372,0,0,6250.255927,9.028260999999475,329.63158685821924,0
"147.32.84.165",4811,"212.117.174.7",4506,6,372,6,372,0,0,6252.061778,9.025590999999622,329.7291002882941,0
"147.32.84.165",4686,"212.117.171.138",65500,14,846,10,604,4,242,6252.26164,151.20142100000066,31.95737161755893,12.804112469286856
"147.32.84.165",2975,"64.202.126.109",25,6,372,6,372,0,0,6252.261774,9.025543000000653,329.7308538666078,0
"147.32.84.165",1772,"178.63.49.46",25,6,372,6,372,0,0,6254.27684,9.04122499999994,329.1589358742891,0
"147.32.84.165",4899,"193.252.22.185",25,6,372,6,372,0,0,6254.377037,9.013165999999728,330.1836446815791,0
"147.32.84.165",4840,"173.192.170.88",80,11,1283,8,846,3,437,6262.589162,25.267612999999983,267.8527647229679,138.35893402356615
"147.32.84.165",4791,"98.139.212.139",587,23,18112,16,17540,7,572,6262.790168,0.5396489999993719,260020.86541467384,8479.585804857095
"147.32.84.165",4827,"212.117.174.7",4506,6,372,6,372,0,0,6262.889381,9.01338399999986,330.17565877588777,0
"147.32.84.165",3001,"195.19.204.76",25,6,372,6,372,0,0,6262.889514,9.01337699999931,330.1759151980693,0
"147.32.84.165",1789,"72.14.213.27",25,6,372,6,372,0,0,6262.903258,8.999680999999327,330.6783873784218,0
"147.32.84.165",4900,"209.85.225.27",25,6,372,6,372,0,0,6266.695063,9.01264699999956,330.2026585530472,0
"147.32.84.165",4820,"79.140.237.191",6667,6,372,6,372,0,0,6270.700519,9.01288999999997,330.19375583192624,0
"147.32.84.165",3028,"194.85.88.229",25,6,372,6,372,0,0,6270.800685,9.014959999999519,330.1179372953578,0
"147.32.84.165",1904,"74.125.39.27",25,6,372,6,372,0,0,6271.303167,9.011389000000236,330.2487552140877,0
"147.32.84.165",4901,"207.115.21.22",25,6,372,6,372,0,0,6273.104001,9.012920000000122,330.1926567638412,0
"147.32.84.165",3034,"195.54.209.178",25,6,372,6,372,0,0,6273.304302,9.014372000000549,330.139470614239,0
"147.32.84.165",1961,"74.125.127.27",25,6,372,6,372,0,0,6275.307619,9.013159999999516,330.18386448261873,0
"147.32.84.165",4903,"66.94.237.64",25,6,372,6,372,0,0,6275.407366,9.013000999999349,330.1896893166011,0
"147.32.84.165",4867,"212.117.174.7",4506,6,372,6,372,0,0,6283.920169,9.012614999999641,330.2038309636125,0
"147.32.84.165",4860,"61.17.216.94",6667,15,1768,10,1210,5,558,6283.92031,1.0543179999995118,9181.290654247088,4234.01668187593
"147.32.84.165",3036,"213.189.198.7",25,6,372,6,372,0,0,6284.11268,8.920498999999836,333.61362408090116,0
"147.32.84.165",1979,"74.125.157.27",25,6,372,6,372,0,0,6287.725026,8.913400000000365,333.8793277537054,0
"147.32.84.165",4878,"174.133.57.141",80,16,3429,12,1428,4,2001,6291.730688,0.4630890000007639,24669.124077620403,34567.869243220186
"147.32.84.165",4904,"93.103.2.3",25,6,372,6,372,0,0,6291.730839,8.913261000000603,333.88453451545945,0
"147.32.84.165",4948,"212.117.174.7",4506,6,372,6,372,0,0,6291.830834,8.91331099999934,333.8826615609195,0
"147.32.84.165",3039,"212.48.143.203",25,6,372,6,372,0,0,6291.830987,8.913281999999526,333.8837478720137,0
"147.32.84.165",1993,"209.85.229.27",25,6,372,6,372,0,0,6292.333024,8.911756000000423,333.94092028550364,0
"147.32.84.165",4905,"205.188.190.1",25,6,372,6,372,0,0,6294.13442,8.913118999999824,333.8898538210988,0
"147.32.84.165",3041,"213.189.198.9",25,6,372,6,372,0,0,6294.334674,8.913172000000486,333.88786842662046,0
"147.32.84.165",1996,"188.64.112.2",25,6,372,6,372,0,0,6296.337776,9.012651000000005,330.20251200229524,0
"147.32.84.165",4907,"209.85.225.27",25,6,372,6,372,0,0,6296.337915,9.012638000000152,330.20298829265636,0
"147.32.84.165",1302,"84.247.61.206",6667,2,124,2,124,0,0,6304.849772,1.0000000656873453e-05,0,0
"147.32.84.165",3046,"81.177.24.85",25,6,372,6,372,0,0,6304.949857,9.012857000000622,330.19496481524055,0
"147.32.84.165",2061,"188.64.112.5",25,6,372,6,372,0,0,6308.65529,9.012870999999905,330.19445191216334,0
"147.32.84.165",1661,"174.133.57.141",80,16,3429,12,1428,4,2001,6312.661269,0.4619199999997363,24731.55524767605,34655.35157605026
"147.32.84.165",4908,"205.188.146.193",25,6,372,6,372,0,0,6312.661404,9.012767999999596,330.1982254508419,0
"147.32.84.165",2652,"212.117.174.7",4506,6,372,6,372,0,0,6312.761132,9.01281199999994,330.1966134431762,0
"147.32.84.165",3050,"92.38.199.19",25,6,372,6,372,0,0,6313.261907,9.012748000000101,330.19895818677793,0
"147.32.84.165",2080,"82.146.40.5",25,6,372,6,372,0,0,6315.064282,9.01310199999989,330.1859892410001,0
"147.32.84.165",4909,"213.199.180.150",25,6,372,6,372,0,0,6315.264591,9.012993999999708,330.1899457605427,0
"147.32.84.165",2764,"111.88.31.68",6667,6,372,6,372,0,0,6317.268156,9.01239699999951,330.21181823217086,0
"147.32.84.165",3056,"92.38.199.19",25,6,372,6,372,0,0,6317.367766,9.01289799999995,330.19346274639037,0
"147.32.84.165",2082,"82.146.40.5",25,6,372,6,372,0,0,6317.367897,9.012893000000076,330.1936459247852,0
"147.32.84.165",4910,"206.46.232.11",25,6,372,6,372,0,0,6317.367958,9.012885000000097,330.1939390106462,0
"147.32.84.165",3060,"82.142.142.20",25,6,372,6,372,0,0,6317.368022,9.01287500000035,330.19430536869584,0
"147.32.84.165",2083,"91.218.229.219",25,6,372,6,372,0,0,6325.980205,9.012788,330.1974927181245,0
"147.32.84.165",3028,"174.133.57.141",80,16,3429,12,1428,4,2001,6329.685491,0.4910970000000816,23262.20685526098,32596.411706846793
"147.32.84.165",4911,"74.6.136.65",25,6,372,6,372,0,0,6329.685629,9.012927000000673,330.1924003156553,0
"147.32.84.165",2827,"212.117.174.7",4506,6,372,6,372,0,0,6333.691486,9.01266300000043,330.20207235085326,0
"147.32.84.165",3061,"83.164.192.67",25,6,372,6,372,0,0,6333.69162,9.012620000000425,330.2036477738837,0
"147.32.84.165",2091,"91.218.229.219",25,6,372,6,372,0,0,6333.791332,9.013404000000264,330.1749261433209,0
"147.32.84.165",4912,"186.215.209.178",25,6,372,6,372,0,0,6333.791465,9.013394999999946,330.1752558275786,0
"147.32.84.165",3062,"74.54.18.180",25,6,372,6,372,0,0,6334.292373,9.012727999999697,330.19969092599933,0
"147.32.84.165",2096,"79.137.226.103",25,6,372,6,372,0,0,6336.094499,9.013174000000618,330.1833516139593,0
"147.32.84.165",4914,"74.6.136.244",25,6,372,6,372,0,0,6336.297064,9.010870000000068,330.2677765853883,0
"147.32.84.165",4882,"61.150.114.216",6667,15,1796,10,1238,5,558,6338.298272,1.620636999999988,6111.177271653106,2754.472469775794
"147.32.84.165",3071,"74.54.18.180",25,6,372,6,372,0,0,6338.398258,9.012611000000106,330.2039775155019,0
"147.32.84.165",2098,"79.137.226.103",25,6,372,6,372,0,0,6338.398349,9.012644000000364,330.20276846615485,0
"147.32.84.165",4916,"200.147.36.15",25,6,372,6,372,0,0,6338.398386,9.012660000000324,330.202182263604,0
"147.32.84.165",3072,"174.123.87.100",25,6,372,6,372,0,0,6338.398421,9.012676000000283,330.20159606313445,0
"147.32.84.165",2139,"217.16.28.65",25,6,372,6,372,0,0,6338.6409,8.970682999999553,331.7473151152647,0
"147.32.84.165",4894,"174.133.57.141",80,17,3489,12,1428,5,2061,6347.010287,2.2350710000000618,5111.247025262143,7376.946862090531
"147.32.84.165",4917,"65.55.37.104",25,6,372,6,372,0,0,6347.010421,9.012909000000036,330.19305975462396,0
"147.32.84.165",4891,"212.117.174.7",4506,6,372,6,372,0,0,6350.715902,9.012684999999692,330.2012663263058,0
"147.32.84.165",1993,"218.248.255.243",6667,4,248,4,248,0,0,6354.721323,3.0045740000005026,660.3265554450209,0
"147.32.84.165",3085,"89.111.178.33",25,6,372,6,372,0,0,6354.823504,9.011015000000043,330.26246210887297,0
"147.32.84.165",2146,"217.16.28.65",25,6,372,6,372,0,0,6355.322928,9.012312000000748,330.2149326387894,0
"147.32.84.165",4918,"209.85.225.27",25,6,372,6,372,0,0,6355.323062,9.012304999999287,330.2151891220099,0
"147.32.84.165",3095,"89.111.178.33",25,6,372,6,372,0,0,6357.12474,8.912961999999425,333.8957352224987,0
"147.32.84.165",2155,"62.118.120.61",25,6,372,6,372,0,0,6357.124873,8.912954000000354,333.8960349172543,0
"147.32.84.165",4919,"209.85.225.27",25,6,372,6,372,0,0,6357.325014,8.912836000000425,333.9004554779038,0
"147.32.84.165",3098,"87.120.70.1",25,6,372,6,372,0,0,6357.325151,8.912830999999642,333.9006427924101,0
"147.32.84.165",2157,"195.128.50.36",25,6,372,6,372,0,0,6359.428601,8.912851000000046,333.89989353574794,0
"147.32.84.165",3056,"174.133.57.141",80,16,3429,12,1428,4,2001,6359.428706,0.4694870000002993,24332.942126177546,34096.79075243786
"147.32.84.165",4920,"200.123.152.60",25,6,372,6,372,0,0,6359.428736,8.91283999999996,333.90030562649093,0
"147.32.84.165",3148,"92.53.104.16",25,6,372,6,372,0,0,6359.628868,8.912374000000455,333.9177642230732,0
"147.32.84.165",2159,"89.208.153.2",25,6,372,6,372,0,0,6367.940879,9.012807000000066,330.1967966250668,0
"147.32.84.165",3061,"174.133.57.141",80,16,3429,12,1428,4,2001,6371.645625,0.5222340000000258,21875.25132411799,30652.925699972056
"147.32.84.165",4921,"205.188.146.193",25,6,372,6,372,0,0,6371.645781,9.012770000000273,330.19815217740046,0
"147.32.84.165",3062,"31.192.109.167",80,15,1540,10,1050,5,490,6372.547273,0.24337800000012066,34514.21245961358,16106.632481153007
"147.32.84.165",3071,"178.150.146.54",6667,6,372,6,372,0,0,6372.6269,8.932980999999927,333.14746779378845,0
"147.32.84.165",4904,"212.117.174.7",4506,6,372,6,372,0,0,6375.752063,9.012918999999783,330.1926933993384,0
"147.32.84.165",3203,"213.171.1.198",25,6,372,6,372,0,0,6376.253019,9.01273399999991,330.19947110388813,0
"147.32.84.165",2682,"81.3.168.250",25,6,372,6,372,0,0,6378.055024,9.013143000000127,330.1844872537757,0
"147.32.84.165",4922,"209.85.225.27",25,6,372,6,372,0,0,6378.255253,9.013450999999804,330.17320446963816,0
"147.32.84.165",2146,"212.117.174.7",4506,6,372,6,372,0,0,6380.358536,9.012561999999889,330.2057727869208,0
"147.32.84.165",3307,"212.192.128.3",25,6,372,6,372,0,0,6380.358671,9.012550999999803,330.2061758097197,0
"147.32.84.165",2832,"81.9.80.10",25,6,372,6,372,0,0,6380.358736,9.012534999999843,330.20676202645,0
"147.32.84.165",4923,"205.188.103.1",25,6,372,6,372,0,0,6380.558444,9.01295299999947,330.19144779742834,0
"147.32.84.165",3413,"95.169.189.196",25,6,372,6,372,0,0,6388.970493,9.013114000000314,330.18554963355575,0
"147.32.84.165",2873,"78.110.50.88",25,6,372,6,372,0,0,6392.67627,9.012539000000288,330.20661547205566,0
"147.32.84.165",4920,"174.133.57.141",80,17,3489,12,1428,5,2061,6393.577793,3.276745999999548,3486.3855788643905,5031.8212031089
"147.32.84.165",4924,"74.125.244.10",25,6,372,6,372,0,0,6393.731519,8.958733999999822,332.1897937811368,0
"147.32.84.165",3434,"81.26.143.243",25,6,372,6,372,0,0,6396.782119,9.013644999999997,330.1660981767089,0
"147.32.84.165",2900,"69.50.196.9",25,6,372,6,372,0,0,6397.28294,9.013460999999552,330.17283815841085,0
"147.32.84.165",4925,"74.6.136.65",25,6,372,6,372,0,0,6399.085165,9.013427999999294,330.1740469885856,0
"147.32.84.165",3451,"62.183.66.246",25,6,372,6,372,0,0,6399.285366,9.013194999999541,330.18258231405747,0
"147.32.84.165",2912,"81.211.26.66",25,6,372,6,372,0,0,6401.388412,9.013702000000194,330.1640103034176,0
"147.32.84.165",4927,"209.85.225.27",25,6,372,6,372,0,0,6401.388508,9.013713999999709,330.1635707545298,0
"147.32.84.165",3504,"87.224.128.126",25,6,372,6,372,0,0,6401.58909,9.013315999999577,330.1781497508952,0
"147.32.84.165",2964,"88.198.234.174",25,6,372,6,372,0,0,6410.001477,9.012416000000485,330.211122078679,0
"147.32.84.165",4928,"209.85.225.27",25,6,372,6,372,0,0,6413.706567,9.012718999999379,330.20002065971494,0
"147.32.84.165",4922,"80.191.196.145",6667,6,372,6,372,0,0,6413.7067,9.012712000000647,330.2002771196712,0
"147.32.84.165",2146,"212.117.174.7",4506,6,372,6,372,0,0,6414.708719,9.012071000000105,330.2237632171301,0
"147.32.84.165",3506,"87.224.128.126",25,6,372,6,372,0,0,6417.812389,9.012598000000253,330.2044538100908,0
"147.32.84.165",2997,"178.162.163.199",25,6,372,6,372,0,0,6417.812521,9.012636999999813,330.2030249304462,0
"147.32.84.165",4929,"64.12.90.1",25,6,372,6,372,0,0,6418.312893,9.012773999999808,330.1980056306819,0
"147.32.84.165",4686,"212.117.171.138",65500,14,846,10,604,4,242,6420.115347,176.60602300000028,27.360335270105665,10.962253535373462
"147.32.84.165",3507,"217.16.18.91",25,6,372,6,372,0,0,6420.137787,8.991006000000198,330.99744344514227,0
"147.32.84.165",3002,"93.170.48.61",25,6,372,6,372,0,0,6420.315848,9.012901999999485,330.19331620383423,0
"147.32.84.165",4930,"209.85.225.27",25,6,372,6,372,0,0,6422.418683,9.012851999999839,330.1951479953352,0
"147.32.84.165",3508,"195.225.38.43",25,6,372,6,372,0,0,6422.418836,9.012832000000344,330.1958807176131,0
"147.32.84.165",3153,"195.16.88.67",25,6,372,6,372,0,0,6422.418918,9.012817999999243,330.1963936251958,0
"147.32.84.165",4931,"218.94.62.106",25,6,372,6,372,0,0,6422.618943,9.012887999999293,330.1938291034165,0
"147.32.84.165",4927,"61.17.216.89",6667,2,124,2,124,0,0,6431.031117,8.999999408842996e-06,0,0
"147.32.84.165",3512,"217.151.130.35",25,6,372,6,372,0,0,6434.73634,8.913187999999536,333.8872690669326,0
"147.32.84.165",3233,"193.104.248.2",25,6,372,6,372,0,0,6435.638201,9.012740000000122,330.1992512820696,0
"147.32.84.165",4933,"205.188.190.1",25,6,372,6,372,0,0,6438.742157,9.013475000000653,330.1723253240048,0
"147.32.84.165",4928,"212.117.174.7",4506,6,372,6,372,0,0,6439.242855,9.013334999999643,330.17745373938925,0
"147.32.84.165",3538,"89.108.79.57",25,6,372,6,372,0,0,6441.045932,9.012533000000076,330.2068353036793,0
"147.32.84.165",3320,"88.198.12.76",25,6,372,6,372,0,0,6441.247684,9.011013000000275,330.26253541082554,0
"147.32.84.165",4934,"216.200.145.235",25,6,372,6,372,0,0,6443.349145,9.012980999999854,330.1904220146529,0
"147.32.84.165",3546,"88.212.221.10",25,6,372,6,372,0,0,6443.349245,9.013006999999561,330.18946950780634,0
"147.32.84.165",3423,"178.63.49.46",25,6,372,6,372,0,0,6443.549091,9.013205000000198,330.18221598198807,0
"147.32.84.165",4935,"209.171.54.132",25,6,372,6,372,0,0,6445.251869,9.01273300000048,330.1995077408641,0
"147.32.84.165",4930,"78.249.161.87",6667,6,372,6,372,0,0,6455.66658,9.013017000000218,330.18910316045424,0
"147.32.84.165",3569,"209.85.229.27",25,6,372,6,372,0,0,6456.667901,9.01303900000039,330.1882971991879,0
"147.32.84.165",3432,"74.125.39.27",25,6,372,6,372,0,0,6459.772307,9.014592999999877,330.1313769795309,0
"147.32.84.165",4936,"207.115.36.22",25,6,372,6,372,0,0,6460.273544,9.013107000000673,330.18580607106713,0
"147.32.84.165",4933,"212.117.174.7",4506,6,372,6,372,0,0,6462.076022,9.012509000000136,330.2077146330678,0
"147.32.84.165",3592,"92.53.104.16",25,6,372,6,372,0,0,6462.276422,9.012348000000202,330.2136135888154,0
"147.32.84.165",3471,"74.125.43.27",25,6,372,6,372,0,0,6464.379371,9.013417000000118,330.17444993391086,0
"147.32.84.165",4937,"67.231.144.94",25,6,372,6,372,0,0,6464.379513,9.01339999999982,330.17507266958745,0
"147.32.84.165",3613,"74.125.43.27",25,6,372,6,372,0,0,6464.579396,9.013589999999567,330.1681128163299,0
"147.32.84.165",3510,"85.214.220.206",25,6,372,6,372,0,0,6464.579527,9.013582999999926,330.1683692267575,0
"147.32.84.165",4938,"209.85.225.27",25,6,372,6,372,0,0,6466.281909,9.013355999999476,330.17668446693693,0
"147.32.84.165",4934,"79.119.209.87",6667,6,372,6,372,0,0,6476.696834,9.013051999999334,330.1878209512405,0
"147.32.84.165",3619,"195.19.204.76",25,6,372,6,372,0,0,6477.698139,9.012950999999703,330.19152106786095,0
"147.32.84.165",3515,"109.70.26.36",25,6,372,6,372,0,0,6480.802657,9.013017999999647,330.1890665257871,0
"147.32.84.165",4939,"74.6.136.65",25,6,372,6,372,0,0,6481.303293,9.013294000000315,330.17895566259085,0
"147.32.84.165",3629,"46.4.54.212",25,6,372,6,372,0,0,6483.105994,9.013857000000826,330.1583328867684,0
"147.32.84.165",3540,"109.70.26.36",25,6,372,6,372,0,0,6483.306332,9.012955000000147,330.19137452699493,0
"147.32.84.165",4940,"64.12.90.98",25,6,372,6,372,0,0,6483.306486,9.012907999999697,330.19309639021054,0
"147.32.84.165",3680,"92.38.225.40",25,6,372,6,372,0,0,6485.409296,9.013326000000234,330.17778342866137,0
"147.32.84.165",3564,"86.111.9.178",25,6,372,6,372,0,0,6485.409435,9.013312000000042,330.17829627998964,0
"147.32.84.165",4941,"209.85.225.27",25,6,372,6,372,0,0,6485.609544,9.013278999999784,330.17950515013143,0
"147.32.84.165",3687,"74.125.39.27",25,6,372,6,372,0,0,6485.60968,9.013268000000608,330.1799081087791,0
"147.32.84.165",3572,"67.228.59.198",25,6,372,6,372,0,0,6487.312401,9.012776999999915,330.19789572071164,0
"147.32.84.165",4942,"98.137.54.237",25,6,372,6,372,0,0,6497.726887,8.912930000000415,333.8969340048515,0
"147.32.84.165",3613,"85.185.226.13",6667,6,372,6,372,0,0,6498.728696,8.912661000000298,333.9070116096529,0
"147.32.84.165",4934,"173.192.170.88",80,51,6712,32,2366,19,4346,6501.832913,41.12079799999992,460.30235113627987,845.5088833635978
"147.32.84.165",3690,"74.125.127.27",25,6,372,6,372,0,0,6502.033772,8.913523000000168,333.87472046686185,0
"147.32.84.165",3596,"67.228.59.198",25,6,372,6,372,0,0,6502.333489,8.91559899999993,333.79697763437133,0
"147.32.84.165",4943,"195.144.11.30",25,6,372,6,372,0,0,6502.333638,8.915477999999894,333.80150789447697,0
"147.32.84.165",4939,"212.117.174.7",4506,6,372,6,372,0,0,6504.136308,8.913322000000335,333.8822495136929,0
"147.32.84.165",3723,"209.85.225.27",25,6,372,6,372,0,0,6504.336586,8.913047999999435,333.8925135374777,0
"147.32.84.165",3614,"64.191.120.172",25,6,372,6,372,0,0,6506.339273,9.012838999999985,330.1956242644526,0
"147.32.84.165",4944,"64.12.90.65",25,6,372,6,372,0,0,6506.339483,9.012690999999904,330.20104650209703,0
"147.32.84.165",3757,"72.14.213.27",25,6,372,6,372,0,0,6506.539654,9.016669999999976,330.0553308483074,0
"147.32.84.165",3626,"89.145.85.120",25,6,372,6,372,0,0,6508.242635,9.013766000000032,330.1616660561179,0
"147.32.84.165",4945,"98.137.54.238",25,6,372,6,372,0,0,6518.656967,9.012972999999874,330.19071509479073,0
"147.32.84.165",3764,"74.125.157.27",25,6,372,6,372,0,0,6519.658598,9.01303199999984,330.1885536410004,0
"147.32.84.165",3656,"89.145.85.120",25,6,372,6,372,0,0,6522.963467,9.014681000000564,330.12815428519474,0
"147.32.84.165",4946,"124.108.110.37",25,6,372,6,372,0,0,6522.9636,9.014674000000014,330.12841063359537,0
"147.32.84.165",3613,"212.117.174.7",4506,6,372,6,372,0,0,6523.264101,9.013001000000259,330.18968931656775,0
"147.32.84.165",3819,"89.111.176.226",25,6,372,6,372,0,0,6523.264232,9.012922999999319,330.1925468574651,0
"147.32.84.165",3681,"188.40.117.142",25,6,372,6,372,0,0,6525.066433,9.013340999999855,330.1772339468847,0
"147.32.84.165",4947,"209.85.225.27",25,6,372,6,372,0,0,6525.266622,9.01326599999993,330.17998137412377,0
"147.32.84.165",3832,"188.40.60.12",25,6,372,6,372,0,0,6527.369523,9.013256999999612,330.180311068477,0
"147.32.84.165",3688,"188.40.117.142",25,6,372,6,372,0,0,6527.36966,9.013245000000097,330.18075066193893,0
"147.32.84.165",4949,"66.94.237.64",25,6,372,6,372,0,0,6527.36972,9.013234000000011,330.18115362366007,0
"147.32.84.165",3846,"188.40.60.12",25,6,372,6,372,0,0,6527.569798,9.013186999999562,330.18287538027835,0
"147.32.84.165",3694,"87.118.92.232",25,6,372,6,372,0,0,6527.56993,9.01317999999992,330.18313181363584,0
"147.32.84.165",4950,"74.6.136.65",25,6,372,6,372,0,0,6529.272652,9.013230000000476,330.18130015542073,0
"147.32.84.165",3626,"212.117.174.7",4506,6,372,6,372,0,0,6539.687243,9.01346999999987,330.17250847898123,0
"147.32.84.165",3887,"188.40.54.222",25,6,372,6,372,0,0,6540.688718,9.013348999999835,330.17694089067834,0
"147.32.84.165",3749,"64.191.120.172",25,6,372,6,372,0,0,6543.993564,9.012891999999738,330.1936825605018,0
"147.32.84.165",4951,"205.188.146.193",25,6,372,6,372,0,0,6544.293881,9.013148000000001,330.1843040855425,0
"147.32.84.165",3901,"188.40.54.222",25,6,372,6,372,0,0,6546.096522,9.013243999999759,330.1807872947942,0
"147.32.84.165",3762,"86.111.9.178",25,6,372,6,372,0,0,6546.096661,9.013229000000138,330.18133678839786,0
"147.32.84.165",4952,"209.85.225.27",25,6,372,6,372,0,0,6546.296808,9.012995000000046,330.1899091256552,0
"147.32.84.165",3905,"94.229.67.92",25,6,372,6,372,0,0,6548.400399,9.01231000000007,330.2150059196784,0
"147.32.84.165",3774,"95.163.15.194",25,6,372,6,372,0,0,6548.40054,9.01229500000045,330.21555552718274,0
"147.32.84.165",4953,"71.74.56.243",25,6,372,6,372,0,0,6548.60014,9.012904000000162,330.1932429325716,0
"147.32.84.165",4949,"212.117.174.7",4506,6,372,6,372,0,0,6550.30314,9.012351000000308,330.21350366845434,0
"147.32.84.165",3951,"77.246.107.36",25,6,372,6,372,0,0,6550.303281,9.01233400000001,330.2141265514568,0
"147.32.84.165",3821,"82.138.17.133",25,6,372,6,372,0,0,6560.71856,9.01225599999998,330.21698451530966,0
"147.32.84.165",4954,"205.188.190.1",25,6,372,6,372,0,0,6561.718886,9.014251999999942,330.143865514301,0
"147.32.84.165",3957,"89.111.176.149",25,6,372,6,372,0,0,6565.024418,9.012512000000243,330.2076047166339,0
"147.32.84.165",3835,"85.214.220.206",25,6,372,6,372,0,0,6565.324528,9.012856000000284,330.1950014512499,0
"147.32.84.165",4955,"68.6.19.3",25,6,372,6,372,0,0,6567.127292,8.912671000000046,333.90663696662705,0
"147.32.84.165",3985,"194.85.88.229",25,6,372,6,372,0,0,6567.327065,8.913138999999319,333.88910461288975,0
"147.32.84.165",3844,"89.108.70.21",25,6,372,6,372,0,0,6569.429984,8.913118999999824,333.8898538210988,0
"147.32.84.165",4956,"209.85.225.27",25,6,372,6,372,0,0,6569.430057,8.91316900000038,333.88798080681215,0
"147.32.84.165",4009,"89.111.176.149",25,6,372,6,372,0,0,6569.631207,8.912319999999454,333.9197874403278,0
"147.32.84.165",3847,"94.245.160.209",25,6,372,6,372,0,0,6569.631277,8.912386999999399,333.9172771559629,0
"147.32.84.165",4957,"183.79.29.229",25,6,372,6,372,0,0,6571.333605,9.012110000000575,330.22233417033414,0
"147.32.84.165",4017,"195.225.241.72",25,6,372,6,372,0,0,6581.647629,9.01351700000032,330.1707868304785,0
"147.32.84.165",3871,"188.138.114.90",25,6,372,6,372,0,0,6582.649599,9.014454000000114,330.1364674998577,0
"147.32.84.165",4958,"66.94.237.64",25,6,372,6,372,0,0,6585.954165,9.012603999999556,330.20423398167134,0
"147.32.84.165",4046,"85.17.228.47",25,6,372,6,372,0,0,6586.354466,9.013106000000334,330.18584270504414,0
"147.32.84.165",3889,"195.9.14.110",25,6,372,6,372,0,0,6588.056916,9.01303900000039,330.1882971991879,0
"147.32.84.165",4959,"74.6.136.65",25,6,372,6,372,0,0,6588.259138,9.011037999999644,330.2616191386739,0
"147.32.84.165",4069,"77.246.107.36",25,6,372,6,372,0,0,6590.360003,9.013084000000163,330.1866486543281,0
"147.32.84.165",3902,"195.9.14.110",25,6,372,6,372,0,0,6590.360071,9.013140000000021,330.18459715481987,0
"147.32.84.165",4960,"205.188.59.194",25,6,372,6,372,0,0,6590.3601,9.013163000000532,330.18375458202905,0
"147.32.84.165",4081,"94.229.67.92",25,6,372,6,372,0,0,6590.560345,9.013030000000072,330.18862691014857,0
"147.32.84.165",3908,"88.198.234.174",25,6,372,6,372,0,0,6592.363729,9.012233000000379,330.2178272576702,0
"147.32.84.165",4961,"209.85.225.27",25,6,372,6,372,0,0,6602.678347,9.01273399999991,330.19947110388813,0
"147.32.84.165",4956,"212.117.174.7",4506,6,372,6,372,0,0,6603.679351,9.012878000000455,330.19419546118894,0
"147.32.84.165",4686,"212.117.171.138",65500,22,1355,16,972,6,383,6606.984151,109.64472000000023,70.91996769201457,27.944802084404916
"147.32.84.165",4009,"212.117.174.7",4506,6,372,6,372,0,0,6607.006865,8.990150999999969,331.02892265102224,0
"147.32.84.165",4120,"173.241.196.95",25,6,372,6,372,0,0,6607.006928,8.990257000000383,331.0250196406925,0
"147.32.84.165",4957,"173.192.170.88",80,16,2023,12,1494,4,529,6607.385302,7.0502030000006926,1695.2703347689173,600.2664036765444
"147.32.84.165",3952,"91.206.222.72",25,6,372,6,372,0,0,6607.586025,9.011900000000423,330.2300291836195,0
"147.32.84.165",4962,"205.188.190.1",25,6,372,6,372,0,0,6609.08713,9.013686999999663,330.1645597412148,0
"147.32.84.165",4132,"173.241.196.95",25,6,372,6,372,0,0,6609.287416,9.013495000000148,330.17159270626445,0
"147.32.84.165",3958,"64.120.170.149",25,6,372,6,372,0,0,6609.287549,9.01348600000074,330.17192238383194,0
"147.32.84.165",4963,"76.96.62.116",25,6,372,6,372,0,0,6611.390708,9.012797999999748,330.197126353002,0
"147.32.84.165",4138,"89.111.176.226",25,6,372,6,372,0,0,6611.390851,9.01278000000002,330.19778581081454,0
"147.32.84.165",3987,"77.222.41.36",25,6,372,6,372,0,0,6611.590822,9.012996999999814,330.189835855938,0
"147.32.84.165",4964,"76.96.30.116",25,6,372,6,372,0,0,6613.393293,9.01297599999998,330.19060518967393,0
"147.32.84.165",4957,"79.113.153.241",6667,4,248,4,248,0,0,6623.708152,3.0044809999999416,660.3469950384238,0
"147.32.84.165",4179,"209.212.156.210",25,6,372,6,372,0,0,6624.709786,9.01302399999986,330.1888467178215,0
"147.32.84.165",4010,"195.239.166.118",25,6,372,6,372,0,0,6628.014774,9.012869999999566,330.19448854805887,0
"147.32.84.165",4966,"157.205.238.165",25,6,372,6,372,0,0,6628.615692,9.012939999999617,330.1919240558715,0
"147.32.84.165",4199,"209.212.156.210",25,6,372,6,372,0,0,6630.117434,9.012767000000167,330.1982620875415,0
"147.32.84.165",4020,"195.16.88.67",25,6,372,6,372,0,0,6630.117566,9.012760999999955,330.19848190804294,0
"147.32.84.165",4967,"212.227.101.213",25,6,372,6,372,0,0,6630.318436,9.01224700000057,330.21731428353127,0
"147.32.84.165",4207,"89.108.122.90",25,6,372,6,372,0,0,6632.421146,9.012674000000516,330.201669338071,0
"147.32.84.165",4066,"88.198.12.76",25,6,372,6,372,0,0,6632.421284,9.012604999999894,330.2041973436132,0
"147.32.84.165",4968,"218.102.23.149",25,6,372,6,372,0,0,6632.621316,9.014513000000079,330.13430675622453,0
"147.32.84.165",3987,"212.117.174.7",4506,6,372,6,372,0,0,6634.424106,9.015008999999736,330.11614297890185,0
"147.32.84.165",4235,"89.108.122.90",25,6,372,6,372,0,0,6639.330492,8.915611999999783,333.79649091953223,0
"147.32.84.165",4070,"83.136.235.194",25,6,372,6,372,0,0,6639.330627,8.915537999999287,333.7992614691607,0
"147.32.84.165",4969,"207.115.21.22",25,6,372,6,372,0,0,6645.639531,9.013260000000628,330.1802011702528,0
"147.32.84.165",4260,"85.233.128.67",25,6,372,6,372,0,0,6648.945426,9.01218499999959,330.219586038251,0
"147.32.84.165",4083,"46.4.116.200",25,6,372,6,372,0,0,6649.545655,9.013162000000193,330.1837912155508,0
"147.32.84.165",4970,"209.85.225.27",25,6,372,6,372,0,0,6651.04773,9.01388599999973,330.15727068215523,0
"147.32.84.165",4966,"212.117.174.7",4506,6,372,6,372,0,0,6651.248102,9.013358000000153,330.1766112030555,0
"147.32.84.165",4271,"81.177.1.85",25,6,372,6,372,0,0,6651.248236,9.013347999999496,330.17697752268816,0
"147.32.84.165",4124,"74.125.43.27",25,6,372,6,372,0,0,6653.350821,9.012923000000228,330.1925468574318,0
"147.32.84.165",4972,"216.32.180.22",25,6,372,6,372,0,0,6653.350961,9.012907000000268,330.19313302577194,0
"147.32.84.165",4316,"209.85.229.27",25,6,372,6,372,0,0,6653.551106,9.013009000000238,330.1893962382509,0
"147.32.84.165",4133,"209.85.225.27",25,6,372,6,372,0,0,6655.353739,9.012853000000177,330.1951113592934,0
"147.32.84.165",4973,"205.188.190.1",25,6,372,6,372,0,0,6655.353874,9.012852999999268,330.1951113593267,0
"147.32.84.165",4329,"74.125.43.27",25,6,372,6,372,0,0,6660.26165,9.012123999999858,330.22182118222594,0
"147.32.84.165",4148,"62.213.75.149",25,6,372,6,372,0,0,6660.261709,9.012228999999934,330.2179738220169,0
"147.32.84.165",4974,"74.6.136.65",25,6,372,6,372,0,0,6666.670027,9.016182999999728,330.0731584529828,0
"147.32.84.165",4969,"124.123.106.96",6667,4,248,4,248,0,0,6669.974671,3.004402999999911,660.3641388988291,0
"147.32.84.165",4235,"212.117.174.7",4506,6,372,6,372,0,0,6670.575461,9.012949999999364,330.19155770310607,0
"147.32.84.165",4347,"83.221.6.50",25,6,372,6,372,0,0,6672.077584,9.013295000000653,330.1789190301421,0
"147.32.84.165",4188,"92.53.96.75",25,6,372,6,372,0,0,6672.278516,9.012284999999792,330.2159219332354,0
"147.32.84.165",4975,"207.115.36.22",25,6,372,6,372,0,0,6674.381692,9.012297999999646,330.2154456055622,0
"147.32.84.165",4389,"92.53.96.75",25,6,372,6,372,0,0,6674.381828,9.01228700000047,330.21584865193984,0
"147.32.84.165",4201,"69.50.196.9",25,6,372,6,372,0,0,6674.381883,9.012284000000363,330.21595857386205,0
"147.32.84.165",4976,"216.32.181.178",25,6,372,6,372,0,0,6674.581798,9.012415999999575,330.2111220787123,0
"147.32.84.165",4395,"92.53.116.6",25,6,372,6,372,0,0,6676.383902,9.012897000000521,330.1934993820331,0
"147.32.84.165",4212,"95.163.16.202",25,6,372,6,372,0,0,6681.290957,9.01306199999999,330.1874546075466,0
"147.32.84.165",4978,"205.188.159.42",25,6,372,6,372,0,0,6687.700312,9.012924999999996,330.19247358654394,0
"147.32.84.165",4420,"81.177.24.21",25,6,372,6,372,0,0,6690.403969,9.013474000000315,330.1723619549905,0
"147.32.84.165",4236,"64.120.170.149",25,6,372,6,372,0,0,6691.606003,9.013120000000526,330.18532983027256,0
"147.32.84.165",4980,"71.74.56.243",25,6,372,6,372,0,0,6693.10812,9.013006000000132,330.1895061425629,0
"147.32.84.165",4235,"212.117.174.7",4506,6,372,6,372,0,0,6693.308147,9.012920000000122,330.1926567638412,0
"147.32.84.165",4440,"188.120.239.168",25,6,372,6,372,0,0,6695.412027,9.012157999999545,330.2205753605463,0
"147.32.84.165",4261,"78.24.218.162",25,6,372,6,372,0,0,6695.412169,9.012076999999408,330.22354336300003,0
"147.32.84.165",4981,"98.137.54.238",25,6,372,6,372,0,0,6695.611685,9.01583600000049,330.08586225390945,0
"147.32.84.165",4455,"77.222.41.36",25,6,372,6,372,0,0,6697.414311,9.01306299999942,330.1874179732452,0
"147.32.84.165",4277,"74.54.79.106",25,6,372,6,372,0,0,6702.321136,9.013032000000749,330.1885536409671,0
"147.32.84.165",4982,"157.205.238.165",25,6,372,6,372,0,0,6708.73077,8.913048999999774,333.89247607637697,0
"147.32.84.165",4477,"77.222.41.41",25,6,372,6,372,0,0,6711.434729,8.912349000000177,333.91870089467335,0
"147.32.84.165",4324,"83.136.235.194",25,6,372,6,372,0,0,6712.635975,8.913026000000173,333.89333768351423,0
"147.32.84.165",4983,"82.241.240.73",25,6,372,6,372,0,0,6714.038589,9.01263900000049,330.20295165487465,0
"147.32.84.165",4483,"46.38.56.73",25,6,372,6,372,0,0,6714.238914,9.012603000000126,330.20427061970423,0
"147.32.84.165",4333,"178.162.190.126",25,6,372,6,372,0,0,6716.34185,9.012918000000354,330.1927300348104,0
"147.32.84.165",4984,"209.85.225.27",25,6,372,6,372,0,0,6716.341949,9.012940000000526,330.1919240558382,0
"147.32.84.165",4516,"62.183.66.244",25,6,372,6,372,0,0,6716.541948,9.012512000000243,330.2076047166339,0
"147.32.84.165",4366,"46.4.116.200",25,6,372,6,372,0,0,6718.344461,9.012739000000693,330.1992879189968,0
"147.32.84.165",4985,"74.6.136.65",25,6,372,6,372,0,0,6723.251653,9.012539999999717,330.20657883350236,0
"147.32.84.165",4686,"212.117.174.7",4506,6,372,6,372,0,0,6729.660463,9.012872000000243,330.19441527627595,0
"147.32.84.165",4527,"194.54.148.122",25,6,372,6,372,0,0,6732.364412,9.013249000000542,330.18060413063273,0
"147.32.84.165",4392,"72.14.213.27",25,6,372,6,372,0,0,6733.566526,9.012610000000677,330.2040141534779,0
"147.32.84.165",4986,"209.85.225.27",25,6,372,6,372,0,0,6735.068477,9.014646999999968,330.12939940965083,0
"147.32.84.165",4538,"89.108.79.57",25,6,372,6,372,0,0,6735.068644,9.014541000000463,330.13328132845004,0
"147.32.84.165",4397,"62.118.120.61",25,6,372,6,372,0,0,6735.268531,9.013388000000305,330.17551224910096,0
"147.32.84.165",4987,"205.188.190.1",25,6,372,6,372,0,0,6737.371499,9.014415000000554,330.1378958035344,0
"147.32.84.165",4483,"212.117.171.138",65500,14,846,10,604,4,242,6737.371656,154.74136199999975,31.22629875779436,12.511199171169265
"147.32.84.165",4562,"91.218.38.36",25,6,372,6,372,0,0,6737.394416,8.991573000000244,330.97657106269605,0
"147.32.84.165",4424,"195.128.50.36",25,6,372,6,372,0,0,6737.57178,9.012831999999435,330.19588071764645,0
"147.32.84.165",4988,"66.94.237.64",25,6,372,6,372,0,0,6739.374338,9.014681000000564,330.12815428519474,0
"147.32.84.165",4579,"74.52.75.130",25,6,372,6,372,0,0,6744.281987,9.012692999999672,330.2009732274369,0
"147.32.84.165",4441,"89.208.153.2",25,6,372,6,372,0,0,6750.691031,9.012903999999253,330.1932429326049,0
"147.32.84.165",4991,"65.55.37.104",25,6,372,6,372,0,0,6753.39477,9.013985999999932,330.1536079598995,0
"147.32.84.165",4586,"64.202.126.109",25,6,372,6,372,0,0,6754.596829,9.012335999999777,330.21405327099137,0
"147.32.84.165",4465,"95.163.15.194",25,6,372,6,372,0,0,6756.098539,9.01351700000032,330.1707868304785,0
"147.32.84.165",4992,"212.32.224.32",25,6,372,6,372,0,0,6756.299349,9.012220000000525,330.2183035922144,0
"147.32.84.165",4616,"213.171.1.198",25,6,372,6,372,0,0,6758.401966,9.012698999999884,330.2007534036184,0
"147.32.84.165",4480,"74.125.127.27",25,6,372,6,372,0,0,6758.402106,9.012685000000602,330.2012663262725,0
"147.32.84.165",4993,"208.65.144.13",25,6,372,6,372,0,0,6758.602199,9.012886999999864,330.1938657391405,0
"147.32.84.165",4987,"212.117.174.7",4506,6,372,6,372,0,0,6760.40458,9.013193999999203,330.18261894731916,0
"147.32.84.165",4424,"114.57.53.106",6667,4,248,4,248,0,0,6765.311788,3.0041760000003705,660.4140369937564,0
"147.32.84.165",4988,"212.117.174.7",4506,6,372,6,372,0,0,6771.720816,9.012993999999708,330.1899457605427,0
"147.32.84.165",4626,"83.221.6.50",25,6,372,6,372,0,0,6771.720952,9.012983000000531,330.19034874467474,0
"147.32.84.165",4491,"74.125.157.27",25,6,372,6,372,0,0,6774.424812,8.912980000000061,333.8950609111632,0
"147.32.84.165",4994,"205.188.59.194",25,6,372,6,372,0,0,6775.627025,8.912834000000657,333.90053040366064,0
"147.32.84.165",4650,"46.4.54.212",25,6,372,6,372,0,0,6777.128639,8.91315300000042,333.8885801690894,0
"147.32.84.165",4518,"62.213.110.35",25,6,372,6,372,0,0,6777.329487,8.91259700000046,333.90940934498065,0
"147.32.84.165",4995,"209.85.225.27",25,6,372,6,372,0,0,6779.432198,8.912862999999561,333.89944398339196,0
"147.32.84.165",1179,"92.38.225.40",25,6,372,6,372,0,0,6779.432337,8.912848999999369,333.8999684612867,0
"147.32.84.165",4529,"62.213.110.35",25,6,372,6,372,0,0,6779.632562,8.91268300000047,333.9061873960785,0
"147.32.84.165",4996,"216.32.180.22",25,6,372,6,372,0,0,6779.632694,8.91267599999992,333.90644964542935,0
"147.32.84.165",4616,"120.138.121.194",6667,6,372,6,372,0,0,6781.434913,8.912749999999505,333.90367731622285,0
"147.32.84.165",1433,"74.125.39.27",25,6,372,6,372,0,0,6781.735726,8.912846000000172,333.90008084958976,0
"147.32.84.165",4537,"77.88.21.89",25,6,372,6,372,0,0,6792.65161,9.012950999999703,330.19152106786095,0
"147.32.84.165",4997,"66.94.237.139",25,6,372,6,372,0,0,6795.355493,9.012902999999824,330.1932795681989,0
"147.32.84.165",4626,"31.192.109.167",80,15,1540,10,1050,5,490,6796.556751,0.2501940000001923,33573.94661739907,15667.841754786234
"147.32.84.165",4616,"212.117.174.7",4506,6,372,6,372,0,0,6796.63828,8.931316000000152,333.20957404261026,0
"147.32.84.165",4994,"212.117.174.7",4506,6,372,6,372,0,0,6798.059093,9.014368000000104,330.1396171090381,0
"147.32.84.165",1804,"74.125.127.27",25,6,372,6,372,0,0,6798.059195,9.014388999999937,330.1388480128848,0
"147.32.84.165",4566,"77.88.21.89",25,6,372,6,372,0,0,6798.259096,9.01335199999994,330.1768309947309,0
"147.32.84.165",4998,"205.188.190.1",25,6,372,6,372,0,0,6798.259231,9.01335199999994,330.1768309947309,0
"147.32.84.165",4581,"89.108.70.32",25,6,372,6,372,0,0,6800.362171,9.01284300000043,330.1954777199445,0
"147.32.84.165",4999,"98.137.54.237",25,6,372,6,372,0,0,6800.362309,9.0128279999999,330.1960272624789,0
"147.32.84.165",2105,"209.85.225.27",25,6,372,6,372,0,0,6800.562554,9.012738000000354,330.19932455596546,0
"147.32.84.165",4595,"89.108.70.32",25,6,372,6,372,0,0,6802.66533,9.013361000000259,330.1765013073275,0
"147.32.84.165",5000,"209.85.225.27",25,6,372,6,372,0,0,6802.665472,9.013278000000355,330.17954178267695,0
"147.32.84.165",4529,"61.177.181.139",6667,6,372,6,372,0,0,6802.665544,9.013228999999228,330.18133678843117,0
"147.32.84.165",2178,"72.14.213.27",25,6,372,6,372,0,0,6802.765435,9.013184999999794,330.1829486469065,0
"147.32.84.165",4617,"188.93.212.21",25,6,372,6,372,0,0,6813.681216,9.013356000000385,330.1766844669036,0
"147.32.84.165",1025,"80.12.242.15",25,6,372,6,372,0,0,6816.38512,9.013136000000486,330.18474368963695,0
"147.32.84.165",2198,"74.125.157.27",25,6,372,6,372,0,0,6817.587346,9.014368999999533,330.13958048535113,0
"147.32.84.165",4635,"188.93.212.21",25,6,372,6,372,0,0,6819.0896,9.01260000000002,330.2043805339184,0
"147.32.84.165",1026,"216.200.145.235",25,6,372,6,372,0,0,6819.089733,9.012593000000379,330.2046370006806,0
"147.32.84.165",2297,"78.138.172.217",25,6,372,6,372,0,0,6819.289378,9.013106999999764,330.18580607110044,0
"147.32.84.165",4658,"94.229.67.92",25,6,372,6,372,0,0,6821.392311,9.014960000000428,330.1179372953245,0
"147.32.84.165",1027,"205.188.190.1",25,6,372,6,372,0,0,6821.392451,9.014947000000575,330.1184133417324,0
"147.32.84.165",2441,"78.138.172.217",25,6,372,6,372,0,0,6821.596054,9.010048000000097,330.29790740293146,0
"147.32.84.165",1221,"94.229.67.92",25,6,372,6,372,0,0,6821.596189,9.010044000000562,330.2980540383393,0
"147.32.84.165",1029,"74.6.136.65",25,6,372,6,372,0,0,6821.596249,9.01003799999944,330.29827399176173,0
"147.32.84.165",4999,"89.46.59.46",6667,4,248,4,248,0,0,6823.79591,3.004327999999987,660.3806242194623,0
"147.32.84.165",2498,"91.121.49.79",25,6,372,6,372,0,0,6823.796051,9.013337999999749,330.1773438431004,0
"147.32.84.165",1454,"194.87.0.16",25,6,372,6,372,0,0,6834.713052,9.011311999999634,330.2515771288488,0
"147.32.84.165",1030,"209.85.225.27",25,6,372,6,372,0,0,6837.415465,9.013208999999733,330.18206944941454,0
"147.32.84.165",2178,"212.117.174.7",4506,6,372,6,372,0,0,6838.617171,9.012823000000026,330.19621044371905,0
"147.32.84.165",2839,"77.221.128.102",25,6,372,6,372,0,0,6840.119351,9.01305499999944,330.1877110480503,0
"147.32.84.165",1828,"194.87.0.16",25,6,372,6,372,0,0,6840.320023,9.012804999999389,330.19686989790654,0
"147.32.84.165",1031,"136.234.80.72",25,6,372,6,372,0,0,6840.320196,9.01275700000042,330.1986284551843,0
"147.32.84.165",2851,"91.121.49.79",25,6,372,6,372,0,0,6842.422877,9.012896000000183,330.19353601771724,0
"147.32.84.165",2132,"78.46.250.193",25,6,372,6,372,0,0,6842.423013,9.012828000000809,330.19602726244557,0
"147.32.84.165",1032,"195.238.5.129",25,6,372,6,372,0,0,6842.423079,9.01278899999943,330.19745608159565,0
"147.32.84.165",2922,"77.221.128.102",25,6,372,6,372,0,0,6842.623082,9.012834000000112,330.19580744524563,0
"147.32.84.165",2180,"78.46.250.193",25,6,372,6,372,0,0,6842.623216,9.012837999999647,330.1956609006083,0
"147.32.84.165",1033,"168.61.70.72",25,6,372,6,372,0,0,6842.623277,9.012833000000683,330.19584408140867,0
"147.32.84.165",1029,"212.117.174.7",4506,6,372,6,372,0,0,6844.22511,8.913170999999238,333.8879058867214,0
"147.32.84.165",1221,"218.248.255.243",6667,6,372,6,372,0,0,6844.225247,8.913160000000062,333.8883179478411,0
"147.32.84.165",2931,"87.118.116.14",25,6,372,6,372,0,0,6844.826402,8.912361000000601,333.91825129163857,0
"147.32.84.165",2206,"209.190.61.35",25,6,372,6,372,0,0,6855.641962,9.012883000000329,330.1940122821844,0
"147.32.84.165",1034,"77.238.184.241",25,6,372,6,372,0,0,6858.345377,9.013176000000385,330.1832783471523,0
"147.32.84.165",3475,"87.118.116.14",25,6,372,6,372,0,0,6859.547582,9.40030299999944,316.58553984910674,0
"147.32.84.165",2286,"209.190.61.35",25,6,372,6,372,0,0,6859.547688,9.40338200000042,316.481878541132,0
"147.32.84.165",1035,"206.46.232.11",25,6,372,6,372,0,0,6859.54772,9.406545000000733,316.375459852663,0
"147.32.84.165",3606,"199.124.61.3",25,6,372,6,372,0,0,6861.049279,9.013057000000117,330.18763777927524,0
"147.32.84.165",2377,"77.243.96.10",25,6,372,6,372,0,0,6861.249775,9.01284299999952,330.1954777199779,0
"147.32.84.165",1036,"205.188.190.1",25,6,372,6,372,0,0,6863.35257,9.013033000000178,330.1885170064219,0
"147.32.84.165",3673,"199.124.61.3",25,6,372,6,372,0,0,6863.352709,9.013018000000557,330.1890665257538,0
"147.32.84.165",2435,"77.243.96.10",25,6,372,6,372,0,0,6863.352768,9.013014000000112,330.18921306457116,0
"147.32.84.165",1037,"205.188.59.194",25,6,372,6,372,0,0,6863.352825,9.013009000000238,330.1893962382509,0
"147.32.84.165",3766,"178.208.82.126",25,6,372,6,372,0,0,6863.55533,9.010959000000184,330.2645145760778,0
"147.32.84.165",2502,"62.213.110.156",25,6,372,6,372,0,0,6865.255421,9.01287400000001,330.19434200455885,0
"147.32.84.165",1038,"207.210.76.46",25,6,372,6,372,0,0,6865.756176,9.01296100000036,330.19115471595643,0
"147.32.84.165",1033,"116.193.128.2",6667,9,552,6,372,3,180,6876.672589,1.6311800000003132,1824.446106499239,882.7965031447931
"147.32.84.165",4058,"178.208.82.126",25,6,372,6,372,0,0,6878.304026,8.983057000000372,331.29033913509363,0
"147.32.84.165",2847,"62.213.110.156",25,6,372,6,372,0,0,6878.304059,8.983148999999685,331.2869462590573,0
"147.32.84.165",1040,"209.85.225.27",25,6,372,6,372,0,0,6878.30409,8.98317600000064,331.28595053684666,0
"147.32.84.165",4086,"87.242.79.74",25,6,372,6,372,0,0,6879.375681,9.01352499999939,330.1704937857499,0
"147.32.84.165",2855,"64.120.247.194",25,6,372,6,372,0,0,6880.57754,9.01277200000004,330.1980789040249,0
"147.32.84.165",1041,"207.115.37.23",25,6,372,6,372,0,0,6882.080037,9.013921000000664,330.1559887200898,0
"147.32.84.165",1034,"212.117.174.7",4506,6,372,6,372,0,0,6882.279847,9.013840000000528,330.15895556165026,0
"147.32.84.165",4094,"87.242.79.74",25,6,372,6,372,0,0,6884.382984,9.01307100000031,330.1871248989271,0
"147.32.84.165",2920,"64.120.247.194",25,6,372,6,372,0,0,6884.383083,9.013092000000142,330.18635558140903,0
"147.32.84.165",1042,"74.6.136.65",25,6,372,6,372,0,0,6884.383112,9.013112999999976,330.18558626747586,0
"147.32.84.165",4150,"88.198.27.35",25,6,372,6,372,0,0,6884.383148,9.013130000000274,330.18496349213973,0
"147.32.84.165",2965,"174.142.90.173",25,6,372,6,372,0,0,6884.583744,9.012535000000753,330.2067620264167,0
"147.32.84.165",1043,"66.94.237.64",25,6,372,6,372,0,0,6886.285847,9.012730999999803,330.19958101490715,0
"147.32.84.165",3673,"83.17.186.77",6667,6,372,6,372,0,0,6886.786482,9.012716999999611,330.20009393395225,0
"147.32.84.165",4263,"88.198.27.35",25,6,372,6,372,0,0,6899.304581,9.012863999999354,330.1947083635361,0
"147.32.84.165",3461,"174.142.90.173",25,6,372,6,372,0,0,6899.304727,9.012840000000324,330.1955876283051,0
"147.32.84.165",1045,"212.27.48.6",25,6,372,6,372,0,0,6899.304798,9.012823000000026,330.19621044371905,0
"147.32.84.165",3673,"212.117.171.138",65500,14,846,10,604,4,242,6900.406172,159.58268800000042,30.27897361899298,12.131641748007121
"147.32.84.165",4278,"46.4.74.165",25,6,372,6,372,0,0,6900.428637,8.990246999999727,331.0253878453051,0
"147.32.84.165",3603,"89.238.159.206",25,6,372,6,372,0,0,6901.607607,9.012974999999642,330.19064182471584,0
"147.32.84.165",1046,"205.188.190.1",25,6,372,6,372,0,0,6903.110467,9.012535999999272,330.2067253878642,0
"147.32.84.165",4365,"46.4.74.165",25,6,372,6,372,0,0,6903.310049,9.01305500000035,330.187711048017,0
"147.32.84.165",3666,"89.238.159.206",25,6,372,6,372,0,0,6903.310189,9.013039999999819,330.1882605646996,0
"147.32.84.165",1047,"75.180.132.243",25,6,372,6,372,0,0,6903.310258,9.01302399999986,330.1888467178215,0
"147.32.84.165",4452,"212.72.165.79",25,6,372,6,372,0,0,6905.4133,9.012816999999814,330.1964302614889,0
"147.32.84.165",3870,"81.26.144.245",25,6,372,6,372,0,0,6905.413449,9.012792000000445,330.1973461719579,0
"147.32.84.165",1048,"207.115.36.22",25,6,372,6,372,0,0,6905.613491,9.013429999999971,330.17397372587453,0
"147.32.84.165",4094,"85.221.145.247",6667,6,372,6,372,0,0,6907.315848,9.01287400000001,330.19434200455885,0
"147.32.84.165",4495,"212.72.165.79",25,6,372,6,372,0,0,6907.316045,9.012738000000354,330.19932455596546,0
"147.32.84.165",4056,"81.26.144.245",25,6,372,6,372,0,0,6907.316171,9.012637999999242,330.20298829268967,0
"147.32.84.165",1050,"209.85.225.27",25,6,372,6,372,0,0,6907.316288,9.012547000000268,330.2063223636905,0
"147.32.84.165",4094,"212.117.174.7",4506,6,372,6,372,0,0,6920.334618,8.912986000000274,333.8948361413233,0
"147.32.84.165",4500,"89.108.67.8",25,6,372,6,372,0,0,6921.436111,8.912935999999718,333.89670923252385,0
"147.32.84.165",4084,"194.28.172.37",25,6,372,6,372,0,0,6922.538443,9.012467999999899,330.20921683161964,0
"147.32.84.165",1051,"94.245.120.86",25,6,372,6,372,0,0,6924.040625,9.012776000000486,330.19793235733806,0
"147.32.84.165",4089,"194.28.172.37",25,6,372,6,372,0,0,6924.241877,9.012284999999792,330.2159219332354,0
"147.32.84.165",1052,"205.188.146.193",25,6,372,6,372,0,0,6924.24201,9.012275000000045,330.2162883400679,0
"147.32.84.165",4559,"89.108.67.8",25,6,372,6,372,0,0,6926.343188,9.01292900000044,330.19232704483244,0
"147.32.84.165",4243,"78.46.183.235",25,6,372,6,372,0,0,6926.343322,9.012997000000723,330.1898358559047,0
"147.32.84.165",1053,"213.228.128.59",25,6,372,6,372,0,0,6926.343386,9.01300700000047,330.18946950777297,0
"147.32.84.165",4560,"65.54.188.78",25,6,372,6,372,0,0,6926.543529,9.012931000000208,330.1922537740421,0
"147.32.84.165",4268,"78.46.183.235",25,6,372,6,372,0,0,6928.247362,9.0118480000001,330.23193467088737,0
"147.32.84.165",4452,"174.133.57.141",80,17,3489,12,1428,5,2061,6928.247489,4.166463999999905,2741.8933656933696,3957.312483679296
"147.32.84.165",1054,"74.6.136.65",25,6,372,6,372,0,0,6928.346533,9.012756000000081,330.1986650920066,0
"147.32.84.165",1048,"178.121.31.113",6667,6,372,6,372,0,0,6928.435488,8.923925999999483,333.4855085082701,0
"147.32.84.165",4641,"188.93.23.170",25,6,372,6,372,0,0,6941.264682,9.012977000000319,330.1905685546401,0
"147.32.84.165",4304,"89.188.104.6",25,6,372,6,372,0,0,6942.366228,9.013127000000168,330.1850733935009,0
"147.32.84.165",1056,"66.94.237.139",25,6,372,6,372,0,0,6943.568121,9.013105999999425,330.18584270507745,0
"147.32.84.165",4674,"81.177.26.77",25,6,372,6,372,0,0,6945.070443,9.012597000000824,330.20449044817246,0
"147.32.84.165",4394,"79.174.66.33",25,6,372,6,372,0,0,6945.270478,9.01292899999953,330.19232704486575,0
"147.32.84.165",1057,"65.54.188.126",25,6,372,6,372,0,0,6947.373443,9.013040999999248,330.18822393021935,0
"147.32.84.165",1052,"212.117.174.7",4506,6,372,6,372,0,0,6947.373583,9.013044000000264,330.1881140267276,0
"147.32.84.165",4089,"212.117.174.7",4506,6,372,6,372,0,0,6947.573724,9.013018999999986,330.1890298910947,0
"147.32.84.165",4685,"81.177.26.77",25,6,372,6,372,0,0,6947.573866,9.013030000000072,330.18862691014857,0
"147.32.84.165",4473,"79.174.66.33",25,6,372,6,372,0,0,6947.573951,9.01302299999952,330.1888833524732,0
"147.32.84.165",1059,"205.188.190.1",25,6,372,6,372,0,0,6947.574037,9.013032999999268,330.1885170064552,0
"147.32.84.165",4560,"111.253.202.95",6667,6,372,6,372,0,0,6949.376643,9.01321900000039,330.1817031184831,0
"147.32.84.165",4709,"206.123.66.59",25,6,372,6,372,0,0,6949.376785,9.013170999999602,330.18346151428074,0
"147.32.84.165",4498,"89.188.104.6",25,6,372,6,372,0,0,6962.295059,9.012665000000197,330.20199907573783,0
"147.32.84.165",1061,"209.85.225.27",25,6,372,6,372,0,0,6962.295191,9.012662000000091,330.2021089884398,0
"147.32.84.165",4721,"206.123.66.59",25,6,372,6,372,0,0,6963.396496,9.013575999999375,330.1686256376167,0
"147.32.84.165",4504,"94.75.243.11",25,6,372,6,372,0,0,6963.396637,9.013582000000497,330.16840585683207,0
"147.32.84.165",1062,"209.85.225.27",25,6,372,6,372,0,0,6964.598162,9.013294999999744,330.1789190301754,0
"147.32.84.165",4724,"195.54.162.79",25,6,372,6,372,0,0,6964.598297,9.020934000000125,329.8993208463734,0
"147.32.84.165",4558,"94.75.243.11",25,6,372,6,372,0,0,6966.10042,9.013050999999905,330.18785758563126,0
"147.32.84.165",1063,"207.115.36.22",25,6,372,6,372,0,0,6966.100557,9.013057000000117,330.18763777927524,0
"147.32.84.165",4733,"195.54.162.79",25,6,372,6,372,0,0,6966.300684,9.012959000000592,330.191227986259,0
"147.32.84.165",4570,"89.111.176.244",25,6,372,6,372,0,0,6966.30082,9.012966999999662,330.1909349052439,0
"147.32.84.165",1064,"64.59.134.8",25,6,372,6,372,0,0,6968.403972,9.012872999999672,330.19437864043,0
"147.32.84.165",4748,"77.88.21.89",25,6,372,6,372,0,0,6968.404113,9.012828000000809,330.19602726244557,0
"147.32.84.165",4642,"89.111.176.244",25,6,372,6,372,0,0,6968.604207,9.01303899999948,330.1882971992212,0
"147.32.84.165",1066,"74.6.136.65",25,6,372,6,372,0,0,6968.604346,9.013001000000259,330.18968931656775,0
"147.32.84.165",1059,"93.116.166.52",6667,6,372,6,372,0,0,6970.407039,9.01239600000008,330.2118548718868,0
"147.32.84.165",4765,"77.88.21.89",25,6,372,6,372,0,0,6970.40718,9.012389999999868,330.2120747104867,0
"147.32.84.165",4665,"178.162.137.203",25,6,372,6,372,0,0,6970.407238,9.01239600000008,330.2118548718868,0
"147.32.84.165",1067,"128.107.234.206",25,6,372,6,372,0,0,6983.325394,8.912782999999763,333.902441022078,0
"147.32.84.165",1061,"212.117.174.7",4506,6,372,6,372,0,0,6984.426684,8.913013999999748,333.8937872194618,0
"147.32.84.165",4709,"212.117.174.7",4506,6,372,6,372,0,0,6985.628405,8.913061999999627,333.8919890830025,0
"147.32.84.165",4767,"81.177.3.190",25,6,372,6,372,0,0,6985.628521,8.913095000000794,333.89075287537435,0
"147.32.84.165",4675,"178.162.137.203",25,6,372,6,372,0,0,6987.130651,8.912791999999172,333.9021038525612,0
"147.32.84.165",1068,"66.94.237.64",25,6,372,6,372,0,0,6987.130782,8.912787000000208,333.9022911688488,0
"147.32.84.165",4780,"208.101.60.120",25,6,372,6,372,0,0,6987.330968,8.912736999999652,333.9041643436933,0
"147.32.84.165",4683,"174.142.184.181",25,6,372,6,372,0,0,6989.434275,8.912646000000677,333.90757357576797,0
"147.32.84.165",1069,"205.188.59.194",25,6,372,6,372,0,0,6989.434415,8.912630000000718,333.90817300838927,0
"147.32.84.165",4798,"208.101.60.120",25,6,372,6,372,0,0,6989.634503,8.912551999999778,333.9110952732813,0
"147.32.84.165",4711,"174.142.184.181",25,6,372,6,372,0,0,6989.634624,8.912564999999631,333.910608225592,0
"147.32.84.165",1070,"205.188.103.1",25,6,372,6,372,0,0,6989.634677,8.912585000000036,333.9098589242053,0
"147.32.84.165",1066,"220.181.65.141",6667,9,552,6,372,3,180,6991.436736,1.9196090000004915,1550.3157153353823,750.1527654848625
"147.32.84.165",4804,"194.85.217.2",25,6,372,6,372,0,0,6991.436855,8.91439199999968,333.842173420252,0
"147.32.84.165",4720,"78.140.170.176",25,6,372,6,372,0,0,6993.356641,8.995879999999488,330.81810784494337,0
"147.32.84.165",1071,"216.32.181.178",25,6,372,6,372,0,0,7004.255617,9.012595000000147,330.2045637244269,0
"147.32.84.165",4819,"194.85.217.2",25,6,372,6,372,0,0,7005.357228,9.012797000000319,330.19716298945764,0
"147.32.84.165",4729,"78.140.170.176",25,6,372,6,372,0,0,7005.357361,9.012775999999576,330.19793235737137,0
"147.32.84.165",1072,"209.85.225.27",25,6,372,6,372,0,0,7005.357419,9.012746000000334,330.1990314605437,0
"147.32.84.165",4837,"62.109.21.242",25,6,372,6,372,0,0,7006.558812,9.013170999999602,330.18346151428074,0
"147.32.84.165",4732,"91.219.194.11",25,6,372,6,372,0,0,7008.061427,9.012395000000652,330.21189151161093,0
"147.32.84.165",1073,"195.2.128.120",25,6,372,6,372,0,0,7008.261581,9.012559000000692,330.20588270210175,0
"147.32.84.165",1095,"62.109.21.242",25,6,372,6,372,0,0,7010.363989,9.015022999999928,330.1156303206352,0
"147.32.84.165",4749,"91.219.194.11",25,6,372,6,372,0,0,7010.364119,9.014954000000216,330.1181570088909,0
"147.32.84.165",1074,"213.199.180.150",25,6,372,6,372,0,0,7010.364179,9.014917999999852,330.11947529639747,0
"147.32.84.165",1110,"194.28.172.37",25,6,372,6,372,0,0,7010.364242,9.014879000000292,330.12090345304733,0
"147.32.84.165",4764,"194.85.217.2",25,6,372,6,372,0,0,7010.564315,9.012997000000723,330.1898358559047,0
"147.32.84.165",1075,"209.85.227.27",25,6,372,6,372,0,0,7010.564449,9.012987999999496,330.19016556997155,0
"147.32.84.165",4683,"212.117.174.7",4506,6,372,6,372,0,0,7012.367023,9.014909999999873,330.1197682506028,0
"147.32.84.165",4798,"212.117.174.7",4506,6,372,6,372,0,0,7014.370199,9.012493999999606,330.2082642163346,0
"147.32.84.165",1518,"194.28.172.37",25,6,372,6,372,0,0,7014.370228,9.012588000000505,330.20482019147363,0
"147.32.84.165",4772,"194.85.217.2",25,6,372,6,372,0,0,7014.370257,9.012611000000106,330.2039775155019,0
"147.32.84.165",1077,"209.85.225.27",25,6,372,6,372,0,0,7025.285551,9.013038000000051,330.18833383371765,0
"147.32.84.165",2148,"66.230.175.168",25,6,372,6,372,0,0,7025.285686,9.0130079999999,330.18943287302454,0
"147.32.84.165",4789,"89.111.177.177",25,6,372,6,372,0,0,7026.3876,9.012762999999723,330.198408634521,0
"147.32.84.165",1078,"207.115.36.22",25,6,372,6,372,0,0,7027.589104,9.014854000000014,330.12181894459917,0
"147.32.84.165",2412,"66.230.175.168",25,6,372,6,372,0,0,7029.090953,9.013504000000466,330.171263029322,0
"147.32.84.165",4797,"89.111.177.177",25,6,372,6,372,0,0,7029.091082,9.013498999999683,330.1714461831198,0
"147.32.84.165",1080,"207.115.36.22",25,6,372,6,372,0,0,7029.091136,9.013496999999916,330.1715194446759,0
"147.32.84.165",2541,"195.137.160.20",25,6,372,6,372,0,0,7029.091193,9.013490999999703,330.17173922957244,0
"147.32.84.165",4807,"81.211.26.66",25,6,372,6,372,0,0,7029.291143,9.013237999999546,330.1810070920295,0
"147.32.84.165",1081,"65.54.188.110",25,6,372,6,372,0,0,7031.394336,9.013102999999319,330.1859526070239,0
"147.32.84.165",2591,"195.137.160.20",25,6,372,6,372,0,0,7031.394476,9.013089000000036,330.18646548369685,0
"147.32.84.165",4817,"62.231.15.143",25,6,372,6,372,0,0,7031.394535,9.013081000000057,330.18675855681107,0
"147.32.84.165",1082,"205.188.190.1",25,6,372,6,372,0,0,7031.594605,9.01299199999994,330.1900190303087,0
"147.32.84.165",2669,"178.218.212.130",25,6,372,6,372,0,0,7033.397212,9.013165999999728,330.1836446815791,0
"147.32.84.165",4841,"94.245.160.209",25,6,372,6,372,0,0,7035.400479,9.012432999999874,330.2104992070445,0
"147.32.84.165",1083,"74.6.136.65",25,6,372,6,372,0,0,7046.315841,9.013254000000416,330.1804209667078,0
"147.32.84.165",2700,"79.175.59.70",25,6,372,6,372,0,0,7047.419035,9.01143200000024,330.2471793606078,0
"147.32.84.165",1106,"65.54.188.72",25,6,372,6,372,0,0,7048.61908,9.013175000000047,330.1833149805684,0
"147.32.84.165",1084,"209.85.225.27",25,6,372,6,372,0,0,7050.121529,9.012619000000086,330.2036844118199,0
"147.32.84.165",4789,"212.117.174.7",4506,6,372,6,372,0,0,7050.32174,9.012710999999399,330.20031375689274,0
"147.32.84.165",2412,"212.117.174.7",4506,6,372,6,372,0,0,7052.424452,8.913566000000174,333.87310981934075,0
"147.32.84.165",3892,"67.195.168.31",25,6,372,6,372,0,0,7052.42465,8.91349100000025,333.87591909835515,0
"147.32.84.165",1140,"92.63.96.236",25,6,372,6,372,0,0,7052.424748,8.913444999999228,333.87764214624735,0
"147.32.84.165",1085,"209.85.225.27",25,6,372,6,372,0,0,7052.624876,8.912690000000111,333.9059251471736,0
"147.32.84.165",4078,"89.111.177.200",25,6,372,6,372,0,0,7052.625045,8.912646000000677,333.90757357576797,0
"147.32.84.165",1472,"92.63.96.236",25,6,372,6,372,0,0,7054.427342,8.912747999999738,333.9037522434257,0
"147.32.84.165",1086,"165.21.74.121",25,6,372,6,372,0,0,7054.427515,8.912700999999288,333.90551304259367,0
"147.32.84.165",4319,"91.218.38.36",25,6,372,6,372,0,0,7056.430605,8.912852000000385,333.89985607299116,0
"147.32.84.165",2296,"91.206.222.71",25,6,372,6,372,0,0,7067.245959,9.013386999999966,330.17554888079377,0
"147.32.84.165",1087,"66.94.237.139",25,6,372,6,372,0,0,7068.347565,9.013017999999647,330.1890665257871,0
"147.32.84.165",3673,"212.117.171.138",65500,14,846,10,604,4,242,7069.549319,30.16465000000062,160.18750424751823,64.18108613890631
"147.32.84.165",4644,"81.30.112.202",25,6,372,6,372,0,0,7069.572197,8.98977399999967,331.0428048580653,0
"147.32.84.165",2417,"95.163.16.202",25,6,372,6,372,0,0,7071.05146,9.013722000000598,330.16327772254374,0
"147.32.84.165",1088,"65.54.188.72",25,6,372,6,372,0,0,7071.251816,9.01357900000039,330.1685157471711,0
"147.32.84.165",4784,"85.233.144.10",25,6,372,6,372,0,0,7073.354874,9.012783000000127,330.19767590099065,0
"147.32.84.165",2565,"178.162.163.199",25,6,372,6,372,0,0,7073.355013,9.012788,330.1974927181245,0
"147.32.84.165",1089,"74.6.136.65",25,6,372,6,372,0,0,7073.554979,9.012971000000107,330.1907883648982,0
"147.32.84.165",2412,"123.27.93.41",6667,6,372,6,372,0,0,7075.357742,9.013358000000153,330.1766112030555,0
"147.32.84.165",4818,"88.212.221.10",25,6,372,6,372,0,0,7077.360722,9.012933999999404,330.1921438679343,0
"147.32.84.165",2588,"93.170.48.61",25,6,372,6,372,0,0,7088.276347,9.014191999999639,330.14606300821185,0
"147.32.84.165",1090,"193.252.22.142",25,6,372,6,372,0,0,7089.378022,9.01285100000041,330.19518463135194,0
"147.32.84.165",1472,"212.117.174.7",4506,6,372,6,372,0,0,7090.579915,9.012595999999576,330.204527086329,0
"147.32.84.165",4319,"212.117.174.7",4506,6,372,6,372,0,0,7092.081525,9.013064000000668,330.18738133888536,0
"147.32.84.165",4843,"195.24.65.155",25,6,372,6,372,0,0,7092.081833,9.012901000000056,330.1933528394444,0
"147.32.84.165",2688,"78.24.218.162",25,6,372,6,372,0,0,7092.28179,9.012966999999662,330.1909349052439,0
"147.32.84.165",1092,"209.85.225.27",25,6,372,6,372,0,0,7094.385108,9.012742999999318,330.1991413713034,0
"147.32.84.165",4854,"74.52.75.130",25,6,372,6,372,0,0,7094.385248,9.012669000000642,330.20185252557127,0
"147.32.84.165",2719,"209.85.225.27",25,6,372,6,372,0,0,7094.585438,9.013052999999672,330.1877843168245,0
"147.32.84.165",1094,"209.85.225.27",25,6,372,6,372,0,0,7094.58557,9.013046000000031,330.188040757807,0
"147.32.84.165",2417,"182.2.117.2",6667,8,492,6,372,2,120,7094.585628,2.402885000000424,1238.5112063205167,399.5197439743602
"147.32.84.165",4859,"64.202.126.109",25,6,372,6,372,0,0,7095.987091,9.012942999999723,330.19181414994983,0
"147.32.84.165",3702,"174.122.29.35",25,6,372,6,372,0,0,7098.391011,9.01314900000034,330.184267451907,0
"147.32.84.165",1096,"192.118.82.172",25,6,372,6,372,0,0,7109.306463,9.012889000000541,330.193792467634,0
"147.32.84.165",4818,"212.117.171.138",65500,14,846,10,604,4,242,7110.408468,2.360467000000426,2047.052553583307,820.1766853760931
"147.32.84.165",4902,"195.19.204.76",25,6,372,6,372,0,0,7110.431491,8.990007999999762,331.03418817870676,0
"147.32.84.165",4080,"93.170.24.242",25,6,372,6,372,0,0,7111.609743,9.012971000000107,330.1907883648982,0
"147.32.84.165",1097,"216.68.8.214",25,6,372,6,372,0,0,7113.112005,9.013933999999608,330.1555125653382,0
"147.32.84.165",4989,"194.85.88.229",25,6,372,6,372,0,0,7113.312532,9.013205999999627,330.1821793488491,0
"147.32.84.165",4506,"195.88.207.18",25,6,372,6,372,0,0,7115.415129,9.013543000000027,330.1698344369124,0
"147.32.84.165",1098,"205.188.103.1",25,6,372,6,372,0,0,7115.415268,9.013527000000067,330.1704205246157,0
"147.32.84.165",1094,"212.117.174.7",4506,6,372,6,372,0,0,7117.01775,9.012528000000202,330.20701849691153,0
"147.32.84.165",4843,"212.117.171.138",65500,14,846,10,604,4,242,7117.017893,47.38811600000008,101.9664930338229,40.854124692359505
"147.32.84.165",1286,"195.54.209.178",25,6,372,6,372,0,0,7117.04112,8.989282000000458,331.0609234419221,0
"147.32.84.165",4657,"195.88.207.18",25,6,372,6,372,0,0,7119.421606,9.012776000000486,330.19793235733806,0
"147.32.84.165",1099,"74.6.136.65",25,6,372,6,372,0,0,7119.42164,9.01286700000037,330.1945984557276,0
"147.32.84.165",1092,"186.110.109.63",6667,9,552,6,372,3,180,7130.337134,1.829381999999896,1626.7788794249475,787.1510706894908
"147.32.84.165",2719,"212.117.174.7",4506,6,372,6,372,0,0,7131.338514,9.01241200000004,330.2112686370737,0
"147.32.84.165",1772,"213.189.198.7",25,6,372,6,372,0,0,7131.338649,9.012405999999828,330.21148847489303,0
"147.32.84.165",4786,"193.104.248.2",25,6,372,6,372,0,0,7132.166756,8.985270000000128,331.20874497927804,0
"147.32.84.165",1100,"205.188.59.194",25,6,372,6,372,0,0,7132.540202,9.01241200000004,330.2112686370737,0
"147.32.84.165",2743,"212.48.143.203",25,6,372,6,372,0,0,7134.041965,9.01270999999997,330.2003503940557,0
"147.32.84.165",4826,"212.59.98.21",25,6,372,6,372,0,0,7134.242282,9.012749999999869,330.19888491304465,0
"147.32.84.165",1101,"209.85.225.27",25,6,372,6,372,0,0,7136.34517,9.012980000000425,330.19045864962084,0
"147.32.84.165",2761,"213.189.198.9",25,6,372,6,372,0,0,7136.345309,9.012966999999662,330.1909349052439,0
"147.32.84.165",4844,"74.54.79.106",25,6,372,6,372,0,0,7137.948067,9.012407999999596,330.2114151955985,0
"147.32.84.165",1102,"207.115.36.22",25,6,372,6,372,0,0,7137.948214,9.012386999999762,330.21218462989646,0
"147.32.84.165",1098,"113.255.129.49",6667,4,248,4,248,0,0,7140.351127,3.004015000000436,660.44943184362,0
"147.32.84.165",4484,"81.177.24.85",25,6,372,6,372,0,0,7152.368408,9.012644999999793,330.2027318284553,0
"147.32.84.165",4855,"178.162.190.126",25,6,372,6,372,0,0,7153.169698,9.013527000000067,330.1704205246157,0
"147.32.84.165",4657,"174.133.57.141",80,16,3429,12,1428,4,2001,7153.569815,0.46630800000002637,24498.82910007839,34329.24161712665
"147.32.84.165",1103,"128.107.234.206",25,6,372,6,372,0,0,7153.724333,8.959198999999899,332.1725524793046,0
"147.32.84.165",1098,"212.117.174.7",4506,6,372,6,372,0,0,7155.072736,9.012738999999783,330.1992879190301,0
"147.32.84.165",4827,"92.38.199.19",25,6,372,6,372,0,0,7155.272828,9.013127000000168,330.1850733935009,0
"147.32.84.165",4863,"178.63.49.46",25,6,372,6,372,0,0,7157.376056,9.012410000000273,330.2113419163032,0
"147.32.84.165",1104,"74.125.43.27",25,6,372,6,372,0,0,7157.376139,9.012428,330.2106824043421,0
"147.32.84.165",1101,"190.79.152.22",6667,6,372,6,372,0,0,7158.977827,9.012735000000248,330.19943446688694,0
"147.32.84.165",4826,"212.117.174.7",4506,6,372,6,372,0,0,7158.977962,9.012740000000122,330.1992512820696,0
"147.32.84.165",4889,"92.38.199.19",25,6,372,6,372,0,0,7158.978019,9.012762999999723,330.198408634521,0
"147.32.84.165",4879,"72.14.213.27",25,6,372,6,372,0,0,7158.978077,9.012815000000046,330.1965035341328,0
"147.32.84.165",1105,"209.85.225.27",25,6,372,6,372,0,0,7159.078121,9.012579000000187,330.2051499354334,0
"147.32.84.165",4843,"212.117.171.138",65500,14,846,10,604,4,242,7173.398554,113.73666499999945,42.48410132299926,17.021775695638777
"147.32.84.165",4890,"82.142.142.20",25,6,372,6,372,0,0,7173.421161,8.990724999999657,331.00778858213476,0
"147.32.84.165",1060,"74.125.39.27",25,6,372,6,372,0,0,7174.199899,9.012539999999717,330.20657883350236,0
"147.32.84.165",1107,"65.55.37.72",25,6,372,6,372,0,0,7174.701525,9.011853999999403,330.2317148058765,0
"147.32.84.165",3028,"83.164.192.67",25,6,372,6,372,0,0,7176.103004,9.071187000000464,328.071728650269,0
"147.32.84.165",1427,"74.125.127.27",25,6,372,6,372,0,0,7176.303326,9.01236499999959,330.2129907077815,0
"147.32.84.165",1108,"195.110.124.132",25,6,372,6,372,0,0,7178.406039,9.012588999999934,330.20478355331875,0
"147.32.84.165",3036,"74.54.18.180",25,6,372,6,372,0,0,7178.406194,9.012557999999444,330.20591934056716,0
"147.32.84.165",2531,"74.125.157.27",25,6,372,6,372,0,0,7180.008249,9.012782999999217,330.19767590102396,0
"147.32.84.165",1111,"205.188.103.1",25,6,372,6,372,0,0,7180.108037,9.013316000000486,330.1781497508619,0
"147.32.84.165",1103,"218.57.210.214",6667,6,372,6,372,0,0,7180.108136,9.013340999999855,330.1772339468847,0
"147.32.84.165",4826,"212.117.174.7",4506,6,372,6,372,0,0,7194.428671,8.912882999999965,333.89869473210985,0
"147.32.84.165",4867,"74.54.18.180",25,6,372,6,372,0,0,7195.230149,8.912682000000132,333.906224860256,0
"147.32.84.165",2756,"209.85.229.27",25,6,372,6,372,0,0,7195.230282,8.912598999999318,333.909334415273,0
"147.32.84.165",1112,"209.85.225.27",25,6,372,6,372,0,0,7195.731042,8.912613999999849,333.9087724431969,0
"147.32.84.165",1105,"212.117.174.7",4506,6,372,6,372,0,0,7197.132882,8.913571000000047,333.8729225357586,0
"147.32.84.165",4882,"174.123.87.100",25,6,372,6,372,0,0,7197.133014,8.913575999999921,333.8727352523865,0
"147.32.84.165",2774,"188.64.112.2",25,6,372,6,372,0,0,7197.333676,9.012936000000082,330.19207059719196,0
"147.32.84.165",1115,"128.107.234.206",25,6,372,6,372,0,0,7199.436318,8.912274000000252,333.92151094096926,0
"147.32.84.165",4914,"89.111.178.33",25,6,372,6,372,0,0,7199.436458,8.91226800000004,333.92173574672427,0
"147.32.84.165",4726,"188.64.112.5",25,6,372,6,372,0,0,7200.938293,9.012923999999657,330.19251022200046,0
"147.32.84.165",1116,"207.115.36.22",25,6,372,6,372,0,0,7201.038207,9.013284000000567,330.1793219873925,0
"147.32.84.165",1107,"219.145.198.122",6667,6,372,6,372,0,0,7201.138825,9.012625000000298,330.2034645843915,0
"147.32.84.165",4891,"89.111.178.33",25,6,372,6,372,0,0,7215.359183,9.013224000000264,330.18151995333886,0
"147.32.84.165",4881,"82.146.40.5",25,6,372,6,372,0,0,7215.359323,9.013210000000072,330.1820328162748,0
"147.32.84.165",1108,"174.133.57.141",80,16,3429,12,1428,4,2001,7216.159827,0.47017999999934545,24297.077714951516,34046.53536948038
"147.32.84.165",1118,"200.42.0.151",25,6,372,6,372,0,0,7216.315849,8.958081000000675,332.21400878154327,0
"147.32.84.165",4917,"87.120.70.1",25,6,372,6,372,0,0,7216.660999,9.013688000000002,330.1645231119603,0
"147.32.84.165",4888,"82.146.40.5",25,6,372,6,372,0,0,7218.06313,9.012856000000284,330.1950014512499,0
"147.32.84.165",1119,"65.55.37.120",25,6,372,6,372,0,0,7218.063276,9.012832999999773,330.195844081442,0
"147.32.84.165",1107,"31.192.109.167",80,15,1540,10,1050,5,490,7218.363639,0.23786999999992986,35313.40648254289,16479.589691853347
"147.32.84.165",2157,"92.53.104.16",25,6,372,6,372,0,0,7218.441548,8.935309999999845,333.0606324794609,0
"147.32.84.165",1961,"91.218.229.219",25,6,372,6,372,0,0,7220.365977,9.013466999999764,330.17261837205126,0
"147.32.84.165",1120,"74.6.136.65",25,6,372,6,372,0,0,7220.366181,9.01331299999947,330.1782596477205,0
"147.32.84.165",2531,"125.114.134.15",6667,6,372,6,372,0,0,7221.968492,9.132719999999608,325.86129871496416,0
"147.32.84.165",1112,"212.117.174.7",4506,6,372,6,372,0,0,7222.068382,9.180413999999473,324.1683871773289,0
"147.32.84.165",3203,"213.171.1.198",25,6,372,6,372,0,0,7222.168784,9.109266999999818,326.70027127320554,0
"147.32.84.165",3034,"91.218.229.219",25,6,372,6,372,0,0,7236.389115,9.012993000000279,330.18998239540497,0
"147.32.84.165",4914,"174.133.57.141",80,16,3429,12,1428,4,2001,7236.389188,0.4859260000002905,23509.752513743184,32943.2876610645
"147.32.84.165",1121,"209.85.225.27",25,6,372,6,372,0,0,7236.550271,8.95187900000019,332.44417177666685,0
"147.32.84.165",4726,"212.117.174.7",4506,6,372,6,372,0,0,7237.290626,9.012601999999788,330.2043072577786,0
"147.32.84.165",2832,"212.192.128.3",25,6,372,6,372,0,0,7237.290725,9.012628000000404,330.20335467078706,0
"147.32.84.165",3046,"79.137.226.103",25,6,372,6,372,0,0,7237.690762,9.013089999999465,330.186428849615,0
"147.32.84.165",1123,"65.54.188.110",25,6,372,6,372,0,0,7239.09316,9.012691999999333,330.2010098647796,0
"147.32.84.165",3413,"95.169.189.196",25,6,372,6,372,0,0,7239.394111,9.012171000000308,330.22009901941476,0
"147.32.84.165",3060,"79.137.226.103",25,6,372,6,372,0,0,7241.396184,9.01360299999942,330.1676366265733,0
"147.32.84.165",1124,"98.136.59.15",25,6,372,6,372,0,0,7241.396317,9.013566000000537,330.1689919394635,0
"147.32.84.165",3434,"81.26.143.243",25,6,372,6,372,0,0,7241.396382,9.013528000000406,330.1703838940608,0
"147.32.84.165",4901,"217.16.28.65",25,6,372,6,372,0,0,7243.098788,9.0130079999999,330.18943287302454,0
"147.32.84.165",1125,"65.55.92.184",25,6,372,6,372,0,0,7243.198739,9.013403999999355,330.1749261433542,0
"147.32.84.165",1120,"196.192.41.18",6667,6,372,6,372,0,0,7243.198843,9.013423999999759,330.17419351403856,0
"147.32.84.165",1120,"212.117.174.7",4506,6,372,6,372,0,0,7257.519403,9.013038000000051,330.18833383371765,0
"147.32.84.165",3504,"87.224.128.126",25,6,372,6,372,0,0,7258.320679,9.012824999999793,330.1961371712053,0
"147.32.84.165",4916,"217.16.28.65",25,6,372,6,372,0,0,7258.721361,9.01267800000005,330.2015227882304,0
"147.32.84.165",1126,"205.188.103.1",25,6,372,6,372,0,0,7258.721494,9.012671999999839,330.2017426130734,0
"147.32.84.165",3506,"87.224.128.126",25,6,372,6,372,0,0,7260.123492,9.012770000000273,330.19815217740046,0
"147.32.84.165",3085,"62.118.120.61",25,6,372,6,372,0,0,7260.123625,9.012761999999384,330.1984452712946,0
"147.32.84.165",1127,"207.115.36.22",25,6,372,6,372,0,0,7260.423904,9.012838999999985,330.1956242644526,0
"147.32.84.165",3507,"217.16.18.91",25,6,372,6,372,0,0,7262.426663,8.913093999999546,333.8907903361225,0
"147.32.84.165",2155,"195.128.50.36",25,6,372,6,372,0,0,7262.426812,8.91308300000037,333.8912024043618,0
"147.32.84.165",1128,"209.85.225.27",25,6,372,6,372,0,0,7264.12914,8.912492000000384,333.91334320410857,0
"147.32.84.165",3434,"212.117.174.7",4506,6,372,6,372,0,0,7264.229555,8.913970000000518,333.85797798285466,0
"147.32.84.165",3060,"117.242.61.2",6667,6,372,6,372,0,0,7264.22966,8.914031999999679,333.8556558917566,0
"147.32.84.165",3153,"195.225.38.43",25,6,372,6,372,0,0,7264.229694,8.914066000000275,333.85438250063527,0
"147.32.84.165",2159,"89.208.153.2",25,6,372,6,372,0,0,7278.450121,9.01264700000047,330.20265855301386,0
"147.32.84.165",1129,"66.94.237.139",25,6,372,6,372,0,0,7279.251299,9.012355000000753,330.2133571080757,0
"147.32.84.165",3512,"217.151.130.35",25,6,372,6,372,0,0,7279.651624,9.012759000000187,330.1985551815973,0
"147.32.84.165",2682,"81.3.168.250",25,6,372,6,372,0,0,7281.05322,9.013036000000284,330.1884071027683,0
"147.32.84.165",1130,"205.188.59.194",25,6,372,6,372,0,0,7281.353627,9.013598999999886,330.1677831463368,0
"147.32.84.165",3538,"89.108.79.57",25,6,372,6,372,0,0,7283.356754,9.013660999999956,330.16551210435074,0
"147.32.84.165",2873,"78.110.50.88",25,6,372,6,372,0,0,7283.356903,9.013570000000072,330.16884541862726,0
"147.32.84.165",1131,"209.85.225.27",25,6,372,6,372,0,0,7285.059077,9.012859999999819,330.19485490732797,0
"147.32.84.165",3507,"111.88.33.160",6667,6,372,6,372,0,0,7285.159829,9.012670000000071,330.201815888075,0
"147.32.84.165",2155,"212.117.174.7",4506,6,372,6,372,0,0,7285.25974,9.012818999999581,330.19635698887754,0
"147.32.84.165",3569,"209.85.229.27",25,6,372,6,372,0,0,7299.480168,9.012421999999788,330.21090224138084,0
"147.32.84.165",2900,"69.50.196.9",25,6,372,6,372,0,0,7300.280863,9.013923000000432,330.15591546542584,0
"147.32.84.165",3434,"174.133.57.141",80,16,3429,12,1428,4,2001,7300.681861,0.4828010000001086,23661.922821198445,33156.517902813786
"147.32.84.165",1132,"168.95.5.28",25,6,372,6,372,0,0,7300.841703,8.953577999999652,332.3810883202353,0
"147.32.84.165",2159,"212.117.174.7",4506,6,372,6,372,0,0,7302.083624,9.013477000000421,330.17225206209116,0
"147.32.84.165",3512,"212.117.171.138",65500,14,846,10,604,4,242,7302.083762,46.00565899999947,105.03055721905986,42.081779548033914
"147.32.84.165",3592,"92.53.104.16",25,6,372,6,372,0,0,7302.106785,8.990445000000364,331.01809754688225,0
"147.32.84.165",2912,"81.211.26.66",25,6,372,6,372,0,0,7302.383867,9.013477000000421,330.17225206209116,0
"147.32.84.165",1133,"64.136.44.37",25,6,372,6,372,0,0,7304.387109,9.013309999999365,330.178369544619,0
"147.32.84.165",3510,"74.125.43.27",25,6,372,6,372,0,0,7304.38724,9.013302999999723,330.1786259709777,0
"147.32.84.165",2964,"88.198.234.174",25,6,372,6,372,0,0,7306.089743,9.013691999999537,330.16437659509035,0
"147.32.84.165",1134,"74.6.136.244",25,6,372,6,372,0,0,7306.289617,9.013412999999673,330.1745964597548,0
"147.32.84.165",3619,"195.19.204.76",25,6,372,6,372,0,0,7306.289694,9.013460999999552,330.17283815841085,0
"147.32.84.165",2997,"178.162.163.199",25,6,372,6,372,0,0,7320.510658,9.01217699999961,330.2198791701637,0
"147.32.84.165",1135,"74.6.136.65",25,6,372,6,372,0,0,7321.311815,9.012770999999702,330.1981155407253,0
"147.32.84.165",2900,"212.117.174.7",4506,6,372,6,372,0,0,7321.812246,9.012752999999975,330.19877500248907,0
"147.32.84.165",3629,"46.4.54.212",25,6,372,6,372,0,0,7323.11361,9.013348999999835,330.17694089067834,0
"147.32.84.165",3002,"93.170.48.61",25,6,372,6,372,0,0,7323.414229,9.012944000000061,330.1917775146478,0
"147.32.84.165",1136,"205.188.190.1",25,6,372,6,372,0,0,7325.417198,9.013245999999526,330.18071402912517,0
"147.32.84.165",2912,"219.94.105.182",6667,6,372,6,372,0,0,7325.417336,9.013230999999905,330.18126352248504,0
"147.32.84.165",3680,"74.125.39.27",25,6,372,6,372,0,0,7327.119608,9.013168999999834,330.18353478116904,0
"147.32.84.165",3233,"193.104.248.2",25,6,372,6,372,0,0,7327.320155,9.013283999999658,330.1793219874258,0
"147.32.84.165",1138,"209.85.225.27",25,6,372,6,372,0,0,7327.320228,9.013333000000785,330.177527003578,0
"147.32.84.165",3619,"212.117.174.7",4506,6,372,6,372,0,0,7341.440506,9.012469999999666,330.2091435533333,0
"147.32.84.165",4943,"209.85.225.27",25,6,372,6,372,0,0,7341.440638,9.012407999999596,330.2114151955985,0
"147.32.84.165",3320,"88.198.12.76",25,6,372,6,372,0,0,7341.440696,9.012377000000015,330.21255102843514,0
"147.32.84.165",1142,"65.55.92.136",25,6,372,6,372,0,0,7342.241172,9.253247999999985,321.61679877163186,0
"147.32.84.165",4945,"74.125.157.27",25,6,372,6,372,0,0,7342.74202,9.013118000000759,330.18540309799,0
"147.32.84.165",3546,"178.63.49.46",25,6,372,6,372,0,0,7344.043739,9.012936000000082,330.19207059719196,0
"147.32.84.165",1143,"64.12.90.1",25,6,372,6,372,0,0,7344.344866,9.012275999999474,330.216251699368,0
"147.32.84.165",4946,"89.111.176.226",25,6,372,6,372,0,0,7346.347528,9.01260899999943,330.2040507915287,0
"147.32.84.165",3432,"74.125.39.27",25,6,372,6,372,0,0,7347.148611,9.012751000000208,330.1988482761736,0
"147.32.84.165",1144,"147.187.10.115",25,6,372,6,372,0,0,7347.148724,9.0127650000004,330.1983353609983,0
"147.32.84.165",3832,"188.40.60.12",25,6,372,6,372,0,0,7348.050191,9.01234199999999,330.213833429757,0
"147.32.84.165",3471,"74.125.43.27",25,6,372,6,372,0,0,7348.249836,9.012942000000294,330.19185078522673,0
"147.32.84.165",1145,"209.85.225.27",25,6,372,6,372,0,0,7348.249988,9.012915000000248,330.19283994134173,0
"147.32.84.165",3512,"212.117.171.138",65500,14,846,10,604,4,242,7362.470193,244.42792499999996,19.768608680861654,7.920535266173046
"147.32.84.165",3846,"188.40.60.12",25,6,372,6,372,0,0,7362.492897,8.990499999999884,331.01607252099865,0
"147.32.84.165",4937,"85.214.220.206",25,6,372,6,372,0,0,7362.49296,8.990562000000864,331.01378979419906,0
"147.32.84.165",1147,"64.12.90.98",25,6,372,6,372,0,0,7363.271326,9.013296999999511,330.17884576533555,0
"147.32.84.165",3320,"212.117.174.7",4506,6,372,6,372,0,0,7363.774275,9.010858000000553,330.2682164117798,0
"147.32.84.165",3626,"188.40.54.222",25,6,372,6,372,0,0,7365.074408,9.01254599999993,330.20635900222015,0
"147.32.84.165",3515,"109.70.26.36",25,6,372,6,372,0,0,7365.374657,9.01270999999997,330.2003503940557,0
"147.32.84.165",1148,"200.91.27.33",25,6,372,6,372,0,0,7367.377908,9.012342999999419,330.213796789602,0
"147.32.84.165",1143,"221.208.241.38",6667,4,248,4,248,0,0,7368.178518,3.00452900000073,660.3364454127479,0
"147.32.84.165",3762,"188.40.54.222",25,6,372,6,372,0,0,7369.081057,9.011660999999549,330.2387872779667,0
"147.32.84.165",3540,"109.70.26.36",25,6,372,6,372,0,0,7369.081187,9.011656000000585,330.2389705066202,0
"147.32.84.165",1149,"64.12.139.193",25,6,372,6,372,0,0,7369.081247,9.01164499999959,330.2393736104935,0
"147.32.84.165",3905,"94.229.67.92",25,6,372,6,372,0,0,7369.28093,9.011993000000075,330.22662134779455,0
"147.32.84.165",3564,"86.111.9.178",25,6,372,6,372,0,0,7369.281067,9.01199700000052,330.2264747757715,0
"147.32.84.165",1150,"206.54.145.17",25,6,372,6,372,0,0,7383.501136,9.012381999999889,330.21236782906414,0
"147.32.84.165",3951,"77.246.107.36",25,6,372,6,372,0,0,7384.301872,9.01313300000038,330.1848535908518,0
"147.32.84.165",4941,"67.228.59.198",25,6,372,6,372,0,0,7384.80248,9.012826000000132,330.1961005349439,0
"147.32.84.165",1151,"209.85.225.27",25,6,372,6,372,0,0,7386.104177,9.012931999999637,330.19221713867586,0
"147.32.84.165",4954,"173.192.217.195",25,6,372,6,372,0,0,7386.404707,9.01383900000019,330.1589921896694,0
"147.32.84.165",3572,"195.110.124.132",25,6,372,6,372,0,0,7388.007083,9.013954999999441,330.1547433951228,0
"147.32.84.165",1152,"193.95.141.41",25,6,372,6,372,0,0,7388.407722,9.013810999999805,330.16001777717156,0
"147.32.84.165",4937,"93.116.166.52",6667,4,248,4,248,0,0,7390.110024,3.004384000000755,660.3683151020314,0
"147.32.84.165",3957,"89.111.176.149",25,6,372,6,372,0,0,7390.310331,9.01328900000044,330.17913882489006,0
"147.32.84.165",3596,"67.228.59.198",25,6,372,6,372,0,0,7390.310469,9.013275999999678,330.179615047859,0
"147.32.84.165",1153,"209.85.225.27",25,6,372,6,372,0,0,7390.310527,9.013268000000608,330.1799081087791,0
"147.32.84.165",4017,"195.225.241.72",25,6,372,6,372,0,0,7390.310584,9.013269000000037,330.1798714761523,0
"147.32.84.165",3614,"64.191.120.172",25,6,372,6,372,0,0,7404.530816,8.912779999999657,333.90255341207956,0
"147.32.84.165",1149,"174.133.57.141",80,17,3489,12,1428,5,2061,7405.332118,11.096429000000171,1029.5203979586427,1485.883431507537
"147.32.84.165",1154,"66.94.237.64",25,6,372,6,372,0,0,7405.487078,8.858181999999942,335.9605842372644,0
"147.32.84.165",3905,"212.117.174.7",4506,6,372,6,372,0,0,7405.832878,8.912768000000142,333.9030029728085,0
"147.32.84.165",4937,"173.192.170.88",80,22,3102,18,2856,4,246,7407.13468,45.36609200000021,503.63606369267814,43.38041725083992
"147.32.84.165",1150,"212.117.174.7",4506,6,372,6,372,0,0,7407.435011,8.913077000000158,333.89142716930945,0
"147.32.84.165",4958,"85.17.228.47",25,6,372,6,372,0,0,7407.435151,8.913027000000511,333.89330022222856,0
"147.32.84.165",4944,"89.145.85.120",25,6,372,6,372,0,0,7409.037528,9.01271700000052,330.20009393391894,0
"147.32.84.165",1156,"208.97.132.210",25,6,372,6,372,0,0,7409.037671,9.012697999999546,330.2007900409123,0
"147.32.84.165",4954,"27.251.19.95",6667,6,372,6,372,0,0,7409.338239,9.012400000000525,330.2117083129717,0
"147.32.84.165",3902,"77.246.107.36",25,6,372,6,372,0,0,7410.24023,9.011598999999478,330.241059328114,0
"147.32.84.165",3656,"89.145.85.120",25,6,372,6,372,0,0,7411.24227,9.011061000000154,330.2607761727447,0
"147.32.84.165",1157,"64.12.90.98",25,6,372,6,372,0,0,7411.242402,9.0110480000003,330.26125263120343,0
"147.32.84.165",4957,"173.241.196.95",25,6,372,6,372,0,0,7411.242473,9.011028999999326,330.26194899608277,0
"147.32.84.165",3819,"188.40.117.142",25,6,372,6,372,0,0,7425.461241,9.012552000000142,330.2061391712307,0
"147.32.84.165",1158,"205.188.190.1",25,6,372,6,372,0,0,7426.362457,9.01268600000003,330.20122968890627,0
"147.32.84.165",4138,"89.111.176.226",25,6,372,6,372,0,0,7426.76297,9.012752999999975,330.19877500248907,0
"147.32.84.165",3688,"188.40.117.142",25,6,372,6,372,0,0,7428.364943,9.013223000000835,330.18155658633145,0
"147.32.84.165",1159,"149.168.221.229",25,6,372,6,372,0,0,7428.365093,9.013196999999309,330.1825090475919,0
"147.32.84.165",1150,"61.17.216.86",6667,15,1752,10,1194,5,558,7430.067527,1.096918000000187,8708.034693567224,4069.584052772622
"147.32.84.165",4179,"209.212.156.210",25,6,372,6,372,0,0,7430.067623,9.01288999999997,330.19375583192624,0
"147.32.84.165",3694,"87.118.92.232",25,6,372,6,372,0,0,7430.067666,9.012971000000107,330.1907883648982,0
"147.32.84.165",1161,"74.6.136.65",25,6,372,6,372,0,0,7430.274573,9.006788000000597,330.4174584768513,0
"147.32.84.165",4020,"209.212.156.210",25,6,372,6,372,0,0,7431.269288,9.013594000000012,330.16796629624054,0
"147.32.84.165",3749,"64.191.120.172",25,6,372,6,372,0,0,7431.269437,9.013568000000305,330.16891867902916,0
"147.32.84.165",1162,"209.85.225.27",25,6,372,6,372,0,0,7432.27061,9.013013000000683,330.1892496992709,0
"147.32.84.165",4260,"85.233.128.67",25,6,372,6,372,0,0,7432.270857,9.012893999999505,330.19360928910993,0
"147.32.84.165",3901,"86.111.9.178",25,6,372,6,372,0,0,7446.491317,9.012732999999571,330.19950774089745,0
"147.32.84.165",1163,"207.115.36.22",25,6,372,6,372,0,0,7447.392473,9.012837000000218,330.19569753673875,0
"147.32.84.165",3819,"212.117.174.7",4506,6,372,6,372,0,0,7447.792891,9.013073000000077,330.1870516304455,0
"147.32.84.165",4138,"212.117.174.7",4506,6,372,6,372,0,0,7449.395458,9.013141999999789,330.1845238874601,0
"147.32.84.165",4972,"209.85.229.27",25,6,372,6,372,0,0,7449.395589,9.013151000000107,330.1841941846935,0
"147.32.84.165",3774,"95.163.15.194",25,6,372,6,372,0,0,7451.097707,9.012948000000506,330.19163097355414,0
"147.32.84.165",1164,"165.212.65.113",25,6,372,6,372,0,0,7451.097809,9.012974000000213,330.19067845973257,0
"147.32.84.165",4148,"74.125.43.27",25,6,372,6,372,0,0,7451.29799,9.012920000000122,330.1926567638412,0
"147.32.84.165",3821,"82.138.17.133",25,6,372,6,372,0,0,7452.299693,9.012759000000187,330.1985551815973,0
"147.32.84.165",1166,"65.55.92.152",25,6,372,6,372,0,0,7453.301218,9.013699000000088,330.1641201908308,0
"147.32.84.165",4179,"173.192.170.88",80,6,372,6,372,0,0,7453.301359,9.013683000000128,330.16470625824735,0
"147.32.84.165",4395,"92.53.116.6",25,6,372,6,372,0,0,7467.521483,9.013272999999572,330.17972494565976,0
"147.32.84.165",3835,"85.214.220.206",25,6,372,6,372,0,0,7468.422777,9.013073000000077,330.1870516304455,0
"147.32.84.165",1167,"98.137.54.238",25,6,372,6,372,0,0,7468.823475,9.013081999999486,330.18672192266416,0
"147.32.84.165",4420,"81.177.24.21",25,6,372,6,372,0,0,7470.425609,8.912788000000546,333.9022537055541,0
"147.32.84.165",3844,"89.108.70.21",25,6,372,6,372,0,0,7472.127911,8.913473000000522,333.8765933323437,0
"147.32.84.165",1168,"205.188.103.1",25,6,372,6,372,0,0,7472.128017,8.91348999999991,333.8759565557408,0
"147.32.84.165",4261,"188.120.239.168",25,6,372,6,372,0,0,7472.328763,8.912799999999152,333.90180414687677,0
"147.32.84.165",3847,"94.245.160.209",25,6,372,6,372,0,0,7473.330546,8.91185200000018,333.9373230165783,0
"147.32.84.165",1169,"67.23.185.243",25,6,372,6,372,0,0,7474.331526,8.912392000000182,333.9170898227927,0
"147.32.84.165",3774,"212.117.174.7",4506,6,372,6,372,0,0,7474.331663,8.912379000000328,333.91757688939066,0
"147.32.84.165",3821,"212.117.174.7",4506,6,372,6,372,0,0,7488.452053,9.012244000000464,330.21742420642926,0
"147.32.84.165",4455,"77.222.41.36",25,6,372,6,372,0,0,7488.452202,9.012219999999616,330.21830359224776,0
"147.32.84.165",3871,"188.138.114.90",25,6,372,6,372,0,0,7489.35298,9.012821000000258,330.1962837162654,0
"147.32.84.165",1170,"199.239.254.18",25,6,372,6,372,0,0,7489.753548,9.012795000000551,330.1972362624267,0
"147.32.84.165",3835,"14.98.87.197",6667,6,372,6,372,0,0,7491.355848,9.012840999999753,330.19555099219895,0
"147.32.84.165",4477,"77.222.41.41",25,6,372,6,372,0,0,7493.058085,9.013452000000143,330.17316783846553,0
"147.32.84.165",3889,"195.9.14.110",25,6,372,6,372,0,0,7493.058225,9.013437000000522,330.1737173067086,0
"147.32.84.165",1171,"64.136.52.37",25,6,372,6,372,0,0,7493.258766,9.01291300000048,330.19291321239217,0
"147.32.84.165",4983,"46.38.56.73",25,6,372,6,372,0,0,7494.259814,9.013192000000345,330.1826922138002,0
"147.32.84.165",4069,"195.9.14.110",25,6,372,6,372,0,0,7495.261247,9.012871999999334,330.19441527630926,0
"147.32.84.165",1172,"94.136.40.221",25,6,372,6,372,0,0,7495.26138,9.012864999999692,330.1946717275918,0
"147.32.84.165",4516,"62.183.66.244",25,6,372,6,372,0,0,7495.261442,9.012856000000284,330.1950014512499,0
"147.32.84.165",3908,"88.198.234.174",25,6,372,6,372,0,0,7509.481828,9.012861000000157,330.19481827135115,0
"147.32.84.165",1173,"64.12.90.98",25,6,372,6,372,0,0,7510.383277,9.012776000000486,330.19793235733806,0
"147.32.84.165",3821,"212.117.174.7",4506,6,372,6,372,0,0,7510.784099,9.01254599999993,330.20635900222015,0
"147.32.84.165",4527,"194.54.148.122",25,6,372,6,372,0,0,7513.588151,9.012273000000278,330.21636162152527,0
"147.32.84.165",4120,"91.206.222.72",25,6,372,6,372,0,0,7514.088851,9.013338999999178,330.1773072110426,0
"147.32.84.165",1174,"209.85.225.27",25,6,372,6,372,0,0,7514.088963,9.013350999999602,330.17686762671633,0
"147.32.84.165",4986,"91.218.38.36",25,6,372,6,372,0,0,7514.288527,9.014259000000493,330.1436091418981,0
"147.32.84.165",3958,"64.120.170.149",25,6,372,6,372,0,0,7515.290082,9.013161999999284,330.1837912155841,0
"147.32.84.165",1175,"205.188.190.1",25,6,372,6,372,0,0,7516.292166,9.012538999999379,330.20661547208897,0
"147.32.84.165",1171,"212.117.174.7",4506,6,372,6,372,0,0,7516.292302,9.012539999999717,330.20657883350236,0
"147.32.84.165",4579,"74.52.75.130",25,6,372,6,372,0,0,7516.292358,9.0125450000005,330.2063956407247,0
"147.32.84.165",4963,"77.222.41.36",25,6,372,6,372,0,0,7530.511973,9.01291300000048,330.19291321239217,0
"147.32.84.165",1176,"64.98.36.4",25,6,372,6,372,0,0,7531.413154,9.013041000000158,330.18822393018604,0
"147.32.84.165",4424,"81.30.112.202",25,6,372,6,372,0,0,7531.813985,9.012824000000364,330.1961738074414,0
"147.32.84.165",4010,"195.239.166.118",25,6,372,6,372,0,0,7534.617724,9.013025000000198,330.18881008317794,0
"147.32.84.165",1177,"66.94.237.64",25,6,372,6,372,0,0,7535.118577,9.013189999999668,330.1827654803804,0
"147.32.84.165",3908,"77.126.98.108",6667,4,248,4,248,0,0,7535.118715,3.004496000000472,660.3436982441275,0
"147.32.84.165",4650,"46.4.54.212",25,6,372,6,372,0,0,7535.319306,9.01275699999951,330.1986284552176,0
"147.32.84.165",4199,"195.16.88.67",25,6,372,6,372,0,0,7536.321667,9.01163699999961,330.23966677753765,0
"147.32.84.165",1180,"64.12.90.98",25,6,372,6,372,0,0,7537.321891,9.01270999999997,330.2003503940557,0
"147.32.84.165",4986,"212.117.174.7",4506,6,372,6,372,0,0,7537.322037,9.012690999999904,330.20104650209703,0
"147.32.84.165",1179,"92.38.225.40",25,6,372,6,372,0,0,7551.44224,9.0128909999994,330.19371919622665,0
"147.32.84.165",4207,"88.198.12.76",25,6,372,6,372,0,0,7552.343387,9.012902999999824,330.1932795681989,0
"147.32.84.165",1181,"209.85.227.27",25,6,372,6,372,0,0,7552.74427,9.012690999999904,330.20104650209703,0
"147.32.84.165",1176,"212.117.174.7",4506,6,372,6,372,0,0,7554.446486,9.013377000000219,330.17591519803597,0
"147.32.84.165",4070,"83.136.235.194",25,6,372,6,372,0,0,7554.446626,9.013363000000027,330.1764280435606,0
"147.32.84.165",1183,"216.32.181.178",25,6,372,6,372,0,0,7555.54786,9.013140000000021,330.18459715481987,0
"147.32.84.165",1433,"74.125.39.27",25,6,372,6,372,0,0,7556.049034,9.012723000000733,330.19987411127113,0
"147.32.84.165",4083,"46.4.116.200",25,6,372,6,372,0,0,7556.248885,9.013144000000466,330.1844506200995,0
"147.32.84.165",1184,"209.85.225.27",25,6,372,6,372,0,0,7557.250874,9.012463000000025,330.2094000274943,0
"147.32.84.165",1804,"74.125.127.27",25,6,372,6,372,0,0,7558.252774,9.01195000000007,330.2281970050851,0
"147.32.84.165",4124,"74.125.43.27",25,6,372,6,372,0,0,7558.252912,9.011935999999878,330.2287100130361,0
"147.32.84.165",1185,"77.238.177.9",25,6,372,6,372,0,0,7572.47217,9.012948999999935,330.19159433832607,0
"147.32.84.165",2105,"209.85.225.27",25,6,372,6,372,0,0,7573.375691,9.010976999999912,330.26385485170243,0
"147.32.84.165",4133,"209.85.225.27",25,6,372,6,372,0,0,7573.375822,9.010967999999593,330.2641847135773,0
"147.32.84.165",1186,"74.6.136.244",25,6,372,6,372,0,0,7573.375884,9.010959999999614,330.2644779246748,0
"147.32.84.165",5000,"72.14.213.27",25,6,372,6,372,0,0,7573.774523,9.012708000000202,330.2004236684394,0
"147.32.84.165",4329,"62.213.75.149",25,6,372,6,372,0,0,7575.4767,9.013361000000259,330.1765013073275,0
"147.32.84.165",1187,"64.12.90.1",25,6,372,6,372,0,0,7576.578761,9.012864000000263,330.1947083635028,0
"147.32.84.165",4635,"78.138.172.217",25,6,372,6,372,0,0,7577.079167,9.012698999999884,330.2007534036184,0
"147.32.84.165",4188,"92.53.96.75",25,6,372,6,372,0,0,7577.279216,9.013112999999976,330.18558626747586,0
"147.32.84.165",1188,"205.188.190.1",25,6,372,6,372,0,0,7578.280678,9.012751999999637,330.1988116393439,0
"147.32.84.165",1183,"212.117.174.7",4506,6,372,6,372,0,0,7579.282133,9.01383100000021,330.1592852140151,0
"147.32.84.165",1027,"78.138.172.217",25,6,372,6,372,0,0,7579.282273,9.013816000000588,330.15983463605266,0
"147.32.84.165",4201,"69.50.196.9",25,6,372,6,372,0,0,7579.282333,9.013809000000037,330.160091033656,0
"147.32.84.165",1189,"74.6.136.65",25,6,372,6,372,0,0,7593.502634,9.012714999999844,330.2001672082221,0
"147.32.84.165",4124,"212.117.174.7",4506,6,372,6,372,0,0,7594.403686,9.012886000000435,330.1939023748726,0
"147.32.84.165",1032,"91.121.49.79",25,6,372,6,372,0,0,7594.403825,9.012886999999864,330.1938657391405,0
"147.32.84.165",4212,"95.163.16.202",25,6,372,6,372,0,0,7594.804899,9.0137050000003,330.16390041607764,0
"147.32.84.165",1190,"74.6.140.64",25,6,372,6,372,0,0,7596.507033,9.013471000000209,330.17247184796304,0
"147.32.84.165",2851,"77.221.128.102",25,6,372,6,372,0,0,7597.608667,9.012757999999849,330.19859181840343,0
"147.32.84.165",4236,"64.120.170.149",25,6,372,6,372,0,0,7598.109298,9.343581999999515,318.50739898254807,0
"147.32.84.165",1191,"65.55.92.184",25,6,372,6,372,0,0,7598.309927,9.146151999999347,325.38274019502546,0
"147.32.84.165",1029,"87.118.116.14",25,6,372,6,372,0,0,7599.31098,9.01287400000001,330.19434200455885,0
"147.32.84.165",4440,"78.24.218.162",25,6,372,6,372,0,0,7600.312376,9.012730999999803,330.19958101490715,0
"147.32.84.165",1195,"205.188.159.42",25,6,372,6,372,0,0,7600.31252,9.012710999999399,330.20031375689274,0
"147.32.84.165",4201,"95.59.69.146",6667,9,552,6,372,3,180,7614.5329,1.4968909999997777,1988.1207115283892,961.993892675027
"147.32.84.165",1035,"87.118.116.14",25,6,372,6,372,0,0,7615.43412,8.912672000000384,333.90659950235704,0
"147.32.84.165",4277,"74.54.79.106",25,6,372,6,372,0,0,7615.434253,8.912663000000066,333.90693668098726,0
"147.32.84.165",1196,"209.85.225.27",25,6,372,6,372,0,0,7615.83534,8.91200900000058,333.931440150005,0
"147.32.84.165",1189,"212.117.174.7",4506,6,372,6,372,0,0,7616.030053,8.8174599999993,337.5121633668013,0
"147.32.84.165",3512,"212.117.171.138",65500,24,1475,18,1092,6,383,7617.537025,148.03844500000014,59.011697941031414,20.697326292504606
"147.32.84.165",3475,"199.124.61.3",25,6,372,6,372,0,0,7617.560223,8.98986799999966,331.03934340305244,0
"147.32.84.165",4324,"83.136.235.194",25,6,372,6,372,0,0,7618.538464,9.013137999999344,330.18467042224546,0
"147.32.84.165",1197,"64.12.139.193",25,6,372,6,372,0,0,7619.039149,9.013041000000158,330.18822393018604,0
"147.32.84.165",1037,"199.124.61.3",25,6,372,6,372,0,0,7619.239445,9.013019999999415,330.18899325644384,0
"147.32.84.165",4333,"178.162.190.126",25,6,372,6,372,0,0,7619.239578,9.013052000000243,330.1878209512072,0
"147.32.84.165",1198,"208.84.244.133",25,6,372,6,372,0,0,7620.241509,9.012389999999868,330.2120747104867,0
"147.32.84.165",1191,"212.117.174.7",4506,6,372,6,372,0,0,7621.24229,9.012942000000294,330.19185078522673,0
"147.32.84.165",2847,"178.208.82.126",25,6,372,6,372,0,0,7621.242462,9.012910999999804,330.1929864835085,0
"147.32.84.165",4366,"46.4.116.200",25,6,372,6,372,0,0,7621.242551,9.01288999999997,330.19375583192624,0
"147.32.84.165",1199,"194.94.212.56",25,6,372,6,372,0,0,7636.364351,9.012727000000268,330.1997275630241,0
"147.32.84.165",4058,"87.242.79.74",25,6,372,6,372,0,0,7636.764632,9.013057999999546,330.18760114493324,0
"147.32.84.165",4392,"72.14.213.27",25,6,372,6,372,0,0,7636.86503,9.012821000000258,330.1962837162654,0
"147.32.84.165",1202,"74.6.136.65",25,6,372,6,372,0,0,7638.5672,9.013200999999754,330.18236251472496,0
"147.32.84.165",1196,"31.192.109.167",80,15,1540,10,1050,5,490,7639.56869,0.24591099999997823,34158.69969216808,15940.726523011768
"147.32.84.165",4150,"87.242.79.74",25,6,372,6,372,0,0,7639.64739,8.934355999999752,333.0961963011192,0
"147.32.84.165",4538,"62.118.120.61",25,6,372,6,372,0,0,7639.647477,8.934392999999545,333.09481684991374,0
"147.32.84.165",1203,"205.188.190.1",25,6,372,6,372,0,0,7640.069698,9.01283499999954,330.1957708090908,0
"147.32.84.165",3461,"88.198.27.35",25,6,372,6,372,0,0,7640.269665,9.013157999999748,330.18393774968587,0
"147.32.84.165",4397,"195.128.50.36",25,6,372,6,372,0,0,7641.272325,9.011962000000494,330.2277572852434,0
"147.32.84.165",1204,"64.12.90.98",25,6,372,6,372,0,0,7642.272901,9.012801999999283,330.1969798071939,0
"147.32.84.165",1197,"212.117.174.7",4506,6,372,6,372,0,0,7642.273039,9.012790000000678,330.1974194450083,0
"147.32.84.165",1191,"61.17.216.15",6667,7,426,6,364,1,62,7657.394363,0.18667499999992287,15599.303602524189,2657.024239990384
"147.32.84.165",4263,"46.4.74.165",25,6,372,6,372,0,0,7657.580745,8.92703100000017,333.3695155757769,0
"147.32.84.165",4465,"95.163.15.194",25,6,372,6,372,0,0,7657.794815,9.013176999999814,330.18324171377765,0
"147.32.84.165",1205,"77.238.184.241",25,6,372,6,372,0,0,7657.895007,9.01313299999947,330.1848535908851,0
"147.32.84.165",1047,"46.4.74.165",25,6,372,6,372,0,0,7659.597482,9.013011999999435,330.18928633404533,0
"147.32.84.165",4480,"74.125.127.27",25,6,372,6,372,0,0,7659.597621,9.012996999999814,330.189835855938,0
"147.32.84.165",1207,"205.188.190.1",25,6,372,6,372,0,0,7660.599464,9.01296100000036,330.19115471595643,0
"147.32.84.165",4491,"74.125.157.27",25,6,372,6,372,0,0,7660.599574,9.012915000000248,330.19283994134173,0
"147.32.84.165",1208,"207.115.20.23",25,6,372,6,372,0,0,7661.099662,9.151797000000442,325.18203801940274,0
"147.32.84.165",1050,"212.72.165.79",25,6,372,6,372,0,0,7661.299936,9.112333000000035,326.5903473896299,0
"147.32.84.165",4518,"62.213.110.35",25,6,372,6,372,0,0,7662.301421,9.012697000000117,330.200826678181,0
"147.32.84.165",1211,"74.6.136.65",25,6,372,6,372,0,0,7663.303237,9.01279599999998,330.19719962595474,0
"147.32.84.165",4150,"212.117.174.7",4506,6,372,6,372,0,0,7663.303338,9.012757999999849,330.19859181840343,0
"147.32.84.165",4243,"89.108.67.8",25,6,372,6,372,0,0,7678.525178,8.912830000000213,333.90068025530934,0
"147.32.84.165",4995,"62.213.110.35",25,6,372,6,372,0,0,7678.825409,8.912492999999813,333.91330573836774,0
"147.32.84.165",1214,"64.12.139.193",25,6,372,6,372,0,0,7678.825544,8.912424000000101,333.91589089567174,0
"147.32.84.165",4559,"65.54.188.78",25,6,372,6,372,0,0,7678.925588,8.912994000000253,333.8945364486855,0
"147.32.84.165",4566,"77.88.21.89",25,6,372,6,372,0,0,7680.628038,8.912731000000349,333.9043891260584,0
"147.32.84.165",1215,"66.94.236.34",25,6,372,6,372,0,0,7681.62941,8.913283000000774,333.8837104128458,0
"147.32.84.165",1052,"81.177.26.77",25,6,372,6,372,0,0,7682.130545,8.912207999999737,333.92398382085423,0
"147.32.84.165",4998,"89.108.70.32",25,6,372,6,372,0,0,7682.330614,8.91229899999962,333.92057425363834,0
"147.32.84.165",1216,"205.188.59.194",25,6,372,6,372,0,0,7683.332159,8.912199000000328,333.92432103456065,0
"147.32.84.165",1207,"212.117.174.7",4506,6,372,6,372,0,0,7684.332949,8.91397600000073,333.8577532629386,0
"147.32.84.165",4473,"206.123.66.59",25,6,372,6,372,0,0,7684.333114,8.913948999999775,333.85876450494334,0
"147.32.84.165",4595,"89.108.70.32",25,6,372,6,372,0,0,7684.333227,8.91389799999979,333.86067464537626,0
"147.32.84.165",1218,"203.188.197.119",25,6,372,6,372,0,0,7684.333302,8.913883999999598,333.8611990014829,0
"147.32.84.165",1208,"89.253.98.138",6667,6,372,6,372,0,0,7699.454874,9.013237999999546,330.1810070920295,0
"147.32.84.165",4498,"206.123.66.59",25,6,372,6,372,0,0,7699.755887,9.01254499999959,330.206395640758,0
"147.32.84.165",4617,"188.93.212.21",25,6,372,6,372,0,0,7699.756035,9.012525000000096,330.2071284129551,0
"147.32.84.165",1226,"74.6.136.65",25,6,372,6,372,0,0,7699.85537,9.013103999999657,330.18591597302253,0
"147.32.84.165",4721,"195.54.162.79",25,6,372,6,372,0,0,7701.558185,9.014044000000467,330.1514836182124,0
"147.32.84.165",1026,"188.93.212.21",25,6,372,6,372,0,0,7702.559111,9.014526000000842,330.1338306639442,0
"147.32.84.165",1232,"64.12.139.193",25,6,372,6,372,0,0,7702.559244,9.014514999999847,330.1342335111818,0
"147.32.84.165",4733,"77.88.21.89",25,6,372,6,372,0,0,7703.061193,9.01303900000039,330.1882971991879,0
"147.32.84.165",4658,"94.229.67.92",25,6,372,6,372,0,0,7703.261919,9.012728000000607,330.199690925966,0
"147.32.84.165",1233,"74.6.136.244",25,6,372,6,372,0,0,7704.261947,9.012964999999895,330.19100817544887,0
"147.32.84.165",4559,"212.117.174.7",4506,6,372,6,372,0,0,7705.263123,9.013432000000648,330.17390046319605,0
"147.32.84.165",4765,"77.88.21.89",25,6,372,6,372,0,0,7705.263282,9.013396999999713,330.17518256436443,0
"147.32.84.165",2839,"194.87.0.16",25,6,372,6,372,0,0,7705.263358,9.013369999999668,330.1761716206158,0
"147.32.84.165",1052,"174.133.57.141",80,16,3429,12,1428,4,2001,7720.485246,0.4845629999999801,23575.881773887955,33035.95198147745
"147.32.84.165",1234,"74.6.140.64",25,6,372,6,372,0,0,7720.645876,8.952313000000686,332.42805518526575,0
"147.32.84.165",4998,"212.117.174.7",4506,6,372,6,372,0,0,7720.78569,9.340791999999965,318.6025339178959,0
"147.32.84.165",1215,"115.98.215.108",6667,6,372,6,372,0,0,7720.785835,9.34384399999999,318.4984680823014,0
"147.32.84.165",4675,"208.101.60.120",25,6,372,6,372,0,0,7720.885587,9.250476000000162,321.71317454366107,0
"147.32.84.165",1828,"78.46.250.193",25,6,372,6,372,0,0,7722.588104,9.034169999999904,329.415983980823,0
"147.32.84.165",1235,"64.12.90.98",25,6,372,6,372,0,0,7723.589926,9.012666999999965,330.201925800655,0
"147.32.84.165",4711,"208.101.60.120",25,6,372,6,372,0,0,7724.090744,9.012407999999596,330.2114151955985,0
"147.32.84.165",2132,"78.46.250.193",25,6,372,6,372,0,0,7724.090875,9.012402000000293,330.2116350335796,0
"147.32.84.165",1236,"64.12.139.193",25,6,372,6,372,0,0,7724.090934,9.012392000000546,330.2120014308987,0
"147.32.84.165",1072,"194.85.217.2",25,6,372,6,372,0,0,7724.291149,9.012241000000358,330.2175341294004,0
"147.32.84.165",2206,"209.190.61.35",25,6,372,6,372,0,0,7725.292426,9.012813000000278,330.19657680680916,0
"147.32.84.165",1237,"74.6.136.65",25,6,372,6,372,0,0,7726.29344,9.012876999999207,330.1942320970609,0
"147.32.84.165",1074,"194.28.172.37",25,6,372,6,372,0,0,7726.293595,9.012853999999606,330.195074723293,0
"147.32.84.165",3606,"77.243.96.10",25,6,372,6,372,0,0,7741.615331,9.013291999999637,330.1790289275128,0
"147.32.84.165",1247,"12.102.252.75",25,6,372,6,372,0,0,7741.815613,9.01364199999989,330.1662080655118,0
"147.32.84.165",1232,"212.117.171.138",65500,14,846,10,604,4,242,7741.915772,82.9695099999999,58.23826126007018,23.333872888968518
"147.32.84.165",1095,"62.109.21.242",25,6,372,6,372,0,0,7741.915903,9.013245999999526,330.18071402912517,0
"147.32.84.165",1036,"77.243.96.10",25,6,372,6,372,0,0,7743.618475,9.012952000000041,330.1914844326239,0
"147.32.84.165",1249,"65.55.37.120",25,6,372,6,372,0,0,7743.61857,9.012985000000299,330.1902754747624,0
"147.32.84.165",4721,"66.94.236.34",25,6,372,6,372,0,0,7744.619821,9.012969999999768,330.19082499998075,0
"147.32.84.165",4772,"194.28.172.37",25,6,372,6,372,0,0,7745.120347,9.012974000000213,330.19067845973257,0
"147.32.84.165",2502,"62.213.110.156",25,6,372,6,372,0,0,7745.120529,9.012918999999783,330.1926933993384,0
"147.32.84.165",1250,"192.75.254.1",25,6,372,6,372,0,0,7745.320641,9.013076999999612,330.1869050935799,0
"147.32.84.165",4733,"112.200.131.200",6667,6,372,6,372,0,0,7746.32259,9.013066000000435,330.18730807029,0
"147.32.84.165",1072,"212.117.174.7",4506,6,372,6,372,0,0,7747.323796,9.013112000000547,330.1856229013707,0
"147.32.84.165",1077,"66.230.175.168",25,6,372,6,372,0,0,7747.323935,9.013083999999253,330.1866486543614,0
"147.32.84.165",1040,"62.213.110.156",25,6,372,6,372,0,0,7762.545999,9.012628999999833,330.20331803295744,0
"147.32.84.165",1252,"65.54.188.94",25,6,372,6,372,0,0,7762.546135,9.012596000000485,330.2045270862956,0
"147.32.84.165",1236,"212.117.174.7",4506,6,372,6,372,0,0,7762.745999,9.013286000000335,330.17924872237376,0
"147.32.84.165",1074,"93.178.250.214",6667,9,552,6,372,3,180,7762.746134,1.0736040000001594,2771.971788480257,1341.2766718452858
"147.32.84.165",2541,"66.230.175.168",25,6,372,6,372,0,0,7762.846238,9.012924999999996,330.19247358654394,0
"147.32.84.165",2855,"64.120.247.194",25,6,372,6,372,0,0,7762.846376,9.012854999999945,330.1950380872674,0
"147.32.84.165",1254,"209.85.225.27",25,6,372,6,372,0,0,7763.820023,8.940771999999924,332.857162670072,0
"147.32.84.165",1081,"195.137.160.20",25,6,372,6,372,0,0,7764.54907,9.012251000000106,330.2171677198033,0
"147.32.84.165",1042,"64.120.247.194",25,6,372,6,372,0,0,7765.551719,9.011038999999982,330.2615824878802,0
"147.32.84.165",1255,"209.85.143.27",25,6,372,6,372,0,0,7765.551778,9.011109000000033,330.259016953406,0
"147.32.84.165",4789,"65.54.188.72",25,6,372,6,372,0,0,7766.050987,9.012566000000334,330.20562623340453,0
"147.32.84.165",2920,"174.142.90.173",25,6,372,6,372,0,0,7766.250759,9.013150000000678,330.1842308182795,0
"147.32.84.165",1260,"124.108.110.37",25,6,372,6,372,0,0,7767.252373,9.012831999999435,330.19588071764645,0
"147.32.84.165",3892,"89.111.177.200",25,6,372,6,372,0,0,7768.254001,9.012700999999652,330.20068012908837,0
"147.32.84.165",1045,"174.142.90.173",25,6,372,6,372,0,0,7768.254139,9.012688000000708,330.20115641413156,0
"147.32.84.165",1261,"209.85.143.27",25,6,372,6,372,0,0,7768.254197,9.012681999999586,330.20137623851997,0
"147.32.84.165",4319,"195.24.65.155",25,6,372,6,372,0,0,7768.254254,9.012675999999374,330.2015960631678,0
"147.32.84.165",3603,"89.238.159.206",25,6,372,6,372,0,0,7783.575852,9.01305500000035,330.187711048017,0
"147.32.84.165",4772,"174.133.57.141",80,16,3429,12,1428,4,2001,7783.876148,0.4797389999994266,23812.948290661494,33368.14392830087
"147.32.84.165",1263,"217.116.0.227",25,6,372,6,372,0,0,7784.034998,8.95435499999985,332.35224647672,0
"147.32.84.165",3512,"118.86.12.94",6667,6,372,6,372,0,0,7784.777921,9.012854999999945,330.1950380872674,0
"147.32.84.165",1094,"195.54.209.178",25,6,372,6,372,0,0,7785.579192,9.012893999999505,330.19360928910993,0
"147.32.84.165",1046,"89.238.159.206",25,6,372,6,372,0,0,7786.580164,9.012877000000117,330.19423209702757,0
"147.32.84.165",1264,"124.108.110.37",25,6,372,6,372,0,0,7786.580224,9.012938999999278,330.1919606912061,0
"147.32.84.165",2719,"212.48.143.203",25,6,372,6,372,0,0,7786.580282,9.012932000000546,330.1922171386425,0
"147.32.84.165",3870,"81.26.144.245",25,6,372,6,372,0,0,7787.080707,9.013103000000228,330.18595260699055,0
"147.32.84.165",1265,"209.85.225.27",25,6,372,6,372,0,0,7787.281026,9.012936000000082,330.19207059719196,0
"147.32.84.165",2761,"213.189.198.9",25,6,372,6,372,0,0,7788.282928,9.014407000000574,330.13818879043407,0
"147.32.84.165",4495,"209.85.229.27",25,6,372,6,372,0,0,7789.284096,9.015007999999398,330.1161795974223,0
"147.32.84.165",1268,"209.85.143.27",25,6,372,6,372,0,0,7789.284241,9.014925999999832,330.119182342712,0
"147.32.84.165",4772,"212.117.174.7",4506,6,372,6,372,0,0,7804.605976,9.013152000000446,330.1841575510823,0
"147.32.84.165",4789,"92.87.4.97",6667,9,552,6,372,3,180,7805.006469,1.0610919999999169,2804.6578430524714,1357.0925047028088
"147.32.84.165",1255,"212.117.174.7",4506,6,372,6,372,0,0,7805.807817,9.013359000000492,330.1765745711269,0
"147.32.84.165",1098,"92.38.199.19",25,6,372,6,372,0,0,7805.807927,9.013372000000345,330.17609835696186,0
"147.32.84.165",4452,"193.232.122.13",25,6,372,6,372,0,0,7806.067757,8.953301000000465,332.3913716292846,0
"147.32.84.165",1270,"65.55.88.22",25,6,372,6,372,0,0,7806.609099,9.013345999999729,330.17705078669894,0
"147.32.84.165",4855,"92.38.199.19",25,6,372,6,372,0,0,7807.610682,9.01249899999948,330.20808102172015,0
"147.32.84.165",4084,"194.28.172.37",25,6,372,6,372,0,0,7807.610716,9.012603999999556,330.20423398167134,0
"147.32.84.165",1271,"124.108.116.109",25,6,372,6,372,0,0,7808.111397,9.01253700000052,330.2066887492199,0
"147.32.84.165",4879,"74.125.157.27",25,6,372,6,372,0,0,7808.311688,9.012513000000581,330.20756807782783,0
"147.32.84.165",1051,"194.28.172.37",25,6,372,6,372,0,0,7809.312851,9.01306999999997,330.1871615331968,0
"147.32.84.165",1272,"209.85.225.27",25,6,372,6,372,0,0,7809.312985,9.013060000000223,330.187527876207,0
"147.32.84.165",4889,"212.95.58.71",25,6,372,6,372,0,0,7810.314568,9.012601999999788,330.2043072577786,0
"147.32.84.165",1053,"78.46.183.235",25,6,372,6,372,0,0,7810.314686,9.012574000000313,330.20533312679555,0
"147.32.84.165",1273,"209.85.143.27",25,6,372,6,372,0,0,7825.636203,8.913292999999612,333.88333582214,0
"147.32.84.165",3870,"111.92.142.42",6667,6,372,6,372,0,0,7826.737805,9.01292999999987,330.19229040944987,0
"147.32.84.165",4863,"72.14.213.27",25,6,372,6,372,0,0,7826.938496,9.012505000000601,330.2078611884045,0
"147.32.84.165",4268,"78.46.183.235",25,6,372,6,372,0,0,7827.538931,9.01307799999995,330.1868684593672,0
"147.32.84.165",1275,"203.32.142.34",25,6,372,6,372,0,0,7827.539165,9.012969999999768,330.19082499998075,0
"147.32.84.165",1232,"212.117.171.138",65500,342,333074,254,326402,88,6672,7828.541033,33.773519999999735,77315.48266215723,1580.4097411226435
"147.32.84.165",1103,"91.218.38.36",25,6,372,6,372,0,0,7828.563863,8.989645999999993,331.04751844510923,0
"147.32.84.165",4641,"89.188.104.6",25,6,372,6,372,0,0,7829.041478,9.012660999999753,330.2021456260345,0
"147.32.84.165",1276,"207.115.37.21",25,6,372,6,372,0,0,7829.241354,9.01315700000032,330.18397438321495,0
"147.32.84.165",4890,"83.164.192.67",25,6,372,6,372,0,0,7830.242939,9.012944000000061,330.1917775146478,0
"147.32.84.165",4674,"79.174.66.33",25,6,372,6,372,0,0,7831.244271,9.012955000000147,330.19137452699493,0
"147.32.84.165",1277,"204.232.236.158",25,6,372,6,372,0,0,7831.244411,9.01287500000035,330.19430536869584,0
"147.32.84.165",4084,"212.117.174.7",4506,6,372,6,372,0,0,7846.566909,10.100494000000253,294.6390542878324,0
"147.32.84.165",1053,"61.17.216.19",6667,6,372,6,372,0,0,7847.768443,10.263758000000053,289.9522767391812,0
"147.32.84.165",1051,"212.117.174.7",4506,6,372,6,372,0,0,7847.96824,10.06714699999975,295.6150337330004,0
"147.32.84.165",1060,"74.54.18.180",25,6,372,6,372,0,0,7847.968372,10.070212999999967,295.5250301061169,0
"147.32.84.165",1057,"79.174.66.33",25,6,372,6,372,0,0,7848.569187,10.33421399999952,287.9754570594472,0
"147.32.84.165",1278,"204.11.209.99",25,6,372,6,372,0,0,7848.569285,10.337354000000232,287.88798371420125,0
"147.32.84.165",1427,"83.146.124.6",25,6,372,6,372,0,0,7849.570902,10.216503999999986,291.29338176738383,0
"147.32.84.165",1063,"94.75.243.11",25,6,372,6,372,0,0,7850.071651,10.156965000000127,293.0009111973865,0
"147.32.84.165",1279,"209.85.225.27",25,6,372,6,372,0,0,7850.271897,9.959900000000744,298.7981807046032,0
"147.32.84.165",1273,"212.117.171.138",65500,14,846,10,604,4,242,7851.27309,5.320314000000508,908.2170713983307,363.8882968185365
"147.32.84.165",3028,"83.146.124.6",25,6,372,6,372,0,0,7851.273222,10.269366999999875,289.7939084268813,0
"147.32.84.165",4558,"89.111.176.244",25,6,372,6,372,0,0,7851.273276,10.27251299999989,289.705157832366,0
"147.32.84.165",1280,"98.139.54.60",25,6,372,6,372,0,0,7852.2747,9.841526000000158,302.3921290255142,0
"147.32.84.165",4863,"65.55.196.251",443,197,170551,136,10936,61,159615,7852.274839,10.119004000000132,8645.910210135193,126190.28513082744
"147.32.84.165",3036,"74.54.18.180",25,6,372,6,372,0,0,7852.375461,9.747173000000657,305.31929616923793,0
"147.32.84.165",1064,"89.111.176.244",25,6,372,6,372,0,0,7852.375491,9.750309000000016,305.2210960698779,0
"147.32.84.165",1281,"209.85.225.27",25,6,372,6,372,0,0,7852.375516,9.753491999999824,305.12148879601824,0
"147.32.84.165",1108,"174.123.87.100",25,6,372,6,372,0,0,7852.375545,9.756691000000501,305.021446307959,0
"147.32.84.165",4665,"178.162.137.203",25,6,372,6,372,0,0,7867.596886,9.01321199999984,330.1819595500531,0
"147.32.84.165",1284,"205.188.103.1",25,6,372,6,372,0,0,7868.798569,9.01300700000047,330.18946950777297,0
"147.32.84.165",1232,"212.117.171.138",65500,14,846,10,604,4,242,7868.998558,203.27412099999947,23.770856694542108,9.524084967018528
"147.32.84.165",1111,"89.111.178.33",25,6,372,6,372,0,0,7869.021406,8.99051099999997,331.0156675187884,0
"147.32.84.165",1066,"91.121.49.79",25,6,372,6,372,0,0,7869.600071,9.012392000000546,330.2120014308987,0
"147.32.84.165",1285,"98.139.54.60",25,6,372,6,372,0,0,7870.601357,9.012648000000809,330.2026219153054,0
"147.32.84.165",4889,"210.211.186.114",6667,4,248,4,248,0,0,7870.601389,3.003932999999961,660.4674604926361,0
"147.32.84.165",4881,"89.111.178.33",25,6,372,6,372,0,0,7871.101679,9.012917999999445,330.1927300348437,0
"147.32.84.165",1067,"66.135.44.67",25,6,372,6,372,0,0,7871.101814,9.012907000000268,330.19313302577194,0
"147.32.84.165",1287,"24.249.116.47",25,6,372,6,372,0,0,7871.302001,9.012894999999844,330.19357265340955,0
"147.32.84.165",1118,"87.120.70.1",25,6,372,6,372,0,0,7872.30328,9.01319599999988,330.18254568080397,0
"147.32.84.165",1061,"66.135.44.67",25,6,372,6,372,0,0,7873.304655,9.013098999999784,330.1860991430441,0
"147.32.84.165",1288,"209.85.225.27",25,6,372,6,372,0,0,7873.304788,9.013090999999804,330.18639221550796,0
"147.32.84.165",1279,"212.117.174.7",4506,6,372,6,372,0,0,7873.405303,9.012536000000182,330.2067253878309,0
"147.32.84.165",4558,"212.117.174.7",4506,6,372,6,372,0,0,7886.123091,9.01327399999991,330.17968831304023,0
"147.32.84.165",1112,"195.137.160.20",25,6,372,6,372,0,0,7886.123225,9.013192999999774,330.1826555805556,0
"147.32.84.165",4767,"178.162.137.203",25,6,372,6,372,0,0,7888.626808,8.912825999999768,333.9008301070926,0
"147.32.84.165",1108,"174.133.57.141",80,16,3441,12,1440,4,2001,7889.829122,0.4696720000001733,24527.755540027403,34083.36030249641
"147.32.84.165",1289,"98.139.54.60",25,6,372,6,372,0,0,7889.984774,8.856863000000885,336.0106168515537,0
"147.32.84.165",3203,"93.170.48.157",25,6,372,6,372,0,0,7890.029141,8.912725000000137,333.90461390876015,0
"147.32.84.165",1069,"174.142.184.181",25,6,372,6,372,0,0,7890.629988,8.912580000000162,333.9100462492282,0
"147.32.84.165",1290,"207.115.37.21",25,6,372,6,372,0,0,7892.131869,8.912685000000238,333.9061124677828,0
"147.32.84.165",1123,"217.16.28.65",25,6,372,6,372,0,0,7892.332162,8.912674000000152,333.9065245738764,0
"147.32.84.165",1070,"174.142.184.181",25,6,372,6,372,0,0,7893.336111,8.910627000000204,333.9832314830294,0
"147.32.84.165",1291,"65.55.88.22",25,6,372,6,372,0,0,7893.336242,8.910618999999315,333.9835313349419,0
"147.32.84.165",1118,"83.17.186.77",6667,6,372,6,372,0,0,7894.335074,8.912835000000086,333.90049294079506,0
"147.32.84.165",4726,"217.16.28.65",25,6,372,6,372,0,0,7894.435483,8.912403999999697,333.91664022413045,0
"147.32.84.165",4720,"78.140.170.176",25,6,372,6,372,0,0,7894.435617,8.912363999999798,333.9181388911031,0
"147.32.84.165",1293,"205.188.59.194",25,6,372,6,372,0,0,7907.053186,9.013304999999491,330.1785527062679,0
"147.32.84.165",3506,"217.16.18.91",25,6,372,6,372,0,0,7909.557114,9.012746999999763,330.19899482367344,0
"147.32.84.165",1071,"78.140.170.176",25,6,372,6,372,0,0,7910.859256,9.012729000000036,330.1996542889494,0
"147.32.84.165",1298,"62.146.106.39",25,6,372,6,372,0,0,7910.859321,9.012789000000339,330.19745608156234,0
"147.32.84.165",2155,"77.222.41.36",25,6,372,6,372,0,0,7910.9591,9.013001000000259,330.18968931656775,0
"147.32.84.165",4837,"91.219.194.11",25,6,372,6,372,0,0,7911.560395,9.012475999999879,330.20892371863624,0
"147.32.84.165",1299,"64.12.139.193",25,6,372,6,372,0,0,7913.061979,9.012942000000294,330.19185078522673,0
"147.32.84.165",1069,"212.117.174.7",4506,6,372,6,372,0,0,7913.262168,9.013625999999931,330.1667941403407,0
"147.32.84.165",3002,"89.108.124.73",25,6,372,6,372,0,0,7914.26355,9.013038000000051,330.18833383371765,0
"147.32.84.165",1110,"91.219.194.11",25,6,372,6,372,0,0,7915.365146,9.013508000000002,330.17111650647,0
"147.32.84.165",1300,"209.85.225.27",25,6,372,6,372,0,0,7915.365281,9.013522999999623,330.17056704688326,0
"147.32.84.165",1070,"212.117.174.7",4506,6,372,6,372,0,0,7916.76757,9.012518000000455,330.2073848839858,0
"147.32.84.165",1136,"89.108.109.146",25,6,372,6,372,0,0,7916.767707,9.012523999999758,330.20716505166365,0
"147.32.84.165",4749,"194.85.217.2",25,6,372,6,372,0,0,7928.083636,9.013597000000118,330.1678564062672,0
"147.32.84.165",1301,"207.109.18.197",25,6,372,6,372,0,0,7930.587684,9.012662000000091,330.2021089884398,0
"147.32.84.165",3233,"89.108.79.71",25,6,372,6,372,0,0,7931.888947,9.012930999999298,330.1922537740755,0
"147.32.84.165",1080,"89.111.177.177",25,6,372,6,372,0,0,7931.989068,9.013176999999814,330.18324171377765,0
"147.32.84.165",1303,"98.139.54.60",25,6,372,6,372,0,0,7932.590219,9.012916000000587,330.19280330581205,0
"147.32.84.165",3432,"85.153.17.132",25,6,372,6,372,0,0,7934.092078,9.013578000000052,330.1685523773115,0
"147.32.84.165",4797,"94.229.67.92",25,6,372,6,372,0,0,7934.293852,9.0114480000002,330.24659300036285,0
"147.32.84.165",1304,"124.108.110.37",25,6,372,6,372,0,0,7935.293957,9.01343100000031,330.17393709453125,0
"147.32.84.165",1299,"117.204.76.152",6667,6,372,6,372,0,0,7936.395854,9.013036999999713,330.1883704682556,0
"147.32.84.165",1147,"74.125.43.27",25,6,372,6,372,0,0,7937.797446,9.013553000000684,330.16946813312956,0
"147.32.84.165",4807,"213.186.117.20",25,6,372,6,372,0,0,7949.114289,9.012845000000198,330.19540444775595,0
"147.32.84.165",3002,"174.133.57.141",80,16,3429,12,1428,4,2001,7951.617581,0.47068899999976566,24270.803014316647,34009.71766922101
"147.32.84.165",1305,"74.125.148.10",25,6,372,6,372,0,0,7951.772887,8.957669000000351,332.22928866872434,0
"147.32.84.165",3002,"212.117.174.7",4506,6,372,6,372,0,0,7952.919637,9.012660999999753,330.2021456260345,0
"147.32.84.165",1300,"212.117.174.7",4506,6,372,6,372,0,0,7953.01983,9.01258400000006,330.20496674427443,0
"147.32.84.165",3320,"74.125.157.27",25,6,372,6,372,0,0,7953.019964,9.012574000000313,330.20533312679555,0
"147.32.84.165",2591,"195.248.234.8",25,6,372,6,372,0,0,7953.620222,9.012998000000152,330.1897992210749,0
"147.32.84.165",1306,"193.252.22.142",25,6,372,6,372,0,0,7955.122401,9.012936000000082,330.19207059719196,0
"147.32.84.165",1151,"173.192.217.195",25,6,372,6,372,0,0,7955.32271,9.012878999999884,330.19415882539175,0
"147.32.84.165",4817,"64.95.64.197",25,6,372,6,372,0,0,7956.325146,9.0130309999995,330.1885902755871,0
"147.32.84.165",1309,"64.12.90.65",25,6,372,6,372,0,0,7957.626921,8.911906000000272,333.93529958685707,0
"147.32.84.165",3432,"218.201.21.157",6667,4,248,4,248,0,0,7958.82798,3.0041330000003654,660.4234899053266,0
"147.32.84.165",3905,"77.221.128.102",25,6,372,6,372,0,0,7970.044142,9.012784000000465,330.1976392643878,0
"147.32.84.165",1082,"64.95.64.197",25,6,372,6,372,0,0,7972.647463,9.013849999999366,330.1585892820725,0
"147.32.84.165",1310,"209.86.93.226",25,6,372,6,372,0,0,7972.647522,9.013847000000169,330.15869916584387,0
"147.32.84.165",4958,"78.110.50.120",25,6,372,6,372,0,0,7973.849186,9.013570999999502,330.1688087884552,0
"147.32.84.165",2700,"74.125.127.27",25,6,372,6,372,0,0,7973.950358,9.01349300000038,330.17166596788553,0
"147.32.84.165",1311,"209.85.143.27",25,6,372,6,372,0,0,7974.551817,9.012186000000838,330.2195493967527,0
"147.32.84.165",4944,"77.222.41.41",25,6,372,6,372,0,0,7976.052813,9.012463000000025,330.2094000274943,0
"147.32.84.165",1140,"92.63.96.236",25,6,372,6,372,0,0,7976.253356,9.01250600000003,330.20782454957475,0
"147.32.84.165",1312,"67.39.166.3",25,6,372,6,372,0,0,7977.35439,9.013128999999935,330.1850001259298,0
"147.32.84.165",1306,"196.205.12.237",6667,6,372,6,372,0,0,7978.556044,9.012877000000117,330.19423209702757,0
"147.32.84.165",4260,"112.216.242.123",25,6,372,6,372,0,0,7978.656189,9.01293799999985,330.1919973265155,0
"147.32.84.165",4078,"92.63.96.236",25,6,372,6,372,0,0,7991.07442,9.012813000000278,330.19657680680916,0
"147.32.84.165",1313,"98.139.54.60",25,6,372,6,372,0,0,7991.074552,9.012735000000248,330.19943446688694,0
"147.32.84.165",1309,"212.117.174.7",4506,6,372,6,372,0,0,7993.678072,9.013176000000385,330.1832783471523,0
"147.32.84.165",1306,"212.117.174.7",4506,6,372,6,372,0,0,7994.879951,9.01274100000046,330.1992146451172,0
"147.32.84.165",4261,"85.21.144.151",25,6,372,6,372,0,0,7994.880083,9.012743999999657,330.1991047343754,0
"147.32.84.165",2588,"62.231.15.143",25,6,372,6,372,0,0,7994.979844,9.012981999999283,330.19038537969305,0
"147.32.84.165",1314,"209.85.225.27",25,6,372,6,372,0,0,7995.580573,9.013184999999794,330.1829486469065,0
"147.32.84.165",3847,"178.170.144.119",25,6,372,6,372,0,0,7997.082614,9.012993999999708,330.1899457605427,0
"147.32.84.165",1090,"82.146.46.219",25,6,372,6,372,0,0,7997.28307,9.012844999999288,330.19540444778926,0
"147.32.84.165",4944,"173.192.170.88",80,50,7182,32,2374,18,4808,7998.385912,57.081826999999976,332.7153491425565,673.8396793080925
"147.32.84.165",1315,"17.148.17.42",25,6,372,6,372,0,0,7999.686384,9.013449000000037,330.1732777319745,0
"147.32.84.165",4424,"81.30.112.202",25,6,372,6,372,0,0,7999.686529,9.01344600000084,330.17338762552333,0
"147.32.84.165",1472,"77.222.41.36",25,6,372,6,372,0,0,8007.598605,9.012528000000202,330.20701849691153,0
"147.32.84.165",1316,"64.12.90.1",25,6,372,6,372,0,0,8012.104599,9.012910999999804,330.1929864835085,0
"147.32.84.165",4212,"74.125.43.27",25,6,372,6,372,0,0,8014.708219,9.013578999999481,330.1685157472044,0
"147.32.84.165",4818,"195.208.0.121",25,6,372,6,372,0,0,8015.910327,9.012298000000555,330.2154456055289,0
"147.32.84.165",1317,"64.12.139.193",25,6,372,6,372,0,0,8016.010172,9.012783000000127,330.19767590099065,0
"147.32.84.165",2855,"213.243.100.67",25,6,372,6,372,0,0,8016.611269,9.012555000000248,330.2060292558457,0
"147.32.84.165",4854,"209.85.225.27",25,6,372,6,372,0,0,8018.113151,9.012673000000177,330.20170597556813,0
"147.32.84.165",1319,"143.164.102.16",25,6,372,6,372,0,0,8018.313496,9.013738000000558,330.1626916601987,0
"147.32.84.165",1081,"74.125.127.27",25,6,372,6,372,0,0,8020.716861,9.013552000000345,330.16950476348126,0
"147.32.84.165",3702,"174.122.29.35",25,6,372,6,372,0,0,8020.717002,9.013533999999709,330.170164111002,0
"147.32.84.165",1320,"98.139.54.60",25,6,372,6,372,0,0,8028.628358,9.095618999999715,327.19048588118005,0
"147.32.84.165",1261,"72.14.213.27",25,6,372,6,372,0,0,8033.135147,8.912671000000046,333.90663696662705,0
"147.32.84.165",4902,"93.170.24.242",25,6,372,6,372,0,0,8035.638683,9.013856999999916,330.1583328868017,0
"147.32.84.165",1323,"209.85.225.27",25,6,372,6,372,0,0,8036.840204,9.012982000000193,330.19038537965974,0
"147.32.84.165",3892,"77.88.21.89",25,6,372,6,372,0,0,8036.840328,9.013001999999688,330.18965268177055,0
"147.32.84.165",4989,"195.88.207.18",25,6,372,6,372,0,0,8036.940226,9.012911000000713,330.1929864834752,0
"147.32.84.165",1324,"81.169.145.102",25,6,372,6,372,0,0,8037.541422,9.01231000000007,330.2150059196784,0
"147.32.84.165",4319,"77.88.21.89",25,6,372,6,372,0,0,8039.043028,9.01313300000038,330.1848535908518,0
"147.32.84.165",1099,"195.88.207.18",25,6,372,6,372,0,0,8039.043159,9.01312599999983,330.1851100273153,0
"147.32.84.165",1325,"64.12.90.1",25,6,372,6,372,0,0,8039.043219,9.013116000000082,330.1854763657733,0
"147.32.84.165",1271,"74.125.157.27",25,6,372,6,372,0,0,8039.243267,9.013036000000284,330.1884071027683,0
"147.32.84.165",2743,"212.59.98.21",25,6,372,6,372,0,0,8041.646794,9.012979000000087,330.19049528463023,0
"147.32.84.165",1326,"148.168.224.83",25,6,372,6,372,0,0,8041.646869,9.013027999999395,330.18870017936257,0
"147.32.84.165",4855,"212.95.58.71",25,6,372,6,372,0,0,8049.558356,9.013004000000365,330.1895794121338,0
"147.32.84.165",2531,"81.26.144.245",25,6,372,6,372,0,0,8054.064756,9.01292100000046,330.1926201283522,0
"147.32.84.165",1327,"209.85.143.27",25,6,372,6,372,0,0,8056.668455,9.013227999999799,330.18137342138317,0
"147.32.84.165",3870,"72.14.213.27",25,6,372,6,372,0,0,8057.870256,9.013377000000219,330.17591519803597,0
"147.32.84.165",4914,"82.146.40.5",25,6,372,6,372,0,0,8057.970607,9.013482999999724,330.17203227654517,0
"147.32.84.165",1328,"64.29.145.47",25,6,372,6,372,0,0,8058.571494,9.012878000000455,330.19419546118894,0
"147.32.84.165",1324,"31.192.109.167",80,15,1540,10,1050,5,490,8060.07343,0.2498889999997118,33614.92502675063,15686.965012483626
"147.32.84.165",4902,"101.0.32.121",6667,6,372,6,372,0,0,8060.156049,8.930190999999468,333.2515508347109,0
"147.32.84.165",4268,"91.218.38.36",25,6,372,6,372,0,0,8060.273704,9.013173999999708,330.1833516139926,0
"147.32.84.165",1119,"91.218.229.219",25,6,372,6,372,0,0,8062.677465,9.013127000000168,330.1850733935009,0
"147.32.84.165",1329,"216.82.241.131",25,6,372,6,372,0,0,8062.677605,9.013112000000547,330.1856229013707,0
"147.32.84.165",4902,"212.117.174.7",4506,6,372,6,372,0,0,8070.588713,9.012700000000223,330.2007167663327,0
"147.32.84.165",1232,"212.117.171.138",65500,14,846,10,604,4,242,8075.095374,23.097042999999758,209.20426913523306,83.82025352769271
"147.32.84.165",3034,"79.137.226.103",25,6,372,6,372,0,0,8075.11795,8.988949999999932,331.07315092419276,0
"147.32.84.165",1330,"64.12.90.65",25,6,372,6,372,0,0,8077.699444,9.016230000000178,330.07143784042125,0
"147.32.84.165",1124,"79.137.226.103",25,6,372,6,372,0,0,8078.900328,9.01811700000053,330.0023718920286,0
"147.32.84.165",1331,"213.165.64.100",25,6,372,6,372,0,0,8078.900462,9.018108000000211,330.0027012317806,0
"147.32.84.165",4674,"188.143.164.2",25,6,372,6,372,0,0,8079.000977,9.01810900000055,330.00266463843127,0
"147.32.84.165",3504,"217.16.28.65",25,6,372,6,372,0,0,8079.601564,9.019312000000355,329.9586487306219,0
"147.32.84.165",1328,"98.126.71.122",80,19,4917,14,1430,5,3487,8080.804234,19.198574999999437,595.8775586209047,1453.024508329437
"147.32.84.165",1332,"157.174.228.62",25,6,372,6,372,0,0,8080.980001,8.946390000000065,332.64814075844873,0
"147.32.84.165",3870,"89.43.210.7",6667,9,552,6,372,3,180,8081.30526,1.056109999999535,2817.8882881530435,1363.494332977279
"147.32.84.165",4890,"188.143.164.2",25,6,372,6,372,0,0,8082.361586,8.96864800000003,331.82258909035005,0
"147.32.84.165",2900,"217.118.84.56",25,6,372,6,372,0,0,8082.361651,8.968707999999424,331.8203692215413,0
"147.32.84.165",1333,"209.85.225.27",25,6,372,6,372,0,0,8083.705639,8.928785000000062,333.3040273676631,0
"147.32.84.165",1057,"83.146.124.6",25,6,372,6,372,0,0,8083.705778,8.928774000000885,333.30443798887785,0
"147.32.84.165",3629,"217.118.84.56",25,6,372,6,372,0,0,8091.530876,9.041683999999805,329.14222616053206,0
"147.32.84.165",1334,"64.12.90.1",25,6,372,6,372,0,0,8091.530955,9.041747000000214,329.13993280280124,0
"147.32.84.165",4902,"86.126.237.212",6667,4,248,4,248,0,0,8096.045447,3.0114599999997154,658.8166537162,0
"147.32.84.165",1063,"83.146.124.6",25,6,372,6,372,0,0,8098.655026,9.028649999999288,329.617384658862,0
"147.32.84.165",3680,"89.108.79.57",25,6,372,6,372,0,0,8098.65509,9.028636999999435,329.61785926271995,0
"147.32.84.165",1335,"209.85.143.27",25,6,372,6,372,0,0,8099.859195,9.028102000000217,329.637392222632,0
"147.32.84.165",3034,"212.117.174.7",4506,6,372,6,372,0,0,8099.972312,9.012666999999965,330.201925800655,0
"147.32.84.165",1331,"212.117.171.138",65500,14,846,10,604,4,242,8100.57278,56.44639499999994,85.60334101052875,34.29802735852311
"147.32.84.165",1112,"195.137.160.20",25,6,372,6,372,0,0,8100.595683,8.990084000000024,331.03138969557926,0
"147.32.84.165",3572,"195.110.124.132",25,6,372,6,372,0,0,8101.874835,9.012720000000627,330.19998402255845,0
"147.32.84.165",1336,"74.6.136.65",25,6,372,6,372,0,0,8103.276602,9.01341500000035,330.17452319679995,0
"147.32.84.165",3504,"212.117.174.7",4506,6,372,6,372,0,0,8104.678757,9.01270999999997,330.2003503940557,0
"147.32.84.165",4767,"93.170.48.157",25,6,372,6,372,0,0,8104.678905,9.012687999999798,330.20115641416487,0
"147.32.84.165",1168,"89.108.70.21",25,6,372,6,372,0,0,8104.679028,9.012613000000783,330.2039042395076,0
"147.32.84.165",1339,"205.188.103.1",25,6,372,6,372,0,0,8112.589901,9.0137679999998,330.16159279893446,0
"147.32.84.165",1123,"217.16.28.65",25,6,372,6,372,0,0,8114.993984,9.012622000000192,330.2035744980691,0
"147.32.84.165",4455,"188.138.114.90",25,6,372,6,372,0,0,8119.700125,9.013358000000153,330.1766112030555,0
"147.32.84.165",1341,"165.21.74.113",25,6,372,6,372,0,0,8120.902393,9.012460999999348,330.2094733059278,0
"147.32.84.165",1290,"72.14.215.114",25,6,372,6,372,0,0,8121.002524,9.013106999999764,330.18580607110044,0
"147.32.84.165",1264,"209.85.229.27",25,6,372,6,372,0,0,8121.603809,9.012015999999676,330.22577856054704,0
"147.32.84.165",3034,"174.133.57.141",80,17,2011,12,1428,5,583,8122.904871,147.28971100000035,77.56142586225845,31.665484088022883
"147.32.84.165",1342,"98.139.54.60",25,6,372,6,372,0,0,8123.063783,8.954746000000341,332.33773464930067,0
"147.32.84.165",3572,"190.246.180.21",6667,6,372,6,372,0,0,8124.306732,9.01297599999998,330.19060518967393,0
"147.32.84.165",1291,"90.156.201.71",25,6,372,6,372,0,0,8125.709098,9.013497999999345,330.1714828139105,0
"147.32.84.165",4772,"193.232.122.13",25,6,372,6,372,0,0,8125.70931,9.013426999999865,330.17408361992,0
"147.32.84.165",1343,"74.6.136.65",25,6,372,6,372,0,0,8133.620433,9.013020999999753,330.1889566217677,0
"147.32.84.165",1336,"212.117.174.7",4506,6,372,6,372,0,0,8136.023708,9.014570000000276,330.13221928499183,0
"147.32.84.165",4720,"217.16.28.65",25,6,372,6,372,0,0,8140.730913,8.912830999999642,333.9006427924101,0
"147.32.84.165",1111,"91.121.49.79",25,6,372,6,372,0,0,8141.932026,8.913015999999516,333.89371229673117,0
"147.32.84.165",1344,"209.85.225.27",25,6,372,6,372,0,0,8142.03271,8.912560999999187,333.9107580862865,0
"147.32.84.165",1298,"77.222.41.36",25,6,372,6,372,0,0,8142.633589,8.912467000000106,333.914279850906,0
"147.32.84.165",1285,"66.135.44.67",25,6,372,6,372,0,0,8144.03568,8.912916999999652,333.89742101268484,0
"147.32.84.165",1345,"209.85.143.27",25,6,372,6,372,0,0,8146.238179,8.947771000000103,332.596799806339,0
"147.32.84.165",2155,"89.108.124.73",25,6,372,6,372,0,0,8146.738922,8.913010000000213,333.8939370650239,0
"147.32.84.165",1061,"66.135.44.67",25,6,372,6,372,0,0,8146.739096,8.912897999999586,333.89813279588054,0
"147.32.84.165",1346,"64.12.90.1",25,6,372,6,372,0,0,8146.739157,8.912860999999793,333.89951890869486,0
"147.32.84.165",1070,"89.108.109.146",25,6,372,6,372,0,0,8154.550381,9.013275000000249,330.1796516804289,0
"147.32.84.165",1303,"94.229.67.92",25,6,372,6,372,0,0,8156.954151,9.013042000000496,330.1881872956807,0
"147.32.84.165",1347,"66.170.48.103",25,6,372,6,372,0,0,8161.660619,9.013119000000188,330.1853664641439,0
"147.32.84.165",1331,"212.117.171.138",65500,14,846,10,604,4,242,8162.862535,2.4054699999996956,2008.7550457917212,804.8323196715174
"147.32.84.165",3233,"89.108.79.71",25,6,372,6,372,0,0,8162.885278,8.98985200000061,331.0399325817375,0
"147.32.84.165",3432,"213.186.117.20",25,6,372,6,372,0,0,8162.962926,9.012327999999798,330.2143463930814,0
"147.32.84.165",1348,"209.85.143.27",25,6,372,6,372,0,0,8163.563791,9.012806000000637,330.1968332614493,0
"147.32.84.165",1080,"85.153.17.132",25,6,372,6,372,0,0,8163.563851,9.012872000000243,330.19441527627595,0
"147.32.84.165",3320,"195.248.234.8",25,6,372,6,372,0,0,8164.965534,9.013621000000057,330.16697728914727,0
"147.32.84.165",1349,"205.188.103.1",25,6,372,6,372,0,0,8167.168644,9.01306199999999,330.1874546075466,0
"147.32.84.165",1298,"116.72.72.149",6667,4,248,4,248,0,0,8167.669198,3.004366000000118,660.3722715541056,0
"147.32.84.165",1331,"212.117.174.7",4506,6,372,6,372,0,0,8167.66934,9.013160999999855,330.18382784908067,0
"147.32.84.165",1147,"74.125.43.27",25,6,372,6,372,0,0,8175.580813,9.012593000000379,330.2046370006806,0
"147.32.84.165",4817,"64.95.64.197",25,6,372,6,372,0,0,8177.983973,9.013108999999531,330.1857328032042,0
"147.32.84.165",1350,"98.139.54.60",25,6,372,6,372,0,0,8182.690948,9.013246999999865,330.1806773962862,0
"147.32.84.165",1298,"212.117.171.138",65500,54,15596,36,10864,18,4732,8183.892874,22.95175300000028,3786.726007377255,1649.3729258937012
"147.32.84.165",1305,"77.222.41.36",25,6,372,6,372,0,0,8183.915613,8.989779000000453,331.04262073626614,0
"147.32.84.165",1082,"64.95.64.197",25,6,372,6,372,0,0,8183.99291,9.012573999999404,330.2053331268289,0
"147.32.84.165",1351,"65.55.92.152",25,6,372,6,372,0,0,8183.992974,9.012632999999369,330.20317148165344,0
"147.32.84.165",3002,"74.125.157.27",25,6,372,6,372,0,0,8184.593546,9.012864000000263,330.1947083635028,0
"147.32.84.165",2700,"64.12.90.1",25,6,372,6,372,0,0,8185.995446,9.01315700000032,330.18397438321495,0
"147.32.84.165",1352,"64.98.36.4",25,6,372,6,372,0,0,8187.09743,9.012714000000415,330.2002038453526,0
"147.32.84.165",1300,"95.57.118.4",25,6,372,6,372,0,0,8188.198605,9.013306000000739,330.17851607387524,0
"147.32.84.165",4261,"62.231.15.143",25,6,372,6,372,0,0,8188.699918,9.01249800000005,330.2081176606068,0
"147.32.84.165",1353,"65.55.37.72",25,6,372,6,372,0,0,8196.611028,9.01283599999988,330.1957341729107,0
"147.32.84.165",1080,"212.117.171.138",65500,125,84670,80,4804,45,79866,8199.014217,8.057677999999214,4769.612287808442,79294.30786388613
"147.32.84.165",2591,"89.188.127.206",25,6,372,6,372,0,0,8199.014351,9.01285900000039,330.1948915432796,0
"147.32.84.165",1090,"82.146.46.219",25,6,372,6,372,0,0,8203.720885,9.012980999999854,330.1904220146529,0
"147.32.84.165",1354,"64.12.90.1",25,6,372,6,372,0,0,8204.922745,9.012823999999455,330.1961738074748,0
"147.32.84.165",1349,"65.55.16.187",443,34,13684,24,8736,10,4948,8204.922847,2.065500000000611,33835.87509076704,19164.366981354775
"147.32.84.165",1151,"77.222.41.41",25,6,372,6,372,0,0,8205.02304,9.012672000000748,330.20174261304004,0
"147.32.84.165",1472,"77.222.41.36",25,6,372,6,372,0,0,8205.088769,8.947066000000632,332.6230073635077,0
"147.32.84.165",1355,"209.85.143.27",25,6,372,6,372,0,0,8205.623998,9.332951000000321,318.8702051473213,0
"147.32.84.165",3905,"77.221.128.102",25,6,372,6,372,0,0,8207.025651,9.012995000000956,330.1899091256219,0
"147.32.84.165",1317,"62.141.76.51",25,6,372,6,372,0,0,8208.127212,9.415032000000792,316.09026926299873,0
"147.32.84.165",1356,"200.16.5.214",25,6,372,6,372,0,0,8209.228895,8.91307500000039,333.89150209101456,0
"147.32.84.165",1298,"212.117.174.7",4506,6,372,6,372,0,0,8209.729597,8.912991999999576,333.8946113718201,0
"147.32.84.165",1351,"212.117.171.138",65500,14,846,10,604,4,242,8217.540994,55.548383999999714,86.98722900741856,34.85249903939618
"147.32.84.165",2700,"212.117.174.7",4506,6,372,6,372,0,0,8217.578926,8.974964999999429,331.58903683749065,0
"147.32.84.165",4958,"78.110.50.120",25,6,372,6,372,0,0,8217.578983,8.975035999999818,331.5864136923863,0
"147.32.84.165",4818,"78.110.50.88",25,6,372,6,372,0,0,8219.944278,9.013178999999582,330.18316844701945,0
"147.32.84.165",1357,"209.85.225.27",25,6,372,6,372,0,0,8224.651384,9.012751000000208,330.1988482761736,0
"147.32.84.165",1311,"77.222.41.41",25,6,372,6,372,0,0,8225.953241,9.012496000001192,330.2081909384044,0
"147.32.84.165",4854,"81.177.6.193",25,6,372,6,372,0,0,8225.953379,9.012480999999752,330.2087405232901,0
"147.32.84.165",1358,"66.170.48.103",25,6,372,6,372,0,0,8226.554084,9.01260000000002,330.2043805339184,0
"147.32.84.165",4260,"112.216.242.123",25,6,372,6,372,0,0,8227.955978,9.013225000000602,330.1814833203211,0
"147.32.84.165",1325,"95.64.43.62",25,6,372,6,372,0,0,8229.057496,9.01360300000124,330.1676366265067,0
"147.32.84.165",1361,"63.174.244.24",25,6,372,6,372,0,0,8230.158933,9.013404999999693,330.1748895117995,0
"147.32.84.165",1306,"85.21.144.151",25,6,372,6,372,0,0,8230.660239,9.012869999998657,330.1944885480922,0
"147.32.84.165",1232,"89.108.79.57",25,6,372,6,372,0,0,8238.571299,9.012724000000162,330.19983747421384,0
"147.32.84.165",1362,"64.12.90.65",25,6,372,6,372,0,0,8240.974921,9.01278099999945,330.1977491742207,0
"147.32.84.165",3847,"178.170.144.119",25,6,372,6,372,0,0,8245.681255,9.013114000001224,330.18554963352244,0
"147.32.84.165",1330,"217.16.28.65",25,6,372,6,372,0,0,8246.983357,9.013153000001694,330.18412091744597,0
"147.32.84.165",1363,"98.139.54.60",25,6,372,6,372,0,0,8246.983494,9.013146999999663,330.18434071918625,0
"147.32.84.165",1357,"212.117.174.7",4506,6,372,6,372,0,0,8247.584164,9.012872999999672,330.19437864043,0
"147.32.84.165",4212,"74.125.43.27",25,6,372,6,372,0,0,8248.986041,9.012902000000395,330.1933162038009,0
"147.32.84.165",2900,"217.118.84.56",25,6,372,6,372,0,0,8250.087513,9.01332899999943,330.1776735321864,0
"147.32.84.165",1364,"195.50.106.142",25,6,372,6,372,0,0,8251.189217,9.01313300000038,330.1848535908518,0
"147.32.84.165",2855,"213.243.100.67",25,6,372,6,372,0,0,8251.690203,9.012586999999257,330.2048568297033,0
"147.32.84.165",3629,"217.118.84.56",25,6,372,6,372,0,0,8259.601837,9.012832000000344,330.1958807176131,0
"147.32.84.165",1365,"209.85.143.27",25,6,372,6,372,0,0,8259.60197,9.012832000000344,330.1958807176131,0
"147.32.84.165",1081,"64.12.90.1",25,6,372,6,372,0,0,8262.004663,9.013656999999512,330.1656586222619,0
"147.32.84.165",1063,"89.108.79.57",25,6,372,6,372,0,0,8266.712227,9.012317000000621,330.2147494367758,0
"147.32.84.165",1366,"64.185.40.80",25,6,372,6,372,0,0,8268.013382,9.012885000000097,330.1939390106462,0
"147.32.84.165",1261,"72.14.213.27",25,6,372,6,372,0,0,8268.01352,9.012870999998995,330.19445191219666,0
"147.32.84.165",1291,"193.232.122.13",25,6,372,6,372,0,0,8268.614866,9.012259999999515,330.2168379518745,0
"147.32.84.165",1367,"64.12.90.1",25,6,372,6,372,0,0,8270.016207,9.012940999999046,330.1918874205784,0
"147.32.84.165",1357,"212.117.174.7",4506,6,372,6,372,0,0,8270.016337,9.012939000000188,330.19196069117277,0
"147.32.84.165",4944,"82.204.252.66",25,6,372,6,372,0,0,8271.117818,9.012923000000228,330.1925468574318,0
"147.32.84.165",1111,"91.121.49.79",25,6,372,6,372,0,0,8272.219628,9.014106999999058,330.14917617466836,0
"147.32.84.165",1368,"216.89.74.55",25,6,372,6,372,0,0,8272.720847,9.013332999998966,330.1775270036447,0
"147.32.84.165",1351,"212.117.171.138",65500,83,46289,56,43760,27,2529,8280.631469,32.049558000000616,10923.083557033557,631.2723563925472
"147.32.84.165",1323,"77.88.21.89",25,6,372,6,372,0,0,8280.654128,8.891750000000684,334.6922709252702,0
"147.32.84.165",1285,"66.135.44.67",25,6,372,6,372,0,0,8283.03559,8.912489000000278,333.9134556014495,0
"147.32.84.165",1370,"168.61.70.64",25,6,372,6,372,0,0,8287.641574,9.013214000000517,330.1818862838305,0
"147.32.84.165",1099,"77.88.21.89",25,6,372,6,372,0,0,8288.943474,9.012948999999935,330.19159433832607,0
"147.32.84.165",2155,"66.135.44.67",25,6,372,6,372,0,0,8288.943604,9.012942999999723,330.19181414994983,0
"147.32.84.165",1371,"204.10.64.148",25,6,372,6,372,0,0,8288.943661,9.012935000000653,330.19210723252576,0
"147.32.84.165",4319,"74.125.157.27",25,6,372,6,372,0,0,8288.943723,9.012925999999425,330.19243695112885,0
"147.32.84.165",1082,"64.95.64.197",25,6,372,6,372,0,0,8289.546011,9.01154200000019,330.2431481759656,0
"147.32.84.165",1372,"203.188.197.119",25,6,372,6,372,0,0,8290.946673,9.014294999999038,330.14229066170094,0
"147.32.84.165",4855,"212.95.58.71",25,6,372,6,372,0,0,8292.047862,9.013159000000087,330.18390111613155,0
"147.32.84.165",3002,"217.72.192.149",25,6,372,6,372,0,0,8293.149509,9.013288999998622,330.1791388249567,0
"147.32.84.165",1373,"205.188.103.1",25,6,372,6,372,0,0,8293.650294,9.012876000000688,330.194268732841,0
"147.32.84.165",1111,"212.117.174.7",4506,6,372,6,372,0,0,8301.56189,9.012785999999323,330.1975659912732,0
"147.32.84.165",4817,"62.231.15.143",25,6,372,6,372,0,0,8303.965074,9.013152999999875,330.1841209175126,0
"147.32.84.165",1374,"98.139.54.60",25,6,372,6,372,0,0,8308.672479,9.013787999998385,330.1608602288553,0
"147.32.84.165",4944,"212.117.171.138",65500,14,846,10,604,4,242,8309.974108,16.91667899999993,285.63525973390045,114.44326631722502
"147.32.84.165",4641,"212.117.174.7",4506,6,372,6,372,0,0,8309.974239,9.01253700000052,330.2066887492199,0
"147.32.84.165",1090,"82.146.46.219",25,6,372,6,372,0,0,8309.974303,9.01256099999955,330.20580942532854,0
"147.32.84.165",1375,"202.67.240.102",25,6,372,6,372,0,0,8309.974365,9.012527000000773,330.20705513556237,0
"147.32.84.165",1285,"65.54.165.169",443,44,24678,34,3828,10,20850,8310.574818,1.6789830000016082,18239.612908511084,99345.85400795615
"147.32.84.165",4268,"91.218.38.36",25,6,372,6,372,0,0,8310.741624,8.946112999999968,332.65844059872825,0
"147.32.84.165",1317,"62.141.76.51",25,6,372,6,372,0,0,8311.976814,9.012978000000658,330.19053191961444,0
"147.32.84.165",1376,"207.115.11.16",25,6,372,6,372,0,0,8313.078753,9.012672000000748,330.20174261304004,0
"147.32.84.165",1124,"188.143.164.2",25,6,372,6,372,0,0,8314.179799,9.013033000001087,330.1885170063885,0
"147.32.84.165",4818,"78.110.50.88",25,6,372,6,372,0,0,8314.680629,9.012950999998793,330.19152106789426,0
"147.32.84.165",1377,"207.115.37.23",25,6,372,6,372,0,0,8322.591948,9.01295300000129,330.19144779736166,0
"147.32.84.165",3002,"95.59.69.146",6667,9,552,6,372,3,180,8324.995491,1.389473999999609,2141.8176950420357,1036.3634008267913
"147.32.84.165",4890,"188.143.164.2",25,6,372,6,372,0,0,8326.385178,8.925202000000354,333.43783143506244,0
"147.32.84.165",4854,"81.177.6.193",25,6,372,6,372,0,0,8326.385244,8.925298000000112,333.4342449966335,0
"147.32.84.165",1378,"209.85.225.27",25,6,372,6,372,0,0,8329.702397,9.016230000001087,330.07143784038794,0
"147.32.84.165",4944,"212.117.174.7",4506,6,372,6,372,0,0,8331.00391,9.013304000000062,330.1785893386021,0
"147.32.84.165",1374,"212.117.171.138",65500,58,20910,40,18030,18,2880,8331.00406,23.48537800000122,6141.693780700166,981.0359450036872
"147.32.84.165",1057,"83.146.124.6",25,6,372,6,372,0,0,8331.026748,8.990523000000394,331.01522569931353,0
"147.32.84.165",4260,"95.64.43.62",25,6,372,6,372,0,0,8331.704945,9.013065000001006,330.18734470456695,0
"147.32.84.165",1379,"64.12.90.1",25,6,372,6,372,0,0,8333.006858,9.01304699999855,330.1880041234089,0
"147.32.84.165",3680,"83.146.124.6",25,6,372,6,372,0,0,8334.109048,9.012236999999004,330.21768069352026,0
"147.32.84.165",1232,"89.108.79.57",25,6,372,6,372,0,0,8334.109179,9.012165000000095,330.2203188689919,0
"147.32.84.165",1382,"65.55.37.72",25,6,372,6,372,0,0,8335.210046,9.013408999999228,330.1747429857288,0
"147.32.84.165",1112,"195.137.160.20",25,6,372,6,372,0,0,8335.712598,9.010991999999533,330.2633050834086,0
"147.32.84.165",1330,"217.16.28.65",25,6,372,6,372,0,0,8343.622406,9.012828999999329,330.19599062627526,0
"147.32.84.165",1383,"194.106.220.51",25,6,372,6,372,0,0,8347.327379,9.013478999999279,330.1721788002433,0
"147.32.84.165",4818,"212.117.174.7",4506,6,372,6,372,0,0,8350.733033,8.912288999999873,333.9209489279401,0
"147.32.84.165",1168,"93.170.48.157",25,6,372,6,372,0,0,8350.733162,8.912286999999196,333.9210238629286,0
"147.32.84.165",3034,"217.118.84.56",25,6,372,6,372,0,0,8352.034271,8.91284799999994,333.9000059240346,0
"147.32.84.165",1384,"209.85.143.27",25,6,372,6,372,0,0,8352.034413,8.912819000001036,333.9010923479602,0
"147.32.84.165",1378,"65.54.165.169",443,35,13487,26,5118,9,8369,8352.735766,1.7875309999999445,22905.33702632361,37455.01476617865
"147.32.84.165",1123,"217.16.28.65",25,6,372,6,372,0,0,8352.902196,8.8463670000001,336.40928530321725,0
"147.32.84.165",1063,"89.108.79.57",25,6,372,6,372,0,0,8352.902256,8.846430000001419,336.406889558785,0
"147.32.84.165",1385,"207.115.37.23",25,6,372,6,372,0,0,8352.902312,8.846433000000616,336.4067754766009,0
"147.32.84.165",4944,"212.117.171.138",65500,48,4473,32,3450,16,1023,8354.037162,55.79577599999902,494.6611012274564,146.67777001614144
"147.32.84.165",1290,"72.14.215.114",25,6,372,6,372,0,0,8354.037266,8.913300000000163,333.8830736090949,0
"147.32.84.165",4268,"62.141.76.51",25,6,372,6,372,0,0,8355.138634,8.913088999999673,333.8909776397509,0
"147.32.84.165",1386,"205.188.103.1",25,6,372,6,372,0,0,8356.240793,8.912467999998626,333.9142423849891,0
"147.32.84.165",4890,"87.239.184.119",6667,9,552,6,372,3,180,8356.640799,1.0179889999999432,2923.410763770695,1414.553595372917
"147.32.84.165",4772,"90.156.201.71",25,6,372,6,372,0,0,8357.659066,8.99643499999911,330.7976993109264,0
"147.32.84.165",1124,"78.110.50.88",25,6,372,6,372,0,0,8364.552179,9.012958999999682,330.1912279862923,0
"147.32.84.165",1387,"98.139.54.60",25,6,372,6,372,0,0,8368.257702,9.012808999999834,330.1967233522928,0
"147.32.84.165",4720,"217.16.28.65",25,6,372,6,372,0,0,8371.662354,9.013249999999971,330.1805674978514,0
"147.32.84.165",4260,"95.64.43.62",25,6,372,6,372,0,0,8372.964404,9.013279999999213,330.17946851759405,0
"147.32.84.165",1388,"209.85.225.27",25,6,372,6,372,0,0,8372.964541,9.01329000000078,330.17910219240065,0
"147.32.84.165",1168,"212.117.174.7",4506,6,372,6,372,0,0,8373.765426,9.013332000000446,330.17756363571795,0
"147.32.84.165",1382,"212.117.171.138",65500,123,84556,80,4804,43,79752,8374.967129,14.366804999999658,2675.055449002121,44409.03875287617
"147.32.84.165",1061,"89.108.124.73",25,6,372,6,372,0,0,8374.967263,9.013075999999273,330.1869417278008,0
"147.32.84.165",1378,"89.108.79.57",25,6,372,6,372,0,0,8376.069261,9.012504000000263,330.20789782727564,0
"147.32.84.165",1389,"64.12.90.1",25,6,372,6,372,0,0,8377.170425,9.012776999999915,330.19789572071164,0
"147.32.84.165",4818,"205.188.186.167",587,30,2661,20,1300,10,1361,8378.674382,31.252785000000586,332.7703435069804,348.3849519330772
"147.32.84.165",1070,"89.108.109.146",25,6,372,6,372,0,0,8378.792264,8.993523000001005,330.9048078266623,0
"147.32.84.165",1390,"202.218.32.162",25,6,372,6,372,0,0,8385.58301,9.012265999999727,330.2166181069323,0
"147.32.84.165",3233,"85.153.17.132",25,6,372,6,372,0,0,8389.288048,9.012791999999536,330.1973461719912,0
"147.32.84.165",1392,"68.6.19.3",25,6,372,6,372,0,0,8392.693213,9.012499999998909,330.20804438284165,0
"147.32.84.165",3034,"212.117.171.138",65500,23,1398,16,972,7,426,8393.99478,6.160170999999536,1262.3026211448653,553.231395686947
"147.32.84.165",1147,"74.125.43.27",25,6,372,6,372,0,0,8393.994918,9.012818999999581,330.19635698887754,0
"147.32.84.165",1393,"65.54.188.110",25,6,372,6,372,0,0,8393.994983,9.012853000000177,330.1951113592934,0
"147.32.84.165",1305,"77.222.41.36",25,6,372,6,372,0,0,8394.7981,9.010840000000826,330.26887615358027,0
"147.32.84.165",1394,"70.39.234.163",25,6,372,6,372,0,0,8395.997485,9.01286600000094,330.1946350916223,0
"147.32.84.165",3432,"95.57.118.4",25,6,372,6,372,0,0,8397.099184,9.012967999999091,330.1908982701703,0
"147.32.84.165",1395,"65.55.88.22",25,6,372,6,372,0,0,8398.2009,9.012607000000571,330.2041240675214,0
"147.32.84.165",2591,"89.188.127.206",25,6,372,6,372,0,0,8399.802823,9.013279000000693,330.1795051500981,0
"147.32.84.165",1396,"211.150.67.46",25,6,372,6,372,0,0,8406.612979,9.012738999999783,330.1992879190301,0
"147.32.84.165",1389,"212.117.174.7",4506,6,372,6,372,0,0,8410.318415,9.012491999999838,330.2083374942306,0
"147.32.84.165",1232,"212.117.171.138",65500,29,4904,20,3952,9,952,8413.722874,22.72159500000089,1391.4516124417657,335.1877366003444
"147.32.84.165",3233,"212.117.174.7",4506,6,372,6,372,0,0,8413.746094,8.989825999999084,331.0408900016867,0
"147.32.84.165",1151,"77.222.41.41",25,6,372,6,372,0,0,8413.746158,8.989886999999726,331.03864375604394,0
"147.32.84.165",1397,"205.188.103.1",25,6,372,6,372,0,0,8415.027273,9.010642999999618,330.276096833503,0
"147.32.84.165",1311,"77.222.41.41",25,6,372,6,372,0,0,8415.02741,9.010630999999194,330.27653668208876,0
"147.32.84.165",1399,"98.139.175.224",25,6,372,6,372,0,0,8415.02747,9.010623999998643,330.27679326098263,0
"147.32.84.165",1306,"85.21.144.151",25,6,372,6,372,0,0,8415.82656,9.012555999999677,330.2059926174225,0
"147.32.84.165",1400,"209.85.143.27",25,6,372,6,372,0,0,8417.028122,9.012904999999591,330.1932062969858,0
"147.32.84.165",1394,"168.187.75.100",6667,6,372,6,372,0,0,8418.129438,8.912566999999399,333.9105332953122,0
"147.32.84.165",1364,"213.243.100.67",25,6,372,6,372,0,0,8419.231177,8.91258899999957,333.90970906435194,0
"147.32.84.165",1401,"209.85.225.27",25,6,372,6,372,0,0,8420.833104,8.912854000000152,333.89978114753694,0
"147.32.84.165",1081,"217.72.192.149",25,6,372,6,372,0,0,8427.542666,9.01323500000035,330.1811169907236,0
"147.32.84.165",1402,"98.139.54.60",25,6,372,6,372,0,0,8431.248606,9.01314900000034,330.184267451907,0
"147.32.84.165",1395,"212.117.171.138",65500,29,3849,20,2568,9,1281,8434.653066,18.190036999998483,1129.409467391502,563.3853301123496
"147.32.84.165",1357,"82.204.252.66",25,6,372,6,372,0,0,8434.653199,9.012993999998798,330.189945760576,0
"147.32.84.165",1404,"64.12.90.1",25,6,372,6,372,0,0,8435.956866,9.01100199999928,330.2629385722296,0
"147.32.84.165",1396,"205.188.192.1",80,13,2966,10,1416,3,1550,8435.957011,0.5807310000000143,19506.44962986257,21352.398959242222
"147.32.84.165",1323,"77.88.21.89",25,6,372,6,372,0,0,8436.07407,8.994484999999258,330.86941609222157,0
"147.32.84.165",1406,"65.55.92.184",25,6,372,6,372,0,0,8436.756361,9.012749999999869,330.19888491304465,0
"147.32.84.165",1397,"212.117.174.7",4506,6,372,6,372,0,0,8438.057828,9.013285999999425,330.1792487224071,0
"147.32.84.165",1099,"77.88.21.89",25,6,372,6,372,0,0,8440.160873,9.013074999998935,330.1869783620298,0
"147.32.84.165",1407,"165.21.74.116",25,6,372,6,372,0,0,8440.161007,9.013064999999187,330.1873447046336,0
"147.32.84.165",1408,"205.188.103.1",25,6,372,6,372,0,0,8440.661628,9.012914999999339,330.19283994137504,0
"147.32.84.165",3432,"78.96.25.166",6667,9,552,6,372,3,180,8441.76316,1.0292200000003504,2891.51007559024,1399.1177785114064
"147.32.84.165",1376,"188.143.164.2",25,6,372,6,372,0,0,8442.792659,8.985960999998497,331.1832757787951,0
"147.32.84.165",1409,"200.147.36.13",25,6,372,6,372,0,0,8448.573196,9.01394000000073,330.155292802011,0
"147.32.84.165",1364,"206.222.227.2",80,13,2932,10,2074,3,858,8452.278881,0.5597660000003088,29640.957114206376,12262.266732878046
"147.32.84.165",3432,"212.117.174.7",4506,6,372,6,372,0,0,8452.299049,8.99223400000119,330.9522416787203,0
"147.32.84.165",1063,"72.14.215.114",25,6,372,6,372,0,0,8452.299114,8.992295000000013,330.94999663600845,0
"147.32.84.165",1410,"209.85.225.27",25,6,372,6,372,0,0,8455.683111,9.013560999999754,330.16917509074176,0
"147.32.84.165",1082,"212.117.171.138",65500,45,15241,30,13124,15,2117,8456.985148,20.9605219999994,5009.035557416128,807.9951443957591
"147.32.84.165",1147,"77.222.41.36",25,6,372,6,372,0,0,8457.007777,8.990616999999475,331.01176482105444,0
"147.32.84.165",1411,"98.139.54.60",25,6,372,6,372,0,0,8457.086092,9.011997999999949,330.22643813281104,0
"147.32.84.165",1402,"117.197.27.8",6667,4,248,4,248,0,0,8457.786173,3.004445000000487,660.3549074786453,0
"147.32.84.165",1364,"67.195.168.31",25,6,372,6,372,0,0,8459.087967,9.013175000000047,330.1833149805684,0
"147.32.84.165",1412,"138.26.5.112",25,6,372,6,372,0,0,8461.191125,9.01319599999988,330.18254568080397,0
"147.32.84.165",1357,"82.204.252.66",25,6,372,6,372,0,0,8461.691835,9.013182000000597,330.18305854689305,0
"147.32.84.165",1413,"64.12.90.1",25,6,372,6,372,0,0,8463.794932,9.01366699999926,330.1652923277779,0
"147.32.84.165",1376,"212.117.174.7",4506,6,372,6,372,0,0,8469.603617,9.012888999999632,330.1937924676673,0
"147.32.84.165",1406,"212.117.171.138",65500,14,846,10,604,4,242,8473.309227,2.2272520000005898,2169.4895772901855,869.2325789805049
"147.32.84.165",1323,"74.125.43.27",25,6,372,6,372,0,0,8473.30936,9.012079000000085,330.2234700783218,0
"147.32.84.165",1414,"168.95.5.77",25,6,372,6,372,0,0,8475.511893,9.012731999999232,330.1995443779149,0
"147.32.84.165",1408,"206.222.227.2",443,34,10110,24,3854,10,6256,8476.713596,0.9966660000009142,30935.137749227644,50215.41820424705
"147.32.84.165",1415,"209.85.143.27",25,6,372,6,372,0,0,8476.733838,8.993037000000186,330.92269052156,0
"147.32.84.165",3432,"222.23.80.7",6667,4,248,4,248,0,0,8478.01574,3.0039079999987734,660.4729572279878,0
"147.32.84.165",1416,"65.55.92.152",25,6,372,6,372,0,0,8478.115745,9.01323500000035,330.1811169907236,0
"147.32.84.165",1406,"212.117.171.138",65500,48,16463,32,13764,16,2699,8480.118581,6.154742999999144,17890.59266975328,3508.188725346128
"147.32.84.165",1082,"212.117.174.7",4506,6,372,6,372,0,0,8480.142412,8.988979000001564,331.0720828249218,0
"147.32.84.165",1411,"65.54.188.72",25,6,372,6,372,0,0,8480.142474,8.989040000000386,331.06983615601575,0
"147.32.84.165",1417,"24.71.223.11",25,6,372,6,372,0,0,8482.221312,9.013043000000835,330.1881506611834,0
"147.32.84.165",1418,"74.6.136.65",25,6,372,6,372,0,0,8482.722592,9.012400999999954,330.21167167328827,0
"147.32.84.165",1412,"206.222.227.2",443,35,11486,24,4910,11,6576,8484.825013,1.2061119999998482,32567.456421961597,43617.839802610884
"147.32.84.165",1419,"173.236.81.226",3817,11,666,8,484,3,182,8484.84509,0.4152699999995093,9324.054229789233,3506.152623598431
"147.32.84.165",1420,"209.85.225.27",25,6,372,6,372,0,0,8484.977096,8.961513999998715,332.08674337845446,0
"147.32.84.165",1413,"212.117.171.138",65500,14,846,10,604,4,242,8490.633364,2.0935110000009445,2308.0843616287757,924.7622773413307
"147.32.84.165",1421,"98.139.54.60",25,6,372,6,372,0,0,8490.656564,8.89020199999868,334.7505489752023,0
"147.32.84.165",1413,"212.117.171.138",65500,14,846,10,604,4,242,8494.338754,0.4349709999987681,11108.786562813808,4450.8714374187775
"147.32.84.165",1323,"74.125.43.27",25,6,372,6,372,0,0,8494.361465,8.890138000000661,334.7529588404341,0
"147.32.84.165",1423,"205.188.190.1",25,6,372,6,372,0,0,8496.441793,9.01316399999996,330.1837179485487,0
"147.32.84.165",1413,"212.117.171.138",65500,38,10004,26,8196,12,1808,8496.541952,3.235855000000811,20262.959866861638,4469.915988199835
"147.32.84.165",1424,"66.94.237.64",25,6,372,6,372,0,0,8496.56503,8.990030000000843,331.0333780865827,0
"147.32.84.165",1425,"208.87.234.190",25,6,372,6,372,0,0,8497.645924,9.01076699999976,330.27155180020515,0
"147.32.84.165",1415,"205.188.101.160",443,32,7376,20,3368,12,4008,8499.045666,0.8148689999998169,33065.43751204924,39348.6560416548
"147.32.84.165",1428,"98.139.175.224",25,6,372,6,372,0,0,8499.163146,8.995728999998391,330.8236608729023,0
"147.32.84.165",1415,"212.117.174.7",4506,6,372,6,372,0,0,8501.048879,9.012450000000172,330.2098763377265,0
"147.32.84.165",1414,"212.117.171.138",65500,22,1338,16,972,6,366,8503.151443,2.7864449999997305,2790.6526057398414,1050.8012898156192
"147.32.84.165",1429,"124.108.116.109",25,6,372,6,372,0,0,8503.174277,8.991697999999815,330.9719699215945,0
"147.32.84.165",1430,"98.137.54.237",25,6,372,6,372,0,0,8503.655578,9.009589999999662,330.31469800513804,0
"147.32.84.165",1431,"209.85.143.27",25,6,372,6,372,0,0,8505.855357,9.013504000000466,330.171263029322,0
"147.32.84.165",1417,"117.207.49.181",6667,4,248,4,248,0,0,8511.563628,3.004283000000214,660.3905158068859,0
"147.32.84.165",1420,"212.117.174.7",4506,6,372,6,372,0,0,8515.269337,9.012657000001127,330.20229217639456,0
"147.32.84.165",1432,"205.188.59.194",25,6,372,6,372,0,0,8515.269528,9.012590999998793,330.20471027703337,0
"147.32.84.165",1323,"74.125.43.27",25,6,372,6,372,0,0,8517.472149,9.012978000000658,330.19053191961444,0
"147.32.84.165",1435,"209.85.225.27",25,6,372,6,372,0,0,8517.572312,9.012832000000344,330.1958807176131,0
"147.32.84.165",1423,"212.117.171.138",65500,14,846,10,604,4,242,8518.673906,0.18926199999987148,25530.745738728754,10229.206074126421
"147.32.84.165",1436,"98.139.54.60",25,6,372,6,372,0,0,8518.696528,8.990394999998898,331.0199385010742,0
"147.32.84.165",1425,"212.117.171.138",65500,23,1398,16,972,7,426,8520.176565,2.1112620000003517,3683.1051759557577,1614.2004166225852
"147.32.84.165",1437,"66.94.237.64",25,6,372,6,372,0,0,8520.199476,8.989357000000382,331.0581613345508,0
"147.32.84.165",1438,"64.12.90.65",25,6,372,6,372,0,0,8522.079168,9.012469999999666,330.2091435533333,0
"147.32.84.165",1428,"212.117.171.138",65500,19,6968,14,844,5,6124,8524.181886,1.4399969999994937,4688.898657429407,34022.29310201148
"147.32.84.165",1440,"77.238.177.9",25,6,372,6,372,0,0,8524.204986,8.98961799999961,331.0485495601848,0
"147.32.84.165",1441,"209.85.143.27",25,6,372,6,372,0,0,8524.682397,9.013546999998653,330.1696879153617,0
"147.32.84.165",1442,"65.54.188.126",25,6,372,6,372,0,0,8524.682529,9.013542000000598,330.1698710673121,0
"147.32.84.165",1428,"212.117.171.138",65500,33,15084,24,1444,9,13640,8526.889015,3.3370239999985642,3461.767131433568,32699.79478722567
"147.32.84.165",1443,"38.121.100.66",25,6,372,6,372,0,0,8526.911542,8.98694500000056,331.14701380722977,0
"147.32.84.165",1444,"64.12.90.98",25,6,372,6,372,0,0,8527.786867,9.012880999998742,330.1940855538218,0
"147.32.84.165",1428,"212.117.171.138",65500,14,846,10,604,4,242,8536.299181,40.052599999999074,120.64135661605268,48.336437584577396
"147.32.84.165",1445,"209.85.225.27",25,6,372,6,372,0,0,8536.321975,8.990034999998898,331.03319397536995,0
"147.32.84.165",1446,"77.238.184.241",25,6,372,6,372,0,0,8536.322037,8.990099000000555,331.03083736895627,0
"147.32.84.165",1447,"24.97.67.249",25,6,372,6,372,0,0,8538.50227,9.012887999999293,330.1938291034165,0
"147.32.84.165",1450,"124.108.110.37",25,6,372,6,372,0,0,8538.602403,9.016141000000061,330.0746960368055,0
"147.32.84.165",1451,"74.6.140.64",25,6,372,6,372,0,0,8539.70403,9.01294599999892,330.1917042441347,0
"147.32.84.165",1452,"64.136.52.37",25,6,372,6,372,0,0,8541.206055,9.01321199999984,330.1819595500531,0
"147.32.84.165",1437,"212.117.174.7",4506,6,372,6,372,0,0,8543.108811,9.012957999999344,330.1912646214724,0
"147.32.84.165",1453,"64.12.90.65",25,6,372,6,372,0,0,8545.211927,9.014273999999205,330.14305977389444,0
"147.32.84.165",1457,"216.163.188.54",25,6,372,6,372,0,0,8545.717799,9.009200000000419,330.3289970252477,0
"147.32.84.165",1440,"187.106.81.34",6667,4,248,4,248,0,0,8547.916214,3.003969999999754,660.4593254926523,0
"147.32.84.165",1458,"98.137.54.237",25,6,372,6,372,0,0,8548.81853,9.01151099999879,330.2442842271845,0
"147.32.84.165",1459,"210.65.31.5",25,6,372,6,372,0,0,8557.329434,8.915145000000848,333.8139761046755,0
"147.32.84.165",1461,"124.108.110.37",25,6,372,6,372,0,0,8559.53263,8.912615000001097,333.90873497841363,0
"147.32.84.165",1462,"64.12.90.1",25,6,372,6,372,0,0,8559.532761,8.912598999999318,333.909334415273,0
"147.32.84.165",1463,"209.85.225.27",25,6,372,6,372,0,0,8559.632759,8.913870000000315,333.86172335920253,0
"147.32.84.165",1464,"98.139.175.224",25,6,372,6,372,0,0,8560.737575,8.909686000000875,334.0185052536877,0
"147.32.84.165",1450,"174.133.57.141",80,16,3429,12,1428,4,2001,8562.236443,0.49882400000024063,22901.865186908588,32091.479158966446
"147.32.84.165",1465,"168.61.70.72",25,6,372,6,372,0,0,8562.401577,8.848211999998966,336.3391383479903,0
"147.32.84.165",1466,"74.125.93.27",25,6,372,6,372,0,0,8564.139337,8.912582999999358,333.9099338542165,0
"147.32.84.165",1468,"194.2.0.84",25,6,372,6,372,0,0,8566.145254,9.009769000000233,330.3081355359858,0
"147.32.84.165",1469,"205.188.103.1",25,6,372,6,372,0,0,8566.64294,9.013269000000946,330.179871476119,0
"147.32.84.165",1474,"98.139.54.60",25,6,372,6,372,0,0,8568.647439,9.011387000000468,330.24882850995584,0
"147.32.84.165",1475,"207.115.21.20",25,6,372,6,372,0,0,8569.747338,9.013591000000815,330.1680761862537,0
"147.32.84.165",1428,"212.117.174.7",4506,6,372,6,372,0,0,8578.259365,9.01441100000011,330.13804229693585,0
"147.32.84.165",1476,"209.85.143.27",25,6,372,6,372,0,0,8580.462573,9.013472999999067,330.1723985860176,0
"147.32.84.165",1477,"66.196.94.104",25,6,372,6,372,0,0,8580.56292,9.013028999999733,330.18866354475153,0
"147.32.84.165",1461,"178.208.75.15",25,6,372,6,372,0,0,8581.664275,9.01306199999999,330.1874546075466,0
"147.32.84.165",1478,"213.176.8.10",25,6,372,6,372,0,0,8583.266481,9.013333999999304,330.1774903715129,0
"147.32.84.165",1465,"212.117.174.7",4506,6,372,6,372,0,0,8585.069642,9.012572999999975,330.20536976510573,0
"147.32.84.165",1464,"212.117.171.138",65500,85,46390,58,43866,27,2524,8585.069746,27.902961000001596,12576.729759969916,723.6507982073604
"147.32.84.165",1462,"81.3.150.104",25,6,372,6,372,0,0,8585.092182,8.99015800000052,331.02866490219947,0
"147.32.84.165",1479,"66.94.237.64",25,6,372,6,372,0,0,8587.172162,9.013361999999688,330.1764646754566,0
"147.32.84.165",1463,"72.14.213.27",25,6,372,6,372,0,0,8587.672991,9.013017999999647,330.1890665257871,0
"147.32.84.165",1480,"205.188.146.193",25,6,372,6,372,0,0,8589.675903,9.013191000000006,330.18272884708625,0
"147.32.84.165",1468,"72.14.213.27",25,6,372,6,372,0,0,8590.778786,9.01169899999877,330.23739474658504,0
"147.32.84.165",1481,"209.85.225.27",25,6,372,6,372,0,0,8590.77892,9.011689999999362,330.23772455557287,0
"147.32.84.165",1469,"74.125.39.27",25,6,372,6,372,0,0,8599.289722,9.012930000000779,330.19229040941656,0
"147.32.84.165",1482,"207.115.21.24",25,6,372,6,372,0,0,8601.493159,9.012940000000526,330.1919240558382,0
"147.32.84.165",1428,"74.125.127.27",25,6,372,6,372,0,0,8601.593397,9.012824999999793,330.1961371712053,0
"147.32.84.165",1483,"98.139.175.224",25,6,372,6,372,0,0,8602.694691,9.013143999998647,330.18445062016616,0
"147.32.84.165",1477,"178.208.75.15",25,6,372,6,372,0,0,8604.297043,9.013394999999946,330.1752558275786,0
"147.32.84.165",1484,"64.12.90.65",25,6,372,6,372,0,0,8606.099762,9.012604999999894,330.2041973436132,0
"147.32.84.165",1461,"212.117.171.138",65500,14,846,10,604,4,242,8608.202538,6.59480700000131,732.6977120026469,293.5643150739082
"147.32.84.165",1462,"81.3.150.104",25,6,372,6,372,0,0,8608.202684,9.012792999999874,330.1973095354616,0
"147.32.84.165",1485,"72.55.186.9",25,6,372,6,372,0,0,8608.703321,9.012807999999495,330.1967599886924,0
"147.32.84.165",1478,"65.54.165.169",443,44,24661,34,3818,10,20843,8610.70631,1.838912999999593,16609.812427236502,90675.30655340242
"147.32.84.165",1479,"212.117.174.7",4506,6,372,6,372,0,0,8610.872719,8.946520999999848,332.64326993700126,0
"147.32.84.165",1463,"72.14.213.27",25,6,372,6,372,0,0,8611.808291,9.012480000001233,330.2087771622897,0
"147.32.84.165",1478,"174.133.57.141",80,16,3429,12,1428,4,2001,8620.320336,0.5026459999990038,22727.724879980426,31847.463224678453
"147.32.84.165",1480,"212.117.174.7",4506,6,372,6,372,0,0,8620.483715,8.94953600000008,332.5312060871059,0
"147.32.84.165",1461,"212.117.171.138",65500,57,24510,40,21712,17,2798,8620.483807,8.725791999999274,19906.0440588103,2565.2685739015856
"147.32.84.165",1468,"74.125.39.27",25,6,372,6,372,0,0,8620.506692,8.926682999999684,333.38251173477374,0
"147.32.84.165",1488,"77.238.184.241",25,6,372,6,372,0,0,8622.523148,9.012800999998944,330.1970164436504,0
"147.32.84.165",1489,"98.139.54.60",25,6,372,6,372,0,0,8622.623249,9.012870999998995,330.19445191219666,0
"147.32.84.165",1490,"64.12.90.98",25,6,372,6,372,0,0,8623.724733,9.013220000000729,330.18166648542467,0
"147.32.84.165",1482,"212.117.171.138",65500,14,846,10,604,4,242,8625.328606,2.485971000000063,1943.707307929126,778.770146554385
"147.32.84.165",1491,"209.85.143.27",25,6,372,6,372,0,0,8625.328741,9.011499000000185,330.2447239909741,0
"147.32.84.165",1483,"65.54.165.169",443,37,15410,28,5194,9,10216,8627.129914,2.00447400000121,20729.62782254842,40772.79126591349
"147.32.84.165",1477,"178.208.75.15",25,6,372,6,372,0,0,8627.2964,8.846223000000464,336.4147614184996,0
"147.32.84.165",1492,"209.85.225.27",25,6,372,6,372,0,0,8629.233095,8.912560000000667,333.91079555142153,0
"147.32.84.165",1484,"212.117.171.138",65500,29,4537,20,2716,9,1821,8629.733975,3.582862000001114,6064.425590489738,4066.023195980049
"147.32.84.165",1493,"199.107.64.221",25,6,372,6,372,0,0,8629.756777,8.88942599999973,334.7797709323516,0
"147.32.84.165",1483,"174.133.57.141",80,17,3489,12,1428,5,2061,8631.836424,3.025582000000213,3775.8024737056194,5449.53004083143
"147.32.84.165",1494,"205.188.103.1",25,6,372,6,372,0,0,8631.991405,8.85802700000022,335.9664629606487,0
"147.32.84.165",1479,"94.245.116.11",80,18,4356,12,3242,6,1114,8632.837838,0.4925629999997909,52655.193345848165,18093.117022601746
"147.32.84.165",1463,"72.14.213.27",25,6,372,6,372,0,0,8632.874574,8.878729000000021,335.1831101050604,0
"147.32.84.165",1495,"141.211.22.134",25,6,372,6,372,0,0,8641.350116,9.014869000000544,330.1212696490454,0
"147.32.84.165",1480,"212.117.174.7",4506,6,372,6,372,0,0,8643.453307,9.013468000001012,330.1725817409754,0
"147.32.84.165",1468,"74.125.39.27",25,6,372,6,372,0,0,8643.553454,9.0134939999989,330.1716293371209,0
"147.32.84.165",1488,"174.133.57.141",80,17,3489,12,1428,5,2061,8644.655009,1.8665220000002591,6120.47433676025,8833.541742340947
"147.32.84.165",1497,"212.82.111.207",25,6,372,6,372,0,0,8644.82177,8.946792999999161,332.6331569312355,0
"147.32.84.165",1490,"72.14.213.27",25,6,372,6,372,0,0,8646.257162,9.012980999999854,330.1904220146529,0
"147.32.84.165",1498,"98.137.54.238",25,6,372,6,372,0,0,8646.257244,9.013026000000536,330.18877344854246,0
"147.32.84.165",1491,"212.117.174.7",4506,6,372,6,372,0,0,8648.160622,9.012289000000237,330.2157753707101,0
"147.32.84.165",1484,"74.125.127.27",25,6,372,6,372,0,0,8648.160728,9.012308999999732,330.2150425601351,0
"147.32.84.165",1499,"202.33.240.44",25,6,372,6,372,0,0,8650.163105,9.012851999999839,330.1951479953352,0
"147.32.84.165",1477,"212.117.171.138",65500,14,846,10,604,4,242,8650.664151,2.959488999998939,1632.714296286194,654.1669862603625
"147.32.84.165",1500,"65.55.88.22",25,6,372,6,372,0,0,8650.68688,8.989631000000372,331.04807082736505,0
"147.32.84.165",1501,"64.12.90.1",25,6,372,6,372,0,0,8652.867081,9.013280999999552,330.1794318850314,0
"147.32.84.165",1477,"212.117.171.138",65500,94,66015,64,62944,30,3071,8653.768696,14.234725000000253,35374.90186849349,1725.9202408195144
"147.32.84.165",1494,"46.50.132.140",25,6,372,6,372,0,0,8653.791347,8.990026999999827,331.033488553489,0
"147.32.84.165",1502,"209.85.225.27",25,6,372,6,372,0,0,8662.380909,9.012384999999995,330.21225790953247,0
"147.32.84.165",1503,"209.85.143.27",25,6,372,6,372,0,0,8664.483684,9.012672999999268,330.20170597560144,0
"147.32.84.165",1495,"212.117.171.138",65500,14,846,10,604,4,242,8664.583842,20.928930000000037,230.87659044203366,92.5035345810797
"147.32.84.165",1506,"141.211.22.134",25,6,372,6,372,0,0,8664.583917,9.01263199999994,330.20320811945055,0
"147.32.84.165",1468,"65.55.72.199",80,52,35202,36,4634,16,30568,8665.785237,1.9726239999999962,18793.24189505961,123968.88611311658
"147.32.84.165",1507,"65.54.188.94",25,6,372,6,372,0,0,8665.913519,8.984775000000809,331.22699232865955,0
"147.32.84.165",1497,"117.224.41.27",6667,6,372,6,372,0,0,8667.287355,9.013068000000203,330.18723480172713,0
"147.32.84.165",1490,"72.14.213.27",25,6,372,6,372,0,0,8669.190421,9.012695000001258,330.2008999527427,0
"147.32.84.165",1508,"64.12.90.1",25,6,372,6,372,0,0,8671.193069,9.01306199999999,330.1874546075466,0
"147.32.84.165",1484,"212.117.174.7",4506,6,372,6,372,0,0,8671.193201,9.013055999999779,330.1876744136587,0
"147.32.84.165",1509,"209.85.225.27",25,6,372,6,372,0,0,8671.69369,9.012990999999602,330.19005566522054,0
"147.32.84.165",1510,"65.55.88.22",25,6,372,6,372,0,0,8671.693823,9.012950000000274,330.19155770307276,0
"147.32.84.165",1511,"206.46.232.11",25,6,372,6,372,0,0,8673.898667,9.011264000000665,330.2533362688942,0
"147.32.84.165",1501,"173.192.170.88",80,44,6017,30,2696,14,3321,8674.798263,62.9212150000003,342.7778691177514,422.2423231973488
"147.32.84.165",1494,"46.50.132.140",25,6,372,6,372,0,0,8683.410621,9.016600999999355,330.0578566136189,0
"147.32.84.165",1512,"209.85.143.27",25,6,372,6,372,0,0,8684.011761,8.912760000001072,333.903302680611,0
"147.32.84.165",1513,"98.139.54.60",25,6,372,6,372,0,0,8684.011824,8.91282400000091,333.9009050329835,0
"147.32.84.165",1514,"205.188.190.1",25,6,372,6,372,0,0,8685.513713,9.013304000000062,330.1785893386021,0
"147.32.84.165",1495,"212.117.171.138",65500,14,846,10,604,4,242,8685.61386,0.5520410000008269,8752.973058147425,3506.9858941584052
"147.32.84.165",1515,"64.12.90.1",25,6,372,6,372,0,0,8685.636486,8.990700000000288,331.0087089992887,0
"147.32.84.165",1506,"212.117.171.138",65500,14,846,10,604,4,242,8686.915889,1.3729610000009416,3519.400769575164,1410.0910368165391
"147.32.84.165",1517,"209.85.225.27",25,6,372,6,372,0,0,8686.938607,8.989895999999135,331.03831234535824,0
"147.32.84.165",1507,"209.236.119.101",6667,6,372,6,372,0,0,8689.422865,9.009337999999843,330.32393723046596,0
"147.32.84.165",1519,"67.231.144.94",25,6,372,6,372,0,0,8690.220631,9.016037999999753,330.07846683876903,0
"147.32.84.165",1506,"212.117.171.138",65500,24,1476,18,1092,6,384,8692.228057,63.50982699999986,137.5535159306924,48.37046714046327
"147.32.84.165",1490,"72.14.213.27",25,6,372,6,372,0,0,8692.251588,9.36613000000034,317.740624996652,0
"147.32.84.165",1520,"212.227.15.134",25,6,372,6,372,0,0,8692.724335,9.170983999998498,324.5017110487258,0
"147.32.84.165",1508,"212.117.174.7",4506,6,372,6,372,0,0,8694.927304,9.01292199999989,330.1925834929046,0
"147.32.84.165",1521,"65.55.92.152",25,6,372,6,372,0,0,8704.34074,9.012956000000486,330.1913378917904,0
"147.32.84.165",1494,"46.50.132.140",25,6,372,6,372,0,0,8704.84139,9.013017999999647,330.1890665257871,0
"147.32.84.165",1522,"98.139.175.224",25,6,372,6,372,0,0,8706.443854,9.012901000000056,330.1933528394444,0
"147.32.84.165",1512,"89.188.129.62",25,6,372,6,372,0,0,8706.543897,9.012978000000658,330.19053191961444,0
"147.32.84.165",1523,"209.85.143.27",25,6,372,6,372,0,0,8707.846026,9.012657000001127,330.20229217639456,0
"147.32.84.165",1513,"89.188.129.62",25,6,372,6,372,0,0,8710.449682,9.012746000000334,330.1990314605437,0
"147.32.84.165",1524,"64.12.90.1",25,6,372,6,372,0,0,8710.44983,9.012722000001304,330.19991074833655,0
"147.32.84.165",1514,"74.125.127.27",25,6,372,6,372,0,0,8711.150615,9.013335999999981,330.17741710727375,0
"147.32.84.165",1525,"64.12.90.65",25,6,372,6,372,0,0,8713.153381,9.015336000000389,330.10416916239967,0
"147.32.84.165",1526,"209.85.225.27",25,6,372,6,372,0,0,8713.65404,9.013095000000249,330.1862456791943,0
"147.32.84.165",1517,"74.125.157.27",25,6,372,6,372,0,0,8715.857271,9.01579799999854,330.08725350772966,0
"147.32.84.165",1527,"68.6.19.3",25,6,372,6,372,0,0,8725.371248,9.012776999999915,330.19789572071164,0
"147.32.84.165",1528,"69.175.10.98",4190,11,666,8,484,3,182,8725.871705,0.4068220000008296,9517.676035199926,3578.9608231536913
"147.32.84.165",1494,"212.117.174.7",4506,6,372,6,372,0,0,8726.003391,8.983476999999766,331.2748504838469,0
"147.32.84.165",1519,"212.117.174.7",4506,6,372,6,372,0,0,8727.477099,9.010001000000557,330.2996303773791,0
"147.32.84.165",1520,"72.14.215.114",25,6,372,6,372,0,0,8727.477229,9.009986999999455,330.30014360733037,0
"147.32.84.165",1529,"67.231.144.94",25,6,372,6,372,0,0,8727.576826,9.01036799999929,330.28617699079933,0
"147.32.84.165",1530,"66.196.94.104",25,6,372,6,372,0,0,8728.875955,9.013680000000022,330.16481614612377,0
"147.32.84.165",1508,"84.47.145.188",25,6,372,6,372,0,0,8731.480434,9.015017000001535,330.1158500310641,0
"147.32.84.165",1531,"98.139.54.60",25,6,372,6,372,0,0,8732.181229,9.017799000001105,330.0140089615698,0
"147.32.84.165",1523,"212.117.171.138",65500,24,1474,18,1092,6,382,8734.187102,78.99232499999925,110.59302280316578,38.68730284872649
"147.32.84.165",1532,"209.85.143.27",25,6,372,6,372,0,0,8734.187242,9.01188000000002,330.2307620607458,0
"147.32.84.165",1524,"205.188.59.194",25,6,372,6,372,0,0,8734.684574,9.01268600000003,330.20122968890627,0
"147.32.84.165",1512,"89.188.129.62",25,6,372,6,372,0,0,8736.887584,9.01329000000078,330.17910219240065,0
"147.32.84.165",1526,"174.133.57.141",80,18,3549,12,1428,6,2121,8746.401528,3.3047869999991235,3456.8037213905254,5134.37023324181
"147.32.84.165",1534,"205.188.59.194",25,6,372,6,372,0,0,8746.554556,8.961688000001232,332.080295587125,0
"147.32.84.165",1535,"62.112.147.153",25,6,372,6,372,0,0,8746.554597,8.961682999999539,332.080480865051,0
"147.32.84.165",1513,"89.188.129.62",25,6,372,6,372,0,0,8747.005001,9.011147999999594,330.25758760150586,0
"147.32.84.165",1536,"209.85.225.27",25,6,372,6,372,0,0,8747.005067,9.011151999999129,330.2574410020259,0
"147.32.84.165",1514,"74.125.127.27",25,6,372,6,372,0,0,8748.504084,9.006917000000612,330.41272613035045,0
"147.32.84.165",1538,"209.94.232.113",25,6,372,6,372,0,0,8748.605251,9.006052999999156,330.4444244332427,0
"147.32.84.165",1517,"74.125.157.27",25,6,372,6,372,0,0,8749.906434,9.009539999999106,330.3165311436872,0
"147.32.84.165",1539,"81.103.221.10",25,6,372,6,372,0,0,8752.511072,9.271380000000136,320.9878141118104,0
"147.32.84.165",1529,"212.117.174.7",4506,6,372,6,372,0,0,8753.213134,9.012700000001132,330.20071676629937,0
"147.32.84.165",1515,"72.14.215.114",25,6,372,6,372,0,0,8755.214169,9.018935999998575,329.97240472717294,0
"147.32.84.165",1531,"98.126.71.122",80,18,4863,14,1430,4,3433,8755.71455,18.96588100000008,603.1884308458938,1448.0740441216458
"147.32.84.165",1540,"76.162.254.116",25,6,372,6,372,0,0,8755.889056,8.845885999999155,336.4275777463427,0
"147.32.84.165",1508,"84.47.145.188",25,6,372,6,372,0,0,8757.911937,8.929462000000058,333.2787574436154,0
"147.32.84.165",1522,"95.100.248.97",80,17,5707,12,2574,5,3133,8767.443029,7.237526999999318,2845.170733042093,3463.061346783558
"147.32.84.165",1524,"174.133.57.141",80,17,3489,12,1428,5,2061,8767.444073,5.660932999999204,2018.0419022803496,2912.5940900558826
"147.32.84.165",1541,"64.12.90.65",25,6,372,6,372,0,0,8767.604035,8.978649999999107,331.452946712512,0
"147.32.84.165",1512,"212.117.174.7",4506,6,372,6,372,0,0,8767.945772,9.039003000001685,329.2398508994239,0
"147.32.84.165",1535,"74.125.43.27",25,6,372,6,372,0,0,8767.94584,9.039058000000296,329.2378475721588,0
"147.32.84.165",1532,"89.188.129.62",25,6,372,6,372,0,0,8769.449952,9.0361869999997,329.34245384697095,0
"147.32.84.165",1534,"195.113.232.83",80,16,3561,12,1644,4,1917,8769.550805,5.129854999999225,2563.8151565691405,2989.558184393578
"147.32.84.165",1542,"195.78.87.96",25,6,372,6,372,0,0,8769.551523,9.034281000000192,329.41193660014966,0
"147.32.84.165",1513,"89.188.129.62",25,6,372,6,372,0,0,8770.854435,9.033515000000989,329.43986919816643,0
"147.32.84.165",1538,"74.125.232.218",80,13,1871,10,1156,3,715,8770.854536,3.82622099999935,2417.006231475278,1494.9476258692248
"147.32.84.165",1543,"67.195.168.230",25,6,372,6,372,0,0,8770.862709,9.025368999999046,329.73721074454846,0
"147.32.84.165",1536,"46.4.54.212",25,6,372,6,372,0,0,8773.462395,9.028997999999774,329.60468038646974,0
"147.32.84.165",1544,"64.12.90.98",25,6,372,6,372,0,0,8774.164502,9.0276300000005,329.6546269618754,0
"147.32.84.165",1514,"74.125.127.27",25,6,372,6,372,0,0,8776.282336,9.013025000000198,330.18881008317794,0
"147.32.84.165",1545,"209.85.225.27",25,6,372,6,372,0,0,8776.785366,9.010779000000184,330.2711119648966,0
"147.32.84.165",1538,"173.192.170.88",80,23,3093,18,2532,5,561,8778.886246,45.53303400000004,444.86383226735956,98.56580169904768
"147.32.84.165",1540,"109.200.239.148",6667,6,372,6,372,0,0,8779.087016,9.013123000000633,330.1852199287407,0
"147.32.84.165",1515,"72.14.213.27",25,6,372,6,372,0,0,8788.600192,9.0131020000008,330.18598924096676,0
"147.32.84.165",1546,"66.11.225.135",25,6,372,6,372,0,0,8789.001069,9.012886000000435,330.1939023748726,0
"147.32.84.165",1512,"212.117.174.7",4506,6,372,6,372,0,0,8790.502855,9.013213000000178,330.18192291693776,0
"147.32.84.165",1541,"74.125.43.27",25,6,372,6,372,0,0,8790.602982,9.013010999999096,330.1893229687946,0
"147.32.84.165",1508,"84.47.145.188",25,6,372,6,372,0,0,8791.904712,9.013302000001204,330.1786626032948,0
"147.32.84.165",1547,"98.139.54.60",25,6,372,6,372,0,0,8794.508563,9.013124000000971,330.1851832949019,0
"147.32.84.165",1536,"46.4.54.212",25,6,372,6,372,0,0,8795.210135,9.012468000000808,330.20921683158633,0
"147.32.84.165",1548,"217.10.138.227",25,6,372,6,372,0,0,8797.312928,9.012657000001127,330.20229217639456,0
"147.32.84.165",1549,"66.94.237.64",25,6,372,6,372,0,0,8797.813736,9.012627000000066,330.2033913086582,0
"147.32.84.165",1550,"76.162.254.120",25,6,372,6,372,0,0,8801.71914,9.013131000001522,330.18492685832456,0
"147.32.84.165",1553,"209.85.225.27",25,6,372,6,372,0,0,8809.630413,8.938850999998976,332.9286951981122,0
"147.32.84.165",1515,"59.113.54.127",6667,6,372,6,372,0,0,8810.0313,8.912827999998626,333.90075518123524,0
"147.32.84.165",1554,"83.166.166.149",25,6,372,6,372,0,0,8811.533098,8.912770000000819,333.9029280459079,0
"147.32.84.165",1555,"64.12.90.1",25,6,372,6,372,0,0,8811.633339,8.912766999999803,333.90304043627145,0
"147.32.84.165",1556,"98.139.54.60",25,6,372,6,372,0,0,8812.935079,8.912927999999738,333.8970089290621,0
"147.32.84.165",1557,"212.68.12.232",25,6,372,6,372,0,0,8812.935212,8.912884999999733,333.89861980717683,0
"147.32.84.165",1541,"212.117.174.7",4506,6,372,6,372,0,0,8815.538776,8.912804000001415,333.9016542941511,0
"147.32.84.165",1558,"217.156.101.1",25,6,372,6,372,0,0,8816.239931,8.912600999999995,333.9092594855308,0
"147.32.84.165",1536,"212.117.174.7",4506,6,372,6,372,0,0,8818.24275,9.014094000000114,330.14965231114326,0
"147.32.84.165",1547,"212.117.171.138",65500,47,4304,30,3214,17,1090,8818.242889,183.59973900000114,140.04377206658143,47.49462089376906
"147.32.84.165",1559,"65.55.92.168",25,6,372,6,372,0,0,8818.481776,8.974387999998726,331.61035604883836,0
"147.32.84.165",1560,"205.188.103.1",25,6,372,6,372,0,0,8818.743399,9.013333999999304,330.1774903715129,0
"147.32.84.165",1548,"74.125.39.27",25,6,372,6,372,0,0,8822.64927,9.014979999999923,330.11720491892663,0
"147.32.84.165",1550,"95.169.184.33",25,6,372,6,372,0,0,8830.560312,9.013345999999729,330.17705078669894,0
"147.32.84.165",1561,"66.94.237.64",25,6,372,6,372,0,0,8832.463371,9.012758999999278,330.1985551816307,0
"147.32.84.165",1549,"74.125.43.27",25,6,372,6,372,0,0,8832.563576,9.012643000000025,330.2028051038959,0
"147.32.84.165",1564,"98.139.175.224",25,6,372,6,372,0,0,8832.96412,9.012613999999303,330.2038676015893,0
"147.32.84.165",1565,"64.12.90.98",25,6,372,6,372,0,0,8833.865275,9.013080000000627,330.1867951909661,0
"147.32.84.165",1566,"65.54.188.126",25,6,372,6,372,0,0,8836.46941,9.01450400000067,330.1346363593359,0
"147.32.84.165",1568,"98.139.54.60",25,6,372,6,372,0,0,8837.170049,9.013433000000077,330.1738638319023,0
"147.32.84.165",1541,"79.174.64.22",25,6,372,6,372,0,0,8839.473692,9.012367000001177,330.2129174277536,0
"147.32.84.165",1570,"209.85.225.27",25,6,372,6,372,0,0,8839.773795,9.013990000001286,330.15346145265033,0
"147.32.84.165",1560,"41.223.57.74",6667,4,248,4,248,0,0,8843.679168,3.0045939999999973,660.3221599989888,0
"147.32.84.165",1548,"74.125.39.27",25,6,372,6,372,0,0,8851.590692,9.013225000000602,330.1814833203211,0
"147.32.84.165",1550,"95.169.184.33",25,6,372,6,372,0,0,8853.493725,9.01273399999991,330.19947110388813,0
"147.32.84.165",1571,"68.1.17.3",25,6,372,6,372,0,0,8853.593725,9.012845999999627,330.19536781169046,0
"147.32.84.165",1560,"212.69.113.6",25,6,372,6,372,0,0,8853.994432,9.01267800000096,330.2015227881971,0
"147.32.84.165",1564,"83.143.242.3",25,6,372,6,372,0,0,8854.895451,9.01323500000035,330.1811169907236,0
"147.32.84.165",1572,"205.188.103.1",25,6,372,6,372,0,0,8857.499027,9.013006999999561,330.18946950780634,0
"147.32.84.165",1561,"212.117.174.7",4506,6,372,6,372,0,0,8858.200843,9.012211999999636,330.2185967218836,0
"147.32.84.165",1549,"74.125.43.27",25,6,372,6,372,0,0,8860.503919,9.013042999999016,330.18815066125006,0
"147.32.84.165",1568,"79.174.64.22",25,6,372,6,372,0,0,8860.804074,9.01314000000093,330.18459715478656,0
"147.32.84.165",1573,"85.115.60.190",25,6,372,6,372,0,0,8863.607808,9.01317299999937,330.183388247425,0
"147.32.84.165",1541,"212.117.174.7",4506,6,372,6,372,0,0,8872.621116,9.013058000000456,330.18760114489993,0
"147.32.84.165",1574,"207.57.68.65",25,6,372,6,372,0,0,8872.621176,9.013127999998687,330.18503675976126,0
"147.32.84.165",1548,"74.125.39.27",25,6,372,6,372,0,0,8874.524121,9.012697000000117,330.200826678181,0
"147.32.84.165",1575,"65.64.186.137",25,6,372,6,372,0,0,8874.624093,9.012854000000516,330.19507472325967,0
"147.32.84.165",1576,"64.12.90.1",25,6,372,6,372,0,0,8875.024419,9.013064000000668,330.18738133888536,0
"147.32.84.165",1550,"212.69.113.6",25,6,372,6,372,0,0,8875.927526,9.011381000000256,330.2490483977889,0
"147.32.84.165",1560,"83.143.242.3",25,6,372,6,372,0,0,8878.529319,8.912802000000738,333.9017292204801,0
"147.32.84.165",1577,"209.85.143.27",25,6,372,6,372,0,0,8879.230713,8.912343999998484,333.9188882296853,0
"147.32.84.165",1572,"93.81.239.20",25,6,372,6,372,0,0,8881.534124,8.912530999999944,333.91188204562974,0
"147.32.84.165",1578,"65.55.92.184",25,6,372,6,372,0,0,8881.834464,8.912786000000779,333.90232863211793,0
"147.32.84.165",1568,"49.128.164.249",6667,4,248,4,248,0,0,8884.638677,2.90355499999896,683.3002991163283,0
"147.32.84.165",1579,"207.115.37.23",25,6,372,6,372,0,0,8893.550956,9.01300000000083,330.18972595137313,0
"147.32.84.165",1574,"217.16.28.65",25,6,372,6,372,0,0,8895.454191,9.012525000000096,330.2071284129551,0
"147.32.84.165",1580,"209.85.225.27",25,6,372,6,372,0,0,8895.554573,9.012298999999985,330.215408965016,0
"147.32.84.165",1581,"98.139.54.60",25,6,372,6,372,0,0,8895.95482,9.012769999999364,330.1981521774338,0
"147.32.84.165",1582,"205.188.146.193",25,6,372,6,372,0,0,8896.856734,9.013120999999956,330.1852931964427,0
"147.32.84.165",1583,"65.55.37.120",25,6,372,6,372,0,0,8899.459865,9.013445999999021,330.17338762558995,0
"147.32.84.165",1584,"205.188.103.1",25,6,372,6,372,0,0,8900.160445,9.013834000001225,330.15917532978705,0
"147.32.84.165",1577,"72.14.213.27",25,6,372,6,372,0,0,8902.464065,9.01309399999991,330.18628231326886,0
"147.32.84.165",1585,"67.195.168.230",25,6,372,6,372,0,0,8902.764123,9.013566999999966,330.16895530925893,0
"147.32.84.165",1578,"212.117.174.7",4506,6,372,6,372,0,0,8904.466579,9.012935000000653,330.19210723252576,0
"147.32.84.165",1572,"93.81.239.20",25,6,372,6,372,0,0,8914.581151,9.012990999999602,330.19005566522054,0
"147.32.84.165",1587,"210.213.253.199",25,6,372,6,372,0,0,8916.483839,9.013327999999092,330.1777101643588,0
"147.32.84.165",1574,"217.16.28.65",25,6,372,6,372,0,0,8916.583956,9.013639999999214,330.1662813247766,0
"147.32.84.165",1588,"69.90.206.20",25,6,372,6,372,0,0,8916.984934,9.012978000000658,330.19053191961444,0
"147.32.84.165",1589,"209.85.225.27",25,6,372,6,372,0,0,8917.885873,9.013428000000204,330.1740469885523,0
"147.32.84.165",1581,"212.117.174.7",4506,6,372,6,372,0,0,8920.489734,9.013310999998794,330.1783329123336,0
"147.32.84.165",1580,"217.72.192.149",25,6,372,6,372,0,0,8920.489866,9.013304000000062,330.1785893386021,0
"147.32.84.165",1590,"209.85.143.27",25,6,372,6,372,0,0,8921.190744,9.012969999999768,330.19082499998075,0
"147.32.84.165",1591,"98.139.54.60",25,6,372,6,372,0,0,8923.494099,9.012904000001072,330.1932429325383,0
"147.32.84.165",1577,"72.14.213.27",25,6,372,6,372,0,0,8923.794428,9.013020000000324,330.18899325641047,0
"147.32.84.165",1592,"205.188.190.1",25,6,372,6,372,0,0,8925.497306,9.012935000000653,330.19210723252576,0
"147.32.84.165",1593,"205.188.59.194",25,6,372,6,372,0,0,8935.611651,9.012792999999874,330.1973095354616,0
"147.32.84.165",1594,"212.77.101.4",25,6,372,6,372,0,0,8937.514713,9.012426999999661,330.21071904383933,0
"147.32.84.165",1595,"66.11.225.176",25,6,372,6,372,0,0,8937.614375,9.012832000000344,330.1958807176131,0
"147.32.84.165",1596,"209.85.143.27",25,6,372,6,372,0,0,8938.014913,9.012862999999925,330.1947449994552,0
"147.32.84.165",1597,"65.54.188.110",25,6,372,6,372,0,0,8938.015044,9.01281100000051,330.19665007951807,0
"147.32.84.165",1598,"209.85.225.27",25,6,372,6,372,0,0,8938.916449,9.013152999999875,330.1841209175126,0
"147.32.84.165",1588,"74.125.39.27",25,6,372,6,372,0,0,8941.520429,9.012407000000167,330.21145183522503,0
"147.32.84.165",1599,"218.102.23.150",25,6,372,6,372,0,0,8942.220978,9.012844000000769,330.1954410838295,0
"147.32.84.165",1589,"74.125.43.27",25,6,372,6,372,0,0,8944.524382,9.013237000001027,330.181043724875,0
"147.32.84.165",1601,"205.188.103.1",25,6,372,6,372,0,0,8944.82473,9.01285999999891,330.1948549073613,0
"147.32.84.165",1590,"79.170.40.26",25,6,372,6,372,0,0,8946.527289,9.012958999999682,330.1912279862923,0
"147.32.84.165",1592,"67.195.168.31",25,6,372,6,372,0,0,8956.641934,9.01281999999992,330.1963203525674,0
"147.32.84.165",1602,"98.139.54.60",25,6,372,6,372,0,0,8958.444734,9.012643999998545,330.2027684662215,0
"147.32.84.165",1591,"74.125.157.27",25,6,372,6,372,0,0,8958.54428,9.013608999999633,330.1674168471387,0
"147.32.84.165",1603,"64.12.90.1",25,6,372,6,372,0,0,8958.945389,9.012574000000313,330.20533312679555,0
"147.32.84.165",1604,"64.18.5.13",25,6,372,6,372,0,0,8959.848626,9.010847999999896,330.2685829347065,0
"147.32.84.165",1595,"212.117.174.7",4506,6,372,6,372,0,0,8962.450363,9.012919999999212,330.19265676387454,0
"147.32.84.165",1588,"114.59.51.188",6667,6,372,6,372,0,0,8963.151535,9.012570999999298,330.20544304175047,0
"147.32.84.165",1597,"74.125.39.27",25,6,372,6,372,0,0,8965.455025,9.012244999999893,330.21738756547734,0
"147.32.84.165",1605,"65.54.188.126",25,6,372,6,372,0,0,8965.755158,9.013081000000966,330.18675855677776,0
"147.32.84.165",1589,"212.117.174.7",4506,6,372,6,372,0,0,8967.457512,9.01281199999903,330.1966134432095,0
"147.32.84.165",1599,"74.125.43.27",25,6,372,6,372,0,0,8967.457594,9.012854000000516,330.19507472325967,0
"147.32.84.165",1607,"216.177.207.223",25,6,372,6,372,0,0,8977.671957,9.012878999999884,330.19415882539175,0
"147.32.84.165",1590,"79.170.40.26",25,6,372,6,372,0,0,8979.474658,9.012869000000137,330.1945251839292,0
"147.32.84.165",1608,"209.85.225.27",25,6,372,6,372,0,0,8979.57495,9.013006999999561,330.18946950780634,0
"147.32.84.165",1591,"74.125.157.27",25,6,372,6,372,0,0,8979.975129,9.01307799999995,330.1868684593672,0
"147.32.84.165",1609,"216.17.3.48",25,6,372,6,372,0,0,8980.876517,9.013392999999269,330.1753290908586,0
"147.32.84.165",1610,"65.55.37.88",25,6,372,6,372,0,0,8983.480311,9.013034000001426,330.1884803718181,0
"147.32.84.165",1604,"212.117.171.138",65500,14,846,10,604,4,242,8985.583292,2.8070970000007947,1721.3512749999848,689.6804777317819
"147.32.84.165",1611,"71.74.56.243",25,6,372,6,372,0,0,8985.583425,9.012998000000152,330.1897992210749,0
"147.32.84.165",1595,"64.12.168.40",587,28,2497,20,1314,8,1183,8986.485097,15.453338999999687,680.2413381341219,612.4242793094872
"147.32.84.165",1613,"205.188.103.1",25,6,372,6,372,0,0,8986.603378,8.994732999999542,330.8602934628689,0
"147.32.84.165",1614,"209.85.143.27",25,6,372,6,372,0,0,8986.78502,9.01353200000085,330.17023737195575,0
"147.32.84.165",1605,"212.117.171.138",65500,23,1398,16,972,7,426,8988.487644,12.4357289999989,625.2950671408719,274.04907263581424
"147.32.84.165",1615,"98.139.54.60",25,6,372,6,372,0,0,8988.487671,9.013042999999016,330.18815066125006,0
"147.32.84.165",1599,"212.117.174.7",4506,6,372,6,372,0,0,8998.702124,9.012894999999844,330.19357265340955,0
"147.32.84.165",1604,"74.125.43.27",25,6,372,6,372,0,0,9000.504666,9.013146999999663,330.18434071918625,0
"147.32.84.165",1618,"205.188.59.194",25,6,372,6,372,0,0,9000.604759,9.013197000000218,330.1825090475586,0
"147.32.84.165",1607,"212.117.171.138",65500,14,846,10,604,4,242,9001.00537,0.5430489999998827,8897.907923596294,3565.055823692555
"147.32.84.165",1590,"79.170.40.26",25,6,372,6,372,0,0,9001.005502,9.013087999999698,330.18650211782017,0
"147.32.84.165",1619,"74.125.159.27",25,6,372,6,372,0,0,9001.906757,9.013583999998446,330.1683325967244,0
"147.32.84.165",1608,"74.125.157.27",25,6,372,6,372,0,0,9004.511046,9.012800000000425,330.19705308004836,0
"147.32.84.165",1620,"98.139.175.224",25,6,372,6,372,0,0,9006.613545,9.013134999999238,330.18478032341153,0
"147.32.84.165",1610,"212.117.171.138",65500,118,84268,78,4684,40,79584,9007.614881,34.89624200000071,1073.811902152651,18244.715290545813
"147.32.84.165",1589,"74.125.43.27",25,6,372,6,372,0,0,9007.637705,8.990760000000591,331.0065000066517,0
"147.32.84.165",1622,"205.188.103.1",25,6,372,6,372,0,0,9007.637767,8.990820999999414,331.00425422775004,0
"147.32.84.165",1591,"74.125.157.27",25,6,372,6,372,0,0,9007.815194,9.013215999999375,330.18181301770716,0
"147.32.84.165",1623,"87.98.168.81",25,6,372,6,372,0,0,9007.815357,9.013151000001017,330.1841941846602,0
"147.32.84.165",1624,"209.85.225.27",25,6,372,6,372,0,0,9009.517957,9.012564999999086,330.20566287181305,0
"147.32.84.165",1607,"74.125.39.27",25,6,372,6,372,0,0,9019.732671,8.91501000000062,333.8190310498578,0
"147.32.84.165",1625,"76.96.30.116",25,6,372,6,372,0,0,9021.535066,8.913470999999845,333.8766682474259,0
"147.32.84.165",1547,"81.177.26.77",25,6,372,6,372,0,0,9021.635153,8.913280000000668,333.88382279023847,0
"147.32.84.165",1626,"64.171.200.242",25,6,372,6,372,0,0,9022.035569,8.912997999999789,333.8943866025854,0
"147.32.84.165",1595,"81.177.26.77",25,6,372,6,372,0,0,9022.937372,8.913886999998795,333.861086639353,0
"147.32.84.165",1590,"174.133.57.141",80,17,3489,12,1428,5,2061,9022.937505,1.3569129999996221,8419.110141920066,12151.11064600648
"147.32.84.165",1627,"98.139.54.60",25,6,372,6,372,0,0,9023.097253,8.854495999999926,336.10043982176114,0
"147.32.84.165",1590,"212.117.174.7",4506,6,372,6,372,0,0,9025.54065,8.91279299999951,333.90206638930846,0
"147.32.84.165",1618,"178.125.252.68",6667,9,552,6,372,3,180,9027.543726,1.0665599999992992,2790.279027904624,1350.1350135022374
"147.32.84.165",1604,"212.117.174.7",4506,6,372,6,372,0,0,9028.545099,9.013090999998894,330.1863922155413,0
"147.32.84.165",1603,"217.16.28.65",25,6,372,6,372,0,0,9028.54516,9.013122000000294,330.18525656258765,0
"147.32.84.165",1628,"205.188.146.193",25,6,372,6,372,0,0,9028.610555,8.947753000000375,332.59746888407346,0
"147.32.84.165",1609,"217.16.28.65",25,6,372,6,372,0,0,9028.746967,9.011368000001312,330.2495248223762,0
"147.32.84.165",1629,"209.85.143.27",25,6,372,6,372,0,0,9028.747097,9.011306000000332,330.25179702030874,0
"147.32.84.165",1611,"112.216.242.123",25,6,372,6,372,0,0,9030.448672,9.012448999999833,330.2099129770449,0
"147.32.84.165",1624,"174.133.57.141",80,16,3429,12,1428,4,2001,9040.662798,0.5048700000006647,22627.607106750173,31707.172143282278
"147.32.84.165",1630,"205.188.190.1",25,6,372,6,372,0,0,9040.829413,8.946205000000191,332.6550196423999,0
"147.32.84.165",1613,"72.14.213.27",25,6,372,6,372,0,0,9042.465093,9.012982000000193,330.19038537965974,0
"147.32.84.165",1631,"209.85.225.27",25,6,372,6,372,0,0,9042.565413,9.012762000000293,330.1984452712613,0
"147.32.84.165",1591,"212.117.171.138",65500,14,846,10,604,4,242,9042.965863,22.295976999999766,216.72071154361393,86.83180826747446
"147.32.84.165",1614,"72.14.213.27",25,6,372,6,372,0,0,9042.988425,8.990900000000693,331.00134580517755,0
"147.32.84.165",1633,"66.94.237.64",25,6,372,6,372,0,0,9042.988491,8.990959000000657,330.9991737254927,0
"147.32.84.165",1615,"69.175.84.210",25,6,372,6,372,0,0,9043.967286,9.01286600000094,330.1946350916223,0
"147.32.84.165",1634,"168.95.6.65",25,6,372,6,372,0,0,9046.47095,9.01293699999951,330.19203396186634,0
"147.32.84.165",1627,"124.81.2.139",6667,6,372,6,372,0,0,9049.575413,9.013229999998657,330.18130015548735,0
"147.32.84.165",1635,"209.85.143.27",25,6,372,6,372,0,0,9049.575554,9.013213000000178,330.18192291693776,0
"147.32.84.165",1589,"74.125.43.27",25,6,372,6,372,0,0,9049.575613,9.013204999999289,330.1822159820214,0
"147.32.84.165",1636,"64.12.90.1",25,6,372,6,372,0,0,9049.775756,9.013089000000036,330.18646548369685,0
"147.32.84.165",1608,"74.125.157.27",25,6,372,6,372,0,0,9051.478213,9.012977999998839,330.1905319196811,0
"147.32.84.165",1629,"174.133.57.141",80,16,3429,12,1428,4,2001,9061.792741,1.1239220000006753,10164.406426774398,14242.981274492697
"147.32.84.165",1637,"98.139.54.60",25,6,372,6,372,0,0,9062.491996,8.914897999999084,333.82322489840107,0
"147.32.84.165",1620,"64.191.120.172",25,6,372,6,372,0,0,9063.495596,9.013016999999309,330.1891031604876,0
"147.32.84.165",1638,"62.97.117.86",25,6,372,6,372,0,0,9063.595642,9.012969999999768,330.19082499998075,0
"147.32.84.165",1607,"74.125.39.27",25,6,372,6,372,0,0,9063.996013,9.013359000000492,330.1765745711269,0
"147.32.84.165",1639,"216.32.180.22",25,6,372,6,372,0,0,9064.997689,9.012824999999793,330.1961371712053,0
"147.32.84.165",1591,"212.117.171.138",65500,14,846,10,604,4,242,9067.501142,2.328283000000738,2075.349087717631,831.5140384564017
"147.32.84.165",1547,"81.177.26.77",25,6,372,6,372,0,0,9067.523991,8.991642999999385,330.9739944079412,0
"147.32.84.165",1641,"209.85.225.27",25,6,372,6,372,0,0,9070.605938,9.0129769999985,330.1905685547068,0
"147.32.84.165",1591,"212.117.171.138",65500,14,846,10,604,4,242,9070.806186,50.89481999999953,94.94089968291557,38.03923464116816
"147.32.84.165",1624,"81.177.26.77",25,6,372,6,372,0,0,9070.828891,8.990354999999909,331.0214112790908,0
"147.32.84.165",1635,"78.159.98.70",25,6,372,6,372,0,0,9070.828967,8.990338999999949,331.02200039398036,0
"147.32.84.165",1642,"65.55.37.72",25,6,372,6,372,0,0,9071.506963,9.012800000000425,330.19705308004836,0
"147.32.84.165",1590,"217.16.28.65",25,6,372,6,372,0,0,9072.508731,9.012361000000965,330.2131372677683,0
"147.32.84.165",1643,"74.125.45.27",25,6,372,6,372,0,0,9083.424438,9.0128820000009,330.1940489179491,0
"147.32.84.165",1604,"217.72.192.149",25,6,372,6,372,0,0,9084.525791,9.012613000000783,330.2039042395076,0
"147.32.84.165",1644,"212.101.97.136",25,6,372,6,372,0,0,9084.626023,9.013075999999273,330.1869417278008,0
"147.32.84.165",1620,"212.117.174.7",4506,6,372,6,372,0,0,9085.02649,9.012865000000602,330.19467172755844,0
"147.32.84.165",1628,"217.16.28.65",25,6,372,6,372,0,0,9086.027637,9.013068000000203,330.18723480172713,0
"147.32.84.165",1645,"65.55.88.22",25,6,372,6,372,0,0,9086.027735,9.013095000000249,330.1862456791943,0
"147.32.84.165",1647,"205.188.159.42",25,6,372,6,372,0,0,9088.531378,8.912704000000303,333.9054006505656,0
"147.32.84.165",1611,"112.216.242.123",25,6,372,6,372,0,0,9091.635767,8.913362000001143,333.88075116882027,0
"147.32.84.165",1648,"209.85.225.27",25,6,372,6,372,0,0,9091.835981,8.913491999999678,333.87588164101203,0
"147.32.84.165",1630,"74.125.39.27",25,6,372,6,372,0,0,9092.537393,8.912546999999904,333.91128259969145,0
"147.32.84.165",1624,"78.159.98.70",25,6,372,6,372,0,0,9093.538541,8.91292600000088,333.89708385323814,0
"147.32.84.165",1649,"98.137.54.238",25,6,372,6,372,0,0,9104.354007,9.013116000000082,330.1854763657733,0
"147.32.84.165",1613,"72.14.213.27",25,6,372,6,372,0,0,9105.455887,9.012665000000197,330.20199907573783,0
"147.32.84.165",1650,"205.188.103.1",25,6,372,6,372,0,0,9105.556178,9.012644999998884,330.2027318284886,0
"147.32.84.165",1631,"78.111.81.140",25,6,372,6,372,0,0,9105.956689,9.014150999999401,330.1475646458771,0
"147.32.84.165",1651,"167.138.239.94",25,6,372,6,372,0,0,9106.957704,9.013562000000093,330.16913846046316,0
"147.32.84.165",1620,"212.117.174.7",4506,6,372,6,372,0,0,9109.461298,9.013042000000496,330.1881872956807,0
"147.32.84.165",1614,"72.14.213.27",25,6,372,6,372,0,0,9112.566169,9.012613000000783,330.2039042395076,0
"147.32.84.165",1654,"64.12.90.1",25,6,372,6,372,0,0,9112.566302,9.012607000000571,330.2041240675214,0
"147.32.84.165",1633,"85.28.205.210",25,6,372,6,372,0,0,9112.766367,9.012704000000667,330.20057021730435,0
"147.32.84.165",1655,"123.100.1.211",25,6,372,6,372,0,0,9113.467191,9.013253999999506,330.1804209667411,0
"147.32.84.165",1615,"69.175.84.210",25,6,372,6,372,0,0,9114.468649,9.029209000000264,329.5969779855481,0
"147.32.84.165",1624,"78.159.98.70",25,6,372,6,372,0,0,9125.384406,9.012746000000334,330.1990314605437,0
"147.32.84.165",1656,"142.161.2.100",25,6,372,6,372,0,0,9126.486403,9.012507999999798,330.20775127190643,0
"147.32.84.165",1591,"212.117.171.138",65500,14,846,10,604,4,242,9126.586057,35.010049999998955,138.0175121143827,55.29840717165665
"147.32.84.165",1634,"194.95.104.22",25,6,372,6,372,0,0,9126.609447,8.989462999999887,331.0542576347483,0
"147.32.84.165",1649,"184.22.104.32",25,6,372,6,372,0,0,9126.987109,9.012622000000192,330.2035744980691,0
"147.32.84.165",1657,"98.139.54.60",25,6,372,6,372,0,0,9127.988065,9.013033000001087,330.1885170063885,0
"147.32.84.165",1589,"74.125.43.27",25,6,372,6,372,0,0,9130.491708,9.013215000000855,330.18184965073146,0
"147.32.84.165",1651,"72.14.213.27",25,6,372,6,372,0,0,9133.59664,9.013130999999703,330.1849268583912,0
"147.32.84.165",1658,"205.188.190.1",25,6,372,6,372,0,0,9133.7965,9.013197000000218,330.1825090475586,0
"147.32.84.165",1608,"74.125.157.27",25,6,372,6,372,0,0,9134.497519,9.01347799999894,330.17221543119643,0
"147.32.84.165",1659,"74.6.136.65",25,6,372,6,372,0,0,9135.499098,9.013356999999814,330.17664783499214,0
"147.32.84.165",1615,"212.117.174.7",4506,6,372,6,372,0,0,9146.414705,9.013425000001007,330.17415688261315,0
"147.32.84.165",1637,"64.191.120.172",25,6,372,6,372,0,0,9147.5163,9.012794000000213,330.19727289894007,0
"147.32.84.165",1660,"209.85.225.27",25,6,372,6,372,0,0,9147.616753,9.01284399999895,330.1954410838961,0
"147.32.84.165",1607,"74.125.39.27",25,6,372,6,372,0,0,9148.016856,9.013182999999117,330.1830219136005,0
"147.32.84.165",1656,"184.22.104.32",25,6,372,6,372,0,0,9149.01865,9.013199000000895,330.1824357810922,0
"147.32.84.165",1663,"64.12.90.1",25,6,372,6,372,0,0,9151.522455,9.012262000000192,330.2167646701723,0
"147.32.84.165",1639,"91.218.10.2",25,6,372,6,372,0,0,9154.626981,9.012314000001425,330.2148593579329,0
"147.32.84.165",1651,"72.14.213.27",25,6,372,6,372,0,0,9154.826873,9.013006999999561,330.18946950780634,0
"147.32.84.165",1664,"66.94.238.147",25,6,372,6,372,0,0,9155.527713,9.012918000000354,330.1927300348104,0
"147.32.84.165",1547,"81.177.26.77",25,6,372,6,372,0,0,9156.52923,8.91325499999948,333.8847592714641,0
"147.32.84.165",1665,"98.139.54.60",25,6,372,6,372,0,0,9167.345101,9.013184999999794,330.1829486469065,0
"147.32.84.165",1591,"212.117.171.138",65500,14,846,10,604,4,242,9168.446723,3.498477000001003,1381.1724358909933,553.3836580887755
"147.32.84.165",1642,"217.16.28.65",25,6,372,6,372,0,0,9168.469445,8.990297999998802,331.02351001050204,0
"147.32.84.165",1666,"123.100.1.212",25,6,372,6,372,0,0,9168.546262,9.013478999999279,330.1721788002433,0
"147.32.84.165",1628,"217.16.28.65",25,6,372,6,372,0,0,9168.94724,9.012579000000187,330.2051499354334,0
"147.32.84.165",1667,"209.85.225.27",25,6,372,6,372,0,0,9168.947373,9.01256899999862,330.20551631842767,0
"147.32.84.165",1637,"202.106.32.73",6667,6,372,6,372,0,0,9169.94831,9.01308699999936,330.1865387519516,0
"147.32.84.165",1630,"74.125.39.27",25,6,372,6,372,0,0,9172.452502,9.012908000000607,330.19309639017723,0
"147.32.84.165",1656,"184.22.104.32",25,6,372,6,372,0,0,9175.556332,9.013231999999334,330.1812268895575,0
"147.32.84.165",1668,"216.82.250.179",25,6,372,6,372,0,0,9175.756623,9.01356400000077,330.16906519993046,0
"147.32.84.165",1591,"212.117.171.138",65500,14,846,10,604,4,242,9176.457963,0.3370649999997113,14335.51392165944,5743.699286492689
"147.32.84.165",1614,"85.28.205.210",25,6,372,6,372,0,0,9176.48044,9.22913300000073,322.45715821841173,0
"147.32.84.165",1669,"74.6.136.65",25,6,372,6,372,0,0,9177.459879,9.012747000000672,330.19899482364013,0
"147.32.84.165",1591,"212.117.174.7",4506,6,372,6,372,0,0,9188.374763,9.013340999999855,330.1772339468847,0
"147.32.84.165",1664,"212.117.171.138",65500,14,846,10,604,4,242,9189.476637,56.62136500000088,85.3388115952331,34.1920404073616
"147.32.84.165",1637,"212.117.174.7",4506,6,372,6,372,0,0,9189.499189,8.99013399999967,331.0295486140817,0
"147.32.84.165",1624,"194.95.104.22",25,6,372,6,372,0,0,9189.499253,8.990193999999974,331.0273393432899,0
"147.32.84.165",1665,"213.178.60.138",25,6,372,6,372,0,0,9189.57693,9.013037000000622,330.1883704682223,0
"147.32.84.165",1670,"64.12.139.193",25,6,372,6,372,0,0,9189.977482,9.013006999999561,330.18946950780634,0
"147.32.84.165",1628,"188.72.216.51",6667,9,552,6,372,3,180,9192.280958,1.022184000001289,2911.413209359809,1408.7483271095853
"147.32.84.165",1615,"64.191.120.172",25,6,372,6,372,0,0,9193.303375,8.991373000000749,330.98393315456406,0
"147.32.84.165",1666,"217.16.28.65",25,6,372,6,372,0,0,9193.482406,9.012668000001213,330.20188916307575,0
"147.32.84.165",1671,"125.5.96.59",25,6,372,6,372,0,0,9196.586862,9.013205999999627,330.1821793488491,0
"147.32.84.165",1639,"91.218.10.2",25,6,372,6,372,0,0,9196.78724,9.013154000000213,330.1840842839177,0
"147.32.84.165",1667,"217.16.28.65",25,6,372,6,372,0,0,9197.488162,9.01339200000075,330.17536572244416,0
"147.32.84.165",1673,"205.188.59.194",25,6,372,6,372,0,0,9197.488256,9.013421999999991,330.17426677681385,0
"147.32.84.165",1614,"85.28.205.210",25,6,372,6,372,0,0,9198.489511,9.012925999999425,330.19243695112885,0
"147.32.84.165",1656,"77.82.34.183",25,6,372,6,372,0,0,9209.40524,9.013343000000532,330.1771606827594,0
"147.32.84.165",1674,"203.23.236.107",25,6,372,6,372,0,0,9210.506718,9.013623999999254,330.1668673998656,0
"147.32.84.165",1668,"77.82.34.183",25,6,372,6,372,0,0,9210.607459,9.012473999999202,330.20899699685833,0
"147.32.84.165",1675,"211.43.198.48",25,6,372,6,372,0,0,9210.60759,9.01246700000047,330.2092534707583,0
"147.32.84.165",1624,"213.178.60.138",25,6,372,6,372,0,0,9211.00743,9.013157000001229,330.18397438318163,0
"147.32.84.165",1676,"98.139.54.60",25,6,372,6,372,0,0,9214.312165,9.012904000001072,330.1932429325383,0
"147.32.84.165",1615,"212.117.174.7",4506,6,372,6,372,0,0,9214.512759,9.012577000001329,330.2052232119139,0
"147.32.84.165",1666,"217.16.28.65",25,6,372,6,372,0,0,9217.61686,9.013042999999016,330.18815066125006,0
"147.32.84.165",1677,"209.85.225.27",25,6,372,6,372,0,0,9217.817144,9.01312499999949,330.1851466611379,0
"147.32.84.165",1639,"91.218.10.2",25,6,372,6,372,0,0,9218.518636,9.01270299999851,330.2006068546242,0
"147.32.84.165",1667,"217.16.28.65",25,6,372,6,372,0,0,9219.520476,9.013522999999623,330.17056704688326,0
"147.32.84.165",1678,"98.139.175.224",25,6,372,6,372,0,0,9219.520537,9.013589000000138,330.16814944634757,0
"147.32.84.165",1680,"216.221.81.26",25,6,372,6,372,0,0,9230.435868,8.912784000000102,333.90240355874954,0
"147.32.84.165",1656,"77.82.34.183",25,6,372,6,372,0,0,9231.53704,8.913288000001558,333.8835231173367,0
"147.32.84.165",1681,"209.85.143.27",25,6,372,6,372,0,0,9231.637222,8.913207000001421,333.88655732998524,0
"147.32.84.165",1682,"64.12.90.65",25,6,372,6,372,0,0,9232.037999,8.912508999999773,333.91270628731775,0
"147.32.84.165",1684,"64.12.90.1",25,6,372,6,372,0,0,9235.242387,9.012800999998944,330.1970164436504,0
"147.32.84.165",1685,"66.94.237.64",25,6,372,6,372,0,0,9235.442847,9.26582099999905,321.1803897355998,0
"147.32.84.165",1615,"212.117.174.7",4506,6,372,6,372,0,0,9238.546926,9.013019999998505,330.18899325647715,0
"147.32.84.165",1686,"98.139.54.60",25,6,372,6,372,0,0,9238.74719,9.013130999999703,330.1849268583912,0
"147.32.84.165",1687,"209.85.225.27",25,6,372,6,372,0,0,9239.448611,9.012936000000991,330.19207059715865,0
"147.32.84.165",1688,"202.108.252.141",25,6,372,6,372,0,0,9240.450466,9.012768999999025,330.19818881415046,0
"147.32.84.165",1639,"212.117.174.7",4506,6,372,6,372,0,0,9251.365765,9.013081999999486,330.18672192266416,0
"147.32.84.165",1664,"212.117.171.138",65500,25,1527,18,1092,7,435,9251.365897,211.40373999999974,41.32377222843839,16.461392783306504
"147.32.84.165",1666,"217.16.28.65",25,6,372,6,372,0,0,9251.389672,8.98935100000017,331.05838230145247,0
"147.32.84.165",1690,"64.12.139.193",25,6,372,6,372,0,0,9252.467132,9.012667999999394,330.20188916314237,0
"147.32.84.165",1680,"72.14.213.27",25,6,372,6,372,0,0,9252.567327,9.012720999999146,330.1999473855101,0
"147.32.84.165",1691,"64.12.90.1",25,6,372,6,372,0,0,9252.96805,9.012575000000652,330.20529648849356,0
"147.32.84.165",1692,"74.6.140.64",25,6,372,6,372,0,0,9252.968181,9.01258400000006,330.20496674427443,0
"147.32.84.165",1656,"89.41.159.184",6667,4,248,4,248,0,0,9256.272549,3.004190000001472,660.4109593597701,0
"147.32.84.165",1693,"64.78.22.100",25,6,372,6,372,0,0,9256.47284,9.01339100000041,330.1754023541045,0
"147.32.84.165",1694,"74.125.93.27",25,6,372,6,372,0,0,9259.577516,9.013300000000527,330.17873586808673,0
"147.32.84.165",1695,"195.114.128.20",25,6,372,6,372,0,0,9259.777723,9.013980000001538,330.1538277208838,0
"147.32.84.165",1696,"98.139.54.60",25,6,372,6,372,0,0,9260.478485,9.01386100000127,330.1581863753591,0
"147.32.84.165",1698,"209.85.225.27",25,6,372,6,372,0,0,9261.479945,9.013377000001128,330.17591519800266,0
"147.32.84.165",1656,"212.117.174.7",4506,6,372,6,372,0,0,9272.395588,9.013625000001412,330.16683077003245,0
"147.32.84.165",1687,"79.174.79.169",25,6,372,6,372,0,0,9273.49734,9.012871000000814,330.19445191213003,0
"147.32.84.165",1666,"174.133.57.141",80,17,3489,12,1428,5,2061,9273.597348,0.6220400000001973,18365.378432249334,26506.333997805235
"147.32.84.165",1699,"119.205.212.219",25,6,372,6,372,0,0,9273.751323,8.959210999999414,332.1721075661902,0
"147.32.84.165",1700,"64.12.139.193",25,6,372,6,372,0,0,9273.998032,9.013461000000461,330.17283815837754,0
"147.32.84.165",1680,"119.154.130.96",6667,6,372,6,372,0,0,9275.801448,9.011964999999691,330.2276473554993,0
"147.32.84.165",1701,"64.12.90.1",25,6,372,6,372,0,0,9277.503597,9.013118999999278,330.1853664641772,0
"147.32.84.165",1702,"216.251.32.72",25,6,372,6,372,0,0,9280.607597,9.012876999999207,330.1942320970609,0
"147.32.84.165",1703,"174.143.82.88",25,6,372,6,372,0,0,9280.807756,9.013570999999502,330.1688087884552,0
"147.32.84.165",1704,"74.208.5.90",25,6,372,6,372,0,0,9281.508708,9.013061000001471,330.1874912418227,0
"147.32.84.165",1706,"209.85.225.27",25,6,372,6,372,0,0,9282.510346,9.012906000001749,330.19316966130816,0
"147.32.84.165",1707,"64.12.90.65",25,6,372,6,372,0,0,9293.425937,9.012858000000051,330.19492817927267,0
"147.32.84.165",1656,"212.176.27.2",25,6,372,6,372,0,0,9294.527598,9.013154000000213,330.1840842839177,0
"147.32.84.165",1708,"64.12.90.98",25,6,372,6,372,0,0,9294.728036,9.013348999998925,330.17694089071165,0
"147.32.84.165",1687,"79.174.79.169",25,6,372,6,372,0,0,9295.02818,9.013132000000041,330.1848902246174,0
"147.32.84.165",1709,"98.137.54.238",25,6,372,6,372,0,0,9296.830662,8.914269999999306,333.8467423580654,0
"147.32.84.165",1710,"98.139.175.224",25,6,372,6,372,0,0,9298.533243,8.912980000000971,333.8950609111291,0
"147.32.84.165",1711,"209.85.225.27",25,6,372,6,372,0,0,9301.63849,8.911987000001318,333.9322644882179,0
"147.32.84.165",1712,"64.12.90.1",25,6,372,6,372,0,0,9301.638622,8.911981999999625,333.9324518384491,0
"147.32.84.165",1714,"209.85.143.27",25,6,372,6,372,0,0,9301.838684,8.912490999999136,333.9133806699259,0
"147.32.84.165",1702,"212.117.174.7",4506,6,372,6,372,0,0,9302.539607,8.91240099999959,333.916752623691,0
"147.32.84.165",1703,"212.117.174.7",4506,6,372,6,372,0,0,9303.540853,8.914011999999275,333.85640494989707,0
"147.32.84.165",1715,"98.139.54.60",25,6,372,6,372,0,0,9303.540889,8.91411700000026,333.85247243220084,0
"147.32.84.165",1706,"209.85.149.121",25,6,372,6,372,0,0,9314.355941,9.01339100000041,330.1754023541045,0
"147.32.84.165",1716,"64.12.139.193",25,6,372,6,372,0,0,9315.457667,9.013003999998546,330.18957941220043,0
"147.32.84.165",1707,"212.176.27.2",25,6,372,6,372,0,0,9315.657974,9.013460000000123,330.172874789477,0
"147.32.84.165",1717,"216.184.2.127",25,6,372,6,372,0,0,9315.958838,9.012289999998757,330.21573873015745,0
"147.32.84.165",1687,"95.143.15.66",25,6,372,6,372,0,0,9317.760941,9.013198999999076,330.1824357811588,0
"147.32.84.165",1718,"98.139.175.224",25,6,372,6,372,0,0,9319.464564,9.012001000000964,330.22632820387855,0
"147.32.84.165",1719,"66.135.225.68",25,6,372,6,372,0,0,9322.567912,9.013005999999223,330.1895061425962,0
"147.32.84.165",1720,"74.6.136.65",25,6,372,6,372,0,0,9322.768735,9.012330999999904,330.2142364722325,0
"147.32.84.165",1722,"209.85.225.27",25,6,372,6,372,0,0,9323.469279,9.012794999998732,330.19723626249333,0
"147.32.84.165",1702,"137.254.16.78",80,10,1467,8,1158,2,309,9324.470813,0.4857499999998254,19071.538857443808,5089.037570768684
"147.32.84.165",1712,"174.133.57.141",80,16,3429,12,1428,4,2001,9324.629684,0.4955730000001495,23052.1033228133,32302.0019250346
"147.32.84.165",1723,"209.85.143.27",25,6,372,6,372,0,0,9324.794196,8.989743999998609,331.0439095930274,0
"147.32.84.165",1703,"114.57.53.106",6667,2,124,2,124,0,0,9335.386182,8.999999408842996e-06,0,0
"147.32.84.165",1706,"209.85.149.121",25,6,372,6,372,0,0,9336.488094,9.012568000000101,330.20555295671187,0
"147.32.84.165",1725,"205.188.146.193",25,6,372,6,372,0,0,9336.688644,9.012359000000288,330.21321054786046,0
"147.32.84.165",1703,"212.176.27.2",25,6,372,6,372,0,0,9336.988725,9.012625000001208,330.2034645843582,0
"147.32.84.165",1726,"98.139.175.224",25,6,372,6,372,0,0,9338.791505,9.012862999999925,330.1947449994552,0
"147.32.84.165",1716,"212.117.174.7",4506,6,372,6,372,0,0,9338.791647,9.012849999999162,330.19522126744334,0
"147.32.84.165",1717,"95.143.15.66",25,6,372,6,372,0,0,9340.493785,9.012638000000152,330.20298829265636,0
"147.32.84.165",1727,"216.32.180.22",25,6,372,6,372,0,0,9343.598662,9.012297999999646,330.2154456055622,0
"147.32.84.165",1728,"209.85.225.27",25,6,372,6,372,0,0,9343.79858,9.012667999999394,330.20188916314237,0
"147.32.84.165",1729,"207.115.21.20",25,6,372,6,372,0,0,9343.798703,9.012671999998929,330.2017426131067,0
"147.32.84.165",1730,"130.88.200.5",25,6,372,6,372,0,0,9344.499207,9.01329899999837,330.1787725005615,0
"147.32.84.165",1732,"205.188.59.194",25,6,372,6,372,0,0,9345.801273,9.012994000000617,330.1899457605094,0
"147.32.84.165",1720,"209.127.193.138",6667,9,552,6,372,3,180,9347.904533,1.6060919999999896,1852.9449122466328,896.586247861274
"147.32.84.165",1734,"12.6.148.4",25,6,372,6,372,0,0,9349.510863,9.008603000000221,330.35088792345795,0
"147.32.84.165",1735,"209.85.143.27",25,6,372,6,372,0,0,9357.518248,9.01293799999985,330.1919973265155,0
"147.32.84.165",1706,"209.85.149.121",25,6,372,6,372,0,0,9357.718747,9.013103999999657,330.18591597302253,0
"147.32.84.165",1736,"209.85.225.27",25,6,372,6,372,0,0,9358.018727,9.012917999998535,330.192730034877,0
"147.32.84.165",1737,"66.180.96.27",25,6,372,6,372,0,0,9359.821378,9.013365999999223,330.17631814798784,0
"147.32.84.165",1738,"205.188.190.1",25,6,372,6,372,0,0,9361.523738,9.01292900000044,330.19232704483244,0
"147.32.84.165",1717,"95.143.15.66",25,6,372,6,372,0,0,9364.628218,9.01323500000035,330.1811169907236,0
"147.32.84.165",1739,"210.104.236.29",25,6,372,6,372,0,0,9364.828638,9.012825999998313,330.19610053501054,0
"147.32.84.165",1740,"64.12.90.1",25,6,372,6,372,0,0,9365.530177,8.912242000000333,333.92270990844827,0
"147.32.84.165",1741,"98.139.54.60",25,6,372,6,372,0,0,9366.83149,8.912709000000177,333.9052133307551,0
"147.32.84.165",1730,"209.85.149.121",25,6,372,6,372,0,0,9370.536912,8.913776999999754,333.86520663463784,0
"147.32.84.165",1742,"209.85.225.27",25,6,372,6,372,0,0,9370.537017,8.913794999998572,333.8645324466713,0
"147.32.84.165",1732,"94.229.67.92",25,6,372,6,372,0,0,9370.537088,8.913775000000896,333.8652815445421,0
"147.32.84.165",1743,"205.178.149.7",25,6,372,6,372,0,0,9378.448362,9.012885000000097,330.1939390106462,0
"147.32.84.165",1734,"89.111.177.200",25,6,372,6,372,0,0,9378.648864,9.012473999999202,330.20899699685833,0
"147.32.84.165",1744,"65.54.188.94",25,6,372,6,372,0,0,9378.949501,9.012489000000642,330.208447411119,0
"147.32.84.165",1736,"212.117.174.7",4506,6,372,6,372,0,0,9380.752116,9.01245899999958,330.20954658436045,0
"147.32.84.165",1706,"121.245.3.131",6667,4,248,4,248,0,0,9382.45391,3.004243999999744,660.3990887558298,0
"147.32.84.165",1735,"212.117.174.7",4506,6,372,6,372,0,0,9385.55861,9.01280399999996,330.1969065343053,0
"147.32.84.165",1745,"64.12.90.1",25,6,372,6,372,0,0,9385.558768,9.012774999999237,330.19796899403923,0
"147.32.84.165",1747,"98.139.54.60",25,6,372,6,372,0,0,9385.558853,9.012740999998641,330.1992146451838,0
"147.32.84.165",1748,"205.188.190.1",25,6,372,6,372,0,0,9385.558938,9.012706999999864,330.2004603056601,0
"147.32.84.165",1749,"203.209.228.250",25,6,372,6,372,0,0,9385.859177,9.01274100000046,330.1992146451172,0
"147.32.84.165",1750,"209.85.225.27",25,6,372,6,372,0,0,9386.460294,9.012230000000272,330.2179371809097,0
"147.32.84.165",1752,"209.85.143.27",25,6,372,6,372,0,0,9387.761717,9.012888000001112,330.19382910334986,0
"147.32.84.165",1753,"98.139.54.60",25,6,372,6,372,0,0,9391.466733,9.013342000000193,330.177197314818,0
"147.32.84.165",1706,"209.85.149.121",25,6,372,6,372,0,0,9399.478569,9.012797999999748,330.197126353002,0
"147.32.84.165",1754,"74.6.140.64",25,6,372,6,372,0,0,9399.678765,9.01271799999995,330.2000572968129,0
"147.32.84.165",1730,"94.229.67.92",25,6,372,6,372,0,0,9399.979349,9.016406000000643,330.0649948549109,0
"147.32.84.165",1757,"203.209.228.250",25,6,372,6,372,0,0,9401.781744,9.013052000000243,330.1878209512072,0
"147.32.84.165",1744,"188.72.216.51",6667,9,552,6,372,3,180,9401.781877,1.0221130000008998,2911.6154476045017,1408.846184324759
"147.32.84.165",1734,"89.111.177.200",25,6,372,6,372,0,0,9401.982015,9.014235000000554,330.1444881345802,0
"147.32.84.165",1758,"209.85.225.27",25,6,372,6,372,0,0,9402.804221,8.992371999998795,330.94716277311466,0
"147.32.84.165",1759,"205.188.103.1",25,6,372,6,372,0,0,9402.804284,8.99236700000074,330.94734678864364,0
"147.32.84.165",1760,"186.202.4.42",25,6,372,6,372,0,0,9406.589114,9.012672999999268,330.20170597560144,0
"147.32.84.165",1735,"212.117.174.7",4506,6,372,6,372,0,0,9406.889217,9.01290599999993,330.19316966137484,0
"147.32.84.165",1762,"208.87.233.190",25,6,372,6,372,0,0,9407.489901,9.012864999998783,330.1946717276251,0
"147.32.84.165",1763,"98.139.54.60",25,6,372,6,372,0,0,9408.79165,9.013345000001209,330.17708741866653,0
"147.32.84.165",1764,"165.212.8.32",25,6,372,6,372,0,0,9408.791797,9.013334999999643,330.17745373938925,0
"147.32.84.165",1765,"209.85.225.27",25,6,372,6,372,0,0,9412.497369,9.013645999999426,330.16606154714634,0
"147.32.84.165",1766,"130.74.120.171",25,6,372,6,372,0,0,9420.508624,9.013014000000112,330.18921306457116,0
"147.32.84.165",1767,"205.188.190.1",25,6,372,6,372,0,0,9420.7095,9.012499999998909,330.20804438284165,0
"147.32.84.165",1768,"204.118.41.248",25,6,372,6,372,0,0,9421.009188,9.013526000000638,330.1704571551454,0
"147.32.84.165",1730,"212.117.174.7",4506,6,372,6,372,0,0,9423.012211,9.01292900000044,330.19232704483244,0
"147.32.84.165",1706,"94.229.67.92",25,6,372,6,372,0,0,9423.012354,9.012910999999804,330.1929864835085,0
"147.32.84.165",1770,"98.139.54.60",25,6,372,6,372,0,0,9423.813318,9.013444999998683,330.17342425681136,0
"147.32.84.165",1757,"89.111.177.200",25,6,372,6,372,0,0,9427.619348,9.012829999999667,330.1959539900464,0
"147.32.84.165",1771,"212.27.48.6",25,6,372,6,372,0,0,9427.919162,9.013209999999162,330.18203281630815,0
"147.32.84.165",1759,"87.245.160.247",25,6,372,6,372,0,0,9428.520209,9.013005999999223,330.1895061425962,0
"147.32.84.165",1773,"64.46.45.27",25,6,372,6,372,0,0,9429.822041,9.01280399999996,330.1969065343053,0
"147.32.84.165",1735,"94.229.67.92",25,6,372,6,372,0,0,9433.527801,9.01234900000054,330.21357694867584,0
"147.32.84.165",1774,"209.85.225.27",25,6,372,6,372,0,0,9433.527901,9.012373999999909,330.21266094816195,0
"147.32.84.165",1760,"79.174.66.57",25,6,372,6,372,0,0,9441.539188,8.912709999998697,333.9051758668727,0
"147.32.84.165",1775,"216.82.249.179",25,6,372,6,372,0,0,9441.739018,8.913574000000153,333.8728101657033,0
"147.32.84.165",1762,"204.93.172.6",25,6,372,6,372,0,0,9442.039439,8.913002999999662,333.89419929513235,0
"147.32.84.165",1777,"209.85.143.27",25,6,372,6,372,0,0,9443.946372,9.009425000000192,330.32074743947993,0
"147.32.84.165",1767,"183.83.70.111",6667,6,372,6,372,0,0,9444.7439,9.012672000000748,330.20174261304004,0
"147.32.84.165",1706,"194.28.172.37",25,6,372,6,372,0,0,9448.549074,9.013095000000249,330.1862456791943,0
"147.32.84.165",1779,"98.139.54.60",25,6,372,6,372,0,0,9448.849248,9.013018999999986,330.1890298910947,0
"147.32.84.165",1757,"212.117.174.7",4506,6,372,6,372,0,0,9449.450789,9.01234199999999,330.213833429757,0
"147.32.84.165",1730,"194.28.172.37",25,6,372,6,372,0,0,9450.752023,9.013405000001512,330.1748895117329,0
"147.32.84.165",1780,"98.139.54.60",25,6,372,6,372,0,0,9450.752155,9.013397999999142,330.17514593278617,0
"147.32.84.165",1771,"87.245.160.247",25,6,372,6,372,0,0,9450.752213,9.013394999999946,330.1752558275786,0
"147.32.84.165",1781,"209.85.225.27",25,6,372,6,372,0,0,9454.457521,9.012846999999965,330.19533117559985,0
"147.32.84.165",1735,"94.229.67.92",25,6,372,6,372,0,0,9462.469697,9.01227999999901,330.21610513658334,0
"147.32.84.165",1767,"174.133.57.141",80,16,3429,12,1428,4,2001,9462.669281,0.485183999999208,23545.70637122957,32993.66838153387
"147.32.84.165",1782,"207.115.37.23",25,6,372,6,372,0,0,9462.829212,8.95378399999936,332.3734412177257,0
"147.32.84.165",1760,"79.174.66.57",25,6,372,6,372,0,0,9462.969591,9.013021000000663,330.1889566217344,0
"147.32.84.165",1783,"209.85.143.27",25,6,372,6,372,0,0,9464.972475,9.012958999999682,330.1912279862923,0
"147.32.84.165",1762,"212.117.174.7",4506,6,372,6,372,0,0,9465.673435,9.013768999999229,330.1615561703716,0
"147.32.84.165",1774,"212.117.171.138",65500,54,4832,36,3690,18,1142,9465.673601,54.18358400000034,544.8144589327981,168.6119544989852
"147.32.84.165",1664,"204.93.172.6",25,6,372,6,372,0,0,9465.696157,8.991180999999415,330.99100107095984,0
"147.32.84.165",1784,"64.12.90.1",25,6,372,6,372,0,0,9469.579741,9.012547000000268,330.2063223636905,0
"147.32.84.165",1767,"77.123.72.98",6667,4,248,4,248,0,0,9469.879763,3.0040619999999763,660.439098793572,0
"147.32.84.165",1706,"194.28.172.37",25,6,372,6,372,0,0,9470.480709,9.013460000000123,330.172874789477,0
"147.32.84.165",1785,"98.139.54.60",25,6,372,6,372,0,0,9471.783155,9.012119000000894,330.22200439205307,0
"147.32.84.165",1730,"87.245.160.247",25,6,372,6,372,0,0,9475.488122,9.012855999999374,330.19500145128325,0
"147.32.84.165",1786,"205.188.190.1",25,6,372,6,372,0,0,9483.499174,9.013074999998935,330.1869783620298,0
"147.32.84.165",1757,"212.117.171.138",65500,120,84364,76,4564,44,79800,9483.800041,3.3490619999993214,10902.157081596995,190620.53792976344
"147.32.84.165",1767,"212.117.174.7",4506,6,372,6,372,0,0,9483.800184,9.012539999999717,330.20657883350236,0
"147.32.84.165",1771,"194.28.172.37",25,6,372,6,372,0,0,9484.000182,9.012858000000051,330.19492817927267,0
"147.32.84.165",1787,"209.85.225.27",25,6,372,6,372,0,0,9484.000315,9.012849000000642,330.19525790344295,0
"147.32.84.165",1781,"64.12.168.40",587,34,3090,22,1406,12,1684,9486.00454,33.94672100000025,331.3427532514824,396.85718099252944
"147.32.84.165",1783,"64.12.90.1",25,6,372,6,372,0,0,9486.122565,8.993367000000944,330.9105477403166,0
"147.32.84.165",1735,"94.229.67.92",25,6,372,6,372,0,0,9486.12263,8.993427999999767,330.9083032632359,0
"147.32.84.165",1788,"209.58.232.24",25,6,372,6,372,0,0,9486.703977,9.012713000000076,330.2002404825245,0
"147.32.84.165",1790,"64.12.90.1",25,6,372,6,372,0,0,9486.704137,9.012675999998464,330.2015960632011,0
"147.32.84.165",1782,"212.117.171.138",65500,32,15030,24,1444,8,13586,9486.704205,3.6087339999994583,3201.1226097578083,30118.04139623932
"147.32.84.165",1791,"98.139.54.60",25,6,372,6,372,0,0,9486.70427,9.012590000000273,330.2047469151387,0
"147.32.84.165",1792,"64.12.90.65",25,6,372,6,372,0,0,9486.704336,9.012571999999636,330.20540640342404,0
"147.32.84.165",1664,"204.93.172.6",25,6,372,6,372,0,0,9490.609415,9.013090999998894,330.1863922155413,0
"147.32.84.165",1793,"65.55.88.22",25,6,372,6,372,0,0,9491.510645,9.013127000000168,330.1850733935009,0
"147.32.84.165",1782,"94.229.67.92",25,6,372,6,372,0,0,9492.812857,9.012660999998843,330.2021456260678,0
"147.32.84.165",1794,"209.85.225.27",25,6,372,6,372,0,0,9492.812916,9.01272599999902,330.19976420012364,0
"147.32.84.165",1784,"194.28.172.37",25,6,372,6,372,0,0,9492.812971,9.012722000001304,330.19991074833655,0
"147.32.84.165",1795,"74.6.136.65",25,6,372,6,372,0,0,9496.51798,9.012775999999576,330.19793235737137,0
"147.32.84.165",1730,"212.117.174.7",4506,6,372,6,372,0,0,9504.529408,8.915235999998913,333.8105687836377,0
"147.32.84.165",1706,"193.109.247.50",25,6,372,6,372,0,0,9504.529541,8.915226000000985,333.81094321104945,0
"147.32.84.165",1797,"76.96.30.116",25,6,372,6,372,0,0,9504.829817,8.912883999999394,333.89865726965616,0
"147.32.84.165",1798,"205.188.59.194",25,6,372,6,372,0,0,9505.030092,8.913159999998243,333.88831794790923,0
"147.32.84.165",1786,"212.117.171.138",65500,29,4889,20,3952,9,937,9507.133197,10.622812000001431,2976.2364240274364,705.6511966886912
"147.32.84.165",1767,"194.28.172.37",25,6,372,6,372,0,0,9507.133341,8.91301999999996,333.8935624513367,0
"147.32.84.165",1799,"205.188.190.1",25,6,372,6,372,0,0,9507.133441,8.913048000000344,333.8925135374436,0
"147.32.84.165",1800,"98.139.175.224",25,6,372,6,372,0,0,9507.733935,8.912913000000117,333.8975708615086,0
"147.32.84.165",1801,"209.85.143.27",25,6,372,6,372,0,0,9507.734081,8.91283999999905,333.900305626525,0
"147.32.84.165",1792,"212.117.174.7",4506,6,372,6,372,0,0,9511.639589,8.912905999999566,333.8978330973248,0
"147.32.84.165",1802,"98.139.54.60",25,6,372,6,372,0,0,9512.540858,8.913271999999779,333.8841224636782,0
"147.32.84.165",1783,"212.117.171.138",65500,14,846,10,604,4,242,9513.742849,5.69920699999966,847.8372517440213,339.69638232128005
"147.32.84.165",1803,"216.82.250.99",25,6,372,6,372,0,0,9513.742915,9.012783999998646,330.1976392644545,0
"147.32.84.165",1664,"205.188.90.1",80,13,2936,10,1386,3,1550,9517.448093,0.4001729999999952,27708.016282957953,30986.598296237247
"147.32.84.165",1782,"94.229.67.92",25,6,372,6,372,0,0,9517.565528,8.995606000000407,330.8281843379829,0
"147.32.84.165",1805,"205.188.146.193",25,6,372,6,372,0,0,9525.459919,9.012765999999829,330.1982987242825,0
"147.32.84.165",1783,"212.117.171.138",65500,29,3834,20,2568,9,1266,9525.760203,7.892453000000387,2602.9930111714307,1283.2512274700277
"147.32.84.165",1706,"193.109.247.50",25,6,372,6,372,0,0,9525.783937,8.989127000000735,331.06663194320834,0
"147.32.84.165",1806,"205.188.190.1",25,6,372,6,372,0,0,9525.960494,9.01279599999907,330.19719962598805,0
"147.32.84.165",1807,"209.85.225.27",25,6,372,6,372,0,0,9525.960638,9.012778999998773,330.1978224474832,0
"147.32.84.165",1808,"63.99.16.91",25,6,372,6,372,0,0,9528.063136,9.013181999998778,330.1830585469597,0
"147.32.84.165",1809,"205.186.176.133",25,6,372,6,372,0,0,9528.664143,9.012849000000642,330.19525790344295,0
"147.32.84.165",1811,"64.12.90.1",25,6,372,6,372,0,0,9528.664292,9.012797999999748,330.197126353002,0
"147.32.84.165",1812,"64.12.139.193",25,6,372,6,372,0,0,9532.570139,9.012759000001097,330.198555181564,0
"147.32.84.165",1799,"212.117.171.138",65500,48,15454,32,13292,16,2162,9533.471055,16.83488600000055,6316.407488592231,1027.3903844670783
"147.32.84.165",1813,"209.85.225.27",25,6,372,6,372,0,0,9533.471188,9.012781999999788,330.1977125376016,0
"147.32.84.165",1792,"206.222.227.2",80,13,2902,10,2044,3,858,9533.471243,0.1780159999998432,91856.91173835163,38558.33183537461
"147.32.84.165",1814,"98.139.175.224",25,6,372,6,372,0,0,9533.491275,8.992818999999145,330.93071260527796,0
"147.32.84.165",1816,"65.55.37.88",25,6,372,6,372,0,0,9534.773207,9.012917000000016,330.1927666703238,0
"147.32.84.165",1803,"212.117.174.7",4506,6,372,6,372,0,0,9538.578833,9.148750000000291,325.2903402104009,0
"147.32.84.165",1767,"212.117.171.138",65500,14,846,10,604,4,242,9546.490111,4.598302000000331,1050.822673238872,421.02497835067396
"147.32.84.165",1782,"94.229.67.92",25,6,372,6,372,0,0,9546.490259,9.012501999999586,330.2079711050424,0
"147.32.84.165",1817,"202.216.238.123",25,6,372,6,372,0,0,9546.790192,9.013027999999395,330.18870017936257,0
"147.32.84.165",1783,"82.103.123.207",6667,6,372,6,372,0,0,9546.990383,9.013106999998854,330.18580607113375,0
"147.32.84.165",1706,"193.109.247.50",25,6,372,6,372,0,0,9549.094853,9.01169999999911,330.23735810116784,0
"147.32.84.165",1818,"98.139.54.60",25,6,372,6,372,0,0,9549.694184,9.013848000000507,330.15866253788977,0
"147.32.84.165",1792,"206.222.227.2",443,33,10056,22,3716,11,6340,9549.694256,0.6012999999984459,49439.54764689312,84350.57375707815
"147.32.84.165",1808,"94.229.67.92",25,6,372,6,372,0,0,9549.71408,8.99407600000086,330.88446217262515,0
"147.32.84.165",1819,"205.188.146.193",25,6,372,6,372,0,0,9549.714117,8.99409100000048,330.8839103362242,0
"147.32.84.165",1767,"212.117.171.138",65500,40,10114,26,7554,14,2560,9553.60043,15.502737999999226,3898.150120320876,1321.0569642601856
"147.32.84.165",1809,"85.195.97.182",25,6,372,6,372,0,0,9553.623034,8.990227000000232,331.0261242569207,0
"147.32.84.165",1820,"209.85.225.27",25,6,372,6,372,0,0,9554.501405,9.012972999998965,330.19071509482404,0
"147.32.84.165",1811,"46.4.116.200",25,6,372,6,372,0,0,9555.803361,9.012967000000572,330.1909349052106,0
"147.32.84.165",1821,"64.12.139.193",25,6,372,6,372,0,0,9559.609168,9.012364999998681,330.2129907078148,0
"147.32.84.165",1814,"212.117.171.138",65500,40,10010,26,7292,14,2718,9567.520124,10.464286999998876,5574.770646103864,2077.9246593678417
"147.32.84.165",1792,"74.125.127.27",25,6,372,6,372,0,0,9567.52026,9.012695000001258,330.2008999527427,0
"147.32.84.165",1822,"98.139.175.224",25,6,372,6,372,0,0,9567.820847,9.012390999998388,330.2120380707553,0
"147.32.84.165",1816,"206.222.227.2",443,30,8211,20,4632,10,3579,9568.020751,0.9998489999998128,37061.5963010484,28636.324084942185
"147.32.84.165",1782,"212.117.174.7",4506,6,372,6,372,0,0,9568.04089,8.993565999999191,330.90322570605116,0
"147.32.84.165",1799,"217.16.28.65",25,6,372,6,372,0,0,9570.124105,9.012973999999303,330.1906784597659,0
"147.32.84.165",1823,"98.137.54.238",25,6,372,6,372,0,0,9570.72499,9.01254499999959,330.206395640758,0
"147.32.84.165",1817,"212.117.174.7",4506,6,372,6,372,0,0,9570.725185,9.012430000000677,330.210609125372,0
"147.32.84.165",1802,"217.16.28.65",25,6,372,6,372,0,0,9570.725316,9.012332000000242,330.2141998319547,0
"147.32.84.165",1824,"64.12.90.1",25,6,372,6,372,0,0,9570.725442,9.012236999999004,330.21768069352026,0
"147.32.84.165",1813,"212.117.171.138",65500,22,1338,16,972,6,366,9574.633063,13.889495999999781,559.8475279448674,210.80678521380807
"147.32.84.165",1812,"74.125.127.27",25,6,372,6,372,0,0,9574.633196,8.910235999999713,333.99788737358875,0
"147.32.84.165",1825,"64.12.139.193",25,6,372,6,372,0,0,9574.633252,8.91024600000128,333.9975125265422,0
"147.32.84.165",1706,"205.188.100.160",443,35,8684,22,5068,13,3616,9574.633313,3.3661319999991974,12044.685116332237,8593.840051431998
"147.32.84.165",1816,"94.229.67.92",25,6,372,6,372,0,0,9574.750402,8.892777999999453,334.6535806921283,0
"147.32.84.165",1826,"209.85.225.27",25,6,372,6,372,0,0,9575.531546,8.915032999999312,333.81816982620586,0
"147.32.84.165",1820,"117.224.41.27",6667,6,372,6,372,0,0,9576.833382,8.912806999998793,333.901541904857,0
"147.32.84.165",1809,"85.195.97.182",25,6,372,6,372,0,0,9580.639392,8.912375000001703,333.9177267562722,0
"147.32.84.165",1827,"98.139.175.224",25,6,372,6,372,0,0,9588.449949,9.013145000000804,330.1844139864314,0
"147.32.84.165",1706,"67.195.168.31",25,6,372,6,372,0,0,9588.450101,9.013120999999956,330.1852931964427,0
"147.32.84.165",1829,"98.139.54.60",25,6,372,6,372,0,0,9588.75422,9.009271999999328,330.3263571130078,0
"147.32.84.165",1792,"74.125.127.27",25,6,372,6,372,0,0,9588.951177,9.012613999999303,330.2038676015893,0
"147.32.84.165",1830,"66.94.237.64",25,6,372,6,372,0,0,9591.053787,9.013464999999997,330.1726916341275,0
"147.32.84.165",1822,"212.117.171.138",65500,52,18670,34,14358,18,4312,9591.655125,11.550186000000394,9944.774915312713,2986.618570471404
"147.32.84.165",1821,"89.111.177.200",25,6,372,6,372,0,0,9591.655276,9.012527000000773,330.20705513556237,0
"147.32.84.165",1831,"205.188.146.193",25,6,372,6,372,0,0,9591.678008,8.990007999998852,331.03418817874024,0
"147.32.84.165",1799,"217.16.28.65",25,6,372,6,372,0,0,9595.660353,9.013591000000815,330.1680761862537,0
"147.32.84.165",1833,"64.12.139.193",25,6,372,6,372,0,0,9596.461708,9.013080999999147,330.1867585568444,0
"147.32.84.165",1824,"212.117.171.138",65500,23,1398,16,972,7,426,9598.466015,13.834709000000657,562.0645869746613,246.3369486123516
"147.32.84.165",1802,"217.16.28.65",25,6,372,6,372,0,0,9598.466148,9.011343000000124,330.2504410274871,0
"147.32.84.165",1834,"74.125.65.27",25,6,372,6,372,0,0,9598.46621,9.011404999999286,330.24816884828016,0
"147.32.84.165",1816,"205.188.100.160",443,44,15225,28,8124,16,7101,9601.569414,1.5899380000009842,40877.065646559655,35729.69512016496
"147.32.84.165",1812,"74.125.127.27",25,6,372,6,372,0,0,9601.686453,8.99614400000064,330.80839968766486,0
"147.32.84.165",1835,"74.6.136.65",25,6,372,6,372,0,0,9601.686519,8.99620799999866,330.80604628088224,0
"147.32.84.165",1826,"60.249.196.250",6667,6,372,6,372,0,0,9609.480388,9.013182000000597,330.18305854689305,0
"147.32.84.165",1825,"94.229.67.92",25,6,372,6,372,0,0,9609.780931,9.0128190000014,330.1963569888109,0
"147.32.84.165",1836,"209.85.225.27",25,6,372,6,372,0,0,9609.981198,9.01296800000091,330.1908982701036,0
"147.32.84.165",1809,"85.195.97.182",25,6,372,6,372,0,0,9612.084059,9.012946999999258,330.191667608857,0
"147.32.84.165",1837,"216.200.145.235",25,6,372,6,372,0,0,9612.68502,9.013212999998359,330.1819229170044,0
"147.32.84.165",1706,"65.54.188.72",25,6,372,6,372,0,0,9612.685174,9.013145999999324,330.1843773528381,0
"147.32.84.165",1838,"98.139.54.60",25,6,372,6,372,0,0,9616.69069,9.012989000000744,330.19012893500195,0
"147.32.84.165",1824,"212.117.174.7",4506,6,372,6,372,0,0,9617.491756,9.012869000000137,330.1945251839292,0
"147.32.84.165",1792,"74.125.127.27",25,6,372,6,372,0,0,9619.494618,9.013014000000112,330.18921306457116,0
"147.32.84.165",1839,"65.55.37.72",25,6,372,6,372,0,0,9622.699183,9.013018999999986,330.1890298910947,0
"147.32.84.165",1834,"212.117.174.7",4506,6,372,6,372,0,0,9630.511179,9.012383000001137,330.2123311891677,0
"147.32.84.165",1822,"178.137.128.94",6667,6,372,6,372,0,0,9630.51131,9.012378999999783,330.212477748669,0
"147.32.84.165",1830,"89.111.177.200",25,6,372,6,372,0,0,9630.81104,9.012961999998879,330.19111808086734,0
"147.32.84.165",1840,"205.188.146.193",25,6,372,6,372,0,0,9631.011258,9.012887999999293,330.1938291034165,0
"147.32.84.165",1833,"212.117.171.138",65500,22,1347,16,972,6,375,9633.11432,4.705916999999317,1652.3878342948096,637.4953064408988
"147.32.84.165",1799,"217.16.28.65",25,6,372,6,372,0,0,9633.137198,8.991463999998814,330.98058336221914,0
"147.32.84.165",1841,"64.12.90.65",25,6,372,6,372,0,0,9633.715508,9.012730000000374,330.1996176519075,0
"147.32.84.165",1842,"66.94.237.64",25,6,372,6,372,0,0,9633.715655,9.012668999999732,330.2018525256046,0
"147.32.84.165",1844,"209.85.225.27",25,6,372,6,372,0,0,9637.721282,9.01274100000046,330.1992146451172,0
"147.32.84.165",1837,"212.117.171.138",65500,14,846,10,604,4,242,9638.525344,5.903585000000021,818.4857167297469,327.93633021291186
"147.32.84.165",1845,"64.12.90.1",25,6,372,6,372,0,0,9638.548451,8.986480999999912,331.1641119588445,0
"147.32.84.165",1824,"83.211.221.197",6667,9,552,6,372,3,180,9640.52563,1.096027999999933,2715.259099220259,1313.8350480098027
"147.32.84.165",1846,"77.238.177.9",25,6,372,6,372,0,0,9641.621919,8.917420000001584,333.72881393939855,0
"147.32.84.165",1847,"65.55.92.184",25,6,372,6,372,0,0,9643.7301,8.912363999999798,333.9181388911031,0
"147.32.84.165",1839,"212.117.171.138",65500,14,846,10,604,4,242,9651.540914,0.9426530000000639,5125.958332493157,2053.7780073896424
"147.32.84.165",1848,"65.54.188.72",25,6,372,6,372,0,0,9651.563325,8.890322000001106,334.7460305711795,0
"147.32.84.165",1834,"178.122.152.136",6667,6,372,6,372,0,0,9651.841088,8.913150000000314,333.8886925497602,0
"147.32.84.165",1830,"89.111.177.200",25,6,372,6,372,0,0,9652.041357,9.013048999999228,330.18793085450386,0
"147.32.84.165",1850,"98.139.54.60",25,6,372,6,372,0,0,9654.044385,9.01288999999997,330.19375583192624,0
"147.32.84.165",1840,"212.117.171.138",65500,14,846,10,604,4,242,9654.645146,6.360674999999901,759.6678025524138,304.370212280934
"147.32.84.165",1851,"205.188.190.1",25,6,372,6,372,0,0,9654.645284,9.0133679999999,330.1762448842689,0
"147.32.84.165",1852,"209.85.225.27",25,6,372,6,372,0,0,9654.667767,8.991024999999354,330.99674397526576,0
"147.32.84.165",1853,"205.188.159.42",25,6,372,6,372,0,0,9654.667837,8.991025999999692,330.9967071611295,0
"147.32.84.165",1854,"64.12.90.1",25,6,372,6,372,0,0,9658.651199,9.01291400000082,330.19287657684623,0
"147.32.84.165",1856,"128.220.161.141",25,6,372,6,372,0,0,9658.651334,9.012832000000344,330.1958807176131,0
"147.32.84.165",1855,"209.85.143.27",25,6,372,6,372,0,0,9659.452088,9.01328900000044,330.17913882489006,0
"147.32.84.165",1840,"212.117.171.138",65500,14,846,10,604,4,242,9662.456585,3.586443000000145,1347.2959140852943,539.8106145838431
"147.32.84.165",1857,"66.94.237.64",25,6,372,6,372,0,0,9662.482773,8.986644000000524,331.158105294905,0
"147.32.84.165",1834,"212.117.174.7",4506,6,372,6,372,0,0,9664.659943,9.012601999998878,330.20430725781193,0
"147.32.84.165",1858,"98.139.54.60",25,6,372,6,372,0,0,9672.47105,9.012758000000758,330.1985918183701,0
"147.32.84.165",1840,"212.117.171.138",65500,130,84916,78,4684,52,80232,9672.471195,7.2583770000001095,5162.586622326097,88429.68614057802
"147.32.84.165",1860,"64.12.90.65",25,6,372,6,372,0,0,9672.495329,8.9886060000008,331.08582131642385,0
"147.32.84.165",1848,"174.133.57.141",80,17,3489,12,1428,5,2061,9673.071698,1.9157699999996112,5963.1375373882665,8606.461109633905
"147.32.84.165",1861,"200.91.27.32",25,6,372,6,372,0,0,9673.230852,8.95783499999925,332.2231320403032,0
"147.32.84.165",1862,"65.55.37.88",25,6,372,6,372,0,0,9674.173222,9.01303100000041,330.18859027555374,0
"147.32.84.165",1863,"209.85.225.27",25,6,372,6,372,0,0,9675.07454,9.013006999999561,330.18946950780634,0
"147.32.84.165",1864,"205.188.59.194",25,6,372,6,372,0,0,9675.675409,9.01319599999988,330.18254568080397,0
"147.32.84.165",1865,"218.102.53.147",25,6,372,6,372,0,0,9675.675553,9.013181000000259,330.1830951802604,0
"147.32.84.165",1851,"212.117.174.7",4506,6,372,6,372,0,0,9679.681477,9.012978000000658,330.19053191961444,0
"147.32.84.165",1866,"203.22.70.85",25,6,372,6,372,0,0,9679.681622,9.012887999999293,330.1938291034165,0
"147.32.84.165",1850,"212.117.171.138",65500,14,846,10,604,4,242,9680.485547,65.1237199999996,74.19723566159965,29.72803150679986
"147.32.84.165",1867,"64.12.90.65",25,6,372,6,372,0,0,9680.508579,8.98900599999979,331.07108839398586,0
"147.32.84.165",1868,"209.85.225.27",25,6,372,6,372,0,0,9680.508642,8.989069999999629,331.06873124807385,0
"147.32.84.165",1869,"205.188.59.194",25,6,372,6,372,0,0,9680.508702,8.98906100000022,331.06906271966864,0
"147.32.84.165",1870,"98.139.54.60",25,6,372,6,372,0,0,9680.508762,8.98905300000115,331.0693573616286,0
"147.32.84.165",1855,"58.147.64.170",6667,6,372,6,372,0,0,9683.48681,9.01336099999935,330.1765013073608,0
"147.32.84.165",1840,"74.125.43.27",25,6,372,6,372,0,0,9685.689844,9.013041000000158,330.18822393018604,0
"147.32.84.165",1872,"67.20.75.40",25,6,372,6,372,0,0,9693.501605,9.012571999999636,330.20540640342404,0
"147.32.84.165",1873,"209.85.225.27",25,6,372,6,372,0,0,9694.202095,9.012908999999127,330.19305975465727,0
"147.32.84.165",1874,"205.188.146.193",25,6,372,6,372,0,0,9694.202228,9.012902000000395,330.1933162038009,0
"147.32.84.165",1875,"205.188.190.1",25,6,372,6,372,0,0,9695.203534,9.012979999999516,330.19045864965415,0
"147.32.84.165",1858,"212.117.174.7",4506,6,372,6,372,0,0,9696.105078,9.013698999999178,330.1641201908641,0
"147.32.84.165",1876,"212.227.15.150",25,6,372,6,372,0,0,9696.70579,9.012883999999758,330.19397564642793,0
"147.32.84.165",1877,"216.35.196.17",25,6,372,6,372,0,0,9696.705897,9.012844000000769,330.1954410838295,0
"147.32.84.165",1879,"209.85.225.27",25,6,372,6,372,0,0,9700.711999,9.012753000000885,330.1987750024557,0
"147.32.84.165",1880,"205.188.146.193",25,6,372,6,372,0,0,9701.512687,9.013042000000496,330.1881872956807,0
"147.32.84.165",1881,"205.188.190.1",25,6,372,6,372,0,0,9701.512825,9.013036000000284,330.1884071027683,0
"147.32.84.165",1882,"209.85.143.27",25,6,372,6,372,0,0,9701.512883,9.013044000001173,330.1881140266943,0
"147.32.84.165",1866,"61.17.216.92",6667,15,1706,10,1148,5,558,9705.418792,1.0732179999995424,8557.44126543155,4159.453158633105
"147.32.84.165",1865,"212.46.12.210",25,6,372,6,372,0,0,9705.617558,8.913705999999365,333.86786595835804,0
"147.32.84.165",1883,"98.139.54.60",25,6,372,6,372,0,0,9706.720069,9.013155999999071,330.18401101681883,0
"147.32.84.165",1870,"212.117.174.7",4506,6,372,6,372,0,0,9714.531398,8.912747000000309,333.90378970702267,0
"147.32.84.165",1866,"217.72.192.149",25,6,372,6,372,0,0,9714.531458,8.912814000001163,333.90127966314697,0
"147.32.84.165",1840,"74.125.43.27",25,6,372,6,372,0,0,9715.234231,8.911438999999518,333.95279931783864,0
"147.32.84.165",1884,"66.94.237.64",25,6,372,6,372,0,0,9716.233921,8.912870000000112,333.8991817450454,0
"147.32.84.165",1873,"83.99.172.192",6667,6,372,6,372,0,0,9717.135084,8.91316900000129,333.8879808067781,0
"147.32.84.165",1886,"217.72.192.149",25,6,372,6,372,0,0,9717.73646,8.912280000000464,333.92128613551694,0
"147.32.84.165",1887,"74.125.93.27",25,6,372,6,372,0,0,9717.736594,8.912210000000414,333.92390888453724,0
"147.32.84.165",1888,"205.196.184.32",25,6,372,6,372,0,0,9717.736656,8.912175000001298,333.92522027446347,0
"147.32.84.165",1889,"209.85.225.27",25,6,372,6,372,0,0,9721.641712,9.012920999999551,330.1926201283855,0
"147.32.84.165",1890,"205.188.146.193",25,6,372,6,372,0,0,9722.442734,9.012880000000223,330.19412218956944,0
"147.32.84.165",1891,"205.188.190.1",25,6,372,6,372,0,0,9726.448943,9.012705000001006,330.20053358005924,0
"147.32.84.165",1865,"212.46.12.210",25,6,372,6,372,0,0,9727.651884,9.01126099999965,330.2534462158088,0
"147.32.84.165",1893,"217.72.192.149",25,6,372,6,372,0,0,9735.46179,9.012544000001071,330.2064322792373,0
"147.32.84.165",1883,"83.243.67.217",25,6,372,6,372,0,0,9736.162382,9.013596999999208,330.16785640630053,0
"147.32.84.165",1894,"209.85.225.27",25,6,372,6,372,0,0,9737.163874,9.012881000000561,330.1940855537552,0
"147.32.84.165",1870,"74.125.43.27",25,6,372,6,372,0,0,9737.164011,9.012869000000137,330.1945251839292,0
"147.32.84.165",1895,"209.85.143.27",25,6,372,6,372,0,0,9738.666188,9.013346000001548,330.1770507866323,0
"147.32.84.165",1884,"202.164.57.158",6667,6,372,6,372,0,0,9738.666329,9.013310000000274,330.1783695445857,0
"147.32.84.165",1896,"205.188.59.194",25,6,372,6,372,0,0,9739.066638,9.012982000000193,330.19038537965974,0
"147.32.84.165",1887,"212.117.174.7",4506,6,372,6,372,0,0,9742.672257,9.013053000000582,330.1877843167912,0
"147.32.84.165",1886,"67.195.168.31",25,6,372,6,372,0,0,9743.473077,9.013236999999208,330.1810437249416,0
"147.32.84.165",1897,"46.4.35.23",25,6,372,6,372,0,0,9747.478647,9.013003000000026,330.1896160469481,0
"147.32.84.165",1850,"212.117.171.138",65500,23,1398,16,972,7,426,9748.680392,29.099779000000126,267.21852423690115,117.11429148654308
"147.32.84.165",1898,"134.192.184.196",25,6,372,6,372,0,0,9748.702921,8.99036200000046,331.021153541965,0
"147.32.84.165",1900,"205.188.103.1",25,6,372,6,372,0,0,9756.491785,9.013000999999349,330.1896893166011,0
"147.32.84.165",1901,"98.139.175.224",25,6,372,6,372,0,0,9757.1926,9.013252999999168,330.18045759952315,0
"147.32.84.165",1893,"212.117.174.7",4506,6,372,6,372,0,0,9758.194014,9.013057999998637,330.18760114496655,0
"147.32.84.165",1883,"83.243.67.217",25,6,372,6,372,0,0,9758.194147,9.013053000000582,330.1877843167912,0
"147.32.84.165",1902,"98.139.54.60",25,6,372,6,372,0,0,9759.6962,9.013575999999375,330.1686256376167,0
"147.32.84.165",1870,"79.175.253.7",6667,6,372,6,372,0,0,9760.097662,9.01209199999903,330.22299372890564,0
"147.32.84.165",1903,"209.85.225.27",25,6,372,6,372,0,0,9760.097806,9.012071999999534,330.22372657477143,0
"147.32.84.165",1905,"205.188.146.193",25,6,372,6,372,0,0,9763.701986,9.013027000000875,330.1887368139151,0
"147.32.84.165",1908,"64.12.139.193",25,6,372,6,372,0,0,9764.503363,9.014451999999437,330.13654074592506,0
"147.32.84.165",1886,"65.54.188.72",25,6,372,6,372,0,0,9768.508882,9.01329799999985,330.1788091329111,0
"147.32.84.165",1909,"206.46.232.11",25,6,372,6,372,0,0,9769.710677,9.013361000001169,330.17650130729413,0
"147.32.84.165",1910,"209.85.225.27",25,6,372,6,372,0,0,9777.52226,9.012851999999839,330.1951479953352,0
"147.32.84.165",1870,"212.117.171.138",65500,24,1473,18,1092,6,381,9777.522294,298.0325329999996,29.312236191342276,10.227071418407883
"147.32.84.165",1911,"94.23.66.5",25,6,372,6,372,0,0,9777.522327,9.012912999998662,330.19291321245885,0
"147.32.84.165",1912,"199.212.150.8",25,6,372,6,372,0,0,9778.223542,9.012559000000692,330.20588270210175,0
"147.32.84.165",1900,"212.117.174.7",4506,6,372,6,372,0,0,9779.224677,9.013284000000567,330.1793219873925,0
"147.32.84.165",1897,"180.251.135.144",6667,6,372,6,372,0,0,9780.726551,9.012969999999768,330.19082499998075,0
"147.32.84.165",1913,"64.12.90.98",25,6,372,6,372,0,0,9781.127387,9.012735000000248,330.19943446688694,0
"147.32.84.165",1914,"98.139.54.60",25,6,372,6,372,0,0,9781.127543,9.012703999998848,330.20057021737097,0
"147.32.84.165",1917,"216.82.253.163",25,6,372,6,372,0,0,9784.732672,8.912521000000197,333.91225670042564,0
"147.32.84.165",1918,"207.87.75.146",25,6,372,6,372,0,0,9785.533759,8.912459999999555,333.91454211296866,0
"147.32.84.165",1908,"212.117.174.7",4506,6,372,6,372,0,0,9789.539404,8.913597000000664,333.8719486644705,0
"147.32.84.165",1919,"64.12.90.98",25,6,372,6,372,0,0,9789.539535,8.913591000000451,333.8721734034969,0
"147.32.84.165",1921,"192.206.180.1",25,6,372,6,372,0,0,9789.539594,8.913581000000704,333.87254796919046,0
"147.32.84.165",1922,"209.85.225.27",25,6,372,6,372,0,0,9790.741445,8.91236200000094,333.9182138247623,0
"147.32.84.165",1923,"65.54.188.126",25,6,372,6,372,0,0,9798.45324,9.011780999999246,330.2343898503802,0
"147.32.84.165",1924,"98.139.54.60",25,6,372,6,372,0,0,9799.153136,9.012802999999622,330.19694317074556,0
"147.32.84.165",1925,"209.85.229.27",25,6,372,6,372,0,0,9799.15327,9.012801999999283,330.1969798071939,0
"147.32.84.165",1926,"79.171.22.227",25,6,372,6,372,0,0,9800.15452,9.013300999999046,330.17869923575336,0
"147.32.84.165",1900,"59.94.130.46",6667,6,372,6,372,0,0,9802.057317,9.013304999998581,330.1785527063012,0
"147.32.84.165",1927,"213.4.149.224",25,6,372,6,372,0,0,9802.057466,9.013280999999552,330.1794318850314,0
"147.32.84.165",1928,"205.188.159.42",25,6,372,6,372,0,0,9802.157408,9.01348500000131,330.1719590146949,0
"147.32.84.165",1914,"212.117.174.7",4506,6,372,6,372,0,0,9805.664537,9.010855999998967,330.2682897163534,0
"147.32.84.165",1913,"174.133.57.141",80,16,3429,12,1428,4,2001,9806.463533,0.4908340000001772,23274.671273782737,32613.877604229172
"147.32.84.165",1929,"205.188.190.1",25,6,372,6,372,0,0,9806.626088,8.950796999999511,332.4843586554541,0
"147.32.84.165",1930,"209.85.225.27",25,6,372,6,372,0,0,9810.469428,9.013214999999036,330.1818496507981,0
"147.32.84.165",1932,"98.139.54.60",25,6,372,6,372,0,0,9810.469562,9.013208000000304,330.18210608252906,0
"147.32.84.165",1933,"205.188.59.194",25,6,372,6,372,0,0,9811.671113,9.0131650000003,330.1836813150432,0
"147.32.84.165",1921,"212.117.174.7",4506,6,372,6,372,0,0,9819.482831,9.01232600000003,330.2144196736769,0
"147.32.84.165",1935,"173.203.205.61",25,6,372,6,372,0,0,9819.482881,9.01240499999949,330.21152511456916,0
"147.32.84.165",1936,"205.188.190.1",25,6,372,6,372,0,0,9820.183306,9.013056999998298,330.1876377793419,0
"147.32.84.165",1937,"209.85.225.27",25,6,372,6,372,0,0,9820.183437,9.013033000001087,330.1885170063885,0
"147.32.84.165",1938,"98.129.185.3",25,6,372,6,372,0,0,9821.18679,9.010862000000998,330.2680698028302,0
"147.32.84.165",1923,"188.173.211.169",6667,9,552,6,372,3,180,9823.087431,1.0603250000003754,2806.686629098575,1358.074175370278
"147.32.84.165",1939,"205.188.159.42",25,6,372,6,372,0,0,9823.187626,9.015878999998677,330.08428795466716,0
"147.32.84.165",1940,"204.255.212.244",25,6,372,6,372,0,0,9823.187738,9.01589199999944,330.0838120066417,0
"147.32.84.165",1942,"217.72.192.149",25,6,372,6,372,0,0,9823.187823,9.015860999999859,330.08494696180946,0
"147.32.84.165",1943,"209.85.225.27",25,6,372,6,372,0,0,9824.147953,8.953953000000183,332.3671678866238,0
"147.32.84.165",1944,"98.139.54.60",25,6,372,6,372,0,0,9824.148016,8.954015000001164,332.36486648722536,0
"147.32.84.165",1945,"212.82.111.207",25,6,372,6,372,0,0,9824.148078,8.9540020000004,332.36534903609214,0
"147.32.84.165",1946,"64.12.139.193",25,6,372,6,372,0,0,9826.695587,9.010073999999804,330.29695427585443,0
"147.32.84.165",1948,"64.12.90.98",25,6,372,6,372,0,0,9827.594139,9.013053999999102,330.18774768245,0
"147.32.84.165",1949,"98.139.175.224",25,6,372,6,372,0,0,9831.499527,9.013222999999925,330.1815565863648,0
"147.32.84.165",1929,"212.117.174.7",4506,6,372,6,372,0,0,9832.701638,9.012587999999596,330.204820191507,0
"147.32.84.165",1930,"168.187.75.100",6667,4,248,4,248,0,0,9840.512892,3.0042130000001634,660.4059033097493,0
"147.32.84.165",1950,"209.85.225.27",25,6,372,6,372,0,0,9841.213671,9.01268600000003,330.20122968890627,0
"147.32.84.165",1951,"98.139.54.60",25,6,372,6,372,0,0,9842.214928,9.012975000001461,330.1906418246492,0
"147.32.84.165",1952,"209.85.143.27",25,6,372,6,372,0,0,9844.217815,9.013735000000452,330.16280154673404,0
"147.32.84.165",1954,"205.188.159.42",25,6,372,6,372,0,0,9844.217847,9.013762000000497,330.1618125705822,0
"147.32.84.165",1955,"65.55.37.88",25,6,372,6,372,0,0,9845.119321,9.012697000000117,330.200826678181,0
"147.32.84.165",1930,"212.117.174.7",4506,6,372,6,372,0,0,9847.723173,9.012821000000258,330.1962837162654,0
"147.32.84.165",1938,"77.222.41.36",25,6,372,6,372,0,0,9847.723349,9.012697000000117,330.200826678181,0
"147.32.84.165",1956,"98.139.175.224",25,6,372,6,372,0,0,9848.624248,9.012840999999753,330.19555099219895,0
"147.32.84.165",1939,"188.40.151.232",25,6,372,6,372,0,0,9848.624382,9.012810000000172,330.19668671590136,0
"147.32.84.165",1957,"74.6.136.65",25,6,372,6,372,0,0,9852.529838,8.913126999999804,333.8895541374049,0
"147.32.84.165",1940,"91.204.73.234",25,6,372,6,372,0,0,9853.731561,8.912694999999076,333.90573782680866,0
"147.32.84.165",1958,"209.85.225.27",25,6,372,6,372,0,0,9856.835937,8.91323100000045,333.8856582983039,0
"147.32.84.165",1942,"62.109.4.31",25,6,372,6,372,0,0,9856.836071,8.913187000000107,333.8873065268309,0
"147.32.84.165",1960,"205.188.146.193",25,6,372,6,372,0,0,9862.143672,9.013456999999107,330.1729846828242,0
"147.32.84.165",1943,"195.54.209.178",25,6,372,6,372,0,0,9863.145029,9.013038000000961,330.18833383368434,0
"147.32.84.165",1962,"65.54.188.110",25,6,372,6,372,0,0,9865.148597,9.012577999999849,330.20518657370286,0
"147.32.84.165",1950,"212.117.174.7",4506,6,372,6,372,0,0,9865.148662,9.01263900000049,330.20295165487465,0
"147.32.84.165",1951,"116.111.222.15",6667,6,372,6,372,0,0,9866.049892,9.01251499999853,330.20749480033993,0
"147.32.84.165",1944,"188.120.228.95",25,6,372,6,372,0,0,9868.652889,9.013074999998935,330.1869783620298,0
"147.32.84.165",1963,"98.139.54.60",25,6,372,6,372,0,0,9869.554186,9.013041000000158,330.18822393018604,0
"147.32.84.165",1945,"90.156.148.46",25,6,372,6,372,0,0,9873.460481,9.012832000000344,330.1958807176131,0
"147.32.84.165",1964,"98.139.175.224",25,6,372,6,372,0,0,9874.661904,9.012886999998955,330.1938657391738,0
"147.32.84.165",1948,"89.106.168.67",25,6,372,6,372,0,0,9877.765935,9.013162000001103,330.1837912155175,0
"147.32.84.165",1965,"205.188.103.1",25,6,372,6,372,0,0,9883.174026,9.012802999999622,330.19694317074556,0
"147.32.84.165",1958,"212.117.174.7",4506,6,372,6,372,0,0,9884.175602,9.012583000001541,330.20500338243664,0
"147.32.84.165",1949,"88.198.19.61",25,6,372,6,372,0,0,9884.175737,9.01253700000052,330.2066887492199,0
"147.32.84.165",1966,"209.85.225.27",25,6,372,6,372,0,0,9886.178246,9.013092000001052,330.1863555813757,0
"147.32.84.165",1930,"77.222.41.36",25,6,372,6,372,0,0,9886.17828,9.013182999999117,330.1830219136005,0
"147.32.84.165",1968,"205.188.159.42",25,6,372,6,372,0,0,9888.081046,9.012979000000996,330.1904952845969,0
"147.32.84.165",1960,"111.88.79.41",6667,4,248,4,248,0,0,9889.683379,3.0042909999992844,660.3887572809933,0
"147.32.84.165",1938,"188.40.151.232",25,6,372,6,372,0,0,9890.584412,9.01290599999993,330.19316966137484,0
"147.32.84.165",1969,"65.54.188.72",25,6,372,6,372,0,0,9894.489992,9.012962999999218,330.1910814457197,0
"147.32.84.165",1957,"80.92.1.204",25,6,372,6,372,0,0,9895.692069,9.309486999998626,319.6738982502945,0
"147.32.84.165",1970,"195.75.94.97",25,6,372,6,372,0,0,9898.796447,9.012806999999157,330.1967966251001,0
"147.32.84.165",1964,"212.117.174.7",4506,6,372,6,372,0,0,9904.204032,9.012886000000435,330.1939023748726,0
"147.32.84.165",1940,"91.204.73.234",25,6,372,6,372,0,0,9905.20582,9.012813000001188,330.19657680677585,0
"147.32.84.165",1971,"74.6.136.65",25,6,372,6,372,0,0,9907.208745,9.012969999999768,330.19082499998075,0
"147.32.84.165",1951,"62.109.4.31",25,6,372,6,372,0,0,9907.208812,9.012963999999556,330.19104481058025,0
"147.32.84.165",1972,"205.188.190.1",25,6,372,6,372,0,0,9909.111682,9.01279599999907,330.19719962598805,0
"147.32.84.165",1943,"195.54.209.178",25,6,372,6,372,0,0,9909.111822,9.012831999998525,330.19588071767976,0
"147.32.84.165",1973,"77.238.177.9",25,6,372,6,372,0,0,9911.614782,9.013369999998758,330.1761716206491,0
"147.32.84.165",1944,"188.120.228.95",25,6,372,6,372,0,0,9915.520114,9.013197999998738,330.182472414388,0
"147.32.84.165",1975,"209.85.225.27",25,6,372,6,372,0,0,9916.722564,9.012582999999722,330.2050033825033,0
"147.32.84.165",1945,"90.156.148.46",25,6,372,6,372,0,0,9919.826748,9.013334999999643,330.17745373938925,0
"147.32.84.165",1976,"64.12.90.1",25,6,372,6,372,0,0,9925.234727,8.912297000000763,333.92064918839054,0
"147.32.84.165",1970,"212.117.174.7",4506,6,372,6,372,0,0,9926.236192,8.912269000000379,333.92169827906605,0
"147.32.84.165",1948,"89.106.168.67",25,6,372,6,372,0,0,9928.239313,8.912898000000496,333.8981327958465,0
"147.32.84.165",1977,"98.137.54.238",25,6,372,6,372,0,0,9928.239378,8.912954999999783,333.8959974553975,0
"147.32.84.165",1965,"69.175.84.210",25,6,372,6,372,0,0,9930.141685,8.91273799999908,333.90412688001226,0
"147.32.84.165",1980,"98.139.54.60",25,6,372,6,372,0,0,9930.141842,8.912704999998823,333.9053631866412,0
"147.32.84.165",1971,"212.117.174.7",4506,6,372,6,372,0,0,9932.544712,9.013363999998546,330.1763914117393,0
"147.32.84.165",1949,"88.198.19.61",25,6,372,6,372,0,0,9932.544847,9.013354000000618,330.17675773078435,0
"147.32.84.165",1981,"209.85.225.27",25,6,372,6,372,0,0,9936.450582,9.013004000000365,330.1895794121338,0
"147.32.84.165",1930,"77.222.41.36",25,6,372,6,372,0,0,9936.450716,9.013004000000365,330.1895794121338,0
"147.32.84.165",1982,"209.85.143.27",25,6,372,6,372,0,0,9937.652998,9.012206999999762,330.21877992816616,0
"147.32.84.165",1966,"78.46.14.164",25,6,372,6,372,0,0,9940.756834,9.013178999999582,330.18316844701945,0
"147.32.84.165",1983,"205.188.190.1",25,6,372,6,372,0,0,9946.164529,9.013060999999652,330.1874912418894,0
"147.32.84.165",1968,"88.198.10.142",25,6,372,6,372,0,0,9947.165818,9.013692000000447,330.164376595057,0
"147.32.84.165",1984,"98.139.54.60",25,6,372,6,372,0,0,9949.16872,9.013694000001124,330.16430333663743,0
"147.32.84.165",1938,"188.40.151.232",25,6,372,6,372,0,0,9949.168782,9.013758999999482,330.1619224565657,0
"147.32.84.165",1985,"64.12.90.98",25,6,372,6,372,0,0,9949.168849,9.013742999999522,330.16250851617997,0
"147.32.84.165",1969,"80.92.1.204",25,6,372,6,372,0,0,9951.071557,9.012972000000445,330.1907517298237,0
"147.32.84.165",1986,"208.110.202.224",25,6,372,6,372,0,0,9951.071695,9.013059999999314,330.1875278762403,0
"147.32.84.165",1980,"212.117.174.7",4506,6,372,6,372,0,0,9953.574949,9.013680000000022,330.16481614612377,0
"147.32.84.165",1940,"91.204.73.234",25,6,372,6,372,0,0,9957.481112,9.012511000000814,330.20764135541486,0
"147.32.84.165",1987,"209.85.225.27",25,6,372,6,372,0,0,9958.682319,9.012998000000152,330.1897992210749,0
"147.32.84.165",1981,"212.117.174.7",4506,6,372,6,372,0,0,9961.787148,9.012609999999768,330.2040141535112,0
"147.32.84.165",1951,"195.54.209.178",25,6,372,6,372,0,0,9961.787281,9.01260099999854,330.20434389589445,0
"147.32.84.165",1988,"98.139.54.60",25,6,372,6,372,0,0,9967.194568,9.01288999999997,330.19375583192624,0
"147.32.84.165",1944,"188.120.228.95",25,6,372,6,372,0,0,9968.196746,9.012343000000328,330.2137967895687,0
"147.32.84.165",1989,"64.12.90.65",25,6,372,6,372,0,0,9970.199103,9.012775999999576,330.19793235737137,0
"147.32.84.165",1945,"90.156.148.46",25,6,372,6,372,0,0,9970.199168,9.012836000001698,330.1957341728441,0
"147.32.84.165",1990,"74.125.113.27",25,6,372,6,372,0,0,9972.101978,9.012570999999298,330.20544304175047,0
"147.32.84.165",1948,"89.106.168.67",25,6,372,6,372,0,0,9972.102117,9.012564999999086,330.20566287181305,0
"147.32.84.165",1992,"193.227.189.195",25,6,372,6,372,0,0,9974.605156,9.013549000001149,330.1696146545185,0
"147.32.84.165",1965,"69.175.84.210",25,6,372,6,372,0,0,9978.510871,9.013277000000016,330.1795784152639,0
"147.32.84.165",1986,"174.133.57.141",80,17,3489,12,1428,5,2061,9979.713005,4.0247290000006615,2838.451980244663,4096.67334123547
"147.32.84.165",1994,"216.32.181.178",25,6,372,6,372,0,0,9979.872876,8.952726000001348,332.41271987990604,0
"147.32.84.165",1966,"78.46.14.164",25,6,372,6,372,0,0,9982.817252,9.013437999999951,330.1736806754555,0
"147.32.84.165",1995,"205.188.59.194",25,6,372,6,372,0,0,9988.224824,9.013900999998441,330.1567212686843,0
"147.32.84.165",1983,"88.198.10.142",25,6,372,6,372,0,0,9989.226189,9.013145999999324,330.1843773528381,0
"147.32.84.165",1997,"205.188.190.1",25,6,372,6,372,0,0,9991.229633,8.912339999998949,333.919038097778,0
"147.32.84.165",1988,"212.117.174.7",4506,6,372,6,372,0,0,9991.229724,8.912372999999207,333.9178016898827,0
"147.32.84.165",1985,"80.92.1.204",25,6,372,6,372,0,0,9993.132131,8.912537000000157,333.91165725314215,0
"147.32.84.165",1998,"209.85.225.27",25,6,372,6,372,0,0,9993.132279,8.912513000001127,333.91255642484043,0
"147.32.84.165",1989,"212.117.174.7",4506,6,372,6,372,0,0,9995.63553,8.91270600000098,333.90532572258894,0
"147.32.84.165",1948,"174.133.57.141",80,16,3429,12,1428,4,2001,9995.635666,0.4967839999990247,22995.909691178516,32223.260008437122
"147.32.84.165",1999,"94.245.120.86",25,6,372,6,372,0,0,9995.800217,8.848156000000017,336.34126703914285,0
"147.32.84.165",1992,"117.204.65.177",6667,4,248,4,248,0,0,9999.541135,2.9040729999996984,683.1784187243936,0
"147.32.84.165",2000,"74.6.140.31",25,6,372,6,372,0,0,10000.742896,9.01328900000044,330.17913882489006,0
"147.32.84.165",2001,"209.85.143.27",25,6,372,6,372,0,0,10003.748079,9.012437999999747,330.2103160099502,0
"147.32.84.165",1994,"78.46.14.164",25,6,372,6,372,0,0,10009.155388,9.012754000001223,330.198738365609,0
"147.32.84.165",2002,"205.188.146.193",25,6,372,6,372,0,0,10010.156713,9.012542000000394,330.20650555635353,0
"147.32.84.165",1966,"83.149.23.163",25,6,372,6,372,0,0,10012.159648,9.01257699999951,330.2052232119805,0
"147.32.84.165",2003,"64.12.90.65",25,6,372,6,372,0,0,10012.159737,9.012612000000445,330.20394087750066,0
"147.32.84.165",1995,"88.198.10.142",25,6,372,6,372,0,0,10014.062482,9.013092000001052,330.1863555813757,0
"147.32.84.165",2005,"98.139.54.60",25,6,372,6,372,0,0,10014.062621,9.01313300000038,330.1848535908518,0
"147.32.84.165",2006,"209.85.225.27",25,6,372,6,372,0,0,10016.666496,9.012147999999797,330.2209417777057,0
"147.32.84.165",1999,"212.117.174.7",4506,6,372,6,372,0,0,10019.670131,9.013050999999905,330.18785758563126,0
"147.32.84.165",1989,"81.18.113.20",25,6,372,6,372,0,0,10021.773506,9.012593000001289,330.20463700064727,0
"147.32.84.165",2007,"74.6.136.65",25,6,372,6,372,0,0,10024.777779,9.012946999999258,330.191667608857,0
"147.32.84.165",2001,"212.117.174.7",4506,6,372,6,372,0,0,10030.1853,9.013288000000102,330.1791754573876,0
"147.32.84.165",2008,"71.74.56.243",25,6,372,6,372,0,0,10030.185434,9.013249999999971,330.1805674978514,0
"147.32.84.165",2009,"80.67.18.126",25,6,372,6,372,0,0,10031.186758,9.013436999999612,330.17371730674193,0
"147.32.84.165",2013,"98.137.54.238",25,6,372,6,372,0,0,10033.189764,9.012930999999298,330.1922537740755,0
"147.32.84.165",2014,"64.12.90.98",25,6,372,6,372,0,0,10033.189841,9.012978000000658,330.19053191961444,0
"147.32.84.165",1966,"83.149.23.163",25,6,372,6,372,0,0,10035.092557,9.013116000000082,330.1854763657733,0
"147.32.84.165",2015,"198.103.104.106",25,6,372,6,372,0,0,10035.092706,9.01309399999991,330.18628231326886,0
"147.32.84.165",2016,"209.85.143.27",25,6,372,6,372,0,0,10037.69599,9.012903999999253,330.1932429326049,0
"147.32.84.165",2006,"119.154.130.96",6667,4,248,4,248,0,0,10040.700361,3.0042000000012195,660.4087610675703,0
"147.32.84.165",2017,"209.85.225.27",25,6,372,6,372,0,0,10042.803265,9.013580999999249,330.16844248698135,0
"147.32.84.165",1989,"81.18.113.20",25,6,372,6,372,0,0,10045.807731,9.013309999998455,330.1783695446523,0
"147.32.84.165",2019,"212.60.50.101",25,6,372,6,372,0,0,10051.215543,9.012746999998853,330.19899482370676,0
"147.32.84.165",2020,"64.98.36.4",25,6,372,6,372,0,0,10052.217354,9.012547000000268,330.2063223636905,0
"147.32.84.165",2021,"205.188.190.1",25,6,372,6,372,0,0,10054.220052,9.012786999999662,330.1975293546948,0
"147.32.84.165",2023,"205.188.159.42",25,6,372,6,372,0,0,10054.220115,9.0128509999995,330.19518463138525,0
"147.32.84.165",2024,"98.139.54.60",25,6,372,6,372,0,0,10056.122796,9.01308600000084,330.1865753860246,0
"147.32.84.165",2025,"209.85.225.27",25,6,372,6,372,0,0,10056.122936,9.013079000000289,330.1868318251626,0
"147.32.84.165",2027,"98.139.175.225",25,6,372,6,372,0,0,10056.122995,9.013069000000542,330.18719816744124,0
"147.32.84.165",2013,"212.117.174.7",4506,6,372,6,372,0,0,10058.726362,9.013089000000036,330.18646548369685,0
"147.32.84.165",2009,"83.149.23.163",25,6,372,6,372,0,0,10061.129815,8.912909999999101,333.8976832482657,0
"147.32.84.165",2028,"205.188.190.1",25,6,372,6,372,0,0,10063.833697,8.912564000000202,333.91064569072745,0
"147.32.84.165",2030,"64.12.90.98",25,6,372,6,372,0,0,10063.833831,8.912554000000455,333.9110203427489,0
"147.32.84.165",2017,"212.117.174.7",4506,6,372,6,372,0,0,10066.838869,8.911878000000797,333.93634876955605,0
"147.32.84.165",2031,"216.82.242.147",25,6,372,6,372,0,0,10066.838933,8.91193899999962,333.93406305856973,0
"147.32.84.165",1989,"81.18.113.20",25,6,372,6,372,0,0,10072.145392,9.01333799999884,330.1773438431337,0
"147.32.84.165",2032,"98.139.54.60",25,6,372,6,372,0,0,10073.146859,9.01301599999897,330.1891397951962,0
"147.32.84.165",2033,"114.147.42.163",25,6,372,6,372,0,0,10073.146938,9.013064000000668,330.18738133888536,0
"147.32.84.165",2034,"208.65.144.13",25,6,372,6,372,0,0,10075.150102,9.012896000000183,330.19353601771724,0
"147.32.84.165",2035,"209.85.225.27",25,6,372,6,372,0,0,10075.150167,9.012956000000486,330.1913378917904,0
"147.32.84.165",2021,"212.117.171.138",65500,23,1407,16,972,7,435,10077.052451,2.995947999999771,2595.505662982333,1161.5688923840687
"147.32.84.165",2037,"74.6.136.65",25,6,372,6,372,0,0,10077.052592,9.012983000000531,330.19034874467474,0
"147.32.84.165",2039,"173.0.137.148",25,6,372,6,372,0,0,10077.075183,8.99051899999904,331.0153729723854,0
"147.32.84.165",2040,"64.12.139.193",25,6,372,6,372,0,0,10079.656284,9.013059999999314,330.1875278762403,0
"147.32.84.165",2019,"212.117.171.138",65500,22,1355,16,972,6,383,10082.059835,56.27467299999989,138.17939022053517,54.44722886261828
"147.32.84.165",2041,"205.188.146.193",25,6,372,6,372,0,0,10082.082312,8.990909000000102,331.0010144691673,0
"147.32.84.165",2009,"212.117.174.7",4506,6,372,6,372,0,0,10084.763685,9.0130079999999,330.18943287302454,0
"147.32.84.165",2027,"115.85.238.119",6667,9,552,6,372,3,180,10087.767907,2.256984999999986,1318.5732293302872,638.0193045146551
"147.32.84.165",2042,"65.55.92.184",25,6,372,6,372,0,0,10090.025165,8.959608000001026,332.1573890285891,0
"147.32.84.165",2045,"209.85.225.27",25,6,372,6,372,0,0,10093.175686,9.01296899999943,330.1908616350714,0
"147.32.84.165",2048,"213.96.113.92",25,6,372,6,372,0,0,10093.175884,9.012833000000683,330.19584408140867,0
"147.32.84.165",2049,"98.139.54.60",25,6,372,6,372,0,0,10094.177545,9.012665999998717,330.20196243824233,0
"147.32.84.165",2050,"64.12.90.98",25,6,372,6,372,0,0,10096.180241,9.012779999999111,330.19778581084785,0
"147.32.84.165",2052,"209.85.225.27",25,6,372,6,372,0,0,10096.180367,9.012778999998773,330.1978224474832,0
"147.32.84.165",2035,"173.192.170.88",80,67,8559,40,2846,27,5713,10098.082831,40.97145300000011,555.7039922406447,1115.5084004465225
"147.32.84.165",2034,"173.192.170.88",80,68,8597,40,2846,28,5751,10098.082969,40.970814000000246,555.7126592603179,1122.9457144785974
"147.32.84.165",2055,"203.147.156.193",25,6,372,6,372,0,0,10098.083033,9.012648999998419,330.20258527770494,0
"147.32.84.165",2037,"173.192.170.88",80,51,7482,32,2366,19,5116,10098.283856,71.96197100000063,263.0278150663749,568.7448444123305
"147.32.84.165",2039,"173.192.170.88",80,77,8948,46,3206,31,5742,10098.283923,92.98426199999994,275.83162406558665,494.01908464897025
"147.32.84.165",2056,"98.139.54.60",25,6,372,6,372,0,0,10098.28399,9.011984000000666,330.2269511352639,0
"147.32.84.165",2057,"205.188.59.194",25,6,372,6,372,0,0,10098.284058,9.012058000000252,330.2242395687996,0
"147.32.84.165",2058,"209.85.143.27",25,6,372,6,372,0,0,10100.686561,9.013576999999714,330.16858900746,0
"147.32.84.165",2059,"209.85.225.27",25,6,372,6,372,0,0,10103.090066,9.014782999998715,330.12441896831285,0
"147.32.84.165",2063,"204.232.236.148",25,6,372,6,372,0,0,10103.090213,9.014762000000701,330.1251879971727,0
"147.32.84.165",2065,"194.151.220.8",25,6,372,6,372,0,0,10105.793844,9.013301000000865,330.17869923568674,0
"147.32.84.165",2066,"98.139.54.60",25,6,372,6,372,0,0,10111.001526,9.013225000000602,330.1814833203211,0
"147.32.84.165",2067,"205.178.149.7",25,6,372,6,372,0,0,10111.001658,9.013236000000688,330.1810803577952,0
"147.32.84.165",2068,"205.188.146.193",25,6,372,6,372,0,0,10114.205956,9.013130999999703,330.1849268583912,0
"147.32.84.165",2069,"208.65.144.13",25,6,372,6,372,0,0,10115.207632,9.012695999999778,330.2008633154911,0
"147.32.84.165",2070,"209.85.143.27",25,6,372,6,372,0,0,10117.210491,9.012983000000531,330.19034874467474,0
"147.32.84.165",2072,"209.85.225.27",25,6,372,6,372,0,0,10117.210547,9.0130709999994,330.18712489896046,0
"147.32.84.165",2073,"74.6.136.65",25,6,372,6,372,0,0,10117.210606,9.013081999999486,330.18672192266416,0
"147.32.84.165",2075,"180.222.96.138",25,6,372,6,372,0,0,10117.210672,9.013085000000501,330.1866120201723,0
"147.32.84.165",2050,"212.117.174.7",4506,6,372,6,372,0,0,10119.112989,9.012947000001077,330.1916676087904,0
"147.32.84.165",2079,"98.139.54.60",25,6,372,6,372,0,0,10119.313302,9.013016999999309,330.1891031604876,0
"147.32.84.165",2056,"212.117.174.7",4506,6,372,6,372,0,0,10121.716754,9.013412000000244,330.17463309121115,0
"147.32.84.165",2055,"190.79.152.22",6667,6,372,6,372,0,0,10121.716889,9.013401000000158,330.17503603800026,0
"147.32.84.165",2081,"209.85.225.27",25,6,372,6,372,0,0,10124.120196,9.013006000001042,330.1895061425296,0
"147.32.84.165",2084,"81.19.232.134",25,6,372,6,372,0,0,10126.824071,9.013066000001345,330.1873080702567,0
"147.32.84.165",2085,"66.11.225.78",25,6,372,6,372,0,0,10132.031523,8.913125999999465,333.88959159785,0
"147.32.84.165",2086,"205.188.190.1",25,6,372,6,372,0,0,10135.236317,8.914230999998836,333.84820294654565,0
"147.32.84.165",2087,"209.85.225.27",25,6,372,6,372,0,0,10136.237891,8.912519999999859,333.9122941659651,0
"147.32.84.165",2088,"146.145.21.187",25,6,372,6,372,0,0,10136.237985,8.912555000000793,333.9109828774953,0
"147.32.84.165",2089,"98.139.54.60",25,6,372,6,372,0,0,10138.241021,8.916644999999335,333.7578203461304,0
"147.32.84.165",2090,"212.49.164.34",25,6,372,6,372,0,0,10138.241079,8.916712000000189,333.7553124963481,0
"147.32.84.165",2092,"205.188.146.193",25,6,372,6,372,0,0,10138.241139,8.916708000000654,333.755462217646,0
"147.32.84.165",2070,"173.192.170.88",80,19,2121,14,1564,5,557,10140.043227,76.85291499999948,162.80449479372493,57.98088465479845
"147.32.84.165",2019,"173.192.170.88",80,19,2121,14,1564,5,557,10140.043357,77.82907899999918,160.7625345277455,57.25366479025207
"147.32.84.165",2073,"212.117.171.138",65500,14,846,10,604,4,242,10140.043414,12.775933000000805,378.21112555926015,151.53492116778304
"147.32.84.165",2075,"173.192.170.88",80,19,2121,14,1564,5,557,10140.066713,77.09987100000035,162.2830211998661,57.795168036013706
"147.32.84.165",2093,"98.137.54.238",25,6,372,6,372,0,0,10140.066818,8.989145999999892,331.0659321808808,0
"147.32.84.165",2094,"64.12.90.65",25,6,372,6,372,0,0,10140.24336,9.015255000000252,330.1071350727092,0
"147.32.84.165",2050,"89.34.90.20",6667,6,372,6,372,0,0,10142.847054,9.012963999999556,330.19104481058025,0
"147.32.84.165",2079,"173.192.170.88",80,24,2427,18,1808,6,619,10145.050309,93.07164700000067,155.40715638136174,53.20632179207019
"147.32.84.165",2095,"209.85.225.27",25,6,372,6,372,0,0,10145.05044,9.012721999999485,330.1999107484032,0
"147.32.84.165",2097,"98.139.54.60",25,6,372,6,372,0,0,10147.75453,9.012915999999677,330.19280330584536,0
"147.32.84.165",2050,"212.117.174.7",4506,6,372,6,372,0,0,10152.962119,9.012709000000541,330.20038703122685,0
"147.32.84.165",2073,"78.129.227.128",5231,1396,597351,942,168352,454,428999,10156.168569,7058.475753000001,190.80833414035246,486.2228220506858
"147.32.84.165",2099,"209.85.143.27",25,6,372,6,372,0,0,10156.237449,8.942112999999154,332.8072458937034,0
"147.32.84.165",2086,"212.117.171.138",65500,14,846,10,604,4,242,10157.167742,1.214869000001272,3977.383569746977,1593.587456752928
"147.32.84.165",2100,"65.55.92.184",25,6,372,6,372,0,0,10157.190375,8.990297000000282,331.0235468305337,0
"147.32.84.165",2087,"212.117.171.138",65500,22,1338,16,972,6,366,10159.174555,4.7653080000000045,1631.7937896144367,614.4408713980287
"147.32.84.165",2101,"207.115.37.21",25,6,372,6,372,0,0,10159.174628,9.009127999999691,330.3316369797501,0
"147.32.84.165",2102,"205.188.59.194",25,6,372,6,372,0,0,10159.197017,8.986876999999367,331.1495194604543,0
"147.32.84.165",2086,"212.117.174.7",4506,6,372,6,372,0,0,10161.073329,9.015399999998408,330.10182576486073,0
"147.32.84.165",2103,"205.188.103.1",25,6,372,6,372,0,0,10161.073464,9.015389000000141,330.10222853389394,0
"147.32.84.165",2106,"209.85.225.27",25,6,372,6,372,0,0,10161.273578,9.01342399999885,330.1741935140719,0
"147.32.84.165",2107,"98.139.54.60",25,6,372,6,372,0,0,10161.273709,9.013356000001295,330.1766844668703,0
"147.32.84.165",2108,"208.89.132.34",25,6,372,6,372,0,0,10161.273768,9.013326000000234,330.17778342866137,0
"147.32.84.165",2109,"205.188.59.194",25,6,372,6,372,0,0,10163.877421,9.012904000001072,330.1932429325383,0
"147.32.84.165",2092,"212.117.171.138",65500,241,126265,160,11118,81,115147,10163.877554,270.4754009999997,328.8432133612036,3405.766278908303
"147.32.84.165",2110,"65.55.37.72",25,6,372,6,372,0,0,10163.877614,9.012844999999288,330.19540444778926,0
"147.32.84.165",2111,"209.85.225.27",25,6,372,6,372,0,0,10166.081234,9.012375000000247,330.2126243082338,0
"147.32.84.165",2113,"195.232.244.5",25,6,372,6,372,0,0,10168.78552,9.013310000000274,330.1783695445857,0
"147.32.84.165",2114,"64.12.90.98",25,6,372,6,372,0,0,10173.991985,9.013231999999334,330.1812268895575,0
"147.32.84.165",2116,"66.97.46.122",25,6,372,6,372,0,0,10177.196618,9.013622000000396,330.1669406593564,0
"147.32.84.165",2117,"64.12.90.65",25,6,372,6,372,0,0,10178.197939,9.013270999999804,330.17979821088977,0
"147.32.84.165",2118,"209.85.143.27",25,6,372,6,372,0,0,10180.201074,9.012638999998671,330.20295165494133,0
"147.32.84.165",2119,"98.139.54.60",25,6,372,6,372,0,0,10180.201149,9.012704999999187,330.20053358012586,0
"147.32.84.165",2120,"209.85.225.27",25,6,372,6,372,0,0,10182.105134,9.011543000000529,330.24311152927146,0
"147.32.84.165",2121,"207.109.18.206",25,6,372,6,372,0,0,10182.105206,9.011559000000489,330.24252518347146,0
"147.32.84.165",2122,"74.125.127.27",25,6,372,6,372,0,0,10182.304147,9.012913999999,330.19287657691285,0
"147.32.84.165",2102,"212.117.174.7",4506,6,372,6,372,0,0,10184.907586,9.013523000001442,330.17056704681664,0
"147.32.84.165",2123,"64.12.90.1",25,6,372,6,372,0,0,10187.111125,9.01285100000132,330.19518463131857,0
"147.32.84.165",2108,"212.117.174.7",4506,6,372,6,372,0,0,10189.814624,9.006196000000273,330.4391776505763,0
"147.32.84.165",2124,"205.188.103.1",25,6,372,6,372,0,0,10189.814711,9.006201999998666,330.4389575095518,0
"147.32.84.165",2110,"111.88.31.68",6667,4,248,4,248,0,0,10195.022798,3.00362800000039,660.5345269120352,0
"147.32.84.165",2113,"98.126.71.122",80,15,4787,12,1414,3,3373,10198.228707,13.991761999999653,808.4757302189875,1928.5633932310075
"147.32.84.165",2111,"98.126.71.122",80,15,4785,12,1412,3,3373,10198.404261,12.840492999999697,879.7170015201337,2101.476944849441
"147.32.84.165",2039,"98.126.71.122",80,15,4785,12,1412,3,3373,10198.404297,13.111638000000312,861.5247004226117,2058.018990457131
"147.32.84.165",2125,"74.6.136.65",25,6,372,6,372,0,0,10198.404327,8.846246999999494,336.41384872027317,0
"147.32.84.165",2116,"195.113.232.88",80,23,8123,16,4296,7,3827,10199.222231,12.998359999999593,2644.025861724177,2355.3740625741216
"147.32.84.165",2126,"209.85.225.27",25,6,372,6,372,0,0,10199.223077,8.930465999999797,333.2412888644409,0
"147.32.84.165",2117,"195.113.232.96",80,13,2896,10,1874,3,1022,10201.229401,10.991287999999258,1363.9893704906115,743.8618658705469
"147.32.84.165",2128,"98.139.175.224",25,6,372,6,372,0,0,10201.229525,8.930062999999791,333.2563275309558,0
"147.32.84.165",2129,"103.10.110.19",25,6,372,6,372,0,0,10201.230818,8.928894999999102,333.29992121088884,0
"147.32.84.165",2118,"195.113.232.99",80,54,40488,42,3418,12,37070,10203.036489,9.184294000000591,2977.256607856656,32289.907095742026
"147.32.84.165",2130,"98.139.54.60",25,6,372,6,372,0,0,10203.037439,9.028736000000208,329.61424500615936,0
"147.32.84.165",2120,"195.113.232.81",80,13,3237,10,1382,3,1855,10203.237057,8.983828000000358,1230.6557961705812,1651.8570925444487
"147.32.84.165",2131,"92.61.40.131",25,6,372,6,372,0,0,10203.237964,9.042590999999447,329.1092121716201,0
"147.32.84.165",2133,"209.85.225.27",25,6,372,6,372,0,0,10205.845206,9.03491799999938,329.3887116629287,0
"147.32.84.165",2134,"205.188.159.42",25,6,372,6,372,0,0,10205.845344,9.034902000001239,329.3892949806862,0
"147.32.84.165",2102,"174.133.57.141",80,17,3489,12,1428,5,2061,10208.053263,3.5598040000004403,3209.1654484344044,4631.715678727806
"147.32.84.165",2135,"98.139.175.224",25,6,372,6,372,0,0,10208.218321,8.968542000000525,331.8265109311888,0
"147.32.84.165",2136,"207.115.21.20",25,6,372,6,372,0,0,10208.218395,8.968595000000278,331.82454999918133,0
"147.32.84.165",2123,"67.195.168.31",25,6,372,6,372,0,0,10210.761709,9.033943000000363,329.4242613662584,0
"147.32.84.165",2137,"98.139.54.60",25,6,372,6,372,0,0,10212.881689,9.020472000000154,329.9162172445022,0
"147.32.84.165",2102,"98.126.71.122",80,18,4863,14,1430,4,3433,10212.881826,19.520054999999047,586.0639224633618,1406.963248822882
"147.32.84.165",2124,"212.117.174.7",4506,6,372,6,372,0,0,10213.056648,8.946138999999675,332.65747379960317,0
"147.32.84.165",2075,"173.192.170.88",80,16,1583,12,1086,4,497,10219.293747,84.69116799999938,102.58448673184037,46.94704411208532
"147.32.84.165",2111,"91.203.175.83",6667,4,248,4,248,0,0,10219.293852,3.010039999999208,659.1274534559415,0
"147.32.84.165",2120,"212.117.174.7",4506,6,372,6,372,0,0,10220.196597,9.029027999999016,329.6035852364534,0
"147.32.84.165",2070,"173.192.170.88",80,22,2307,16,1688,6,619,10220.196734,85.3103540000011,158.29262647298154,58.04688139026989
"147.32.84.165",2138,"205.188.190.1",25,6,372,6,372,0,0,10220.196801,9.028913000000102,329.607783351104,0
"147.32.84.165",2113,"195.113.232.88",80,17,5800,12,2556,5,3244,10222.203602,10.198534000001018,2004.9940511055763,2544.6794607928364
"147.32.84.165",2140,"67.195.168.31",25,6,372,6,372,0,0,10222.203702,9.028128999998444,329.63640639168017,0
"147.32.84.165",2141,"205.188.146.193",25,6,372,6,372,0,0,10222.203731,9.028226000000359,329.6328647510465,0
"147.32.84.165",2142,"209.85.225.27",25,6,372,6,372,0,0,10222.204439,9.027572000000873,329.65674491432605,0
"147.32.84.165",2143,"205.188.103.1",25,6,372,6,372,0,0,10224.108824,8.94271099999969,332.78499103908234,0
"147.32.84.165",2144,"208.69.48.6",25,6,372,6,372,0,0,10224.309564,8.942571999999927,332.7901637247119,0
"147.32.84.165",2145,"98.139.175.224",25,6,372,6,372,0,0,10226.918236,8.937224000001152,332.98930406126294,0
"147.32.84.165",2147,"216.40.42.4",25,6,372,6,372,0,0,10229.22575,8.93344900000011,333.13001507032317,0
"147.32.84.165",2149,"98.139.54.60",25,6,372,6,372,0,0,10231.834018,8.928611999999703,333.31048543716526,0
"147.32.84.165",2150,"205.188.159.42",25,6,372,6,372,0,0,10233.952749,9.013246000000436,330.18071402909186,0
"147.32.84.165",2123,"80.72.108.202",6667,6,372,6,372,0,0,10234.353222,9.013606000000436,330.16752673678616,0
"147.32.84.165",2124,"65.54.188.72",25,6,372,6,372,0,0,10241.16321,9.013004999998884,330.18954277739425,0
"147.32.84.165",2151,"205.188.190.1",25,6,372,6,372,0,0,10243.165943,9.013272000000143,330.17976157825404,0
"147.32.84.165",2152,"209.85.225.27",25,6,372,6,372,0,0,10243.166031,9.013307999999597,330.1784428092475,0
"147.32.84.165",2120,"212.117.174.7",4506,6,372,6,372,0,0,10245.068605,9.013263999999253,330.1800546395009,0
"147.32.84.165",2153,"209.183.5.10",25,6,372,6,372,0,0,10245.269103,9.01293699999951,330.19203396186634,0
"147.32.84.165",2141,"212.117.174.7",4506,6,372,6,372,0,0,10247.872791,9.01313300000038,330.1848535908518,0
"147.32.84.165",2154,"124.108.110.37",25,6,372,6,372,0,0,10247.872929,9.013136999999915,330.1847070559371,0
"147.32.84.165",2144,"173.192.170.88",80,16,2125,12,1596,4,529,10250.176312,11.616783999999825,1099.0993720809643,364.30048109701136
"147.32.84.165",2158,"98.139.54.60",25,6,372,6,372,0,0,10250.176344,9.013098999999784,330.1860991430441,0
"147.32.84.165",2160,"205.188.59.194",25,6,372,6,372,0,0,10250.176371,9.013238999999885,330.1809704591255,0
"147.32.84.165",2161,"209.85.143.27",25,6,372,6,372,0,0,10252.783291,9.009589999999662,330.31469800513804,0
"147.32.84.165",2163,"64.12.90.65",25,6,372,6,372,0,0,10254.982917,9.013178000001062,330.1832050803445,0
"147.32.84.165",2164,"66.94.237.64",25,6,372,6,372,0,0,10256.587587,9.011286000000837,330.25252999402346,0
"147.32.84.165",2165,"195.47.247.195",25,6,372,6,372,0,0,10262.193481,9.012925999999425,330.19243695112885,0
"147.32.84.165",2124,"173.192.170.88",80,18,2258,14,1730,4,528,10264.19629,11.863868000000366,1166.5672612001056,356.03902538361604
"147.32.84.165",2167,"205.188.159.42",25,6,372,6,372,0,0,10264.196424,9.012791000001016,330.1973828084624,0
"147.32.84.165",2168,"209.85.225.27",25,6,372,6,372,0,0,10264.196488,9.012786999999662,330.1975293546948,0
"147.32.84.165",2151,"212.52.133.252",6667,9,552,6,372,3,180,10266.098931,3.6166080000002694,822.8704908023701,398.1631407108243
"147.32.84.165",2169,"155.44.218.58",25,6,372,6,372,0,0,10266.299255,9.016756000000896,330.052182847102,0
"147.32.84.165",2170,"205.188.190.1",25,6,372,6,372,0,0,10268.904649,9.006810999999288,330.4166147152677,0
"147.32.84.165",2086,"68.67.185.214",80,16,2560,12,1528,4,1032,10269.715817,12.72623399999975,960.5355362788583,648.7386606281294
"147.32.84.165",2171,"98.139.54.60",25,6,372,6,372,0,0,10269.739892,8.974003000001176,331.6245826973325,0
"147.32.84.165",2151,"212.117.174.7",4506,6,372,6,372,0,0,10271.206545,9.013100000000122,330.1860625090102,0
"147.32.84.165",2154,"68.67.185.206",80,13,2606,10,1784,3,822,10273.811682,8.742427000001044,1632.4986185184384,752.1938701917917
"147.32.84.165",2172,"134.25.0.135",25,6,372,6,372,0,0,10273.840924,9.002269999999044,330.583286215623,0
"147.32.84.165",2161,"217.163.21.38",80,21,6763,14,1674,7,5089,10276.013233,0.18897000000106345,70868.39180782471,215441.60448627235
"147.32.84.165",2173,"213.158.72.46",25,6,372,6,372,0,0,10276.059705,8.986775999999736,331.1532411623576,0
"147.32.84.165",2124,"217.163.21.38",80,15,2440,10,1554,5,886,10277.610601,0.1404529999999795,88513.59529523623,50465.280200501475
"147.32.84.165",2179,"216.32.181.178",25,6,372,6,372,0,0,10277.656582,8.99217900000076,330.95426592372644,0
"147.32.84.165",2164,"173.192.170.88",80,6,372,6,372,0,0,10283.247334,8.909316999999646,334.0323394038082,0
"147.32.84.165",2184,"205.188.59.194",25,6,372,6,372,0,0,10283.247466,8.909320999999181,334.0321894339954,0
"147.32.84.165",2124,"173.192.170.88",80,18,2154,14,1626,4,528,10285.247075,9.113404000001537,1427.3481127356808,463.4931140986713
"147.32.84.165",2154,"212.117.174.7",4506,6,372,6,372,0,0,10285.247294,8.91283199999998,333.90060532948524,0
"147.32.84.165",2186,"209.85.225.27",25,6,372,6,372,0,0,10285.247411,8.912850999999137,333.89989353578204,0
"147.32.84.165",2187,"98.139.54.60",25,6,372,6,372,0,0,10285.247523,8.912804999999935,333.90161683106743,0
"147.32.84.165",2188,"65.54.188.110",25,6,372,6,372,0,0,10285.2476,8.912791999999172,333.9021038525612,0
"147.32.84.165",2190,"205.188.190.1",25,6,372,6,372,0,0,10285.24768,8.912773000000016,333.9028156556882,0
"147.32.84.165",2191,"77.238.184.241",25,6,372,6,372,0,0,10285.247754,8.912771999999677,333.90285311910907,0
"147.32.84.165",2192,"216.221.81.26",25,6,372,6,372,0,0,10287.354932,8.907788999998957,334.0896377316917,0
"147.32.84.165",2193,"64.12.90.98",25,6,372,6,372,0,0,10289.853441,9.012823000000935,330.19621044368574,0
"147.32.84.165",2194,"209.85.225.27",25,6,372,6,372,0,0,10290.65468,9.012823000000935,330.19621044368574,0
"147.32.84.165",2195,"98.139.54.60",25,6,372,6,372,0,0,10292.15686,9.01314900000034,330.184267451907,0
"147.32.84.165",2196,"64.12.139.193",25,6,372,6,372,0,0,10294.760662,9.013241999999082,330.18086056052897,0
"147.32.84.165",2197,"66.97.46.122",25,6,372,6,372,0,0,10296.963651,9.01287400000001,330.19434200455885,0
"147.32.84.165",2173,"173.192.170.88",80,29,9953,22,2500,7,7453,10298.566534,19.707777999999962,1014.8277497341425,3025.4044875074255
"147.32.84.165",2199,"209.85.143.27",25,6,372,6,372,0,0,10298.566668,9.012683000000834,330.2013396010627,0
"147.32.84.165",2075,"173.192.170.88",80,18,1707,14,1210,4,497,10304.173841,92.27625799999987,104.90238995170365,43.08800645123696
"147.32.84.165",2179,"41.223.57.75",6667,4,248,4,248,0,0,10304.173975,3.00470900000073,660.2968873190441,0
"147.32.84.165",2200,"218.102.23.150",25,6,372,6,372,0,0,10306.177022,9.01752900000065,330.0238901366201,0
"147.32.84.165",2201,"74.55.28.130",25,6,372,6,372,0,0,10306.177098,9.01751399999921,330.02443910819113,0
"147.32.84.165",2154,"174.36.246.56",80,28,14186,22,2080,6,12106,10308.279776,0.4148880000011559,40107.20965647028,233431.67312559095
"147.32.84.165",2202,"98.139.54.60",25,6,372,6,372,0,0,10308.400826,9.000660000001517,330.6424195558435,0
"147.32.84.165",2203,"130.149.17.20",25,6,372,6,372,0,0,10308.40089,9.00072199999886,330.6401419797631,0
"147.32.84.165",2192,"173.192.170.88",80,17,1643,12,1086,5,557,10310.879153,88.76484800000071,97.87658285631188,50.20005216479348
"147.32.84.165",2186,"195.113.232.97",80,7,426,6,364,1,62,10310.879291,0.0013530000014725374,0,0
"147.32.84.165",2205,"209.85.225.27",25,6,372,6,372,0,0,10310.880189,9.038405999999668,329.26159767553145,0
"147.32.84.165",2187,"195.113.232.97",80,65,53856,52,3542,13,50314,10310.880246,7.5068129999999655,3774.7043918637814,53619.55865958055
"147.32.84.165",2208,"205.188.59.194",25,6,372,6,372,0,0,10310.880303,9.038416999999754,329.2611969551837,0
"147.32.84.165",2186,"212.117.174.7",4506,6,372,6,372,0,0,10311.682555,9.03730700000051,329.30163819817477,0
"147.32.84.165",2188,"195.113.232.97",80,13,1547,10,1210,3,337,10313.187043,5.200216999999611,1861.4607813483021,518.4399035656015
"147.32.84.165",2209,"98.139.175.224",25,6,372,6,372,0,0,10313.187182,9.034797000000253,329.3931230552182,0
"147.32.84.165",2190,"74.125.232.207",80,13,1556,10,1246,3,310,10315.796598,2.5908609999987675,3847.3696581965382,957.2107496315625
"147.32.84.165",2210,"209.85.225.27",25,6,372,6,372,0,0,10315.804724,9.020986999999877,329.8973826256529,0
"147.32.84.165",2196,"174.36.246.56",80,22,8102,16,2142,6,5960,10318.003778,0.353928000000451,48416.62711053707,134716.66553632164
"147.32.84.165",2211,"98.139.54.60",25,6,372,6,372,0,0,10318.126496,9.002591999998913,330.57146208562597,0
"147.32.84.165",2212,"64.12.90.1",25,6,372,6,372,0,0,10319.618388,9.01271799999995,330.2000572968129,0
"147.32.84.165",2213,"209.86.93.228",25,6,372,6,372,0,0,10320.719726,9.01306300000033,330.1874179732119,0
"147.32.84.165",2197,"212.117.174.7",4506,6,372,6,372,0,0,10327.229571,9.012511000000814,330.20764135541486,0
"147.32.84.165",2190,"79.132.91.208",6667,4,248,4,248,0,0,10327.229722,3.0039340000002994,660.4672406250611,0
"147.32.84.165",2214,"205.188.190.1",25,6,372,6,372,0,0,10327.229803,9.012408999999025,330.2113785559801,0
"147.32.84.165",2215,"68.178.227.144",25,6,372,6,372,0,0,10329.432394,9.013148000000001,330.1843040855425,0
"147.32.84.165",2217,"209.85.225.27",25,6,372,6,372,0,0,10331.936512,9.012951999999132,330.1914844326572,0
"147.32.84.165",2218,"209.85.143.27",25,6,372,6,372,0,0,10331.936609,9.012995999999475,330.1898724908092,0
"147.32.84.165",2219,"205.188.159.42",25,6,372,6,372,0,0,10332.737054,9.013327000000572,330.1777467964727,0
"147.32.84.165",2221,"98.139.54.60",25,6,372,6,372,0,0,10334.239153,9.01297599999998,330.19060518967393,0
"147.32.84.165",2222,"209.85.143.27",25,6,372,6,372,0,0,10334.239284,9.012972000000445,330.1907517298237,0
"147.32.84.165",2223,"195.113.180.18",25,6,372,6,372,0,0,10334.239339,9.012974000001122,330.19067845969926,0
"147.32.84.165",2224,"209.85.225.27",25,6,372,6,372,0,0,10336.842913,8.9128639999999,333.899406520736,0
"147.32.84.165",2225,"205.178.149.7",25,6,372,6,372,0,0,10339.146477,8.91268399999899,333.90614993197755,0
"147.32.84.165",2211,"217.72.192.149",25,6,372,6,372,0,0,10340.648536,8.916289999999208,333.77110883565524,0
"147.32.84.165",2212,"173.192.170.88",80,26,2555,20,1936,6,619,10341.750469,82.23104199999943,188.3473640039744,60.22056731325421
"147.32.84.165",2226,"64.12.90.98",25,6,372,6,372,0,0,10341.750524,8.912554000000455,333.9110203427489,0
"147.32.84.165",2227,"218.71.143.68",25,6,372,6,372,0,0,10343.552514,9.013365999999223,330.17631814798784,0
"147.32.84.165",2228,"114.108.154.169",25,6,372,6,372,0,0,10348.15927,9.013363000000027,330.1764280435606,0
"147.32.84.165",2229,"209.85.143.27",25,6,372,6,372,0,0,10350.36257,9.016131000000314,330.07506213029694,0
"147.32.84.165",2231,"209.85.225.27",25,6,372,6,372,0,0,10350.362703,9.016120999998748,330.07542822466706,0
"147.32.84.165",2232,"64.12.90.98",25,6,372,6,372,0,0,10350.362758,9.01611899999989,330.07550144358527,0
"147.32.84.165",2233,"209.183.189.27",25,6,372,6,372,0,0,10350.362819,9.01611000000048,330.0758309292856,0
"147.32.84.165",2215,"93.180.230.38",6667,6,372,6,372,0,0,10352.866056,9.012805999998818,330.1968332615159,0
"147.32.84.165",2234,"64.98.36.4",25,6,372,6,372,0,0,10353.667442,9.012568000000101,330.20555295671187,0
"147.32.84.165",2217,"212.117.174.7",4506,6,372,6,372,0,0,10355.269475,9.013080000000627,330.1867951909661,0
"147.32.84.165",2236,"205.188.190.1",25,6,372,6,372,0,0,10357.773307,9.012862000001405,330.1947816353491,0
"147.32.84.165",2222,"212.117.174.7",4506,6,372,6,372,0,0,10360.076404,9.012910000001284,330.1930231190122,0
"147.32.84.165",2237,"66.94.237.64",25,6,372,6,372,0,0,10360.076505,9.012933999998495,330.1921438679676,0
"147.32.84.165",2238,"93.17.128.86",25,6,372,6,372,0,0,10361.578605,9.013241999999082,330.18086056052897,0
"147.32.84.165",2239,"209.85.225.27",25,6,372,6,372,0,0,10362.680145,9.01301500000045,330.1891764298463,0
"147.32.84.165",2240,"64.12.139.193",25,6,372,6,372,0,0,10364.583082,9.012807000000976,330.19679662503347,0
"147.32.84.165",2227,"67.195.168.31",25,6,372,6,372,0,0,10369.1895,9.008191999999326,330.3659602282259,0
"147.32.84.165",2228,"173.192.170.88",80,18,2154,14,1626,4,528,10371.39267,12.667731000001368,1026.861085067136,333.4456659996604
"147.32.84.165",2241,"205.188.159.42",25,6,372,6,372,0,0,10371.392803,9.011930999999095,330.2288932305739,0
"147.32.84.165",2231,"95.155.98.55",6667,9,552,6,372,3,180,10374.196627,1.0426299999999173,2854.32032456407,1381.1227376922918
"147.32.84.165",2233,"173.192.170.88",80,16,2029,12,1500,4,529,10374.697838,9.158417999999074,1310.2699614716444,462.08853974566654
"147.32.84.165",2242,"74.125.47.27",25,6,372,6,372,0,0,10374.697871,9.01718400000027,330.036516943639,0
"147.32.84.165",2244,"77.238.184.241",25,6,372,6,372,0,0,10375.239491,8.977593999999954,331.49193425321033,0
"147.32.84.165",2231,"174.36.246.56",80,28,14462,22,2080,6,12382,10376.299784,0.40572900000006484,41012.59707833884,244143.25818461133
"147.32.84.165",2234,"68.67.185.215",80,21,4304,16,2368,5,1936,10376.420816,13.985201999999845,1354.574642540037,1107.4562955901654
"147.32.84.165",2245,"209.85.143.27",25,6,372,6,372,0,0,10376.445487,8.97523099999853,331.579209493381,0
"147.32.84.165",2231,"68.67.185.217",80,16,2508,12,1424,4,1084,10378.799358,11.925917000000481,955.2305286041769,727.1558237408201
"147.32.84.165",2217,"68.67.185.208",80,21,4890,16,3308,5,1582,10378.828965,11.577159999998912,2285.880129496568,1093.1869301280442
"147.32.84.165",2247,"209.85.225.27",25,6,372,6,372,0,0,10378.852974,8.975562999999966,331.5669446028078,0
"147.32.84.165",2248,"205.188.103.1",25,6,372,6,372,0,0,10378.853041,8.975625999999465,331.564617331446,0
"147.32.84.165",2236,"68.67.185.218",80,16,2784,12,1900,4,884,10381.106612,12.287851000000956,1236.9941660261684,575.5278119827015
"147.32.84.165",2249,"205.188.159.42",25,6,372,6,372,0,0,10381.130426,9.004809000000023,330.4900748033626,0
"147.32.84.165",2250,"192.118.80.172",25,6,372,6,372,0,0,10381.130491,9.004870000000665,330.48783602648126,0
"147.32.84.165",2237,"212.117.174.7",4506,6,372,6,372,0,0,10382.612263,9.028202999999849,329.63370451462487,0
"147.32.84.165",2222,"217.163.21.36",80,21,6671,14,1570,7,5101,10383.715191,0.18706200000087847,67143.51391485719,218152.2703692271
"147.32.84.165",2251,"207.69.189.217",25,6,372,6,372,0,0,10383.761101,8.982518999999229,331.3101814758483,0
"147.32.84.165",2233,"217.163.21.36",80,15,2026,10,1242,5,784,10385.62164,0.149344999999812,66530.51658918952,41996.7190063805
"147.32.84.165",2252,"209.85.143.27",25,6,372,6,372,0,0,10385.667738,8.898040000000037,334.45567787962153,0
"147.32.84.165",2239,"195.113.232.88",80,13,1768,10,1224,3,544,10385.667802,7.726539999999659,1267.3201717716381,563.2534096762836
"147.32.84.165",2253,"209.85.143.27",25,6,372,6,372,0,0,10385.668609,8.897231999999349,334.4860513921878,0
"147.32.84.165",2254,"67.223.35.251",25,6,372,6,372,0,0,10385.668674,8.897193999999217,334.48747998529217,0
"147.32.84.165",2240,"212.117.174.7",4506,6,372,6,372,0,0,10390.236052,8.936157000000094,333.0290638358266,0
"147.32.84.165",2255,"205.188.59.194",25,6,372,6,372,0,0,10390.236187,8.936075999999957,333.03208253824323,0
"147.32.84.165",2227,"65.54.188.72",25,6,372,6,372,0,0,10392.442707,8.932742999999391,333.1563440255925,0
"147.32.84.165",2256,"209.85.225.27",25,6,372,6,372,0,0,10395.666867,9.008614000000307,330.3504845473342,0
"147.32.84.165",2257,"64.12.90.65",25,6,372,6,372,0,0,10396.168009,9.00856499999827,330.3522814122528,0
"147.32.84.165",2242,"173.192.170.88",80,20,3517,14,1206,6,2311,10397.369358,48.246196000000054,199.97431507346172,383.20119579997515
"147.32.84.165",2259,"74.6.140.30",25,6,372,6,372,0,0,10397.369492,9.011324000000968,330.25113734670737,0
"147.32.84.165",2075,"173.192.170.88",80,16,2131,12,1602,4,529,10399.772899,11.449284000000262,1119.371307410988,369.63010088664964
"147.32.84.165",2260,"208.84.65.76",25,6,372,6,372,0,0,10399.773032,9.01606300000094,330.0775515876153,0
"147.32.84.165",2247,"174.36.246.56",80,18,6535,14,1702,4,4833,10402.076176,0.46892899999875226,29036.37864162001,82451.71443886575
"147.32.84.165",2261,"76.162.254.116",25,6,372,6,372,0,0,10402.196982,9.000551000000996,330.6464237577978,0
"147.32.84.165",2249,"195.113.232.82",80,7,426,6,364,1,62,10403.571734,0.0010150000016437843,0,0
"147.32.84.165",2262,"74.125.127.27",25,6,372,6,372,0,0,10403.572597,9.030000999999174,329.5680698153048,0
"147.32.84.165",2250,"195.113.232.82",80,57,43757,48,3302,9,40455,10404.675617,12.984118999998827,2034.4853586140412,24925.834398162035
"147.32.84.165",2263,"205.188.159.42",25,6,372,6,372,0,0,10404.676444,9.029574999998658,329.5836182766567,0
"147.32.84.165",2247,"69.16.175.10",80,13,1940,10,1244,3,696,10406.581303,11.078628999999637,898.3060990669808,502.58926442975775
"147.32.84.165",2264,"207.115.37.21",25,6,372,6,372,0,0,10406.598118,9.013563000000431,330.16910183019274,0
"147.32.84.165",2252,"68.67.179.209",80,18,4310,14,2440,4,1870,10411.197681,6.462437000000136,3020.5323471624697,2314.9161840958272
"147.32.84.165",2254,"174.36.246.56",80,29,15019,22,2230,7,12789,10411.221856,0.4774059999999736,37368.61287876773,214308.15699845762
"147.32.84.165",2265,"209.85.225.27",25,6,372,6,372,0,0,10411.342812,8.984393999999156,331.2410386276781,0
"147.32.84.165",2075,"68.67.185.206",80,18,4896,14,3374,4,1522,10411.342875,6.3166349999992235,4273.161263869658,1927.608608064499
"147.32.84.165",2266,"180.222.96.138",25,6,372,6,372,0,0,10411.366666,8.960675000000265,332.1178371048958,0
"147.32.84.165",2240,"217.163.21.36",80,19,6631,12,1544,7,5087,10413.405057,0.18766400000095018,65819.762980313,216855.65691765043
"147.32.84.165",2254,"68.67.185.218",80,16,2444,12,1416,4,1028,10413.450906,11.354432000000088,997.6720984369726,724.2986703341863
"147.32.84.165",2267,"205.188.103.1",25,6,372,6,372,0,0,10413.474716,8.959267999998701,332.1699942451137,0
"147.32.84.165",2240,"217.163.21.34",80,21,6773,14,1672,7,5101,10416.715414,0.18780299999889394,71223.5693789704,217291.52356586602
"147.32.84.165",2227,"68.67.185.206",80,16,3121,12,1874,4,1247,10416.761366,11.395324999999502,1315.6272418733695,875.4467292508494
"147.32.84.165",2268,"205.188.146.193",25,6,372,6,372,0,0,10416.761405,8.983188000000155,331.28550799559673,0
"147.32.84.165",2256,"217.163.21.37",80,21,6649,14,1562,7,5087,10417.216959,0.18692100000043865,66851.77160388975,217717.6454218868
"147.32.84.165",2270,"98.139.175.224",25,6,372,6,372,0,0,10417.262892,8.983170999999857,331.2861349294194,0
"147.32.84.165",2257,"217.163.21.38",80,15,2320,10,1438,5,882,10418.421034,0.14097599999877275,81602.54227740996,50051.07252341835
"147.32.84.165",2271,"209.85.225.27",25,6,372,6,372,0,0,10418.466935,8.8837769999991,334.99265008569006,0
"147.32.84.165",2250,"212.117.174.7",4506,6,372,6,372,0,0,10420.828976,8.939034999999421,332.9218422346699,0
"147.32.84.165",2247,"77.238.167.32",80,13,2599,10,1552,3,1047,10423.236652,0.14063900000110152,88282.76651499765,59556.73746211504
"147.32.84.165",2273,"205.188.146.193",25,6,372,6,372,0,0,10423.282579,8.989423999999417,331.055693890976,0
"147.32.84.165",2259,"212.117.171.138",65500,14,846,10,604,4,242,10423.28264,111.36532199999965,43.388731009101875,17.384226662587174
"147.32.84.165",2274,"65.55.88.22",25,6,372,6,372,0,0,10423.282702,8.989424999999756,331.05565706372556,0
"147.32.84.165",2247,"64.12.168.40",587,70,26786,46,24464,24,2322,10424.640878,9.594482000000426,20398.39149210883,1936.1128615384525
"147.32.84.165",2261,"217.163.21.39",80,17,3494,12,1650,5,1844,10424.7592,0.23802799999975832,55455.66067863194,61975.90199478624
"147.32.84.165",2276,"205.188.190.1",25,6,372,6,372,0,0,10424.805173,8.868786999999429,335.5588537643526,0
"147.32.84.165",2261,"217.219.211.243",6667,6,372,6,372,0,0,10425.744742,8.930413999998564,333.2432292613174,0
"147.32.84.165",2254,"195.113.232.88",80,33,20577,26,2196,7,18381,10427.551199,0.6056860000007873,29005.128069622155,242779.26186144116
"147.32.84.165",2277,"74.6.136.65",25,6,372,6,372,0,0,10427.552037,9.025700000000143,329.72511827336973,0
"147.32.84.165",2264,"212.117.174.7",4506,6,372,6,372,0,0,10432.272193,9.012455999998565,330.20965650212037,0
"147.32.84.165",2278,"66.94.236.34",25,6,372,6,372,0,0,10432.272255,9.012446000000637,330.2100228949821,0
"147.32.84.165",2092,"173.192.170.88",80,11,1283,8,846,3,437,10434.374704,11.242340000000695,602.0099018531357,310.96728972792
"147.32.84.165",2279,"209.85.225.27",25,6,372,6,372,0,0,10434.374836,9.01288299999942,330.1940122822178,0
"147.32.84.165",2280,"66.94.237.64",25,6,372,6,372,0,0,10434.374893,9.012950000000274,330.19155770307276,0
"147.32.84.165",2281,"204.50.132.187",25,6,372,6,372,0,0,10437.679604,9.012774999999237,330.19796899403923,0
"147.32.84.165",2283,"205.188.59.194",25,6,372,6,372,0,0,10438.280286,9.01317200000085,330.18342488079884,0
"147.32.84.165",2284,"209.85.225.27",25,6,372,6,372,0,0,10439.382376,9.012469999999666,330.2091435533333,0
"147.32.84.165",2285,"209.85.143.27",25,6,372,6,372,0,0,10441.785332,9.013565000001108,330.16902856967624,0
"147.32.84.165",2287,"207.253.141.229",25,6,372,6,372,0,0,10444.288928,9.013026000000536,330.18877344854246,0
"147.32.84.165",2288,"205.188.146.193",25,6,372,6,372,0,0,10445.691041,9.012742999999318,330.1991413713034,0
"147.32.84.165",2242,"212.117.174.7",4506,6,372,6,372,0,0,10448.094352,9.012950000000274,330.19155770307276,0
"147.32.84.165",2274,"175.100.132.163",6667,4,248,4,248,0,0,10448.595066,3.0046519999996235,660.3094135361595,0
"147.32.84.165",2289,"64.12.90.65",25,6,372,6,372,0,0,10453.302096,9.01296100000036,330.19115471595643,0
"147.32.84.165",2290,"98.139.54.60",25,6,372,6,372,0,0,10455.405064,9.012710999999399,330.20031375689274,0
"147.32.84.165",2279,"212.117.174.7",4506,6,372,6,372,0,0,10458.709722,9.012880000000223,330.19412218956944,0
"147.32.84.165",2291,"64.141.104.250",25,6,372,6,372,0,0,10458.70986,9.01286699999946,330.1945984557609,0
"147.32.84.165",2292,"209.85.225.27",25,6,372,6,372,0,0,10459.31057,9.012962000000698,330.19111808080066,0
"147.32.84.165",2293,"216.150.16.17",25,6,372,6,372,0,0,10459.310723,9.012864000000263,330.1947083635028,0
"147.32.84.165",2274,"174.133.57.141",80,17,3489,12,1428,5,2061,10460.41218,4.891589000000749,2335.4374212547805,3370.683841180744
"147.32.84.165",2294,"193.160.157.181",25,6,372,6,372,0,0,10460.567603,8.957680000001346,332.2288806922722,0
"147.32.84.165",2295,"217.72.192.149",25,6,372,6,372,0,0,10462.815501,9.01307700000143,330.1869050935133,0
"147.32.84.165",2298,"205.188.59.194",25,6,372,6,372,0,0,10465.319523,9.012482000000091,330.2087038842319,0
"147.32.84.165",2299,"168.95.6.68",25,6,372,6,372,0,0,10466.721304,9.01307799999995,330.1868684593672,0
"147.32.84.165",2300,"209.85.225.27",25,6,372,6,372,0,0,10469.125007,9.013687999999092,330.1645231119936,0
"147.32.84.165",2301,"98.139.54.60",25,6,372,6,372,0,0,10469.125152,9.013664999998582,330.1653655866363,0
"147.32.84.165",2302,"205.188.103.1",25,6,372,6,372,0,0,10469.12521,9.013662999999724,330.16543884546064,0
"147.32.84.165",2303,"77.238.184.241",25,6,372,6,372,0,0,10474.332176,9.013340999999855,330.1772339468847,0
"147.32.84.165",2304,"64.12.90.1",25,6,372,6,372,0,0,10476.435104,9.012998000000152,330.1897992210749,0
"147.32.84.165",2305,"216.32.180.22",25,6,372,6,372,0,0,10479.739781,9.013386999999057,330.1755488808271,0
"147.32.84.165",2306,"207.115.21.20",25,6,372,6,372,0,0,10480.341177,9.013004000000365,330.1895794121338,0
"147.32.84.165",2307,"209.85.225.27",25,6,372,6,372,0,0,10481.542443,9.0130079999999,330.18943287302454,0
"147.32.84.165",2308,"64.12.139.193",25,6,372,6,372,0,0,10481.542577,9.013004000000365,330.1895794121338,0
"147.32.84.165",2309,"98.139.54.60",25,6,372,6,372,0,0,10483.845675,8.912974999999278,333.89524821961703,0
"147.32.84.165",2295,"212.117.174.7",4506,6,372,6,372,0,0,10486.34945,8.91287899999952,333.8988445821109,0
"147.32.84.165",2310,"65.55.88.22",25,6,372,6,372,0,0,10487.751328,8.913151999999172,333.88861762935,0
"147.32.84.165",2298,"208.81.160.62",6667,4,248,4,248,0,0,10490.154881,2.904410999999527,683.0989140312176,0
"147.32.84.165",2314,"96.11.120.21",25,6,372,6,372,0,0,10490.155022,8.912765999999465,333.90307789974275,0
"147.32.84.165",2302,"212.117.174.7",4506,6,372,6,372,0,0,10495.262478,9.012935999999172,330.1920705972253,0
"147.32.84.165",2315,"205.188.146.193",25,6,372,6,372,0,0,10495.262542,9.012932999999975,330.19218050328436,0
"147.32.84.165",2316,"209.85.143.27",25,6,372,6,372,0,0,10497.365353,9.01292900000044,330.19232704483244,0
"147.32.84.165",2317,"205.188.103.1",25,6,372,6,372,0,0,10500.670033,9.01286699999946,330.1945984557609,0
"147.32.84.165",2318,"209.85.225.27",25,6,372,6,372,0,0,10501.270829,9.01502900000014,330.11541061043215,0
"147.32.84.165",2320,"98.139.54.60",25,6,372,6,372,0,0,10502.572715,9.012892000000647,330.1936825604685,0
"147.32.84.165",2321,"64.12.90.97",25,6,372,6,372,0,0,10502.572856,9.01287499999853,330.1943053687625,0
"147.32.84.165",2322,"64.12.90.1",25,6,372,6,372,0,0,10504.776044,9.01312599999983,330.1851100273153,0
"147.32.84.165",2323,"209.85.143.27",25,6,372,6,372,0,0,10507.280177,9.012181999998575,330.2196959626948,0
"147.32.84.165",2325,"144.92.197.138",25,6,372,6,372,0,0,10507.28031,9.012173999999504,330.21998909476935,0
"147.32.84.165",2309,"190.79.152.22",6667,6,372,6,372,0,0,10508.682038,9.012624999999389,330.2034645844248,0
"147.32.84.165",2326,"209.85.225.27",25,6,372,6,372,0,0,10509.983349,9.013581999999587,330.1684058568654,0
"147.32.84.165",2327,"205.188.59.194",25,6,372,6,372,0,0,10509.983481,9.013575000000856,330.1686622677148,0
"147.32.84.165",2328,"98.139.54.60",25,6,372,6,372,0,0,10511.084924,9.013197000000218,330.1825090475586,0
"147.32.84.165",2329,"64.12.90.65",25,6,372,6,372,0,0,10516.292553,9.013004000000365,330.1895794121338,0
"147.32.84.165",2315,"212.117.174.7",4506,6,372,6,372,0,0,10518.395664,9.012713000000076,330.2002404825245,0
"147.32.84.165",2330,"209.85.143.27",25,6,372,6,372,0,0,10521.700762,9.0159079999994,330.08322622637655,0
"147.32.84.165",2332,"209.85.225.27",25,6,372,6,372,0,0,10522.301386,9.01327400000082,330.1796883130069,0
"147.32.84.165",2333,"207.69.189.218",25,6,372,6,372,0,0,10523.605321,9.011208000001716,330.255388622639,0
"147.32.84.165",2334,"64.12.90.1",25,6,372,6,372,0,0,10525.806129,9.013458999999784,330.1729114205846,0
"147.32.84.165",2320,"212.117.174.7",4506,6,372,6,372,0,0,10528.30991,9.012679999999818,330.20144951335897,0
"147.32.84.165",2336,"64.12.90.65",25,6,372,6,372,0,0,10528.310043,9.012672000000748,330.20174261304004,0
"147.32.84.165",2337,"209.85.225.27",25,6,372,6,372,0,0,10528.310098,9.012666000000536,330.20196243817566,0
"147.32.84.165",2338,"209.85.225.27",25,6,372,6,372,0,0,10528.310151,9.01266299999952,330.20207235088657,0
"147.32.84.165",2339,"209.85.225.27",25,6,372,6,372,0,0,10528.31021,9.012652000001253,330.20247536458595,0
"147.32.84.165",2340,"65.55.88.22",25,6,372,6,372,0,0,10528.310265,9.0126479999999,330.2026219153387,0
"147.32.84.165",2341,"205.188.159.42",25,6,372,6,372,0,0,10531.013953,9.012870000000476,330.19448854802556,0
"147.32.84.165",2342,"198.94.221.66",25,6,372,6,372,0,0,10531.014098,9.012849000000642,330.19525790344295,0
"147.32.84.165",2344,"209.85.225.27",25,6,372,6,372,0,0,10532.11525,9.013073000000077,330.1870516304455,0
"147.32.84.165",2345,"209.85.143.27",25,6,372,6,372,0,0,10532.115381,9.013076999999612,330.1869050935799,0
"147.32.84.165",2346,"98.139.54.60",25,6,372,6,372,0,0,10532.11544,9.013071000001219,330.1871248988938,0
"147.32.84.165",2328,"212.117.171.138",65500,14,846,10,604,4,242,10537.322974,104.98928999999953,46.02374204073598,18.439976115659118
"147.32.84.165",2347,"74.208.5.21",25,6,372,6,372,0,0,10537.345588,8.990182999999888,331.0277443740619,0
"147.32.84.165",2329,"117.204.73.9",6667,6,372,6,372,0,0,10539.42732,9.011505999998917,330.2444674619711,0
"147.32.84.165",2350,"64.12.90.1",25,6,372,6,372,0,0,10542.730538,9.012808999999834,330.1967233522928,0
"147.32.84.165",2351,"209.85.225.27",25,6,372,6,372,0,0,10542.730669,9.012800999998944,330.1970164436504,0
"147.32.84.165",2352,"98.139.175.224",25,6,372,6,372,0,0,10542.730732,9.012806000000637,330.1968332614493,0
"147.32.84.165",2353,"98.139.54.60",25,6,372,6,372,0,0,10543.331212,9.013114000001224,330.18554963352244,0
"147.32.84.165",2354,"64.136.44.37",25,6,372,6,372,0,0,10543.331347,9.013028000001214,330.18870017929595,0
"147.32.84.165",2355,"64.12.139.193",25,6,372,6,372,0,0,10544.633171,9.012939000000188,330.19196069117277,0
"147.32.84.165",2356,"205.188.146.193",25,6,372,6,372,0,0,10546.836662,9.013118000000759,330.18540309799,0
"147.32.84.165",2357,"209.85.143.27",25,6,372,6,372,0,0,10549.340666,9.012654000000111,330.202402089325,0
"147.32.84.165",2336,"212.117.174.7",4506,6,372,6,372,0,0,10552.043952,8.912689000000682,333.9059626112582,0
"147.32.84.165",2359,"209.85.225.27",25,6,372,6,372,0,0,10552.044098,8.912632999999914,333.90806061463866,0
"147.32.84.165",2360,"98.139.175.224",25,6,372,6,372,0,0,10553.145415,8.912912999998298,333.8975708615767,0
"147.32.84.165",2362,"216.82.249.99",25,6,372,6,372,0,0,10553.145548,8.91287999999986,333.8988071195895,0
"147.32.84.165",2341,"212.117.174.7",4506,6,372,6,372,0,0,10558.353477,8.912567999999737,333.91049583016786,0
"147.32.84.165",2344,"174.133.57.141",80,16,3429,12,1428,4,2001,10558.353542,0.4704409999994823,24283.597730666697,34027.64639990481
"147.32.84.165",2363,"64.12.139.193",25,6,372,6,372,0,0,10558.509408,8.856590999999753,336.02093627221615,0
"147.32.84.165",2364,"209.85.143.27",25,6,372,6,372,0,0,10558.509471,8.856653000000733,336.01858399552896,0
"147.32.84.165",2365,"64.12.90.98",25,6,372,6,372,0,0,10558.509529,8.85664799999904,336.01877369410215,0
"147.32.84.165",2366,"209.85.225.27",25,6,372,6,372,0,0,10562.258515,9.013044999999693,330.1880773922799,0
"147.32.84.165",2367,"98.139.54.60",25,6,372,6,372,0,0,10562.258613,9.013155000000552,330.18404765033085,0
"147.32.84.165",2368,"64.98.36.4",25,6,372,6,372,0,0,10563.660955,9.015481000000364,330.09885994988844,0
"147.32.84.165",2369,"208.180.26.102",25,6,372,6,372,0,0,10564.261302,9.01360299999942,330.1676366265733,0
"147.32.84.165",2370,"205.188.159.42",25,6,372,6,372,0,0,10565.563397,9.012845999999627,330.19536781169046,0
"147.32.84.165",2371,"74.125.93.27",25,6,372,6,372,0,0,10567.766764,9.012591999999131,330.20467363886956,0
"147.32.84.165",2372,"209.85.225.27",25,6,372,6,372,0,0,10570.273092,9.0099050000008,330.30314970021726,0
"147.32.84.165",2373,"64.12.139.193",25,6,372,6,372,0,0,10570.273224,9.009939999999915,330.30186660510816,0
"147.32.84.165",2355,"116.111.222.15",6667,4,248,4,248,0,0,10572.974378,3.004421999999977,660.3599627482475,0
"147.32.84.165",2374,"84.2.44.11",25,6,372,6,372,0,0,10572.974517,9.012703999998848,330.20057021737097,0
"147.32.84.165",2375,"216.82.253.227",25,6,372,6,372,0,0,10574.075627,9.013295999999173,330.17888239776806,0
"147.32.84.165",2378,"209.85.143.27",25,6,372,6,372,0,0,10579.383785,9.012563000000227,330.2057361485212,0
"147.32.84.165",2355,"212.117.174.7",4506,6,372,6,372,0,0,10583.289121,9.013021000000663,330.1889566217344,0
"147.32.84.165",2379,"98.139.54.60",25,6,372,6,372,0,0,10584.690776,9.012948000001415,330.19163097352083,0
"147.32.84.165",2366,"212.117.174.7",4506,6,372,6,372,0,0,10585.29158,9.013126000001648,330.1851100272487,0
"147.32.84.165",2380,"66.77.179.12",25,6,372,6,372,0,0,10585.291714,9.01304699999855,330.1880041234089,0
"147.32.84.165",2381,"64.12.90.98",25,6,372,6,372,0,0,10586.595738,9.010748999999123,330.27221155536455,0
"147.32.84.165",2382,"209.85.225.27",25,6,372,6,372,0,0,10588.796894,9.012815000000046,330.1965035341328,0
"147.32.84.165",2383,"198.155.167.200",25,6,372,6,372,0,0,10591.300653,9.012756000000081,330.1986650920066,0
"147.32.84.165",2384,"65.55.88.22",25,6,372,6,372,0,0,10592.902587,9.013071999999738,330.1870882646989,0
"147.32.84.165",2385,"205.188.103.1",25,6,372,6,372,0,0,10594.004199,9.01304699999855,330.1880041234089,0
"147.32.84.165",2386,"168.95.5.62",25,6,372,6,372,0,0,10595.105809,9.013016999999309,330.1891031604876,0
"147.32.84.165",2387,"205.188.59.194",25,6,372,6,372,0,0,10600.413541,9.012715999999273,330.2001305710998,0
"147.32.84.165",2378,"202.112.126.218",6667,15,1820,10,1262,5,558,10604.318966,1.182898999999452,8534.963678221622,3773.7795027319057
"147.32.84.165",2388,"209.85.225.27",25,6,372,6,372,0,0,10604.535511,8.997462999999698,330.75990420856414,0
"147.32.84.165",2389,"98.139.54.60",25,6,372,6,372,0,0,10604.535571,8.997530999999071,330.7574044479877,0
"147.32.84.165",2391,"74.125.113.27",25,6,372,6,372,0,0,10604.535628,8.997526000001017,330.7575882525556,0
"147.32.84.165",2392,"64.12.90.98",25,6,372,6,372,0,0,10605.721665,9.012249000001248,330.2172410016177,0
"147.32.84.165",2393,"65.54.188.72",25,6,372,6,372,0,0,10605.7218,9.01224000000002,330.21757077041815,0
"147.32.84.165",2394,"209.85.225.27",25,6,372,6,372,0,0,10606.322025,9.012721000000965,330.19994738544347,0
"147.32.84.165",2395,"98.139.54.60",25,6,372,6,372,0,0,10606.32216,9.012711999999738,330.20027711970454,0
"147.32.84.165",2396,"209.85.143.27",25,6,372,6,372,0,0,10607.623845,9.012953999999809,330.19141116220754,0
"147.32.84.165",2380,"212.117.174.7",4506,6,372,6,372,0,0,10609.827221,9.012627000000066,330.2033913086582,0
"147.32.84.165",2366,"174.133.57.141",80,17,3489,12,1428,5,2061,10612.332606,1.8478639999993902,6182.273154303439,8922.734573542988
"147.32.84.165",2398,"124.108.110.37",25,6,372,6,372,0,0,10612.495259,8.948330000001079,332.57602256506425,0
"147.32.84.165",2399,"74.125.244.13",25,6,372,6,372,0,0,10613.932968,9.012930000000779,330.19229040941656,0
"147.32.84.165",2401,"64.12.90.98",25,6,372,6,372,0,0,10615.034368,9.01350999999886,330.1710432451261,0
"147.32.84.165",2384,"222.23.80.7",6667,6,372,6,372,0,0,10616.136088,9.013261000000057,330.180164537561,0
"147.32.84.165",2402,"24.56.134.54",25,6,372,6,372,0,0,10621.443729,8.913069000000178,333.8917268563657,0
"147.32.84.165",2403,"209.85.225.27",25,6,372,6,372,0,0,10625.549506,8.914385000000038,333.8424355690255,0
"147.32.84.165",2384,"212.117.174.7",4506,6,372,6,372,0,0,10626.751512,8.912938999999824,333.8965968464565,0
"147.32.84.165",2404,"98.139.54.60",25,6,372,6,372,0,0,10626.751646,8.912932999999612,333.8968216186669,0
"147.32.84.165",2405,"216.82.249.3",25,6,372,6,372,0,0,10626.751705,8.91292599999906,333.89708385330624,0
"147.32.84.165",2406,"205.188.59.194",25,6,372,6,372,0,0,10627.352106,8.912954999999783,333.8959974553975,0
"147.32.84.165",2407,"209.85.143.27",25,6,372,6,372,0,0,10628.655346,8.91204900000048,333.9299413636348,0
"147.32.84.165",2408,"64.12.90.1",25,6,372,6,372,0,0,10630.757217,9.013177999999243,330.18320508041114,0
"147.32.84.165",2409,"98.139.54.60",25,6,372,6,372,0,0,10633.361156,9.012792999999874,330.1973095354616,0
"147.32.84.165",2410,"209.85.225.27",25,6,372,6,372,0,0,10634.864148,9.012055999999575,330.2243128538194,0
"147.32.84.165",2413,"205.188.59.194",25,6,372,6,372,0,0,10634.864279,9.012011000000712,330.2259617747654,0
"147.32.84.165",2414,"98.139.175.224",25,6,372,6,372,0,0,10634.864338,9.011975999999777,330.2272442802859,0
"147.32.84.165",2415,"209.85.225.27",25,6,372,6,372,0,0,10635.964952,9.012668999999732,330.2018525256046,0
"147.32.84.165",2416,"170.69.251.203",25,6,372,6,372,0,0,10635.965085,9.012662000001,330.2021089884065,0
"147.32.84.165",2418,"64.12.90.65",25,6,372,6,372,0,0,10637.967813,9.012688000000708,330.20115641413156,0
"147.32.84.165",2419,"64.12.90.1",25,6,372,6,372,0,0,10642.37408,9.012806000000637,330.1968332614493,0
"147.32.84.165",2421,"195.35.82.79",25,6,372,6,372,0,0,10642.374138,9.012872000001153,330.19441527624264,0
"147.32.84.165",2328,"212.117.171.138",65500,24,1475,18,1092,6,383,10646.479737,134.41226900000038,64.99406687346358,22.795538106718453
"147.32.84.165",2422,"80.12.242.82",25,6,372,6,372,0,0,10646.502569,8.98994700000003,331.03643436385,0
"147.32.84.165",2424,"209.85.225.27",25,6,372,6,372,0,0,10647.681307,9.013342999998713,330.177160682826,0
"147.32.84.165",2425,"98.139.54.60",25,6,372,6,372,0,0,10648.282237,9.012996000001294,330.1898724907426,0
"147.32.84.165",2426,"64.12.90.65",25,6,372,6,372,0,0,10648.282368,9.012990999999602,330.19005566522054,0
"147.32.84.165",2429,"64.12.90.98",25,6,372,6,372,0,0,10648.282425,9.012987000000066,330.1902022048826,0
"147.32.84.165",2430,"65.55.92.136",25,6,372,6,372,0,0,10649.584386,9.012990999999602,330.19005566522054,0
"147.32.84.165",2431,"98.139.54.60",25,6,372,6,372,0,0,10651.787444,9.013269000000946,330.179871476119,0
"147.32.84.165",2432,"209.85.143.27",25,6,372,6,372,0,0,10651.78751,9.013299000000188,330.17877250049486,0
"147.32.84.165",2408,"212.117.174.7",4506,6,372,6,372,0,0,10654.391244,9.01279599999907,330.19719962598805,0
"147.32.84.165",2433,"209.85.225.27",25,6,372,6,372,0,0,10655.893049,9.01569500000005,330.09102459654895,0
"147.32.84.165",2434,"216.32.181.178",25,6,372,6,372,0,0,10655.893183,9.015685000000303,330.09139072626203,0
"147.32.84.165",2436,"168.95.5.37",25,6,372,6,372,0,0,10656.995216,9.012485000001107,330.20859396710614,0
"147.32.84.165",2437,"64.12.90.1",25,6,372,6,372,0,0,10658.99774,9.012746999998853,330.19899482370676,0
"147.32.84.165",2438,"216.82.254.83",25,6,372,6,372,0,0,10663.404178,9.012810000000172,330.19668671590136,0
"147.32.84.165",2421,"174.133.57.141",80,16,3429,12,1428,4,2001,10667.509823,0.5040200000003097,22665.767231445145,31760.644418852753
"147.32.84.165",2439,"64.12.139.193",25,6,372,6,372,0,0,10667.676939,8.945985999998811,332.663163121471,0
"147.32.84.165",2440,"209.85.225.27",25,6,372,6,372,0,0,10668.711467,9.015992000000551,330.0801509140445,0
"147.32.84.165",2442,"74.6.140.64",25,6,372,6,372,0,0,10669.312509,9.016133000000991,330.07498891150703,0
"147.32.84.165",2443,"216.32.181.178",25,6,372,6,372,0,0,10670.614654,9.014177999999447,330.1465757610048,0
"147.32.84.165",2444,"209.85.143.27",25,6,372,6,372,0,0,10670.614716,9.014299000000392,330.14214416449585,0
"147.32.84.165",2445,"212.105.205.30",25,6,372,6,372,0,0,10670.614772,9.014352999998664,330.14016646568433,0
"147.32.84.165",2425,"212.117.174.7",4506,6,372,6,372,0,0,10672.817956,9.012487999998484,330.2084840501869,0
"147.32.84.165",2446,"64.12.90.1",25,6,372,6,372,0,0,10672.818037,9.012531000000308,330.20690858094116,0
"147.32.84.165",2447,"98.139.54.60",25,6,372,6,372,0,0,10672.818073,9.012547000000268,330.2063223636905,0
"147.32.84.165",2448,"194.217.242.207",25,6,372,6,372,0,0,10675.421422,9.01271700000143,330.2000939338856,0
"147.32.84.165",2449,"77.238.184.241",25,6,372,6,372,0,0,10676.923408,9.013012999999773,330.1892496993042,0
"147.32.84.165",2433,"174.133.57.141",80,17,2011,12,1428,5,583,10678.027423,194.6022009999997,58.704372002452416,23.966840950581066
"147.32.84.165",2450,"209.85.225.27",25,6,372,6,372,0,0,10678.193189,8.944961999999578,332.70124568445794,0
"147.32.84.165",2452,"98.137.54.238",25,6,372,6,372,0,0,10678.193254,8.9449910000003,332.7001670543772,0
"147.32.84.165",2454,"64.12.139.193",25,6,372,6,372,0,0,10680.027964,9.012762999998813,330.19840863455437,0
"147.32.84.165",2455,"216.32.181.178",25,6,372,6,372,0,0,10680.028064,9.012790000000678,330.1974194450083,0
"147.32.84.165",2436,"212.117.174.7",4506,6,372,6,372,0,0,10684.434272,9.014304999998785,330.14192441906516,0
"147.32.84.165",2456,"205.188.59.194",25,6,372,6,372,0,0,10688.640506,9.012754999999743,330.1987017288371,0
"147.32.84.165",2457,"98.139.54.60",25,6,372,6,372,0,0,10689.743688,9.01144000000022,330.24688618022503,0
"147.32.84.165",2459,"209.85.225.27",25,6,372,6,372,0,0,10689.743833,9.011420999999245,330.2475824845215,0
"147.32.84.165",2460,"216.99.131.17",25,6,372,6,372,0,0,10690.342698,8.912948999999571,333.89622222680094,0
"147.32.84.165",2462,"205.188.190.1",25,6,372,6,372,0,0,10691.648775,8.908837000000858,334.0503367610961,0
"147.32.84.165",2463,"208.97.132.73",25,6,372,6,372,0,0,10693.847859,8.912782999999763,333.902441022078,0
"147.32.84.165",2446,"193.220.38.27",6667,6,372,6,372,0,0,10696.453464,8.910837999999785,333.97532308409956,0
"147.32.84.165",2448,"173.192.170.88",80,28,4807,18,1526,10,3281,10697.953982,38.606699999998455,316.21454307155204,679.8819893956503
"147.32.84.165",2464,"205.188.159.42",25,6,372,6,372,0,0,10698.154914,8.912171999998463,333.9253326799026,0
"147.32.84.165",2449,"173.192.170.88",80,44,7557,28,2126,16,5431,10699.155424,43.3053089999994,392.7463027685644,1003.2950001580778
"147.32.84.165",2465,"209.85.143.27",25,6,372,6,372,0,0,10699.155493,9.013247999999294,330.1806407634887,0
"147.32.84.165",2466,"209.85.225.27",25,6,372,6,372,0,0,10700.958079,9.012716999999611,330.20009393395225,0
"147.32.84.165",2467,"98.139.175.224",25,6,372,6,372,0,0,10700.958172,9.012773999998899,330.1980056307152,0
"147.32.84.165",2468,"128.121.85.2",25,6,372,6,372,0,0,10705.364441,9.013296999999511,330.17884576533555,0
"147.32.84.165",2469,"98.139.54.60",25,6,372,6,372,0,0,10709.570314,9.013393999999607,330.1752924592146,0
"147.32.84.165",2456,"212.117.174.7",4506,6,372,6,372,0,0,10710.672631,9.012394000001223,330.21192815134316,0
"147.32.84.165",2470,"205.188.146.193",25,6,372,6,372,0,0,10711.272846,9.012770999999702,330.1981155407253,0
"147.32.84.165",2472,"209.85.225.27",25,6,372,6,372,0,0,10712.574701,9.012813000001188,330.19657680677585,0
"147.32.84.165",2460,"212.117.174.7",4506,6,372,6,372,0,0,10714.77812,9.012711999999738,330.20027711970454,0
"147.32.84.165",2473,"209.85.143.27",25,6,372,6,372,0,0,10714.778252,9.012721999999485,330.1999107484032,0
"147.32.84.165",2474,"205.188.190.1",25,6,372,6,372,0,0,10714.778311,9.012753999999404,330.19873836567564,0
"147.32.84.165",2462,"208.73.210.29",80,73,40379,44,6734,29,33645,10719.084348,16.003021000000444,3366.364388323836,16819.32430132989
"147.32.84.165",2477,"213.33.87.13",25,6,372,6,372,0,0,10719.084489,9.012919999999212,330.19265676387454,0
"147.32.84.165",2478,"217.18.208.148",25,6,372,6,372,0,0,10719.26691,8.930312999998932,333.2469981735641,0
"147.32.84.165",2464,"74.125.232.217",80,13,2928,10,2054,3,874,10720.185473,14.902006000000256,1102.6703384765592,469.19857635273263
"147.32.84.165",2480,"64.12.90.98",25,6,372,6,372,0,0,10720.193645,9.004919000000882,330.48603768670307,0
"147.32.84.165",2465,"94.127.76.180",80,25,8824,18,6346,7,2478,10721.988656,13.098912000001292,3875.741740993068,1513.4081364924084
"147.32.84.165",2479,"98.139.54.60",25,6,372,6,372,0,0,10722.002726,8.998650999999882,330.71623735602583,0
"147.32.84.165",2481,"209.85.225.27",25,6,372,6,372,0,0,10722.002787,8.998716000000059,330.7138485090518,0
"147.32.84.165",2482,"209.85.143.27",25,6,372,6,372,0,0,10722.002856,8.998701000000437,330.71439977835195,0
"147.32.84.165",2466,"94.127.76.180",80,13,2237,10,1646,3,591,10726.394467,8.693187999999282,1514.7492496424888,543.8741230490346
"147.32.84.165",2483,"218.102.53.147",25,6,372,6,372,0,0,10726.394602,9.012774999999237,330.19796899403923,0
"147.32.84.165",2467,"50.22.198.84",80,13,3329,10,2304,3,1025,10730.60088,0.36817599999994854,50063.013341452395,22271.95689018607
"147.32.84.165",2484,"209.191.88.254",25,6,372,6,372,0,0,10730.72182,8.992049999998926,330.9590137955589,0
"147.32.84.165",2485,"209.85.143.27",25,6,372,6,372,0,0,10731.70222,9.01300000000083,330.18972595137313,0
"147.32.84.165",2486,"64.12.139.193",25,6,372,6,372,0,0,10731.702354,9.01299200000176,330.190019030242,0
"147.32.84.165",2487,"65.254.254.55",25,6,372,6,372,0,0,10732.302987,9.012993000000279,330.18998239540497,0
"147.32.84.165",2490,"64.12.90.98",25,6,372,6,372,0,0,10733.604952,9.012855000000854,330.195038087234,0
"147.32.84.165",2491,"209.85.143.27",25,6,372,6,372,0,0,10733.605084,9.01281199999903,330.1966134432095,0
"147.32.84.165",2492,"209.85.225.27",25,6,372,6,372,0,0,10733.605142,9.012778000000253,330.19785908406004,0
"147.32.84.165",2495,"205.188.190.1",25,6,372,6,372,0,0,10735.808214,9.013487000000168,330.1718857529771,0
"147.32.84.165",2448,"212.117.174.7",4506,6,372,6,372,0,0,10740.114298,9.013177999999243,330.18320508041114,0
"147.32.84.165",2464,"117.204.64.132",6667,4,248,4,248,0,0,10740.214581,3.004289999998946,660.3889770963176,0
"147.32.84.165",2472,"173.192.170.88",80,17,1641,12,1084,5,557,10741.215882,63.661659999999756,136.2201362641193,69.99503311726426
"147.32.84.165",2496,"222.227.75.45",25,6,372,6,372,0,0,10741.216016,9.013060999999652,330.1874912418894,0
"147.32.84.165",2478,"173.192.170.88",80,17,1641,12,1084,5,557,10743.018815,60.73839600000065,142.77624321853853,73.363807631666
"147.32.84.165",2501,"64.12.90.98",25,6,372,6,372,0,0,10743.018919,9.012679999999818,330.20144951335897,0
"147.32.84.165",2503,"98.139.54.60",25,6,372,6,372,0,0,10747.424913,9.012742999999318,330.1991413713034,0
"147.32.84.165",2483,"217.72.192.149",25,6,372,6,372,0,0,10751.731461,9.01257600000099,330.20525985019964,0
"147.32.84.165",2504,"209.85.225.27",25,6,372,6,372,0,0,10752.732374,9.012946000000738,330.19170424406803,0
"147.32.84.165",2506,"74.125.67.27",25,6,372,6,372,0,0,10752.732507,9.012939999998707,330.19192405590485,0
"147.32.84.165",2508,"74.6.136.65",25,6,372,6,372,0,0,10753.333457,9.012700999999652,330.20068012908837,0
"147.32.84.165",2509,"68.1.17.3",25,6,372,6,372,0,0,10754.635117,9.013065000001006,330.18734470456695,0
"147.32.84.165",2485,"212.117.174.7",4506,6,372,6,372,0,0,10756.838317,9.012926999999763,330.1924003156886,0
"147.32.84.165",2510,"205.188.146.193",25,6,372,6,372,0,0,10756.838417,9.012953999999809,330.19141116220754,0
"147.32.84.165",2492,"66.94.238.147",25,6,372,6,372,0,0,10759.943346,8.912255999999616,333.9221853591423,0
"147.32.84.165",2511,"98.139.54.60",25,6,372,6,372,0,0,10761.144507,8.91294999999991,333.896184764868,0
"147.32.84.165",2495,"212.117.171.138",65500,25,1527,18,1092,7,435,10761.144657,108.150701999999,80.77617471220927,32.177322344149296
"147.32.84.165",2512,"64.12.139.193",25,6,372,6,372,0,0,10761.144734,8.912852999999814,333.8998186102769,0
"147.32.84.165",2513,"202.137.234.30",25,6,372,6,372,0,0,10762.246643,8.912179999999353,333.92503293248296,0
"147.32.84.165",2514,"209.85.225.27",25,6,372,6,372,0,0,10764.04867,8.912914000000455,333.897533399273,0
"147.32.84.165",2519,"12.102.252.75",25,6,372,6,372,0,0,10768.455077,8.913055999999415,333.8922138490093,0
"147.32.84.165",2520,"209.85.143.27",25,6,372,6,372,0,0,10772.664826,9.006685000000289,330.4212371144216,0
"147.32.84.165",2521,"205.188.59.194",25,6,372,6,372,0,0,10773.662692,9.011709000000337,330.2370282928453,0
"147.32.84.165",2523,"194.231.186.24",25,6,372,6,372,0,0,10774.263342,9.01277300000038,330.19804226733265,0
"147.32.84.165",2524,"61.208.203.214",25,6,372,6,372,0,0,10775.565365,9.015190000000075,330.1095151627392,0
"147.32.84.165",2504,"98.126.71.122",80,18,4967,14,1534,4,3433,10777.768585,18.41566899999998,666.3890407674038,1491.3387072715104
"147.32.84.165",2506,"212.117.174.7",4506,6,372,6,372,0,0,10777.943468,8.944015000000945,332.73647237842124,0
"147.32.84.165",2485,"218.201.21.157",6667,4,248,4,248,0,0,10780.868692,3.0103589999998803,659.0576074149558,0
"147.32.84.165",2525,"209.85.225.27",25,6,372,6,372,0,0,10782.072524,9.028322000000117,329.6293596971798,0
"147.32.84.165",2510,"195.113.232.98",80,24,8272,16,4296,8,3976,10782.072618,14.11185999999907,2435.398310357548,2253.990614986408
"147.32.84.165",2526,"98.139.54.60",25,6,372,6,372,0,0,10782.072646,9.028331999999864,329.628994591697,0
"147.32.84.165",2328,"195.113.232.89",80,13,2900,10,1878,3,1022,10783.175583,13.009078999999474,1154.885753249758,628.4841532594529
"147.32.84.165",2492,"212.117.174.7",4506,6,372,6,372,0,0,10783.176508,9.028134999998656,329.6361873189139,0
"147.32.84.165",2527,"205.188.190.1",25,6,372,6,372,0,0,10783.176571,9.028196999999636,329.633923584091,0
"147.32.84.165",2528,"205.188.159.42",25,6,372,6,372,0,0,10784.981682,9.029139000000214,329.59953324452414,0
"147.32.84.165",2529,"65.54.188.110",25,6,372,6,372,0,0,10789.395911,9.040646000001288,329.1800165607165,0
"147.32.84.165",2532,"209.85.225.27",25,6,372,6,372,0,0,10793.709317,9.033245999999053,329.449679550442,0
"147.32.84.165",2533,"203.124.10.223",25,6,372,6,372,0,0,10794.712757,9.031424000000698,329.51614274778484,0
"147.32.84.165",2534,"208.94.108.68",25,6,372,6,372,0,0,10795.314356,9.030675999998493,329.54343617249657,0
"147.32.84.165",2535,"64.12.90.65",25,6,372,6,372,0,0,10796.633808,9.012892999999167,330.1936459248185,0
"147.32.84.165",2328,"174.133.57.141",80,16,3429,12,1428,4,2001,10798.93721,0.462917999999263,24678.236750392487,34580.63847166342
"147.32.84.165",2536,"64.12.90.98",25,6,372,6,372,0,0,10798.937346,9.01280399999996,330.1969065343053,0
"147.32.84.165",2485,"68.41.173.2",6667,6,372,6,372,0,0,10799.738384,9.014204999999492,330.1455868820564,0
"147.32.84.165",2537,"209.85.143.27",25,6,372,6,372,0,0,10803.145899,8.912522000000536,333.91221923489456,0
"147.32.84.165",2510,"212.117.174.7",4506,6,372,6,372,0,0,10804.24497,8.91244800000095,333.9149917059469,0
"147.32.84.165",2504,"173.192.170.88",80,6,372,6,372,0,0,10806.047117,8.913136999999551,333.8891795335525,0
"147.32.84.165",2521,"212.117.174.7",4506,6,372,6,372,0,0,10810.453627,8.912975999999617,333.89521075790265,0
"147.32.84.165",2519,"173.192.170.88",80,6,372,6,372,0,0,10810.453777,8.912948999999571,333.89622222680094,0
"147.32.84.165",2520,"174.133.57.141",80,17,3489,12,1428,5,2061,10810.453852,5.249486999999135,2176.212647064729,3140.878337255186
"147.32.84.165",2540,"98.139.54.60",25,6,372,6,372,0,0,10810.453927,8.912851999999475,333.89985607302526,0
"147.32.84.165",2542,"74.125.244.13",25,6,372,6,372,0,0,10814.660188,9.01240499999949,330.21152511456916,0
"147.32.84.165",2544,"209.85.225.27",25,6,372,6,372,0,0,10815.661376,9.012539999999717,330.20657883350236,0
"147.32.84.165",2547,"64.12.90.98",25,6,372,6,372,0,0,10816.262114,9.012737000000925,330.19936119290895,0
"147.32.84.165",2548,"209.85.143.27",25,6,372,6,372,0,0,10816.262246,9.012666999999055,330.2019258006883,0
"147.32.84.165",2549,"98.139.54.60",25,6,372,6,372,0,0,10816.262303,9.012636000001294,330.2030615681775,0
"147.32.84.165",2550,"77.238.184.241",25,6,372,6,372,0,0,10816.262362,9.01260000000002,330.2043805339184,0
"147.32.84.165",2551,"64.12.90.65",25,6,372,6,372,0,0,10817.564039,9.012881999999081,330.1940489180157,0
"147.32.84.165",2552,"209.85.225.27",25,6,372,6,372,0,0,10819.867113,9.012869000000137,330.1945251839292,0
"147.32.84.165",2553,"209.85.143.27",25,6,372,6,372,0,0,10819.867245,9.012862999999925,330.1947449994552,0
"147.32.84.165",2554,"160.44.248.163",25,6,372,6,372,0,0,10819.867304,9.012856999999713,330.19496481527386,0
"147.32.84.165",2472,"111.88.33.160",6667,6,372,6,372,0,0,10821.972805,9.010858000001463,330.2682164117465,0
"147.32.84.165",2555,"98.139.54.60",25,6,372,6,372,0,0,10824.073096,9.013229000000138,330.18133678839786,0
"147.32.84.165",2556,"205.188.159.42",25,6,372,6,372,0,0,10824.07323,9.013198000000557,330.1824724143213,0
"147.32.84.165",2557,"205.188.190.1",25,6,372,6,372,0,0,10825.174999,9.013001999999688,330.18965268177055,0
"147.32.84.165",2485,"174.133.57.141",80,16,3429,12,1428,4,2001,10826.977325,0.5350849999995262,21349.87899120722,29916.7421998639
"147.32.84.165",2558,"210.158.24.242",25,6,372,6,372,0,0,10826.977422,9.01563200000055,330.09333122734137,0
"147.32.84.165",2525,"212.117.174.7",4506,6,372,6,372,0,0,10831.383744,9.012815000000046,330.1965035341328,0
"147.32.84.165",2492,"173.192.170.88",80,6,372,6,372,0,0,10835.689815,9.015551000000414,330.0962969429005,0
"147.32.84.165",2535,"212.117.174.7",4506,6,372,6,372,0,0,10836.691236,9.013095999998768,330.1862090451945,0
"147.32.84.165",2527,"67.195.168.31",25,6,372,6,372,0,0,10836.691371,9.01308599999902,330.1865753860912,0
"147.32.84.165",2526,"173.192.170.88",80,6,372,6,372,0,0,10837.292131,9.013033999999607,330.18848037188474,0
"147.32.84.165",2559,"193.74.71.108",25,6,372,6,372,0,0,10837.292267,9.013021999999182,330.18891998713303,0
"147.32.84.165",2536,"174.133.57.141",80,17,3483,12,1428,5,2055,10838.594013,0.46228900000096473,24711.814470982783,35562.169984502536
"147.32.84.165",2560,"213.180.147.146",25,6,372,6,372,0,0,10838.746325,8.96092999999928,332.10838607156165,0
"147.32.84.165",2561,"209.85.225.27",25,6,372,6,372,0,0,10840.897562,9.012693999999101,330.20093659013577,0
"147.32.84.165",2485,"178.122.115.200",6667,6,372,6,372,0,0,10843.000912,9.012505000000601,330.2078611884045,0
"147.32.84.165",2562,"64.18.5.10",25,6,372,6,372,0,0,10845.103579,9.013030999998591,330.1885902756204,0
"147.32.84.165",2563,"205.188.159.42",25,6,372,6,372,0,0,10846.204982,9.013575000000856,330.1686622677148,0
"147.32.84.165",2566,"208.66.171.141",25,6,372,6,372,0,0,10848.007564,9.013515000000552,330.170860091742,0
"147.32.84.165",2540,"174.133.57.141",80,17,3489,12,1428,5,2061,10852.41385,1.77288899999985,6443.719826791732,9300.074623962017
"147.32.84.165",2567,"209.85.225.27",25,6,372,6,372,0,0,10852.573553,8.95333600000049,332.39007225908165,0
"147.32.84.165",2568,"64.12.90.98",25,6,372,6,372,0,0,10852.573618,8.953365999999733,332.3889585213079,0
"147.32.84.165",2569,"205.188.190.1",25,6,372,6,372,0,0,10856.719978,9.013291000001118,330.1790655599193,0
"147.32.84.165",2540,"212.117.174.7",4506,6,372,6,372,0,0,10857.721862,9.012692000000243,330.20100986474625,0
"147.32.84.165",2570,"65.55.92.152",25,6,372,6,372,0,0,10858.322348,9.013080000000627,330.1867951909661,0
"147.32.84.165",2572,"50.22.60.162",25,6,372,6,372,0,0,10859.72475,9.012876000000688,330.194268732841,0
"147.32.84.165",2573,"83.221.140.46",25,6,372,6,372,0,0,10861.927972,9.012597000000824,330.20449044817246,0
"147.32.84.165",2557,"46.24.73.184",6667,6,372,6,372,0,0,10864.030617,9.0130079999999,330.18943287302454,0
"147.32.84.165",2558,"212.117.174.7",4506,6,372,6,372,0,0,10866.133748,9.013084000000163,330.1866486543281,0
"147.32.84.165",2492,"65.54.188.72",25,6,372,6,372,0,0,10866.133882,9.013074000000415,330.1870149962003,0
"147.32.84.165",2526,"174.133.57.141",80,16,3429,12,1428,4,2001,10867.235214,0.4734649999991234,24128.499466742316,33810.31332839732
"147.32.84.165",2574,"205.188.190.1",25,6,372,6,372,0,0,10867.389933,8.958236999998917,332.2082235601,0
"147.32.84.165",2562,"173.192.170.88",80,19,1908,16,1722,3,186,10867.389998,19.38908199999969,710.5029521253364,76.74422130970532
"147.32.84.165",2575,"209.85.225.27",25,6,372,6,372,0,0,10869.037822,9.015681999999288,330.0915005653743,0
"147.32.84.165",2560,"212.117.171.138",65500,11,666,8,484,3,182,10873.544577,304.0828679999995,12.733371088830976,4.788168467287681
"147.32.84.165",2577,"205.188.146.193",25,6,372,6,372,0,0,10873.567083,8.890570999999909,334.73665527220135,0
"147.32.84.165",2578,"200.143.5.118",25,6,372,6,372,0,0,10876.549294,8.915713000000324,333.7927095679159,0
"147.32.84.165",2581,"98.139.175.224",25,6,372,6,372,0,0,10877.750203,8.913027000000511,333.89330022222856,0
"147.32.84.165",2582,"98.139.54.60",25,6,372,6,372,0,0,10878.752119,8.912368999999671,333.91795155700015,0
"147.32.84.165",2584,"209.85.225.27",25,6,372,6,372,0,0,10879.352705,8.91260400000101,333.90914709098064,0
"147.32.84.165",2585,"205.188.159.42",25,6,372,6,372,0,0,10879.352838,8.912596000000121,333.90944680988116,0
"147.32.84.165",2586,"64.12.139.193",25,6,372,6,372,0,0,10880.757238,8.910243000000264,333.9976249805883,0
"147.32.84.165",2587,"147.228.57.19",25,6,372,6,372,0,0,10882.858025,9.015111000000616,330.1124079337234,0
"147.32.84.165",2589,"77.238.184.241",25,6,372,6,372,0,0,10885.060737,9.01306199999999,330.1874546075466,0
"147.32.84.165",2590,"65.55.37.120",25,6,372,6,372,0,0,10887.063715,9.01305499999944,330.1877110480503,0
"147.32.84.165",2592,"209.85.225.27",25,6,372,6,372,0,0,10889.967786,9.013104000001476,330.18591597295585,0
"147.32.84.165",2593,"209.85.225.27",25,6,372,6,372,0,0,10894.474247,9.013444000000163,330.1734608879742,0
"147.32.84.165",2594,"66.94.236.34",25,6,372,6,372,0,0,10894.474381,9.01345399999991,330.17309457617796,0
"147.32.84.165",2577,"173.192.170.88",80,22,2782,18,2536,4,246,10897.479228,45.46538800000053,446.2295581861033,43.28567480827343
"147.32.84.165",2595,"205.188.146.193",25,6,372,6,372,0,0,10898.68102,9.012355999999272,330.2133204680597,0
"147.32.84.165",2596,"209.85.143.27",25,6,372,6,372,0,0,10899.681764,9.012998999998672,330.1897625862866,0
"147.32.84.165",2597,"213.165.64.100",25,6,372,6,372,0,0,10900.286232,9.00973299999896,330.3094553412786,0
"147.32.84.165",2598,"205.188.103.1",25,6,372,6,372,0,0,10900.683967,9.012236999999004,330.21768069352026,0
"147.32.84.165",2599,"98.139.54.60",25,6,372,6,372,0,0,10901.684989,9.012917000000016,330.1927666703238,0
"147.32.84.165",2586,"212.117.174.7",4506,6,372,6,372,0,0,10903.888143,9.012661000000662,330.2021456260012,0
"147.32.84.165",2600,"209.85.225.27",25,6,372,6,372,0,0,10906.091404,9.012794999998732,330.19723626249333,0
"147.32.84.165",2601,"205.188.59.194",25,6,372,6,372,0,0,10906.091553,9.012790999999197,330.197382808529,0
"147.32.84.165",2603,"205.188.103.1",25,6,372,6,372,0,0,10908.09399,9.012971000000107,330.1907883648982,0
"147.32.84.165",2604,"71.74.56.243",25,6,372,6,372,0,0,10908.094123,9.012978999999177,330.19049528466354,0
"147.32.84.165",2605,"98.139.54.60",25,6,372,6,372,0,0,10910.998314,9.012703000000329,330.2006068545576,0
"147.32.84.165",2606,"209.85.225.27",25,6,372,6,372,0,0,10910.998457,9.012698000000455,330.200790040879,0
"147.32.84.165",2607,"65.54.188.126",25,6,372,6,372,0,0,10915.504638,9.013208000000304,330.18210608252906,0
"147.32.84.165",2608,"24.113.32.85",25,6,372,6,372,0,0,10919.711032,9.012805000000299,330.1968698978732,0
"147.32.84.165",2610,"74.125.67.27",25,6,372,6,372,0,0,10920.711982,9.013050999999905,330.18785758563126,0
"147.32.84.165",2611,"65.55.92.152",25,6,372,6,372,0,0,10921.313192,9.012660000000324,330.202182263604,0
"147.32.84.165",2612,"193.187.8.2",25,6,372,6,372,0,0,10921.713618,9.013139000000592,330.18463378849526,0
"147.32.84.165",2613,"209.85.143.27",25,6,372,6,372,0,0,10922.71531,9.012544000001071,330.2064322792373,0
"147.32.84.165",2599,"212.117.174.7",4506,6,372,6,372,0,0,10924.918638,9.012579000000187,330.2051499354334,0
"147.32.84.165",2598,"112.152.241.216",6667,4,248,4,248,0,0,10927.121751,3.0038079999994807,660.4949450831555,0
"147.32.84.165",2614,"209.85.225.27",25,6,372,6,372,0,0,10929.124287,9.013118999999278,330.1853664641772,0
"147.32.84.165",2615,"205.188.190.1",25,6,372,6,372,0,0,10929.124421,9.013118999999278,330.1853664641772,0
"147.32.84.165",2604,"212.117.174.7",4506,6,372,6,372,0,0,10932.028572,9.012885000000097,330.1939390106462,0
"147.32.84.165",2617,"65.55.88.22",25,6,372,6,372,0,0,10932.028689,9.01289099999849,330.19371919625996,0
"147.32.84.165",2618,"209.85.225.27",25,6,372,6,372,0,0,10936.534927,9.01276499999949,330.19833536103164,0
"147.32.84.165",2619,"148.123.15.75",25,6,372,6,372,0,0,10940.741164,9.013040000001638,330.1882605646329,0
"147.32.84.165",2621,"205.188.59.194",25,6,372,6,372,0,0,10941.742343,9.013510000000679,330.1710432450595,0
"147.32.84.165",2622,"71.74.56.243",25,6,372,6,372,0,0,10942.343107,8.913421999999628,333.87850367682853,0
"147.32.84.165",2624,"209.85.225.27",25,6,372,6,372,0,0,10942.743656,8.912974999999278,333.89524821961703,0
"147.32.84.165",2623,"98.139.54.60",25,6,372,6,372,0,0,10942.743795,8.912963999999192,333.8956602988938,0
"147.32.84.165",2626,"64.12.90.1",25,6,372,6,372,0,0,10943.745414,8.912491999999475,333.9133432041426,0
"147.32.84.165",2628,"74.125.45.27",25,6,372,6,372,0,0,10945.948669,8.914645000000746,333.8326988903934,0
"147.32.84.165",2629,"65.55.37.88",25,6,372,6,372,0,0,10946.348879,8.913211000000956,333.8864074910468,0
"147.32.84.165",2630,"64.12.90.98",25,6,372,6,372,0,0,10950.15458,8.912770999999339,333.90289058253836,0
"147.32.84.165",2614,"212.117.174.7",4506,6,372,6,372,0,0,10952.958921,9.01313300000038,330.1848535908518,0
"147.32.84.165",2604,"173.192.170.88",80,6,372,6,372,0,0,10957.468047,9.00984199999948,330.3054592966416,0
"147.32.84.165",2631,"209.85.225.27",25,6,372,6,372,0,0,10961.670994,9.012869000000137,330.1945251839292,0
"147.32.84.165",2618,"212.117.174.7",4506,6,372,6,372,0,0,10962.772776,9.01291300000048,330.19291321239217,0
"147.32.84.165",2632,"77.238.184.241",25,6,372,6,372,0,0,10962.772909,9.012904000001072,330.1932429325383,0
"147.32.84.165",2633,"64.12.90.1",25,6,372,6,372,0,0,10963.273171,9.013143999998647,330.18445062016616,0
"147.32.84.165",2634,"203.188.197.119",25,6,372,6,372,0,0,10963.273305,9.013135999999577,330.18474368967026,0
"147.32.84.165",2635,"209.85.225.27",25,6,372,6,372,0,0,10963.67416,9.012504000000263,330.20789782727564,0
"147.32.84.165",2638,"65.54.188.72",25,6,372,6,372,0,0,10963.674294,9.012429999998858,330.2106091254387,0
"147.32.84.165",2622,"178.123.248.251",6667,6,372,6,372,0,0,10964.675795,9.0127250000005,330.19980083713136,0
"147.32.84.165",2639,"64.98.36.4",25,6,372,6,372,0,0,10966.878598,9.01291300000048,330.19291321239217,0
"147.32.84.165",2641,"64.12.90.98",25,6,372,6,372,0,0,10967.279622,9.01291400000082,330.19287657684623,0
"147.32.84.165",2642,"209.85.143.27",25,6,372,6,372,0,0,10967.279755,9.012894000001324,330.1936092890433,0
"147.32.84.165",2643,"98.139.54.60",25,6,372,6,372,0,0,10971.087439,9.010034999999334,330.29838396856616,0
"147.32.84.165",2644,"217.77.188.135",25,6,372,6,372,0,0,10973.989097,9.012994000000617,330.1899457605094,0
"147.32.84.165",2645,"64.12.139.193",25,6,372,6,372,0,0,10982.701168,9.013014000000112,330.18921306457116,0
"147.32.84.165",2646,"209.85.225.27",25,6,372,6,372,0,0,10983.802945,9.012966000000233,330.1909715403257,0
"147.32.84.165",2618,"212.117.174.7",4506,6,372,6,372,0,0,10984.303667,9.013234000000011,330.18115362366007,0
"147.32.84.165",2647,"62.67.228.136",25,6,372,6,372,0,0,10984.704712,9.012489999999161,330.20841077219245,0
"147.32.84.165",2648,"98.139.175.224",25,6,372,6,372,0,0,10984.804182,9.01317200000085,330.18342488079884,0
"147.32.84.165",2635,"115.137.250.215",6667,9,552,6,372,3,180,10987.207738,1.9252350000006118,1545.7853197137256,747.9606385711575
"147.32.84.165",2634,"173.192.170.88",80,16,2139,12,1610,4,529,10987.908658,7.51077499999883,1714.8696372880304,563.4571665374957
"147.32.84.165",2649,"66.94.237.64",25,6,372,6,372,0,0,10988.109478,9.012799000000086,330.1970897165211,0
"147.32.84.165",2650,"205.188.159.42",25,6,372,6,372,0,0,10988.309719,9.012673999999606,330.2016693381043,0
"147.32.84.165",2651,"205.188.103.1",25,6,372,6,372,0,0,10989.133249,8.990136000000348,331.0294749712223,0
"147.32.84.165",2654,"209.85.225.27",25,6,372,6,372,0,0,10992.114964,9.012795000000551,330.1972362624267,0
"147.32.84.165",2655,"209.85.143.27",25,6,372,6,372,0,0,10992.115025,9.012823000000935,330.19621044368574,0
"147.32.84.165",2656,"65.54.188.94",25,6,372,6,372,0,0,10995.019374,9.012486999999965,330.2085206891296,0
"147.32.84.165",2657,"64.12.90.1",25,6,372,6,372,0,0,11003.73152,9.012920000001031,330.1926567638079,0
"147.32.84.165",2658,"205.178.149.7",25,6,372,6,372,0,0,11004.832909,9.013433999998597,330.17382720064995,0
"147.32.84.165",2659,"98.139.54.60",25,6,372,6,372,0,0,11005.3353,9.011598999999478,330.241059328114,0
"147.32.84.165",2660,"205.188.190.1",25,6,372,6,372,0,0,11005.734534,9.012799000000086,330.1970897165211,0
"147.32.84.165",2662,"209.85.225.27",25,6,372,6,372,0,0,11005.834593,9.012797000001228,330.1971629894243,0
"147.32.84.165",2663,"74.125.45.27",25,6,372,6,372,0,0,11009.139271,9.013033999999607,330.18848037188474,0
"147.32.84.165",2665,"64.12.90.1",25,6,372,6,372,0,0,11009.33953,9.013003000000026,330.1896160469481,0
"147.32.84.165",2666,"98.139.54.60",25,6,372,6,372,0,0,11009.339664,9.012993000000279,330.18998239540497,0
"147.32.84.165",2667,"64.12.139.193",25,6,372,6,372,0,0,11009.339721,9.012988999998925,330.1901289350686,0
"147.32.84.165",2668,"209.85.143.27",25,6,372,6,372,0,0,11010.140847,9.01269499999944,330.2008999528094,0
"147.32.84.165",2671,"65.55.92.168",25,6,372,6,372,0,0,11010.140982,9.012691999998424,330.20100986481293,0
"147.32.84.165",2651,"173.192.170.88",80,21,2611,16,2050,5,561,11013.145187,28.369181000000026,578.0921204598745,158.1998436965803
"147.32.84.165",2672,"209.85.225.27",25,6,372,6,372,0,0,11013.346139,8.912452000000485,333.9148418414863,0
"147.32.84.165",2673,"84.2.44.11",25,6,372,6,372,0,0,11013.346202,8.912474999999176,333.91398012339727,0
"147.32.84.165",2655,"212.117.174.7",4506,6,372,6,372,0,0,11016.049121,8.91309899999942,333.8906030327043,0
"147.32.84.165",2675,"98.137.54.238",25,6,372,6,372,0,0,11024.663471,9.010937000000922,330.2653209094343,0
"147.32.84.165",2676,"207.115.37.23",25,6,372,6,372,0,0,11025.763133,9.01339199999893,330.17536572251083,0
"147.32.84.165",2677,"205.188.159.42",25,6,372,6,372,0,0,11026.263779,9.013066999999864,330.18727143602115,0
"147.32.84.165",2678,"98.139.54.60",25,6,372,6,372,0,0,11026.664334,9.013072000001557,330.1870882646323,0
"147.32.84.165",2679,"64.12.90.65",25,6,372,6,372,0,0,11026.764475,9.013614999999845,330.1671970679967,0
"147.32.84.165",2680,"209.85.143.27",25,6,372,6,372,0,0,11030.069248,9.014006999999765,330.1528387985585,0
"147.32.84.165",2686,"209.85.225.27",25,6,372,6,372,0,0,11030.269491,9.01321900000039,330.1817031184831,0
"147.32.84.165",2662,"212.117.174.7",4506,6,372,6,372,0,0,11031.071013,9.012829999999667,330.1959539900464,0
"147.32.84.165",2687,"66.94.237.64",25,6,372,6,372,0,0,11031.071144,9.01283500000136,330.1957708090241,0
"147.32.84.165",2667,"74.125.127.27",25,6,372,6,372,0,0,11034.275627,9.0134939999989,330.1716293371209,0
"147.32.84.165",2689,"98.139.54.60",25,6,372,6,372,0,0,11036.97922,9.013324999999895,330.1778200608582,0
"147.32.84.165",2691,"205.188.59.194",25,6,372,6,372,0,0,11036.979354,9.013339000000997,330.177307210976,0
"147.32.84.165",2655,"174.133.57.141",80,17,3489,12,1428,5,2061,11045.692021,3.619210999999268,3156.489080079142,4555.689071458761
"147.32.84.165",2692,"74.125.113.27",25,6,372,6,372,0,0,11045.84695,8.958010000000286,332.21664186576095,0
"147.32.84.165",2693,"64.12.139.193",25,6,372,6,372,0,0,11046.793386,9.015139000001,330.11138264198365,0
"147.32.84.165",2694,"12.156.137.227",25,6,372,6,372,0,0,11047.293997,9.013304000000062,330.1785893386021,0
"147.32.84.165",2695,"209.85.143.27",25,6,372,6,372,0,0,11047.696804,9.010760000001028,330.27180837128725,0
"147.32.84.165",2696,"209.85.225.27",25,6,372,6,372,0,0,11047.696939,9.01071200000115,330.2735677269033,0
"147.32.84.165",2697,"94.125.33.2",25,6,372,6,372,0,0,11047.697,9.010675999999876,330.27488725596623,0
"147.32.84.165",2698,"64.12.90.98",25,6,372,6,372,0,0,11047.796372,9.01130799999919,330.25172372315626,0
"147.32.84.165",2677,"221.207.141.60",6667,15,1710,10,1152,5,558,11051.099584,1.9121969999996509,4819.587103212526,2334.4875031185675
"147.32.84.165",2701,"98.139.54.60",25,6,372,6,372,0,0,11051.299885,9.012977999998839,330.1905319196811,0
"147.32.84.165",2702,"205.188.190.1",25,6,372,6,372,0,0,11051.538666,8.974371999998766,331.6109472618707,0
"147.32.84.165",2686,"212.117.174.7",4506,6,372,6,372,0,0,11052.10092,9.013128999999026,330.1850001259631,0
"147.32.84.165",2704,"67.231.152.94",25,6,372,6,372,0,0,11055.305523,9.013177999999243,330.18320508041114,0
"147.32.84.165",2705,"66.45.246.210",25,6,372,6,372,0,0,11058.010028,9.012488999998823,330.2084474111856,0
"147.32.84.165",2689,"174.133.57.141",80,12,1430,8,1188,4,242,11066.822916,196.160484,48.45012515364716,9.869469938705901
"147.32.84.165",2706,"205.188.159.42",25,6,372,6,372,0,0,11066.978879,8.95627599999898,332.28096141748415,0
"147.32.84.165",2708,"98.139.54.60",25,6,372,6,372,0,0,11067.82378,9.012871999999334,330.19441527630926,0
"147.32.84.165",2709,"209.85.143.27",25,6,372,6,372,0,0,11067.823922,9.012821000000258,330.1962837162654,0
"147.32.84.165",2710,"38.113.116.194",25,6,372,6,372,0,0,11068.324289,9.012956000000486,330.1913378917904,0
"147.32.84.165",2711,"209.85.225.27",25,6,372,6,372,0,0,11068.724827,9.013261000000057,330.180164537561,0
"147.32.84.165",2712,"207.246.139.8",25,6,372,6,372,0,0,11068.825055,9.012978000000658,330.19053191961444,0
"147.32.84.165",2695,"212.117.174.7",4506,6,372,6,372,0,0,11072.330089,9.01292900000044,330.19232704483244,0
"147.32.84.165",2713,"174.122.122.64",25,6,372,6,372,0,0,11072.33024,9.01290500000141,330.1932062969192,0
"147.32.84.165",2714,"205.188.159.42",25,6,372,6,372,0,0,11072.530618,9.012967999999091,330.1908982701703,0
"147.32.84.165",2715,"209.85.143.27",25,6,372,6,372,0,0,11072.539194,9.004517999999734,330.50075528752205,0
"147.32.84.165",2717,"194.116.198.12",25,6,372,6,372,0,0,11072.539269,9.004508999998507,330.50108562282446,0
"147.32.84.165",2697,"183.83.68.80",6667,6,372,6,372,0,0,11073.131167,9.013292999999976,330.17899229504775,0
"147.32.84.165",2718,"209.85.225.27",25,6,372,6,372,0,0,11076.33749,9.011946000000535,330.2283435786037,0
"147.32.84.165",2720,"98.139.54.60",25,6,372,6,372,0,0,11076.337622,9.011908000000403,330.22973603368644,0
"147.32.84.165",2704,"212.117.174.7",4506,6,372,6,372,0,0,11079.041642,9.011005000000296,330.2628286189945,0
"147.32.84.165",2705,"74.125.127.27",25,6,372,6,372,0,0,11087.952835,8.912474999999176,333.91398012339727,0
"147.32.84.165",2721,"208.65.144.13",25,6,372,6,372,0,0,11088.854225,8.913658000001305,333.8696638349333,0
"147.32.84.165",2722,"64.12.90.65",25,6,372,6,372,0,0,11089.354601,8.912737000000561,333.90416434365926,0
"147.32.84.165",2723,"205.188.146.193",25,6,372,6,372,0,0,11089.755074,8.912827999998626,333.90075518123524,0
"147.32.84.165",2724,"209.85.143.27",25,6,372,6,372,0,0,11089.855221,9.013598999999886,330.1677831463368,0
"147.32.84.165",2726,"209.85.225.27",25,6,372,6,372,0,0,11093.260227,9.012860999999248,330.19481827138446,0
"147.32.84.165",2728,"195.219.49.78",25,6,372,6,372,0,0,11093.460722,9.012590000000273,330.2047469151387,0
"147.32.84.165",2695,"78.138.22.163",6667,6,372,6,372,0,0,11095.363592,9.012727999999697,330.19969092599933,0
"147.32.84.165",2729,"165.21.74.116",25,6,372,6,372,0,0,11097.2659,9.013382999999521,330.1756954076131,0
"147.32.84.165",2717,"212.117.174.7",4506,6,372,6,372,0,0,11099.970118,9.013213000000178,330.18192291693776,0
"147.32.84.165",2695,"212.117.174.7",4506,6,372,6,372,0,0,11108.882627,9.012914999999339,330.19283994137504,0
"147.32.84.165",2731,"205.188.103.1",25,6,372,6,372,0,0,11108.882762,9.01290500000141,330.1932062969192,0
"147.32.84.165",2732,"98.139.54.60",25,6,372,6,372,0,0,11109.785051,9.011869999998453,330.2311285005788,0
"147.32.84.165",2733,"205.188.146.193",25,6,372,6,372,0,0,11110.284676,9.012867000001279,330.19459845569423,0
"147.32.84.165",2734,"209.85.225.27",25,6,372,6,372,0,0,11110.284808,9.012842000000092,330.1955143560677,0
"147.32.84.165",2735,"209.85.143.27",25,6,372,6,372,0,0,11110.284864,9.012814000001526,330.19654017041694,0
"147.32.84.165",2736,"68.142.202.129",25,6,372,6,372,0,0,11110.28492,9.012785000000804,330.1976026277931,0
"147.32.84.165",2737,"69.31.1.34",25,6,372,6,372,0,0,11110.685364,9.01326699999845,330.179944741514,0
"147.32.84.165",2738,"205.188.190.1",25,6,372,6,372,0,0,11110.885566,9.012925999999425,330.19243695112885,0
"147.32.84.165",2739,"65.54.188.94",25,6,372,6,372,0,0,11114.290906,9.012753999999404,330.19873836567564,0
"147.32.84.165",2740,"98.139.54.60",25,6,372,6,372,0,0,11114.491023,9.012778999998773,330.1978224474832,0
"147.32.84.165",2741,"205.188.146.193",25,6,372,6,372,0,0,11114.491155,9.01277200000004,330.1980789040249,0
"147.32.84.165",2745,"209.85.225.27",25,6,372,6,372,0,0,11116.393566,9.014975999998569,330.1173513939995,0
"147.32.84.165",2746,"64.12.90.65",25,6,372,6,372,0,0,11118.296581,9.012602999999217,330.20427061973754,0
"147.32.84.165",2747,"67.231.144.94",25,6,372,6,372,0,0,11121.000466,9.012482000000091,330.2087038842319,0
"147.32.84.165",2748,"207.115.21.20",25,6,372,6,372,0,0,11129.912848,9.013020000000324,330.18899325641047,0
"147.32.84.165",2749,"77.238.184.241",25,6,372,6,372,0,0,11130.816767,9.010298999999577,330.2887062904505,0
"147.32.84.165",2750,"205.188.59.194",25,6,372,6,372,0,0,11131.31527,9.01296100000036,330.19115471595643,0
"147.32.84.165",2751,"216.99.131.14",25,6,372,6,372,0,0,11131.715789,9.013290999999299,330.179065559986,0
"147.32.84.165",2752,"204.11.209.99",25,6,372,6,372,0,0,11131.91596,9.012692000000243,330.20100986474625,0
"147.32.84.165",2736,"117.198.86.115",6667,9,552,6,372,3,180,11135.320837,1.6190480000004754,1838.1172145601156,889.411555432314
"147.32.84.165",2738,"212.117.174.7",4506,6,372,6,372,0,0,11135.521125,9.01295200000095,330.1914844325906,0
"147.32.84.165",2753,"98.139.54.60",25,6,372,6,372,0,0,11136.940125,8.995724000000337,330.82384475111604,0
"147.32.84.165",2754,"209.85.225.27",25,6,372,6,372,0,0,11137.423794,9.012769999999364,330.1981521774338,0
"147.32.84.165",2736,"174.133.57.141",80,17,3489,12,1428,5,2061,11139.326436,11.326915000001463,1008.5711775888249,1455.647897066224
"147.32.84.165",2757,"209.85.143.27",25,6,372,6,372,0,0,11139.326572,9.01297599999998,330.19060518967393,0
"147.32.84.165",2746,"212.117.174.7",4506,6,372,6,372,0,0,11142.030249,9.012926999999763,330.1924003156886,0
"147.32.84.165",2758,"216.221.81.40",25,6,372,6,372,0,0,11142.030382,9.01293799999985,330.1919973265155,0
"147.32.84.165",2760,"205.188.159.42",25,6,372,6,372,0,0,11150.943183,8.91284700000142,333.90004338675686,0
"147.32.84.165",2762,"212.247.156.1",25,6,372,6,372,0,0,11151.844301,8.91284799999994,333.9000059240346,0
"147.32.84.165",2763,"64.12.90.65",25,6,372,6,372,0,0,11152.345482,8.912497999999687,333.9131184096877,0
"147.32.84.165",2765,"209.85.225.27",25,6,372,6,372,0,0,11152.746096,8.912345999999161,333.9188132956553,0
"147.32.84.165",2766,"209.85.143.27",25,6,372,6,372,0,0,11152.746239,8.912352999999712,333.9185510268833,0
"147.32.84.165",2770,"212.227.15.186",25,6,372,6,372,0,0,11152.746313,8.912374999999884,333.91772675634036,0
"147.32.84.165",2771,"205.188.146.193",25,6,372,6,372,0,0,11152.946226,8.912936999999147,333.8966717705157,0
"147.32.84.165",2772,"64.98.36.4",25,6,372,6,372,0,0,11156.551114,9.012963000001037,330.1910814456531,0
"147.32.84.165",2752,"117.204.67.233",6667,6,372,6,372,0,0,11157.953242,8.912725000000137,333.90461390876015,0
"147.32.84.165",2773,"209.85.225.27",25,6,372,6,372,0,0,11158.45382,8.913015000000087,333.8937497580753,0
"147.32.84.165",2777,"205.188.159.42",25,6,372,6,372,0,0,11160.256584,9.013097999999445,330.1861357770861,0
"147.32.84.165",2778,"98.139.54.60",25,6,372,6,372,0,0,11160.256718,9.013087999999698,330.18650211782017,0
"147.32.84.165",2757,"212.117.174.7",4506,6,372,6,372,0,0,11162.960543,9.012831000000006,330.1959173538257,0
"147.32.84.165",2779,"209.85.143.27",25,6,372,6,372,0,0,11171.873348,9.012777000001734,330.19789572064496,0
"147.32.84.165",2752,"212.117.174.7",4506,6,372,6,372,0,0,11172.774482,9.012988999998925,330.1901289350686,0
"147.32.84.165",2780,"209.85.225.27",25,6,372,6,372,0,0,11172.774629,9.012942999999723,330.19181414994983,0
"147.32.84.165",2781,"205.188.103.1",25,6,372,6,372,0,0,11172.774704,9.012894999999844,330.19357265340955,0
"147.32.84.165",2782,"205.188.159.42",25,6,372,6,372,0,0,11173.275122,9.013012000001254,330.1892863339787,0
"147.32.84.165",2783,"98.139.54.60",25,6,372,6,372,0,0,11173.675898,9.012918000000354,330.1927300348104,0
"147.32.84.165",2785,"209.85.225.27",25,6,372,6,372,0,0,11173.676079,9.012831000000006,330.1959173538257,0
"147.32.84.165",2786,"98.139.175.224",25,6,372,6,372,0,0,11173.676169,9.01277200000004,330.1980789040249,0
"147.32.84.165",2788,"65.54.188.94",25,6,372,6,372,0,0,11173.876101,9.013301999999385,330.1786626033615,0
"147.32.84.165",2765,"212.117.171.138",65500,14,846,10,604,4,242,11177.581668,204.4085019999984,23.638938462550044,9.471230311154157
"147.32.84.165",2789,"64.12.90.65",25,6,372,6,372,0,0,11177.581805,9.01243600000089,330.21038928872355,0
"147.32.84.165",2560,"93.180.203.85",6667,6,372,6,372,0,0,11179.384237,9.012688999999227,330.201119776823,0
"147.32.84.165",2790,"98.137.54.238",25,6,372,6,372,0,0,11179.484219,9.012806999999157,330.1967966251001,0
"147.32.84.165",2791,"205.188.159.42",25,6,372,6,372,0,0,11181.286814,9.014500000001135,330.1347828498115,0
"147.32.84.165",2792,"65.112.30.195",25,6,372,6,372,0,0,11181.286947,9.014489999999569,330.13514907666905,0
"147.32.84.165",2793,"209.85.225.27",25,6,372,6,372,0,0,11183.99341,9.01161300000058,330.24054628175986,0
"147.32.84.165",2560,"212.117.174.7",4506,6,372,6,372,0,0,11192.905902,9.010760999999547,330.27177171829874,0
"147.32.84.165",2794,"98.139.175.224",25,6,372,6,372,0,0,11193.80524,9.013404999999693,330.1748895117995,0
"147.32.84.165",2795,"205.188.159.42",25,6,372,6,372,0,0,11193.805371,9.013398999999481,330.1751093011828,0
"147.32.84.165",2796,"64.12.139.193",25,6,372,6,372,0,0,11193.805431,9.013395999998465,330.17521919601745,0
"147.32.84.165",2797,"65.55.37.120",25,6,372,6,372,0,0,11194.305742,9.012821000000258,330.1962837162654,0
"147.32.84.165",2799,"98.139.54.60",25,6,372,6,372,0,0,11194.706145,9.01317999999992,330.18313181363584,0
"147.32.84.165",2800,"65.220.119.60",25,6,372,6,372,0,0,11194.906397,9.01569599999857,330.0909879836756,0
"147.32.84.165",2801,"209.85.225.27",25,6,372,6,372,0,0,11198.611668,9.01295300000129,330.19144779736166,0
"147.32.84.165",2803,"62.211.72.32",25,6,372,6,372,0,0,11198.611803,9.012947999999597,330.19163097358745,0
"147.32.84.165",2786,"212.117.174.7",4506,6,372,6,372,0,0,11200.514738,9.012693000000581,330.2009732274036,0
"147.32.84.165",2788,"174.133.57.141",80,17,3489,12,1428,5,2061,11200.51487,1.8842139999997016,6063.00558216944,8750.598392752952
"147.32.84.165",2804,"205.188.190.1",25,6,372,6,372,0,0,11200.514927,9.01259299999947,330.2046370007139,0
"147.32.84.165",2805,"205.188.159.42",25,6,372,6,372,0,0,11200.514996,9.012548000000606,330.2062857251689,0
"147.32.84.165",2806,"65.55.92.152",25,6,372,6,372,0,0,11202.317172,9.013144000000466,330.1844506200995,0
"147.32.84.165",2807,"65.54.188.126",25,6,372,6,372,0,0,11205.021305,9.012673999999606,330.2016693381043,0
"147.32.84.165",2689,"89.200.164.105",6667,4,248,4,248,0,0,11213.933861,3.004501999999775,660.3423795358261,0
"147.32.84.165",2808,"209.85.225.27",25,6,372,6,372,0,0,11214.835188,9.012967000000572,330.1909349052106,0
"147.32.84.165",2809,"77.238.184.241",25,6,372,6,372,0,0,11215.335657,9.013614999999845,330.1671970679967,0
"147.32.84.165",2795,"64.12.90.1",25,6,372,6,372,0,0,11215.736693,9.012448999999833,330.2099129770449,0
"147.32.84.165",2811,"98.139.54.60",25,6,372,6,372,0,0,11215.936457,9.012926999999763,330.1924003156886,0
"147.32.84.165",2812,"64.12.90.98",25,6,372,6,372,0,0,11219.642263,9.012791999999536,330.1973461719912,0
"147.32.84.165",2813,"209.85.143.27",25,6,372,6,372,0,0,11221.544613,8.91329399999995,333.88329836309856,0
"147.32.84.165",2814,"64.12.90.65",25,6,372,6,372,0,0,11221.544751,8.91327900000033,333.88386024939757,0
"147.32.84.165",2816,"209.85.225.27",25,6,372,6,372,0,0,11223.347463,8.912658999999621,333.9070865383862,0
"147.32.84.165",2817,"77.238.184.241",25,6,372,6,372,0,0,11223.347622,8.91262800000004,333.9082479376438,0
"147.32.84.165",2818,"98.139.54.60",25,6,372,6,372,0,0,11223.347705,8.912615999999616,333.908697513741,0
"147.32.84.165",2819,"205.188.59.194",25,6,372,6,372,0,0,11223.347789,8.912596000000121,333.90944680988116,0
"147.32.84.165",2804,"212.117.174.7",4506,6,372,6,372,0,0,11226.051247,9.01311700000042,330.1854397318776,0
"147.32.84.165",2820,"209.85.225.27",25,6,372,6,372,0,0,11231.759476,9.012854000000516,330.19507472325967,0
"147.32.84.165",2821,"98.139.175.224",25,6,372,6,372,0,0,11231.759612,9.012842000000092,330.1955143560677,0
"147.32.84.165",2822,"98.139.54.60",25,6,372,6,372,0,0,11235.765187,9.012915999999677,330.19280330584536,0
"147.32.84.165",2823,"64.12.90.1",25,6,372,6,372,0,0,11235.765326,9.015050999998493,330.1146050089453,0
"147.32.84.165",2824,"65.54.188.109",25,6,372,6,372,0,0,11235.765384,9.015074999999342,330.1137261753471,0
"147.32.84.165",2825,"98.137.54.238",25,6,372,6,372,0,0,11236.265696,9.013779999999315,330.16115325648354,0
"147.32.84.165",2808,"78.129.163.119",6251,1422,786720,990,274108,432,512612,11236.666607,5962.393559,367.7824984716008,687.7935781025152
"147.32.84.165",2826,"209.85.225.27",25,6,372,6,372,0,0,11236.722764,8.956998999999996,332.2541400306064,0
"147.32.84.165",2829,"209.85.143.27",25,6,372,6,372,0,0,11236.867022,9.012676000000283,330.20159606313445,0
"147.32.84.165",2830,"129.12.21.31",25,6,372,6,372,0,0,11236.867124,9.012711999999738,330.20027711970454,0
"147.32.84.165",2831,"65.54.188.72",25,6,372,6,372,0,0,11240.571997,9.01299200000176,330.190019030242,0
"147.32.84.165",2833,"205.188.146.193",25,6,372,6,372,0,0,11242.474757,9.013504000000466,330.171263029322,0
"147.32.84.165",2834,"64.12.90.65",25,6,372,6,372,0,0,11242.474895,9.013490000001184,330.17177586036144,0
"147.32.84.165",2835,"74.6.136.65",25,6,372,6,372,0,0,11244.277696,9.012728000001516,330.19969092593266,0
"147.32.84.165",2816,"212.117.174.7",4506,6,372,6,372,0,0,11247.081415,9.012818999999581,330.19635698887754,0
"147.32.84.165",2836,"145.78.21.41",25,6,372,6,372,0,0,11252.7897,9.012956000000486,330.1913378917904,0
"147.32.84.165",2837,"209.85.225.27",25,6,372,6,372,0,0,11256.795262,9.01320400000077,330.1822526151351,0
"147.32.84.165",2838,"98.139.54.60",25,6,372,6,372,0,0,11256.795395,9.013257000000522,330.1803110684437,0
"147.32.84.165",2840,"189.14.105.150",25,6,372,6,372,0,0,11257.295952,9.012963999999556,330.19104481058025,0
"147.32.84.165",2841,"205.188.146.193",25,6,372,6,372,0,0,11257.698511,9.011381999998775,330.24901174985195,0
"147.32.84.165",2842,"209.85.143.27",25,6,372,6,372,0,0,11257.698643,9.011453000000984,330.24640976318415,0
"147.32.84.165",2843,"209.85.225.27",25,6,372,6,372,0,0,11257.897446,9.015670999999202,330.0919033092782,0
"147.32.84.165",2844,"205.188.103.1",25,6,372,6,372,0,0,11261.602125,9.012918000000354,330.1927300348104,0
"147.32.84.165",2830,"212.117.174.7",4506,6,372,6,372,0,0,11263.50485,9.0134620000008,330.1728015272862,0
"147.32.84.165",2845,"80.12.242.148",25,6,372,6,372,0,0,11263.504983,9.013441999999486,330.17353415045767,0
"147.32.84.165",2846,"205.188.146.193",25,6,372,6,372,0,0,11263.505047,9.013406000000032,330.17485288025296,0
"147.32.84.165",2849,"198.85.228.146",25,6,372,6,372,0,0,11265.307405,9.01368999999977,330.16444985350904,0
"147.32.84.165",2850,"98.139.54.60",25,6,372,6,372,0,0,11268.11179,9.012677999999141,330.2015227882638,0
"147.32.84.165",2852,"209.85.225.27",25,6,372,6,372,0,0,11268.111922,9.012699000000794,330.2007534035851,0
"147.32.84.165",2853,"209.85.143.27",25,6,372,6,372,0,0,11268.11198,9.01271000000088,330.2003503940224,0
"147.32.84.165",2854,"64.12.139.193",25,6,372,6,372,0,0,11268.112038,9.012719000000288,330.20002065968157,0
"147.32.84.165",2856,"180.222.96.138",25,6,372,6,372,0,0,11273.819963,9.014447999999902,330.1366872380907,0
"147.32.84.165",2857,"76.162.254.119",25,6,372,6,372,0,0,11277.825618,9.012955999998667,330.191337891857,0
"147.32.84.165",2858,"211.132.7.202",25,6,372,6,372,0,0,11278.326518,9.012743999999657,330.1991047343754,0
"147.32.84.165",2859,"205.188.146.193",25,6,372,6,372,0,0,11278.726896,9.012833000000683,330.19584408140867,0
"147.32.84.165",2860,"78.66.104.247",25,6,372,6,372,0,0,11278.727001,9.012865000000602,330.19467172755844,0
"147.32.84.165",2861,"217.77.176.17",25,6,372,6,372,0,0,11278.927003,9.01316399999996,330.1837179485487,0
"147.32.84.165",2862,"209.85.143.27",25,6,372,6,372,0,0,11282.635677,9.009701999999379,330.3105918486766,0
"147.32.84.165",2863,"209.85.225.27",25,6,372,6,372,0,0,11284.535197,9.013498000000254,330.17148281387716,0
"147.32.84.165",2864,"216.17.3.48",25,6,372,6,372,0,0,11284.535347,9.013420000001133,330.1743400395883,0
"147.32.84.165",2866,"98.139.54.60",25,6,372,6,372,0,0,11286.337817,9.012920000001031,330.1926567638079,0
"147.32.84.165",2849,"212.117.174.7",4506,6,372,6,372,0,0,11289.142234,9.013065999999526,330.1873080703233,0
"147.32.84.165",2852,"81.199.182.101",6667,9,552,6,372,3,180,11294.850017,2.000321999999869,1487.7604705643364,719.8840986601629
"147.32.84.165",2850,"212.117.174.7",4506,6,372,6,372,0,0,11296.850626,8.815112000000227,337.60206336572054,0
"147.32.84.165",2867,"205.188.190.1",25,6,372,6,372,0,0,11296.850703,8.815158999999767,337.60026336451546,0
"147.32.84.165",2852,"173.192.170.88",80,39,8119,28,3452,11,4667,11298.756031,55.56229699999858,497.0276876782237,671.9664595580157
"147.32.84.165",2868,"64.12.90.66",25,6,372,6,372,0,0,11298.956662,9.01225499999964,330.2170211562055,0
"147.32.84.165",2869,"209.85.143.27",25,6,372,6,372,0,0,11299.256582,9.012794000000213,330.19727289894007,0
"147.32.84.165",2870,"205.188.146.193",25,6,372,6,372,0,0,11299.256714,9.012799000000086,330.1970897165211,0
"147.32.84.165",2871,"209.85.225.27",25,6,372,6,372,0,0,11299.657286,9.013027000000875,330.1887368139151,0
"147.32.84.165",2872,"167.154.2.117",25,6,372,6,372,0,0,11299.657356,9.01309399999991,330.18628231326886,0
"147.32.84.165",2874,"162.119.242.67",25,6,372,6,372,0,0,11299.857105,9.015809000000445,330.0868507751055,0
"147.32.84.165",2875,"209.85.143.27",25,6,372,6,372,0,0,11303.562467,9.013141999999789,330.1845238874601,0
"147.32.84.165",2876,"98.139.54.60",25,6,372,6,372,0,0,11305.465397,9.012795000000551,330.1972362624267,0
"147.32.84.165",2877,"209.85.225.27",25,6,372,6,372,0,0,11305.465549,9.012788,330.1974927181245,0
"147.32.84.165",2878,"205.188.146.193",25,6,372,6,372,0,0,11305.465628,9.01278000000093,330.1977858107812,0
"147.32.84.165",2879,"64.12.90.65",25,6,372,6,372,0,0,11305.465697,9.012797999999748,330.197126353002,0
"147.32.84.165",2862,"115.240.199.38",6667,6,372,6,372,0,0,11307.267865,9.012846999999965,330.19533117559985,0
"147.32.84.165",2880,"204.255.212.244",25,6,372,6,372,0,0,11310.071883,9.012849999999162,330.19522126744334,0
"147.32.84.165",2882,"77.238.177.9",25,6,372,6,372,0,0,11317.68282,9.013091000000713,330.18639221547465,0
"147.32.84.165",2883,"98.139.54.60",25,6,372,6,372,0,0,11319.986266,9.012948999999935,330.19159433832607,0
"147.32.84.165",2884,"205.188.59.194",25,6,372,6,372,0,0,11320.287165,9.012649000000238,330.2025852776383,0
"147.32.84.165",2885,"66.94.237.64",25,6,372,6,372,0,0,11320.687169,9.013390999998592,330.1754023541711,0
"147.32.84.165",2886,"205.188.190.1",25,6,372,6,372,0,0,11320.88759,9.01329799999985,330.1788091329111,0
"147.32.84.165",2872,"212.117.174.7",4506,6,372,6,372,0,0,11324.592805,9.01282700000047,330.1960638986907,0
"147.32.84.165",2887,"209.85.225.27",25,6,372,6,372,0,0,11326.495682,9.013095999998768,330.1862090451945,0
"147.32.84.165",2875,"212.117.174.7",4506,6,372,6,372,0,0,11326.495834,9.013034000001426,330.1884803718181,0
"147.32.84.165",2888,"209.86.93.228",25,6,372,6,372,0,0,11326.495894,9.013004000000365,330.1895794121338,0
"147.32.84.165",2878,"117.204.64.132",6667,6,372,6,372,0,0,11329.700423,9.012596000000485,330.2045270862956,0
"147.32.84.165",2889,"67.20.16.11",25,6,372,6,372,0,0,11331.102749,9.012334999999439,330.21408991123667,0
"147.32.84.165",2890,"32.97.110.149",25,6,372,6,372,0,0,11338.713159,9.013715999999476,330.1634974965012,0
"147.32.84.165",2882,"94.63.150.20",80,26,11056,18,1674,8,9382,11341.016547,0.8327399999998306,16081.850277400777,90131.37353797736
"147.32.84.165",2892,"165.212.65.113",25,6,372,6,372,0,0,11341.117403,9.012660000000324,330.202182263604,0
"147.32.84.165",2893,"205.188.103.1",25,6,372,6,372,0,0,11341.317075,9.012673999999606,330.2016693381043,0
"147.32.84.165",2894,"205.188.146.193",25,6,372,6,372,0,0,11341.717688,9.012824999999793,330.1961371712053,0
"147.32.84.165",2895,"200.44.32.36",25,6,372,6,372,0,0,11341.918198,9.01235799999995,330.21324718791874,0
"147.32.84.165",2896,"209.85.225.27",25,6,372,6,372,0,0,11345.623156,9.012719000000288,330.20002065968157,0
"147.32.84.165",2897,"98.139.54.60",25,6,372,6,372,0,0,11345.62329,9.012714000000415,330.2002038453526,0
"147.32.84.165",2902,"98.137.54.237",25,6,372,6,372,0,0,11347.527115,9.011757999998736,330.23523268161637,0
"147.32.84.165",2903,"205.188.103.1",25,6,372,6,372,0,0,11347.527257,9.011770999999499,330.23475629819774,0
"147.32.84.165",2904,"64.56.216.40",25,6,372,6,372,0,0,11347.527314,9.011767999998483,330.2348662327416,0
"147.32.84.165",2875,"221.158.173.198",6667,6,372,6,372,0,0,11350.730351,9.013151999999536,330.1841575511157,0
"147.32.84.165",2905,"205.188.59.194",25,6,372,6,372,0,0,11352.132589,9.01295299999947,330.19144779742834,0
"147.32.84.165",2906,"74.125.93.27",25,6,372,6,372,0,0,11359.74364,8.913273000000117,333.8840850044603,0
"147.32.84.165",2907,"64.18.6.14",25,6,372,6,372,0,0,11362.147134,8.912569999998595,333.9104208999726,0
"147.32.84.165",2909,"209.85.225.27",25,6,372,6,372,0,0,11362.347747,8.912529000001086,333.9119569764808,0
"147.32.84.165",2910,"98.139.54.60",25,6,372,6,372,0,0,11362.748019,8.9128639999999,333.899406520736,0
"147.32.84.165",2913,"98.139.175.224",25,6,372,6,372,0,0,11362.748089,8.912921999999526,333.89723370182736,0
"147.32.84.165",2914,"65.55.37.104",25,6,372,6,372,0,0,11362.947932,8.913523000001078,333.8747204668278,0
"147.32.84.165",2915,"205.188.146.193",25,6,372,6,372,0,0,11366.653361,8.913739999999962,333.866592474092,0
"147.32.84.165",2916,"205.188.190.1",25,6,372,6,372,0,0,11368.455857,9.013223999998445,330.18151995340554,0
"147.32.84.165",2917,"165.21.74.113",25,6,372,6,372,0,0,11368.455997,9.013210000000981,330.1820328162415,0
"147.32.84.165",2902,"85.221.145.247",6667,6,372,6,372,0,0,11371.761115,9.012511000000814,330.20764135541486,0
"147.32.84.165",2903,"212.117.174.7",4506,6,372,6,372,0,0,11373.062636,9.005479999999807,330.46544992605214,0
"147.32.84.165",2904,"98.126.71.122",80,15,4663,12,1290,3,3373,11380.673791,10.162262000001647,1015.5219379305835,2655.3143384805103
"147.32.84.165",2918,"212.82.111.207",25,6,372,6,372,0,0,11380.848437,8.944612999999663,332.7142269878095,0
"147.32.84.165",2765,"212.117.171.138",65500,14,846,10,604,4,242,11383.071543,271.6837639999994,17.78538374490428,7.125931897792774
"147.32.84.165",2906,"95.100.248.96",80,17,5711,12,2512,5,3199,11383.094273,7.741895999999542,2595.746571641002,3305.6501921495087
"147.32.84.165",2919,"209.85.225.27",25,6,372,6,372,0,0,11383.095116,9.013461000000461,330.17283815837754,0
"147.32.84.165",2921,"216.32.180.22",25,6,372,6,372,0,0,11383.095151,9.013549000001149,330.1696146545185,0
"147.32.84.165",2923,"69.89.27.233",25,6,372,6,372,0,0,11383.272255,9.0356699999993,329.3612980553994,0
"147.32.84.165",2907,"195.113.232.81",80,13,3379,10,1524,3,1855,11383.672926,7.16334199999983,1701.9988714765107,2071.6587313575637
"147.32.84.165",2924,"76.96.62.116",25,6,372,6,372,0,0,11383.673739,9.03523800000039,329.3770457402308,0
"147.32.84.165",2909,"74.125.232.217",80,13,1871,10,1156,3,715,11383.873899,6.962460999999166,1328.265968024971,821.5485874894933
"147.32.84.165",2925,"205.188.59.194",25,6,372,6,372,0,0,11383.88255,9.026120000000446,329.7097756289361,0
"147.32.84.165",2910,"77.238.175.247",80,14,2274,10,1276,4,998,11387.585385,0.14040100000056555,72706.03485700872,56865.69183957265
"147.32.84.165",2926,"209.85.225.27",25,6,372,6,372,0,0,11387.631272,8.98288599999978,331.29664564373553,0
"147.32.84.165",2913,"68.67.185.206",80,13,1990,10,1250,3,740,11389.491766,1.3446810000004916,7436.708037070758,4402.5311579458885
"147.32.84.165",2927,"209.85.143.27",25,6,372,6,372,0,0,11389.491904,9.02542799999901,329.73505522401,0
"147.32.84.165",2910,"77.238.167.32",80,13,2342,10,1390,3,952,11389.521097,0.1400519999988319,79399.08034224964,54379.801788360906
"147.32.84.165",2928,"98.139.54.60",25,6,372,6,372,0,0,11389.566948,8.9505079999999,332.4950941332082,0
"147.32.84.165",2904,"59.48.7.162",6667,9,552,6,372,3,180,11390.906024,2.2486790000002657,1323.4436751531225,640.3759718482851
"147.32.84.165",2929,"205.188.190.1",25,6,372,6,372,0,0,11393.155016,8.967266999999993,331.87369128185907,0
"147.32.84.165",2916,"212.117.174.7",4506,6,372,6,372,0,0,11394.112089,9.011322000000291,330.25121064366624,0
"147.32.84.165",2930,"74.125.93.27",25,6,372,6,372,0,0,11401.821605,9.013006000001042,330.1895061425296,0
"147.32.84.165",2903,"173.192.170.88",80,17,1643,12,1086,5,557,11404.125257,68.81946900000003,126.24334546957921,64.7491191773072
"147.32.84.165",2918,"210.211.247.235",6667,6,372,6,372,0,0,11404.325352,9.013150000000678,330.1842308182795,0
"147.32.84.165",2932,"218.102.53.147",25,6,372,6,372,0,0,11404.326011,9.012646000001041,330.20269519069717,0
"147.32.84.165",2933,"208.65.145.3",25,6,372,6,372,0,0,11404.726338,9.012457999999242,330.20958322360565,0
"147.32.84.165",2934,"64.12.90.98",25,6,372,6,372,0,0,11404.92651,9.012606000000233,330.2041607055632,0
"147.32.84.165",2935,"209.85.143.27",25,6,372,6,372,0,0,11408.631555,9.012645000000703,330.202731828422,0
"147.32.84.165",2936,"65.55.37.104",25,6,372,6,372,0,0,11408.631688,9.012646000001041,330.20269519069717,0
"147.32.84.165",2926,"212.117.174.7",4506,6,372,6,372,0,0,11410.534156,9.01304700000037,330.1880041233423,0
"147.32.84.165",2937,"209.85.225.27",25,6,372,6,372,0,0,11410.53429,9.013044999999693,330.1880773922799,0
"147.32.84.165",2938,"208.65.144.12",25,6,372,6,372,0,0,11410.534356,9.013037000000622,330.1883704682223,0
"147.32.84.165",2939,"212.12.42.230",25,6,372,6,372,0,0,11414.139451,9.012777000001734,330.19789572064496,0
"147.32.84.165",2941,"98.139.175.224",25,6,372,6,372,0,0,11415.140923,9.012645999999222,330.20269519076385,0
"147.32.84.165",2942,"98.137.54.237",25,6,372,6,372,0,0,11422.85177,8.913212000001295,333.8863700313162,0
"147.32.84.165",2943,"98.139.54.60",25,6,372,6,372,0,0,11425.355383,9.013199999999415,330.1823991479378,0
"147.32.84.165",2944,"205.188.59.194",25,6,372,6,372,0,0,11425.655876,9.012892999999167,330.1936459248185,0
"147.32.84.165",2945,"209.85.143.27",25,6,372,6,372,0,0,11425.756093,9.013145000000804,330.1844139864314,0
"147.32.84.165",2947,"64.12.90.65",25,6,372,6,372,0,0,11425.85609,9.013425000001007,330.17415688261315,0
"147.32.84.165",2948,"209.85.225.27",25,6,372,6,372,0,0,11429.56185,9.0130709999994,330.18712489896046,0
"147.32.84.165",2950,"94.73.141.68",25,6,372,6,372,0,0,11429.562118,9.01292900000044,330.19232704483244,0
"147.32.84.165",2935,"212.117.174.7",4506,6,372,6,372,0,0,11431.464145,9.013388999999734,330.17547561744954,0
"147.32.84.165",2952,"98.137.54.237",25,6,372,6,372,0,0,11431.464281,9.013377999999648,330.1758785662952,0
"147.32.84.165",2953,"205.188.159.42",25,6,372,6,372,0,0,11431.464339,9.013371999999436,330.17609835699517,0
"147.32.84.165",2938,"95.59.1.63",6667,6,372,6,372,0,0,11435.06949,9.01275700000042,330.1986284551843,0
"147.32.84.165",2954,"209.85.225.27",25,6,372,6,372,0,0,11436.071522,9.012763999999152,330.1983719977889,0
"147.32.84.165",2955,"98.139.54.60",25,6,372,6,372,0,0,11443.782548,9.01263199999994,330.20320811945055,0
"147.32.84.165",2957,"199.228.142.101",25,6,372,6,372,0,0,11443.782909,9.012596000000485,330.2045270862956,0
"147.32.84.165",2959,"98.139.175.224",25,6,372,6,372,0,0,11446.385762,9.013403000000835,330.1749627748503,0
"147.32.84.165",2938,"212.117.174.7",4506,6,372,6,372,0,0,11446.686031,9.013503000000128,330.17129966007195,0
"147.32.84.165",2960,"74.125.157.27",25,6,372,6,372,0,0,11446.686172,9.013490000001184,330.17177586036144,0
"147.32.84.165",2962,"209.85.143.27",25,6,372,6,372,0,0,11446.786749,9.012799999998606,330.197053080115,0
"147.32.84.165",2971,"98.139.54.60",25,6,372,6,372,0,0,11446.886307,9.013119999999617,330.1853298303059,0
"147.32.84.165",2972,"205.188.146.193",25,6,372,6,372,0,0,11450.591831,9.013038000000961,330.18833383368434,0
"147.32.84.165",2973,"98.137.54.237",25,6,372,6,372,0,0,11452.494523,9.013103000001138,330.18595260695724,0
"147.32.84.165",2974,"205.188.103.1",25,6,372,6,372,0,0,11452.494667,9.01305499999944,330.1877110480503,0
"147.32.84.165",2976,"74.125.93.27",25,6,372,6,372,0,0,11457.000911,9.013378000001467,330.1758785662285,0
"147.32.84.165",2977,"209.85.225.27",25,6,372,6,372,0,0,11457.101013,9.013291999999637,330.1790289275128,0
"147.32.84.165",2978,"64.12.90.65",25,6,372,6,372,0,0,11464.812404,9.01308699999936,330.1865387519516,0
"147.32.84.165",2979,"205.188.146.193",25,6,372,6,372,0,0,11467.416018,9.012805000000299,330.1968698978732,0
"147.32.84.165",2980,"65.54.188.126",25,6,372,6,372,0,0,11467.416154,9.012806999999157,330.1967966251001,0
"147.32.84.165",2957,"212.117.174.7",4506,6,372,6,372,0,0,11467.716269,9.01288299999942,330.1940122822178,0
"147.32.84.165",2981,"98.139.54.60",25,6,372,6,372,0,0,11467.816891,9.01250699999946,330.2077879107532,0
"147.32.84.165",2982,"64.12.90.65",25,6,372,6,372,0,0,11467.816948,9.012775000001056,330.19796899397255,0
"147.32.84.165",2983,"124.108.110.37",25,6,372,6,372,0,0,11467.81701,9.01276499999949,330.19833536103164,0
"147.32.84.165",2984,"209.85.225.27",25,6,372,6,372,0,0,11467.916538,9.012919000000693,330.1926933993051,0
"147.32.84.165",2986,"68.142.202.129",25,6,372,6,372,0,0,11467.916609,9.012972000000445,330.1907517298237,0
"147.32.84.165",2987,"194.179.34.52",25,6,372,6,372,0,0,11471.621837,9.01332199999888,330.1779299574973,0
"147.32.84.165",2972,"212.117.174.7",4506,6,372,6,372,0,0,11473.526679,9.011102000000392,330.2592735050464,0
"147.32.84.165",2988,"205.188.59.194",25,6,372,6,372,0,0,11473.526813,9.011077999999543,330.26015311377296,0
"147.32.84.165",2989,"65.55.88.22",25,6,372,6,372,0,0,11473.526875,9.011044000000766,330.26139923406737,0
"147.32.84.165",2973,"125.99.28.64",6667,4,248,4,248,0,0,11478.03121,3.004275000001144,660.392274342144,0
"147.32.84.165",2990,"209.85.225.27",25,6,372,6,372,0,0,11478.131495,9.013032000000749,330.1885536409671,0
"147.32.84.165",2992,"67.195.168.230",25,6,372,6,372,0,0,11485.844818,9.011265000001004,330.2532996199389,0
"147.32.84.165",2993,"64.12.139.193",25,6,372,6,372,0,0,11488.44616,8.913201000001209,333.88678208867907,0
"147.32.84.165",2994,"98.139.54.60",25,6,372,6,372,0,0,11488.746484,8.912731000000349,333.9043891260584,0
"147.32.84.165",2995,"98.139.175.224",25,6,372,6,372,0,0,11488.847073,8.912474999999176,333.91398012339727,0
"147.32.84.165",2996,"205.188.159.42",25,6,372,6,372,0,0,11488.947015,8.91363900000033,333.87037549982557,0
"147.32.84.165",2982,"65.54.188.72",25,6,372,6,372,0,0,11492.65202,8.913069000000178,333.8917268563657,0
"147.32.84.165",2980,"174.133.57.141",80,17,3489,12,1428,5,2061,11494.554935,2.0205490000007558,5653.9089128725545,8160.158451982027
"147.32.84.165",2998,"74.125.93.27",25,6,372,6,372,0,0,11494.555074,8.912755999999717,333.9034525347821,0
"147.32.84.165",2984,"212.117.174.7",4506,6,372,6,372,0,0,11494.708406,8.85946100000001,335.9120831391432,0
"147.32.84.165",2989,"200.29.244.194",6667,6,372,6,372,0,0,11497.860319,9.012760999999955,330.19848190804294,0
"147.32.84.165",2999,"74.125.159.27",25,6,372,6,372,0,0,11499.061293,9.013030999998591,330.1885902756204,0
"147.32.84.165",3000,"209.85.225.27",25,6,372,6,372,0,0,11506.87315,9.013210000000981,330.1820328162415,0
"147.32.84.165",3004,"66.94.238.147",25,6,372,6,372,0,0,11509.37683,9.012728000001516,330.19969092593266,0
"147.32.84.165",3005,"72.4.117.21",25,6,372,6,372,0,0,11509.677218,9.01263999999901,330.20291501716775,0
"147.32.84.165",3006,"64.12.139.193",25,6,372,6,372,0,0,11509.776894,9.013060999999652,330.1874912418894,0
"147.32.84.165",3007,"206.46.232.11",25,6,372,6,372,0,0,11509.877751,9.012753000000885,330.1987750024557,0
"147.32.84.165",3008,"212.77.101.4",25,6,372,6,372,0,0,11513.58218,9.012935000000653,330.19210723252576,0
"147.32.84.165",2982,"212.117.174.7",4506,6,372,6,372,0,0,11515.485288,9.012587999999596,330.204820191507,0
"147.32.84.165",3009,"205.188.146.193",25,6,372,6,372,0,0,11515.48542,9.01257699999951,330.2052232119805,0
"147.32.84.165",3010,"209.85.143.27",25,6,372,6,372,0,0,11515.585025,9.013010999999096,330.1893229687946,0
"147.32.84.165",2998,"212.42.113.170",6667,6,372,6,372,0,0,11518.890186,9.012747999999192,330.19895818681124,0
"147.32.84.165",2984,"173.192.170.88",80,23,4315,18,3724,5,591,11520.091885,14.421813999999358,2065.759550081656,327.8367062562456
"147.32.84.165",3011,"82.99.162.137",25,6,372,6,372,0,0,11520.29267,9.01302399999986,330.1888467178215,0
"147.32.84.165",2999,"212.117.174.7",4506,6,372,6,372,0,0,11527.903267,9.012630000001081,330.20328139506927,0
"147.32.84.165",3012,"209.85.225.27",25,6,372,6,372,0,0,11530.406521,9.012837999998737,330.1956609006416,0
"147.32.84.165",3013,"69.89.31.171",25,6,372,6,372,0,0,11530.706917,9.012993000000279,330.18998239540497,0
"147.32.84.165",3014,"98.139.175.224",25,6,372,6,372,0,0,11530.80705,9.012962000000698,330.19111808080066,0
"147.32.84.165",3015,"64.12.139.193",25,6,372,6,372,0,0,11530.907685,9.01274899999953,330.1989215499239,0
"147.32.84.165",3016,"98.139.54.60",25,6,372,6,372,0,0,11534.614378,9.011585000000196,330.2415723759955,0
"147.32.84.165",3017,"64.12.90.98",25,6,372,6,372,0,0,11536.515173,9.013608000001113,330.16745347696866,0
"147.32.84.165",3018,"74.125.43.27",25,6,372,6,372,0,0,11536.615644,9.01311700000042,330.1854397318776,0
"147.32.84.165",3009,"118.136.111.104",6667,6,372,6,372,0,0,11539.920262,9.013437999999951,330.1736806754555,0
"147.32.84.165",3020,"209.85.143.27",25,6,372,6,372,0,0,11541.322383,9.012657999999647,330.20225553883404,0
"147.32.84.165",3021,"209.85.225.27",25,6,372,6,372,0,0,11548.934035,9.012765999999829,330.1982987242825,0
"147.32.84.165",3022,"98.139.175.224",25,6,372,6,372,0,0,11548.934095,9.013041999998677,330.1881872957473,0
"147.32.84.165",3023,"98.139.54.60",25,6,372,6,372,0,0,11548.934152,9.01305499999944,330.1877110480503,0
"147.32.84.165",3024,"207.115.37.23",25,6,372,6,372,0,0,11548.934211,9.01306300000033,330.1874179732119,0
"147.32.84.165",3025,"205.188.59.194",25,6,372,6,372,0,0,11551.438167,9.011812000000646,330.2332538672341,0
"147.32.84.165",3026,"130.94.124.172",25,6,372,6,372,0,0,11551.737405,9.012527999999293,330.2070184969449,0
"147.32.84.165",3027,"76.96.62.116",25,6,372,6,372,0,0,11551.837475,9.012672999999268,330.20170597560144,0
"147.32.84.165",3029,"209.85.143.27",25,6,372,6,372,0,0,11551.9382,9.012697000000117,330.200826678181,0
"147.32.84.165",3030,"209.85.225.27",25,6,372,6,372,0,0,11551.93823,9.012716999999611,330.20009393395225,0
"147.32.84.165",3015,"212.117.174.7",4506,6,372,6,372,0,0,11555.644617,8.911191999999573,333.9620558057937,0
"147.32.84.165",3016,"212.117.174.7",4506,6,372,6,372,0,0,11557.546039,8.91213499999867,333.9267190185566,0
"147.32.84.165",3031,"98.139.54.60",25,6,372,6,372,0,0,11557.546219,8.912050999999337,333.92986642471203,0
"147.32.84.165",3032,"211.43.197.164",25,6,372,6,372,0,0,11557.645565,8.913077999999587,333.89138970848654,0
"147.32.84.165",3018,"75.30.247.238",6667,9,603,6,372,3,231,11560.950764,1.6123139999999694,1845.794305575748,1146.1787220107467
"147.32.84.165",3033,"207.69.189.40",25,6,372,6,372,0,0,11562.352741,8.91233899999861,333.91907556483926,0
"147.32.84.165",3035,"205.188.59.194",25,6,372,6,372,0,0,11562.563348,8.901961999999912,334.3083243896154,0
"147.32.84.165",3037,"64.12.90.65",25,6,372,6,372,0,0,11562.56344,8.90201100000013,334.30648423147943,0
"147.32.84.165",3038,"98.137.54.237",25,6,372,6,372,0,0,11569.863422,9.012628999998924,330.20331803299075,0
"147.32.84.165",3040,"72.52.221.166",25,6,372,6,372,0,0,11572.366763,9.012962000000698,330.19111808080066,0
"147.32.84.165",3025,"190.190.120.89",6667,6,372,6,372,0,0,11572.667214,9.013163000001441,330.1837545819957,0
"147.32.84.165",3042,"209.85.225.27",25,6,372,6,372,0,0,11572.76735,9.0128509999995,330.19518463138525,0
"147.32.84.165",3043,"98.139.54.60",25,6,372,6,372,0,0,11572.767459,9.01287499999853,330.1943053687625,0
"147.32.84.165",3044,"195.130.137.67",25,6,372,6,372,0,0,11572.767489,9.012902000000395,330.1933162038009,0
"147.32.84.165",3045,"205.188.59.194",25,6,372,6,372,0,0,11572.867567,9.014788000000408,330.12423586665216,0
"147.32.84.165",3047,"74.125.93.27",25,6,372,6,372,0,0,11576.572678,9.013065999999526,330.1873080703233,0
"147.32.84.165",3048,"65.55.88.22",25,6,372,6,372,0,0,11578.475685,9.012862999999925,330.1947449994552,0
"147.32.84.165",3049,"168.95.5.36",25,6,372,6,372,0,0,11578.575738,9.013033999999607,330.18848037188474,0
"147.32.84.165",3051,"64.12.139.193",25,6,372,6,372,0,0,11583.282437,9.014562000000296,330.1325122618162,0
"147.32.84.165",3052,"205.188.59.194",25,6,372,6,372,0,0,11583.48272,9.013160000000425,330.1838644825854,0
"147.32.84.165",3053,"209.85.143.27",25,6,372,6,372,0,0,11583.482864,9.013151000001017,330.1841941846602,0
"147.32.84.165",3025,"212.117.174.7",4506,6,372,6,372,0,0,11590.893363,9.013115000001562,330.18551299961047,0
"147.32.84.165",3037,"174.133.57.141",80,17,3489,12,1428,5,2061,11593.397231,3.274156999999832,3489.1423960428856,5035.800054792989
"147.32.84.165",3054,"65.55.37.72",25,6,372,6,372,0,0,11593.559193,8.951050000001487,332.47496103803525,0
"147.32.84.165",3040,"41.233.20.42",6667,6,372,6,372,0,0,11593.79762,9.013081000000966,330.18675855677776,0
"147.32.84.165",3055,"72.14.164.85",25,6,372,6,372,0,0,11593.897929,9.012909999999465,330.1930231190788,0
"147.32.84.165",3042,"67.195.168.31",25,6,372,6,372,0,0,11595.199948,9.012697000000117,330.200826678181,0
"147.32.84.165",3057,"98.139.54.60",25,6,372,6,372,0,0,11597.604507,9.011564000000362,330.2423419508401,0
"147.32.84.165",3047,"173.192.170.88",80,42,7362,28,2576,14,4786,11599.50584,56.783612999999605,362.92160556955304,674.2790389192083
"147.32.84.165",3058,"209.85.225.27",25,6,372,6,372,0,0,11599.605993,9.01341500000126,330.1745231967666,0
"147.32.84.165",3059,"212.77.101.4",25,6,372,6,372,0,0,11604.31285,9.012763999999152,330.1983719977889,0
"147.32.84.165",3063,"64.12.90.65",25,6,372,6,372,0,0,11604.512924,9.012994999999137,330.18990912568853,0
"147.32.84.165",3040,"174.133.57.141",80,17,3489,12,1428,5,2061,11608.71978,4.798831000000064,2380.579770364876,3435.8367694131716
"147.32.84.165",3064,"205.188.159.42",25,6,372,6,372,0,0,11608.874764,8.957736000000295,332.22680373700473,0
"147.32.84.165",3065,"208.65.144.13",25,6,372,6,372,0,0,11611.923615,9.013092000001052,330.1863555813757,0
"147.32.84.165",3066,"65.55.92.168",25,6,372,6,372,0,0,11614.527333,9.01321199999984,330.1819595500531,0
"147.32.84.165",3040,"78.138.22.163",6667,6,372,6,372,0,0,11614.928202,9.012730000000374,330.1996176519075,0
"147.32.84.165",3067,"98.139.54.60",25,6,372,6,372,0,0,11616.229914,9.012967000000572,330.1909349052106,0
"147.32.84.165",3068,"66.94.237.64",25,6,372,6,372,0,0,11616.23005,9.012956999999005,330.19130125666067,0
"147.32.84.165",3069,"209.85.225.27",25,6,372,6,372,0,0,11616.230117,9.01293700000133,330.19203396179967,0
"147.32.84.165",3070,"207.109.18.203",25,6,372,6,372,0,0,11616.230171,9.01293700000133,330.19203396179967,0
"147.32.84.165",3055,"212.117.174.7",4506,6,372,6,372,0,0,11618.633372,9.012958999999682,330.1912279862923,0
"147.32.84.165",3054,"65.54.188.72",25,6,372,6,372,0,0,11620.636401,9.012743000001137,330.19914137123675,0
"147.32.84.165",3073,"205.188.146.193",25,6,372,6,372,0,0,11625.342897,8.912870000000112,333.8991817450454,0
"147.32.84.165",3074,"98.139.175.224",25,6,372,6,372,0,0,11625.543162,8.91285500000049,333.8997436848054,0
"147.32.84.165",3075,"98.139.54.60",25,6,372,6,372,0,0,11629.849469,8.91273000000001,333.9044265898323,0
"147.32.84.165",3076,"64.12.90.65",25,6,372,6,372,0,0,11632.954224,8.912624000000505,333.9083977961856,0
"147.32.84.165",3077,"209.85.225.27",25,6,372,6,372,0,0,11635.457481,9.013520000000426,330.17067693862765,0
"147.32.84.165",3078,"202.137.234.30",25,6,372,6,372,0,0,11637.16036,9.012421999999788,330.21090224138084,0
"147.32.84.165",3079,"76.96.62.116",25,6,372,6,372,0,0,11637.160519,9.012387000000672,330.2121846298631,0
"147.32.84.165",3081,"205.188.103.1",25,6,372,6,372,0,0,11637.260157,9.012808999999834,330.1967233522928,0
"147.32.84.165",3068,"212.117.174.7",4506,6,372,6,372,0,0,11639.563332,9.012960000000021,330.19119135112027,0
"147.32.84.165",3082,"98.139.54.60",25,6,372,6,372,0,0,11641.56625,9.013612000000649,330.16730695749783,0
"147.32.84.165",3083,"205.188.59.194",25,6,372,6,372,0,0,11641.566381,9.013568999998824,330.1688820488741,0
"147.32.84.165",3084,"98.139.175.224",25,6,372,6,372,0,0,11646.2731,9.012729000000036,330.1996542889494,0
"147.32.84.165",3086,"216.32.181.178",25,6,372,6,372,0,0,11646.27316,9.012801999999283,330.1969798071939,0
"147.32.84.165",3087,"209.85.225.27",25,6,372,6,372,0,0,11646.473213,9.0154050000001,330.10164268826156,0
"147.32.84.165",3088,"94.245.120.86",25,6,372,6,372,0,0,11646.473347,9.015394000000015,330.1020454569146,0
"147.32.84.165",3089,"205.188.103.1",25,6,372,6,372,0,0,11650.779932,9.012699000000794,330.2007534035851,0
"147.32.84.165",3090,"65.254.254.50",25,6,372,6,372,0,0,11650.780068,9.012693000000581,330.2009732274036,0
"147.32.84.165",3091,"205.188.159.42",25,6,372,6,372,0,0,11653.883991,9.012939000000188,330.19196069117277,0
"147.32.84.165",3076,"212.117.174.7",4506,6,372,6,372,0,0,11656.487696,9.01312499999949,330.1851466611379,0
"147.32.84.165",2765,"212.117.171.138",65500,14,846,10,604,4,242,11656.487799,58.352514999998675,82.80705638823125,33.17766166548338
"147.32.84.165",3092,"67.69.240.20",25,6,372,6,372,0,0,11656.510846,8.99010200000157,331.03072690381936,0
"147.32.84.165",3093,"98.139.54.60",25,6,372,6,372,0,0,11658.190021,9.01303899999948,330.1882971992212,0
"147.32.84.165",3094,"98.137.54.238",25,6,372,6,372,0,0,11658.19016,9.01302399999986,330.1888467178215,0
"147.32.84.165",3096,"209.85.225.27",25,6,372,6,372,0,0,11658.290146,9.012973000000784,330.1907150947574,0
"147.32.84.165",3078,"74.125.127.27",25,6,372,6,372,0,0,11660.593521,9.012987000000066,330.1902022048826,0
"147.32.84.165",3097,"209.85.143.27",25,6,372,6,372,0,0,11662.59664,9.012705999999525,330.20049694288895,0
"147.32.84.165",3099,"65.55.37.72",25,6,372,6,372,0,0,11667.303258,9.012892000000647,330.1936825604685,0
"147.32.84.165",3100,"74.6.136.65",25,6,372,6,372,0,0,11667.503399,9.013010000000577,330.18935960348534,0
"147.32.84.165",3088,"212.117.174.7",4506,6,372,6,372,0,0,11671.8096,9.009592999998858,330.3145880175028,0
"147.32.84.165",3101,"207.115.37.23",25,6,372,6,372,0,0,11674.914185,9.015204999999696,330.108965908163,0
"147.32.84.165",3090,"98.126.71.122",80,18,4863,14,1430,4,3433,11677.517948,17.465910999999323,654.9901691357778,1572.4344410091787
"147.32.84.165",3102,"205.188.159.42",25,6,372,6,372,0,0,11677.692667,8.948116000001392,332.58397633641954,0
"147.32.84.165",3076,"95.100.248.97",80,23,7905,16,3984,7,3921,11679.213711,15.770368999999846,2021.005342360747,1989.0466735432954
"147.32.84.165",3104,"64.12.90.65",25,6,372,6,372,0,0,11679.213852,9.0316729999995,329.50705810542127,0
"147.32.84.165",3105,"66.94.237.64",25,6,372,6,372,0,0,11679.214788,9.030862999999954,329.53661239241643,0
"147.32.84.165",3106,"216.99.131.39",25,6,372,6,372,0,0,11679.314822,9.031106999998883,329.5277090616209,0
"147.32.84.165",3093,"195.113.232.96",80,13,2792,10,1770,3,1022,11681.62099,13.363276000000042,1059.620410444262,611.8260223017152
"147.32.84.165",3107,"209.85.225.27",25,6,372,6,372,0,0,11681.621803,8.930657999999312,333.2341245180623,0
"147.32.84.165",3078,"212.117.174.7",4506,6,372,6,372,0,0,11683.628804,8.931877999999415,333.1886082635919,0
"147.32.84.165",3108,"98.139.54.60",25,6,372,6,372,0,0,11683.628907,8.931940999998915,333.1862581716966,0
"147.32.84.165",3109,"207.115.37.23",25,6,372,6,372,0,0,11688.346063,8.939849999998842,332.8914914680208,0
"147.32.84.165",3110,"205.188.59.194",25,6,372,6,372,0,0,11688.346124,8.939915000000838,332.88907109292666,0
"147.32.84.165",3111,"67.195.168.31",25,6,372,6,372,0,0,11688.546716,8.939453999999387,332.9062378977736,0
"147.32.84.165",3112,"98.139.175.224",25,6,372,6,372,0,0,11692.761001,9.031243999999788,329.5227102711509,0
"147.32.84.165",3076,"61.17.216.13",6667,6,372,6,372,0,0,11695.883983,9.013046000000031,330.188040757807,0
"147.32.84.165",3113,"209.85.225.27",25,6,372,6,372,0,0,11698.588697,9.012149000000136,330.22090513593986,0
"147.32.84.165",3114,"205.188.190.1",25,6,372,6,372,0,0,11698.58883,9.012068,330.2238731443216,0
"147.32.84.165",3102,"173.192.170.88",80,22,2782,18,2536,4,246,11700.190574,45.46571099999892,446.2263880575954,43.28536729580775
"147.32.84.165",3115,"65.55.92.184",25,6,372,6,372,0,0,11700.190713,9.01245899999958,330.20954658436045,0
"147.32.84.165",3116,"205.188.159.42",25,6,372,6,372,0,0,11700.290724,9.012504000000263,330.20789782727564,0
"147.32.84.165",3117,"180.222.96.138",25,6,372,6,372,0,0,11702.593714,9.012606000000233,330.2041607055632,0
"147.32.84.165",3106,"212.117.174.7",4506,6,372,6,372,0,0,11703.395415,9.012241999998878,330.2174974884574,0
"147.32.84.165",3119,"168.95.5.39",25,6,372,6,372,0,0,11704.596328,9.013049000001047,330.1879308544372,0
"147.32.84.165",3120,"98.139.54.60",25,6,372,6,372,0,0,11709.303368,9.013200999999754,330.18236251472496,0
"147.32.84.165",3121,"209.85.225.27",25,6,372,6,372,0,0,11709.503404,9.012980000001335,330.1904586495875,0
"147.32.84.165",3122,"209.85.143.27",25,6,372,6,372,0,0,11713.80988,9.01312599999983,330.1851100273153,0
"147.32.84.165",3112,"212.117.174.7",4506,6,372,6,372,0,0,11718.616808,9.01271799999995,330.2000572968129,0
"147.32.84.165",2765,"212.117.171.138",65500,14,846,10,604,4,242,11718.616986,39.10675599999922,123.55921314465705,49.5055125513361
"147.32.84.165",3123,"64.12.90.1",25,6,372,6,372,0,0,11718.639768,8.989887000001545,331.038643755977,0
"147.32.84.165",3124,"199.247.52.2",25,6,372,6,372,0,0,11719.618283,9.012930000000779,330.19229040941656,0
"147.32.84.165",3126,"184.154.227.7",25,6,372,6,372,0,0,11721.220923,9.012192000000141,330.2193295482335,0
"147.32.84.165",3127,"98.137.54.237",25,6,372,6,372,0,0,11721.32102,9.012249000001248,330.2172410016177,0
"147.32.84.165",3129,"194.2.0.80",25,6,372,6,372,0,0,11723.62368,9.012979999999516,330.19045864965415,0
"147.32.84.165",3130,"209.85.225.27",25,6,372,6,372,0,0,11724.424798,9.012980999999854,330.1904220146529,0
"147.32.84.165",3131,"98.139.54.60",25,6,372,6,372,0,0,11724.42493,9.01297599999998,330.19060518967393,0
"147.32.84.165",3132,"205.188.59.194",25,6,372,6,372,0,0,11724.42499,9.012971000000107,330.1907883648982,0
"147.32.84.165",3134,"205.188.190.1",25,6,372,6,372,0,0,11725.626552,9.013345999999729,330.17705078669894,0
"147.32.84.165",3119,"125.99.28.64",6667,4,248,4,248,0,0,11730.333406,3.0043930000010732,660.3663368937723,0
"147.32.84.165",3135,"209.85.143.27",25,6,372,6,372,0,0,11730.533545,9.013160999998945,330.18382784911404,0
"147.32.84.165",3136,"209.85.143.27",25,6,372,6,372,0,0,11730.53368,9.01315699999941,330.18397438324826,0
"147.32.84.165",3138,"66.94.237.64",25,6,372,6,372,0,0,11730.533738,9.013161999999284,330.1837912155841,0
"147.32.84.165",3139,"98.137.54.237",25,6,372,6,372,0,0,11734.839827,9.012942999999723,330.19181414994983,0
"147.32.84.165",3140,"74.6.136.244",25,6,372,6,372,0,0,11734.839964,9.012934999998834,330.1921072325924,0
"147.32.84.165",3141,"98.139.54.60",25,6,372,6,372,0,0,11739.646833,8.912932999999612,333.8968216186669,0
"147.32.84.165",3142,"209.85.225.27",25,6,372,6,372,0,0,11740.648644,8.91244899999947,333.9149542398702,0
"147.32.84.165",3143,"64.12.90.1",25,6,372,6,372,0,0,11742.250679,8.9129269999994,333.89704639117997,0
"147.32.84.165",3146,"202.108.252.141",25,6,372,6,372,0,0,11742.35101,8.912603999999192,333.9091470910488,0
"147.32.84.165",3124,"174.133.57.141",80,16,3429,12,1428,4,2001,11744.656687,0.47046299999965413,24282.46217026291,34026.05518396084
"147.32.84.165",3149,"64.12.90.65",25,6,372,6,372,0,0,11744.812572,8.854510999999547,336.0998704502318,0
"147.32.84.165",3150,"200.108.130.17",25,6,372,6,372,0,0,11745.455182,9.013629999999466,330.16664762145507,0
"147.32.84.165",3129,"173.192.170.88",80,6,372,6,372,0,0,11746.656776,8.91285600000083,333.8997062220823,0
"147.32.84.165",3151,"92.103.191.5",25,6,372,6,372,0,0,11749.260628,9.013270999999804,330.17979821088977,0
"147.32.84.165",3152,"98.139.54.60",25,6,372,6,372,0,0,11751.463972,9.012907000000268,330.19313302577194,0
"147.32.84.165",3159,"205.188.159.42",25,6,372,6,372,0,0,11751.464114,9.01288999999997,330.19375583192624,0
"147.32.84.165",3160,"209.85.143.27",25,6,372,6,372,0,0,11755.769867,9.013151999999536,330.1841575511157,0
"147.32.84.165",3140,"61.17.216.66",6667,4,248,4,248,0,0,11760.577056,3.0042990000001737,660.3869987640662,0
"147.32.84.165",3161,"207.69.189.218",25,6,372,6,372,0,0,11761.578915,9.012536000000182,330.2067253878309,0
"147.32.84.165",2765,"212.117.171.138",65500,14,846,10,604,4,242,11763.180794,1.4242030000004888,3392.774765955655,1359.3567770881928
"147.32.84.165",3162,"205.188.190.1",25,6,372,6,372,0,0,11763.203341,8.990162000000055,331.02851761736684,0
"147.32.84.165",3163,"194.134.42.41",25,6,372,6,372,0,0,11763.281075,9.012500999999247,330.20800774393797,0
"147.32.84.165",2765,"212.117.171.138",65500,23,1407,16,972,7,435,11765.684267,2.339905999999246,3323.2104195649335,1487.239230978134
"147.32.84.165",3146,"212.117.174.7",4506,6,372,6,372,0,0,11765.707124,8.990278999999646,331.02420959350843,0
"147.32.84.165",3164,"98.139.54.60",25,6,372,6,372,0,0,11766.485459,9.013356000001295,330.1766844668703,0
"147.32.84.165",3165,"217.19.237.56",25,6,372,6,372,0,0,11767.58711,9.012919999999212,330.19265676387454,0
"147.32.84.165",3129,"212.117.171.138",65500,14,846,10,604,4,242,11770.290837,21.06231200000002,229.41451061972663,91.91773438737391
"147.32.84.165",3166,"216.32.181.178",25,6,372,6,372,0,0,11770.313847,8.990116000000853,331.0302114010228,0
"147.32.84.165",3167,"209.85.143.27",25,6,372,6,372,0,0,11772.495371,9.01160499999969,330.2408394509194,0
"147.32.84.165",3168,"75.126.136.141",25,6,372,6,372,0,0,11772.495514,9.011586000000534,330.2415357296511,0
"147.32.84.165",3169,"205.188.146.193",25,6,372,6,372,0,0,11776.800284,9.01317999999992,330.18313181363584,0
"147.32.84.165",3170,"209.85.143.27",25,6,372,6,372,0,0,11780.505572,9.013118000000759,330.18540309799,0
"147.32.84.165",3172,"199.43.38.110",25,6,372,6,372,0,0,11782.609141,9.012399999999616,330.2117083130051,0
"147.32.84.165",3173,"66.94.237.64",25,6,372,6,372,0,0,11784.210939,9.013214999999036,330.1818496507981,0
"147.32.84.165",3174,"209.85.143.27",25,6,372,6,372,0,0,11784.311141,9.013240000000224,330.18093382622965,0
"147.32.84.165",3175,"64.12.139.193",25,6,372,6,372,0,0,11784.311277,9.013227999999799,330.18137342138317,0
"147.32.84.165",3176,"74.6.136.65",25,6,372,6,372,0,0,11786.714534,9.012967999999091,330.1908982701703,0
"147.32.84.165",3177,"205.188.59.194",25,6,372,6,372,0,0,11787.515622,9.013698999999178,330.1641201908641,0
"147.32.84.165",3178,"98.139.175.224",25,6,372,6,372,0,0,11788.618526,9.01177699999971,330.23453642939626,0
"147.32.84.165",3165,"212.117.174.7",4506,6,372,6,372,0,0,11791.321444,9.013058000000456,330.18760114489993,0
"147.32.84.165",3164,"196.28.244.30",6667,4,248,4,248,0,0,11793.524429,3.0047580000009475,660.2861195475224,0
"147.32.84.165",3167,"174.133.57.141",80,16,3429,12,1428,4,2001,11797.830523,0.4731919999994716,24142.419990221213,33829.819608146114
"147.32.84.165",3179,"199.200.24.199",25,6,372,6,372,0,0,11797.985253,8.95835199999965,332.2039589424613,0
"147.32.84.165",3129,"212.117.171.138",65500,11,666,8,484,3,182,11801.535844,303.78227100000004,12.745970945750154,4.792906430013487
"147.32.84.165",3180,"62.141.94.155",25,6,372,6,372,0,0,11801.558637,8.990523000000394,331.01522569931353,0
"147.32.84.165",3181,"209.85.143.27",25,6,372,6,372,0,0,11803.639322,9.012754999999743,330.1987017288371,0
"147.32.84.165",3182,"209.85.143.27",25,6,372,6,372,0,0,11805.240994,9.013076000001092,330.18694172773417,0
"147.32.84.165",3183,"205.188.59.194",25,6,372,6,372,0,0,11805.241126,9.013068999998723,330.18719816750786,0
"147.32.84.165",3184,"98.139.54.60",25,6,372,6,372,0,0,11805.241182,9.013065000001006,330.18734470456695,0
"147.32.84.165",3185,"64.12.139.193",25,6,372,6,372,0,0,11805.341323,9.012932999999975,330.19218050328436,0
"147.32.84.165",3174,"212.117.174.7",4506,6,372,6,372,0,0,11807.744795,9.012944999998581,330.1917408794205,0
"147.32.84.165",3186,"165.21.74.115",25,6,372,6,372,0,0,11807.74493,9.012920999999551,330.1926201283855,0
"147.32.84.165",3176,"174.133.57.141",80,17,3489,12,1428,5,2061,11808.545827,1.8951759999999922,6027.936191678265,8699.983537149092
"147.32.84.165",3188,"203.198.189.146",25,6,372,6,372,0,0,11808.703996,8.95490400000017,332.3318708944221,0
"147.32.84.165",3189,"206.54.145.17",25,6,372,6,372,0,0,11809.647892,8.912286999999196,333.9210238629286,0
"147.32.84.165",3177,"114.57.53.106",6667,6,372,6,372,0,0,11811.150033,8.912503999999899,333.9128936155354,0
"147.32.84.165",3192,"209.85.143.27",25,6,372,6,372,0,0,11812.35145,8.91271400000005,333.90502601115475,0
"147.32.84.165",3193,"205.188.159.42",25,6,372,6,372,0,0,11812.351583,8.912705000000642,333.9053631865731,0
"147.32.84.165",3165,"173.192.170.88",80,18,2154,14,1626,4,528,11818.860577,13.680427999999665,950.8474442466506,308.76226971846955
"147.32.84.165",3179,"174.133.57.141",80,17,3489,12,1428,5,2061,11822.065821,3.1458540000003268,3631.446341756106,5241.184110895892
"147.32.84.165",3194,"209.85.143.27",25,6,372,6,372,0,0,11822.22802,8.950692999998864,332.48822186174607,0
"147.32.84.165",3196,"74.220.207.63",25,6,372,6,372,0,0,11822.228089,8.950762000000395,332.48565876289285,0
"147.32.84.165",3197,"65.55.92.168",25,6,372,6,372,0,0,11822.466112,9.012598999999682,330.2044171720172,0
"147.32.84.165",3198,"199.84.53.8",25,6,372,6,372,0,0,11824.569105,9.013089000000036,330.18646548369685,0
"147.32.84.165",3199,"128.121.85.2",25,6,372,6,372,0,0,11826.171106,9.013135000001057,330.18478032334485,0
"147.32.84.165",3200,"64.12.90.65",25,6,372,6,372,0,0,11826.271222,9.013033000001087,330.1885170063885,0
"147.32.84.165",3182,"212.117.174.7",4506,6,372,6,372,0,0,11828.674842,9.012848000000304,330.1952945395173,0
"147.32.84.165",3201,"209.85.143.27",25,6,372,6,372,0,0,11829.575991,9.01306199999999,330.1874546075466,0
"147.32.84.165",3202,"64.12.139.193",25,6,372,6,372,0,0,11830.577966,9.012408999999025,330.2113785559801,0
"147.32.84.165",3204,"98.139.175.224",25,6,372,6,372,0,0,11832.179699,9.012942999999723,330.19181414994983,0
"147.32.84.165",3205,"65.54.188.94",25,6,372,6,372,0,0,11833.281545,9.013269000000946,330.179871476119,0
"147.32.84.165",3206,"216.32.180.22",25,6,372,6,372,0,0,11843.195776,9.01338399999986,330.17565877588777,0
"147.32.84.165",3207,"64.12.90.33",25,6,372,6,372,0,0,11843.496218,9.01306300000033,330.1874179732119,0
"147.32.84.165",3208,"209.85.143.27",25,6,372,6,372,0,0,11845.599655,9.012557000000015,330.2059559789741,0
"147.32.84.165",3209,"65.55.88.22",25,6,372,6,372,0,0,11845.599757,9.012504000000263,330.20789782727564,0
"147.32.84.165",3210,"209.85.143.27",25,6,372,6,372,0,0,11847.201632,9.013058999998975,330.1875645105994,0
"147.32.84.165",3211,"65.54.188.110",25,6,372,6,372,0,0,11847.201767,9.012974999999642,330.19064182471584,0
"147.32.84.165",3212,"205.188.190.1",25,6,372,6,372,0,0,11847.301672,9.012979000000996,330.1904952845969,0
"147.32.84.165",3198,"173.192.170.88",80,23,4003,18,3412,5,591,11849.705398,17.73589600000014,1539.0257137276733,266.5780178232869
"147.32.84.165",3213,"74.125.45.27",25,6,372,6,372,0,0,11849.906271,9.012543000000733,330.20646891779137,0
"147.32.84.165",3214,"205.188.59.193",25,6,372,6,372,0,0,11850.606473,9.012795000000551,330.1972362624267,0
"147.32.84.165",3201,"147.32.84.171",139,33,4810,22,3278,11,1532,11851.607938,0.015530000000580912,1688602.7043798498,789182.2279163911
"147.32.84.165",3215,"207.115.37.23",25,6,372,6,372,0,0,11851.608139,9.015634999999747,330.0932213870774,0
"147.32.84.165",3216,"209.85.143.27",25,6,372,6,372,0,0,11853.210131,9.012904999999591,330.1932062969858,0
"147.32.84.165",3204,"212.117.174.7",4506,6,372,6,372,0,0,11854.311615,9.01317299999937,330.183388247425,0
"147.32.84.165",3218,"205.188.103.1",25,6,372,6,372,0,0,11864.225934,9.013182000000597,330.18305854689305,0
"147.32.84.165",3219,"74.6.136.244",25,6,372,6,372,0,0,11864.526251,9.01290599999993,330.19316966137484,0
"147.32.84.165",3220,"209.85.143.27",25,6,372,6,372,0,0,11866.629808,9.01256099999955,330.20580942532854,0
"147.32.84.165",3221,"205.188.190.2",25,6,372,6,372,0,0,11866.629942,9.012480999999752,330.2087405232901,0
"147.32.84.165",3222,"62.24.139.61",25,6,372,6,372,0,0,11868.23159,9.013222999999925,330.1815565863648,0
"147.32.84.165",3223,"209.85.143.27",25,6,372,6,372,0,0,11868.331685,9.013256000000183,330.18034770120136,0
"147.32.84.165",3224,"205.188.190.1",25,6,372,6,372,0,0,11868.331817,9.013246999998955,330.18067739631954,0
"147.32.84.165",3198,"212.117.174.7",4506,6,372,6,372,0,0,11870.935415,9.013659000000189,330.1655853632734,0
"147.32.84.165",3211,"84.40.69.185",6667,9,552,6,372,3,180,11870.935547,1.024295000001075,2905.4129913715055,1405.844995824922
"147.32.84.165",3225,"209.85.143.27",25,6,372,6,372,0,0,11871.636836,9.013461000000461,330.17283815837754,0
"147.32.84.165",3226,"68.6.19.3",25,6,372,6,372,0,0,11871.636972,9.013445999999021,330.17338762558995,0
"147.32.84.165",3227,"74.6.136.244",25,6,372,6,372,0,0,11871.960103,8.9897660000006,331.0430994532896,0
"147.32.84.165",3228,"62.24.202.3",25,6,372,6,372,0,0,11871.960167,8.98982800000158,331.0408163537141,0
"147.32.84.165",3211,"173.192.170.88",80,15,1531,12,1094,3,437,11872.63856,30.541417000000365,286.56168769117346,114.46751144519452
"147.32.84.165",3229,"205.188.156.193",25,6,372,6,372,0,0,11874.240414,9.013322999999218,330.17789332527616,0
"147.32.84.165",3230,"209.85.143.27",25,6,372,6,372,0,0,11875.34191,9.012857000001532,330.19496481520724,0
"147.32.84.165",3231,"74.125.159.27",25,6,372,6,372,0,0,11881.852354,8.911751999999979,333.9410701734078,0
"147.32.84.165",3232,"193.252.22.185",25,6,372,6,372,0,0,11885.256144,8.912750999999844,333.903639852617,0
"147.32.84.165",3234,"64.12.90.65",25,6,372,6,372,0,0,11885.556592,8.913083999999799,333.89116494358933,0
"147.32.84.165",3235,"209.85.143.27",25,6,372,6,372,0,0,11887.660187,9.012781000001269,330.197749174154,0
"147.32.84.165",3236,"74.6.136.244",25,6,372,6,372,0,0,11887.660282,9.012816999998904,330.1964302615222,0
"147.32.84.165",3238,"209.85.143.27",25,6,372,6,372,0,0,11889.161621,9.013202000000092,330.18232588152017,0
"147.32.84.165",3240,"212.89.224.76",25,6,372,6,372,0,0,11889.161756,9.013130999999703,330.1849268583912,0
"147.32.84.165",3242,"205.188.59.193",25,6,372,6,372,0,0,11889.261772,9.013032000000749,330.1885536409671,0
"147.32.84.165",3224,"119.154.117.193",6667,6,372,6,372,0,0,11892.566826,9.013218000000052,330.1817397515497,0
"147.32.84.165",3220,"212.117.174.7",4506,6,372,6,372,0,0,11892.867133,9.013237000001027,330.181043724875,0
"147.32.84.165",3244,"64.12.139.193",25,6,372,6,372,0,0,11895.170512,9.012822999999116,330.1962104437524,0
"147.32.84.165",3245,"208.84.67.210",25,6,372,6,372,0,0,11896.272282,9.012570000000778,330.20547968001836,0
"147.32.84.165",3230,"173.192.170.88",80,46,5753,30,2254,16,3499,11902.78122,48.692706999998336,370.3223975615202,574.8704831711442
"147.32.84.165",3246,"74.6.136.244",25,6,372,6,372,0,0,11902.781353,9.012996999999814,330.189835855938,0
"147.32.84.165",3247,"209.85.143.27",25,6,372,6,372,0,0,11902.78141,9.013004000000365,330.1895794121338,0
"147.32.84.165",3248,"65.55.88.22",25,6,372,6,372,0,0,11906.186499,9.013065000001006,330.18734470456695,0
"147.32.84.165",3250,"209.85.143.27",25,6,372,6,372,0,0,11906.486648,9.013506999999663,330.17115313718745,0
"147.32.84.165",3251,"200.147.36.15",25,6,372,6,372,0,0,11906.486727,9.013560000001235,330.1692117209618,0
"147.32.84.165",3252,"205.188.190.1",25,6,372,6,372,0,0,11908.69032,9.012580000000526,330.205113297172,0
"147.32.84.165",3253,"212.36.74.25",25,6,372,6,372,0,0,11910.191939,9.013178999999582,330.18316844701945,0
"147.32.84.165",3255,"209.85.143.27",25,6,372,6,372,0,0,11910.29253,9.01292999999896,330.1922904094832,0
"147.32.84.165",3256,"209.85.143.27",25,6,372,6,372,0,0,11910.292663,9.0128509999995,330.19518463138525,0
"147.32.84.165",3257,"98.137.54.237",25,6,372,6,372,0,0,11910.292737,9.012829000001148,330.1959906262086,0
"147.32.84.165",3258,"74.6.136.65",25,6,372,6,372,0,0,11913.898319,9.011897000000317,330.2301391149827,0
"147.32.84.165",3260,"74.6.136.244",25,6,372,6,372,0,0,11914.498215,9.012993000000279,330.18998239540497,0
"147.32.84.165",3220,"174.133.57.141",80,17,3489,12,1428,5,2061,11916.200608,2.462414000001445,4639.349841250617,6695.8683633175915
"147.32.84.165",3261,"216.32.181.178",25,6,372,6,372,0,0,11916.362266,8.951489999999467,332.45861862105386,0
"147.32.84.165",3244,"64.12.90.1",25,6,372,6,372,0,0,11917.30225,9.013471000000209,330.17247184796304,0
"147.32.84.165",3262,"205.188.103.1",25,6,372,6,372,0,0,11923.811839,9.012919999999212,330.19265676387454,0
"147.32.84.165",3220,"212.117.174.7",4506,6,372,6,372,0,0,11927.216523,9.012965000001714,330.19100817538225,0
"147.32.84.165",3263,"74.208.5.90",25,6,372,6,372,0,0,11927.518691,9.011560000000827,330.2424885369156,0
"147.32.84.165",3264,"209.85.143.27",25,6,372,6,372,0,0,11929.720083,9.013187000000471,330.18287538024504,0
"147.32.84.165",3265,"209.85.143.27",25,6,372,6,372,0,0,11931.224325,9.010809000001245,330.27001238175046,0
"147.32.84.165",3266,"206.46.232.11",25,6,372,6,372,0,0,11931.224458,9.010811000000103,330.2699390765122,0
"147.32.84.165",3267,"205.188.190.2",25,6,372,6,372,0,0,11931.324962,9.011065999999119,330.26059291989327,0
"147.32.84.165",3253,"212.117.174.7",4506,6,372,6,372,0,0,11934.928071,9.012441999999282,330.2101694524344,0
"147.32.84.165",3255,"84.25.41.150",6667,6,372,6,372,0,0,11934.928211,9.012437999999747,330.2103160099502,0
"147.32.84.165",3269,"64.12.90.65",25,6,372,6,372,0,0,11935.528497,9.012940000000526,330.1919240558382,0
"147.32.84.165",3270,"62.28.115.202",25,6,372,6,372,0,0,11937.331526,9.012747999999192,330.19895818681124,0
"147.32.84.165",3272,"67.231.144.184",25,6,372,6,372,0,0,11938.332307,9.01298399999905,330.1903121097645,0
"147.32.84.165",3273,"74.6.136.244",25,6,372,6,372,0,0,11944.842336,9.012332000000242,330.2141998319547,0
"147.32.84.165",3274,"209.85.143.27",25,6,372,6,372,0,0,11948.24671,8.912927999999738,333.8970089290621,0
"147.32.84.165",3275,"208.65.145.11",25,6,372,6,372,0,0,11948.246829,8.91293399999995,333.89678415659944,0
"147.32.84.165",3276,"124.108.110.37",25,6,372,6,372,0,0,11948.547253,8.912632999999914,333.90806061463866,0
"147.32.84.165",3277,"64.12.90.97",25,6,372,6,372,0,0,11950.750707,8.912577000000965,333.9101586443155,0
"147.32.84.165",3264,"173.192.170.88",80,16,1581,12,1084,4,497,11952.252343,80.01680599999963,108.37723265285095,49.68956146537539
"147.32.84.165",3278,"67.52.29.17",25,6,372,6,372,0,0,11952.352678,8.913196000001335,333.88696938781044,0
"147.32.84.165",3279,"209.85.143.27",25,6,372,6,372,0,0,11952.453018,8.812912999999753,337.68630190722223,0
"147.32.84.165",3266,"77.89.69.181",6667,6,372,6,372,0,0,11955.958459,8.912093000000823,333.9282927141498,0
"147.32.84.165",3265,"212.117.174.7",4506,6,372,6,372,0,0,11956.558833,8.913131000001158,333.8894042957086,0
"147.32.84.165",3280,"205.188.103.1",25,6,372,6,372,0,0,11958.261583,9.012335000001258,330.21408991117005,0
"147.32.84.165",3282,"74.125.43.27",25,6,372,6,372,0,0,11959.264491,9.011608999999225,330.2406928663079,0
"147.32.84.165",3283,"141.71.1.161",25,6,372,6,372,0,0,11965.771837,9.012942999999723,330.19181414994983,0
"147.32.84.165",3266,"212.117.174.7",4506,6,372,6,372,0,0,11969.176763,9.013060000001133,330.1875278761737,0
"147.32.84.165",3284,"209.85.143.27",25,6,372,6,372,0,0,11969.176894,9.013050999999905,330.18785758563126,0
"147.32.84.165",3285,"88.198.124.248",25,6,372,6,372,0,0,11969.176951,9.013044000001173,330.1881140266943,0
"147.32.84.165",3288,"98.137.54.237",25,6,372,6,372,0,0,11969.477832,9.012346999999863,330.2136502289631,0
"147.32.84.165",3289,"209.85.143.27",25,6,372,6,372,0,0,11971.680765,9.01259200000095,330.20467363880294,0
"147.32.84.165",3291,"64.12.139.193",25,6,372,6,372,0,0,11971.6809,9.012582999999722,330.2050033825033,0
"147.32.84.165",3293,"205.188.190.2",25,6,372,6,372,0,0,11973.282721,9.01322700000128,330.18141005430994,0
"147.32.84.165",3294,"208.100.38.50",25,6,372,6,372,0,0,11973.282861,9.013123000000633,330.1852199287407,0
"147.32.84.165",3278,"41.201.54.29",6667,9,552,6,372,3,180,11976.988312,1.077635999999984,2761.600391969129,1336.2582541786107
"147.32.84.165",3296,"72.20.52.10",25,6,372,6,372,0,0,11977.48883,9.013343999999051,330.1771240507755,0
"147.32.84.165",3297,"74.6.136.244",25,6,372,6,372,0,0,11978.066218,8.936600999999428,333.0125178465717,0
"147.32.84.165",3298,"209.85.143.27",25,6,372,6,372,0,0,11979.291497,9.013079000000289,330.1868318251626,0
"147.32.84.165",3299,"205.188.103.1",25,6,372,6,372,0,0,11980.292798,9.012883999999758,330.19397564642793,0
"147.32.84.165",3300,"205.188.190.2",25,6,372,6,372,0,0,11986.802558,9.012548000000606,330.2062857251689,0
"147.32.84.165",3303,"209.191.88.254",25,6,372,6,372,0,0,11986.802695,9.012554999999338,330.206029255879,0
"147.32.84.165",3283,"212.117.174.7",4506,6,372,6,372,0,0,11990.207457,9.012619999999515,330.20364777391706,0
"147.32.84.165",3305,"64.18.7.10",25,6,372,6,372,0,0,11990.507737,9.012754999999743,330.1987017288371,0
"147.32.84.165",3306,"74.6.136.244",25,6,372,6,372,0,0,11992.710542,9.012940999999046,330.1918874205784,0
"147.32.84.165",3308,"209.85.143.27",25,6,372,6,372,0,0,11992.710641,9.012967000000572,330.1909349052106,0
"147.32.84.165",3309,"208.65.144.12",25,6,372,6,372,0,0,11992.710672,9.01299100000142,330.19005566515386,0
"147.32.84.165",3310,"64.12.139.193",25,6,372,6,372,0,0,11994.312823,9.013122000000294,330.18525656258765,0
"147.32.84.165",3311,"98.137.54.238",25,6,372,6,372,0,0,11994.312963,9.0130079999999,330.18943287302454,0
"147.32.84.165",3289,"212.117.174.7",4506,6,372,6,372,0,0,11998.519156,9.01296100000036,330.19115471595643,0
"147.32.84.165",3312,"205.188.190.2",25,6,372,6,372,0,0,11998.519233,9.01300899999842,330.1893962383175,0
"147.32.84.165",3313,"74.6.136.244",25,6,372,6,372,0,0,11999.022301,9.010674999999537,330.274923909713,0
"147.32.84.165",3314,"64.12.90.65",25,6,372,6,372,0,0,12000.321501,9.013186000000132,330.1829120135717,0
"147.32.84.165",3316,"209.85.143.27",25,6,372,6,372,0,0,12001.323398,9.01252199999908,330.20723832910517,0
"147.32.84.165",3319,"128.242.120.13",25,6,372,6,372,0,0,12007.832311,9.01356499999929,330.1690285697429,0
"147.32.84.165",3300,"82.206.239.241",6667,4,248,4,248,0,0,12011.237278,3.007360999999946,659.7146135764996,0
"147.32.84.165",3321,"209.85.143.27",25,6,372,6,372,0,0,12011.537754,9.012823999999455,330.1961738074748,0
"147.32.84.165",3322,"208.64.101.235",25,6,372,6,372,0,0,12011.537942,9.01277200000004,330.1980789040249,0
"147.32.84.165",3324,"74.6.136.244",25,6,372,6,372,0,0,12013.740951,9.0128509999995,330.19518463138525,0
"147.32.84.165",3325,"64.12.139.193",25,6,372,6,372,0,0,12013.741082,9.012846999999965,330.19533117559985,0
"147.32.84.165",3328,"205.188.190.2",25,6,372,6,372,0,0,12013.74114,9.012844000000769,330.1954410838295,0
"147.32.84.165",3329,"209.86.93.226",25,6,372,6,372,0,0,12013.741198,9.012837000000218,330.19569753673875,0
"147.32.84.165",3330,"209.85.143.27",25,6,372,6,372,0,0,12015.343298,9.013160000000425,330.1838644825854,0
"147.32.84.165",3331,"74.6.136.244",25,6,372,6,372,0,0,12015.343431,9.013079000000289,330.1868318251626,0
"147.32.84.165",3332,"74.125.43.27",25,6,372,6,372,0,0,12015.343492,9.013069000000542,330.18719816744124,0
"147.32.84.165",3333,"64.12.139.193",25,6,372,6,372,0,0,12015.343563,9.013049999999566,330.18789422006347,0
"147.32.84.165",3334,"62.24.139.61",25,6,372,6,372,0,0,12019.549682,8.912350999999035,333.91862596079557,0
"147.32.84.165",3335,"205.188.190.2",25,6,372,6,372,0,0,12020.050238,8.91263699999945,333.9079107563995,0
"147.32.84.165",3336,"65.54.188.94",25,6,372,6,372,0,0,12021.351795,8.912803999999596,333.90165429421927,0
"147.32.84.165",3337,"209.85.143.27",25,6,372,6,372,0,0,12022.35338,8.912674999999581,333.9064871096657,0
"147.32.84.165",3338,"208.87.136.141",25,6,372,6,372,0,0,12028.762375,9.01303100000041,330.18859027555374,0
"147.32.84.165",3339,"209.85.143.27",25,6,372,6,372,0,0,12031.065764,9.01341499999944,330.17452319683326,0
"147.32.84.165",3340,"208.65.144.3",25,6,372,6,372,0,0,12031.065902,9.013413000000583,330.1745964597215,0
"147.32.84.165",3264,"173.192.170.88",80,16,1947,12,1448,4,499,12032.467745,41.440066999999544,279.536227583805,96.33189058309303
"147.32.84.165",3342,"64.12.139.193",25,6,372,6,372,0,0,12032.668421,9.013150999999198,330.18419418472683,0
"147.32.84.165",3343,"205.139.110.15",25,6,372,6,372,0,0,12032.668495,9.013199000000895,330.1824357810922,0
"147.32.84.165",3344,"65.55.37.104",25,6,372,6,372,0,0,12034.671073,9.01271000000088,330.2003503940224,0
"147.32.84.165",3346,"74.6.136.244",25,6,372,6,372,0,0,12036.273262,9.013215999999375,330.18181301770716,0
"147.32.84.165",3348,"64.58.179.14",25,6,372,6,372,0,0,12036.273411,9.013119999999617,330.1853298303059,0
"147.32.84.165",3333,"77.126.98.108",6667,6,372,6,372,0,0,12040.479807,9.01239600000008,330.2118548718868,0
"147.32.84.165",3325,"212.117.174.7",4506,6,372,6,372,0,0,12040.979982,9.013223999998445,330.18151995340554,0
"147.32.84.165",3349,"209.85.143.27",25,6,372,6,372,0,0,12042.282178,9.012737000000925,330.19936119290895,0
"147.32.84.165",3350,"64.12.90.65",25,6,372,6,372,0,0,12042.28231,9.012736999999106,330.1993611929756,0
"147.32.84.165",3351,"98.129.185.3",25,6,372,6,372,0,0,12043.283318,9.01293799999985,330.1919973265155,0
"147.32.84.165",3353,"209.85.143.27",25,6,372,6,372,0,0,12049.793266,9.01292199999989,330.1925834929046,0
"147.32.84.165",3355,"64.12.139.193",25,6,372,6,372,0,0,12052.095904,9.01292900000044,330.19232704483244,0
"147.32.84.165",3356,"205.188.190.2",25,6,372,6,372,0,0,12053.698185,9.014307000001281,330.1418511705422,0
"147.32.84.165",3342,"212.117.174.7",4506,6,372,6,372,0,0,12055.701638,9.013369999998758,330.1761716206491,0
"147.32.84.165",3357,"209.85.143.27",25,6,372,6,372,0,0,12055.701814,9.013245000000097,330.18075066193893,0
"147.32.84.165",3358,"98.137.54.238",25,6,372,6,372,0,0,12055.701893,9.013214000000517,330.1818862838305,0
"147.32.84.165",3359,"209.85.143.27",25,6,372,6,372,0,0,12057.303557,9.013082999999824,330.1866852884921,0
"147.32.84.165",3360,"64.12.90.65",25,6,372,6,372,0,0,12057.303706,9.012982999998712,330.19034874474136,0
"147.32.84.165",3361,"209.85.143.27",25,6,372,6,372,0,0,12057.303766,9.012973999999303,330.1906784597659,0
"147.32.84.165",3362,"81.255.198.177",25,6,372,6,372,0,0,12057.303823,9.012969999999768,330.19082499998075,0
"147.32.84.165",3363,"219.94.203.132",25,6,372,6,372,0,0,12057.303888,9.012956000000486,330.1913378917904,0
"147.32.84.165",3364,"209.85.143.27",25,6,372,6,372,0,0,12061.710146,9.012781999999788,330.1977125376016,0
"147.32.84.165",3367,"209.85.143.27",25,6,372,6,372,0,0,12061.710245,9.012807999999495,330.1967599886924,0
"147.32.84.165",3368,"64.12.139.193",25,6,372,6,372,0,0,12061.710274,9.012829000001148,330.1959906262086,0
"147.32.84.165",3369,"205.188.190.2",25,6,372,6,372,0,0,12061.710299,9.01285999999891,330.1948549073613,0
"147.32.84.165",3370,"66.94.237.64",25,6,372,6,372,0,0,12061.710328,9.012891000000309,330.19371919619334,0
"147.32.84.165",3371,"80.179.55.150",25,6,372,6,372,0,0,12062.010686,9.012641999999687,330.20284174164505,0
"147.32.84.165",3325,"67.195.168.31",25,6,372,6,372,0,0,12063.312084,9.016492000000653,330.0618466693903,0
"147.32.84.165",3372,"209.85.143.27",25,6,372,6,372,0,0,12064.313913,9.01259200000095,330.20467363880294,0
"147.32.84.165",3373,"218.102.53.145",25,6,372,6,372,0,0,12064.314049,9.012580999999045,330.2050766589854,0
"147.32.84.165",3350,"212.117.174.7",4506,6,372,6,372,0,0,12070.823496,9.012648999998419,330.20258527770494,0
"147.32.84.165",3374,"64.12.139.193",25,6,372,6,372,0,0,12073.126258,9.012894999999844,330.19357265340955,0
"147.32.84.165",3375,"173.193.193.4",25,6,372,6,372,0,0,12074.728889,9.012716999999611,330.20009393395225,0
"147.32.84.165",3376,"165.212.8.32",25,6,372,6,372,0,0,12076.731299,9.013737000001129,330.16272828901344,0
"147.32.84.165",3377,"77.238.184.241",25,6,372,6,372,0,0,12078.333699,9.013209999999162,330.18203281630815,0
"147.32.84.165",3378,"74.6.136.244",25,6,372,6,372,0,0,12078.333841,9.013123000000633,330.1852199287407,0
"147.32.84.165",3359,"212.117.174.7",4506,6,372,6,372,0,0,12082.7408,9.014651000001322,330.12925292388616,0
"147.32.84.165",3358,"178.150.199.9",6667,4,248,4,248,0,0,12082.740865,3.00414500000079,660.4208518561782,0
"147.32.84.165",3380,"209.85.143.27",25,6,372,6,372,0,0,12083.040755,9.01283599999988,330.1957341729107,0
"147.32.84.165",3381,"64.12.139.193",25,6,372,6,372,0,0,12084.342418,9.01289799999904,330.19346274642373,0
"147.32.84.165",3382,"64.239.199.221",25,6,372,6,372,0,0,12084.342561,9.012880000000223,330.19412218956944,0
"147.32.84.165",3383,"74.6.136.244",25,6,372,6,372,0,0,12085.343774,9.014885999999024,330.120647116372,0
"147.32.84.165",3384,"209.85.143.27",25,6,372,6,372,0,0,12085.343923,9.014863999998852,330.12145274741573,0
"147.32.84.165",3387,"74.6.136.65",25,6,372,6,372,0,0,12085.343989,9.014846000000034,330.12211190296415,0
"147.32.84.165",3388,"65.54.188.94",25,6,372,6,372,0,0,12091.854435,8.914221000000907,333.84857745838895,0
"147.32.84.165",3391,"64.98.36.4",25,6,372,6,372,0,0,12094.156448,8.912760999999591,333.90326521715735,0
"147.32.84.165",3392,"209.85.143.27",25,6,372,6,372,0,0,12095.758704,8.915481,333.80139557248793,0
"147.32.84.165",3393,"64.12.90.65",25,6,372,6,372,0,0,12095.758849,8.915476000000126,333.8015827758336,0
"147.32.84.165",3395,"83.137.242.245",25,6,372,6,372,0,0,12097.661906,9.012477000000217,330.2088870795374,0
"147.32.84.165",3396,"74.125.67.27",25,6,372,6,372,0,0,12099.264239,9.012969999999768,330.19082499998075,0
"147.32.84.165",3397,"216.82.241.131",25,6,372,6,372,0,0,12099.264333,9.012944000000061,330.1917775146478,0
"147.32.84.165",3398,"98.137.54.238",25,6,372,6,372,0,0,12102.568646,9.013269000000946,330.179871476119,0
"147.32.84.165",3399,"209.85.143.27",25,6,372,6,372,0,0,12103.971036,9.012593999999808,330.20460036256634,0
"147.32.84.165",3359,"212.117.171.138",65500,14,846,10,604,4,242,12105.272656,21.285115000000587,227.01310281855967,90.95558093061497
"147.32.84.165",3400,"64.12.139.193",25,6,372,6,372,0,0,12105.272788,9.012979999999516,330.19045864965415,0
"147.32.84.165",3401,"195.103.111.199",25,6,372,6,372,0,0,12106.273884,9.01310100000046,330.1860258749844,0
"147.32.84.165",3387,"212.117.174.7",4506,6,372,6,372,0,0,12112.783358,9.012932999999975,330.19218050328436,0
"147.32.84.165",3402,"119.161.16.24",25,6,372,6,372,0,0,12115.086718,9.013037999999142,330.18833383375096,0
"147.32.84.165",3404,"65.55.37.88",25,6,372,6,372,0,0,12116.689124,9.01310100000046,330.1860258749844,0
"147.32.84.165",3392,"212.117.174.7",4506,6,372,6,372,0,0,12118.69213,9.012677000000622,330.20155942566174,0
"147.32.84.165",3405,"209.85.143.27",25,6,372,6,372,0,0,12118.692263,9.012668999999732,330.2018525256046,0
"147.32.84.165",3408,"205.188.103.1",25,6,372,6,372,0,0,12118.692321,9.01266299999952,330.20207235088657,0
"147.32.84.165",3409,"209.85.143.27",25,6,372,6,372,0,0,12120.293944,9.0131790000014,330.1831684469528,0
"147.32.84.165",3410,"205.188.190.2",25,6,372,6,372,0,0,12120.294078,9.013097999999445,330.1861357770861,0
"147.32.84.165",3411,"212.27.48.7",25,6,372,6,372,0,0,12120.294143,9.013084000000163,330.1866486543281,0
"147.32.84.165",3397,"61.17.216.70",6667,4,248,4,248,0,0,12123.599087,3.003956999998991,660.4621837132378,0
"147.32.84.165",3412,"119.161.16.24",25,6,372,6,372,0,0,12125.000985,9.01287499999853,330.1943053687625,0
"147.32.84.165",3414,"209.85.143.27",25,6,372,6,372,0,0,12125.001117,9.01286699999946,330.1945984557609,0
"147.32.84.165",3415,"216.32.181.178",25,6,372,6,372,0,0,12126.302754,9.014138000000457,330.1480407777038,0
"147.32.84.165",3399,"212.117.171.138",65500,14,846,10,604,4,242,12127.304247,24.433209999999235,197.76361763354677,79.23641633661973
"147.32.84.165",3416,"122.28.30.179",25,6,372,6,372,0,0,12127.326837,8.990295999999944,331.0235836506405,0
"147.32.84.165",3417,"64.12.139.193",25,6,372,6,372,0,0,12133.813598,9.012903999999253,330.1932429326049,0
"147.32.84.165",3418,"205.188.59.193",25,6,372,6,372,0,0,12136.116744,9.01292199999989,330.1925834929046,0
"147.32.84.165",3419,"209.85.143.27",25,6,372,6,372,0,0,12137.719091,9.012917999998535,330.192730034877,0
"147.32.84.165",3420,"74.6.136.244",25,6,372,6,372,0,0,12137.719226,9.012912000000142,330.19294984794624,0
"147.32.84.165",3421,"195.23.128.251",25,6,372,6,372,0,0,12139.72228,9.012743999999657,330.1991047343754,0
"147.32.84.165",3422,"208.65.144.13",25,6,372,6,372,0,0,12141.324453,9.013205000001108,330.18221598195476,0
"147.32.84.165",3424,"209.85.143.27",25,6,372,6,372,0,0,12141.32459,9.01312599999983,330.1851100273153,0
"147.32.84.165",3425,"64.12.139.193",25,6,372,6,372,0,0,12141.324649,9.01311700000042,330.1854397318776,0
"147.32.84.165",3427,"165.212.65.113",25,6,372,6,372,0,0,12141.324706,9.013113000000885,330.18558626744255,0
"147.32.84.165",3409,"212.42.113.170",6667,6,372,6,372,0,0,12144.028586,9.012695999999778,330.2008633154911,0
"147.32.84.165",3428,"64.12.90.97",25,6,372,6,372,0,0,12146.03104,9.013017999999647,330.1890665257871,0
"147.32.84.165",3429,"209.85.143.27",25,6,372,6,372,0,0,12147.333838,9.013442999999825,330.1734975192119,0
"147.32.84.165",3430,"74.125.93.27",25,6,372,6,372,0,0,12148.334543,9.013098999999784,330.1860991430441,0
"147.32.84.165",3414,"212.117.174.7",4506,6,372,6,372,0,0,12154.843838,9.012823999999455,330.1961738074748,0
"147.32.84.165",3399,"212.117.171.138",65500,50,4582,34,3570,16,1012,12157.147476,36.43248700000004,783.9157398175967,222.21925173540833
"147.32.84.165",3416,"212.117.174.7",4506,6,372,6,372,0,0,12157.175425,8.884367000000566,334.97040363143606,0
"147.32.84.165",3431,"207.111.237.11",25,6,372,6,372,0,0,12157.175493,8.88442699999905,334.96814144573625,0
"147.32.84.165",3433,"64.12.139.193",25,6,372,6,372,0,0,12158.749261,8.912881999998717,333.8987321946401,0
"147.32.84.165",3436,"74.6.136.244",25,6,372,6,372,0,0,12160.75276,8.912707000001319,333.9052882586132,0
"147.32.84.165",3420,"212.117.171.138",65500,14,846,10,604,4,242,12162.354554,2.7506090000006225,1756.7018794742933,703.844130517846
"147.32.84.165",3437,"209.85.143.27",25,6,372,6,372,0,0,12162.354705,8.913157000000865,333.8884303283013,0
"147.32.84.165",3421,"64.12.175.136",587,28,2519,18,1158,10,1361,12162.354784,31.319142000000284,295.7935437694914,347.6468161228651
"147.32.84.165",3440,"98.137.54.238",25,6,372,6,372,0,0,12162.354871,8.91304400000081,333.8926633818626,0
"147.32.84.165",3441,"205.188.190.1",25,6,372,6,372,0,0,12162.47278,8.894852999999785,334.5755123777843,0
"147.32.84.165",3424,"77.123.72.98",6667,6,372,6,372,0,0,12165.058307,8.91342700000132,333.87831638712686,0
"147.32.84.165",3442,"65.55.37.88",25,6,372,6,372,0,0,12166.961426,9.015637000000424,330.09314816023095,0
"147.32.84.165",3420,"212.117.171.138",65500,29,4861,20,3948,9,913,12168.263338,10.162953999999445,3107.75784284783,718.6886804762079
"147.32.84.165",3443,"209.85.143.27",25,6,372,6,372,0,0,12168.26347,9.012645000000703,330.202731828422,0
"147.32.84.165",3429,"217.72.192.149",25,6,372,6,372,0,0,12169.264663,9.013114999999743,330.1855129996771,0
"147.32.84.165",3444,"205.188.190.1",25,6,372,6,372,0,0,12175.776118,9.010881000000154,330.26737341220564,0
"147.32.84.165",3445,"65.55.92.168",25,6,372,6,372,0,0,12175.776257,9.01088400000117,330.2672634560176,0
"147.32.84.165",3414,"205.188.192.1",80,13,2886,10,1338,3,1548,12178.077471,0.4429949999994278,24162.800934579,27955.16879426629
"147.32.84.165",3446,"209.85.143.27",25,6,372,6,372,0,0,12178.194767,8.995435999999245,330.83443648537434,0
"147.32.84.165",3447,"64.12.90.33",25,6,372,6,372,0,0,12178.194832,8.995498000000225,330.83215626304684,0
"147.32.84.165",3416,"212.117.171.138",65500,22,1338,16,972,6,366,12179.679506,3.680992999999944,2112.473454853111,795.4375354693814
"147.32.84.165",3448,"77.238.177.9",25,6,372,6,372,0,0,12179.679636,9.012738999999783,330.1992879190301,0
"147.32.84.165",3420,"212.117.174.7",4506,6,372,6,372,0,0,12181.682388,9.012960000000021,330.19119135112027,0
"147.32.84.165",3449,"209.85.143.27",25,6,372,6,372,0,0,12183.284508,9.013157999999748,330.18393774968587,0
"147.32.84.165",3433,"212.117.171.138",65500,29,3810,20,2568,9,1242,12183.284606,7.355579000000944,2792.982034452674,1350.811404513326
"147.32.84.165",3452,"209.85.143.27",25,6,372,6,372,0,0,12183.284634,9.013055999999779,330.1876744136587,0
"147.32.84.165",3455,"64.12.139.193",25,6,372,6,372,0,0,12183.284661,9.01305499999944,330.1877110480503,0
"147.32.84.165",3472,"66.94.236.34",25,6,372,6,372,0,0,12183.388566,9.009106999999858,330.33240697441454,0
"147.32.84.165",3437,"60.173.109.42",6667,15,1712,10,1154,5,558,12186.088784,1.9505349999999453,4733.060416757587,2288.6028704945697
"147.32.84.165",3481,"65.54.188.72",25,6,372,6,372,0,0,12186.513339,8.988895000000412,331.075176648505,0
"147.32.84.165",3483,"62.149.128.160",25,6,372,6,372,0,0,12187.991457,9.013144000000466,330.1844506200995,0
"147.32.84.165",3437,"212.117.174.7",4506,6,372,6,372,0,0,12189.293232,9.015330000000176,330.1043888576394,0
"147.32.84.165",3486,"65.55.37.72",25,6,372,6,372,0,0,12189.293367,9.015336999998908,330.10413254661034,0
"147.32.84.165",3442,"206.222.227.2",80,13,2854,10,1996,3,858,12190.29506,0.34467399999994086,46327.83441745748,19914.46990489906
"147.32.84.165",3495,"65.55.92.152",25,6,372,6,372,0,0,12190.314749,8.992873000001055,330.9287254473238,0
"147.32.84.165",3429,"212.117.171.138",65500,14,846,10,604,4,242,12196.807414,1.964587999998912,2459.5487705323844,985.4483484583394
"147.32.84.165",3497,"64.12.139.193",25,6,372,6,372,0,0,12196.830184,8.987463999999818,331.12789102688595,0
"147.32.84.165",3505,"209.85.143.27",25,6,372,6,372,0,0,12196.830248,8.987528999999995,331.1254962292752,0
"147.32.84.165",3429,"212.117.171.138",65500,23,1398,16,972,7,426,12199.207514,3.3661599999995815,2310.050621479955,1012.4295933646719
"147.32.84.165",3445,"173.192.170.88",80,39,6111,26,2452,13,3659,12199.230892,51.537427999999636,380.61658800668397,567.9755691339545
"147.32.84.165",3509,"64.12.90.97",25,6,372,6,372,0,0,12200.709674,9.012837000000218,330.19569753673875,0
"147.32.84.165",3521,"74.125.93.27",25,6,372,6,372,0,0,12202.41282,9.012206000001243,330.21881656939377,0
"147.32.84.165",3448,"212.117.171.138",65500,23,1398,16,972,7,426,12202.712476,1.7599169999994047,4418.39018544774,1936.4549578196886
"147.32.84.165",3531,"119.161.16.24",25,6,372,6,372,0,0,12202.735388,8.990196000000651,331.02726570141346,0
"147.32.84.165",3533,"205.188.103.1",25,6,372,6,372,0,0,12204.315187,9.012651999999434,330.20247536465257,0
"147.32.84.165",3447,"212.117.171.138",65500,70,6938,44,4288,26,2650,12204.414898,242.1739519999992,141.65024651371306,87.54038089117061
"147.32.84.165",3549,"209.85.143.27",25,6,372,6,372,0,0,12204.414988,9.013651999999638,330.16584176980865,0
"147.32.84.165",3558,"74.6.136.244",25,6,372,6,372,0,0,12204.415018,9.013763000000836,330.16177594193726,0
"147.32.84.165",3560,"209.85.143.27",25,6,372,6,372,0,0,12207.519513,9.012825000001612,330.1961371711386,0
"147.32.84.165",3568,"74.125.93.27",25,6,372,6,372,0,0,12207.519662,9.012826999998651,330.1960638987573,0
"147.32.84.165",3600,"80.12.242.82",25,6,372,6,372,0,0,12207.519739,9.01281999999992,330.1963203525674,0
"147.32.84.165",3481,"212.117.174.7",4506,6,372,6,372,0,0,12209.021622,9.014085999999224,330.1499453189437,0
"147.32.84.165",3616,"64.12.139.193",25,6,372,6,372,0,0,12210.323631,9.013397000000623,330.1751825643311,0
"147.32.84.165",3621,"205.188.190.2",25,6,372,6,372,0,0,12211.325345,9.012425000000803,330.2107923227916,0
"147.32.84.165",3625,"65.55.92.168",25,6,372,6,372,0,0,12217.834255,9.012865000000602,330.19467172755844,0
"147.32.84.165",3630,"209.85.143.27",25,6,372,6,372,0,0,12221.739858,9.012955999998667,330.191337891857,0
"147.32.84.165",3632,"64.12.139.193",25,6,372,6,372,0,0,12223.444942,9.010798999999679,330.2703789086968,0
"147.32.84.165",3633,"209.85.143.27",25,6,372,6,372,0,0,12223.445076,9.01079000000027,330.2707087835707,0
"147.32.84.165",3640,"65.54.188.94",25,6,372,6,372,0,0,12223.445135,9.010780000000523,330.271075311996,0
"147.32.84.165",3642,"74.6.136.244",25,6,372,6,372,0,0,12223.7431,9.012807999999495,330.1967599886924,0
"147.32.84.165",3644,"122.200.253.201",25,6,372,6,372,0,0,12223.743242,9.012790999999197,330.197382808529,0
"147.32.84.165",3645,"205.188.190.2",25,6,372,6,372,0,0,12225.345171,9.013553999999203,330.1694315028526,0
"147.32.84.165",3648,"209.85.143.27",25,6,372,6,372,0,0,12225.345305,9.013473999999405,330.1723619550238,0
"147.32.84.165",3651,"94.136.40.61",25,6,372,6,372,0,0,12225.345364,9.013465999998516,330.17265500313533,0
"147.32.84.165",3652,"205.188.103.1",25,6,372,6,372,0,0,12225.445299,9.013429999999062,330.1739737259079,0
"147.32.84.165",3558,"117.207.5.248",6667,9,552,6,372,3,180,12228.549712,1.3827949999995326,2152.1628296320177,1041.3691111122666
"147.32.84.165",3655,"209.85.143.27",25,6,372,6,372,0,0,12229.932746,8.83176900000035,336.96533503082816,0
"147.32.84.165",3661,"200.53.119.250",25,6,372,6,372,0,0,12229.932809,8.831829000000653,336.96304581981605,0
"147.32.84.165",3662,"205.188.190.2",25,6,372,6,372,0,0,12230.05206,8.912963999999192,333.8956602988938,0
"147.32.84.165",3663,"98.137.54.238",25,6,372,6,372,0,0,12230.052192,8.91295700000046,333.89592253164085,0
"147.32.84.165",3600,"212.117.174.7",4506,6,372,6,372,0,0,12231.354046,8.91259799999898,333.9093718801567,0
"147.32.84.165",3664,"209.85.143.27",25,6,372,6,372,0,0,12232.355533,9.01267899999948,330.2014861508073,0
"147.32.84.165",3670,"205.188.103.1",25,6,372,6,372,0,0,12232.355668,9.01263199999994,330.20320811945055,0
"147.32.84.165",3674,"74.6.136.244",25,6,372,6,372,0,0,12232.355732,9.012591999999131,330.20467363886956,0
"147.32.84.165",3621,"212.117.174.7",4506,6,372,6,372,0,0,12238.764699,9.012590000000273,330.2047469151387,0
"147.32.84.165",3676,"202.14.166.248",25,6,372,6,372,0,0,12238.764757,9.012620999999854,330.203611135989,0
"147.32.84.165",3682,"209.85.143.27",25,6,372,6,372,0,0,12242.670189,9.012838999999076,330.19562426448596,0
"147.32.84.165",3685,"209.85.143.27",25,6,372,6,372,0,0,12244.372567,9.01275700000042,330.1986284551843,0
"147.32.84.165",3689,"74.6.136.65",25,6,372,6,372,0,0,12244.37267,9.012806999999157,330.1967966251001,0
"147.32.84.165",3692,"205.188.156.193",25,6,372,6,372,0,0,12244.67294,9.012789999998859,330.19741944507496,0
"147.32.84.165",3695,"165.212.8.32",25,6,372,6,372,0,0,12246.275211,9.013450000000375,330.1732411007856,0
"147.32.84.165",3699,"74.6.136.244",25,6,372,6,372,0,0,12246.375859,9.012455000000045,330.2096931413233,0
"147.32.84.165",3701,"64.12.90.65",25,6,372,6,372,0,0,12246.375966,9.012447000000975,330.20998625563936,0
"147.32.84.165",3652,"61.17.216.87",6667,6,372,6,372,0,0,12250.781958,9.012791999999536,330.1973461719912,0
"147.32.84.165",3704,"209.85.143.27",25,6,372,6,372,0,0,12250.986814,9.008281000000352,330.3626962791107,0
"147.32.84.165",3707,"65.54.188.72",25,6,372,6,372,0,0,12250.98688,9.008338999999978,330.3605692458962,0
"147.32.84.165",3708,"209.85.143.27",25,6,372,6,372,0,0,12252.283719,9.01387000000068,330.1578567252219,0
"147.32.84.165",3713,"64.12.139.193",25,6,372,6,372,0,0,12252.283816,9.013898000001063,330.1568311511456,0
"147.32.84.165",3717,"74.6.136.244",25,6,372,6,372,0,0,12253.385559,9.01304700000037,330.1880041233423,0
"147.32.84.165",3719,"219.99.153.135",25,6,372,6,372,0,0,12259.794891,9.012625999999727,330.20342794653743,0
"147.32.84.165",3720,"209.65.160.73",25,6,372,6,372,0,0,12263.700943,9.012173000000985,330.22002573626526,0
"147.32.84.165",3725,"205.188.190.2",25,6,372,6,372,0,0,12265.402642,9.0050310000006,330.48192726930114,0
"147.32.84.165",3730,"209.85.143.27",25,6,372,6,372,0,0,12265.703041,9.005973999999696,330.4473230768932,0
"147.32.84.165",3732,"216.163.188.58",25,6,372,6,372,0,0,12267.305451,9.00814200000059,330.3677939357312,0
"147.32.84.165",3689,"212.117.174.7",4506,6,372,6,372,0,0,12267.405505,9.009212999999363,330.3285203713366,0
"147.32.84.165",3733,"74.6.136.244",25,6,372,6,372,0,0,12272.012101,9.016670999999405,330.05529424331843,0
"147.32.84.165",3699,"115.99.115.251",6667,7,432,6,372,1,60,12272.012235,3.6998980000007577,804.3464982005964,129.73330616138654
"147.32.84.165",3734,"205.188.103.1",25,6,372,6,372,0,0,12272.612961,9.018839999998818,329.9759170802886,0
"147.32.84.165",3704,"98.126.71.122",80,18,4965,14,1532,4,3433,12273.314052,18.27180700000099,670.760149776064,1503.0806750530207
"147.32.84.165",3741,"64.12.90.97",25,6,372,6,372,0,0,12273.489333,8.945152000000235,332.6941789250671,0
"147.32.84.165",3708,"95.100.248.96",80,23,8182,16,4308,7,3874,12274.407814,18.74488399999973,1838.5816631354187,1653.357790851117
"147.32.84.165",3742,"209.85.143.27",25,6,372,6,372,0,0,12274.408546,9.029168999999456,329.59843812871145,0
"147.32.84.165",3743,"205.188.190.1",25,6,372,6,372,0,0,12274.40861,9.029230000000098,329.5962114155878,0
"147.32.84.165",3713,"195.113.232.96",80,13,2902,10,1880,3,1022,12280.828659,12.324235999998564,1220.3596231037568,663.4082631978933
"147.32.84.165",3747,"195.3.86.220",25,6,372,6,372,0,0,12280.829497,8.931198999998742,333.2139391363264,0
"147.32.84.165",3719,"195.113.232.83",80,13,3379,10,1524,3,1855,12284.742066,8.4110299999993,1449.5252067821675,1764.3499072053285
"147.32.84.165",3748,"209.85.143.27",25,6,372,6,372,0,0,12284.743132,8.939755000001242,332.89502900242644,0
"147.32.84.165",3751,"218.102.53.139",25,6,372,6,372,0,0,12284.743193,8.939818999999261,332.8926458131027,0
"147.32.84.165",3720,"74.125.232.217",80,13,1871,10,1156,3,715,12286.449324,6.7039590000003955,1379.4833769119791,853.2271751661463
"147.32.84.165",3758,"64.12.90.65",25,6,372,6,372,0,0,12286.457633,8.927411000000575,333.35532552492634,0
"147.32.84.165",3759,"205.188.190.2",25,6,372,6,372,0,0,12286.751605,8.934468999999808,333.0919834183838,0
"147.32.84.165",3761,"74.6.136.244",25,6,372,6,372,0,0,12288.256072,9.032067000000097,329.49268423274185,0
"147.32.84.165",3767,"209.85.143.27",25,6,372,6,372,0,0,12288.35622,9.03203399999984,329.4938880876725,0
"147.32.84.165",3730,"212.117.174.7",4506,6,372,6,372,0,0,12291.867549,9.02886799999942,329.60942612077076,0
"147.32.84.165",3704,"210.75.13.174",6667,6,372,6,372,0,0,12293.582647,9.013516000000891,330.1708234610895,0
"147.32.84.165",3708,"212.117.174.7",4506,6,372,6,372,0,0,12294.383764,9.013132000000041,330.1848902246174,0
"147.32.84.165",3768,"209.85.143.27",25,6,372,6,372,0,0,12294.383898,9.013123000000633,330.1852199287407,0
"147.32.84.165",3770,"217.34.44.67",25,6,372,6,372,0,0,12294.383955,9.013116000000082,330.1854763657733,0
"147.32.84.165",3771,"64.12.139.193",25,6,372,6,372,0,0,12295.385182,9.013005999999223,330.1895061425962,0
"147.32.84.165",3734,"173.192.170.88",80,18,3711,14,1568,4,2143,12301.794432,4.736753999999564,2648.2270348008688,3619.3562089147076
"147.32.84.165",3776,"64.12.90.97",25,6,372,6,372,0,0,12301.995367,9.012386000000333,330.2122212696937,0
"147.32.84.165",3777,"206.46.232.11",25,6,372,6,372,0,0,12305.700211,9.01292900000044,330.19232704483244,0
"147.32.84.165",3780,"150.70.226.96",25,6,372,6,372,0,0,12307.402372,9.013053999999102,330.18774768245,0
"147.32.84.165",3784,"205.188.59.193",25,6,372,6,372,0,0,12307.702763,9.013106000000334,330.18584270504414,0
"147.32.84.165",3788,"74.6.136.244",25,6,372,6,372,0,0,12309.305374,9.013261000000057,330.180164537561,0
"147.32.84.165",3790,"209.85.143.27",25,6,372,6,372,0,0,12309.405345,9.013354000000618,330.17675773078435,0
"147.32.84.165",3795,"64.12.139.193",25,6,372,6,372,0,0,12312.910308,9.013017999999647,330.1890665257871,0
"147.32.84.165",3798,"77.238.184.241",25,6,372,6,372,0,0,12312.910446,9.013006000001042,330.1895061425296,0
"147.32.84.165",3759,"222.124.57.154",6667,6,372,6,372,0,0,12314.412901,9.01304700000037,330.1880041233423,0
"147.32.84.165",3799,"94.245.120.86",25,6,372,6,372,0,0,12315.414122,9.012918000000354,330.1927300348104,0
"147.32.84.165",3767,"74.125.127.27",25,6,372,6,372,0,0,12316.415562,9.012747999999192,330.19895818681124,0
"147.32.84.165",3800,"205.188.59.193",25,6,372,6,372,0,0,12323.024762,9.0130390000013,330.1882971991546,0
"147.32.84.165",3770,"212.117.174.7",4506,6,372,6,372,0,0,12323.024896,9.013001999999688,330.18965268177055,0
"147.32.84.165",3759,"212.117.174.7",4506,6,372,6,372,0,0,12326.730169,9.01292999999896,330.1922904094832,0
"147.32.84.165",3801,"209.85.143.27",25,6,372,6,372,0,0,12326.730303,9.01292199999989,330.1925834929046,0
"147.32.84.165",3806,"64.12.90.65",25,6,372,6,372,0,0,12326.73036,9.012919000000693,330.1926933993051,0
"147.32.84.165",3810,"66.231.182.6",25,6,372,6,372,0,0,12328.432818,9.012769000000844,330.1981888140838,0
"147.32.84.165",3811,"209.85.143.27",25,6,372,6,372,0,0,12328.733195,9.012928000000102,330.19236368025645,0
"147.32.84.165",3812,"205.188.103.1",25,6,372,6,372,0,0,12328.733329,9.012919999999212,330.19265676387454,0
"147.32.84.165",3814,"216.104.13.1",25,6,372,6,372,0,0,12330.335298,9.01346999999987,330.17250847898123,0
"147.32.84.165",3817,"168.95.5.32",25,6,372,6,372,0,0,12330.435465,9.013107999999193,330.18576943716494,0
"147.32.84.165",3820,"205.188.59.193",25,6,372,6,372,0,0,12333.941245,9.012499000000389,330.20808102168684,0
"147.32.84.165",3483,"220.134.142.48",6667,6,372,6,372,0,0,12335.442919,9.01271799999995,330.2000572968129,0
"147.32.84.165",3823,"209.85.143.27",25,6,372,6,372,0,0,12336.444226,9.014515000000756,330.13423351114847,0
"147.32.84.165",3824,"74.6.136.244",25,6,372,6,372,0,0,12337.445768,9.012942000001203,330.1918507851934,0
"147.32.84.165",3826,"209.85.143.27",25,6,372,6,372,0,0,12344.055134,8.912764999999126,333.90311536322247,0
"147.32.84.165",3827,"150.70.226.96",25,6,372,6,372,0,0,12344.055269,8.91275399999904,333.9035274619181,0
"147.32.84.165",3830,"205.188.103.1",25,6,372,6,372,0,0,12347.760583,8.912760000001072,333.903302680611,0
"147.32.84.165",3834,"41.248.240.86",25,6,372,6,372,0,0,12347.760719,8.912754999999379,333.9034899983459,0
"147.32.84.165",3801,"212.117.174.7",4506,6,372,6,372,0,0,12349.464317,8.911294999999882,333.95819575045374,0
"147.32.84.165",3837,"209.85.143.27",25,6,372,6,372,0,0,12349.764552,8.91385900000023,333.8621353557335,0
"147.32.84.165",3840,"64.12.90.65",25,6,372,6,372,0,0,12349.764686,8.913848999998663,333.8625098989725,0
"147.32.84.165",3843,"74.125.93.27",25,6,372,6,372,0,0,12351.265613,9.012957000000824,330.191301256594,0
"147.32.84.165",3845,"216.200.145.235",25,6,372,6,372,0,0,12351.365624,9.013141999999789,330.1845238874601,0
"147.32.84.165",3810,"212.117.174.7",4506,6,372,6,372,0,0,12354.870757,9.012773999998899,330.1980056307152,0
"147.32.84.165",3849,"64.16.45.216",25,6,372,6,372,0,0,12354.870891,9.012765999999829,330.1982987242825,0
"147.32.84.165",3857,"64.12.139.193",25,6,372,6,372,0,0,12356.47305,9.012958999999682,330.1912279862923,0
"147.32.84.165",3861,"74.6.136.244",25,6,372,6,372,0,0,12357.37436,9.0143079999998,330.1418145463929,0
"147.32.84.165",3867,"209.85.143.27",25,6,372,6,372,0,0,12357.374493,9.014307000001281,330.1418511705422,0
"147.32.84.165",3874,"62.149.128.68",25,6,372,6,372,0,0,12358.375748,9.013457999999446,330.17294805170036,0
"147.32.84.165",3878,"64.12.90.97",25,6,372,6,372,0,0,12364.985278,9.013292999999976,330.17899229504775,0
"147.32.84.165",3879,"74.6.136.244",25,6,372,6,372,0,0,12368.691149,9.01267100000041,330.20177925055344,0
"147.32.84.165",3880,"209.85.143.27",25,6,372,6,372,0,0,12370.393011,9.012829999999667,330.1959539900464,0
"147.32.84.165",3882,"64.12.139.193",25,6,372,6,372,0,0,12370.393143,9.012824000001274,330.1961738074081,0
"147.32.84.165",3888,"64.12.90.97",25,6,372,6,372,0,0,12370.393197,9.012823000000935,330.19621044368574,0
"147.32.84.165",3894,"209.85.143.27",25,6,372,6,372,0,0,12370.393253,9.012817000000723,330.1964302614556,0
"147.32.84.165",3909,"62.58.50.87",25,6,372,6,372,0,0,12370.393313,9.012808999999834,330.1967233522928,0
"147.32.84.165",3910,"217.11.254.90",25,6,372,6,372,0,0,12370.693692,9.012987000000066,330.1902022048826,0
"147.32.84.165",3918,"12.42.184.3",25,6,372,6,372,0,0,12372.295646,9.013600999998744,330.1677098864721,0
"147.32.84.165",3921,"74.6.136.244",25,6,372,6,372,0,0,12372.395733,9.013722000001508,330.16327772251043,0
"147.32.84.165",3927,"205.188.190.2",25,6,372,6,372,0,0,12372.395864,9.013614999999845,330.1671970679967,0
"147.32.84.165",3840,"182.0.125.28",6667,6,372,6,372,0,0,12375.900979,9.012797999999748,330.197126353002,0
"147.32.84.165",3933,"209.85.143.27",25,6,372,6,372,0,0,12377.503363,9.012993000000279,330.18998239540497,0
"147.32.84.165",3939,"64.12.139.193",25,6,372,6,372,0,0,12377.503494,9.012987000000066,330.1902022048826,0
"147.32.84.165",3942,"165.21.74.117",25,6,372,6,372,0,0,12378.404728,9.012646000001041,330.20269519069717,0
"147.32.84.165",3945,"74.6.136.244",25,6,372,6,372,0,0,12379.406183,9.012662000001,330.2021089884065,0
"147.32.84.165",3949,"209.85.143.27",25,6,372,6,372,0,0,12379.40624,9.01284300000043,330.1954777199445,0
"147.32.84.165",3857,"212.117.174.7",4506,6,372,6,372,0,0,12386.015802,9.013186000000132,330.1829120135717,0
"147.32.84.165",3964,"216.32.180.22",25,6,372,6,372,0,0,12389.720909,9.01412100000016,330.1486634137646,0
"147.32.84.165",3970,"64.12.90.65",25,6,372,6,372,0,0,12391.423105,9.013521000000765,330.1706403080159,0
"147.32.84.165",3965,"205.188.156.193",25,6,372,6,372,0,0,12391.723569,9.013358000000153,330.1766112030555,0
"147.32.84.165",3977,"209.85.225.27",25,6,372,6,372,0,0,12393.326151,9.01288999999997,330.19375583192624,0
"147.32.84.165",3979,"66.231.249.144",25,6,372,6,372,0,0,12393.426235,9.01281199999903,330.1966134432095,0
"147.32.84.165",3894,"117.197.182.9",6667,6,372,6,372,0,0,12397.932609,9.013184000001274,330.18298528018283,0
"147.32.84.165",3882,"212.117.174.7",4506,6,372,6,372,0,0,12398.53335,9.013378999999986,330.17584193452916,0
"147.32.84.165",3980,"64.12.139.193",25,6,372,6,372,0,0,12398.533484,9.01338399999986,330.17565877588777,0
"147.32.84.165",3986,"74.6.136.244",25,6,372,6,372,0,0,12399.435003,9.012763999999152,330.1983719977889,0
"147.32.84.165",3992,"209.85.143.27",25,6,372,6,372,0,0,12400.436765,9.012531999998828,330.20687194235614,0
"147.32.84.165",3994,"209.85.143.27",25,6,372,6,372,0,0,12407.045928,9.013011000000915,330.18932296872794,0
"147.32.84.165",3995,"205.188.190.2",25,6,372,6,372,0,0,12407.046132,9.012980999999854,330.1904220146529,0
"147.32.84.165",3945,"174.133.57.141",80,16,3429,12,1428,4,2001,12410.750949,0.4846850000012637,23569.947491608396,33027.636506098315
"147.32.84.165",3997,"71.74.56.227",25,6,372,6,372,0,0,12410.911668,8.95252900000014,332.42003460697566,0
"147.32.84.165",3894,"212.117.174.7",4506,6,372,6,372,0,0,12412.453359,8.914035000001604,333.8555435332556,0
"147.32.84.165",4002,"209.85.143.27",25,6,372,6,372,0,0,12412.753805,8.912919000000329,333.8973460882894,0
"147.32.84.165",4007,"74.6.136.244",25,6,372,6,372,0,0,12412.753938,8.912889999999607,333.8984324949743,0
"147.32.84.165",4012,"64.12.139.193",25,6,372,6,372,0,0,12412.753992,8.912861999999222,333.89948144605626,0
"147.32.84.165",4013,"205.188.190.2",25,6,372,6,372,0,0,12412.754044,8.912838000000193,333.90038055218054,0
"147.32.84.165",4027,"12.172.137.108",25,6,372,6,372,0,0,12412.754106,8.912803999999596,333.90165429421927,0
"147.32.84.165",4036,"209.85.143.27",25,6,372,6,372,0,0,12414.356115,8.912967000000208,333.89554791349843,0
"147.32.84.165",4038,"74.6.136.244",25,6,372,6,372,0,0,12414.356248,8.912958999999319,333.895847607986,0
"147.32.84.165",4040,"205.188.190.1",25,6,372,6,372,0,0,12414.356309,8.912953999999445,333.8960349172884,0
"147.32.84.165",4041,"64.12.90.97",25,6,372,6,372,0,0,12414.456445,8.912970999999743,333.8953980664905,0
"147.32.84.165",3965,"86.126.237.212",6667,6,372,6,372,0,0,12418.962987,8.912571999999273,333.9103459697428,0
"147.32.84.165",4045,"209.85.143.27",25,6,372,6,372,0,0,12419.563951,8.912592000000586,333.9095966694991,0
"147.32.84.165",4049,"64.136.52.37",25,6,372,6,372,0,0,12419.564085,8.912524999999732,333.91210683842,0
"147.32.84.165",4057,"65.55.88.22",25,6,372,6,372,0,0,12420.364847,9.012955999998667,330.191337891857,0
"147.32.84.165",3979,"174.133.57.141",80,17,2011,12,1428,5,583,12421.367526,37.64765299999999,303.4452107811343,123.88554473767597
"147.32.84.165",4059,"64.124.14.38",25,6,372,6,372,0,0,12421.52875,8.950859000000492,332.4820556328545,0
"147.32.84.165",4063,"209.85.143.27",25,6,372,6,372,0,0,12427.97617,9.0127250000005,330.19980083713136,0
"147.32.84.165",3965,"212.117.174.7",4506,6,372,6,372,0,0,12431.881438,9.01290599999993,330.19316966137484,0
"147.32.84.165",4065,"65.55.37.104",25,6,372,6,372,0,0,12431.881511,9.012973000000784,330.1907150947574,0
"147.32.84.165",4073,"212.38.97.175",25,6,372,6,372,0,0,12433.383464,9.012971000000107,330.1907883648982,0
"147.32.84.165",4085,"74.6.136.244",25,6,372,6,372,0,0,12433.683916,9.01401799999985,330.1524359059466,0
"147.32.84.165",4087,"64.12.139.193",25,6,372,6,372,0,0,12435.286334,9.013039999999819,330.1882605646996,0
"147.32.84.165",4091,"205.188.59.193",25,6,372,6,372,0,0,12435.386396,9.013646999999764,330.1660249175587,0
"147.32.84.165",4012,"212.117.174.7",4506,6,372,6,372,0,0,12439.992952,9.013168999999834,330.18353478116904,0
"147.32.84.165",4002,"188.72.216.51",6667,9,552,6,372,3,180,12440.495562,1.0203519999995478,2916.640531896168,1411.2776767239523
"147.32.84.165",4027,"64.12.90.1",25,6,372,6,372,0,0,12441.395027,9.013027999999395,330.18870017936257,0
"147.32.84.165",4096,"209.85.143.27",25,6,372,6,372,0,0,12441.516129,8.992519999999786,330.9417160039756,0
"147.32.84.165",4099,"64.12.90.65",25,6,372,6,372,0,0,12441.516217,8.992514999999912,330.9419000135145,0
"147.32.84.165",4038,"212.117.171.138",65500,11,666,8,484,3,182,12442.496781,307.88793500000065,12.576004317934679,4.728993359223371
"147.32.84.165",4101,"209.85.143.27",25,6,372,6,372,0,0,12442.496912,9.013332999998966,330.1775270036447,0
"147.32.84.165",4041,"205.188.186.167",587,52,6094,38,4434,14,1660,12442.496969,4.188911000001099,8468.072012031455,3170.275042844433
"147.32.84.165",4110,"209.191.88.254",25,6,372,6,372,0,0,12442.614696,8.995654000000286,330.82641906857526,0
"147.32.84.165",4119,"64.12.90.97",25,6,372,6,372,0,0,12449.006259,9.013231999999334,330.1812268895575,0
"147.32.84.165",4041,"101.0.32.121",6667,6,372,6,372,0,0,12452.912722,9.01174600000013,330.2356724212996,0
"147.32.84.165",4123,"74.6.136.244",25,6,372,6,372,0,0,12454.413865,9.01283499999954,330.1957708090908,0
"147.32.84.165",4125,"209.85.143.27",25,6,372,6,372,0,0,12454.414016,9.012775999999576,330.19793235737137,0
"147.32.84.165",4129,"209.85.143.27",25,6,372,6,372,0,0,12454.714805,9.012920000001031,330.1926567638079,0
"147.32.84.165",4131,"64.12.139.193",25,6,372,6,372,0,0,12454.714955,9.01286600000094,330.1946350916223,0
"147.32.84.165",4139,"209.85.143.27",25,6,372,6,372,0,0,12454.715098,9.012751999998727,330.1988116393772,0
"147.32.84.165",4140,"205.188.59.193",25,6,372,6,372,0,0,12454.715176,9.01270199999999,330.2006434918189,0
"147.32.84.165",4143,"64.12.90.65",25,6,372,6,372,0,0,12454.715252,9.012651999999434,330.20247536465257,0
"147.32.84.165",4144,"74.6.136.244",25,6,372,6,372,0,0,12454.715326,9.012604999999894,330.2041973436132,0
"147.32.84.165",4145,"209.85.143.27",25,6,372,6,372,0,0,12456.316534,9.013006999999561,330.18946950780634,0
"147.32.84.165",4146,"209.85.143.27",25,6,372,6,372,0,0,12456.316631,9.012979999999516,330.19045864965415,0
"147.32.84.165",4157,"65.54.188.126",25,6,372,6,372,0,0,12456.316661,9.012982999998712,330.19034874474136,0
"147.32.84.165",4158,"200.91.27.32",25,6,372,6,372,0,0,12456.4166,9.013074000000415,330.1870149962003,0
"147.32.84.165",4159,"64.12.139.193",25,6,372,6,372,0,0,12461.023317,9.013186000000132,330.1829120135717,0
"147.32.84.165",3979,"174.133.57.141",80,16,3429,12,1428,4,2001,12462.425477,0.49507899999844085,23075.105185305732,32334.233526468328
"147.32.84.165",4160,"74.6.136.244",25,6,372,6,372,0,0,12462.525871,9.012598999999682,330.2044171720172,0
"147.32.84.165",4164,"205.188.156.193",25,6,372,6,372,0,0,12462.526004,9.012571000001117,330.2054430416838,0
"147.32.84.165",4166,"195.140.44.136",25,6,372,6,372,0,0,12462.587382,8.95122100000117,332.4686095896427,0
"147.32.84.165",3979,"212.117.174.7",4506,6,372,6,372,0,0,12463.628543,9.011964999999691,330.2276473554993,0
"147.32.84.165",4167,"209.85.143.27",25,6,372,6,372,0,0,12470.036638,9.012507000001278,330.20778791068653,0
"147.32.84.165",4096,"212.117.174.7",4506,6,372,6,372,0,0,12470.036695,9.012588999999934,330.20478355331875,0
"147.32.84.165",4177,"85.115.58.190",25,6,372,6,372,0,0,12470.036754,9.01260099999854,330.20434389589445,0
"147.32.84.165",4178,"208.65.144.12",25,6,372,6,372,0,0,12474.242195,9.013100999998642,330.18602587505103,0
"147.32.84.165",4182,"209.85.225.27",25,6,372,6,372,0,0,12475.444164,9.012917000000016,330.1927666703238,0
"147.32.84.165",4183,"209.191.88.254",25,6,372,6,372,0,0,12475.744404,9.013448000001517,330.1733143631049,0
"147.32.84.165",4191,"64.12.139.193",25,6,372,6,372,0,0,12477.346895,9.012840999999753,330.19555099219895,0
"147.32.84.165",4197,"74.6.136.244",25,6,372,6,372,0,0,12477.347025,9.01283500000136,330.1957708090241,0
"147.32.84.165",4200,"205.188.156.193",25,6,372,6,372,0,0,12477.446922,9.013171000000511,330.1834615142474,0
"147.32.84.165",4203,"209.85.143.27",25,6,372,6,372,0,0,12477.447052,9.013182000000597,330.18305854689305,0
"147.32.84.165",4208,"165.21.74.117",25,6,372,6,372,0,0,12482.053674,8.912757999998576,333.90337760774787,0
"147.32.84.165",4158,"59.103.193.24",6667,6,372,6,372,0,0,12483.55567,8.912709000000177,333.9052133307551,0
"147.32.84.165",4210,"209.85.143.27",25,6,372,6,372,0,0,12483.555751,8.912695999999414,333.9057003627405,0
"147.32.84.165",4220,"64.12.139.193",25,6,372,6,372,0,0,12483.555779,8.912696999999753,333.9056628986807,0
"147.32.84.165",4221,"209.85.143.27",25,6,372,6,372,0,0,12484.657269,8.91284000000087,333.9003056264568,0
"147.32.84.165",4229,"74.6.136.244",25,6,372,6,372,0,0,12484.657341,8.912893999999142,333.8982826453772,0
"147.32.84.165",4233,"64.12.139.193",25,6,372,6,372,0,0,12484.657372,8.912916000001132,333.8974584748271,0
"147.32.84.165",4245,"209.85.143.27",25,6,372,6,372,0,0,12484.657403,8.912937000000966,333.89667177044754,0
"147.32.84.165",4257,"216.32.181.178",25,6,372,6,372,0,0,12484.657435,8.912956000000122,333.89595999351496,0
"147.32.84.165",4262,"64.12.90.65",25,6,372,6,372,0,0,12490.966575,9.012987000000066,330.1902022048826,0
"147.32.84.165",4269,"209.85.143.27",25,6,372,6,372,0,0,12495.175701,9.009632999999667,330.3131215222762,0
"147.32.84.165",4279,"64.12.90.33",25,6,372,6,372,0,0,12495.175833,9.009593000000677,330.3145880174361,0
"147.32.84.165",4280,"165.21.74.116",25,6,372,6,372,0,0,12496.374161,9.013194999999541,330.18258231405747,0
"147.32.84.165",4281,"74.6.136.244",25,6,372,6,372,0,0,12496.674523,9.012962000000698,330.19111808080066,0
"147.32.84.165",4289,"200.251.53.137",25,6,372,6,372,0,0,12496.674657,9.01295300000129,330.19144779736166,0
"147.32.84.165",4295,"205.188.103.1",25,6,372,6,372,0,0,12498.276956,9.014632000000347,330.1299487322262,0
"147.32.84.165",4296,"209.85.143.27",25,6,372,6,372,0,0,12498.376953,9.014591999999539,330.1314136014311,0
"147.32.84.165",4191,"173.192.170.88",80,6,372,6,372,0,0,12502.988039,9.008998999999676,330.3363670037156,0
"147.32.84.165",4297,"74.125.43.27",25,6,372,6,372,0,0,12504.48567,9.013202000000092,330.18232588152017,0
"147.32.84.165",4210,"212.117.174.7",4506,6,372,6,372,0,0,12505.487222,9.01300000000083,330.18972595137313,0
"147.32.84.165",4298,"65.55.92.152",25,6,372,6,372,0,0,12505.587448,9.01320399999895,330.1822526152017,0
"147.32.84.165",4233,"212.117.174.7",4506,6,372,6,372,0,0,12511.997173,9.012340999999651,330.21387006995354,0
"147.32.84.165",4299,"209.85.143.27",25,6,372,6,372,0,0,12511.99723,9.012409999999363,330.2113419163365,0
"147.32.84.165",4303,"205.188.156.193",25,6,372,6,372,0,0,12511.997302,9.01238899999953,330.21211135029296,0
"147.32.84.165",4262,"174.133.57.141",80,16,3429,12,1428,4,2001,12516.202684,0.4760600000008708,23996.975171153015,33626.01352764508
"147.32.84.165",4307,"205.188.103.1",25,6,372,6,372,0,0,12516.360662,8.95499700000073,332.32841954048195,0
"147.32.84.165",4320,"208.65.144.12",25,6,372,6,372,0,0,12516.360729,8.955056999999215,332.3261928986338,0
"147.32.84.165",4331,"209.85.143.27",25,6,372,6,372,0,0,12517.404359,9.013042000000496,330.1881872956807,0
"147.32.84.165",4334,"200.251.53.137",25,6,372,6,372,0,0,12517.40449,9.013019999998505,330.18899325647715,0
"147.32.84.165",4338,"204.127.217.16",25,6,372,6,372,0,0,12517.404551,9.012990000001082,330.19009230007384,0
"147.32.84.165",4341,"209.85.143.27",25,6,372,6,372,0,0,12517.704807,9.012904999999591,330.1932062969858,0
"147.32.84.165",4344,"205.188.190.2",25,6,372,6,372,0,0,12517.704917,9.01287500000035,330.19430536869584,0
"147.32.84.165",4350,"64.12.139.193",25,6,372,6,372,0,0,12519.307222,9.01275700000042,330.1986284551843,0
"147.32.84.165",4355,"94.136.40.60",25,6,372,6,372,0,0,12519.407165,9.01470899999913,330.12712889570673,0
"147.32.84.165",4356,"74.6.136.244",25,6,372,6,372,0,0,12524.013921,9.01283499999954,330.1957708090908,0
"147.32.84.165",4361,"216.82.241.131",25,6,372,6,372,0,0,12525.518576,9.010557999999946,330.2792124527713,0
"147.32.84.165",4362,"209.85.143.27",25,6,372,6,372,0,0,12526.517468,9.013206999999966,330.182142715685,0
"147.32.84.165",4210,"174.133.57.141",80,17,3489,12,1428,5,2061,12526.617717,1.7084490000015649,6686.766769151163,9650.858761358928
"147.32.84.165",4363,"209.85.143.27",25,6,372,6,372,0,0,12526.784591,8.946036999999706,332.6612666592032,0
"147.32.84.165",4367,"205.188.103.1",25,6,372,6,372,0,0,12526.784622,8.946101999999883,332.6588496308268,0
"147.32.84.165",4373,"212.170.236.87",25,6,372,6,372,0,0,12533.026873,9.01321999999891,330.1816664854913,0
"147.32.84.165",4233,"115.137.250.215",6667,9,552,6,372,3,180,12537.333131,1.923428000000058,1547.2375363153235,748.6633240235436
"147.32.84.165",4320,"174.133.57.141",80,17,3489,12,1428,5,2061,12538.434601,0.6815959999985353,16760.661741008676,24190.28280687597
"147.32.84.165",4374,"209.85.143.27",25,6,372,6,372,0,0,12538.595762,8.952194999999847,332.4324369609968,0
"147.32.84.165",4307,"212.117.174.7",4506,6,372,6,372,0,0,12538.595827,8.952240000000529,332.4307659311886,0
"147.32.84.165",4375,"75.180.132.243",25,6,372,6,372,0,0,12538.735055,9.013234000000011,330.18115362366007,0
"147.32.84.165",4376,"74.6.136.244",25,6,372,6,372,0,0,12539.256838,8.992358999999851,330.94764121406286,0
"147.32.84.165",4378,"209.85.143.27",25,6,372,6,372,0,0,12539.256902,8.992358000001332,330.94767801721855,0
"147.32.84.165",4384,"205.188.103.1",25,6,372,6,372,0,0,12539.25696,8.99232899999879,330.9487453139671,0
"147.32.84.165",4385,"209.85.143.27",25,6,372,6,372,0,0,12539.257015,8.992298000001028,330.94988622481816,0
"147.32.84.165",4386,"64.12.90.33",25,6,372,6,372,0,0,12539.257073,8.992267999999967,330.95099033970195,0
"147.32.84.165",4391,"65.55.37.104",25,6,372,6,372,0,0,12540.337428,9.012794999998732,330.19723626249333,0
"147.32.84.165",4401,"74.6.136.244",25,6,372,6,372,0,0,12540.437572,9.012744999999995,330.1990680974555,0
"147.32.84.165",4408,"205.188.103.1",25,6,372,6,372,0,0,12540.437668,9.01277200000004,330.1980789040249,0
"147.32.84.165",4411,"69.69.103.6",25,6,372,6,372,0,0,12540.437697,9.012792000001355,330.1973461719246,0
"147.32.84.165",4341,"212.117.174.7",4506,6,372,6,372,0,0,12545.044219,9.012871000000814,330.19445191213003,0
"147.32.84.165",4355,"64.12.90.1",25,6,372,6,372,0,0,12545.044355,9.012856999999713,330.19496481527386,0
"147.32.84.165",4413,"209.85.143.27",25,6,372,6,372,0,0,12546.546626,9.012849000000642,330.19525790344295,0
"147.32.84.165",4414,"205.188.59.193",25,6,372,6,372,0,0,12546.54676,9.012842000000092,330.1955143560677,0
"147.32.84.165",4425,"205.188.190.1",25,6,372,6,372,0,0,12547.548105,9.01246700000047,330.2092534707583,0
"147.32.84.165",4426,"74.6.136.244",25,6,372,6,372,0,0,12547.748408,9.012400000001435,330.2117083129384,0
"147.32.84.165",4367,"122.218.153.19",6667,4,248,4,248,0,0,12554.057276,3.0039340000002994,660.4672406250611,0
"147.32.84.165",4439,"96.30.21.168",25,6,372,6,372,0,0,12559.464743,9.013291999999637,330.1790289275128,0
"147.32.84.165",4443,"205.188.190.2",25,6,372,6,372,0,0,12559.666317,9.012022000000798,330.2255587036668,0
"147.32.84.165",4448,"207.115.21.22",25,6,372,6,372,0,0,12560.166063,9.013268999999127,330.1798714761856,0
"147.32.84.165",4449,"209.85.143.27",25,6,372,6,372,0,0,12561.267311,9.013386000000537,330.17558551246145,0
"147.32.84.165",4638,"74.6.136.244",25,6,372,6,372,0,0,12561.36851,9.01293799999985,330.1919973265155,0
"147.32.84.165",4640,"205.188.190.1",25,6,372,6,372,0,0,12561.368649,9.012935000000653,330.19210723252576,0
"147.32.84.165",4653,"209.85.143.27",25,6,372,6,372,0,0,12561.368708,9.012928000000102,330.19236368025645,0
"147.32.84.165",4654,"204.127.217.21",25,6,372,6,372,0,0,12561.368775,9.012911999998323,330.1929498480129,0
"147.32.84.165",4384,"212.117.174.7",4506,6,372,6,372,0,0,12565.977221,9.009800000001633,330.30699904542394,0
"147.32.84.165",4684,"64.12.90.97",25,6,372,6,372,0,0,12567.476406,9.012806000000637,330.1968332614493,0
"147.32.84.165",4688,"209.85.143.27",25,6,372,6,372,0,0,12568.47817,9.012789000000339,330.19745608156234,0
"147.32.84.165",4885,"64.12.139.193",25,6,372,6,372,0,0,12568.478231,9.012863000001744,330.19474499938855,0
"147.32.84.165",1091,"209.85.143.27",25,6,372,6,372,0,0,12568.678501,9.01263900000049,330.20295165487465,0
"147.32.84.165",1093,"74.6.136.244",25,6,372,6,372,0,0,12568.678563,9.012744999999995,330.1990680974555,0
"147.32.84.165",4355,"78.58.99.95",6667,6,372,6,372,0,0,12572.183141,9.012840999999753,330.19555099219895,0
"147.32.84.165",4425,"212.117.174.7",4506,6,372,6,372,0,0,12580.495127,9.012972999998965,330.19071509482404,0
"147.32.84.165",1139,"207.172.157.50",25,6,372,6,372,0,0,12580.495262,9.012963999999556,330.19104481058025,0
"147.32.84.165",1178,"209.85.143.27",25,6,372,6,372,0,0,12580.69535,9.013224000000264,330.18151995333886,0
"147.32.84.165",1182,"134.114.96.19",25,6,372,6,372,0,0,12580.695486,9.013240999998743,330.18089719340855,0
"147.32.84.165",1192,"205.188.103.1",25,6,372,6,372,0,0,12581.196119,9.013284000000567,330.1793219873925,0
"147.32.84.165",1194,"209.85.143.27",25,6,372,6,372,0,0,12582.297673,9.013403000000835,330.1749627748503,0
"147.32.84.165",1200,"74.6.136.244",25,6,372,6,372,0,0,12582.397907,9.013355999999476,330.17668446693693,0
"147.32.84.165",1201,"208.89.132.28",25,6,372,6,372,0,0,12582.398006,9.01339200000075,330.17536572244416,0
"147.32.84.165",1206,"64.12.139.193",25,6,372,6,372,0,0,12587.004821,9.012823999999455,330.1961738074748,0
"147.32.84.165",1209,"209.85.143.27",25,6,372,6,372,0,0,12587.00497,9.012774999999237,330.19796899403923,0
"147.32.84.165",1210,"74.125.67.27",25,6,372,6,372,0,0,12587.005044,9.012729000000036,330.1996542889494,0
"147.32.84.165",1212,"64.12.90.33",25,6,372,6,372,0,0,12588.506741,9.01282700000047,330.1960638986907,0
"147.32.84.165",4653,"174.133.57.141",80,16,3429,12,1428,4,2001,12589.508294,0.4764450000002398,23977.583981349893,33598.84141924449
"147.32.84.165",1213,"74.6.136.244",25,6,372,6,372,0,0,12589.661802,8.959445999998934,332.16339492423464,0
"147.32.84.165",1220,"64.12.139.193",25,6,372,6,372,0,0,12589.661865,8.959506999999576,332.16113341952195,0
"147.32.84.165",1222,"209.85.143.27",25,6,372,6,372,0,0,12589.708832,9.012658999999985,330.20221890121496,0
"147.32.84.165",1225,"216.17.3.48",25,6,372,6,372,0,0,12589.708909,9.012705999999525,330.20049694288895,0
"147.32.84.165",4384,"212.117.174.7",4506,6,372,6,372,0,0,12593.213321,9.013304000000062,330.1785893386021,0
"147.32.84.165",1091,"111.92.129.242",6667,2,124,2,124,0,0,12601.525263,9.999999747378752e-06,0,0
"147.32.84.165",4684,"174.133.57.141",80,17,3489,12,1428,5,2061,12601.725472,3.9735660000005737,2874.9994337575745,4149.421451662718
"147.32.84.165",1227,"170.202.219.7",25,6,372,6,372,0,0,12601.887097,8.951553999999305,332.4562416760521,0
"147.32.84.165",1229,"64.12.90.65",25,6,372,6,372,0,0,12602.226763,9.012441999999282,330.2101694524344,0
"147.32.84.165",1230,"207.115.21.24",25,6,372,6,372,0,0,12603.328424,9.01409700000113,330.14954243332716,0
"147.32.84.165",1231,"217.27.95.175",25,6,372,6,372,0,0,12603.428276,9.014361999999892,330.1398368514639,0
"147.32.84.165",4688,"212.117.174.7",4506,6,372,6,372,0,0,12608.034666,9.012934000000314,330.192143867901,0
"147.32.84.165",1239,"209.85.143.27",25,6,372,6,372,0,0,12608.034799,9.012938000001668,330.19199732644887,0
"147.32.84.165",1238,"74.6.136.244",25,6,372,6,372,0,0,12609.5371,9.012894999999844,330.19357265340955,0
"147.32.84.165",1240,"64.12.90.33",25,6,372,6,372,0,0,12610.638644,9.015108999999939,330.11248116911514,0
"147.32.84.165",1241,"209.85.143.27",25,6,372,6,372,0,0,12610.73865,9.01485700000012,330.12170908534216,0
"147.32.84.165",1242,"159.220.9.53",25,6,372,6,372,0,0,12610.738755,9.014875999999276,330.1210133118014,0
"147.32.84.165",4885,"210.75.13.174",6667,6,372,6,372,0,0,12614.243867,9.014773000000787,330.12478517204374,0
"147.32.84.165",1244,"205.188.103.1",25,6,372,6,372,0,0,12614.244018,9.014752000000954,330.12555420267637,0
"147.32.84.165",1178,"212.117.174.7",4506,6,372,6,372,0,0,12622.855873,8.91282499999943,333.90086757006793,0
"147.32.84.165",1091,"174.133.57.141",80,16,3429,12,1428,4,2001,12623.258836,0.4682359999987966,24397.953168977525,34187.88815905044
"147.32.84.165",1251,"209.85.143.27",25,6,372,6,372,0,0,12623.413723,8.855657000000065,336.0563761672317,0
"147.32.84.165",1256,"68.1.17.3",25,6,372,6,372,0,0,12623.413786,8.855718000000707,336.0540613420349,0
"147.32.84.165",1257,"207.115.21.24",25,6,372,6,372,0,0,12624.358698,8.912881000000198,333.8987696570765,0
"147.32.84.165",1259,"74.6.136.244",25,6,372,6,372,0,0,12624.458655,8.912914999998975,333.897495937114,0
"147.32.84.165",1262,"209.85.143.27",25,6,372,6,372,0,0,12624.45872,8.912974999999278,333.89524821961703,0
"147.32.84.165",1266,"205.188.190.2",25,6,372,6,372,0,0,12624.458749,8.913000000000466,333.8943116795517,0
"147.32.84.165",1267,"205.188.103.1",25,6,372,6,372,0,0,12628.964714,9.013382999999521,330.1756954076131,0
"147.32.84.165",1274,"209.85.143.27",25,6,372,6,372,0,0,12628.964847,9.013348000000406,330.17697752265485,0
"147.32.84.165",1282,"65.204.48.20",25,6,372,6,372,0,0,12630.466954,9.013542000000598,330.1698710673121,0
"147.32.84.165",1283,"219.109.215.203",25,6,372,6,372,0,0,12631.568659,9.016020999999455,330.07908921243416,0
"147.32.84.165",1307,"217.72.192.149",25,6,372,6,372,0,0,12631.668891,9.015362000000096,330.103217153118,0
"147.32.84.165",1212,"85.130.81.228",6667,6,372,6,372,0,0,12635.173732,9.013324999999895,330.1778200608582,0
"147.32.84.165",1220,"212.117.174.7",4506,6,372,6,372,0,0,12635.276195,9.01078299999972,330.2709653534097,0
"147.32.84.165",1213,"174.133.57.141",80,17,2011,12,1428,5,583,12635.276329,147.2883440000005,77.56214571874038,31.665777979009555
"147.32.84.165",1318,"64.12.90.65",25,6,372,6,372,0,0,12635.43262,8.95450400000118,332.3467162446527,0
"147.32.84.165",1321,"209.85.143.27",25,6,372,6,372,0,0,12643.785948,9.01334499999939,330.17708741873315,0
"147.32.84.165",1338,"209.85.143.27",25,6,372,6,372,0,0,12643.786082,9.013332999998966,330.1775270036447,0
"147.32.84.165",1340,"66.175.58.41",25,6,372,6,372,0,0,12643.786142,9.013324999999895,330.1778200608582,0
"147.32.84.165",1359,"205.188.156.193",25,6,372,6,372,0,0,12644.287121,9.012491000001319,330.2083741331408,0
"147.32.84.165",1360,"64.26.60.153",25,6,372,6,372,0,0,12645.288431,9.012878999999884,330.19415882539175,0
"147.32.84.165",1369,"74.125.67.27",25,6,372,6,372,0,0,12645.388532,9.012909999999465,330.1930231190788,0
"147.32.84.165",1239,"212.117.174.7",4506,6,372,6,372,0,0,12649.995425,9.012521000000561,330.20727496777147,0
"147.32.84.165",1380,"74.6.136.244",25,6,372,6,372,0,0,12651.497412,9.013057999998637,330.18760114496655,0
"147.32.84.165",1391,"64.12.90.65",25,6,372,6,372,0,0,12652.599248,9.012574999998833,330.2052964885602,0
"147.32.84.165",1403,"74.6.136.65",25,6,372,6,372,0,0,12652.599384,9.012567000001582,330.20558959500414,0
"147.32.84.165",1405,"61.195.68.133",25,6,372,6,372,0,0,12652.699364,9.012582999999722,330.2050033825033,0
"147.32.84.165",1244,"119.154.129.1",6667,6,372,6,372,0,0,12656.306523,9.010653000001184,330.27573029386537,0
"147.32.84.165",1422,"209.85.143.27",25,6,372,6,372,0,0,12656.406465,9.01093199999923,330.2655041676327,0
"147.32.84.165",1266,"212.117.174.7",4506,6,372,6,372,0,0,12664.818368,9.011280000000625,330.25274988678564,0
"147.32.84.165",1426,"74.6.136.244",25,6,372,6,372,0,0,12664.818499,9.011276999999609,330.25285983330986,0
"147.32.84.165",1434,"209.85.143.27",25,6,372,6,372,0,0,12664.818557,9.011270999999397,330.2530797265113,0
"147.32.84.165",1439,"64.12.139.193",25,6,372,6,372,0,0,12664.818616,9.011263999998846,330.2533362689608,0
"147.32.84.165",1448,"205.188.59.193",25,6,372,6,372,0,0,12665.317312,9.013018000001466,330.1890665257205,0
"147.32.84.165",1455,"66.94.236.34",25,6,372,6,372,0,0,12666.319022,9.012313000001086,330.21489599835706,0
"147.32.84.165",1456,"65.55.92.184",25,6,372,6,372,0,0,12666.418716,9.012840999999753,330.19555099219895,0
"147.32.84.165",1460,"209.85.143.27",25,6,372,6,372,0,0,12671.025449,9.012742999999318,330.1991413713034,0
"147.32.84.165",1467,"209.85.143.27",25,6,372,6,372,0,0,12671.025579,9.012736000000587,330.1993978298939,0
"147.32.84.165",1471,"205.188.103.1",25,6,372,6,372,0,0,12671.025639,9.012731000000713,330.1995810148738,0
"147.32.84.165",1473,"74.6.136.244",25,6,372,6,372,0,0,12672.527572,9.013406999998551,330.1748162487812,0
"147.32.84.165",1380,"174.133.57.141",80,17,2011,12,1428,5,583,12673.629018,252.31395800000064,45.27692439432927,18.484906808048994
"147.32.84.165",1496,"64.12.90.97",25,6,372,6,372,0,0,12673.629153,9.012946999999258,330.191667608857,0
"147.32.84.165",1505,"74.6.140.31",25,6,372,6,372,0,0,12673.72915,9.012935000000653,330.19210723252576,0
"147.32.84.165",1405,"212.117.174.7",4506,6,372,6,372,0,0,12677.334379,9.01320300000043,330.18228924832357,0
"147.32.84.165",1403,"111.88.79.41",6667,4,248,4,248,0,0,12677.434502,3.0045699999991484,660.3274345415691,0
"147.32.84.165",1516,"168.95.5.39",25,6,372,6,372,0,0,12685.846759,9.014486000000034,330.13529556759966,0
"147.32.84.165",1567,"209.85.143.27",25,6,372,6,372,0,0,12686.347682,9.012848000000304,330.1952945395173,0
"147.32.84.165",1586,"74.6.136.244",25,6,372,6,372,0,0,12687.348658,9.013171999999031,330.18342488086546,0
"147.32.84.165",1600,"168.95.195.16",25,6,372,6,372,0,0,12687.348793,9.0131650000003,330.1836813150432,0
"147.32.84.165",1612,"205.188.190.1",25,6,372,6,372,0,0,12687.449281,9.012539000001198,330.2066154720223,0
"147.32.84.165",1403,"67.195.168.31",25,6,372,6,372,0,0,12692.055409,8.91283999999905,333.900305626525,0
"147.32.84.165",1616,"65.54.188.94",25,6,372,6,372,0,0,12693.558153,8.912172000000282,333.92533267983447,0
"147.32.84.165",1621,"209.85.143.27",25,6,372,6,372,0,0,12694.660249,8.912075000000186,333.92896715971733,0
"147.32.84.165",1640,"98.139.175.224",25,6,372,6,372,0,0,12694.660382,8.912050000000818,333.9299038941351,0
"147.32.84.165",1646,"205.188.103.1",25,6,372,6,372,0,0,12694.760618,8.913478999998915,333.8763685874351,0
"147.32.84.165",1473,"212.117.174.7",4506,6,372,6,372,0,0,12697.76359,8.913134000000355,333.8892919145927,0
"147.32.84.165",1652,"74.6.136.244",25,6,372,6,372,0,0,12697.76372,8.913140999999086,333.8890296922606,0
"147.32.84.165",1653,"209.85.143.27",25,6,372,6,372,0,0,12698.265868,9.011500999999043,330.2446506969611,0
"147.32.84.165",1679,"205.188.59.193",25,6,372,6,372,0,0,12698.266001,9.011462000000392,330.2460799368483,0
"147.32.84.165",1683,"66.94.236.34",25,6,372,6,372,0,0,12706.776897,9.016028000000006,330.0788329406251,0
"147.32.84.165",1705,"205.188.103.1",25,6,372,6,372,0,0,12707.277498,9.012934000000314,330.192143867901,0
"147.32.84.165",1713,"74.6.136.244",25,6,372,6,372,0,0,12707.277533,9.013027999999395,330.18870017936257,0
"147.32.84.165",1721,"66.196.94.104",25,6,372,6,372,0,0,12707.277568,9.013049000001047,330.1879308544372,0
"147.32.84.165",1731,"77.238.184.241",25,6,372,6,372,0,0,12708.278701,9.013213000000178,330.18192291693776,0
"147.32.84.165",1567,"212.117.174.7",4506,6,372,6,372,0,0,12708.379238,9.012892000000647,330.1936825604685,0
"147.32.84.165",1733,"209.85.143.27",25,6,372,6,372,0,0,12712.985543,9.013252999999168,330.18045759952315,0
"147.32.84.165",1746,"209.85.143.27",25,6,372,6,372,0,0,12714.487634,9.013365000000704,330.17635477979286,0
"147.32.84.165",1751,"206.77.1.236",25,6,372,6,372,0,0,12714.487779,9.013345000001209,330.17708741866653,0
"147.32.84.165",1755,"205.188.190.1",25,6,372,6,372,0,0,12715.589158,9.013114999999743,330.1855129996771,0
"147.32.84.165",1778,"207.69.189.218",25,6,372,6,372,0,0,12715.692723,9.009605999999621,330.3141114051075,0
"147.32.84.165",1796,"209.85.143.27",25,6,372,6,372,0,0,12718.695181,9.011423000001741,330.24750918910644,0
"147.32.84.165",1815,"205.188.103.1",25,6,372,6,372,0,0,12718.695243,9.011504000000059,330.24454075590273,0
"147.32.84.165",1832,"209.85.143.27",25,6,372,6,372,0,0,12719.294893,9.013208000000304,330.18210608252906,0
"147.32.84.165",1849,"180.222.96.138",25,6,372,6,372,0,0,12719.295026,9.013280000001032,330.17946851752737,0
"147.32.84.165",1859,"205.188.156.193",25,6,372,6,372,0,0,12727.808776,9.010997999999745,330.2630851765902,0
"147.32.84.165",1871,"209.85.143.27",25,6,372,6,372,0,0,12728.308433,9.012048999999024,330.22456935157834,0
"147.32.84.165",1878,"205.188.103.1",25,6,372,6,372,0,0,12728.30854,9.012070000000676,330.2237998594969,0
"147.32.84.165",1892,"74.6.140.64",25,6,372,6,372,0,0,12728.308622,9.012053999998898,330.2243861388718,0
"147.32.84.165",1683,"212.117.174.7",4506,6,372,6,372,0,0,12729.309003,9.012883999999758,330.19397564642793,0
"147.32.84.165",1899,"205.188.190.2",25,6,372,6,372,0,0,12729.309137,9.01287500000035,330.19430536869584,0
"147.32.84.165",1906,"209.85.143.27",25,6,372,6,372,0,0,12729.409645,9.012386000000333,330.2122212696937,0
"147.32.84.165",1915,"74.125.67.27",25,6,372,6,372,0,0,12729.409778,9.012380000000121,330.2124411087815,0
"147.32.84.165",1916,"194.116.198.12",25,6,372,6,372,0,0,12734.015804,9.013522999999623,330.17056704688326,0
"147.32.84.165",1931,"184.172.33.106",25,6,372,6,372,0,0,12735.518142,9.012643999998545,330.2027684662215,0
"147.32.84.165",1941,"64.12.90.97",25,6,372,6,372,0,0,12736.619697,9.013102999999319,330.1859526070239,0
"147.32.84.165",1947,"74.6.136.244",25,6,372,6,372,0,0,12736.719723,9.013052000000243,330.1878209512072,0
"147.32.84.165",1953,"65.55.88.22",25,6,372,6,372,0,0,12739.724246,9.01286600000094,330.1946350916223,0
"147.32.84.165",1959,"209.85.143.27",25,6,372,6,372,0,0,12740.324937,9.013182000000597,330.18305854689305,0
"147.32.84.165",1967,"208.65.144.3",25,6,372,6,372,0,0,12748.837205,9.013052000000243,330.1878209512072,0
"147.32.84.165",1978,"205.188.103.1",25,6,372,6,372,0,0,12749.338222,9.01281999999992,330.1963203525674,0
"147.32.84.165",1892,"212.117.171.138",65500,22,1351,16,972,6,379,12750.33919,40.55480399999942,191.74053954249442,74.76302930720719
"147.32.84.165",1991,"74.6.140.64",25,6,372,6,372,0,0,12750.339324,9.012971999998626,330.1907517298904,0
"147.32.84.165",2010,"74.6.136.244",25,6,372,6,372,0,0,12750.439391,9.013268000000608,330.1799081087791,0
"147.32.84.165",2011,"66.94.236.34",25,6,372,6,372,0,0,12750.439522,9.013278999998874,330.17950515016474,0
"147.32.84.165",2018,"209.85.143.27",25,6,372,6,372,0,0,12755.046148,9.012784000000465,330.1976392643878,0
"147.32.84.165",2022,"205.188.156.193",25,6,372,6,372,0,0,12755.046281,9.012816999998904,330.1964302615222,0
"147.32.84.165",1916,"212.117.174.7",4506,6,372,6,372,0,0,12756.548369,9.012651999999434,330.20247536465257,0
"147.32.84.165",2029,"205.188.103.1",25,6,372,6,372,0,0,12757.652202,9.01053900000079,330.2799088933236,0
"147.32.84.165",2036,"213.171.221.177",25,6,372,6,372,0,0,12757.652337,9.010528000000704,330.28031209711213,0
"147.32.84.165",2038,"74.125.67.27",25,6,372,6,372,0,0,12757.75011,9.012719999998808,330.1999840226251,0
"147.32.84.165",2043,"168.95.6.59",25,6,372,6,372,0,0,12760.754272,8.91274599999997,333.9038271706621,0
"147.32.84.165",2044,"205.188.156.193",25,6,372,6,372,0,0,12761.357109,8.910737999998673,333.9790710938245,0
"147.32.84.165",2046,"64.12.90.98",25,6,372,6,372,0,0,12761.357176,8.910767000001215,333.97798416226055,0
"147.32.84.165",2047,"205.188.103.1",25,6,372,6,372,0,0,12769.767342,9.01314000000093,330.18459715478656,0
"147.32.84.165",2053,"65.55.37.120",25,6,372,6,372,0,0,12769.767476,9.013082999999824,330.1866852884921,0
"147.32.84.165",2064,"209.85.143.27",25,6,372,6,372,0,0,12770.267994,9.012753000000885,330.1987750024557,0
"147.32.84.165",2071,"74.6.136.244",25,6,372,6,372,0,0,12771.269919,9.012495999999373,330.2081909384711,0
"147.32.84.165",2074,"64.12.90.97",25,6,372,6,372,0,0,12771.369896,9.013134000000719,330.18481695709426,0
"147.32.84.165",2011,"212.117.174.7",4506,6,372,6,372,0,0,12775.976198,9.013268000000608,330.1799081087791,0
"147.32.84.165",2077,"205.188.103.1",25,6,372,6,372,0,0,12775.976341,9.013248999999632,330.18060413066604,0
"147.32.84.165",2104,"66.97.46.122",25,6,372,6,372,0,0,12777.479169,9.012157999999545,330.2205753605463,0
"147.32.84.165",2112,"98.139.175.224",25,6,372,6,372,0,0,12778.579994,9.015681000000768,330.0915371783614,0
"147.32.84.165",2115,"74.6.136.244",25,6,372,6,372,0,0,12778.680136,9.013028999999733,330.18866354475153,0
"147.32.84.165",2127,"205.188.103.1",25,6,372,6,372,0,0,12778.680298,9.013014000000112,330.18921306457116,0
"147.32.84.165",2162,"65.54.188.126",25,6,372,6,372,0,0,12778.680374,9.01300000000083,330.18972595137313,0
"147.32.84.165",2166,"64.12.90.33",25,6,372,6,372,0,0,12781.684713,9.012455000000045,330.2096931413233,0
"147.32.84.165",2174,"74.6.136.244",25,6,372,6,372,0,0,12782.285118,9.013263000000734,330.18009127213503,0
"147.32.84.165",2175,"205.188.103.1",25,6,372,6,372,0,0,12782.285249,9.013234000000011,330.18115362366007,0
"147.32.84.165",2177,"200.35.106.230",25,6,372,6,372,0,0,12782.285307,9.01320400000077,330.1822526151351,0
"147.32.84.165",2044,"212.117.174.7",4506,6,372,6,372,0,0,12790.798659,9.011721000000762,330.23658854948445,0
"147.32.84.165",2313,"74.6.136.244",25,6,372,6,372,0,0,12791.298545,9.012464999999793,330.2093267491267,0
"147.32.84.165",2047,"212.117.171.138",65500,51,4526,34,3454,17,1072,12791.298577,34.440794000000096,802.3043835748945,249.0070350875179
"147.32.84.165",2053,"217.72.192.149",25,6,372,6,372,0,0,12791.321253,8.989884999999049,331.0387174029829,0
"147.32.84.165",2319,"205.188.103.1",25,6,372,6,372,0,0,12792.299716,9.01293799999985,330.1919973265155,0
"147.32.84.165",2616,"64.12.90.97",25,6,372,6,372,0,0,12792.299854,9.012922999998409,330.1925468574984,0
"147.32.84.165",2620,"91.198.26.11",25,6,372,6,372,0,0,12792.29992,9.012910000001284,330.1930231190122,0
"147.32.84.165",2625,"65.245.57.15",25,6,372,6,372,0,0,12792.399839,9.013049999999566,330.18789422006347,0
"147.32.84.165",2071,"64.12.175.136",587,28,2461,20,1278,8,1183,12797.00654,28.828922999999122,354.6438415337372,328.281427648209
"147.32.84.165",2730,"205.188.190.1",25,6,372,6,372,0,0,12797.124525,8.995182000000568,330.8437783693328,0
"147.32.84.165",2074,"212.117.171.138",65500,20,1218,14,852,6,366,12798.508917,1.16660100000081,5842.614570016027,2509.855554725195
"147.32.84.165",2775,"74.6.136.244",25,6,372,6,372,0,0,12798.509121,9.012417000001733,330.211085439059,0
"147.32.84.165",2776,"202.81.31.142",25,6,372,6,372,0,0,12799.610102,9.012902999998914,330.1932795682322,0
"147.32.84.165",2784,"64.12.90.33",25,6,372,6,372,0,0,12799.710232,9.012985000001208,330.19027547472905,0
"147.32.84.165",2798,"74.125.148.11",25,6,372,6,372,0,0,12799.710378,9.012948999999935,330.19159433832607,0
"147.32.84.165",2127,"212.117.174.7",4506,6,372,6,372,0,0,12802.714638,9.012896000000183,330.19353601771724,0
"147.32.84.165",2104,"212.117.171.138",65500,31,4983,22,4068,9,915,12802.714697,9.955744000000777,3268.866696451562,735.2539398360814
"147.32.84.165",2802,"64.12.90.65",25,6,372,6,372,0,0,12802.714756,9.012855000000854,330.195038087234,0
"147.32.84.165",2810,"65.254.254.51",25,6,372,6,372,0,0,12803.315463,9.013474999999744,330.1723253240381,0
"147.32.84.165",2908,"76.96.62.116",25,6,372,6,372,0,0,12811.827635,9.012936000000991,330.19207059715865,0
"147.32.84.165",2044,"205.188.90.1",80,13,2890,10,1342,3,1548,12812.329104,0.43516099999942526,24671.328542801813,28458.432626123104
"147.32.84.165",2956,"207.115.37.23",25,6,372,6,372,0,0,12812.44656,8.994944000000032,330.85253226701457,0
"147.32.84.165",2958,"209.85.143.27",25,6,372,6,372,0,0,12813.334058,9.009164999999484,330.33028033121496,0
"147.32.84.165",2313,"212.117.171.138",65500,23,1398,16,972,7,426,12813.432851,4.829633999999714,1610.059892737309,705.6435332367217
"147.32.84.165",2961,"207.115.37.23",25,6,372,6,372,0,0,12813.432981,9.010378999999375,330.2857737726911,0
"147.32.84.165",2967,"209.85.143.27",25,6,372,6,372,0,0,12813.433038,9.010446000000229,330.28331782909794,0
"147.32.84.165",2969,"76.96.62.116",25,6,372,6,372,0,0,12813.433094,9.010442999999213,330.28342779597625,0
"147.32.84.165",2970,"209.85.143.27",25,6,372,6,372,0,0,12813.433149,9.01043799999934,330.28361107420284,0
"147.32.84.165",2985,"209.85.225.27",25,6,372,6,372,0,0,12813.433206,9.010432000000947,330.2838310082899,0
"147.32.84.165",2991,"64.18.5.10",25,6,372,6,372,0,0,12818.136632,9.013386000000537,330.17558551246145,0
"147.32.84.165",2620,"212.117.171.138",65500,20,1218,14,852,6,366,12819.538813,1.1833620000015799,5759.860465344417,2474.306256239503
"147.32.84.165",3019,"168.61.70.65",25,6,372,6,372,0,0,12819.539023,9.012690999999904,330.20104650209703,0
"147.32.84.165",3080,"207.69.189.220",25,6,372,6,372,0,0,12820.640774,9.012591000000612,330.20471027696675,0
"147.32.84.165",3103,"83.103.62.243",25,6,372,6,372,0,0,12820.746164,9.007180000000517,330.4030784329645,0
"147.32.84.165",2784,"212.117.171.138",65500,14,846,10,604,4,242,12823.745122,1.9418599999989965,2488.335925351208,996.9822747268086
"147.32.84.165",2798,"212.117.174.7",4506,6,372,6,372,0,0,12823.745185,9.012670000000071,330.201815888075,0
"147.32.84.165",3125,"209.85.143.27",25,6,372,6,372,0,0,12824.345733,9.01339100000041,330.1754023541045,0
"147.32.84.165",3133,"199.91.36.34",25,6,372,6,372,0,0,12824.345865,9.013354000000618,330.17675773078435,0
"147.32.84.165",2810,"212.117.171.138",65500,14,846,10,604,4,242,12832.858028,250.06648700000005,19.32286112372986,7.741941046262627
"147.32.84.165",3137,"207.69.189.220",25,6,372,6,372,0,0,12832.880644,8.890314999998736,334.74629414148126,0
"147.32.84.165",2071,"210.211.247.235",6667,4,248,4,248,0,0,12832.880707,2.9815459999990708,665.4265941228538,0
"147.32.84.165",3145,"209.85.225.27",25,6,372,6,372,0,0,12833.459084,8.912514999999985,333.91248149372035,0
"147.32.84.165",3147,"209.85.143.27",25,6,372,6,372,0,0,12833.459195,8.912528000000748,333.91199444195297,0
"147.32.84.165",3155,"209.85.225.27",25,6,372,6,372,0,0,12833.459222,8.912554000000455,333.9110203427489,0
"147.32.84.165",3156,"65.54.188.72",25,6,372,6,372,0,0,12833.459251,8.912576000000627,333.9101961093842,0
"147.32.84.165",2956,"174.133.57.141",80,17,2011,12,1428,5,583,12834.360148,310.80060799999956,36.75668485178773,15.006405650274683
"147.32.84.165",3157,"85.115.58.190",25,6,372,6,372,0,0,12834.460223,8.913162999999258,333.88820556745657,0
"147.32.84.165",3158,"209.85.143.27",25,6,372,6,372,0,0,12834.515009,8.858438999999635,335.95083738795546,0
"147.32.84.165",3187,"128.242.120.13",25,6,372,6,372,0,0,12839.066829,9.012872000001153,330.19441527624264,0
"147.32.84.165",3190,"205.188.190.1",25,6,372,6,372,0,0,12840.468789,9.017139999999927,330.03812738850945,0
"147.32.84.165",3191,"209.85.225.27",25,6,372,6,372,0,0,12841.570766,9.01250599999912,330.2078245496081,0
"147.32.84.165",3195,"65.55.92.168",25,6,372,6,372,0,0,12841.670867,9.01426999999967,330.14320627184554,0
"147.32.84.165",3237,"12.180.54.148",25,6,372,6,372,0,0,12844.675342,9.012944000000061,330.1917775146478,0
"147.32.84.165",3239,"209.85.143.27",25,6,372,6,372,0,0,12845.275821,9.01281999999992,330.1963203525674,0
"147.32.84.165",3243,"64.12.90.65",25,6,372,6,372,0,0,12845.275954,9.012826999998651,330.1960638987573,0
"147.32.84.165",3249,"212.170.244.44",25,6,372,6,372,0,0,12849.181321,9.013130999999703,330.1849268583912,0
"147.32.84.165",3254,"98.139.175.224",25,6,372,6,372,0,0,12854.389252,9.014784999999392,330.1243457276242,0
"147.32.84.165",3259,"207.115.37.23",25,6,372,6,372,0,0,12855.390372,9.012878999999884,330.19415882539175,0
"147.32.84.165",3271,"192.117.170.199",25,6,372,6,372,0,0,12855.390511,9.012864000000263,330.1947083635028,0
"147.32.84.165",3155,"218.94.106.74",6667,9,552,6,372,3,180,12860.097426,2.2431029999988823,1326.733547234114,641.9678454358616
"147.32.84.165",3286,"209.85.225.27",25,6,372,6,372,0,0,12861.500367,9.01154299999871,330.2431115293381,0
"147.32.84.165",3287,"82.165.24.57",25,6,372,6,372,0,0,12861.500501,9.011533999999301,330.2434413497448,0
"147.32.84.165",3292,"64.12.139.193",25,6,372,6,372,0,0,12862.340763,8.972626999999193,331.6754390882701,0
"147.32.84.165",3295,"98.139.175.224",25,6,372,6,372,0,0,12862.600707,9.012990999999602,330.19005566522054,0
"147.32.84.165",3301,"98.139.175.224",25,6,372,6,372,0,0,12862.600837,9.01300000000083,330.18972595137313,0
"147.32.84.165",3302,"76.96.62.116",25,6,372,6,372,0,0,12862.600903,9.013010999999096,330.1893229687946,0
"147.32.84.165",3315,"202.185.111.224",25,6,372,6,372,0,0,12862.700791,9.013005000000703,330.18954277732763,0
"147.32.84.165",3191,"212.117.174.7",4506,6,372,6,372,0,0,12865.705257,9.012709000000541,330.20038703122685,0
"147.32.84.165",3317,"209.85.143.27",25,6,372,6,372,0,0,12866.306337,9.012491999999838,330.2083374942306,0
"147.32.84.165",3323,"209.85.225.27",25,6,372,6,372,0,0,12870.211523,9.01314000000093,330.18459715478656,0
"147.32.84.165",3326,"64.12.139.193",25,6,372,6,372,0,0,12875.41934,9.012633000000278,330.2031714816201,0
"147.32.84.165",3327,"64.12.90.65",25,6,372,6,372,0,0,12875.419474,9.012627000000066,330.2033913086582,0
"147.32.84.165",3345,"211.174.55.162",25,6,372,6,372,0,0,12876.420671,9.013226000000941,330.18144668731145,0
"147.32.84.165",3347,"209.85.143.27",25,6,372,6,372,0,0,12876.420829,9.013191999998526,330.1826922138668,0
"147.32.84.165",3354,"209.85.225.27",25,6,372,6,372,0,0,12876.420909,9.013167999999496,330.1835714146421,0
"147.32.84.165",3365,"168.61.70.72",25,6,372,6,372,0,0,12876.42108,9.013049999999566,330.18789422006347,0
"147.32.84.165",3271,"212.117.174.7",4506,6,372,6,372,0,0,12882.529461,9.012842000000092,330.1955143560677,0
"147.32.84.165",3366,"76.96.62.116",25,6,372,6,372,0,0,12882.529605,9.012829999999667,330.1959539900464,0
"147.32.84.165",3379,"194.209.66.39",25,6,372,6,372,0,0,12882.529687,9.01281199999903,330.1966134432095,0
"147.32.84.165",3385,"69.4.216.8",25,6,372,6,372,0,0,12883.330537,9.013537000000724,330.17005421953235,0
"147.32.84.165",3386,"205.188.190.1",25,6,372,6,372,0,0,12883.634076,9.010293999999703,330.2888895745353,0
"147.32.84.165",3390,"64.12.90.65",25,6,372,6,372,0,0,12883.731229,9.012792999999874,330.1973095354616,0
"147.32.84.165",3394,"98.139.175.224",25,6,372,6,372,0,0,12883.731387,9.0127250000005,330.19980083713136,0
"147.32.84.165",3406,"67.231.144.228",25,6,372,6,372,0,0,12886.735592,9.013210999999501,330.1819961831765,0
"147.32.84.165",3407,"209.85.143.27",25,6,372,6,372,0,0,12887.336863,9.012715999999273,330.2001305710998,0
"147.32.84.165",3301,"74.125.127.27",25,6,372,6,372,0,0,12891.241891,9.012887000000774,330.1938657391072,0
"147.32.84.165",3426,"209.85.225.27",25,6,372,6,372,0,0,12896.449666,9.01287400000001,330.19434200455885,0
"147.32.84.165",3323,"78.249.161.87",6667,4,248,4,248,0,0,12897.456908,2.9981299999999464,661.7458215621189,0
"147.32.84.165",3438,"168.95.5.33",25,6,372,6,372,0,0,12897.457071,9.0065829999985,330.42497915141576,0
"147.32.84.165",3439,"76.96.62.116",25,6,372,6,372,0,0,12903.559523,8.913123000000269,333.8897039791676,0
"147.32.84.165",3450,"64.12.139.193",25,6,372,6,372,0,0,12904.361297,8.912443000001076,333.91517903672883,0
"147.32.84.165",3453,"84.206.24.179",25,6,372,6,372,0,0,12904.661166,8.912922999999864,333.89719623966744,0
"147.32.84.165",3454,"205.188.103.1",25,6,372,6,372,0,0,12904.761305,8.912797999999384,333.90187907323894,0
"147.32.84.165",3385,"212.117.174.7",4506,6,372,6,372,0,0,12907.665827,9.012681000000157,330.2014128759187,0
"147.32.84.165",3457,"213.4.149.224",25,6,372,6,372,0,0,12908.266387,9.012743999999657,330.1991047343754,0
"147.32.84.165",3458,"98.139.175.224",25,6,372,6,372,0,0,12912.173227,9.012002999999822,330.22625491803086,0
"147.32.84.165",3459,"124.108.116.109",25,6,372,6,372,0,0,12915.276425,9.013747999999396,330.16232537233117,0
"147.32.84.165",3460,"209.85.143.27",25,6,372,6,372,0,0,12917.37928,9.013130000001183,330.1849634921064,0
"147.32.84.165",3462,"209.85.225.27",25,6,372,6,372,0,0,12918.380958,9.01276499999949,330.19833536103164,0
"147.32.84.165",3463,"217.72.192.149",25,6,372,6,372,0,0,12924.489672,9.012896000000183,330.19353601771724,0
"147.32.84.165",3464,"64.12.139.193",25,6,372,6,372,0,0,12925.292105,9.011535999999978,330.2433680562345,0
"147.32.84.165",3465,"24.113.32.85",25,6,372,6,372,0,0,12925.591944,9.01213000000098,330.2216013306151,0
"147.32.84.165",3466,"148.123.15.75",25,6,372,6,372,0,0,12925.691446,9.01576599999862,330.0884250989273,0
"147.32.84.165",3467,"65.54.188.126",25,6,372,6,372,0,0,12928.695901,9.013184000001274,330.18298528018283,0
"147.32.84.165",3468,"64.12.139.193",25,6,372,6,372,0,0,12929.296458,9.013444999998683,330.17342425681136,0
"147.32.84.165",3469,"98.139.175.224",25,6,372,6,372,0,0,12929.29657,9.013455999998769,330.1730213139562,0
"147.32.84.165",3470,"212.56.128.203",25,6,372,6,372,0,0,12929.296611,9.013464999999997,330.1726916341275,0
"147.32.84.165",3473,"209.85.143.27",25,6,372,6,372,0,0,12933.202537,9.012512000001152,330.2076047166006,0
"147.32.84.165",3474,"209.85.225.27",25,6,372,6,372,0,0,12933.202669,9.012500999999247,330.20800774393797,0
"147.32.84.165",3476,"124.108.110.37",25,6,372,6,372,0,0,12933.202733,9.012491999999838,330.2083374942306,0
"147.32.84.165",3458,"212.117.174.7",4506,6,372,6,372,0,0,12936.306832,9.013307999999597,330.1784428092475,0
"147.32.84.165",3478,"64.12.139.193",25,6,372,6,372,0,0,12938.410057,9.01544400000057,330.10021469822357,0
"147.32.84.165",3479,"66.94.237.139",25,6,372,6,372,0,0,12938.410191,9.01542899999913,330.10076392374526,0
"147.32.84.165",3480,"165.237.59.23",25,6,372,6,372,0,0,12939.410982,9.013280000001032,330.17946851752737,0
"147.32.84.165",3482,"217.26.49.139",25,6,372,6,372,0,0,12945.520028,9.012705999999525,330.20049694288895,0
"147.32.84.165",3484,"64.12.139.193",25,6,372,6,372,0,0,12946.321175,9.01328900000044,330.17913882489006,0
"147.32.84.165",3485,"98.139.175.224",25,6,372,6,372,0,0,12946.621497,9.013257000000522,330.1803110684437,0
"147.32.84.165",3487,"69.2.104.22",25,6,372,6,372,0,0,12946.721542,9.01305400000092,330.18774768238336,0
"147.32.84.165",3465,"212.117.174.7",4506,6,372,6,372,0,0,12949.72608,9.013451999999234,330.17316783849884,0
"147.32.84.165",3489,"209.85.225.27",25,6,372,6,372,0,0,12949.72611,9.013517999999749,330.17075019987567,0
"147.32.84.165",3491,"85.115.52.190",25,6,372,6,372,0,0,12950.326684,9.013076000001092,330.18694172773417,0
"147.32.84.165",3468,"61.17.216.23",6667,6,372,6,372,0,0,12954.232296,9.013209000000643,330.18206944938123,0
"147.32.84.165",3469,"174.133.57.141",80,17,3489,12,1428,5,2061,12957.336844,6.429479000000356,1776.8158197576145,2564.4379583476493
"147.32.84.165",3492,"205.188.190.1",25,6,372,6,372,0,0,12957.336978,9.012721000000965,330.19994738544347,0
"147.32.84.165",3493,"77.238.177.9",25,6,372,6,372,0,0,12959.440273,9.01279699999941,330.19716298949095,0
"147.32.84.165",3494,"77.238.177.9",25,6,372,6,372,0,0,12960.441519,9.012785000000804,330.1976026277931,0
"147.32.84.165",3496,"74.85.246.28",25,6,372,6,372,0,0,12960.441652,9.012776999999915,330.19789572071164,0
"147.32.84.165",3479,"212.117.174.7",4506,6,372,6,372,0,0,12966.55187,9.012669000001551,330.20185252553796,0
"147.32.84.165",3498,"74.6.136.244",25,6,372,6,372,0,0,12967.351472,8.913022999999157,333.8934500674217,0
"147.32.84.165",3499,"205.188.103.1",25,6,372,6,372,0,0,12967.651987,8.912909000000582,333.8977207104668,0
"147.32.84.165",3500,"98.139.175.224",25,6,372,6,372,0,0,12967.752133,8.912872999999308,333.8990693573476,0
"147.32.84.165",3487,"174.133.57.141",80,17,3489,12,1428,5,2061,12970.75657,1.9938899999997375,5729.5036336014045,8269.26259723564
"147.32.84.165",3501,"209.92.99.193",25,6,372,6,372,0,0,12970.756632,8.913070999999036,333.8916519345938,0
"147.32.84.165",3502,"165.21.74.122",25,6,372,6,372,0,0,12971.357239,8.912797999999384,333.90187907323894,0
"147.32.84.165",3489,"78.249.161.87",6667,6,372,6,372,0,0,12975.964726,8.912108999998964,333.9276932093566,0
"147.32.84.165",3503,"195.50.106.142",25,6,372,6,372,0,0,12978.266854,9.013284000000567,330.1793219873925,0
"147.32.84.165",3511,"24.215.0.65",25,6,372,6,372,0,0,12980.370566,9.012419000000591,330.2110121599767,0
"147.32.84.165",3493,"212.117.174.7",4506,6,372,6,372,0,0,12981.371649,9.013003999998546,330.18957941220043,0
"147.32.84.165",3513,"64.12.139.193",25,6,372,6,372,0,0,12981.371782,9.012998000000152,330.1897992210749,0
"147.32.84.165",3514,"205.188.190.1",25,6,372,6,372,0,0,12987.480406,9.01289899999938,330.1934261107558,0
"147.32.84.165",3516,"209.85.225.27",25,6,372,6,372,0,0,12988.281651,9.012636999999813,330.2030249304462,0
"147.32.84.165",3517,"98.139.175.224",25,6,372,6,372,0,0,12988.582122,9.012606000000233,330.2041607055632,0
"147.32.84.165",3518,"74.6.136.244",25,6,372,6,372,0,0,12988.582256,9.012622000000192,330.2035744980691,0
"147.32.84.165",3520,"216.155.74.236",25,6,372,6,372,0,0,12988.682036,9.012743999999657,330.1991047343754,0
"147.32.84.165",3522,"213.189.198.9",25,6,372,6,372,0,0,12991.686347,9.012810999998692,330.1966500795847,0
"147.32.84.165",3523,"207.115.20.23",25,6,372,6,372,0,0,12992.287269,9.015043999999762,330.11486133623737,0
"147.32.84.165",3525,"78.47.84.50",25,6,372,6,372,0,0,12996.993898,9.013136999999915,330.1847070559371,0
"147.32.84.165",3528,"168.95.5.39",25,6,372,6,372,0,0,12999.297169,9.013269000000946,330.179871476119,0
"147.32.84.165",3529,"205.188.103.1",25,6,372,6,372,0,0,13001.402709,9.010491000000911,330.28166833524375,0
"147.32.84.165",3530,"98.139.175.224",25,6,372,6,372,0,0,13002.402192,9.01234900000054,330.21357694867584,0
"147.32.84.165",3493,"212.117.174.7",4506,6,372,6,372,0,0,13008.510557,9.012985999999728,330.1902388398351,0
"147.32.84.165",3532,"209.85.225.27",25,6,372,6,372,0,0,13009.311614,9.013043999999354,330.1881140267609,0
"147.32.84.165",3534,"64.98.36.4",25,6,372,6,372,0,0,13009.612012,9.013076000001092,330.18694172773417,0
"147.32.84.165",3535,"203.188.197.119",25,6,372,6,372,0,0,13009.712314,9.012934000000314,330.192143867901,0
"147.32.84.165",3520,"212.117.174.7",4506,6,372,6,372,0,0,13012.716592,9.013537999999244,330.17001758912534,0
"147.32.84.165",3536,"64.12.139.193",25,6,372,6,372,0,0,13012.71665,9.013605000000098,330.1675633667071,0
"147.32.84.165",3537,"66.94.237.139",25,6,372,6,372,0,0,13013.317315,9.013108999999531,330.1857328032042,0
"147.32.84.165",3541,"194.109.125.213",25,6,372,6,372,0,0,13018.024231,9.013340999999855,330.1772339468847,0
"147.32.84.165",3542,"209.85.225.27",25,6,372,6,372,0,0,13020.327542,9.012868999998318,330.19452518399584,0
"147.32.84.165",3543,"98.139.175.224",25,6,372,6,372,0,0,13020.327685,9.0128509999995,330.19518463138525,0
"147.32.84.165",3544,"76.96.62.116",25,6,372,6,372,0,0,13020.327742,9.01284300000043,330.1954777199445,0
"147.32.84.165",3545,"64.12.90.65",25,6,372,6,372,0,0,13022.430708,9.012993000000279,330.18998239540497,0
"147.32.84.165",3548,"216.155.74.236",25,6,372,6,372,0,0,13023.431894,9.01293700000133,330.19203396179967,0
"147.32.84.165",3550,"74.125.113.27",25,6,372,6,372,0,0,13029.540745,9.012849000000642,330.19525790344295,0
"147.32.84.165",3551,"205.188.103.1",25,6,372,6,372,0,0,13030.344261,9.010951000000205,330.26480778776096,0
"147.32.84.165",3552,"74.6.136.244",25,6,372,6,372,0,0,13030.642776,9.01282799999899,330.19602726251225,0
"147.32.84.165",3553,"98.139.54.60",25,6,372,6,372,0,0,13030.742627,9.012957000000824,330.191301256594,0
"147.32.84.165",3554,"209.85.225.27",25,6,372,6,372,0,0,13033.747287,9.013444000000163,330.1734608879742,0
"147.32.84.165",3555,"167.136.36.141",25,6,372,6,372,0,0,13034.348097,9.01260899999943,330.2040507915287,0
"147.32.84.165",3520,"212.117.174.7",4506,6,372,6,372,0,0,13039.055328,8.912830999999642,333.9006427924101,0
"147.32.84.165",3537,"41.239.162.145",6667,4,248,4,248,0,0,13041.358307,3.003850999999486,660.4854901259548,0
"147.32.84.165",3556,"216.82.241.99",25,6,372,6,372,0,0,13043.461038,8.912368999999671,333.91795155700015,0
"147.32.84.165",3543,"212.117.174.7",4506,6,372,6,372,0,0,13044.462149,8.914408999999068,333.8415367749349,0
"147.32.84.165",3557,"76.96.62.116",25,6,372,6,372,0,0,13044.462443,8.914238999999725,333.8479033375807,0
"147.32.84.165",3559,"205.188.103.1",25,6,372,6,372,0,0,13050.471442,9.014365999999427,330.1396903565031,0
"147.32.84.165",3561,"216.69.186.201",25,6,372,6,372,0,0,13050.471583,9.014350999999806,330.1402397133265,0
"147.32.84.165",3562,"74.125.113.27",25,6,372,6,372,0,0,13051.271834,9.013155000000552,330.18404765033085,0
"147.32.84.165",3563,"98.139.175.224",25,6,372,6,372,0,0,13051.572548,9.012870000000476,330.19448854802556,0
"147.32.84.165",3565,"209.85.225.27",25,6,372,6,372,0,0,13051.672429,9.013129999999364,330.1849634921731,0
"147.32.84.165",3566,"64.12.139.193",25,6,372,6,372,0,0,13051.672571,9.013116000000082,330.1854763657733,0
"147.32.84.165",3567,"64.98.36.4",25,6,372,6,372,0,0,13054.677183,9.013010000000577,330.18935960348534,0
"147.32.84.165",3570,"204.232.236.138",25,6,372,6,372,0,0,13055.277665,9.013026000000536,330.18877344854246,0
"147.32.84.165",3571,"161.85.125.6",25,6,372,6,372,0,0,13058.282217,9.015314000000217,330.10497471301926,0
"147.32.84.165",3573,"209.85.225.27",25,6,372,6,372,0,0,13059.984497,9.013006000001042,330.1895061425296,0
"147.32.84.165",3576,"64.12.139.193",25,6,372,6,372,0,0,13064.390748,9.013011000000915,330.18932296872794,0
"147.32.84.165",3577,"207.115.37.23",25,6,372,6,372,0,0,13064.390883,9.013004000000365,330.1895794121338,0
"147.32.84.165",3578,"203.188.197.119",25,6,372,6,372,0,0,13065.392262,9.012832000000344,330.1958807176131,0
"147.32.84.165",3579,"148.245.131.66",25,6,372,6,372,0,0,13071.501435,9.012738999999783,330.1992879190301,0
"147.32.84.165",3580,"207.115.21.20",25,6,372,6,372,0,0,13072.302469,9.012596999999005,330.20449044823914,0
"147.32.84.165",3581,"98.139.175.224",25,6,372,6,372,0,0,13072.602935,9.01311799999894,330.1854030980566,0
"147.32.84.165",3584,"205.188.190.1",25,6,372,6,372,0,0,13072.702918,9.01270199999999,330.2006434918189,0
"147.32.84.165",3565,"212.117.174.7",4506,6,372,6,372,0,0,13075.707371,9.012720999999146,330.1999473855101,0
"147.32.84.165",3566,"212.117.174.7",4506,6,372,6,372,0,0,13076.307934,9.013059999999314,330.1875278762403,0
"147.32.84.165",3585,"209.85.225.27",25,6,372,6,372,0,0,13076.308087,9.013039999999819,330.1882605646996,0
"147.32.84.165",3586,"207.115.37.23",25,6,372,6,372,0,0,13076.308145,9.013044999999693,330.1880773922799,0
"147.32.84.165",3587,"65.55.88.22",25,6,372,6,372,0,0,13076.308203,9.01304799999889,330.1879674889523,0
"147.32.84.165",3588,"209.85.225.27",25,6,372,6,372,0,0,13079.312521,9.012726999999359,330.1997275630574,0
"147.32.84.165",3589,"216.36.79.66",25,6,372,6,372,0,0,13079.312579,9.012806000000637,330.1968332614493,0
"147.32.84.165",3590,"192.9.171.171",25,6,372,6,372,0,0,13081.01474,9.013059999999314,330.1875278762403,0
"147.32.84.165",2810,"212.117.171.138",65500,14,846,10,604,4,242,13085.420988,78.06685900000048,61.895663049540275,24.79925572514693
"147.32.84.165",3591,"205.188.156.193",25,6,372,6,372,0,0,13085.44368,8.990294999999605,331.0236204707555,0
"147.32.84.165",3593,"64.12.139.193",25,6,372,6,372,0,0,13086.422838,9.013004999998884,330.18954277739425,0
"147.32.84.165",3594,"98.139.175.224",25,6,372,6,372,0,0,13092.533341,9.010741000000053,330.27250478068146,0
"147.32.84.165",3595,"209.85.225.27",25,6,372,6,372,0,0,13092.533484,9.010726000000432,330.2730545796041,0
"147.32.84.165",3597,"65.55.88.22",25,6,372,6,372,0,0,13093.332645,9.015271999998731,330.1065125933437,0
"147.32.84.165",3598,"64.207.35.180",25,6,372,6,372,0,0,13093.332779,9.015266999998858,330.10669567527805,0
"147.32.84.165",3599,"80.237.187.77",25,6,372,6,372,0,0,13093.632991,9.013482000000295,330.1720689074325,0
"147.32.84.165",3601,"205.188.190.1",25,6,372,6,372,0,0,13093.733053,9.01349300000038,330.17166596788553,0
"147.32.84.165",3602,"94.245.120.86",25,6,372,6,372,0,0,13096.737223,9.012930999999298,330.1922537740755,0
"147.32.84.165",3604,"209.85.143.27",25,6,372,6,372,0,0,13097.338516,9.012877000001026,330.19423209699426,0
"147.32.84.165",3566,"173.192.170.88",80,20,2978,16,2732,4,246,13100.342658,21.333364000000074,1024.4985272833635,92.24986739081531
"147.32.84.165",3585,"173.192.170.88",80,6,372,6,372,0,0,13100.543725,9.012007000001176,330.2261083462997,0
"147.32.84.165",3605,"205.188.190.1",25,6,372,6,372,0,0,13100.543786,9.012129000000641,330.2216379725355,0
"147.32.84.165",3607,"65.55.92.152",25,6,372,6,372,0,0,13100.543846,9.012163999999757,330.22035551062766,0
"147.32.84.165",3589,"212.117.174.7",4506,6,372,6,372,0,0,13102.044822,9.013961000000563,330.1545236328196,0
"147.32.84.165",3608,"209.191.88.254",25,6,372,6,372,0,0,13106.451443,8.91260499999953,333.9091096262155,0
"147.32.84.165",3609,"209.85.225.27",25,6,372,6,372,0,0,13107.452746,8.91294199999902,333.8964844604988,0
"147.32.84.165",3610,"98.139.175.224",25,6,372,6,372,0,0,13107.452879,8.912945000000036,333.89637207454865,0
"147.32.84.165",3611,"64.12.139.193",25,6,372,6,372,0,0,13113.561467,8.912846999999601,333.900043386825,0
"147.32.84.165",3612,"209.85.225.27",25,6,372,6,372,0,0,13114.36265,8.912732000000688,333.9043516622928,0
"147.32.84.165",3617,"203.131.74.12",25,6,372,6,372,0,0,13114.663456,8.912780999999086,333.90251594876,0
"147.32.84.165",3618,"64.12.139.193",25,6,372,6,372,0,0,13114.763171,8.912962000000334,333.89573522246457,0
"147.32.84.165",3620,"65.55.92.168",25,6,372,6,372,0,0,13114.763305,8.912931999999273,333.8968590807428,0
"147.32.84.165",3597,"178.165.97.227",6667,9,552,6,372,3,180,13117.667527,1.0672560000002704,2788.459376193946,1349.2545368680383
"147.32.84.165",3622,"67.195.168.31",25,6,372,6,372,0,0,13118.268576,9.012988000000405,330.1901655699382,0
"147.32.84.165",3623,"98.139.175.224",25,6,372,6,372,0,0,13118.735023,8.947142000000895,332.6201819530418,0
"147.32.84.165",3624,"74.6.136.65",25,6,372,6,372,0,0,13118.735098,8.947191000001112,332.61836033226854,0
"147.32.84.165",3627,"209.85.225.27",25,6,372,6,372,0,0,13121.474985,9.010817999998835,330.26968250833437,0
"147.32.84.165",3628,"64.12.139.193",25,6,372,6,372,0,0,13121.475116,9.010811000000103,330.2699390765122,0
"147.32.84.165",3631,"98.139.175.224",25,6,372,6,372,0,0,13121.475173,9.01080699999875,330.2700856871547,0
"147.32.84.165",3634,"209.85.143.27",25,6,372,6,372,0,0,13121.475228,9.010803000001033,330.270232297794,0
"147.32.84.165",3566,"173.192.170.88",80,43,5625,30,2254,13,3371,13122.975003,102.73223599999983,175.52426290030357,262.5076709125658
"147.32.84.165",3605,"212.117.174.7",4506,6,372,6,372,0,0,13127.381854,9.012502999999924,330.20793446615494,0
"147.32.84.165",3604,"173.192.170.88",80,17,4844,12,1166,5,3678,13128.382706,1.601902999998856,5823.074181149957,18368.15337758966
"147.32.84.165",3589,"173.192.170.88",80,17,4850,12,1166,5,3684,13128.382838,1.7055149999996502,5469.315719886318,17280.41090228233
"147.32.84.165",3635,"81.93.1.103",25,6,372,6,372,0,0,13128.382897,9.012770999999702,330.1981155407253,0
"147.32.84.165",3608,"212.117.174.7",4506,6,372,6,372,0,0,13132.189181,9.012330999999904,330.2142364722325,0
"147.32.84.165",3609,"111.92.142.42",6667,4,248,4,248,0,0,13132.189244,3.0036180000006425,660.5367260415857,0
"147.32.84.165",3636,"213.199.180.150",25,6,372,6,372,0,0,13134.491554,9.012960000000021,330.19119135112027,0
"147.32.84.165",3638,"98.139.54.60",25,6,372,6,372,0,0,13135.292843,9.012818000001062,330.1963936251292,0
"147.32.84.165",3639,"174.120.11.194",25,6,372,6,372,0,0,13135.593226,9.01293799999985,330.1919973265155,0
"147.32.84.165",3641,"50.22.67.226",25,6,372,6,372,0,0,13135.693335,9.013645000000906,330.1660981766756,0
"147.32.84.165",3643,"205.188.103.1",25,6,372,6,372,0,0,13139.298582,9.012799000000086,330.1970897165211,0
"147.32.84.165",3646,"209.85.225.27",25,6,372,6,372,0,0,13139.699546,9.01317200000085,330.18342488079884,0
"147.32.84.165",3647,"98.139.175.225",25,6,372,6,372,0,0,13142.503079,9.013026999999056,330.1887368139818,0
"147.32.84.165",3627,"174.133.57.141",80,17,3489,12,1428,5,2061,13148.41171,1.174961999999141,9722.867633173117,14032.794252079688
"147.32.84.165",3649,"65.55.88.22",25,6,372,6,372,0,0,13148.57177,8.952924999999595,332.4053312185832,0
"147.32.84.165",3650,"209.85.143.27",25,6,372,6,372,0,0,13149.413021,9.012918000000354,330.1927300348104,0
"147.32.84.165",3627,"202.44.45.5",6667,9,552,6,372,3,180,13151.416072,1.9242969999995694,1546.538813915246,748.3252325396351
"147.32.84.165",3653,"161.88.253.52",25,6,372,6,372,0,0,13153.340613,8.991352999999435,330.9846693818146,0
"147.32.84.165",3608,"212.117.174.7",4506,6,372,6,372,0,0,13155.522372,9.012418000000253,330.2110487995471,0
"147.32.84.165",3654,"65.54.188.110",25,6,372,6,372,0,0,13156.323548,9.012361999999484,330.21310062780105,0
"147.32.84.165",3657,"74.125.148.11",25,6,372,6,372,0,0,13156.624123,9.012211999999636,330.2185967218836,0
"147.32.84.165",3658,"65.55.92.184",25,6,372,6,372,0,0,13156.723577,9.012933999998495,330.1921438679676,0
"147.32.84.165",3659,"209.85.225.27",25,6,372,6,372,0,0,13160.328761,9.013017999999647,330.1890665257871,0
"147.32.84.165",3660,"209.85.143.27",25,6,372,6,372,0,0,13160.328855,9.013052000000243,330.1878209512072,0
"147.32.84.165",3665,"64.12.139.193",25,6,372,6,372,0,0,13160.328892,9.013066000001345,330.1873080702567,0
"147.32.84.165",3667,"75.180.132.243",25,6,372,6,372,0,0,13160.731653,9.010573999999906,330.27862597877015,0
"147.32.84.165",3668,"151.151.26.141",25,6,372,6,372,0,0,13163.535244,9.011081999999078,330.26000651201537,0
"147.32.84.165",2810,"212.117.171.138",65500,14,846,10,604,4,242,13169.541928,44.80800999999883,107.83786202511841,43.206560612713005
"147.32.84.165",3669,"82.223.191.131",25,6,372,6,372,0,0,13169.564746,8.990558999999848,331.0139002480324,0
"147.32.84.165",3671,"98.139.175.224",25,6,372,6,372,0,0,13170.44349,9.012689000001046,330.20111977675634,0
"147.32.84.165",3672,"209.85.225.27",25,6,372,6,372,0,0,13174.349335,9.015305999999327,330.10526764152235,0
"147.32.84.165",3675,"64.12.139.193",25,6,372,6,372,0,0,13176.551937,8.91307500000039,333.89150209101456,0
"147.32.84.165",3677,"204.127.217.16",25,6,372,6,372,0,0,13176.552072,8.913065999999162,333.8918392391888,0
"147.32.84.165",3678,"74.125.113.27",25,6,372,6,372,0,0,13177.353661,8.912270000000717,333.92166081141625,0
"147.32.84.165",3679,"205.188.190.1",25,6,372,6,372,0,0,13177.653976,8.91352200000074,333.87475792394446,0
"147.32.84.165",3683,"98.139.175.224",25,6,372,6,372,0,0,13177.753903,8.913855999999214,333.86224771863743,0
"147.32.84.165",3684,"209.85.143.27",25,6,372,6,372,0,0,13177.754038,8.913844000000609,333.86269717080495,0
"147.32.84.165",3658,"173.192.170.88",80,19,1765,14,1208,5,557,13181.359187,84.90184299999964,113.82556206701003,52.48413747626207
"147.32.84.165",3686,"200.80.13.113",25,6,372,6,372,0,0,13181.359321,8.912426000000778,333.915815962987,0
"147.32.84.165",3691,"205.188.103.1",25,6,372,6,372,0,0,13181.759658,9.01274899999953,330.1989215499239,0
"147.32.84.165",3667,"212.117.174.7",4506,6,372,6,372,0,0,13184.563769,8.913339999999152,333.88157525689394,0
"147.32.84.165",3693,"216.82.251.230",25,6,372,6,372,0,0,13190.471998,9.013088999998217,330.1864654837635,0
"147.32.84.165",3696,"195.75.94.108",25,6,372,6,372,0,0,13191.373797,9.01296100000036,330.19115471595643,0
"147.32.84.165",3669,"212.117.174.7",4506,6,372,6,372,0,0,13195.279177,9.012977999998839,330.1905319196811,0
"147.32.84.165",3697,"209.85.225.27",25,6,372,6,372,0,0,13195.279309,9.012957000000824,330.191301256594,0
"147.32.84.165",3698,"65.54.188.110",25,6,372,6,372,0,0,13197.482056,9.013418999998976,330.17437667108766,0
"147.32.84.165",3703,"216.17.3.48",25,6,372,6,372,0,0,13198.283659,9.012634999999136,330.2030982060502,0
"147.32.84.165",3705,"74.6.136.244",25,6,372,6,372,0,0,13198.583905,9.012679000001299,330.20148615074066,0
"147.32.84.165",3706,"64.12.139.193",25,6,372,6,372,0,0,13198.684184,9.014385000000402,330.13899450709806,0
"147.32.84.165",3677,"174.133.57.141",80,17,3489,12,1428,5,2061,13202.289169,0.7920659999999771,14423.040504200826,20816.447114256232
"147.32.84.165",3709,"205.188.103.1",25,6,372,6,372,0,0,13202.451401,8.951122999998915,332.4722495714069,0
"147.32.84.165",3710,"129.35.232.212",25,6,372,6,372,0,0,13202.451464,8.951184999999896,332.4699467165559,0
"147.32.84.165",3711,"209.85.225.27",25,6,372,6,372,0,0,13202.78969,9.013112000000547,330.1856229013707,0
"147.32.84.165",3712,"77.238.177.9",25,6,372,6,372,0,0,13202.789824,9.013103000001138,330.18595260695724,0
"147.32.84.165",3684,"125.40.93.86",6667,4,248,4,248,0,0,13205.496322,3.001773999998477,660.942496004365,0
"147.32.84.165",3714,"98.139.175.224",25,6,372,6,372,0,0,13211.502383,9.012901000000056,330.1933528394444,0
"147.32.84.165",3715,"216.17.3.48",25,6,372,6,372,0,0,13212.403578,9.013216999999713,330.18177638462436,0
"147.32.84.165",3716,"209.85.143.27",25,6,372,6,372,0,0,13212.403713,9.013206999999966,330.182142715685,0
"147.32.84.165",3684,"212.117.174.7",4506,6,372,6,372,0,0,13216.309474,9.012953999999809,330.19141116220754,0
"147.32.84.165",2810,"212.117.171.138",65500,14,846,10,604,4,242,13218.512608,222.17934200000127,21.748196553755086,8.713681400676705
"147.32.84.165",3718,"207.115.21.20",25,6,372,6,372,0,0,13218.535223,8.99020500000006,331.026934313509,0
"147.32.84.165",3721,"64.12.139.193",25,6,372,6,372,0,0,13219.313584,9.014234000000215,330.1445247593893,0
"147.32.84.165",3722,"65.55.37.120",25,6,372,6,372,0,0,13219.313642,9.014305000000604,330.14192441899854,0
"147.32.84.165",3724,"209.85.225.27",25,6,372,6,372,0,0,13219.613925,9.013005000000703,330.18954277732763,0
"147.32.84.165",3726,"74.122.245.36",25,6,372,6,372,0,0,13219.714045,9.01314899999852,330.1842674519736,0
"147.32.84.165",3706,"212.117.174.7",4506,6,372,6,372,0,0,13223.419421,9.01299999999901,330.18972595143975,0
"147.32.84.165",3727,"209.85.143.27",25,6,372,6,372,0,0,13223.41957,9.012990999999602,330.19005566522054,0
"147.32.84.165",3728,"209.85.225.27",25,6,372,6,372,0,0,13223.419645,9.0130079999999,330.18943287302454,0
"147.32.84.165",3731,"192.85.154.102",25,6,372,6,372,0,0,13223.419719,9.013003000000026,330.1896160469481,0
"147.32.84.165",3735,"64.12.139.193",25,6,372,6,372,0,0,13223.82069,9.01238199999898,330.21236782909745,0
"147.32.84.165",3710,"84.25.41.150",6667,6,372,6,372,0,0,13225.922964,9.013511000001017,330.1710066143664,0
"147.32.84.165",3736,"74.6.136.244",25,6,372,6,372,0,0,13232.532876,9.01299199999994,330.1900190303087,0
"147.32.84.165",3737,"98.139.175.225",25,6,372,6,372,0,0,13233.433917,9.012877999999546,330.19419546122225,0
"147.32.84.165",3738,"65.55.37.88",25,6,372,6,372,0,0,13237.339393,9.00666099999944,330.4221175861049,0
"147.32.84.165",3739,"209.85.225.27",25,6,372,6,372,0,0,13239.54565,9.006763999999748,330.41833892839685,0
"147.32.84.165",3744,"62.211.72.32",25,6,372,6,372,0,0,13239.54584,9.00672399999894,330.4198063580443,0
"147.32.84.165",3745,"209.85.143.27",25,6,372,6,372,0,0,13240.343975,9.011293999999907,330.25223680417383,0
"147.32.84.165",3746,"66.94.238.147",25,6,372,6,372,0,0,13240.644179,8.912339999998949,333.919038097778,0
"147.32.84.165",3750,"64.12.139.193",25,6,372,6,372,0,0,13240.744766,8.91177400000015,333.94024579168524,0
"147.32.84.165",3752,"199.239.254.18",25,6,372,6,372,0,0,13240.744913,8.911717999999382,333.9423442259064,0
"147.32.84.165",3724,"212.117.174.7",4506,6,372,6,372,0,0,13244.449692,8.919141000000309,333.6644190286819,0
"147.32.84.165",3726,"98.126.71.122",80,19,5021,14,1534,5,3487,13244.850254,17.7945869999985,689.6479249561136,1567.667740757476
"147.32.84.165",3753,"64.12.139.193",25,6,372,6,372,0,0,13245.024892,8.845095000000583,336.45766382382595,0
"147.32.84.165",3727,"115.240.199.38",6667,6,372,6,372,0,0,13246.646724,8.928656000000046,333.3088428986383,0
"147.32.84.165",3728,"95.100.248.96",80,17,5936,12,2782,5,3154,13253.468458,9.176508000000467,2425.323445476086,2749.6298156116372
"147.32.84.165",3755,"74.125.113.27",25,6,372,6,372,0,0,13253.469263,9.0282729999999,329.6311487257899,0
"147.32.84.165",3760,"74.6.136.244",25,6,372,6,372,0,0,13254.371282,9.04460199999994,329.03603718549687,0
"147.32.84.165",3763,"209.85.225.27",25,6,372,6,372,0,0,13258.283598,9.037288999999873,329.30229408399373,0
"147.32.84.165",3765,"209.85.143.27",25,6,372,6,372,0,0,13260.490477,9.033605000000534,329.43658705465026,0
"147.32.84.165",3769,"204.127.217.16",25,6,372,6,372,0,0,13260.490551,9.033668999998554,329.4342531257761,0
"147.32.84.165",3772,"192.85.154.102",25,6,372,6,372,0,0,13261.29377,9.033306999999695,329.4474548468352,0
"147.32.84.165",3773,"64.98.36.4",25,6,372,6,372,0,0,13261.594841,9.032013000000006,329.49465418174196,0
"147.32.84.165",3778,"65.55.37.88",25,6,372,6,372,0,0,13261.69466,9.031740000000354,329.5046137289031,0
"147.32.84.165",3745,"212.117.174.7",4506,6,372,6,372,0,0,13265.418267,9.013170000000173,330.1834981477042,0
"147.32.84.165",3781,"195.110.124.132",25,6,372,6,372,0,0,13265.918939,9.013408000000709,330.1747796171843,0
"147.32.84.165",3752,"173.192.170.88",80,11,1283,8,846,3,437,13266.921024,33.17779300000075,203.9918688985686,105.37168641687292
"147.32.84.165",3658,"178.148.4.76",6667,6,372,6,372,0,0,13267.121955,9.011952999999266,330.2280870750482,0
"147.32.84.165",3782,"66.94.237.139",25,6,372,6,372,0,0,13274.531777,9.01245899999958,330.20954658436045,0
"147.32.84.165",3728,"212.117.174.7",4506,6,372,6,372,0,0,13275.432941,9.013788000000204,330.1608602287887,0
"147.32.84.165",3783,"64.12.139.193",25,6,372,6,372,0,0,13275.433073,9.013780999999653,330.1611166279849,0
"147.32.84.165",3785,"74.6.136.244",25,6,372,6,372,0,0,13279.338402,9.013240000000224,330.18093382622965,0
"147.32.84.165",3786,"209.85.225.27",25,6,372,6,372,0,0,13281.541433,9.01338399999986,330.17565877588777,0
"147.32.84.165",3787,"76.199.43.190",25,6,372,6,372,0,0,13282.34275,9.012920999999551,330.1926201283855,0
"147.32.84.165",3789,"77.238.184.241",25,6,372,6,372,0,0,13282.642913,9.013397000000623,330.1751825643311,0
"147.32.84.165",3791,"209.85.143.27",25,6,372,6,372,0,0,13282.743084,9.013043000000835,330.1881506611834,0
"147.32.84.165",3792,"64.12.139.193",25,6,372,6,372,0,0,13286.449019,9.012839000000895,330.1956242644193,0
"147.32.84.165",3793,"209.221.56.66",25,6,372,6,372,0,0,13286.44919,9.012792000001355,330.1973461719246,0
"147.32.84.165",3794,"98.139.175.224",25,6,372,6,372,0,0,13286.950609,9.011454999999842,330.24633646842295,0
"147.32.84.165",3781,"189.242.185.74",6667,6,372,6,372,0,0,13289.152372,8.912843000000066,333.9001932380025,0
"147.32.84.165",3797,"74.125.113.27",25,6,372,6,372,0,0,13295.561785,8.912564000000202,333.91064569072745,0
"147.32.84.165",3802,"65.55.92.168",25,6,372,6,372,0,0,13296.463365,8.912250000001222,333.92241016573723,0
"147.32.84.165",3728,"212.117.174.7",4506,6,372,6,372,0,0,13300.268632,9.012869000000137,330.1945251839292,0
"147.32.84.165",3803,"205.188.103.1",25,6,372,6,372,0,0,13302.471673,9.012779000000592,330.19782244741657,0
"147.32.84.165",3807,"209.85.225.27",25,6,372,6,372,0,0,13303.273462,9.012235000000146,330.2177539755623,0
"147.32.84.165",3808,"66.94.236.34",25,6,372,6,372,0,0,13303.573288,9.012897000000521,330.1934993820331,0
"147.32.84.165",3809,"64.12.139.193",25,6,372,6,372,0,0,13303.67371,9.012452000000849,330.20980305911417,0
"147.32.84.165",3791,"212.117.174.7",4506,6,372,6,372,0,0,13307.378577,9.013543000000936,330.1698344368791,0
"147.32.84.165",3813,"208.65.145.13",25,6,372,6,372,0,0,13307.378644,9.013600000000224,330.16774651636706,0
"147.32.84.165",3815,"98.139.175.224",25,6,372,6,372,0,0,13307.879312,9.01325100000031,330.180530865045,0
"147.32.84.165",3816,"209.85.225.27",25,6,372,6,372,0,0,13310.182883,9.012948000001415,330.19163097352083,0
"147.32.84.165",3818,"209.85.225.27",25,6,372,6,372,0,0,13310.183013,9.012944000000061,330.1917775146478,0
"147.32.84.165",3822,"204.127.217.16",25,6,372,6,372,0,0,13310.183071,9.012936000000991,330.19207059715865,0
"147.32.84.165",3825,"209.85.225.27",25,6,372,6,372,0,0,13316.492027,9.016617999999653,330.0572343200205,0
"147.32.84.165",3828,"66.40.66.242",25,6,372,6,372,0,0,13316.49216,9.016609000000244,330.05756376925285,0
"147.32.84.165",3831,"64.12.139.193",25,6,372,6,372,0,0,13317.393207,9.012736000000587,330.1993978298939,0
"147.32.84.165",3833,"205.188.103.1",25,6,372,6,372,0,0,13317.39334,9.012697000000117,330.200826678181,0
"147.32.84.165",3838,"119.205.212.219",25,6,372,6,372,0,0,13317.393397,9.012666000000536,330.20196243817566,0
"147.32.84.165",3839,"74.125.113.27",25,6,372,6,372,0,0,13321.298531,9.012912000000142,330.19294984794624,0
"147.32.84.165",3841,"98.139.175.224",25,6,372,6,372,0,0,13323.501653,9.013187000000471,330.18287538024504,0
"147.32.84.165",3842,"218.102.53.139",25,6,372,6,372,0,0,13323.501792,9.013191000000006,330.18272884708625,0
"147.32.84.165",3848,"208.65.145.13",25,6,372,6,372,0,0,13324.303125,9.013737999999648,330.162691660232,0
"147.32.84.165",3851,"209.85.225.27",25,6,372,6,372,0,0,13324.303186,9.013863000000129,330.1581131197532,0
"147.32.84.165",3852,"209.85.143.27",25,6,372,6,372,0,0,13324.60333,9.01332800000091,330.1777101642922,0
"147.32.84.165",3853,"165.21.74.117",25,6,372,6,372,0,0,13324.703523,9.013123000000633,330.1852199287407,0
"147.32.84.165",3854,"205.188.190.1",25,6,372,6,372,0,0,13328.408926,9.012853000000177,330.1951113592934,0
"147.32.84.165",3791,"178.124.94.49",6667,9,552,6,372,3,180,13328.909557,1.072997999999643,2773.537322530881,1342.034188321394
"147.32.84.165",3855,"209.85.143.27",25,6,372,6,372,0,0,13329.982845,8.941505999999208,332.8298387318941,0
"147.32.84.165",3856,"77.238.184.241",25,6,372,6,372,0,0,13329.982911,8.941565000000992,332.82764258825716,0
"147.32.84.165",3858,"74.125.43.27",25,6,372,6,372,0,0,13331.213131,9.01289799999904,330.19346274642373,0
"147.32.84.165",3818,"212.117.174.7",4506,6,372,6,372,0,0,13337.521949,9.012816000000385,330.1964668977901,0
"147.32.84.165",3816,"174.133.57.141",80,16,3429,12,1428,4,2001,13338.423102,0.48940399999992223,23342.678032876345,32709.172789765806
"147.32.84.165",3859,"74.85.237.252",25,6,372,6,372,0,0,13338.585112,8.951524999998583,332.45731872507434,0
"147.32.84.165",3825,"150.186.92.225",6667,9,552,6,372,3,180,13342.328795,2.1053659999997762,1413.5309490132909,683.9665882322375
"147.32.84.165",3860,"202.67.240.41",25,6,372,6,372,0,0,13344.434391,9.01064199999928,330.2761334875182,0
"147.32.84.165",3862,"216.55.102.36",25,6,372,6,372,0,0,13344.532066,9.013074000000415,330.1870149962003,0
"147.32.84.165",3863,"209.85.225.27",25,6,372,6,372,0,0,13345.33313,9.013027999999395,330.18870017936257,0
"147.32.84.165",3868,"98.139.175.225",25,6,372,6,372,0,0,13345.633848,9.012995000000956,330.1899091256219,0
"147.32.84.165",3869,"64.12.139.193",25,6,372,6,372,0,0,13345.734154,9.012528999999631,330.2069818582688,0
"147.32.84.165",3853,"174.133.57.141",80,16,3429,12,1428,4,2001,13349.439784,0.6615899999997055,17267.49195121614,24196.25447785959
"147.32.84.165",3872,"38.113.116.194",25,6,372,6,372,0,0,13349.606606,8.945440999999846,332.68343058772075,0
"147.32.84.165",3875,"209.85.225.27",25,6,372,6,372,0,0,13350.941516,9.012903999999253,330.1932429326049,0
"147.32.84.165",3876,"63.217.87.6",25,6,372,6,372,0,0,13350.941652,9.012904999999591,330.1932062969858,0
"147.32.84.165",3855,"212.117.174.7",4506,6,372,6,372,0,0,13352.243544,9.012434999998732,330.2104259282224,0
"147.32.84.165",3877,"98.139.175.224",25,6,372,6,372,0,0,13352.243678,9.012444999998479,330.21005953439965,0
"147.32.84.165",3858,"77.127.115.133",6667,4,248,4,248,0,0,13358.552181,3.00443500000074,660.357105412336,0
"147.32.84.165",3881,"98.139.175.225",25,6,372,6,372,0,0,13359.553655,8.913108000000648,333.8902658870266,0
"147.32.84.165",3883,"209.85.225.27",25,6,372,6,372,0,0,13359.553798,8.913014999998268,333.8937497581434,0
"147.32.84.165",3884,"205.188.103.1",25,6,372,6,372,0,0,13359.553867,8.912997999999789,333.8943866025854,0
"147.32.84.165",3818,"174.133.57.141",80,17,3489,12,1428,5,2061,13365.462608,8.50594799999999,1343.0601738924356,1938.4082761850907
"147.32.84.165",3886,"207.115.21.20",25,6,372,6,372,0,0,13365.562683,8.912718999999925,333.90483869176455,0
"147.32.84.165",3890,"98.139.175.224",25,6,372,6,372,0,0,13365.614631,8.860898999999336,335.8575693053519,0
"147.32.84.165",3895,"74.125.65.27",25,6,372,6,372,0,0,13365.614695,8.86088799999925,335.8579862424908,0
"147.32.84.165",3896,"12.233.15.67",25,6,372,6,372,0,0,13366.363355,8.913109000000986,333.89022842643016,0
"147.32.84.165",3897,"165.21.74.117",25,6,372,6,372,0,0,13366.66381,8.913099999999758,333.89056557203224,0
"147.32.84.165",3898,"209.85.143.27",25,6,372,6,372,0,0,13366.763889,8.913109999999506,333.89019096591034,0
"147.32.84.165",3863,"212.117.174.7",4506,6,372,6,372,0,0,13370.46926,9.013566999999966,330.16895530925893,0
"147.32.84.165",3900,"64.12.90.65",25,6,372,6,372,0,0,13371.871516,9.012930000000779,330.19229040941656,0
"147.32.84.165",3903,"209.85.225.27",25,6,372,6,372,0,0,13373.174952,9.011341000001266,330.25051432407025,0
"147.32.84.165",3904,"62.154.248.254",25,6,372,6,372,0,0,13376.878925,9.01245899999958,330.20954658436045,0
"147.32.84.165",3911,"65.55.88.22",25,6,372,6,372,0,0,13380.484131,9.013114000001224,330.18554963352244,0
"147.32.84.165",3913,"207.115.21.20",25,6,372,6,372,0,0,13386.492988,9.012445000000298,330.21005953433297,0
"147.32.84.165",3914,"207.140.148.93",25,6,372,6,372,0,0,13386.493129,9.012429000000338,330.210645764853,0
"147.32.84.165",3915,"64.12.139.193",25,6,372,6,372,0,0,13387.293844,9.012542000000394,330.20650555635353,0
"147.32.84.165",3916,"209.85.143.27",25,6,372,6,372,0,0,13387.594114,9.012883000001239,330.1940122821511,0
"147.32.84.165",3917,"98.139.175.224",25,6,372,6,372,0,0,13387.594251,9.012837999998737,330.1956609006416,0
"147.32.84.165",3919,"168.95.5.46",25,6,372,6,372,0,0,13387.694132,9.013116999998601,330.1854397319442,0
"147.32.84.165",3895,"212.117.174.7",4506,6,372,6,372,0,0,13391.499593,9.012917000000016,330.1927666703238,0
"147.32.84.165",3920,"209.85.225.27",25,6,372,6,372,0,0,13392.901681,9.01279600000089,330.1971996259214,0
"147.32.84.165",3922,"209.85.225.27",25,6,372,6,372,0,0,13392.901825,9.012774999999237,330.19796899403923,0
"147.32.84.165",3923,"98.139.175.224",25,6,372,6,372,0,0,13392.901883,9.012767999998687,330.1982254508752,0
"147.32.84.165",3924,"165.21.74.117",25,6,372,6,372,0,0,13392.901942,9.012762999998813,330.19840863455437,0
"147.32.84.165",3925,"74.6.136.244",25,6,372,6,372,0,0,13394.20375,9.012823999999455,330.1961738074748,0
"147.32.84.165",3903,"112.205.111.114",6667,4,248,4,248,0,0,13397.908791,3.004316000000472,660.3832619470417,0
"147.32.84.165",3904,"173.192.170.88",80,24,5123,18,1968,6,3155,13401.513961,44.3649379999988,354.87483381584855,568.9177340899402
"147.32.84.165",3926,"114.108.154.214",25,6,372,6,372,0,0,13401.714705,9.012466000000131,330.2092901099385,0
"147.32.84.165",3903,"212.117.174.7",4506,6,372,6,372,0,0,13407.522618,9.012978999999177,330.19049528466354,0
"147.32.84.165",3928,"64.12.90.65",25,6,372,6,372,0,0,13407.522751,9.012973999999303,330.1906784597659,0
"147.32.84.165",3929,"209.85.143.27",25,6,372,6,372,0,0,13407.522814,9.012969999999768,330.19082499998075,0
"147.32.84.165",3931,"98.139.175.224",25,6,372,6,372,0,0,13408.32366,9.01293799999985,330.1919973265155,0
"147.32.84.165",3932,"98.139.175.225",25,6,372,6,372,0,0,13408.323793,9.012930000000779,330.19229040941656,0
"147.32.84.165",3934,"209.85.225.27",25,6,372,6,372,0,0,13408.624601,9.01261599999998,330.2037943256438,0
"147.32.84.165",3935,"98.139.175.224",25,6,372,6,372,0,0,13408.724786,9.012559999999212,330.2058460637444,0
"147.32.84.165",3936,"148.123.15.75",25,6,372,6,372,0,0,13412.530197,9.012446000000637,330.2100228949821,0
"147.32.84.165",3919,"217.72.192.149",25,6,372,6,372,0,0,13413.932409,9.012619000000996,330.2036844117865,0
"147.32.84.165",3938,"209.85.225.27",25,6,372,6,372,0,0,13415.233818,9.012998000000152,330.1897992210749,0
"147.32.84.165",3940,"64.12.139.193",25,6,372,6,372,0,0,13415.233968,9.012972999998965,330.19071509482404,0
"147.32.84.165",3922,"116.72.72.149",6667,6,372,6,372,0,0,13418.338137,9.01292999999896,330.1922904094832,0
"147.32.84.165",3924,"212.117.174.7",4506,6,372,6,372,0,0,13422.746131,9.011214000000109,330.25516872642953,0
"147.32.84.165",3926,"174.133.57.141",80,17,2011,12,1428,5,583,13428.552832,112.6529129999999,101.40882908194314,41.401503749840934
"147.32.84.165",3941,"77.238.184.241",25,6,372,6,372,0,0,13428.552972,8.912608000000546,333.90899723176625,0
"147.32.84.165",3944,"98.139.175.225",25,6,372,6,372,0,0,13428.712937,8.854670999999144,336.09379727381037,0
"147.32.84.165",3946,"209.85.225.27",25,6,372,6,372,0,0,13428.712999,8.854733000000124,336.09144397690574,0
"147.32.84.165",3947,"209.85.143.27",25,6,372,6,372,0,0,13428.713062,8.854718999999022,336.0919753636822,0
"147.32.84.165",3948,"74.125.113.27",25,6,372,6,372,0,0,13429.353951,8.912940000000162,333.89655938443946,0
"147.32.84.165",3950,"209.85.225.27",25,6,372,6,372,0,0,13429.654311,8.912845999999263,333.9000808496238,0
"147.32.84.165",3953,"64.12.139.193",25,6,372,6,372,0,0,13429.754503,8.912807999999131,333.90150444173037,0
"147.32.84.165",3954,"98.139.175.224",25,6,372,6,372,0,0,13429.754638,8.91276199999993,333.903227753644,0
"147.32.84.165",3956,"98.139.175.224",25,6,372,6,372,0,0,13433.560175,9.012957999999344,330.1912646214724,0
"147.32.84.165",3959,"204.50.189.23",25,6,372,6,372,0,0,13433.560311,9.012967000000572,330.1909349052106,0
"147.32.84.165",3935,"212.117.174.7",4506,6,372,6,372,0,0,13434.962233,8.912585000000036,333.9098589242053,0
"147.32.84.165",3960,"209.85.143.27",25,6,372,6,372,0,0,13434.962365,8.912578999999823,333.9100837142716,0
"147.32.84.165",3961,"209.85.225.27",25,6,372,6,372,0,0,13434.962427,8.912570999998934,333.91038343485354,0
"147.32.84.165",3962,"64.12.139.193",25,6,372,6,372,0,0,13434.962485,8.912561999999525,333.91072062109174,0
"147.32.84.165",3963,"98.139.175.224",25,6,372,6,372,0,0,13434.962542,8.91255700000147,333.9109079470133,0
"147.32.84.165",3966,"81.93.162.11",25,6,372,6,372,0,0,13434.9626,8.912548999998762,333.91120766914304,0
"147.32.84.165",3967,"209.85.225.27",25,6,372,6,372,0,0,13436.264054,8.912583000001177,333.90993385414833,0
"147.32.84.165",3968,"208.113.200.127",25,6,372,6,372,0,0,13436.26413,8.912635000000591,333.90798568546813,0
"147.32.84.165",3971,"205.178.149.7",25,6,372,6,372,0,0,13439.369086,9.017775999998776,330.01485066832487,0
"147.32.84.165",2810,"212.117.171.138",65500,14,846,10,604,4,242,13443.67453,9.971378000000186,484.5869848680804,194.1557124802574
"147.32.84.165",3972,"209.85.143.27",25,6,372,6,372,0,0,13443.697157,8.990431000000171,331.01861301198386,0
"147.32.84.165",3973,"161.58.16.34",25,6,372,6,372,0,0,13443.697194,8.99041699999907,331.0191284787244,0
"147.32.84.165",3904,"173.192.170.88",80,16,1581,12,1084,4,497,13449.483486,139.79393000000164,62.03416700567684,28.44186439282416
"147.32.84.165",3974,"64.12.139.193",25,6,372,6,372,0,0,13449.582992,9.01329799999985,330.1788091329111,0
"147.32.84.165",3976,"209.85.225.27",25,6,372,6,372,0,0,13449.684196,9.012700999999652,330.20068012908837,0
"147.32.84.165",3978,"98.139.175.224",25,6,372,6,372,0,0,13449.684257,9.012761999998474,330.1984452713279,0
"147.32.84.165",3982,"64.12.90.65",25,6,372,6,372,0,0,13449.684314,9.012753999999404,330.19873836567564,0
"147.32.84.165",3944,"65.54.188.72",25,6,372,6,372,0,0,13450.284576,9.012837000000218,330.19569753673875,0
"147.32.84.165",3983,"209.85.225.27",25,6,372,6,372,0,0,13450.584618,9.012955999998667,330.191337891857,0
"147.32.84.165",3984,"209.85.143.27",25,6,372,6,372,0,0,13450.685177,9.012448000001314,330.2099496163047,0
"147.32.84.165",2810,"212.117.174.7",4506,6,372,6,372,0,0,13454.590206,9.013046000000031,330.188040757807,0
"147.32.84.165",3988,"207.115.36.21",25,6,372,6,372,0,0,13455.892579,9.012785000000804,330.1976026277931,0
"147.32.84.165",3959,"212.117.171.138",65500,14,846,10,604,4,242,13457.194075,54.08398600000146,89.34252737954391,35.79617818849276
"147.32.84.165",3989,"170.206.225.64",25,6,372,6,372,0,0,13457.216838,8.990443999999115,331.0181343658103,0
"147.32.84.165",3960,"62.209.146.67",6667,9,552,6,372,3,180,13460.398809,8.886946000000535,334.87319490855697,162.03541689123725
"147.32.84.165",3990,"209.85.225.27",25,6,372,6,372,0,0,13464.708378,9.009449000001041,330.3198675079526,0
"147.32.84.165",3971,"212.117.174.7",4506,6,372,6,372,0,0,13464.708525,9.009329000000434,330.32426721233696,0
"147.32.84.165",3991,"64.12.90.65",25,6,372,6,372,0,0,13464.708621,9.009259000000384,330.3268337606759,0
"147.32.84.165",3993,"205.188.103.1",25,6,372,6,372,0,0,13464.708698,9.009212999999363,330.3285203713366,0
"147.32.84.165",3996,"74.6.136.244",25,6,372,6,372,0,0,13470.613617,9.012624999999389,330.2034645844248,0
"147.32.84.165",3998,"205.178.149.7",25,6,372,6,372,0,0,13470.713675,9.01282099999844,330.196283716332,0
"147.32.84.165",3999,"98.139.175.224",25,6,372,6,372,0,0,13471.314389,9.014141000001473,330.1479309009604,0
"147.32.84.165",4000,"207.115.37.22",25,6,372,6,372,0,0,13471.614806,9.012977000000319,330.1905685546401,0
"147.32.84.165",4001,"207.115.36.21",25,6,372,6,372,0,0,13471.714956,9.013050999999905,330.18785758563126,0
"147.32.84.165",4003,"128.121.85.2",25,6,372,6,372,0,0,13471.715089,9.013009000000238,330.1893962382509,0
"147.32.84.165",4004,"168.58.229.116",25,6,372,6,372,0,0,13475.62282,9.011190999999599,330.2560116637337,0
"147.32.84.165",4005,"65.55.37.72",25,6,372,6,372,0,0,13476.922629,9.012703999998848,330.20057021737097,0
"147.32.84.165",4008,"209.85.225.27",25,6,372,6,372,0,0,13478.224211,9.013063999998849,330.187381338952,0
"147.32.84.165",3984,"92.46.218.192",6667,6,372,6,372,0,0,13480.227079,9.013107000000673,330.18580607106713,0
"147.32.84.165",4011,"205.188.103.1",25,6,372,6,372,0,0,13485.73503,9.013622000000396,330.1669406593564,0
"147.32.84.165",3984,"212.117.174.7",4506,6,372,6,372,0,0,13491.643624,9.013009000000238,330.1893962382509,0
"147.32.84.165",4014,"64.12.139.193",25,6,372,6,372,0,0,13491.743759,9.01293799999985,330.1919973265155,0
"147.32.84.165",4015,"65.55.92.152",25,6,372,6,372,0,0,13492.344567,9.014169000000038,330.14690538861515,0
"147.32.84.165",4016,"207.115.36.20",25,6,372,6,372,0,0,13492.645104,9.013252000000648,330.1804942322467,0
"147.32.84.165",4018,"207.115.36.21",25,6,372,6,372,0,0,13492.745193,9.013063999998849,330.187381338952,0
"147.32.84.165",3999,"212.117.174.7",4506,6,372,6,372,0,0,13496.651023,9.01256900000044,330.20551631836105,0
"147.32.84.165",4019,"203.12.160.122",25,6,372,6,372,0,0,13496.651159,9.012558000000354,330.20591934053385,0
"147.32.84.165",4022,"209.85.225.27",25,6,372,6,372,0,0,13497.952802,8.912975999999617,333.89521075790265,0
"147.32.84.165",4023,"205.188.190.1",25,6,372,6,372,0,0,13497.952934,8.912969999999405,333.8954355282469,0
"147.32.84.165",4024,"209.85.143.27",25,6,372,6,372,0,0,13499.254747,8.912434999998368,333.91547876652623,0
"147.32.84.165",4004,"210.212.249.136",6667,6,372,6,372,0,0,13501.258452,8.911817000000156,333.9386345119012,0
"147.32.84.165",4025,"98.139.175.224",25,6,372,6,372,0,0,13506.665359,9.013135999999577,330.18474368967026,0
"147.32.84.165",3959,"212.117.171.138",65500,14,846,10,604,4,242,13512.574065,90.65397799999846,53.30157712439362,21.35592990745572
"147.32.84.165",4026,"205.188.103.1",25,6,372,6,372,0,0,13512.596838,8.98963300000105,331.04799717626435,0
"147.32.84.165",4028,"74.6.136.244",25,6,372,6,372,0,0,13512.673967,9.012688999999227,330.201119776823,0
"147.32.84.165",4030,"74.208.5.3",25,6,372,6,372,0,0,13513.274912,9.013381999999183,330.1757320393466,0
"147.32.84.165",4031,"68.6.19.3",25,6,372,6,372,0,0,13513.575365,9.013234000000011,330.18115362366007,0
"147.32.84.165",4032,"213.199.180.150",25,6,372,6,372,0,0,13513.675524,9.013074999998935,330.1869783620298,0
"147.32.84.165",4033,"207.115.36.20",25,6,372,6,372,0,0,13517.581439,9.012135000000853,330.22141812120196,0
"147.32.84.165",3999,"212.117.174.7",4506,6,372,6,372,0,0,13518.882625,9.015858000000662,330.08505679656685,0
"147.32.84.165",4034,"209.85.225.27",25,6,372,6,372,0,0,13520.184673,9.018391999999949,329.99230905021835,0
"147.32.84.165",4024,"98.126.71.122",80,19,5021,14,1534,5,3487,13522.288159,19.158331000000544,640.5568418250865,1456.0767323625012
"147.32.84.165",4035,"64.12.139.193",25,6,372,6,372,0,0,13522.462837,8.946893000000273,332.62943906894935,0
"147.32.84.165",4037,"67.231.152.37",25,6,372,6,372,0,0,13527.69843,9.028636999999435,329.61785926271995,0
"147.32.84.165",4039,"209.85.143.27",25,6,372,6,372,0,0,13533.616763,9.04084999999941,329.1725888605822,0
"147.32.84.165",4042,"98.139.175.224",25,6,372,6,372,0,0,13533.717414,9.0403239999996,329.191741357957,0
"147.32.84.165",4044,"64.12.139.193",25,6,372,6,372,0,0,13534.320023,9.03885099999934,329.24538749451864,0
"147.32.84.165",4047,"207.115.37.23",25,6,372,6,372,0,0,13534.320157,9.038893999999345,329.24382120204257,0
"147.32.84.165",4048,"65.55.92.152",25,6,372,6,372,0,0,13534.620091,9.039154000000053,329.23435091381145,0
"147.32.84.165",4050,"200.199.41.130",25,6,372,6,372,0,0,13534.720672,9.038464000001113,329.25948479737633,0
"147.32.84.165",4051,"207.115.36.20",25,6,372,6,372,0,0,13538.633295,9.031149000000369,329.52617656954595,0
"147.32.84.165",4052,"209.85.225.27",25,6,372,6,372,0,0,13539.937334,9.029265999999552,329.5948973039611,0
"147.32.84.165",4053,"64.12.139.193",25,6,372,6,372,0,0,13539.937404,9.029317000000447,329.5930356637,0
"147.32.84.165",4054,"209.85.143.27",25,6,372,6,372,0,0,13539.937435,9.029340999999476,329.5921596050224,0
"147.32.84.165",4055,"64.12.139.193",25,6,372,6,372,0,0,13539.937465,9.02936199999931,329.5913930574749,0
"147.32.84.165",4060,"206.46.232.11",25,6,372,6,372,0,0,13539.937497,9.029399999999441,329.5900059804842,0
"147.32.84.165",4033,"213.33.174.74",6667,9,552,6,372,3,180,13541.241134,1.0855919999994512,2741.361395442767,1326.4651913432745
"147.32.84.165",3926,"74.125.127.27",25,6,372,6,372,0,0,13542.327011,8.842662000000928,336.5502379260553,0
"147.32.84.165",4061,"98.139.175.224",25,6,372,6,372,0,0,13543.458757,8.912519999999859,333.9122941659651,0
"147.32.84.165",4033,"212.117.174.7",4506,6,372,6,372,0,0,13543.458891,8.91251199999897,333.91259389051527,0
"147.32.84.165",4035,"174.133.57.141",80,17,3489,12,1428,5,2061,13548.76612,1.1013440000006085,10372.780893157531,14970.799314284084
"147.32.84.165",4062,"195.110.146.166",25,6,372,6,372,0,0,13548.92491,8.85433600000033,336.1065132382472,0
"147.32.84.165",4037,"212.117.174.7",4506,6,372,6,372,0,0,13554.57524,9.012731000000713,330.1995810148738,0
"147.32.84.165",4035,"173.192.170.88",80,15,1531,12,1094,3,437,13554.575418,34.70348600000034,252.19368451918388,100.73915917265388
"147.32.84.165",4064,"65.55.88.22",25,6,372,6,372,0,0,13554.575516,9.012591999999131,330.20467363886956,0
"147.32.84.165",4067,"209.85.225.27",25,6,372,6,372,0,0,13554.674904,9.012759999999616,330.1985185448327,0
"147.32.84.165",4068,"209.56.120.20",25,6,372,6,372,0,0,13555.275706,9.012770999999702,330.1981155407253,0
"147.32.84.165",4071,"74.125.113.27",25,6,372,6,372,0,0,13555.575885,9.013284000000567,330.1793219873925,0
"147.32.84.165",4072,"64.12.139.193",25,6,372,6,372,0,0,13555.676022,9.013569000000643,330.16888204880746,0
"147.32.84.165",4074,"118.23.109.24",25,6,372,6,372,0,0,13559.581567,9.013184000001274,330.18298528018283,0
"147.32.84.165",4075,"64.12.90.65",25,6,372,6,372,0,0,13560.883844,9.01469200000065,330.1277514528267,0
"147.32.84.165",4053,"70.38.78.73",6667,6,372,6,372,0,0,13563.187117,9.012713000000076,330.2002404825245,0
"147.32.84.165",4076,"74.6.136.65",25,6,372,6,372,0,0,13564.388491,9.0129450000004,330.19174087935386,0
"147.32.84.165",4077,"208.94.45.242",25,6,372,6,372,0,0,13569.796259,9.013095999998768,330.1862090451945,0
"147.32.84.165",4053,"212.117.174.7",4506,6,372,6,372,0,0,13575.604978,9.012628000000404,330.20335467078706,0
"147.32.84.165",4082,"65.54.188.110",25,6,372,6,372,0,0,13575.705163,9.012703000000329,330.2006068545576,0
"147.32.84.165",4088,"209.85.225.27",25,6,372,6,372,0,0,13576.30581,9.01308600000084,330.1865753860246,0
"147.32.84.165",4090,"198.102.73.74",25,6,372,6,372,0,0,13576.606374,9.012755999998262,330.19866509207327,0
"147.32.84.165",4092,"134.84.119.205",25,6,372,6,372,0,0,13576.706163,9.013135999999577,330.18474368967026,0
"147.32.84.165",4093,"206.46.232.11",25,6,372,6,372,0,0,13580.611807,9.013091000000713,330.18639221547465,0
"147.32.84.165",4095,"64.12.90.65",25,6,372,6,372,0,0,13581.913968,9.012848999998823,330.19525790350957,0
"147.32.84.165",4097,"209.85.225.27",25,6,372,6,372,0,0,13585.318695,9.013466000000335,330.17265500306866,0
"147.32.84.165",4098,"165.21.74.117",25,6,372,6,372,0,0,13585.31883,9.013463999999658,330.1727282651945,0
"147.32.84.165",4100,"180.222.96.138",25,6,372,6,372,0,0,13585.418806,9.013442999999825,330.1734975192119,0
"147.32.84.165",4035,"212.117.174.7",4506,6,372,6,372,0,0,13590.82718,9.012322000000495,330.2145662349655,0
"147.32.84.165",4102,"207.115.20.21",25,6,372,6,372,0,0,13590.827258,9.012369000000035,330.21284414785816,0
"147.32.84.165",4103,"205.188.103.1",25,6,372,6,372,0,0,13596.635121,9.013127000000168,330.1850733935009,0
"147.32.84.165",4104,"65.54.188.72",25,6,372,6,372,0,0,13596.735248,9.013204999999289,330.1822159820214,0
"147.32.84.165",4105,"98.139.175.224",25,6,372,6,372,0,0,13597.335972,9.012817999999243,330.1963936251958,0
"147.32.84.165",4106,"65.55.88.22",25,6,372,6,372,0,0,13597.636477,9.014005999999426,330.15287542522043,0
"147.32.84.165",4107,"65.55.37.104",25,6,372,6,372,0,0,13597.736664,9.0140420000007,330.15155687090976,0
"147.32.84.165",4088,"174.133.57.141",80,18,3549,12,1428,6,2121,13601.642044,3.1680359999991197,3606.019628565829,5355.999742428658
"147.32.84.165",4108,"74.125.113.27",25,6,372,6,372,0,0,13601.797358,8.958190999999715,332.20992943777316,0
"147.32.84.165",4090,"212.117.174.7",4506,6,372,6,372,0,0,13602.944388,9.012833999999202,330.19580744527894,0
"147.32.84.165",4093,"212.117.171.138",65500,14,846,10,604,4,242,13606.348928,1.5106219999997847,3198.6823970527957,1281.5912915343984
"147.32.84.165",4109,"209.85.225.27",25,6,372,6,372,0,0,13606.371697,8.990277999999307,331.0242464137627,0
"147.32.84.165",4095,"213.174.1.227",6667,4,248,4,248,0,0,13606.450594,3.0031699999999546,660.6352620730861,0
"147.32.84.165",4112,"65.49.35.216",25,6,372,6,372,0,0,13611.857033,8.914302999999563,333.84550648549254,0
"147.32.84.165",4097,"212.117.171.138",65500,85,46416,58,43894,27,2522,13617.665285,10.634063000001333,33021.43310604385,1897.2992730997992
"147.32.84.165",4095,"212.117.174.7",4506,6,372,6,372,0,0,13617.688613,8.889262999999119,334.7859096980588,0
"147.32.84.165",4114,"165.21.74.117",25,6,372,6,372,0,0,13617.688688,8.889283000000432,334.78515646310905,0
"147.32.84.165",4115,"205.188.190.1",25,6,372,6,372,0,0,13617.76534,8.913770999999542,333.8654313645878,0
"147.32.84.165",4116,"98.139.175.224",25,6,372,6,372,0,0,13618.366151,8.913006999999197,333.8940494493349,0
"147.32.84.165",4117,"205.188.103.1",25,6,372,6,372,0,0,13618.666636,9.019588999999542,329.9485153924587,0
"147.32.84.165",4118,"74.125.113.27",25,6,372,6,372,0,0,13618.766704,9.513104999999996,312.8316149143735,0
"147.32.84.165",4122,"83.238.107.240",25,6,372,6,372,0,0,13618.76684,9.516186999999263,312.73029838529135,0
"147.32.84.165",4126,"193.252.23.67",25,6,372,6,372,0,0,13622.672801,9.012914999999339,330.19283994137504,0
"147.32.84.165",4104,"212.117.171.138",65500,14,846,10,604,4,242,13623.874343,9.816329000001133,492.2410404133197,197.22240360931022
"147.32.84.165",4127,"204.127.217.21",25,6,372,6,372,0,0,13623.874479,9.012747999999192,330.19895818681124,0
"147.32.84.165",4105,"65.54.165.139",443,45,24725,34,3814,11,20911,13626.177623,1.9193620000005467,15896.949090370295,87158.12858645339
"147.32.84.165",4130,"209.85.225.27",25,6,372,6,372,0,0,13626.341628,8.951375000000553,332.4628897794826,0
"147.32.84.165",4107,"124.123.111.216",6667,6,372,6,372,0,0,13626.341693,8.95145599999887,332.4598813869359,0
"147.32.84.165",4135,"205.188.103.1",25,6,372,6,372,0,0,13627.279293,9.013065999999526,330.1873080703233,0
"147.32.84.165",4136,"64.12.139.193",25,6,372,6,372,0,0,13627.279352,9.013132000000041,330.1848902246174,0
"147.32.84.165",4097,"212.117.174.7",4506,6,372,6,372,0,0,13632.78718,9.013055999999779,330.1876744136587,0
"147.32.84.165",4104,"212.117.171.138",65500,58,24493,40,21624,18,2869,13638.595759,2.8920369999996183,59816.662096654654,7936.274674218563
"147.32.84.165",4103,"174.133.57.141",80,16,3429,12,1428,4,2001,13638.619409,0.5034259999993083,22692.510915240167,31798.11928669158
"147.32.84.165",4141,"74.10.239.236",25,6,372,6,372,0,0,13638.695777,9.013320999998541,330.1779665897267,0
"147.32.84.165",4142,"204.232.236.138",25,6,372,6,372,0,0,13638.78604,8.923138999998628,333.51492115055675,0
"147.32.84.165",4147,"200.2.127.147",25,6,372,6,372,0,0,13639.296214,9.01331299999947,330.1782596477205,0
"147.32.84.165",4095,"212.117.171.138",65500,31,4643,22,2836,9,1807,13639.596803,20.628005000000485,1099.8639955729827,700.7948660085966
"147.32.84.165",4156,"130.94.149.85",25,6,372,6,372,0,0,13639.596877,9.013280999999552,330.1794318850314,0
"147.32.84.165",4114,"65.54.165.139",443,38,15442,28,5216,10,10226,13639.696909,1.7276050000000396,24153.669386230675,47353.41701372601
"147.32.84.165",4161,"209.85.225.27",25,6,372,6,372,0,0,13639.860841,8.949228999999832,332.5426134474887,0
"147.32.84.165",4117,"212.117.174.7",4506,6,372,6,372,0,0,13643.703231,9.012405999999828,330.21148847489303,0
"147.32.84.165",4162,"203.10.59.89",25,6,372,6,372,0,0,13643.703386,9.012322000000495,330.2145662349655,0
"147.32.84.165",4163,"98.139.175.224",25,6,372,6,372,0,0,13644.904263,9.013191000000006,330.18272884708625,0
"147.32.84.165",4122,"115.97.135.112",6667,9,552,6,372,3,180,13647.207711,1.7731720000010682,1678.3481805477456,812.1039583295543
"147.32.84.165",4165,"200.205.95.99",25,6,372,6,372,0,0,13648.309611,9.012509999998656,330.2076779943039,0
"147.32.84.165",4127,"174.133.57.141",80,17,3489,12,1428,5,2061,13648.98114,1.9026599999997416,6004.225663019957,8665.762669106534
"147.32.84.165",4168,"205.188.103.1",25,6,372,6,372,0,0,13649.143525,8.979910000000018,331.406439485473,0
"147.32.84.165",4114,"212.117.171.138",65500,22,1362,16,972,6,390,13653.818731,12.246106000000509,634.9773552506957,254.77486476108163
"147.32.84.165",4169,"64.12.90.65",25,6,372,6,372,0,0,13653.81887,9.01118100000167,330.2563781594719,0
"147.32.84.165",4122,"94.245.116.13",80,18,4328,12,3214,6,1114,13659.725639,0.5126299999992625,50157.03333795718,17384.858474948443
"147.32.84.165",4170,"62.211.72.32",25,6,372,6,372,0,0,13659.725797,9.013389000001553,330.1754756173829,0
"147.32.84.165",4171,"80.12.242.53",25,6,372,6,372,0,0,13659.762518,8.976736000000528,331.5236183842128,0
"147.32.84.165",4172,"205.188.59.193",25,6,372,6,372,0,0,13660.326606,9.01279599999907,330.19719962598805,0
"147.32.84.165",4141,"174.133.57.141",80,16,3429,12,1428,4,2001,13660.627011,0.48972499999945285,23327.37760990916,32687.732911364306
"147.32.84.165",4173,"134.84.119.232",25,6,372,6,372,0,0,13660.787105,8.95303899999999,332.4010986660511,0
"147.32.84.165",4174,"74.125.113.27",25,6,372,6,372,0,0,13660.827444,9.012885000000097,330.1939390106462,0
"147.32.84.165",4107,"212.117.174.7",4506,6,372,6,372,0,0,13664.732765,9.012967999999091,330.1908982701703,0
"147.32.84.165",4175,"65.55.92.184",25,6,372,6,372,0,0,13665.934832,9.012939999998707,330.19192405590485,0
"147.32.84.165",4162,"212.117.171.138",65500,14,846,10,604,4,242,13669.339541,1.8680130000011559,2586.7057670353524,1036.3953569909856
"147.32.84.165",4117,"64.12.90.1",25,6,372,6,372,0,0,13669.362538,8.990002000000459,331.034409113574,0
"147.32.84.165",4176,"209.85.225.27",25,6,372,6,372,0,0,13670.140648,9.012865999999121,330.19463509168895,0
"147.32.84.165",4162,"212.117.171.138",65500,22,1362,16,972,6,390,13674.847598,5.994666999999026,1297.1529527830758,520.4626045117279
"147.32.84.165",4165,"212.117.174.7",4506,6,372,6,372,0,0,13674.870173,8.990120000000388,331.03006411481397,0
"147.32.84.165",4168,"174.133.57.141",80,16,3429,12,1428,4,2001,13674.870239,0.536391999999978,21297.85679130276,29843.84554579609
"147.32.84.165",4180,"64.12.90.65",25,6,372,6,372,0,0,13675.025887,8.93452199999956,333.09000750125705,0
"147.32.84.165",4181,"74.125.113.27",25,6,372,6,372,0,0,13680.756019,8.91326300000037,333.88445959688124,0
"147.32.84.165",4168,"212.117.171.138",65500,14,846,10,604,4,242,13680.756155,19.151065000000017,252.30972794463366,101.09098371291614
"147.32.84.165",4184,"62.211.72.32",25,6,372,6,372,0,0,13680.756214,8.913132999998197,333.8893293750471,0
"147.32.84.165",4185,"65.55.37.72",25,6,372,6,372,0,0,13680.756275,8.913099999999758,333.89056557203224,0
"147.32.84.165",4186,"64.62.128.235",25,6,372,6,372,0,0,13681.356695,8.91284799999994,333.9000059240346,0
"147.32.84.165",4189,"212.52.84.171",25,6,372,6,372,0,0,13681.75758,8.912458000000697,333.91461704501353,0
"147.32.84.165",4190,"98.139.175.224",25,6,372,6,372,0,0,13681.857846,8.913775999999416,333.8652440896198,0
"147.32.84.165",4192,"209.85.225.27",25,6,372,6,372,0,0,13685.763064,9.014968999999837,330.11760772555664,0
"147.32.84.165",4193,"208.65.144.12",25,6,372,6,372,0,0,13685.763142,9.014950000000681,330.11830348474206,0
"147.32.84.165",4194,"217.161.98.212",25,6,372,6,372,0,0,13686.965259,8.912227999999232,333.92323445947034,0
"147.32.84.165",4195,"64.12.90.65",25,6,372,6,372,0,0,13690.269679,9.012948999999935,330.19159433832607,0
"147.32.84.165",4198,"74.125.113.27",25,6,372,6,372,0,0,13690.26974,9.01301500000045,330.1891764298463,0
"147.32.84.165",4202,"212.199.251.240",25,6,372,6,372,0,0,13691.070883,9.01265500000045,330.2023654516734,0
"147.32.84.165",4165,"212.117.174.7",4506,6,372,6,372,0,0,13695.877581,9.013332999998966,330.1775270036447,0
"147.32.84.165",4204,"89.104.217.10",25,6,372,6,372,0,0,13701.685995,9.013612000000649,330.16730695749783,0
"147.32.84.165",4205,"75.150.112.115",25,6,372,6,372,0,0,13701.686137,9.013560999999754,330.16917509074176,0
"147.32.84.165",4206,"66.94.238.147",25,6,372,6,372,0,0,13702.287029,9.012706000001344,330.20049694282227,0
"147.32.84.165",4209,"64.12.90.65",25,6,372,6,372,0,0,13702.687667,9.012816000000385,330.1964668977901,0
"147.32.84.165",4211,"209.85.225.27",25,6,372,6,372,0,0,13702.787677,9.012792999999874,330.1973095354616,0
"147.32.84.165",4184,"212.117.171.138",65500,47,4300,30,3214,17,1086,13706.793353,67.07259200000044,383.345853101962,129.531299461335
"147.32.84.165",4213,"209.85.143.27",25,6,372,6,372,0,0,13706.81592,8.990547000001243,331.01434206390206,0
"147.32.84.165",4215,"194.168.231.1",25,6,372,6,372,0,0,13707.89485,9.01314999999886,330.1842308183462,0
"147.32.84.165",4216,"124.108.110.37",25,6,372,6,372,0,0,13711.299877,9.013003000000026,330.1896160469481,0
"147.32.84.165",4217,"66.94.237.139",25,6,372,6,372,0,0,13712.100958,9.015826999999263,330.0861917603614,0
"147.32.84.165",4218,"98.139.175.224",25,6,372,6,372,0,0,13716.90815,9.012620999999854,330.203611135989,0
"147.32.84.165",4219,"67.195.168.31",25,6,372,6,372,0,0,13722.716173,9.0135569999984,330.1693216119372,0
"147.32.84.165",4222,"64.12.90.65",25,6,372,6,372,0,0,13722.716332,9.013521999999284,330.1706036774788,0
"147.32.84.165",4223,"209.85.225.27",25,6,372,6,372,0,0,13722.716408,9.013498000000254,330.17148281387716,0
"147.32.84.165",4224,"98.139.175.225",25,6,372,6,372,0,0,13722.716481,9.01347800000076,330.1722154311298,0
"147.32.84.165",4225,"209.85.143.27",25,6,372,6,372,0,0,13723.31737,9.012568000000101,330.20555295671187,0
"147.32.84.165",4226,"165.212.65.113",25,6,372,6,372,0,0,13723.317456,9.012611999998626,330.20394087756733,0
"147.32.84.165",4227,"77.238.177.9",25,6,372,6,372,0,0,13723.717711,9.015867000000071,330.0847272924475,0
"147.32.84.165",4228,"74.5.113.25",25,6,372,6,372,0,0,13723.817784,9.01303199999893,330.1885536410337,0
"147.32.84.165",4211,"212.117.174.7",4506,6,372,6,372,0,0,13727.823561,9.013881000000765,330.157453820363,0
"147.32.84.165",4206,"212.117.174.7",4506,6,372,6,372,0,0,13728.925221,9.014788000000408,330.12423586665216,0
"147.32.84.165",4232,"62.129.227.203",25,6,372,6,372,0,0,13728.925356,9.014712000000145,330.1270190328823,0
"147.32.84.165",4213,"92.47.55.219",6667,4,248,4,248,0,0,13732.330143,3.005451000000903,660.1338700911789,0
"147.32.84.165",4234,"213.4.149.224",25,6,372,6,372,0,0,13733.13127,9.013108999999531,330.1857328032042,0
"147.32.84.165",4237,"195.50.106.142",25,6,372,6,372,0,0,13737.940103,9.01108799999929,330.2597866095897,0
"147.32.84.165",4238,"64.12.90.65",25,6,372,6,372,0,0,13743.746355,9.018200000000434,329.99933467874484,0
"147.32.84.165",4239,"98.139.175.225",25,6,372,6,372,0,0,13743.746501,9.018196000000898,329.9994810491703,0
"147.32.84.165",4240,"209.85.225.27",25,6,372,6,372,0,0,13744.347878,9.012520000000222,330.2073116065126,0
"147.32.84.165",4241,"98.139.175.224",25,6,372,6,372,0,0,13744.747952,9.012924000000567,330.19251022196715,0
"147.32.84.165",4244,"76.96.62.116",25,6,372,6,372,0,0,13744.848042,9.012946000000738,330.19170424406803,0
"147.32.84.165",4246,"209.85.143.27",25,6,372,6,372,0,0,13748.853915,9.012802000001102,330.19697980712726,0
"147.32.84.165",4226,"212.117.171.138",65500,14,846,10,604,4,242,13749.955267,3.8782400000000052,1245.9259870456685,499.19551136597977
"147.32.84.165",4247,"204.127.217.21",25,6,372,6,372,0,0,13749.955406,8.912798000001203,333.9018790731708,0
"147.32.84.165",4227,"64.12.168.40",587,28,2489,20,1306,8,1183,13751.758302,22.20378399999936,470.55042509872646,426.233654587897
"147.32.84.165",4248,"98.139.175.224",25,6,372,6,372,0,0,13751.876478,8.894459999999526,334.590295532293,0
"147.32.84.165",4228,"68.202.89.226",6667,6,372,6,372,0,0,13751.87654,8.894466000001557,334.5900698253812,0
"147.32.84.165",4249,"64.12.139.193",25,6,372,6,372,0,0,13754.161366,8.912899999999354,333.8980578711997,0
"147.32.84.165",4226,"212.117.174.7",4506,6,372,6,372,0,0,13758.86834,9.013530999998693,330.1702740025448,0
"147.32.84.165",4234,"212.117.174.7",4506,6,372,6,372,0,0,13764.676661,9.03312300000107,329.45416551946073,0
"147.32.84.165",4250,"65.55.92.152",25,6,372,6,372,0,0,13764.676795,9.033129999999801,329.4539102171745,0
"147.32.84.165",4251,"65.55.92.184",25,6,372,6,372,0,0,13764.676862,9.033132000000478,329.4538372736989,0
"147.32.84.165",4238,"212.117.171.138",65500,14,846,10,604,4,242,13765.277414,1.1010819999992236,4388.410672414413,1758.2705011991522
"147.32.84.165",4252,"132.64.178.45",25,6,372,6,372,0,0,13765.277527,9.0327699999998,329.46704056452955,0
"147.32.84.165",4253,"168.95.6.70",25,6,372,6,372,0,0,13765.678628,9.032444000000396,329.4789317265481,0
"147.32.84.165",4255,"209.85.225.27",25,6,372,6,372,0,0,13765.778205,9.032834999999977,329.46466972993613,0
"147.32.84.165",4240,"212.117.171.138",65500,23,1398,16,972,7,426,13769.78384,3.149609000000055,2468.877882937172,1082.0390721514768
"147.32.84.165",4256,"98.139.175.224",25,6,372,6,372,0,0,13769.783977,9.033299000000625,329.44774660949383,0
"147.32.84.165",4258,"209.85.143.27",25,6,372,6,372,0,0,13770.885454,9.032955000000584,329.46029289416447,0
"147.32.84.165",4259,"204.127.217.21",25,6,372,6,372,0,0,13772.70862,9.012644000000364,330.20276846615485,0
"147.32.84.165",4264,"65.55.37.120",25,6,372,6,372,0,0,13775.112194,9.012335000001258,330.21408991117005,0
"147.32.84.165",4227,"212.117.171.138",65500,14,846,10,604,4,242,13779.918578,25.512823999999455,189.3949489872271,75.88340671342543
"147.32.84.165",4265,"77.238.177.9",25,6,372,6,372,0,0,13779.941,8.990476999999373,331.0169193470166,0
"147.32.84.165",4266,"76.96.30.116",25,6,372,6,372,0,0,13785.726935,9.01441100000011,330.13804229693585,0
"147.32.84.165",4267,"64.12.90.65",25,6,372,6,372,0,0,13785.727007,9.014463000001342,330.1361378930233,0
"147.32.84.165",4273,"199.185.220.200",25,6,372,6,372,0,0,13786.327725,9.01287500000035,330.19430536869584,0
"147.32.84.165",4274,"209.85.143.27",25,6,372,6,372,0,0,13786.729101,9.012653999998292,330.2024020893916,0
"147.32.84.165",4276,"209.85.225.27",25,6,372,6,372,0,0,13786.729205,9.012673999999606,330.2016693381043,0
"147.32.84.165",4282,"204.232.236.252",25,6,372,6,372,0,0,13786.729236,9.012698000000455,330.200790040879,0
"147.32.84.165",4283,"124.108.110.37",25,6,372,6,372,0,0,13786.828523,9.013380000000325,330.1758053027713,0
"147.32.84.165",4284,"193.192.161.130",25,6,372,6,372,0,0,13790.834165,9.013058000000456,330.18760114489993,0
"147.32.84.165",4285,"74.125.113.27",25,6,372,6,372,0,0,13791.935669,9.013084999998682,330.1866120202389,0
"147.32.84.165",4286,"98.139.175.224",25,6,372,6,372,0,0,13793.738633,9.013184999999794,330.1829486469065,0
"147.32.84.165",4287,"71.74.56.243",25,6,372,6,372,0,0,13796.141743,9.013229000000138,330.18133678839786,0
"147.32.84.165",4288,"167.127.98.30",25,6,372,6,372,0,0,13800.948892,9.012818999999581,330.19635698887754,0
"147.32.84.165",4227,"212.117.171.138",65500,14,846,10,604,4,242,13806.757464,118.59157799999957,40.74488324963529,16.324936666244604
"147.32.84.165",4290,"64.12.90.65",25,6,372,6,372,0,0,13806.757617,8.912266000001182,333.9218106819977,0
"147.32.84.165",4291,"212.227.15.186",25,6,372,6,372,0,0,13806.780101,8.889906999998857,334.7616572367273,0
"147.32.84.165",4292,"68.6.19.3",25,6,372,6,372,0,0,13807.357888,8.912779999998747,333.90255341211366,0
"147.32.84.165",4293,"209.85.225.27",25,6,372,6,372,0,0,13807.758539,8.91266799999903,333.9067493594874,0
"147.32.84.165",4294,"98.139.175.224",25,6,372,6,372,0,0,13807.859054,8.915188999999373,333.8123286001238,0
"147.32.84.165",4300,"74.125.113.27",25,6,372,6,372,0,0,13807.859187,8.915177000000767,333.81277791789705,0
"147.32.84.165",4301,"64.12.90.65",25,6,372,6,372,0,0,13807.859246,8.915166999999201,333.8131523504009,0
"147.32.84.165",4305,"114.134.80.211",25,6,372,6,372,0,0,13807.859303,8.915165000000343,333.813227236948,0
"147.32.84.165",4267,"212.117.174.7",4506,6,372,6,372,0,0,13811.864581,8.912782999999763,333.902441022078,0
"147.32.84.165",4276,"116.72.72.149",6667,6,372,6,372,0,0,13812.966509,8.912302000000636,333.92046185147086,0
"147.32.84.165",4274,"212.117.174.7",4506,6,372,6,372,0,0,13814.668677,9.013273000000481,330.17972494562645,0
"147.32.84.165",4308,"203.188.197.119",25,6,372,6,372,0,0,13814.668812,9.013273000000481,330.17972494562645,0
"147.32.84.165",4309,"209.85.225.27",25,6,372,6,372,0,0,13817.075101,9.010111999999936,330.2955612538469,0
"147.32.84.165",4310,"64.12.90.65",25,6,372,6,372,0,0,13817.075236,9.010102000000188,330.295927837436,0
"147.32.84.165",4311,"12.154.55.40",25,6,372,6,372,0,0,13817.075293,9.010098000000653,330.2960744710862,0
"147.32.84.165",4312,"209.85.143.27",25,6,372,6,372,0,0,13821.878916,9.01303899999948,330.1882971992212,0
"147.32.84.165",4313,"64.12.139.193",25,6,372,6,372,0,0,13827.687436,9.01524099999915,330.1076477046238,0
"147.32.84.165",4314,"216.33.127.20",25,6,372,6,372,0,0,13827.687576,9.01522599999953,330.1081969548135,0
"147.32.84.165",4315,"208.65.144.2",25,6,372,6,372,0,0,13828.288098,9.01304699999855,330.1880041234089,0
"147.32.84.165",4317,"66.196.94.104",25,6,372,6,372,0,0,13828.688605,9.013096000000587,330.1862090451279,0
"147.32.84.165",4325,"64.12.139.193",25,6,372,6,372,0,0,13828.788865,9.012867999999798,330.194561819841,0
"147.32.84.165",4327,"98.139.175.224",25,6,372,6,372,0,0,13828.78901,9.012848000000304,330.1952945395173,0
"147.32.84.165",4292,"208.81.160.62",6667,6,372,6,372,0,0,13832.794516,9.012912000000142,330.19294984794624,0
"147.32.84.165",4328,"209.85.225.27",25,6,372,6,372,0,0,13833.996778,9.012354999998934,330.21335710814236,0
"147.32.84.165",4330,"207.126.147.12",25,6,372,6,372,0,0,13835.698604,9.013225000000602,330.1814833203211,0
"147.32.84.165",4305,"212.117.174.7",4506,6,372,6,372,0,0,13838.102281,9.013394999999946,330.1752558275786,0
"147.32.84.165",4274,"212.117.174.7",4506,6,372,6,372,0,0,13842.909325,9.013177999999243,330.18320508041114,0
"147.32.84.165",4332,"207.115.36.20",25,6,372,6,372,0,0,13842.909459,9.013186000000132,330.1829120135717,0
"147.32.84.165",4312,"174.133.57.141",80,16,3429,12,1428,4,2001,13848.71737,0.48637699999926554,23487.952760959608,32912.74052848752
"147.32.84.165",4335,"64.12.139.193",25,6,372,6,372,0,0,13848.717523,9.014278000000559,330.14291327600677,0
"147.32.84.165",4336,"195.245.198.250",25,6,372,6,372,0,0,13848.877455,8.954718999999386,332.33873670410026,0
"147.32.84.165",4339,"74.6.136.244",25,6,372,6,372,0,0,13849.318279,9.01331300000129,330.1782596476539,0
"147.32.84.165",4340,"64.12.90.65",25,6,372,6,372,0,0,13849.718757,9.013018999999986,330.1890298910947,0
"147.32.84.165",4342,"194.218.238.3",25,6,372,6,372,0,0,13849.819226,9.013060999999652,330.1874912418894,0
"147.32.84.165",4312,"41.239.162.145",6667,6,372,6,372,0,0,13855.026485,9.015051000000312,330.1146050088787,0
"147.32.84.165",4343,"209.85.143.27",25,6,372,6,372,0,0,13855.026663,9.015000999999756,330.116435927193,0
"147.32.84.165",4345,"209.85.225.27",25,6,372,6,372,0,0,13856.728973,9.012884000001577,330.1939756463613,0
"147.32.84.165",4328,"174.133.57.141",80,16,3429,12,1428,4,2001,13859.132402,0.5039390000001731,22669.410384979285,31765.749426010887
"147.32.84.165",4346,"64.12.139.193",25,6,372,6,372,0,0,13859.299622,8.946340000000419,332.6499998882069,0
"147.32.84.165",4348,"94.245.120.86",25,6,372,6,372,0,0,13859.299683,8.946402999999918,332.6476573881176,0
"147.32.84.165",4349,"207.115.36.20",25,6,372,6,372,0,0,13863.940017,9.014156999999614,330.1473448931639,0
"147.32.84.165",4274,"212.117.174.7",4506,6,372,6,372,0,0,13869.747788,9.012735000000248,330.19943446688694,0
"147.32.84.165",4351,"98.139.175.224",25,6,372,6,372,0,0,13869.848315,9.012380000000121,330.2124411087815,0
"147.32.84.165",4352,"173.210.69.114",25,6,372,6,372,0,0,13870.34878,9.012582999999722,330.2050033825033,0
"147.32.84.165",4357,"205.188.103.1",25,6,372,6,372,0,0,13870.749196,9.015280999999959,330.1061830463203,0
"147.32.84.165",4359,"209.85.225.27",25,6,372,6,372,0,0,13870.849314,9.014717000000019,330.1268359284039,0
"147.32.84.165",4360,"199.239.254.18",25,6,372,6,372,0,0,13870.849447,9.014707999998791,330.12716551666443,0
"147.32.84.165",4340,"42.201.166.157",6667,6,372,6,372,0,0,13876.0572,8.912222000000838,333.9234592674779,0
"147.32.84.165",4364,"64.12.90.65",25,6,372,6,372,0,0,13876.057311,8.912249999999403,333.9224101658054,0
"147.32.84.165",4368,"114.108.154.244",25,6,372,6,372,0,0,13877.759219,8.913029999999708,333.8931878384901,0
"147.32.84.165",4369,"165.21.74.113",25,6,372,6,372,0,0,13880.263114,8.912846000001082,333.90008084955565,0
"147.32.84.165",4370,"64.12.90.65",25,6,372,6,372,0,0,13884.869269,9.013143000000127,330.1844872537757,0
"147.32.84.165",4371,"207.115.37.23",25,6,372,6,372,0,0,13884.869418,9.013132000000041,330.1848902246174,0
"147.32.84.165",4372,"98.139.175.224",25,6,372,6,372,0,0,13890.678087,9.012789999998859,330.19741944507496,0
"147.32.84.165",4377,"209.85.225.27",25,6,372,6,372,0,0,13890.678264,9.012710999999399,330.20031375689274,0
"147.32.84.165",4379,"64.12.90.65",25,6,372,6,372,0,0,13890.777814,9.013355000000956,330.1767210988233,0
"147.32.84.165",4380,"67.195.168.230",25,6,372,6,372,0,0,13890.777904,9.01339199999893,330.17536572251083,0
"147.32.84.165",4381,"74.6.136.244",25,6,372,6,372,0,0,13891.278819,9.013142000001608,330.1845238873934,0
"147.32.84.165",4382,"74.125.113.27",25,6,372,6,372,0,0,13891.679675,9.012822000000597,330.1962470799715,0
"147.32.84.165",4383,"168.95.5.78",25,6,372,6,372,0,0,13891.779399,9.013307000001078,330.17847944152396,0
"147.32.84.165",4360,"212.117.174.7",4506,6,372,6,372,0,0,13896.986725,9.013692999998966,330.1643399659098,0
"147.32.84.165",4359,"124.123.106.96",6667,6,372,6,372,0,0,13897.086892,9.013230000000476,330.18130015542073,0
"147.32.84.165",4352,"212.117.174.7",4506,6,372,6,372,0,0,13898.689223,9.012930000000779,330.19229040941656,0
"147.32.84.165",4387,"209.85.143.27",25,6,372,6,372,0,0,13898.689358,9.012920000001031,330.1926567638079,0
"147.32.84.165",4388,"205.188.103.1",25,6,372,6,372,0,0,13901.192995,9.01314000000093,330.18459715478656,0
"147.32.84.165",4390,"98.139.175.224",25,6,372,6,372,0,0,13905.900018,9.01301500000045,330.1891764298463,0
"147.32.84.165",4359,"174.133.57.141",80,17,3489,12,1428,5,2061,13911.708024,0.8628660000013042,13239.599196147181,19108.41312553175
"147.32.84.165",4393,"209.85.225.27",25,6,372,6,372,0,0,13911.808059,9.013214999999036,330.1818496507981,0
"147.32.84.165",4396,"64.12.90.65",25,6,372,6,372,0,0,13911.86673,8.954685000000609,332.3399985593907,0
"147.32.84.165",4398,"65.55.92.168",25,6,372,6,372,0,0,13912.309327,9.012692999998762,330.2009732274703,0
"147.32.84.165",4400,"65.55.37.72",25,6,372,6,372,0,0,13912.709795,9.012730999998894,330.19958101494046,0
"147.32.84.165",4402,"205.188.103.1",25,6,372,6,372,0,0,13912.809497,9.013016999999309,330.1891031604876,0
"147.32.84.165",4403,"209.85.225.27",25,6,372,6,372,0,0,13912.809627,9.013059999999314,330.1875278762403,0
"147.32.84.165",4404,"77.238.184.241",25,6,372,6,372,0,0,13912.809684,9.01310100000046,330.1860258749844,0
"147.32.84.165",4380,"122.218.153.19",6667,6,372,6,372,0,0,13918.017589,9.012527000000773,330.20705513556237,0
"147.32.84.165",4405,"98.139.175.224",25,6,372,6,372,0,0,13918.117379,9.012862999999925,330.1947449994552,0
"147.32.84.165",4406,"64.12.139.193",25,6,372,6,372,0,0,13918.117512,9.012853999998697,330.1950747233263,0
"147.32.84.165",4407,"98.139.175.224",25,6,372,6,372,0,0,13919.719795,9.012672999999268,330.20170597560144,0
"147.32.84.165",4412,"205.188.190.1",25,6,372,6,372,0,0,13919.719946,9.0126479999999,330.2026219153387,0
"147.32.84.165",4360,"67.195.168.31",25,6,372,6,372,0,0,13922.223139,9.01332100000036,330.17796658966,0
"147.32.84.165",4416,"12.102.252.75",25,6,372,6,372,0,0,13926.929977,9.013028999999733,330.18866354475153,0
"147.32.84.165",4388,"212.117.174.7",4506,6,372,6,372,0,0,13932.838577,9.01263999999901,330.20291501716775,0
"147.32.84.165",4227,"212.117.171.138",65500,83,46302,58,43886,25,2416,13932.838674,12.37765699999909,28364.657382251407,1561.5233157617326
"147.32.84.165",4380,"212.117.174.7",4506,6,372,6,372,0,0,13932.86124,8.990101999999752,331.0307269038863,0
"147.32.84.165",4417,"209.85.225.27",25,6,372,6,372,0,0,13932.861301,8.990093999998862,331.03102147768163,0
"147.32.84.165",4418,"66.175.58.43",25,6,372,6,372,0,0,13933.339106,9.015198000000964,330.1092222266978,0
"147.32.84.165",4419,"205.188.103.1",25,6,372,6,372,0,0,13933.739556,9.013467999999193,330.172581741042,0
"147.32.84.165",4421,"207.115.37.23",25,6,372,6,372,0,0,13933.840059,9.012920999999551,330.1926201283855,0
"147.32.84.165",4422,"65.54.188.72",25,6,372,6,372,0,0,13939.147655,9.013223999998445,330.18151995340554,0
"147.32.84.165",4400,"212.117.171.138",65500,23,1409,16,972,7,437,13939.147763,8.911618999998609,872.5687218002939,392.29684303161366
"147.32.84.165",4423,"205.188.103.1",25,6,372,6,372,0,0,13939.147791,9.013246000000436,330.18071402909186,0
"147.32.84.165",4402,"86.123.31.54",6667,4,248,4,248,0,0,13939.147817,3.003961000000345,660.461304257869,0
"147.32.84.165",4428,"98.139.175.224",25,6,372,6,372,0,0,13940.749662,9.015438000000358,330.10043438819963,0
"147.32.84.165",4404,"65.54.165.139",443,43,24641,34,3842,9,20799,13943.253535,1.532322999999451,20058.434155208146,108588.07183606825
"147.32.84.165",4407,"65.54.188.72",25,6,372,6,372,0,0,13943.417377,8.949135000000751,332.54610641137384,0
"147.32.84.165",4430,"98.139.175.224",25,6,372,6,372,0,0,13943.417438,8.94919899999877,332.54372821527477,0
"147.32.84.165",4431,"80.85.32.229",25,6,372,6,372,0,0,13943.417498,8.949203999998645,332.543542420136,0
"147.32.84.165",4432,"209.85.225.27",25,6,372,6,372,0,0,13947.960669,8.912360000000263,333.91828875852326,0
"147.32.84.165",4404,"212.117.171.138",65500,60,24703,42,21820,18,2883,13947.96082,8.15228500000012,21412.401553674514,2829.1454481779847
"147.32.84.165",4433,"205.188.190.1",25,6,372,6,372,0,0,13947.960896,8.912258999998812,333.92207295595836,0
"147.32.84.165",4435,"65.55.92.168",25,6,372,6,372,0,0,13953.768609,9.013339999999516,330.1772705789596,0
"147.32.84.165",4436,"205.188.103.1",25,6,372,6,372,0,0,13953.768757,9.013316000000486,330.1781497508619,0
"147.32.84.165",4437,"98.139.175.224",25,6,372,6,372,0,0,13953.768816,9.0133050000004,330.1785527062346,0
"147.32.84.165",4438,"128.146.216.132",25,6,372,6,372,0,0,13953.768878,9.01328999999896,330.17910219246727,0
"147.32.84.165",4380,"65.54.165.139",443,37,15454,28,5244,9,10210,13954.269108,1.7777819999992062,23597.943954893646,45944.89088090468
"147.32.84.165",4442,"209.85.225.27",25,6,372,6,372,0,0,13954.432885,8.949356999999509,332.5378571890878,0
"147.32.84.165",4444,"205.188.103.1",25,6,372,6,372,0,0,13954.670098,9.013096999999107,330.1861724111363,0
"147.32.84.165",4446,"212.142.144.9",25,6,372,6,372,0,0,13954.770376,9.012378999999783,330.212477748669,0
"147.32.84.165",4418,"212.117.174.7",4506,6,372,6,372,0,0,13959.576922,9.01274899999953,330.1989215499239,0
"147.32.84.165",4419,"212.117.174.7",4506,6,372,6,372,0,0,13960.077525,9.01308699999936,330.1865387519516,0
"147.32.84.165",4451,"98.139.175.224",25,6,372,6,372,0,0,13960.077603,9.013134000000719,330.18481695709426,0
"147.32.84.165",4404,"111.88.77.58",6667,6,372,6,372,0,0,13960.077637,9.013152999999875,330.1841209175126,0
"147.32.84.165",4453,"66.94.237.139",25,6,372,6,372,0,0,13961.679948,9.012784999998985,330.1976026278598,0
"147.32.84.165",4454,"209.85.225.27",25,6,372,6,372,0,0,13964.283461,9.013463999999658,330.1727282651945,0
"147.32.84.165",4457,"205.188.190.1",25,6,372,6,372,0,0,13964.283593,9.013456000000588,330.1730213138896,0
"147.32.84.165",4459,"98.139.175.224",25,6,372,6,372,0,0,13964.283652,9.013452999999572,330.17313120733434,0
"147.32.84.165",4463,"65.54.188.110",25,6,372,6,372,0,0,13968.892493,9.010799000001498,330.2703789086301,0
"147.32.84.165",4466,"209.85.225.27",25,6,372,6,372,0,0,13974.799195,9.015129999999772,330.1117121993887,0
"147.32.84.165",4467,"65.54.188.110",25,6,372,6,372,0,0,13974.799336,9.015113999999812,330.11229808076325,0
"147.32.84.165",4468,"199.0.233.8",25,6,372,6,372,0,0,13974.799396,9.015101999999388,330.1127374931756,0
"147.32.84.165",4469,"64.12.139.193",25,6,372,6,372,0,0,13974.799467,9.015082999998413,330.11343323189857,0
"147.32.84.165",4470,"64.184.231.231",25,6,372,6,372,0,0,13975.399515,9.013144000000466,330.1844506200995,0
"147.32.84.165",4471,"208.84.244.133",25,6,372,6,372,0,0,13975.699937,9.013186000000132,330.1829120135717,0
"147.32.84.165",4472,"67.195.168.230",25,6,372,6,372,0,0,13975.800035,9.013209999999162,330.18203281630815,0
"147.32.84.165",4476,"205.188.103.1",25,6,372,6,372,0,0,13980.607547,9.012934000000314,330.192143867901,0
"147.32.84.165",4438,"188.129.211.240",6667,6,372,6,372,0,0,13980.607686,9.012854000000516,330.19507472325967,0
"147.32.84.165",4479,"208.67.179.142",25,6,372,6,372,0,0,13982.710539,9.012350000000879,330.21354030854434,0
"147.32.84.165",4446,"212.117.171.138",65500,123,84562,80,4804,43,79758,13985.314003,10.561413999999786,3638.9066842754937,60414.63766120833
"147.32.84.165",4481,"98.139.175.224",25,6,372,6,372,0,0,13985.336669,8.990034000000378,331.0332307975559,0
"147.32.84.165",4451,"212.117.174.7",4506,6,372,6,372,0,0,13989.920811,9.012640999999348,330.20287837940236,0
"147.32.84.165",4453,"212.117.174.7",4506,6,372,6,372,0,0,13995.829111,9.015987000000678,330.0803339667389,0
"147.32.84.165",4482,"209.85.225.27",25,6,372,6,372,0,0,13995.829247,9.015973999999915,330.08080990473445,0
"147.32.84.165",4459,"212.117.171.138",65500,22,1348,16,972,6,376,13995.82931,5.876958000000741,1323.1334986567915,511.82941923349136
"147.32.84.165",4485,"64.12.139.193",25,6,372,6,372,0,0,13995.829367,9.01590699999906,330.0832628375947,0
"147.32.84.165",4487,"205.188.190.1",25,6,372,6,372,0,0,13996.43032,9.01256100000137,330.2058094252619,0
"147.32.84.165",4488,"74.6.136.65",25,6,372,6,372,0,0,13996.730533,9.012660000000324,330.202182263604,0
"147.32.84.165",4489,"213.199.180.150",25,6,372,6,372,0,0,13996.830735,9.012595000000147,330.2045637244269,0
"147.32.84.165",4468,"173.192.170.88",80,6,372,6,372,0,0,14001.637232,9.013190000001487,330.1827654803138,0
"147.32.84.165",4466,"173.192.170.88",80,6,372,6,372,0,0,14001.637373,9.013173999999708,330.1833516139926,0
"147.32.84.165",4472,"173.192.170.88",80,6,372,6,372,0,0,14001.637437,9.013161000000764,330.18382784904736,0
"147.32.84.165",4469,"173.192.170.88",80,6,372,6,372,0,0,14001.637493,9.013157999999748,330.18393774968587,0
"147.32.84.165",4467,"173.192.170.88",80,6,372,6,372,0,0,14001.637551,9.013151999999536,330.1841575511157,0
"147.32.84.165",4490,"65.54.188.94",25,6,372,6,372,0,0,14001.637606,9.01314999999886,330.1842308183462,0
"147.32.84.165",4471,"212.117.171.138",65500,119,84310,76,4564,43,79746,14003.740707,7.2564569999995,5031.656633533764,87917.28525367737
"147.32.84.165",4459,"174.133.57.141",80,17,3489,12,1428,5,2061,14003.76329,0.6626679999990301,17239.401932818124,24881.237663542124
"147.32.84.165",4492,"74.6.136.244",25,6,372,6,372,0,0,14003.923295,8.930059000000256,333.25647680490295,0
"147.32.84.165",4494,"98.139.175.224",25,6,372,6,372,0,0,14006.344108,9.013042000000496,330.1881872956807,0
"147.32.84.165",4496,"209.86.93.227",25,6,372,6,372,0,0,14010.950948,9.012539999999717,330.20657883350236,0
"147.32.84.165",4451,"212.117.171.138",65500,51,4539,34,3454,17,1085,14016.859212,52.88777800000025,522.4647554676974,164.1210942913873
"147.32.84.165",4497,"209.85.225.27",25,6,372,6,372,0,0,14016.85935,8.916744000000108,333.75411473066447,0
"147.32.84.165",4499,"89.31.148.93",25,6,372,6,372,0,0,14016.88173,8.89448700000139,334.5892798538617,0
"147.32.84.165",4501,"216.32.181.178",25,6,372,6,372,0,0,14017.460232,8.9128639999999,333.899406520736,0
"147.32.84.165",4502,"205.188.190.1",25,6,372,6,372,0,0,14017.760623,8.912940000000162,333.89655938443946,0
"147.32.84.165",4503,"64.12.90.65",25,6,372,6,372,0,0,14017.8607,8.91269100000136,333.9058876830293,0
"147.32.84.165",4488,"212.117.174.7",4506,6,372,6,372,0,0,14022.667856,9.012614999999641,330.2038309636125,0
"147.32.84.165",4489,"212.117.174.7",4506,6,372,6,372,0,0,14022.667964,9.012630999999601,330.20324475728916,0
"147.32.84.165",4505,"204.127.217.16",25,6,372,6,372,0,0,14022.667997,9.012649999998757,330.2025486400127,0
"147.32.84.165",4469,"173.192.170.88",80,20,2978,16,2732,4,246,14024.770508,21.43192900000031,1019.7868796597677,91.82561215091611
"147.32.84.165",4467,"173.192.170.88",80,6,372,6,372,0,0,14024.971449,9.01260799999909,330.20408742955425,0
"147.32.84.165",4472,"173.192.170.88",80,6,372,6,372,0,0,14024.971516,9.012667000000874,330.20192580062167,0
"147.32.84.165",4468,"173.192.170.88",80,6,372,6,372,0,0,14024.97157,9.012666000000536,330.20196243817566,0
"147.32.84.165",4466,"173.192.170.88",80,6,372,6,372,0,0,14024.971628,9.012662000001,330.2021089884065,0
"147.32.84.165",4508,"209.85.227.27",25,6,372,6,372,0,0,14024.971687,9.012658000001466,330.20225553876736,0
"147.32.84.165",4509,"209.85.143.27",25,6,372,6,372,0,0,14027.27412,9.01298499999939,330.1902754747957,0
"147.32.84.165",4510,"210.197.74.195",25,6,372,6,372,0,0,14031.88078,9.012894000001324,330.1936092890433,0
"147.32.84.165",4511,"65.160.50.110",25,6,372,6,372,0,0,14037.789511,9.0126479999999,330.2026219153387,0
"147.32.84.165",4512,"98.139.175.224",25,6,372,6,372,0,0,14037.789615,9.012668000001213,330.20188916307575,0
"147.32.84.165",4513,"209.85.225.27",25,6,372,6,372,0,0,14038.390215,9.01481700000113,330.1231738813585,0
"147.32.84.165",4514,"64.12.90.65",25,6,372,6,372,0,0,14038.690905,9.012563000000227,330.2057361485212,0
"147.32.84.165",4515,"205.188.190.1",25,6,372,6,372,0,0,14038.69101,9.012590999998793,330.20471027703337,0
"147.32.84.165",4520,"170.66.1.94",25,6,372,6,372,0,0,14038.790669,9.013176000000385,330.1832783471523,0
"147.32.84.165",4522,"98.139.175.224",25,6,372,6,372,0,0,14043.69774,9.012893000000986,330.1936459247518,0
"147.32.84.165",4501,"212.117.171.138",65500,22,1338,16,972,6,366,14043.69789,9.27021700000114,838.8153157578776,315.85021148907737
"147.32.84.165",4523,"98.139.175.224",25,6,372,6,372,0,0,14043.697963,9.012792999999874,330.1973095354616,0
"147.32.84.165",4502,"59.94.130.46",6667,4,248,4,248,0,0,14043.698037,3.0042730000004667,660.3927139776218,0
"147.32.84.165",4524,"64.12.139.193",25,6,372,6,372,0,0,14043.698122,9.012688000000708,330.20115641413156,0
"147.32.84.165",4488,"64.12.175.136",587,28,2487,20,1304,8,1183,14046.001394,23.841467999998713,437.5569490939301,396.95542237585835
"147.32.84.165",4489,"67.195.168.31",25,6,372,6,372,0,0,14046.119698,8.994376999999076,330.8733890074105,0
"147.32.84.165",4525,"209.85.225.27",25,6,372,6,372,0,0,14048.30437,9.01307000000088,330.1871615331634,0
"147.32.84.165",4526,"205.188.103.1",25,6,372,6,372,0,0,14048.304504,9.013060999999652,330.1874912418894,0
"147.32.84.165",4508,"212.117.174.7",4506,6,372,6,372,0,0,14052.910903,9.013084000000163,330.1866486543281,0
"147.32.84.165",4528,"65.55.92.152",25,6,372,6,372,0,0,14058.819908,9.012776999999915,330.19789572071164,0
"147.32.84.165",4469,"212.117.174.7",4506,6,372,6,372,0,0,14058.820044,9.01276499999949,330.19833536103164,0
"147.32.84.165",4472,"212.117.171.138",65500,22,1338,16,972,6,366,14058.8201,4.163785999999163,1867.5311363267858,703.2061686168762
"147.32.84.165",4530,"65.55.37.104",25,6,372,6,372,0,0,14058.820153,9.012705999999525,330.20049694288895,0
"147.32.84.165",4533,"207.115.20.21",25,6,372,6,372,0,0,14059.4209,9.017397999999957,330.0286845495801,0
"147.32.84.165",4534,"98.139.175.224",25,6,372,6,372,0,0,14059.72475,9.009208000001308,330.3287036995447,0
"147.32.84.165",4535,"205.188.103.1",25,6,372,6,372,0,0,14059.821026,9.012982000000193,330.19038537965974,0
"147.32.84.165",4536,"209.85.225.27",25,6,372,6,372,0,0,14059.821158,9.012972999998965,330.19071509482404,0
"147.32.84.165",4542,"205.188.103.1",25,6,372,6,372,0,0,14062.92676,9.011881999998877,330.2306887729301,0
"147.32.84.165",4513,"212.117.171.138",65500,23,1398,16,972,7,426,14062.926891,6.713623000001462,1158.2419805220381,507.6245717102759
"147.32.84.165",4543,"76.96.30.116",25,6,372,6,372,0,0,14062.926948,9.011787999999797,330.23413333736517,0
"147.32.84.165",4514,"41.71.139.171",6667,4,248,4,248,0,0,14064.728016,3.004281000001356,660.3909554396225,0
"147.32.84.165",4544,"74.125.113.27",25,6,372,6,372,0,0,14067.131649,9.01284399999895,330.1954410838961,0
"147.32.84.165",4545,"65.54.188.94",25,6,372,6,372,0,0,14069.334576,9.012897000000521,330.1934993820331,0
"147.32.84.165",4522,"212.117.171.138",65500,14,846,10,604,4,242,14073.941696,110.04204799999934,43.91048774373982,17.593274890703704
"147.32.84.165",4526,"65.54.188.72",25,6,372,6,372,0,0,14073.964289,8.99022800000057,331.0260874362487,0
"147.32.84.165",4546,"72.4.117.21",25,6,372,6,372,0,0,14079.849995,9.012881999999081,330.1940489180157,0
"147.32.84.165",4514,"212.117.174.7",4506,6,372,6,372,0,0,14079.850101,9.012903999999253,330.1932429326049,0
"147.32.84.165",4549,"98.139.175.224",25,6,372,6,372,0,0,14080.453012,9.010652000000846,330.2757669477992,0
"147.32.84.165",4550,"203.150.217.35",25,6,372,6,372,0,0,14080.453145,9.010642000001098,330.27613348745155,0
"147.32.84.165",4551,"209.85.225.27",25,6,372,6,372,0,0,14080.751171,9.012994000000617,330.1899457605094,0
"147.32.84.165",4552,"98.139.175.224",25,6,372,6,372,0,0,14080.751318,9.012973999999303,330.1906784597659,0
"147.32.84.165",4554,"205.188.190.1",25,6,372,6,372,0,0,14080.851262,9.012957999999344,330.1912646214724,0
"147.32.84.165",4530,"190.79.152.22",6667,6,372,6,372,0,0,14083.955801,8.913086000000476,333.8910900220015,0
"147.32.84.165",4555,"208.65.145.11",25,6,372,6,372,0,0,14083.955945,8.913162000000739,333.8882430275309,0
"147.32.84.165",4556,"67.231.152.94",25,6,372,6,372,0,0,14088.165075,8.909562999999252,334.02311650978277,0
"147.32.84.165",4543,"212.117.174.7",4506,6,372,6,372,0,0,14090.36474,8.914063999998689,333.85445740578456,0
"147.32.84.165",4561,"67.195.168.230",25,6,372,6,372,0,0,14090.364874,8.914057999998477,333.8546821212638,0
"147.32.84.165",4530,"174.133.57.141",80,17,3489,12,1428,5,2061,14094.871325,10.382905000000392,1100.270107450619,1587.9948819717968
"147.32.84.165",4567,"209.85.225.27",25,6,372,6,372,0,0,14095.030417,8.953934999999547,332.367836040819,0
"147.32.84.165",4568,"205.188.159.42",25,6,372,6,372,0,0,14100.779824,9.012894000001324,330.1936092890433,0
"147.32.84.165",4569,"64.12.90.33",25,6,372,6,372,0,0,14100.779964,9.012880000000223,330.19412218956944,0
"147.32.84.165",4571,"64.12.139.193",25,6,372,6,372,0,0,14101.38085,9.012807000000976,330.19679662503347,0
"147.32.84.165",4572,"98.139.175.224",25,6,372,6,372,0,0,14101.681208,9.012785000000804,330.1976026277931,0
"147.32.84.165",4574,"94.136.40.151",25,6,372,6,372,0,0,14101.781227,9.01292900000044,330.19232704483244,0
"147.32.84.165",4546,"200.206.208.45",6667,6,372,6,372,0,0,14104.886221,9.012394999999742,330.21189151164424,0
"147.32.84.165",4575,"204.127.217.16",25,6,372,6,372,0,0,14104.986405,9.012703000000329,330.2006068545576,0
"147.32.84.165",4550,"212.117.174.7",4506,6,372,6,372,0,0,14109.091636,9.013103000001138,330.18595260695724,0
"147.32.84.165",4577,"64.12.90.65",25,6,372,6,372,0,0,14111.29859,9.010148999999728,330.2942049016159,0
"147.32.84.165",4556,"74.125.127.27",25,6,372,6,372,0,0,14116.001579,9.013075000000754,330.18697836196316,0
"147.32.84.165",4543,"174.133.57.141",80,17,2011,12,1428,5,583,14121.810226,251.3160339999995,45.45670969803711,18.558306550389098
"147.32.84.165",4580,"209.85.225.27",25,6,372,6,372,0,0,14121.810365,9.012572000001455,330.20540640335736,0
"147.32.84.165",4582,"212.77.101.4",25,6,372,6,372,0,0,14121.970038,8.953025000000707,332.40161844737,0
"147.32.84.165",4584,"205.188.103.1",25,6,372,6,372,0,0,14122.410893,9.012892999999167,330.1936459248185,0
"147.32.84.165",4585,"207.115.20.21",25,6,372,6,372,0,0,14122.711358,9.01286699999946,330.1945984557609,0
"147.32.84.165",4587,"64.12.139.193",25,6,372,6,372,0,0,14122.811365,9.012998000000152,330.1897992210749,0
"147.32.84.165",4569,"117.204.67.227",6667,6,372,6,372,0,0,14126.017713,9.01137000000017,330.2494515262323,0
"147.32.84.165",4588,"69.12.116.4",25,6,372,6,372,0,0,14126.017853,9.011332000000039,330.2508441593304,0
"147.32.84.165",4572,"212.117.174.7",4506,6,372,6,372,0,0,14130.122552,9.012643999998545,330.2027684662215,0
"147.32.84.165",4590,"209.85.225.27",25,6,372,6,372,0,0,14132.327659,9.01104899999882,330.26121598055784,0
"147.32.84.165",4594,"64.136.52.37",25,6,372,6,372,0,0,14132.327808,9.010979999999108,330.2637448979239,0
"147.32.84.165",4596,"98.139.175.224",25,6,372,6,372,0,0,14137.032072,9.01273399999991,330.19947110388813,0
"147.32.84.165",4598,"64.12.139.193",25,6,372,6,372,0,0,14142.840412,9.01285100000132,330.19518463131857,0
"147.32.84.165",4599,"77.238.177.9",25,6,372,6,372,0,0,14142.840566,9.012826999998651,330.1960638987573,0
"147.32.84.165",4601,"209.85.225.27",25,6,372,6,372,0,0,14142.940588,9.012978000000658,330.19053191961444,0
"147.32.84.165",4603,"64.12.139.193",25,6,372,6,372,0,0,14143.441033,9.017117000001235,330.038969218165,0
"147.32.84.165",4605,"209.85.143.27",25,6,372,6,372,0,0,14143.441168,9.017108000000007,330.03929863100205,0
"147.32.84.165",4607,"216.32.180.22",25,6,372,6,372,0,0,14143.745455,9.009274000000005,330.3262837826886,0
"147.32.84.165",4609,"98.139.175.224",25,6,372,6,372,0,0,14143.844607,9.010364999998274,330.28628695958156,0
"147.32.84.165",4610,"74.6.136.244",25,6,372,6,372,0,0,14143.844739,9.010322000000087,330.2878631862403,0
"147.32.84.165",4584,"112.205.182.117",6667,9,552,6,372,3,180,14147.046307,1.9930339999991702,1493.2008184512854,722.5165250570735
"147.32.84.165",4612,"207.109.18.201",25,6,372,6,372,0,0,14147.046419,9.012758999999278,330.1985551816307,0
"147.32.84.165",4613,"204.127.217.16",25,6,372,6,372,0,0,14149.039606,8.922656999999163,333.5329375543943,0
"147.32.84.165",4588,"212.117.174.7",4506,6,372,6,372,0,0,14151.15237,9.01318800000081,330.18283874692645,0
"147.32.84.165",4614,"205.188.190.1",25,6,372,6,372,0,0,14153.355604,8.91297300000042,333.8953231430029,0
"147.32.84.165",4594,"212.117.174.7",4506,6,372,6,372,0,0,14158.062431,8.912652999999409,333.9073113247197,0
"147.32.84.165",4590,"174.133.57.141",80,17,3489,12,1428,5,2061,14158.062562,1.3496700000014243,8464.291271190694,12216.31954476472
"147.32.84.165",4615,"94.245.120.86",25,6,372,6,372,0,0,14158.062647,8.912580999998681,333.9100087842613,0
"147.32.84.165",4596,"218.3.166.230",6667,4,248,4,248,0,0,14163.77068,3.004086000000825,660.4338224669517,0
"147.32.84.165",4618,"64.12.139.193",25,6,372,6,372,0,0,14163.870675,9.01327499999934,330.1796516804622,0
"147.32.84.165",4619,"209.85.225.27",25,6,372,6,372,0,0,14164.37128,9.013084000000163,330.1866486543281,0
"147.32.84.165",4623,"98.139.175.224",25,6,372,6,372,0,0,14164.671727,9.012963999999556,330.19104481058025,0
"147.32.84.165",4624,"65.55.92.136",25,6,372,6,372,0,0,14164.771905,9.013038000000961,330.18833383368434,0
"147.32.84.165",4598,"74.125.127.27",25,6,372,6,372,0,0,14167.976565,9.012749999999869,330.19888491304465,0
"147.32.84.165",4605,"174.133.57.141",80,17,3489,12,1428,5,2061,14169.879334,10.93453000000045,1044.7636981195835,1507.8837407734325
"147.32.84.165",4625,"208.65.144.12",25,6,372,6,372,0,0,14169.879422,9.012867999999798,330.194561819841,0
"147.32.84.165",4627,"64.12.139.193",25,6,372,6,372,0,0,14172.082262,9.013301999999385,330.1786626033615,0
"147.32.84.165",4628,"209.85.143.27",25,6,372,6,372,0,0,14172.082396,9.013295000000653,330.1789190301421,0
"147.32.84.165",4629,"206.223.25.226",25,6,372,6,372,0,0,14174.285455,9.013098000001264,330.18613577701944,0
"147.32.84.165",4614,"212.117.174.7",4506,6,372,6,372,0,0,14178.992213,9.015454000000318,330.09984854893554,0
"147.32.84.165",4630,"202.67.240.41",25,6,372,6,372,0,0,14181.896412,9.01334499999939,330.17708741873315,0
"147.32.84.165",4522,"212.117.174.7",4506,6,372,6,372,0,0,14184.90124,9.012468000000808,330.20921683158633,0
"147.32.84.165",4594,"117.205.50.80",6667,4,248,4,248,0,0,14184.901301,3.0066619999997783,659.8679864913802,0
"147.32.84.165",4633,"64.12.139.193",25,6,372,6,372,0,0,14185.404388,9.01228699999956,330.21584865197315,0
"147.32.84.165",4634,"209.85.225.27",25,6,372,6,372,0,0,14185.702306,9.012963000001037,330.1910814456531,0
"147.32.84.165",4636,"98.139.175.224",25,6,372,6,372,0,0,14185.802257,9.01320300000043,330.18228924832357,0
"147.32.84.165",4618,"212.117.171.138",65500,11,666,8,484,3,182,14189.006879,308.08849999999984,12.567817364166471,4.725914793963425
"147.32.84.165",4639,"205.188.190.1",25,6,372,6,372,0,0,14189.029408,8.990268999999898,331.0245777962855,0
"147.32.84.165",4624,"174.133.57.141",80,17,2011,12,1428,5,583,14190.909892,86.98357100000067,131.33514603579465,53.61932082553801
"147.32.84.165",4645,"65.54.188.110",25,6,372,6,372,0,0,14190.909952,9.012855000000854,330.195038087234,0
"147.32.84.165",4646,"114.108.154.209",25,6,372,6,372,0,0,14193.112617,9.012917000000016,330.1927666703238,0
"147.32.84.165",4647,"98.139.175.224",25,6,372,6,372,0,0,14195.315883,9.012985000001208,330.19027547472905,0
"147.32.84.165",4648,"98.129.185.3",25,6,372,6,372,0,0,14195.316015,9.013011999999435,330.18928633404533,0
"147.32.84.165",4649,"67.231.144.184",25,6,372,6,372,0,0,14200.02241,9.016023000000132,330.07901599185766,0
"147.32.84.165",4651,"208.65.144.12",25,6,372,6,372,0,0,14202.928604,9.011021999998775,330.2622055523119,0
"147.32.84.165",4652,"209.85.225.27",25,6,372,6,372,0,0,14202.928745,9.011006000000634,330.2627919679324,0
"147.32.84.165",4656,"98.139.175.224",25,6,372,6,372,0,0,14202.928803,9.010995999999068,330.2631584788527,0
"147.32.84.165",4659,"64.12.90.65",25,6,372,6,372,0,0,14202.928864,9.01098600000114,330.26352499045316,0
"147.32.84.165",4630,"212.117.174.7",4506,6,372,6,372,0,0,14206.431945,9.012754999999743,330.1987017288371,0
"147.32.84.165",4660,"205.188.103.1",25,6,372,6,372,0,0,14206.732803,9.012676999998803,330.20155942572836,0
"147.32.84.165",4661,"205.178.149.7",25,6,372,6,372,0,0,14206.832558,9.012643000000025,330.2028051038959,0
"147.32.84.165",4662,"192.26.237.55",25,6,372,6,372,0,0,14210.037026,9.012747000000672,330.19899482364013,0
"147.32.84.165",4636,"41.240.106.5",6667,6,372,6,372,0,0,14211.939916,9.01263199999994,330.20320811945055,0
"147.32.84.165",4971,"207.115.37.23",25,6,372,6,372,0,0,14214.142788,9.015500000001339,330.09816427259256,0
"147.32.84.165",4646,"212.117.174.7",4506,6,372,6,372,0,0,14216.345988,9.013606000000436,330.16752673678616,0
"147.32.84.165",4977,"98.139.175.224",25,6,372,6,372,0,0,14216.346061,9.013628999999128,330.166684251181,0
"147.32.84.165",4979,"209.85.225.27",25,6,372,6,372,0,0,14221.052618,9.013633000000482,330.1665377323262,0
"147.32.84.165",4990,"205.188.190.1",25,6,372,6,372,0,0,14223.95701,8.913189000000784,333.8872316069746,0
"147.32.84.165",1137,"64.12.139.193",25,6,372,6,372,0,0,14223.957154,8.91311400000086,333.8900411236424,0
"147.32.84.165",1193,"69.175.81.214",25,6,372,6,372,0,0,14227.461913,8.913081000000602,333.8912773259661,0
"147.32.84.165",1224,"209.85.225.27",25,6,372,6,372,0,0,14227.762814,8.912403000000268,333.91667769061957,0
"147.32.84.165",1228,"207.115.37.23",25,6,372,6,372,0,0,14227.762944,8.912365000000136,333.9181014242521,0
"147.32.84.165",1246,"209.85.143.27",25,6,372,6,372,0,0,14227.763001,8.912335000000894,333.919225433032,0
"147.32.84.165",1248,"98.139.175.224",25,6,372,6,372,0,0,14227.862591,8.912771000001158,333.9028905824702,0
"147.32.84.165",1253,"66.94.237.139",25,6,372,6,372,0,0,14227.862725,8.912760999999591,333.90326521715735,0
"147.32.84.165",4660,"174.133.57.141",80,17,3489,12,1428,5,2061,14231.067041,2.0478430000002845,5578.5526527172315,8051.3984714637345
"147.32.84.165",1258,"64.12.139.193",25,6,372,6,372,0,0,14231.067173,8.912733000001026,333.90431419853564,0
"147.32.84.165",1337,"76.96.62.116",25,6,372,6,372,0,0,14231.067233,8.912797000000865,333.90191653638146,0
"147.32.84.165",1486,"65.55.92.152",25,6,372,6,372,0,0,14233.570855,9.01274899999953,330.1989215499239,0
"147.32.84.165",1504,"205.188.190.1",25,6,372,6,372,0,0,14235.072798,9.01329700000133,330.1788457652689,0
"147.32.84.165",1606,"203.188.197.119",25,6,372,6,372,0,0,14235.072947,9.013273999999,330.1796883130736,0
"147.32.84.165",1617,"216.32.181.178",25,6,372,6,372,0,0,14237.275959,9.013213999998698,330.1818862838972,0
"147.32.84.165",4646,"212.117.174.7",4506,6,372,6,372,0,0,14241.98271,9.012962999999218,330.1910814457197,0
"147.32.84.165",1632,"216.130.191.236",25,6,372,6,372,0,0,14244.887379,9.012572999999975,330.20536976510573,0
"147.32.84.165",1672,"216.99.131.4",25,6,372,6,372,0,0,14244.887488,9.012591999999131,330.20467363886956,0
"147.32.84.165",1689,"209.85.225.27",25,6,372,6,372,0,0,14248.392232,9.012695999999778,330.2008633154911,0
"147.32.84.165",1697,"205.188.190.1",25,6,372,6,372,0,0,14248.692828,9.012484000000768,330.20863060613993,0
"147.32.84.165",1756,"64.18.7.10",25,6,372,6,372,0,0,14248.792915,9.012590000000273,330.2047469151387,0
"147.32.84.165",1769,"98.139.175.224",25,6,372,6,372,0,0,14251.997213,9.012885000000097,330.1939390106462,0
"147.32.84.165",1246,"212.117.174.7",4506,6,372,6,372,0,0,14254.602319,9.013273000000481,330.17972494562645,0
"147.32.84.165",1228,"190.122.143.202",6667,4,248,4,248,0,0,14254.602453,3.0030880000012985,660.6533008686865,0
"147.32.84.165",1776,"74.6.136.244",25,6,372,6,372,0,0,14256.103249,9.01285900000039,330.1948915432796,0
"147.32.84.165",1810,"209.85.225.27",25,6,372,6,372,0,0,14258.306452,9.013189999999668,330.1827654803804,0
"147.32.84.165",1843,"67.195.168.31",25,6,372,6,372,0,0,14258.306603,9.013165999998819,330.18364468161246,0
"147.32.84.165",1885,"64.12.90.65",25,6,372,6,372,0,0,14263.012989,9.01366699999926,330.1652923277779,0
"147.32.84.165",1907,"64.12.139.193",25,6,372,6,372,0,0,14265.917224,9.013148000000001,330.1843040855425,0
"147.32.84.165",2012,"209.85.225.27",25,6,372,6,372,0,0,14265.917309,9.013187000000471,330.18287538024504,0
"147.32.84.165",2026,"64.98.36.4",25,6,372,6,372,0,0,14265.917339,9.013210000000981,330.1820328162415,0
"147.32.84.165",1632,"212.117.174.7",4506,6,372,6,372,0,0,14269.422152,9.013068000000203,330.18723480172713,0
"147.32.84.165",2051,"205.188.190.1",25,6,372,6,372,0,0,14269.723599,9.012442999999621,330.21013281305915,0
"147.32.84.165",2060,"65.54.188.110",25,6,372,6,372,0,0,14269.822932,9.012747000000672,330.19899482364013,0
"147.32.84.165",2062,"209.191.88.254",25,6,372,6,372,0,0,14273.027769,9.012622000000192,330.2035744980691,0
"147.32.84.165",1756,"61.17.216.17",6667,6,372,6,372,0,0,14275.030562,9.012697000000117,330.200826678181,0
"147.32.84.165",2156,"209.85.225.27",25,6,372,6,372,0,0,14277.13368,9.012547999998787,330.20628572523555,0
"147.32.84.165",2176,"64.12.90.65",25,6,372,6,372,0,0,14279.336778,9.012619999999515,330.20364777391706,0
"147.32.84.165",2189,"208.97.132.73",25,6,372,6,372,0,0,14279.336915,9.012609999999768,330.2040141535112,0
"147.32.84.165",1810,"212.117.174.7",4506,6,372,6,372,0,0,14284.043396,9.012729000000036,330.1996542889494,0
"147.32.84.165",4624,"174.133.57.141",80,17,3489,12,1428,5,2061,14284.04346,8.112867999998343,1408.1333506230267,2032.3269157101245
"147.32.84.165",2204,"218.102.53.139",25,6,372,6,372,0,0,14284.203807,8.954885999999533,332.3325389067103,0
"147.32.84.165",2207,"209.85.225.27",25,6,372,6,372,0,0,14286.947872,9.012742999999318,330.1991413713034,0
"147.32.84.165",2216,"205.188.103.1",25,6,372,6,372,0,0,14286.947952,9.012786999999662,330.1975293546948,0
"147.32.84.165",2220,"161.58.16.34",25,6,372,6,372,0,0,14286.947988,9.012800000000425,330.19705308004836,0
"147.32.84.165",2230,"65.55.37.120",25,6,372,6,372,0,0,14290.454381,9.01132300000063,330.25117399518274,0
"147.32.84.165",2235,"207.115.37.23",25,6,372,6,372,0,0,14290.753155,9.012993999998798,330.189945760576,0
"147.32.84.165",2243,"98.139.175.224",25,6,372,6,372,0,0,14290.853474,9.012651000000915,330.2025120022619,0
"147.32.84.165",2026,"64.12.90.1",25,6,372,6,372,0,0,14294.057768,8.912930999998935,333.896896542827,0
"147.32.84.165",2246,"209.85.143.27",25,6,372,6,372,0,0,14296.060717,8.912618999998813,333.9085851196373,0
"147.32.84.165",2060,"61.17.216.24",6667,4,248,4,248,0,0,14298.164204,2.9035119999989547,683.3104185554301,0
"147.32.84.165",2062,"212.117.174.7",4506,6,372,6,372,0,0,14300.366866,8.91277699999955,333.90266580215683,0
"147.32.84.165",2156,"173.192.170.88",80,24,5712,18,1972,6,3740,14305.073488,9.67299500000081,1630.9323017326772,3093.1474688033536
"147.32.84.165",2176,"174.133.57.141",80,17,3489,12,1428,5,2061,14307.8777,0.838489000001573,13624.50789453239,19663.943116688555
"147.32.84.165",2258,"205.188.103.1",25,6,372,6,372,0,0,14307.877839,9.014874999998938,330.12104993140235,0
"147.32.84.165",2272,"209.85.225.27",25,6,372,6,372,0,0,14308.032159,8.959896000000299,332.1467124171866,0
"147.32.84.165",2275,"205.188.103.1",25,6,372,6,372,0,0,14308.279407,9.01165299999957,330.23908044396984,0
"147.32.84.165",2282,"70.61.177.124",25,6,372,6,372,0,0,14308.279475,9.011711000001014,330.2369550021816,0
"147.32.84.165",2176,"212.117.174.7",4506,6,372,6,372,0,0,14311.382805,9.012817000000723,330.1964302614556,0
"147.32.84.165",2311,"205.188.103.1",25,6,372,6,372,0,0,14311.382937,9.012808999999834,330.1967233522928,0
"147.32.84.165",2312,"201.18.42.58",25,6,372,6,372,0,0,14311.382998,9.012797000001228,330.1971629894243,0
"147.32.84.165",2324,"75.180.132.243",25,6,372,6,372,0,0,14311.683018,9.012960000000021,330.19119135112027,0
"147.32.84.165",2331,"216.32.180.22",25,6,372,6,372,0,0,14311.783156,9.01288999999997,330.19375583192624,0
"147.32.84.165",2335,"205.188.103.1",25,6,372,6,372,0,0,14314.987727,9.016325000000506,330.06796006131464,0
"147.32.84.165",2348,"207.115.37.23",25,6,372,6,372,0,0,14314.987829,9.01634600000034,330.0671912989905,0
"147.32.84.165",2230,"186.110.109.63",6667,9,552,6,372,3,180,14316.992191,1.9436530000002676,1531.1375024243475,740.8729850440391
"147.32.84.165",2358,"167.138.239.79",25,6,372,6,372,0,0,14317.090742,9.013014000000112,330.18921306457116,0
"147.32.84.165",2243,"174.133.57.141",80,17,3489,12,1428,5,2061,14318.936092,4.986274000000776,2291.0894988920027,3306.6774910479116
"147.32.84.165",2361,"205.188.103.1",25,6,372,6,372,0,0,14319.097924,9.0108450000007,330.2686928917065,0
"147.32.84.165",2376,"202.218.102.82",25,6,372,6,372,0,0,14319.097989,9.010903000000326,330.2665670687935,0
"147.32.84.165",2390,"217.16.101.209",25,6,372,6,372,0,0,14321.296849,9.01315699999941,330.18397438324826,0
"147.32.84.165",2243,"212.117.174.7",4506,6,372,6,372,0,0,14328.908174,9.012630999999601,330.20324475728916,0
"147.32.84.165",2397,"205.188.103.1",25,6,372,6,372,0,0,14329.007981,9.014393999999811,330.1386648952844,0
"147.32.84.165",2400,"65.55.92.136",25,6,372,6,372,0,0,14329.308608,9.012909000000946,330.19305975459065,0
"147.32.84.165",2411,"74.6.136.244",25,6,372,6,372,0,0,14332.412765,9.013350000001083,330.1769042586433,0
"147.32.84.165",2420,"124.108.110.37",25,6,372,6,372,0,0,14332.713389,9.013100999998642,330.18602587505103,0
"147.32.84.165",2423,"98.139.175.224",25,6,372,6,372,0,0,14332.813467,9.013150000000678,330.1842308182795,0
"147.32.84.165",2272,"174.133.57.141",80,17,3489,12,1428,5,2061,14336.01899,0.6730369999986578,16973.806789259404,24497.91021895212
"147.32.84.165",2427,"209.85.225.27",25,6,372,6,372,0,0,14336.181204,8.950011999999333,332.5135206522876,0
"147.32.84.165",2312,"212.117.174.7",4506,6,372,6,372,0,0,14338.122917,9.0109709999997,330.2640747595458,0
"147.32.84.165",2428,"205.188.103.1",25,6,372,6,372,0,0,14338.123047,9.010966000001645,330.26425801622787,0
"147.32.84.165",2451,"98.139.175.224",25,6,372,6,372,0,0,14338.123104,9.010958999999275,330.2645145761111,0
"147.32.84.165",2458,"64.12.90.65",25,6,372,6,372,0,0,14338.123163,9.010952000000543,330.2647711362596,0
"147.32.84.165",2331,"92.112.3.72",6667,6,372,6,372,0,0,14340.123963,9.01469999999972,330.1274584844856,0
"147.32.84.165",2461,"74.6.136.244",25,6,372,6,372,0,0,14342.327077,9.013033999999607,330.18848037188474,0
"147.32.84.165",2475,"209.85.225.27",25,6,372,6,372,0,0,14342.327175,9.013063999998849,330.187381338952,0
"147.32.84.165",2476,"65.54.188.94",25,6,372,6,372,0,0,14342.327205,9.013087000001178,330.186538751885,0
"147.32.84.165",2488,"205.188.103.1",25,6,372,6,372,0,0,14349.938267,9.01425399999971,330.1437922650167,0
"147.32.84.165",2489,"94.247.159.134",25,6,372,6,372,0,0,14349.938366,9.014364000000569,330.13976360393394,0
"147.32.84.165",2493,"64.12.90.65",25,6,372,6,372,0,0,14350.038221,9.013291999999637,330.1790289275128,0
"147.32.84.165",2494,"207.115.21.20",25,6,372,6,372,0,0,14350.038332,9.013322000000699,330.1779299574307,0
"147.32.84.165",2497,"74.6.136.65",25,6,372,6,372,0,0,14350.338665,9.013037000000622,330.1883704682223,0
"147.32.84.165",2499,"209.85.229.27",25,6,372,6,372,0,0,14353.44358,9.012324000001172,330.21449295427163,0
"147.32.84.165",2507,"203.99.196.252",25,6,372,6,372,0,0,14353.74391,9.014797000001636,330.12390628424134,0
"147.32.84.165",2515,"209.85.225.27",25,6,372,6,372,0,0,14353.843939,9.01292199999989,330.1925834929046,0
"147.32.84.165",2516,"205.188.190.1",25,6,372,6,372,0,0,14353.844072,9.01291300000048,330.19291321239217,0
"147.32.84.165",2517,"165.21.74.116",25,6,372,6,372,0,0,14357.148338,9.013182999999117,330.1830219136005,0
"147.32.84.165",2518,"205.188.190.1",25,6,372,6,372,0,0,14359.151536,9.013082999999824,330.1866852884921,0
"147.32.84.165",2522,"65.54.188.94",25,6,372,6,372,0,0,14359.151686,9.013058000000456,330.18760114489993,0
"147.32.84.165",2609,"207.115.37.22",25,6,372,6,372,0,0,14359.151762,9.013033999999607,330.18848037188474,0
"147.32.84.165",2427,"79.113.190.202",6667,6,372,6,372,0,0,14361.555375,8.912481999999727,333.9137178622174,0
"147.32.84.165",2312,"212.117.174.7",4506,6,372,6,372,0,0,14363.35755,8.912596000000121,333.90944680988116,0
"147.32.84.165",2476,"64.12.90.1",25,6,372,6,372,0,0,14370.868077,9.013406000000032,330.17485288025296,0
"147.32.84.165",2683,"65.54.188.94",25,6,372,6,372,0,0,14370.969118,9.012463999999454,330.20936338832314,0
"147.32.84.165",2475,"212.117.174.7",4506,6,372,6,372,0,0,14371.268604,9.013478999999279,330.1721788002433,0
"147.32.84.165",2787,"24.113.32.85",25,6,372,6,372,0,0,14371.268738,9.013471000000209,330.17247184796304,0
"147.32.84.165",2815,"209.85.225.27",25,6,372,6,372,0,0,14374.373536,9.012766000001648,330.1982987242159,0
"147.32.84.165",2828,"64.12.90.65",25,6,372,6,372,0,0,14374.673907,9.012673999999606,330.2016693381043,0
"147.32.84.165",2891,"77.238.184.241",25,6,372,6,372,0,0,14374.774015,9.01278099999945,330.1977491742207,0
"147.32.84.165",2901,"98.139.175.224",25,6,372,6,372,0,0,14378.078609,9.013354000000618,330.17675773078435,0
"147.32.84.165",2940,"63.117.255.126",25,6,372,6,372,0,0,14380.081803,9.012534000001324,330.20679866501064,0
"147.32.84.165",2489,"119.154.54.142",6667,6,372,6,372,0,0,14382.584996,9.013568000000305,330.16891867902916,0
"147.32.84.165",2946,"66.175.58.41",25,6,372,6,372,0,0,14384.287418,9.013531000000512,330.17027400247815,0
"147.32.84.165",2312,"212.117.174.7",4506,6,372,6,372,0,0,14391.899035,9.012561999999889,330.2057727869208,0
"147.32.84.165",2499,"217.72.192.149",25,6,372,6,372,0,0,14391.998732,9.013113999999405,330.18554963358906,0
"147.32.84.165",2494,"174.133.57.141",80,17,3489,12,1428,5,2061,14392.299166,2.4250539999993634,4710.822934253422,6799.023856790129
"147.32.84.165",2949,"205.188.190.1",25,6,372,6,372,0,0,14392.458426,8.95385300000089,332.37087988821173,0
"147.32.84.165",2966,"209.85.225.27",25,6,372,6,372,0,0,14395.403675,9.013295000000653,330.1789190301421,0
"147.32.84.165",3003,"74.125.113.27",25,6,372,6,372,0,0,14395.703751,9.0133360000018,330.1774171072071,0
"147.32.84.165",3118,"205.188.103.1",25,6,372,6,372,0,0,14395.804008,9.013320000000022,330.1780032218975,0
"147.32.84.165",2516,"212.117.174.7",4506,6,372,6,372,0,0,14399.109355,9.012289999998757,330.21573873015745,0
"147.32.84.165",3144,"98.139.175.225",25,6,372,6,372,0,0,14399.109487,9.012287999999899,330.21581201133756,0
"147.32.84.165",3154,"65.55.37.88",25,6,372,6,372,0,0,14401.111891,9.012856999999713,330.19496481527386,0
"147.32.84.165",2517,"111.88.77.58",6667,6,372,6,372,0,0,14403.615172,9.01297599999998,330.19060518967393,0
"147.32.84.165",2518,"174.133.57.141",80,17,3489,12,1428,5,2061,14405.317767,8.400276000000304,1359.955315753862,1962.7926510985358
"147.32.84.165",3171,"77.238.184.241",25,6,372,6,372,0,0,14405.471517,8.959264999999505,332.17010547184,0
"147.32.84.165",3217,"98.139.175.224",25,6,372,6,372,0,0,14412.929108,9.012849999999162,330.19522126744334,0
"147.32.84.165",3268,"64.12.139.193",25,6,372,6,372,0,0,14413.028936,9.012908999999127,330.19305975465727,0
"147.32.84.165",3281,"209.191.88.254",25,6,372,6,372,0,0,14413.429348,9.013118000000759,330.18540309799,0
"147.32.84.165",3290,"209.85.143.27",25,6,372,6,372,0,0,14416.434155,9.012863999998444,330.1947083635694,0
"147.32.84.165",3304,"209.85.225.27",25,6,372,6,372,0,0,14416.734318,9.013042999999016,330.18815066125006,0
"147.32.84.165",3318,"216.32.180.22",25,6,372,6,372,0,0,14416.834426,9.012853000000177,330.1951113592934,0
"147.32.84.165",2522,"212.117.174.7",4506,6,372,6,372,0,0,14420.139328,9.01252900000145,330.2069818582022,0
"147.32.84.165",3403,"98.139.175.224",25,6,372,6,372,0,0,14422.14232,9.012753999999404,330.19873836567564,0
"147.32.84.165",3456,"98.139.175.224",25,6,372,6,372,0,0,14422.142413,9.01279600000089,330.1971996259214,0
"147.32.84.165",3477,"64.12.90.65",25,6,372,6,372,0,0,14422.142463,9.012807999999495,330.1967599886924,0
"147.32.84.165",2609,"119.178.199.146",6667,6,372,6,372,0,0,14424.645474,9.01335199999994,330.1768309947309,0
"147.32.84.165",2312,"174.133.57.141",80,16,3429,12,1428,4,2001,14426.448636,0.4907259999999951,23279.79361191401,32621.055334341687
"147.32.84.165",3488,"98.139.175.224",25,6,372,6,372,0,0,14426.606674,8.954474000000118,332.34782969942853,0
"147.32.84.165",2475,"212.117.174.7",4506,6,372,6,372,0,0,14426.606741,8.954534000000422,332.3456027974052,0
"147.32.84.165",3490,"64.12.139.193",25,6,372,6,372,0,0,14426.606804,8.954523000000336,332.3460110605432,0
"147.32.84.165",3519,"80.179.55.150",25,6,372,6,372,0,0,14426.606863,8.954522999998517,332.3460110606107,0
"147.32.84.165",3524,"200.234.222.116",25,6,372,6,372,0,0,14433.958815,8.912814999999682,333.90124220014735,0
"147.32.84.165",3526,"209.85.225.27",25,6,372,6,372,0,0,14434.059586,8.912191000001258,333.9246207806341,0
"147.32.84.165",3547,"65.54.188.126",25,6,372,6,372,0,0,14434.059718,8.912183999998888,333.924883059009,0
"147.32.84.165",3574,"98.139.175.224",25,6,372,6,372,0,0,14434.459554,8.912826000001587,333.90083010702443,0
"147.32.84.165",2499,"174.133.57.141",80,17,3489,12,1428,5,2061,14437.464076,1.2156699999995908,9397.287092717468,13562.891245161556
"147.32.84.165",3575,"64.12.90.65",25,6,372,6,372,0,0,14437.623801,8.853125999999975,336.1524505581428,0
"147.32.84.165",3582,"209.85.225.27",25,6,372,6,372,0,0,14437.623875,8.853183000001081,336.15028628682325,0
"147.32.84.165",3583,"205.188.190.2",25,6,372,6,372,0,0,14437.623985,8.853128999999171,336.1523366484639,0
"147.32.84.165",3637,"64.12.139.193",25,6,372,6,372,0,0,14437.764392,8.912712000001193,333.9051009389288,0
"147.32.84.165",3700,"98.139.175.224",25,6,372,6,372,0,0,14437.864362,8.912945000000036,333.89637207454865,0
"147.32.84.165",3729,"64.12.90.65",25,6,372,6,372,0,0,14437.864499,8.91293399999995,333.89678415659944,0
"147.32.84.165",3740,"209.85.225.27",25,6,372,6,372,0,0,14437.864546,8.912937999999485,333.89663430848185,0
"147.32.84.165",3754,"67.195.168.31",25,6,372,6,372,0,0,14441.069223,9.012762999998813,330.19840863455437,0
"147.32.84.165",3756,"76.96.62.116",25,6,372,6,372,0,0,14443.071997,9.013014000000112,330.18921306457116,0
"147.32.84.165",2518,"85.221.145.247",6667,6,372,6,372,0,0,14445.675619,9.013044000001173,330.1881140266943,0
"147.32.84.165",2787,"212.117.174.7",4506,6,372,6,372,0,0,14447.47862,9.012684999999692,330.2012663263058,0
"147.32.84.165",2891,"174.133.57.141",80,17,3489,12,1428,5,2061,14454.888919,1.8291789999984758,6245.424860010704,9013.879997536456
"147.32.84.165",3775,"66.175.58.41",25,6,372,6,372,0,0,14454.989075,9.012872000001153,330.19441527624264,0
"147.32.84.165",2940,"212.117.174.7",4506,6,372,6,372,0,0,14455.042518,8.959554999999455,332.1593538965028,0
"147.32.84.165",3804,"65.54.188.72",25,6,372,6,372,0,0,14455.042552,8.959570999999414,332.15876072640026,0
"147.32.84.165",3805,"65.55.88.22",25,6,372,6,372,0,0,14455.389981,9.012522999999419,330.2072016903804,0
"147.32.84.165",3829,"207.115.21.20",25,6,372,6,372,0,0,14458.494117,9.013000999999349,330.1896893166011,0
"147.32.84.165",3836,"205.188.190.1",25,6,372,6,372,0,0,14458.694348,9.013014999998632,330.18917642991295,0
"147.32.84.165",3850,"76.96.62.116",25,6,372,6,372,0,0,14458.794574,9.012979000000996,330.1904952845969,0
"147.32.84.165",3864,"65.54.188.110",25,6,372,6,372,0,0,14458.794711,9.012967999999091,330.1908982701703,0
"147.32.84.165",3865,"194.116.198.28",25,6,372,6,372,0,0,14462.099639,9.012690999999904,330.20104650209703,0
"147.32.84.165",3873,"209.85.225.27",25,6,372,6,372,0,0,14464.102796,9.01241100000152,330.2113052766344,0
"147.32.84.165",3003,"117.96.96.152",6667,6,372,6,372,0,0,14466.705878,9.013703999999052,330.16393704522727,0
"147.32.84.165",3118,"174.133.57.141",80,17,3489,12,1428,5,2061,14468.508834,8.113002000000051,1408.1100929101124,2032.2933483807715
"147.32.84.165",3891,"205.188.103.1",25,6,372,6,372,0,0,14468.674011,8.947614000000613,332.6026357417515,0
"147.32.84.165",2499,"212.117.174.7",4506,6,372,6,372,0,0,14476.019217,9.01317200000085,330.18342488079884,0
"147.32.84.165",3893,"118.23.109.73",25,6,372,6,372,0,0,14476.019362,9.013151000001017,330.1841941846602,0
"147.32.84.165",3899,"205.188.103.1",25,6,372,6,372,0,0,14476.422183,9.01054699999986,330.27961565485936,0
"147.32.84.165",3906,"98.139.175.224",25,6,372,6,372,0,0,14476.422318,9.010495999998966,330.28148505923997,0
"147.32.84.165",3907,"209.85.143.27",25,6,372,6,372,0,0,14479.524388,9.013048000000708,330.1879674888857,0
"147.32.84.165",3930,"213.153.32.222",25,6,372,6,372,0,0,14479.724613,9.013218000000052,330.1817397515497,0
"147.32.84.165",3937,"209.85.225.27",25,6,372,6,372,0,0,14479.825521,9.012413999998898,330.21119535791007,0
"147.32.84.165",3943,"64.12.90.65",25,6,372,6,372,0,0,14479.825669,9.01240499999949,330.21152511456916,0
"147.32.84.165",3171,"212.117.174.7",4506,6,372,6,372,0,0,14483.12956,9.012878999999884,330.19415882539175,0
"147.32.84.165",3955,"98.139.175.224",25,6,372,6,372,0,0,14483.129693,9.012918999998874,330.1926933993717,0
"147.32.84.165",3975,"205.188.103.1",25,6,372,6,372,0,0,14483.129748,9.012959000001501,330.1912279862256,0
"147.32.84.165",3981,"209.85.143.27",25,6,372,6,372,0,0,14483.129802,9.012974000001122,330.19067845969926,0
"147.32.84.165",4006,"195.229.241.254",25,6,372,6,372,0,0,14483.129859,9.012987999998586,330.19016557000487,0
"147.32.84.165",4029,"65.55.88.22",25,6,372,6,372,0,0,14485.132539,9.012907000000268,330.19313302577194,0
"147.32.84.165",3281,"115.184.216.90",6667,6,372,6,372,0,0,14487.736238,9.012909000000946,330.19305975459065,0
"147.32.84.165",3268,"174.133.57.141",80,17,3489,12,1428,5,2061,14489.639128,1.1700679999994463,9763.535110784507,14091.488699808731
"147.32.84.165",4043,"67.195.168.31",25,6,372,6,372,0,0,14489.792874,8.959242999999333,332.1709211370003,0
"147.32.84.165",3477,"212.117.171.138",65500,24,1473,18,1092,6,381,14497.049508,36.17996400000084,241.45961007589167,84.24552329570946
"147.32.84.165",4079,"74.6.136.244",25,6,372,6,372,0,0,14497.049672,9.01277200000004,330.1980789040249,0
"147.32.84.165",4111,"64.12.90.65",25,6,372,6,372,0,0,14497.04975,9.012818999999581,330.19635698887754,0
"147.32.84.165",4113,"124.108.110.37",25,6,372,6,372,0,0,14497.04982,9.012801999999283,330.1969798071939,0
"147.32.84.165",4121,"209.85.225.27",25,6,372,6,372,0,0,14497.454658,9.008366000000024,330.3595790845967,0
"147.32.84.165",3575,"174.133.57.141",80,17,2011,12,1428,5,583,14500.554794,202.0417809999999,56.542760331339615,23.08433422490966
"147.32.84.165",4128,"64.12.90.65",25,6,372,6,372,0,0,14500.713708,8.853888999999981,336.1234820088671,0
"147.32.84.165",4134,"128.119.103.10",25,6,372,6,372,0,0,14500.713745,8.853954000000158,336.1210144077942,0
"147.32.84.165",4137,"98.139.175.224",25,6,372,6,372,0,0,14500.754953,8.912788999999975,333.90221624230173,0
"147.32.84.165",4149,"209.85.143.27",25,6,372,6,372,0,0,14500.855651,8.912500000000364,333.91304347824723,0
"147.32.84.165",3583,"212.117.174.7",4506,6,372,6,372,0,0,14504.159711,8.913586999999097,333.872323229728,0
"147.32.84.165",4153,"207.115.36.20",25,6,372,6,372,0,0,14506.162607,8.914484999999331,333.83869062545097,0
"147.32.84.165",4155,"64.12.139.193",25,6,372,6,372,0,0,14508.768575,8.910875999999917,333.97389886247186,0
"147.32.84.165",3268,"212.117.174.7",4506,6,372,6,372,0,0,14510.66911,9.012863999998444,330.1947083635694,0
"147.32.84.165",3756,"212.117.171.138",65500,24,1467,18,1092,6,375,14510.669244,121.62783099999979,71.82566628192207,24.665407377033677
"147.32.84.165",4214,"74.6.136.244",25,6,372,6,372,0,0,14510.6693,9.012797999999748,330.197126353002,0
"147.32.84.165",3003,"95.59.69.146",6667,9,552,6,372,3,180,14510.669356,1.5047429999995074,1977.7463659913847,956.9740480603474
"147.32.84.165",4230,"209.85.225.27",25,6,372,6,372,0,0,14512.174294,9.010043999998743,330.29805403840595,0
"147.32.84.165",3171,"206.46.232.11",25,6,372,6,372,0,0,14512.174357,9.010107000000062,330.2957445455398,0
"147.32.84.165",4231,"64.12.90.65",25,6,372,6,372,0,0,14517.980267,9.012567999998282,330.2055529567785,0
"147.32.84.165",4242,"61.8.0.80",25,6,372,6,372,0,0,14517.980407,9.01255300000048,330.20610253274975,0
"147.32.84.165",4254,"195.75.94.111",25,6,372,6,372,0,0,14518.380238,9.01314000000093,330.18459715478656,0
"147.32.84.165",4270,"98.139.175.224",25,6,372,6,372,0,0,14521.584726,9.013176000000385,330.1832783471523,0
"147.32.84.165",4275,"205.188.103.1",25,6,372,6,372,0,0,14521.584829,9.013198000000557,330.1824724143213,0
"147.32.84.165",4302,"209.85.225.27",25,6,372,6,372,0,0,14521.688807,9.0092939999995,330.3255504815544,0
"147.32.84.165",4318,"216.32.181.178",25,6,372,6,372,0,0,14521.785553,9.012630000001081,330.20328139506927,0
"147.32.84.165",3893,"180.177.137.11",6667,9,552,6,372,3,180,14525.089855,1.9458410000006552,1529.415815577428,740.0399107632716
"147.32.84.165",4321,"67.231.152.184",25,6,372,6,372,0,0,14527.035959,8.969610999998622,331.7869637825383,0
"147.32.84.165",4322,"98.139.175.224",25,6,372,6,372,0,0,14527.09294,9.012747999999192,330.19895818681124,0
"147.32.84.165",4323,"65.55.92.184",25,6,372,6,372,0,0,14529.69651,9.012862999999925,330.1947449994552,0
"147.32.84.165",3975,"212.117.174.7",4506,6,372,6,372,0,0,14533.206108,9.008276000000478,330.3628796453219,0
"147.32.84.165",4326,"206.186.120.17",25,6,372,6,372,0,0,14539.009797,9.013005999999223,330.1895061425962,0
"147.32.84.165",3583,"212.117.174.7",4506,6,372,6,372,0,0,14539.009945,9.012983000000531,330.19034874467474,0
"147.32.84.165",3754,"190.55.176.74",6667,6,372,6,372,0,0,14539.010006,9.012973999999303,330.1906784597659,0
"147.32.84.165",4337,"205.188.190.1",25,6,372,6,372,0,0,14539.410608,9.012699999999313,330.200716766366,0
"147.32.84.165",4079,"174.133.57.141",80,17,3489,12,1428,5,2061,14542.615187,5.760903000000326,1983.0224532507063,2862.0513138303263
"147.32.84.165",4353,"66.94.237.139",25,6,372,6,372,0,0,14542.61532,9.013044999999693,330.1880773922799,0
"147.32.84.165",4354,"209.85.225.27",25,6,372,6,372,0,0,14542.715463,9.01296899999943,330.1908616350714,0
"147.32.84.165",4358,"124.108.110.37",25,6,372,6,372,0,0,14542.815597,9.013214999999036,330.1818496507981,0
"147.32.84.165",4399,"98.139.175.224",25,6,372,6,372,0,0,14548.023042,9.012914999999339,330.19283994137504,0
"147.32.84.165",4409,"205.188.190.1",25,6,372,6,372,0,0,14548.023102,9.012979000000996,330.1904952845969,0
"147.32.84.165",4415,"209.85.225.27",25,6,372,6,372,0,0,14548.023155,9.012973999999303,330.1906784597659,0
"147.32.84.165",4434,"98.139.175.224",25,6,372,6,372,0,0,14548.023213,9.012971000000107,330.1907883648982,0
"147.32.84.165",4445,"124.108.110.37",25,6,372,6,372,0,0,14548.023267,9.012969999999768,330.19082499998075,0
"147.32.84.165",4450,"203.188.197.119",25,6,372,6,372,0,0,14548.023325,9.012963999999556,330.19104481058025,0
"147.32.84.165",4458,"195.226.16.146",25,6,372,6,372,0,0,14548.122954,9.013397999999142,330.17514593278617,0
"147.32.84.165",4134,"67.195.168.31",25,6,372,6,372,0,0,14550.726829,9.01319599999988,330.18254568080397,0
"147.32.84.165",4460,"205.188.190.1",25,6,372,6,372,0,0,14554.23252,9.01316399999996,330.1837179485487,0
"147.32.84.165",4461,"209.85.225.27",25,6,372,6,372,0,0,14554.232653,9.01318000000174,330.1831318135692,0
"147.32.84.165",4462,"98.139.175.224",25,6,372,6,372,0,0,14554.232711,9.01321999999891,330.1816664854913,0
"147.32.84.165",3754,"99.236.68.164",6667,6,372,6,372,0,0,14559.840355,9.01227900000049,330.21614177721733,0
"147.32.84.165",4079,"212.117.174.7",4506,6,372,6,372,0,0,14560.040233,9.013006000001042,330.1895061425296,0
"147.32.84.165",3975,"174.133.57.141",80,17,2011,12,1428,5,583,14560.440901,280.8327960000006,40.679009584051485,16.60774691001542
"147.32.84.165",4464,"195.131.52.142",25,6,372,6,372,0,0,14560.44102,9.013028999999733,330.18866354475153,0
"147.32.84.165",4474,"209.85.143.27",25,6,372,6,372,0,0,14563.645537,9.013034999999945,330.1884437373225,0
"147.32.84.165",4475,"205.188.190.1",25,6,372,6,372,0,0,14563.745572,9.013048000000708,330.1879674888857,0
"147.32.84.165",4478,"67.231.144.94",25,6,372,6,372,0,0,14563.845664,9.012946999999258,330.191667608857,0
"147.32.84.165",4302,"212.117.174.7",4506,6,372,6,372,0,0,14569.053384,9.012800999998944,330.1970164436504,0
"147.32.84.165",4486,"209.85.225.27",25,6,372,6,372,0,0,14569.053442,9.01287400000001,330.19434200455885,0
"147.32.84.165",4493,"98.139.175.224",25,6,372,6,372,0,0,14569.153156,9.01317299999937,330.183388247425,0
"147.32.84.165",4507,"62.211.72.32",25,6,372,6,372,0,0,14569.153288,9.013134000000719,330.18481695709426,0
"147.32.84.165",4531,"74.125.113.27",25,6,372,6,372,0,0,14571.757104,8.91316199999892,333.88824302759906,0
"147.32.84.165",3754,"65.54.188.72",25,6,372,6,372,0,0,14575.262433,8.914612000000488,333.83393466814226,0
"147.32.84.165",4532,"205.188.103.1",25,6,372,6,372,0,0,14580.870024,9.012993000000279,330.18998239540497,0
"147.32.84.165",4354,"60.243.195.59",6667,6,372,6,372,0,0,14580.970495,9.012650000000576,330.20254863994603,0
"147.32.84.165",4539,"205.188.103.2",25,6,372,6,372,0,0,14581.374385,9.00920700000097,330.3287403652374,0
"147.32.84.165",4540,"64.12.90.65",25,6,372,6,372,0,0,14584.575594,9.012855000000854,330.195038087234,0
"147.32.84.165",4541,"66.94.237.64",25,6,372,6,372,0,0,14584.675547,9.01285899999857,330.1948915433462,0
"147.32.84.165",4547,"98.139.175.224",25,6,372,6,372,0,0,14584.775828,9.013286999999764,330.17921208989327,0
"147.32.84.165",4434,"212.117.174.7",4506,6,372,6,372,0,0,14589.983285,9.01275700000042,330.1986284551843,0
"147.32.84.165",4548,"209.85.225.27",25,6,372,6,372,0,0,14590.083182,9.013046000000031,330.188040757807,0
"147.32.84.165",4553,"209.85.143.27",25,6,372,6,372,0,0,14592.687102,9.012931999999637,330.19221713867586,0
"147.32.84.165",4461,"212.117.174.7",4506,6,372,6,372,0,0,14596.192031,9.013090999998894,330.1863922155413,0
"147.32.84.165",4557,"65.55.37.72",25,6,372,6,372,0,0,14596.192168,9.013087999999698,330.18650211782017,0
"147.32.84.165",3754,"173.192.170.88",80,6,372,6,372,0,0,14601.900274,9.012974999999642,330.19064182471584,0
"147.32.84.165",4507,"61.17.216.86",6667,15,1794,10,1236,5,558,14601.900415,1.078287000000273,9170.100353614107,4139.899674204427
"147.32.84.165",4478,"173.192.170.88",80,28,7016,20,1650,8,5366,14602.101589,37.83483200000046,348.8848582702796,1134.615848168679
"147.32.84.165",4486,"173.192.170.88",80,28,5792,20,1650,8,4142,14602.101658,37.78404799999953,349.3537801984627,876.9838530800197
"147.32.84.165",4354,"173.192.170.88",80,31,6645,24,3658,7,2987,14602.10171,127.95004699999845,228.71425752583235,186.76038469919663
"147.32.84.165",4475,"174.133.57.141",80,16,3429,12,1428,4,2001,14602.10177,0.46598900000026333,24515.600153637843,34352.74223209336
"147.32.84.165",4563,"75.180.132.243",25,6,372,6,372,0,0,14602.10183,9.011798999999883,330.23373024631803,0
"147.32.84.165",4576,"205.188.190.1",25,6,372,6,372,0,0,14602.400898,9.013037000000622,330.1883704682223,0
"147.32.84.165",4578,"76.96.62.116",25,6,372,6,372,0,0,14605.605645,9.013129000000845,330.18500012589647,0
"147.32.84.165",4583,"205.188.103.1",25,6,372,6,372,0,0,14605.705784,9.012941999999384,330.19185078526004,0
"147.32.84.165",4589,"209.85.225.27",25,6,372,6,372,0,0,14605.805856,9.012998999998672,330.1897625862866,0
"147.32.84.165",4592,"68.6.19.3",25,6,372,6,372,0,0,14605.806004,9.01312599999983,330.1851100273153,0
"147.32.84.165",4597,"213.4.149.253",25,6,372,6,372,0,0,14611.013447,9.012903000000733,330.19327956816556,0
"147.32.84.165",4600,"64.136.52.37",25,6,372,6,372,0,0,14611.113725,9.01270199999999,330.2006434918189,0
"147.32.84.165",4548,"174.133.57.141",80,16,3429,12,1428,4,2001,14613.717377,0.48235699999895587,23683.703149378423,33187.03781646094
"147.32.84.165",4604,"205.188.103.1",25,6,372,6,372,0,0,14613.717517,9.012668000001213,330.20188916307575,0
"147.32.84.165",4606,"65.55.37.120",25,6,372,6,372,0,0,14613.717586,9.01273399999991,330.19947110388813,0
"147.32.84.165",4553,"212.117.174.7",4506,6,372,6,372,0,0,14617.223054,9.01208299999962,330.2233235091294,0
"147.32.84.165",4557,"208.73.210.29",80,72,39568,44,6790,28,32778,14622.930479,14.895581999999195,3646.71887275052,17604.14598100391
"147.32.84.165",4608,"209.85.225.27",25,6,372,6,372,0,0,14623.109255,8.934552000000622,333.08888906794573,0
"147.32.84.165",3754,"173.192.170.88",80,6,372,6,372,0,0,14623.131068,9.013331000000107,330.17760026786596,0
"147.32.84.165",4461,"208.73.210.29",80,70,39815,42,6998,28,32817,14623.431928,14.340828000000329,3903.8192215957624,18306.892740084044
"147.32.84.165",4620,"205.188.190.1",25,6,372,6,372,0,0,14623.432062,9.01242000000093,330.21097552041437,0
"147.32.84.165",4563,"74.125.232.217",80,13,2944,10,2070,3,874,14626.636377,11.18989799999872,1479.906251156346,624.8493060437905
"147.32.84.165",4576,"174.133.57.141",80,17,3489,12,1428,5,2061,14626.64452,2.2217639999998937,5141.860251584122,7421.130237055236
"147.32.84.165",4621,"98.139.175.224",25,6,372,6,372,0,0,14626.644553,9.004221999999572,330.5116199933921,0
"147.32.84.165",4622,"205.188.190.1",25,6,372,6,372,0,0,14626.73632,9.0129450000004,330.19174087935386,0
"147.32.84.165",4632,"203.188.197.119",25,6,372,6,372,0,0,14626.736432,9.012908000000607,330.19309639017723,0
"147.32.84.165",4637,"209.85.225.27",25,6,372,6,372,0,0,14626.836352,9.012806000000637,330.1968332614493,0
"147.32.84.165",4655,"208.65.144.2",25,6,372,6,372,0,0,14626.836457,9.01283599999988,330.1957341729107,0
"147.32.84.165",4583,"212.117.174.7",4506,6,372,6,372,0,0,14632.043942,9.013103999999657,330.18591597302253,0
"147.32.84.165",4578,"94.127.76.180",80,25,8904,18,6426,7,2478,14632.044009,5.782450000000608,8890.349246425752,3428.3046113667933
"147.32.84.165",4663,"209.85.143.27",25,6,372,6,372,0,0,14632.057825,8.999331000000893,330.69124804940554,0
"147.32.84.165",4576,"212.117.171.138",65500,340,332938,252,326282,88,6656,14632.1445,151.26239700000042,17256.476505525643,352.02403939162656
"147.32.84.165",4597,"94.127.76.180",80,13,2261,10,1670,3,591,14632.144528,5.682111999998597,2351.23841275978,832.0849712221736
"147.32.84.165",4666,"98.139.175.224",25,6,372,6,372,0,0,14632.144551,9.012536000000182,330.2067253878309,0
"147.32.84.165",4667,"64.12.90.65",25,6,372,6,372,0,0,14632.144576,9.012619999999515,330.20364777391706,0
"147.32.84.165",4600,"178.122.247.101",6667,6,372,6,372,0,0,14634.74774,9.012934999998834,330.1921072325924,0
"147.32.84.165",4668,"205.188.190.1",25,6,372,6,372,0,0,14638.252453,9.013166000000638,330.1836446815458,0
"147.32.84.165",4669,"203.188.197.119",25,6,372,6,372,0,0,14638.252585,9.01314099999945,330.18456052115255,0
"147.32.84.165",4671,"209.85.225.27",25,6,372,6,372,0,0,14638.252641,9.01313300000038,330.1848535908518,0
"147.32.84.165",4672,"98.139.175.224",25,6,372,6,372,0,0,14638.252697,9.013113000000885,330.18558626744255,0
"147.32.84.165",4673,"205.188.103.1",25,6,372,6,372,0,0,14638.252756,9.013089000000036,330.18646548369685,0
"147.32.84.165",4557,"173.192.170.88",80,29,3089,22,2408,7,681,14644.060969,79.853466999999,241.2418736934771,68.22496511015693
"147.32.84.165",4486,"217.72.192.149",25,6,372,6,372,0,0,14644.061103,8.912544000000707,333.9113949956111,0
"147.32.84.165",4553,"173.192.170.88",80,6,372,6,372,0,0,14644.161104,8.913595999998506,333.8719861210334,0
"147.32.84.165",4606,"174.133.57.141",80,17,3489,12,1428,5,2061,14644.461501,5.827777000000424,1960.267182495001,2829.209147844676
"147.32.84.165",4676,"205.188.190.1",25,6,372,6,372,0,0,14644.4616,8.913185999999769,333.88734398677167,0
"147.32.84.165",4620,"173.192.170.88",80,6,372,6,372,0,0,14647.66603,8.913164999999935,333.88813064719676,0
"147.32.84.165",4608,"173.192.170.88",80,6,372,6,372,0,0,14647.666114,8.91314500000044,333.888879851035,0
"147.32.84.165",4677,"209.85.143.27",25,6,372,6,372,0,0,14647.666161,8.913124000000607,333.8896665186973,0
"147.32.84.165",4678,"204.127.217.16",25,6,372,6,372,0,0,14647.66621,8.913099999999758,333.89056557203224,0
"147.32.84.165",4679,"195.110.128.233",25,6,372,6,372,0,0,14647.768274,8.91133500000069,333.95669672386566,0
"147.32.84.165",4680,"99.178.165.1",25,6,372,6,372,0,0,14647.866701,8.912489999998797,333.91341813571756,0
"147.32.84.165",4681,"209.85.225.27",25,6,372,6,372,0,0,14652.973747,9.0132420000009,330.18086056046235,0
"147.32.84.165",4687,"98.139.175.224",25,6,372,6,372,0,0,14653.074831,9.012192000000141,330.2193295482335,0
"147.32.84.165",3575,"195.70.198.9",6667,6,372,6,372,0,0,14655.377506,9.012790999999197,330.197382808529,0
"147.32.84.165",4655,"212.117.174.7",4506,6,372,6,372,0,0,14659.182679,9.01275700000042,330.1986284551843,0
"147.32.84.165",4663,"174.133.57.141",80,17,3489,12,1428,5,2061,14664.991249,4.501529999999548,2537.803813370376,3662.754663414807
"147.32.84.165",4691,"74.125.113.27",25,6,372,6,372,0,0,14664.991384,9.012871999999334,330.19441527630926,0
"147.32.84.165",4667,"212.117.174.7",4506,6,372,6,372,0,0,14665.091215,9.013017999999647,330.1890665257871,0
"147.32.84.165",4694,"205.188.103.1",25,6,372,6,372,0,0,14665.091347,9.013027000000875,330.1887368139151,0
"147.32.84.165",4671,"173.192.170.88",80,20,3368,18,3248,2,120,14665.391582,189.43584499999997,137.1651706148855,5.067678717298725
"147.32.84.165",4696,"77.238.184.241",25,6,372,6,372,0,0,14668.596643,9.01262399999905,330.2035012223203,0
"147.32.84.165",4697,"64.12.90.65",25,6,372,6,372,0,0,14668.598835,9.010567999999694,330.27884590628486,0
"147.32.84.165",4486,"173.192.170.88",80,19,5451,14,1728,5,3723,14668.696729,4.996657000001505,2766.649782043441,5960.785381104011
"147.32.84.165",4553,"173.192.170.88",80,20,5505,14,1728,6,3777,14668.696813,4.974827000000005,2778.7900966204425,6073.77904799503
"147.32.84.165",4698,"68.6.19.3",25,6,372,6,372,0,0,14668.696851,9.012409999999363,330.2113419163365,0
"147.32.84.165",4699,"98.139.175.225",25,6,372,6,372,0,0,14668.796832,9.012727999999697,330.19969092599933,0
"147.32.84.165",4608,"67.195.168.31",25,6,372,6,372,0,0,14674.004393,9.0131790000014,330.1831684469528,0
"147.32.84.165",4700,"209.85.225.27",25,6,372,6,372,0,0,14674.104436,9.014170000000377,330.1468687632778,0
"147.32.84.165",4678,"1.23.71.127",6667,6,372,6,372,0,0,14676.407905,9.012478999999075,330.20881380143084,0
"147.32.84.165",4553,"174.133.57.141",80,17,3489,12,1428,5,2061,14680.213187,6.223570000000109,1835.6023954096765,2649.2832891732096
"147.32.84.165",4701,"74.125.113.27",25,6,372,6,372,0,0,14680.213329,9.012644000000364,330.20276846615485,0
"147.32.84.165",4702,"65.54.188.72",25,6,372,6,372,0,0,14680.213393,9.012658999999985,330.20221890121496,0
"147.32.84.165",4703,"74.208.5.3",25,6,372,6,372,0,0,14686.021182,9.013132000000041,330.1848902246174,0
"147.32.84.165",4704,"65.54.188.72",25,6,372,6,372,0,0,14686.121303,9.01312599999983,330.1851100273153,0
"147.32.84.165",4705,"205.188.190.1",25,6,372,6,372,0,0,14686.121441,9.013055000001259,330.18771104798367,0
"147.32.84.165",4706,"130.68.1.48",25,6,372,6,372,0,0,14689.62659,9.012668999999732,330.2018525256046,0
"147.32.84.165",4707,"205.188.103.1",25,6,372,6,372,0,0,14689.626732,9.012654000000111,330.202402089325,0
"147.32.84.165",4708,"98.139.175.224",25,6,372,6,372,0,0,14689.726725,9.014083000000028,330.1500551969613,0
"147.32.84.165",4712,"68.6.19.3",25,6,372,6,372,0,0,14689.826791,9.013216999999713,330.18177638462436,0
"147.32.84.165",4691,"212.117.174.7",4506,6,372,6,372,0,0,14695.034461,9.013166000000638,330.1836446815458,0
"147.32.84.165",4667,"212.117.174.7",4506,6,372,6,372,0,0,14695.134532,9.013263999999253,330.1800546395009,0
"147.32.84.165",4697,"65.54.188.72",25,6,372,6,372,0,0,14695.134566,9.013326000000234,330.17778342866137,0
"147.32.84.165",4713,"209.85.225.27",25,6,372,6,372,0,0,14695.134594,9.013324999999895,330.1778200608582,0
"147.32.84.165",4699,"178.124.94.49",6667,9,552,6,372,3,180,14697.437917,1.0690970000014204,2783.657610110258,1346.9311016662537
"147.32.84.165",4539,"174.133.57.141",80,17,3483,12,1428,5,2055,14698.507258,0.4688640000003943,24365.274365253874,35063.47256344308
"147.32.84.165",4714,"205.188.190.1",25,6,372,6,372,0,0,14698.50732,8.94503099999929,332.6986793002994,0
"147.32.84.165",4715,"98.139.175.224",25,6,372,6,372,0,0,14698.507378,8.945098000000144,332.69618734193324,0
"147.32.84.165",4716,"205.188.190.1",25,6,372,6,372,0,0,14698.507437,8.945095999999467,332.6962617282338,0
"147.32.84.165",4717,"98.139.175.224",25,6,372,6,372,0,0,14698.507494,8.945090000001073,332.6964848871999,0
"147.32.84.165",4718,"68.6.19.3",25,6,372,6,372,0,0,14698.507547,8.945089000000735,332.69652208041254,0
"147.32.84.165",4719,"209.85.225.27",25,6,372,6,372,0,0,14698.507606,8.945083000000523,332.6967452397956,0
"147.32.84.165",4722,"205.188.190.1",25,6,372,6,372,0,0,14698.507661,8.945082000000184,332.69678243306646,0
"147.32.84.165",4723,"98.139.175.224",25,6,372,6,372,0,0,14698.507717,8.94507700000031,332.6969683994779,0
"147.32.84.165",4727,"205.188.190.1",25,6,372,6,372,0,0,14698.507773,8.94506900000124,332.69726594614167,0
"147.32.84.165",4728,"98.129.185.3",25,6,372,6,372,0,0,14698.507834,8.945057999999335,332.69767507379174,0
"147.32.84.165",4731,"165.21.74.117",25,6,372,6,372,0,0,14701.242993,9.009721000000354,330.30989527865324,0
"147.32.84.165",4699,"98.126.71.122",80,15,4793,12,1420,3,3373,14707.051716,14.463306999999986,785.4358619366934,1865.686734022864
"147.32.84.165",4734,"209.85.225.27",25,6,372,6,372,0,0,14707.152062,8.920336000001043,333.619720154,0
"147.32.84.165",4735,"205.188.190.1",25,6,372,6,372,0,0,14707.152198,8.920264000000316,333.6224129689317,0
"147.32.84.165",4736,"205.188.190.1",25,6,372,6,372,0,0,14707.226404,8.846086000001378,336.41997149920724,0
"147.32.84.165",4737,"216.40.42.4",25,6,372,6,372,0,0,14707.226469,8.846049000001585,336.4213786289751,0
"147.32.84.165",4703,"195.113.232.98",80,17,5963,12,2768,5,3195,14710.654253,10.860889999999927,2038.875267128214,2353.39829424662
"147.32.84.165",4704,"182.177.235.90",6667,4,248,4,248,0,0,14710.654355,2.90936899999906,681.9348112943532,0
"147.32.84.165",4540,"208.73.210.29",80,72,39252,44,6632,28,32620,14710.654391,16.97946199999933,3124.7162012554986,15369.155983859224
"147.32.84.165",4705,"174.133.57.141",80,17,3489,12,1428,5,2061,14710.754291,0.7803730000014184,14639.153327933227,21128.357849349006
"147.32.84.165",4738,"209.85.143.27",25,6,372,6,372,0,0,14710.836029,8.84720500000003,336.3774208916816,0
"147.32.84.165",4739,"207.115.37.23",25,6,372,6,372,0,0,14710.854758,8.92924800000037,333.2867448636074,0
"147.32.84.165",4742,"74.125.113.27",25,6,372,6,372,0,0,14710.914278,8.869853000000148,335.5185255043066,0
"147.32.84.165",4705,"74.125.232.217",80,13,2934,10,2060,3,874,14715.9714,11.66265199999907,1413.0576819064236,599.5205893136962
"147.32.84.165",4743,"98.139.175.224",25,6,372,6,372,0,0,14715.979506,9.036213000001226,329.3415062260702,0
"147.32.84.165",4708,"94.127.76.180",80,16,3883,12,2820,4,1063,14716.072562,11.561388000000079,1951.322799649994,735.5518212865048
"147.32.84.165",4744,"205.188.190.1",25,6,372,6,372,0,0,14716.086891,9.023033999999825,329.82254084380685,0
"147.32.84.165",4745,"209.85.225.27",25,6,372,6,372,0,0,14716.086926,9.023133000000598,329.8189220972142,0
"147.32.84.165",4712,"67.214.158.5",80,15,2547,10,1698,5,849,14719.382545,0.3147759999992559,43154.497166340865,21577.248583170433
"147.32.84.165",4746,"205.188.190.1",25,6,372,6,372,0,0,14719.485959,9.02884400000039,329.61030227123996,0
"147.32.84.165",4667,"50.22.198.84",80,13,3344,10,2316,3,1028,14719.48604,0.36707899999964866,50474.148616558654,22403.89670890427
"147.32.84.165",4747,"65.254.254.55",25,6,372,6,372,0,0,14719.60696,9.007956000001286,330.3746155065117,0
"147.32.84.165",4716,"212.117.174.7",4506,6,372,6,372,0,0,14722.205662,9.013648000000103,330.1659882879791,0
"147.32.84.165",4722,"173.192.170.88",80,24,2431,18,1812,6,619,14728.114151,84.36284800000067,171.82919192106797,58.69882439246196
"147.32.84.165",4717,"212.117.174.7",4506,6,372,6,372,0,0,14728.114224,9.013127999998687,330.18503675976126,0
"147.32.84.165",4718,"174.133.57.141",80,17,3489,12,1428,5,2061,14728.114257,6.676846000000296,1710.9874931965621,2469.4294282059627
"147.32.84.165",4750,"204.127.217.16",25,6,372,6,372,0,0,14728.114292,9.013183999999455,330.18298528024945,0
"147.32.84.165",4751,"98.139.175.224",25,6,372,6,372,0,0,14728.272871,8.954698999999891,332.33947897076564,0
"147.32.84.165",4753,"205.188.190.1",25,6,372,6,372,0,0,14728.272905,8.954756000000998,332.33736351941565,0
"147.32.84.165",4540,"42.201.161.145",6667,6,372,6,372,0,0,14730.718503,9.012478999999075,330.20881380143084,0
"147.32.84.165",4557,"173.192.170.88",80,6,372,6,372,0,0,14731.719232,9.0132420000009,330.18086056046235,0
"147.32.84.165",4754,"205.188.190.1",25,6,372,6,372,0,0,14731.719365,9.013249999999971,330.1805674978514,0
"147.32.84.165",4755,"209.85.225.27",25,6,372,6,372,0,0,14731.719421,9.013246000000436,330.18071402909186,0
"147.32.84.165",4756,"74.125.43.27",25,6,372,6,372,0,0,14731.719481,9.013236999999208,330.1810437249416,0
"147.32.84.165",4757,"216.159.168.184",25,6,372,6,372,0,0,14731.81943,9.01332800000091,330.1777101642922,0
"147.32.84.165",4759,"98.139.175.224",25,6,372,6,372,0,0,14731.819574,9.013308000001416,330.17844280918086,0
"147.32.84.165",4760,"209.85.143.27",25,6,372,6,372,0,0,14731.819639,9.013317000000825,330.1781131185919,0
"147.32.84.165",4761,"204.127.217.16",25,6,372,6,372,0,0,14737.027619,9.012303999999858,330.21522576247395,0
"147.32.84.165",4762,"202.179.178.24",25,6,372,6,372,0,0,14737.027716,9.01234199999999,330.213833429757,0
"147.32.84.165",4763,"205.188.190.1",25,6,372,6,372,0,0,14737.127539,9.012531000000308,330.20690858094116,0
"147.32.84.165",4766,"209.85.225.27",25,6,372,6,372,0,0,14737.127595,9.012597999999343,330.2044538101241,0
"147.32.84.165",4768,"195.156.147.12",25,6,372,6,372,0,0,14740.632377,9.012709000000541,330.20038703122685,0
"147.32.84.165",4705,"74.125.127.27",25,6,372,6,372,0,0,14743.236223,9.01314000000093,330.18459715478656,0
"147.32.84.165",4712,"174.133.57.141",80,17,3489,12,1428,5,2061,14749.144555,0.9799219999986235,11658.070744422563,16825.828994576263
"147.32.84.165",4769,"195.244.170.253",25,6,372,6,372,0,0,14749.244566,9.013177000000724,330.18324171374434,0
"147.32.84.165",4734,"212.117.174.7",4506,6,372,6,372,0,0,14749.299819,8.958044999999402,332.2153438613223,0
"147.32.84.165",4736,"46.24.73.184",6667,6,372,6,372,0,0,14752.348963,9.012909999999465,330.1930231190788,0
"147.32.84.165",4770,"209.85.143.27",25,6,372,6,372,0,0,14752.753632,9.012781999999788,330.1977125376016,0
"147.32.84.165",4771,"77.238.184.241",25,6,372,6,372,0,0,14752.753766,9.012788,330.1974927181245,0
"147.32.84.165",4354,"173.192.170.88",80,6,372,6,372,0,0,14752.849811,9.015328999999838,330.10442547355217,0
"147.32.84.165",4774,"65.55.92.168",25,6,372,6,372,0,0,14752.849943,9.015320000000429,330.1047550169998,0
"147.32.84.165",4775,"205.188.103.1",25,6,372,6,372,0,0,14752.850008,9.01531100000102,330.10508456110534,0
"147.32.84.165",4712,"212.117.174.7",4506,6,372,6,372,0,0,14758.058594,8.91131200000018,333.9575586625112,0
"147.32.84.165",4776,"66.175.58.41",25,6,372,6,372,0,0,14758.058727,8.91130400000111,333.9578584682589,0
"147.32.84.165",4777,"205.188.190.1",25,6,372,6,372,0,0,14758.157479,8.916428000000451,333.76594304354273,0
"147.32.84.165",4778,"209.85.225.27",25,6,372,6,372,0,0,14761.662383,8.913045999999667,333.8925884596704,0
"147.32.84.165",4779,"98.139.175.224",25,6,372,6,372,0,0,14764.266572,8.912788999999975,333.90221624230173,0
"147.32.84.165",4781,"205.188.190.1",25,6,372,6,372,0,0,14770.174904,10.199118000000453,291.7899371298447,0
"147.32.84.165",4782,"202.179.178.24",25,6,372,6,372,0,0,14770.175038,10.202183999999761,291.70224728352963,0
"147.32.84.165",4783,"147.108.253.152",25,6,372,6,372,0,0,14770.175103,10.205323000000135,291.61252416998076,0
"147.32.84.165",4746,"212.117.171.138",65500,341,333022,250,326186,91,6836,14773.379173,48.754077999999936,53523.48166649779,1121.71129561716
"147.32.84.165",4753,"174.133.57.141",80,17,3489,12,1428,5,2061,14773.379307,11.300263000000996,1010.9499221388912,1459.08108510382
"147.32.84.165",4785,"205.188.190.1",25,6,372,6,372,0,0,14773.546475,9.562372000000323,311.21985214546135,0
"147.32.84.165",4747,"65.55.196.251",443,196,170453,134,10784,62,159669,14773.546558,9.938979000000472,8680.167248567072,128519.43846545398
"147.32.84.165",4787,"203.188.197.119",25,6,372,6,372,0,0,14773.646945,9.469495999999708,314.2722696118243,0
"147.32.84.165",4751,"221.130.69.202",6667,9,552,6,372,3,180,14773.680063,3.108298000001014,957.4371569260828,463.27604367391103
"147.32.84.165",4788,"209.85.225.27",25,6,372,6,372,0,0,14773.779751,9.343090000000302,318.5241713394502,0
"147.32.84.165",4790,"66.11.225.137",25,6,372,6,372,0,0,14773.779883,9.346158000000287,318.4196115665826,0
"147.32.84.165",4793,"205.188.190.1",25,6,372,6,372,0,0,14773.779946,9.349293999999645,318.31280522359367,0
"147.32.84.165",4794,"74.125.113.27",25,6,372,6,372,0,0,14773.780002,9.352442000001247,318.20566222165326,0
"147.32.84.165",4756,"212.117.174.7",4506,6,372,6,372,0,0,14776.788622,9.008508000000802,330.35437166728775,0
"147.32.84.165",4795,"205.188.190.1",25,6,372,6,372,0,0,14778.987302,9.012932999999975,330.19218050328436,0
"147.32.84.165",4796,"203.188.197.119",25,6,372,6,372,0,0,14778.987397,9.013066999999864,330.18727143602115,0
"147.32.84.165",4799,"209.85.225.27",25,6,372,6,372,0,0,14778.987424,9.013090999998894,330.1863922155413,0
"147.32.84.165",4800,"98.139.175.224",25,6,372,6,372,0,0,14778.987451,9.013113999999405,330.18554963358906,0
"147.32.84.165",4801,"66.94.236.34",25,6,372,6,372,0,0,14778.987479,9.013135000001057,330.18478032334485,0
"147.32.84.165",4802,"98.139.175.224",25,6,372,6,372,0,0,14779.087411,9.013068000000203,330.18723480172713,0
"147.32.84.165",4803,"205.188.190.1",25,6,372,6,372,0,0,14779.087474,9.013236999999208,330.1810437249416,0
"147.32.84.165",4805,"207.115.37.23",25,6,372,6,372,0,0,14782.592787,9.012689000001046,330.20111977675634,0
"147.32.84.165",4736,"212.117.174.7",4506,6,372,6,372,0,0,14785.196496,9.013262000000395,330.1801279048439,0
"147.32.84.165",4806,"205.188.190.1",25,6,372,6,372,0,0,14785.196595,9.013222000001406,330.1815932193322,0
"147.32.84.165",4808,"205.188.103.1",25,6,372,6,372,0,0,14785.196627,9.013253000000987,330.18045759945653,0
"147.32.84.165",4763,"173.192.170.88",80,18,2255,14,1728,4,527,14791.20493,12.443014000000403,1110.9848465974203,338.8246609703938
"147.32.84.165",4759,"41.93.130.4",6667,4,248,4,248,0,0,14791.205043,3.0045910000008007,660.3228193120033,0
"147.32.84.165",4768,"74.125.127.27",25,6,372,6,372,0,0,14791.205076,9.01260899999943,330.2040507915287,0
"147.32.84.165",4761,"98.126.71.122",80,16,4737,12,1310,4,3427,14794.610087,14.2643390000012,734.6993085343189,1921.9958246924512
"147.32.84.165",4774,"174.133.57.141",80,16,3429,12,1428,4,2001,14794.785064,0.46302599999944505,24672.48059507175,34572.57259855642
"147.32.84.165",4810,"209.85.225.27",25,6,372,6,372,0,0,14794.815882,9.01410499999838,330.1492494263751,0
"147.32.84.165",4814,"98.139.175.224",25,6,372,6,372,0,0,14794.816039,9.014047000000573,330.15137373921067,0
"147.32.84.165",4815,"74.6.140.31",25,6,372,6,372,0,0,14794.937986,8.991500000000087,330.9792581882857,0
"147.32.84.165",4354,"174.36.246.56",80,28,14281,22,2178,6,12103,14797.810505,0.41229700000076264,42260.79743478068,234840.41843579
"147.32.84.165",4775,"195.113.232.88",80,17,5887,12,2556,5,3331,14797.931605,10.942943000000014,1868.6015270297921,2435.176716172237
"147.32.84.165",4823,"205.188.190.1",25,6,372,6,372,0,0,14797.932567,9.006685000000289,330.4212371144216,0
"147.32.84.165",4829,"98.139.175.224",25,6,372,6,372,0,0,14797.932629,9.006760999998733,330.4184489852033,0
"147.32.84.165",4831,"205.188.103.1",25,6,372,6,372,0,0,14797.932684,9.006767000000764,330.4182288716637,0
"147.32.84.165",4832,"98.139.175.224",25,6,372,6,372,0,0,14797.932741,9.006776000000173,330.4178987020376,0
"147.32.84.165",4834,"209.85.225.27",25,6,372,6,372,0,0,14797.932798,9.006781000000046,330.4177152747452,0
"147.32.84.165",4835,"205.188.103.1",25,6,372,6,372,0,0,14797.932855,9.006783000000723,330.41764190385857,0
"147.32.84.165",4836,"208.84.244.133",25,6,372,6,372,0,0,14797.932911,9.006787000000259,330.4174951622498,0
"147.32.84.165",4694,"195.113.232.82",80,7,426,6,364,1,62,14800.017408,0.0010180000008404022,0,0
"147.32.84.165",4760,"195.113.232.83",80,13,2066,10,1694,3,372,14800.018218,8.856424999999945,1530.1885354417934,336.0272344653761
"147.32.84.165",1028,"209.85.225.27",25,6,372,6,372,0,0,14800.019129,9.026738999998997,329.68716609623146,0
"147.32.84.165",4712,"195.113.232.82",80,60,45681,46,3700,14,41981,14800.019194,9.78381199999967,3025.4056394379813,34326.906526823215
"147.32.84.165",1039,"205.188.190.1",25,6,372,6,372,0,0,14800.020132,9.025824000000284,329.7205883916977,0
"147.32.84.165",4745,"195.113.232.82",80,13,1651,10,1314,3,337,14800.020193,9.7829270000002,1074.5250373430963,275.5821442805354
"147.32.84.165",1044,"209.85.143.27",25,6,372,6,372,0,0,14800.020298,9.025687999999718,329.7255566556359,0
"147.32.84.165",4747,"74.125.232.195",80,18,3662,14,2968,4,694,14800.117985,9.685230999999476,2451.5677530046814,573.2439422457038
"147.32.84.165",4762,"195.113.232.83",80,13,3471,10,1616,3,1855,14800.126135,8.74861299999975,1477.719954008752,1696.2688828503929
"147.32.84.165",1049,"124.108.116.109",25,6,372,6,372,0,0,14800.126172,9.02042799999981,329.9178265155559,0
"147.32.84.165",4776,"95.172.94.46",80,13,2172,10,1596,3,576,14803.62908,0.056190999999671476,227225.0004462396,82006.01519864285
"147.32.84.165",4785,"212.117.174.7",4506,6,372,6,372,0,0,14803.64729,9.097595999999612,327.11938406587046,0
"147.32.84.165",4777,"74.125.232.218",80,13,1871,10,1156,3,715,14806.237659,2.6371870000002673,3506.766869394951,2168.9777782157353
"147.32.84.165",4793,"174.133.57.141",80,17,3489,12,1428,5,2061,14806.245735,6.049940999999308,1888.2828774695997,2725.315833658855
"147.32.84.165",1055,"65.55.37.88",25,6,372,6,372,0,0,14806.40097,10.252221999999165,290.2785366918744,0
"147.32.84.165",4774,"174.36.246.56",80,19,8330,14,2120,5,6210,14807.541486,0.4545749999997497,37309.5748776535,109288.89622180576
"147.32.84.165",4790,"212.117.171.138",65500,82,7740,54,4890,28,2850,14807.662394,49.67209999999977,787.5648502881935,459.0101888182723
"147.32.84.165",4778,"68.67.179.213",80,13,1990,10,1250,3,740,14807.662472,1.2124710000007326,8247.619943069943,4882.591006297407
"147.32.84.165",1058,"216.32.181.178",25,6,372,6,372,0,0,14807.691996,9.860378999999739,301.813956644068,0
"147.32.84.165",4694,"65.55.196.251",443,221,171893,142,11300,79,160593,14812.265848,9.9464480000006,9088.67165444333,129166.11035416085
"147.32.84.165",4799,"173.192.170.88",80,22,3140,18,2894,4,246,14812.366895,45.36575200000152,510.34092854890235,43.38074237146855
"147.32.84.165",4795,"212.117.174.7",4506,6,372,6,372,0,0,14812.366961,9.481416000000536,313.8771677141718,0
"147.32.84.165",4796,"173.192.170.88",80,18,2429,14,1930,4,499,14812.36702,36.05868100000043,428.19092578566074,110.70843107100762
"147.32.84.165",1065,"165.21.74.117",25,6,372,6,372,0,0,14812.36708,9.484496999999465,313.7752060019807,0
"147.32.84.165",4756,"92.46.218.192",6667,4,248,4,248,0,0,14815.770841,3.9355370000012044,504.1243418622142,0
"147.32.84.165",1076,"209.85.225.27",25,6,372,6,372,0,0,14815.770971,9.013457999999446,330.17294805170036,0
"147.32.84.165",1079,"205.188.190.1",25,6,372,6,372,0,0,14815.871149,9.012754999999743,330.1987017288371,0
"147.32.84.165",1109,"98.139.175.224",25,6,372,6,372,0,0,14818.875627,9.012684000001173,330.20130296364687,0
"147.32.84.165",1117,"217.116.81.20",25,6,372,6,372,0,0,14820.978787,9.012554999999338,330.206029255879,0
"147.32.84.165",1122,"207.115.36.20",25,6,372,6,372,0,0,14821.079198,9.012324999999691,330.21445631400354,0
"147.32.84.165",4806,"174.133.57.141",80,14,1831,10,1308,4,523,14824.583906,265.0247780000009,39.4831007084174,15.787203112004818
"147.32.84.165",1141,"205.188.190.1",25,6,372,6,372,0,0,14824.745822,8.951167999999598,332.4705781413257,0
"147.32.84.165",1028,"212.117.171.138",65500,91,53352,62,50524,29,2828,14824.745866,27.49523600000066,14700.437559437218,822.8334537662981
"147.32.84.165",1146,"209.85.225.27",25,6,372,6,372,0,0,14824.745909,8.951193000000785,332.4696495762899,0
"147.32.84.165",1049,"64.12.175.136",587,47,5953,30,4112,17,1841,14824.745951,32.683224999998856,1006.5102204571657,450.6287246745239
"147.32.84.165",1155,"216.82.241.195",25,6,372,6,372,0,0,14824.863819,8.93312700000024,333.1420229444762,0
"147.32.84.165",1160,"65.55.88.22",25,6,372,6,372,0,0,14827.287454,9.013197000000218,330.1825090475586,0
"147.32.84.165",1165,"207.115.36.20",25,6,372,6,372,0,0,14828.589238,9.013069999999061,330.1871615332301,0
"147.32.84.165",1217,"65.55.37.72",25,6,372,6,372,0,0,14828.589378,9.012995999999475,330.1898724908092,0
"147.32.84.165",4722,"212.117.174.7",4506,6,372,6,372,0,0,14830.492479,9.012528999999631,330.2069818582688,0
"147.32.84.165",4712,"186.92.63.171",6667,4,248,4,248,0,0,14833.296062,3.004515000000538,660.339522352075,0
"147.32.84.165",1219,"205.188.190.1",25,6,372,6,372,0,0,14836.801441,9.01302399999986,330.1888467178215,0
"147.32.84.165",1223,"98.139.175.224",25,6,372,6,372,0,0,14836.801568,9.013003999998546,330.18957941220043,0
"147.32.84.165",1243,"209.85.225.27",25,6,372,6,372,0,0,14836.801624,9.012983000000531,330.19034874467474,0
"147.32.84.165",1245,"65.55.37.88",25,6,372,6,372,0,0,14836.901238,9.013458999999784,330.1729114205846,0
"147.32.84.165",4747,"212.117.174.7",4506,6,372,6,372,0,0,14839.90886,9.009643999999753,330.31271823837676,0
"147.32.84.165",1470,"205.188.190.1",25,6,372,6,372,0,0,14839.908916,9.009694000000309,330.3108851421478,0
"147.32.84.165",1761,"98.139.175.224",25,6,372,6,372,0,0,14842.009187,9.012693000000581,330.2009732274036,0
"147.32.84.165",1920,"64.12.139.193",25,6,372,6,372,0,0,14842.109153,9.012878000001365,330.19419546115563,0
"147.32.84.165",2004,"85.17.162.148",25,6,372,6,372,0,0,14845.814649,9.012459999999919,330.2095099451234,0
"147.32.84.165",2054,"216.32.180.22",25,6,372,6,372,0,0,14848.318164,9.01277200000004,330.1980789040249,0
"147.32.84.165",4768,"212.117.171.138",65500,46,8855,32,7112,14,1743,14849.620183,15.452877999998236,3681.9031380437027,902.356182453624
"147.32.84.165",2181,"209.85.225.27",25,6,372,6,372,0,0,14849.620313,9.012284000000363,330.21595857386205,0
"147.32.84.165",4775,"65.54.234.75",443,48,28488,34,4208,14,24280,14849.620372,2.405743999999686,13993.17633131555,80740.09537175417
"147.32.84.165",2183,"205.188.103.1",25,6,372,6,372,0,0,14849.786891,8.946407999999792,332.6474714768284,0
"147.32.84.165",4777,"78.138.22.163",6667,6,372,6,372,0,0,14851.522315,9.013160000000425,330.1838644825854,0
"147.32.84.165",2185,"205.188.103.1",25,6,372,6,372,0,0,14851.522453,9.0131020000008,330.18598924096676,0
"147.32.84.165",2269,"205.188.146.193",25,6,372,6,372,0,0,14851.522509,9.013075999999273,330.1869417278008,0
"147.32.84.165",4810,"212.117.174.7",4506,6,372,6,372,0,0,14857.831439,9.012776999999915,330.19789572071164,0
"147.32.84.165",4814,"173.192.170.88",80,23,2371,18,1812,5,559,14857.931405,120.01406400000087,120.78584389909415,37.26229952516205
"147.32.84.165",2349,"65.55.37.88",25,6,372,6,372,0,0,14860.936061,9.013159000000087,330.18390111613155,0
"147.32.84.165",4782,"212.117.171.138",65500,58,17060,40,15012,18,2048,14861.136759,10.399405999998635,11548.351896254051,1575.4745992225085
"147.32.84.165",2453,"209.240.204.25",25,6,372,6,372,0,0,14861.136794,9.012815000000046,330.1965035341328,0
"147.32.84.165",4823,"74.125.235.19",443,27,6010,18,2878,9,3132,14863.039218,2.35003400000096,9797.30506026321,10661.973401231542
"147.32.84.165",4832,"174.133.57.141",80,16,3429,12,1428,4,2001,14863.139134,0.5600480000011885,20398.251578392847,28583.26429157149
"147.32.84.165",2471,"65.55.92.136",25,6,372,6,372,0,0,14863.139282,9.007407999999486,330.3947151056297,0
"147.32.84.165",2500,"209.85.225.27",25,6,372,6,372,0,0,14863.378932,8.968643000000156,331.8227740807554,0
"147.32.84.165",1028,"212.117.174.7",4506,6,372,6,372,0,0,14866.844307,9.014092000001256,330.14972556299466,0
"147.32.84.165",2505,"205.188.103.1",25,6,372,6,372,0,0,14866.844337,9.014187999999194,330.1462095088616,0
"147.32.84.165",1049,"212.117.171.138",65500,44,8559,30,6784,14,1775,14866.844365,26.96104799999921,2012.9781305237686,526.6857579126901
"147.32.84.165",2538,"205.188.190.1",25,6,372,6,372,0,0,14866.844401,9.014177999999447,330.1465757610048,0
"147.32.84.165",1055,"74.125.235.18",443,39,10564,24,3368,15,7196,14869.348573,2.48343400000158,10849.493080944716,23180.805288146727
"147.32.84.165",2539,"98.139.175.224",25,6,372,6,372,0,0,14869.688334,8.879413999999088,335.1572524943995,0
"147.32.84.165",1065,"98.126.71.122",80,18,4863,14,1430,4,3433,14870.749815,19.678205000000162,581.353837913565,1395.6557521379502
"147.32.84.165",2543,"208.65.145.12",25,6,372,6,372,0,0,14870.924907,8.845633999999336,336.43716210734283,0
"147.32.84.165",1076,"119.154.54.142",6667,6,372,6,372,0,0,14872.347438,8.92854399999851,333.31302393766515,0
"147.32.84.165",1117,"195.113.232.88",80,17,5675,12,2556,5,3119,14872.547869,17.880396000000474,1143.5988330459493,1395.4948201370562
"147.32.84.165",2546,"169.232.46.250",25,6,372,6,372,0,0,14872.54882,8.927490000000034,333.3523756397362,0
"147.32.84.165",1141,"195.113.232.99",80,56,40073,44,3446,12,36627,14878.767517,11.66093600000022,2364.132690548982,25128.000016464757
"147.32.84.165",1146,"174.133.57.141",80,17,3489,12,1428,5,2061,14878.768819,12.900045999998838,885.5782374730314,1278.1349771932198
"147.32.84.165",2564,"209.85.225.27",25,6,372,6,372,0,0,14878.768894,9.02779399999963,329.6486384159986,0
"147.32.84.165",2571,"205.188.190.1",25,6,372,6,372,0,0,14878.768995,9.027863999999681,329.64608239558163,0
"147.32.84.165",2576,"98.139.175.224",25,6,372,6,372,0,0,14878.769066,9.027868999999555,329.6458998242162,0
"147.32.84.165",2579,"209.240.204.25",25,6,372,6,372,0,0,14878.769137,9.02787200000057,329.64579028145414,0
"147.32.84.165",2580,"98.139.175.224",25,6,372,6,372,0,0,14878.769207,9.027879000001121,329.6455346820256,0
"147.32.84.165",2602,"209.85.143.27",25,6,372,6,372,0,0,14878.769284,9.027876000000106,329.64564422461774,0
"147.32.84.165",2627,"205.188.103.1",25,6,372,6,372,0,0,14881.877162,9.04021499999908,329.19571050028156,0
"147.32.84.165",2636,"209.240.204.25",25,6,372,6,372,0,0,14882.078073,9.039361999999528,329.22677507551475,0
"147.32.84.165",1219,"212.117.174.7",4506,6,372,6,372,0,0,14884.084685,9.036254000000554,329.3400119119956,0
"147.32.84.165",2637,"65.54.188.110",25,6,372,6,372,0,0,14884.285313,9.035480000000462,329.36822393495953,0
"147.32.84.165",2640,"205.188.103.1",25,6,372,6,372,0,0,14887.797252,9.02842099999907,329.6257451884783,0
"147.32.84.165",2653,"208.65.145.12",25,6,372,6,372,0,0,14887.797331,9.02842899999996,329.6254531103931,0
"147.32.84.165",2661,"64.12.90.65",25,6,372,6,372,0,0,14887.797411,9.028373000001011,329.6274976675938,0
"147.32.84.165",2664,"98.139.175.224",25,6,372,6,372,0,0,14890.617219,9.013050999999905,330.18785758563126,0
"147.32.84.165",1761,"212.117.171.138",65500,50,15340,32,10624,18,4716,14891.618586,15.634738999999172,5436.099700801177,2413.0879319444985
"147.32.84.165",2670,"204.11.209.99",25,6,372,6,372,0,0,14891.618758,9.013272000000143,330.17976157825404,0
"147.32.84.165",1920,"74.125.235.48",443,27,5970,18,2942,9,3028,14891.818855,2.3026800000006915,10221.133635586764,10519.915924050552
"147.32.84.165",2674,"205.188.190.1",25,6,372,6,372,0,0,14892.158774,8.973323000000164,331.6497132667514,0
"147.32.84.165",4671,"74.115.3.63",6667,6,372,6,372,0,0,14893.521,9.012967999999091,330.1908982701703,0
"147.32.84.165",4781,"173.192.170.88",80,6,372,6,372,0,0,14899.830093,9.012832000000344,330.1958807176131,0
"147.32.84.165",4712,"212.117.174.7",4506,6,372,6,372,0,0,14899.830276,9.01277299999856,330.19804226739933,0
"147.32.84.165",4722,"173.192.170.88",80,6,372,6,372,0,0,14899.83036,9.01274100000046,330.1992146451172,0
"147.32.84.165",2681,"209.85.143.27",25,6,372,6,372,0,0,14899.830432,9.01271899999847,330.20002065974825,0
"147.32.84.165",4777,"173.192.170.88",80,6,372,6,372,0,0,14902.934481,9.013020000000324,330.18899325641047,0
"147.32.84.165",4790,"174.133.57.141",80,17,3489,12,1428,5,2061,14902.934632,6.509861999998975,1754.8759098121893,2532.7725841196934
"147.32.84.165",2684,"170.206.225.64",25,6,372,6,372,0,0,14902.934704,9.012932000001456,330.1922171386092,0
"147.32.84.165",4763,"212.117.171.138",65500,155,15352,100,8012,55,7340,14903.134731,36.052897999999914,1777.8321176844133,1628.7178911387412
"147.32.84.165",2685,"209.85.225.27",25,6,372,6,372,0,0,14903.134863,9.012806000000637,330.1968332614493,0
"147.32.84.165",4796,"65.55.196.251",443,34,13652,24,8704,10,4948,14905.137805,2.195319999998901,31718.382741484093,18031.084306624918
"147.32.84.165",2690,"98.139.175.224",25,6,372,6,372,0,0,14905.239616,9.011086999998952,330.2598232599847,0
"147.32.84.165",2699,"212.170.236.90",25,6,372,6,372,0,0,14905.23965,9.011178000000655,330.256488108412,0
"147.32.84.165",2703,"205.188.190.1",25,6,372,6,372,0,0,14905.33793,9.01320300000043,330.18228924832357,0
"147.32.84.165",2716,"74.6.136.65",25,6,372,6,372,0,0,14905.338063,9.01319500000136,330.18258231399085,0
"147.32.84.165",2725,"209.85.225.27",25,6,372,6,372,0,0,14908.843224,9.01255300000048,330.20610253274975,0
"147.32.84.165",4823,"212.117.171.138",65500,52,15476,34,10744,18,4732,14908.843285,19.620300999999017,4380.768674242271,1929.4301346346265
"147.32.84.165",2744,"74.208.5.3",25,6,372,6,372,0,0,14908.843345,9.01249000000098,330.20841077212583,0
"147.32.84.165",1049,"212.117.174.7",4506,6,372,6,372,0,0,14911.647349,9.0134939999989,330.1716293371209,0
"147.32.84.165",1028,"205.188.186.167",587,116,15984,74,12470,42,3514,14912.649328,26.63231799999994,3745.8249034124715,1055.5596399832739
"147.32.84.165",2898,"98.139.175.224",25,6,372,6,372,0,0,14912.767705,9.001019999999698,330.6291953578705,0
"147.32.84.165",1065,"84.234.53.214",6667,6,372,6,372,0,0,14913.149774,9.012966000000233,330.1909715403257,0
"147.32.84.165",2968,"207.115.37.23",25,6,372,6,372,0,0,14914.450905,9.01308600000084,330.1865753860246,0
"147.32.84.165",1920,"64.12.90.1",25,6,372,6,372,0,0,14920.860543,8.9130669999995,333.89180177823937,0
"147.32.84.165",1761,"174.133.57.141",80,17,3489,12,1428,5,2061,14923.964689,2.482842999999775,4601.17695722244,6640.774305907177
"147.32.84.165",3341,"205.188.190.1",25,6,372,6,372,0,0,14923.964791,8.913720000000467,333.8673415812752,0
"147.32.84.165",2349,"173.192.170.88",80,48,7616,34,2936,14,4680,14924.164983,131.1788579999993,179.0532434731222,285.4118458631512
"147.32.84.165",1146,"212.117.171.138",65500,53,15536,34,10744,19,4792,14924.165087,22.999526000001424,3737.1204954395444,1666.8169596189775
"147.32.84.165",2183,"173.192.170.88",80,72,9347,48,3776,24,5571,14924.165119,89.6574099999998,336.9269756955958,497.092209110213
"147.32.84.165",2181,"173.192.170.88",80,28,2677,22,2056,6,621,14924.165144,252.39286100000027,65.16824578489161,19.683599529386033
"147.32.84.165",3352,"162.95.222.12",25,6,372,6,372,0,0,14924.165172,8.913398999999117,333.87936521188993,0
"147.32.84.165",2185,"65.55.196.251",443,36,13804,26,8856,10,4948,14926.267996,2.274980999998661,31142.238111017938,17399.705755794574
"147.32.84.165",2500,"212.117.174.7",4506,6,372,6,372,0,0,14926.368566,8.91258999999991,333.9096715993926,0
"147.32.84.165",2471,"173.192.170.88",80,18,2258,14,1730,4,528,14926.368659,18.5379410000005,746.5769796116854,227.8570203670346
"147.32.84.165",3435,"64.12.90.65",25,6,372,6,372,0,0,14926.368695,8.912582000000839,333.9099713191665,0
"147.32.84.165",3527,"209.85.225.27",25,6,372,6,372,0,0,14926.369511,8.911816999998337,333.9386345119694,0
"147.32.84.165",3539,"98.139.175.224",25,6,372,6,372,0,0,14929.773752,9.010039000000688,330.29823733279875,0
"147.32.84.165",3615,"98.139.175.224",25,6,372,6,372,0,0,14929.773807,9.010073000001285,330.2969909344326,0
"147.32.84.165",3779,"205.188.190.1",25,6,372,6,372,0,0,14929.773865,9.010040000001027,330.29820067387726,0
"147.32.84.165",3796,"209.85.225.27",25,6,372,6,372,0,0,14929.773925,9.010005000000092,330.2994837405717,0
"147.32.84.165",3885,"209.85.225.27",25,6,372,6,372,0,0,14929.773984,9.009974000000511,330.30062017935137,0
"147.32.84.165",3969,"205.188.103.1",25,6,372,6,372,0,0,14929.774042,9.009940000001734,330.3018666050415,0
"147.32.84.165",2539,"68.67.185.216",80,16,2560,12,1528,4,1032,14932.577154,12.329248000000007,991.4635507372383,669.6272148958311
"147.32.84.165",4021,"209.85.225.27",25,6,372,6,372,0,0,14932.606459,8.987745999998879,331.117501540472,0
"147.32.84.165",4151,"71.74.56.243",25,6,372,6,372,0,0,14932.606521,8.987821000000622,331.1147384888722,0
"147.32.84.165",2543,"68.67.185.210",80,16,2785,12,1904,4,881,14933.679385,11.22681399999965,1356.7517908464927,627.7827351553361
"147.32.84.165",4152,"205.188.190.1",25,6,372,6,372,0,0,14933.703626,8.994093999999677,330.88379996919167,0
"147.32.84.165",4154,"205.188.190.1",25,6,372,6,372,0,0,14933.703657,8.99420099999952,330.8798635921255,0
"147.32.84.165",4187,"76.162.254.120",25,6,372,6,372,0,0,14933.703685,8.994238999999652,330.87846564896876,0
"147.32.84.165",2571,"61.150.114.216",6667,15,1714,10,1156,5,558,14935.381372,1.979036000000633,4672.982199412765,2255.643656809968
"147.32.84.165",2564,"217.163.21.36",80,21,6763,14,1674,7,5089,14935.481281,0.18715499999962049,71555.66241899578,217530.92356646928
"147.32.84.165",4196,"207.115.37.23",25,6,372,6,372,0,0,14935.526998,8.976067000001422,331.5483273464345,0
"147.32.84.165",2576,"217.163.21.36",80,15,2440,10,1554,5,886,14935.845709,0.1410439999999653,88142.70724031549,50253.821502522216
"147.32.84.165",4306,"66.94.237.139",25,6,372,6,372,0,0,14935.891817,9.012829999999667,330.1959539900464,0
"147.32.84.165",2640,"212.117.174.7",4506,6,372,6,372,0,0,14941.79478,9.036955999999918,329.3144284425006,0
"147.32.84.165",2579,"195.113.232.88",80,14,2298,10,1332,4,966,14944.904796,0.24892299999919487,42808.41866775857,31045.745069860943
"147.32.84.165",2627,"174.133.57.141",80,17,3489,12,1428,5,2061,14944.905828,6.0075419999993755,1901.6096766366657,2744.550100523927
"147.32.84.165",4429,"209.85.143.27",25,6,372,6,372,0,0,14944.905889,9.030569000000469,329.5473408153845,0
"147.32.84.165",2602,"212.117.171.138",65500,82,7957,52,4802,30,3155,14945.123183,41.378772000000026,928.3987451343403,609.974602436244
"147.32.84.165",4456,"209.85.225.27",25,6,372,6,372,0,0,14945.123286,9.015391999999338,330.1021186877086,0
"147.32.84.165",4782,"65.55.196.251",443,36,13804,26,8856,10,4948,14945.123314,2.1205559999998513,33410.105651539016,18666.802480105584
"147.32.84.165",4517,"65.55.37.72",25,6,372,6,372,0,0,14945.22482,9.012199000000692,330.2190730586144,0
"147.32.84.165",4810,"202.86.18.246",6667,6,372,6,372,0,0,14947.326476,9.01429300000018,330.14236391028567,0
"147.32.84.165",4521,"98.139.175.224",25,6,372,6,372,0,0,14947.326576,9.014318999999887,330.1414116806869,0
"147.32.84.165",1049,"173.192.170.88",80,29,2737,22,2056,7,681,14950.831892,60.58870999999999,271.4697177081341,89.91774210079734
"147.32.84.165",4565,"74.6.136.65",25,6,372,6,372,0,0,14950.831957,9.012634999999136,330.2030982060502,0
"147.32.84.165",2185,"212.117.174.7",4506,6,372,6,372,0,0,14953.635758,9.01332100000036,330.17796658966,0
"147.32.84.165",4573,"98.139.175.224",25,6,372,6,372,0,0,14953.635835,9.013374000000113,330.17602509337377,0
"147.32.84.165",1920,"64.12.168.40",587,53,6699,34,4722,19,1977,14953.635865,32.96067299999959,1146.0931031353782,479.8445711348248
"147.32.84.165",4591,"207.115.37.23",25,6,372,6,372,0,0,14953.754527,8.994610000001558,330.8648179297918,0
"147.32.84.165",4593,"64.12.90.65",25,6,372,6,372,0,0,14953.754591,8.99464899999839,330.86338332941426,0
"147.32.84.165",2471,"212.117.171.138",65500,79,7502,50,4666,29,2836,14954.737265,43.88669300000038,850.5539480953755,516.9676375478965
"147.32.84.165",4602,"200.44.32.36",25,6,372,6,372,0,0,14954.737395,9.012935999999172,330.1920705972253,0
"147.32.84.165",4611,"209.85.225.27",25,6,372,6,372,0,0,14956.540195,9.012528000001112,330.2070184968782,0
"147.32.84.165",4631,"64.12.139.193",25,6,372,6,372,0,0,14956.940409,9.012719999998808,330.1999840226251,0
"147.32.84.165",2637,"173.192.170.88",80,6,372,6,372,0,0,14962.848777,9.01290599999993,330.19316966137484,0
"147.32.84.165",2579,"208.73.210.29",80,72,39721,44,6646,28,33075,14962.848884,21.21112499999981,2506.6091496797303,12474.585860014608
"147.32.84.165",2664,"174.133.57.141",80,17,3489,12,1428,5,2061,14963.032173,3.3371040000001813,3423.3275318957335,4940.810954647834
"147.32.84.165",4643,"209.85.143.27",25,6,372,6,372,0,0,14963.032229,8.929871000000276,333.263492832081,0
"147.32.84.165",2564,"212.117.171.138",65500,148,14702,94,7716,54,6986,14963.032259,119.22373499999958,517.7492552133199,468.7657201814739
"147.32.84.165",4664,"65.54.188.72",25,6,372,6,372,0,0,14963.032286,8.92993899999965,333.2609550860445,0
"147.32.84.165",2674,"64.12.168.40",587,50,5995,32,4086,18,1909,14965.953161,32.76611299999968,997.6160431357946,466.0912937704924
"147.32.84.165",2684,"74.125.232.217",80,13,2940,10,2066,3,874,14965.95319,18.107633999999962,912.7641965813996,386.13548296812354
"147.32.84.165",4670,"205.188.190.1",25,6,372,6,372,0,0,14965.961625,9.00470999999925,330.4937082926877,0
"147.32.84.165",2685,"67.214.158.5",80,15,2553,10,1704,5,849,14966.253827,0.31493199999931676,43285.53465519405,21566.560400387178
"147.32.84.165",4692,"205.188.103.1",25,6,372,6,372,0,0,14966.357256,9.009723000001031,330.30982195564275,0
"147.32.84.165",2744,"212.117.174.7",4506,6,372,6,372,0,0,14968.358705,9.011061999999583,330.2607395221715,0
"147.32.84.165",2898,"222.23.80.7",6667,6,372,6,372,0,0,14969.558352,9.012932999999975,330.19218050328436,0
"147.32.84.165",2690,"195.113.232.83",80,16,2318,12,1668,4,650,14971.861784,12.198832999998558,1093.8751272356608,426.27028339519154
"147.32.84.165",3341,"208.73.210.29",80,72,40353,44,7902,28,32451,14971.862657,17.004252000000633,3717.658383326573,15267.240217328603
"147.32.84.165",4693,"65.54.188.126",25,6,372,6,372,0,0,14971.862694,8.911787000000913,333.93975865891935,0
"147.32.84.165",2703,"50.22.198.84",80,13,3359,10,2328,3,1031,14974.766009,0.36633899999833375,50838.158099696484,22514.665378344962
"147.32.84.165",3527,"74.125.232.217",80,13,3152,10,2146,3,1006,14974.886782,13.980346000000281,1228.0096644245896,575.665294692981
"147.32.84.165",4695,"209.85.143.27",25,6,372,6,372,0,0,14974.886846,8.892352000000756,334.6696127188563,0
"147.32.84.165",2716,"67.214.158.5",80,15,2640,10,1748,5,892,14975.767584,0.3302780000012717,42340.08925797708,21606.04097146199
"147.32.84.165",4722,"67.214.158.5",80,15,2626,10,1734,5,892,14975.871515,0.3273589999989781,42375.49601521053,21798.69806549469
"147.32.84.165",4725,"98.139.175.224",25,6,372,6,372,0,0,14975.871578,8.90867900000012,334.05626131550594,0
"147.32.84.165",4712,"50.22.198.84",80,14,3012,10,2432,4,580,14977.569947,0.37299700000039593,52161.27743649238,12439.778336005584
"147.32.84.165",4823,"174.133.57.141",80,17,3489,12,1428,5,2061,14977.690982,7.1250249999993684,1603.3627952184045,2314.097143519
"147.32.84.165",4763,"50.22.198.84",80,14,3518,10,2426,4,1092,14977.851735,0.40201600000000326,48276.685505054134,21730.478388919666
"147.32.84.165",4730,"209.85.225.27",25,6,372,6,372,0,0,14977.851802,8.831536000001506,336.97422509510153,0
"147.32.84.165",4781,"68.67.185.209",80,13,2037,10,1156,3,881,14977.970343,6.090666999998575,1518.3887084948435,1157.1803219584406
"147.32.84.165",4777,"195.113.232.83",80,13,2136,10,1548,3,588,14977.994336,10.873160999999527,1138.9512212686393,432.6248824973901
"147.32.84.165",4740,"205.188.190.1",25,6,372,6,372,0,0,14977.9944,8.88911200000075,334.7915967308938,0
"147.32.84.165",4782,"68.67.185.209",80,13,2066,10,1156,3,910,14977.994456,6.066735000000335,1524.3784341988712,1199.9864836686615
"147.32.84.165",4790,"68.67.185.209",80,16,2200,12,1258,4,942,14977.994513,10.87279800000033,925.6127079708181,693.1058592277509
"147.32.84.165",4741,"205.188.103.1",25,6,372,6,372,0,0,14977.994569,8.888965000000098,334.7971332995424,0
"147.32.84.165",4808,"68.67.185.209",80,16,2228,12,1258,4,970,14977.994625,10.87305600000036,925.5907446811334,713.690796773211
"147.32.84.165",4752,"98.139.175.224",25,6,372,6,372,0,0,14977.994681,8.888876999999411,334.8004477956211,0
"147.32.84.165",4758,"216.32.180.22",25,6,372,6,372,0,0,14977.994741,8.888847000000169,334.8015777524288,0
"147.32.84.165",2640,"212.117.174.7",4506,6,372,6,372,0,0,14983.878904,9.016897000001336,330.04702171928534,0
"147.32.84.165",1117,"217.163.21.36",80,7,426,6,364,1,62,14983.879017,0.049061000001529464,59354.68090559139,10109.86323117216
"147.32.84.165",1141,"217.163.21.36",80,15,2113,10,1156,5,957,14983.924939,0.14296699999977136,64686.256269032645,53550.81941995177
"147.32.84.165",4809,"98.139.175.224",25,6,372,6,372,0,0,14983.925003,8.97092899999916,331.7382179705445,0
"147.32.84.165",2580,"94.245.121.178",80,7,426,6,364,1,62,14983.925062,0.037817999998878804,77000.3701963703,13115.447670810328
"147.32.84.165",1146,"50.22.198.84",80,14,3014,10,2434,4,580,14983.961614,0.37168500000007043,52388.4472066301,12483.689145376113
"147.32.84.165",4813,"209.85.225.27",25,6,372,6,372,0,0,14984.082292,9.0099050000008,330.30314970021726,0
"147.32.84.165",2185,"94.245.121.178",80,13,2266,10,1182,3,1084,14984.082354,0.11650000000008731,81167.3819741881,74437.76824028757
"147.32.84.165",4816,"74.125.113.27",25,6,372,6,372,0,0,14984.119124,8.973203999999896,331.6541115080003,0
"147.32.84.165",4821,"205.188.190.1",25,6,372,6,372,0,0,14986.883628,9.012769000000844,330.1981888140838,0
"147.32.84.165",2703,"173.192.170.88",80,25,3559,20,3004,5,555,14987.283887,108.54574200000025,221.39974868843723,40.90441428830981
"147.32.84.165",2716,"173.192.170.88",80,17,3196,16,3136,1,60,14987.283991,93.27178300000014,268.97738193768595,5.146250929930216
"147.32.84.165",4822,"64.12.139.193",25,6,372,6,372,0,0,14987.284022,9.01276499999949,330.19833536103164,0
"147.32.84.165",3796,"203.200.75.211",6667,6,372,6,372,0,0,14989.2867,9.013043999999354,330.1881140267609,0
"147.32.84.165",3615,"173.192.170.88",80,6,372,6,372,0,0,14990.589148,9.012431000001015,330.21057248589915,0
"147.32.84.165",4824,"212.77.101.4",25,6,372,6,372,0,0,14990.589225,9.012453000001187,330.2097664198202,0
"147.32.84.165",3969,"173.192.170.88",80,6,372,6,372,0,0,14992.796659,9.008082000000286,330.3699944116745,0
"147.32.84.165",4021,"64.12.90.1",25,6,372,6,372,0,0,14992.796817,9.008025999999518,330.3720482156867,0
"147.32.84.165",4154,"174.133.57.141",80,16,3429,12,1428,4,2001,14995.796441,0.47326799999973446,24138.543066521313,33824.38702808764
"147.32.84.165",4828,"209.85.225.27",25,6,372,6,372,0,0,14995.951309,8.958502999999837,332.19835948037905,0
"147.32.84.165",4152,"212.117.174.7",4506,6,372,6,372,0,0,14995.951345,8.958596000000398,332.19491089896985,0
"147.32.84.165",4830,"205.188.190.1",25,6,372,6,372,0,0,14996.797664,9.013231000000815,330.18126352245173,0
"147.32.84.165",4833,"98.139.175.224",25,6,372,6,372,0,0,14996.797739,9.01325100000031,330.180530865045,0
"147.32.84.165",4838,"98.139.175.224",25,6,372,6,372,0,0,14998.700276,9.013076000001092,330.18694172773417,0
"147.32.84.165",4839,"74.125.113.27",25,6,372,6,372,0,0,14998.700384,9.013032000000749,330.1885536409671,0
"147.32.84.165",4842,"204.127.217.16",25,6,372,6,372,0,0,14998.700416,9.013028000001214,330.18870017929595,0
"147.32.84.165",4845,"205.188.190.1",25,6,372,6,372,0,0,14998.900712,9.012754999999743,330.1987017288371,0
"147.32.84.165",4846,"212.27.48.7",25,6,372,6,372,0,0,14998.900742,9.012790000000678,330.1974194450083,0
"147.32.84.165",4847,"209.85.225.27",25,6,372,6,372,0,0,15005.115492,9.007080999999744,330.40671000961186,0
"147.32.84.165",4521,"174.133.57.141",80,17,2011,12,1428,5,583,15007.913568,191.11981100000048,59.774023112653516,24.403540248373247
"147.32.84.165",4848,"200.205.245.2",25,6,372,6,372,0,0,15008.075725,8.952839999999924,332.4084871392793,0
"147.32.84.165",4849,"66.96.140.50",25,6,372,6,372,0,0,15008.314813,9.012706999999864,330.2004603056601,0
"147.32.84.165",4573,"119.63.45.53",6667,6,372,6,372,0,0,15011.619104,9.012657000001127,330.20229217639456,0
"147.32.84.165",4593,"173.192.170.88",80,6,372,6,372,0,0,15011.619269,9.012588999999934,330.20478355331875,0
"147.32.84.165",4565,"212.117.174.7",4506,6,372,6,372,0,0,15011.61938,9.01250699999946,330.2077879107532,0
"147.32.84.165",4850,"207.115.21.20",25,6,372,6,372,0,0,15011.619516,9.0123969999986,330.21181823220417,0
"147.32.84.165",4851,"64.12.139.193",25,6,372,6,372,0,0,15013.822166,9.01319599999988,330.18254568080397,0
"147.32.84.165",4611,"173.192.170.88",80,6,372,6,372,0,0,15016.926434,9.013523999999961,330.1705304162959,0
"147.32.84.165",4722,"217.72.192.149",25,6,372,6,372,0,0,15016.926545,9.01348599999983,330.17192238386525,0
"147.32.84.165",4852,"98.139.175.224",25,6,372,6,372,0,0,15017.82785,9.012781999999788,330.1977125376016,0
"147.32.84.165",4853,"65.54.188.72",25,6,372,6,372,0,0,15019.730668,9.013082999999824,330.1866852884921,0
"147.32.84.165",4856,"209.85.225.27",25,6,372,6,372,0,0,15019.931082,9.013222000001406,330.1815932193322,0
"147.32.84.165",4857,"66.96.140.50",25,6,372,6,372,0,0,15019.931139,9.013245000000097,330.18075066193893,0
"147.32.84.165",4858,"209.85.143.27",25,6,372,6,372,0,0,15019.931195,9.01322700000128,330.18141005430994,0
"147.32.84.165",1049,"212.117.174.7",4506,6,372,6,372,0,0,15026.139974,9.012892000000647,330.1936825604685,0
"147.32.84.165",4861,"205.188.103.1",25,6,372,6,372,0,0,15029.044132,9.012829999999667,330.1959539900464,0
"147.32.84.165",4862,"98.139.175.224",25,6,372,6,372,0,0,15029.344416,9.012883999999758,330.19397564642793,0
"147.32.84.165",4864,"209.85.225.27",25,6,372,6,372,0,0,15029.344533,9.012891000000309,330.19371919619334,0
"147.32.84.165",2185,"80.191.196.145",6667,9,552,6,372,3,180,15032.649176,2.837021999999706,1048.9872831441942,507.57449184396495
"147.32.84.165",4865,"209.85.143.27",25,6,372,6,372,0,0,15032.649336,9.01283499999954,330.1957708090908,0
"147.32.84.165",4866,"98.139.175.224",25,6,372,6,372,0,0,15032.649395,9.012872999999672,330.19437864043,0
"147.32.84.165",4868,"161.58.16.34",25,6,372,6,372,0,0,15032.649448,9.012846999999965,330.19533117559985,0
"147.32.84.165",2471,"173.192.170.88",80,22,3504,20,3384,2,120,15034.852623,310.1188779999993,87.29555638338167,3.095587105793676
"147.32.84.165",4869,"210.130.202.123",25,6,372,6,372,0,0,15034.852684,9.013058000000456,330.18760114489993,0
"147.32.84.165",4870,"64.195.224.3",25,6,372,6,372,0,0,15035.48647,8.979650999999649,331.4159982386973,0
"147.32.84.165",2579,"212.117.174.7",4506,6,372,6,372,0,0,15037.956831,9.013295000000653,330.1789190301421,0
"147.32.84.165",4871,"205.188.103.1",25,6,372,6,372,0,0,15037.956928,9.013268000000608,330.1799081087791,0
"147.32.84.165",4872,"205.188.190.1",25,6,372,6,372,0,0,15037.956958,9.013272000000143,330.17976157825404,0
"147.32.84.165",4873,"65.55.37.120",25,6,372,6,372,0,0,15038.858164,9.012870000000476,330.19448854802556,0
"147.32.84.165",4874,"209.85.225.27",25,6,372,6,372,0,0,15040.760715,8.913160000000062,333.8883179478411,0
"147.32.84.165",4875,"209.85.143.27",25,6,372,6,372,0,0,15040.760809,8.913190000001123,333.887194147059,0
"147.32.84.165",4876,"98.139.175.224",25,6,372,6,372,0,0,15040.760837,8.913217999999688,333.88614527324523,0
"147.32.84.165",4877,"98.139.175.224",25,6,372,6,372,0,0,15040.963136,8.910851000000548,333.97483584899095,0
"147.32.84.165",4906,"209.85.225.27",25,6,372,6,372,0,0,15040.963191,8.910931999998866,333.97180003173395,0
"147.32.84.165",4913,"98.139.175.224",25,6,372,6,372,0,0,15040.963242,8.910941000000093,333.9714627220592,0
"147.32.84.165",4915,"64.12.139.193",25,6,372,6,372,0,0,15040.963297,8.91095200000018,333.9710504556573,0
"147.32.84.165",2684,"87.239.184.119",6667,9,552,6,372,3,180,15047.169926,1.017651999998634,2924.378864291521,1415.0220311088003
"147.32.84.165",2744,"174.133.57.141",80,17,3489,12,1428,5,2061,15048.187815,0.6116689999998925,18676.767990534107,26955.75548213641
"147.32.84.165",4926,"205.188.103.1",25,6,372,6,372,0,0,15048.18789,8.88863400000082,334.8096006652682,0
"147.32.84.165",4932,"65.205.167.9",25,6,372,6,372,0,0,15048.187971,8.888656000000992,334.80877198978874,0
"147.32.84.165",3341,"212.117.171.138",65500,138,13637,90,7316,48,6321,15049.974271,77.86343300000044,751.6750513684603,649.4447785265223
"147.32.84.165",4965,"209.85.225.27",25,6,372,6,372,0,0,15049.974416,9.008152000000337,330.3674271926016,0
"147.32.84.165",3527,"205.188.186.137",587,113,15256,68,11522,45,3734,15049.974489,32.37603999999919,2847.0436779792185,922.6576196471448
"147.32.84.165",1113,"206.54.145.17",25,6,372,6,372,0,0,15050.092893,8.99066600000151,331.0099607748191,0
"147.32.84.165",1114,"205.188.103.1",25,6,372,6,372,0,0,15050.274463,9.009041999999681,330.3347903140096,0
"147.32.84.165",3969,"212.117.174.7",4506,6,372,6,372,0,0,15053.579554,9.01560100000097,330.0944662479717,0
"147.32.84.165",4152,"98.126.71.122",80,18,4863,14,1430,4,3433,15055.782306,18.861425000000963,606.5289340545274,1456.0935878385962
"147.32.84.165",1269,"77.238.184.241",25,6,372,6,372,0,0,15055.957614,8.944204999999783,332.7294041225656,0
"147.32.84.165",4573,"195.113.232.98",80,17,5747,12,2574,5,3173,15056.37444,18.380316000000676,1120.3289432020235,1381.0426327816708
"147.32.84.165",1308,"209.85.225.27",25,6,372,6,372,0,0,15056.374571,9.030178999999407,329.5615734749218,0
"147.32.84.165",4643,"178.126.207.235",6667,6,372,6,372,0,0,15058.883059,9.029619000000821,329.58201226427485,0
"147.32.84.165",4631,"195.113.232.83",80,13,3379,10,1524,3,1855,15059.785642,14.969216999999844,814.4714583267867,991.3678183702029
"147.32.84.165",4664,"174.133.57.141",80,17,3489,12,1428,5,2061,15059.786426,3.8774039999989327,2946.301185020479,4252.329651489641
"147.32.84.165",1322,"64.12.139.193",25,6,372,6,372,0,0,15059.786456,9.029121999999916,329.6001538134082,0
"147.32.84.165",1449,"205.188.190.1",25,6,372,6,372,0,0,15059.786485,9.029194999999163,329.59748903421354,0
"147.32.84.165",4692,"77.238.175.247",80,14,2274,10,1276,4,998,15061.691701,0.14142100000026403,72181.64204736879,56455.547620120735
"147.32.84.165",1533,"210.202.48.66",25,6,372,6,372,0,0,15061.737651,8.984049000000596,331.25375874506057,0
"147.32.84.165",4693,"68.67.185.210",80,16,2170,12,1370,4,800,15061.892434,12.862516000001051,852.088347256408,497.5698378139609
"147.32.84.165",1537,"216.32.181.178",25,6,372,6,372,0,0,15061.921561,9.001187000001664,330.6230611584283,0
"147.32.84.165",4763,"212.117.174.7",4506,6,372,6,372,0,0,15069.115858,9.030868000001647,329.5364299422223,0
"147.32.84.165",4695,"74.125.232.218",80,13,1871,10,1156,3,715,15069.116,5.639055999999982,1639.9908069719522,1014.3541755925137
"147.32.84.165",1551,"212.16.233.25",25,6,372,6,372,0,0,15069.12408,9.022775000001275,329.8320084452488,0
"147.32.84.165",4725,"64.236.79.229",80,14,2814,10,2100,4,714,15071.122488,0.35642399999960617,47134.87307257245,16025.856844674634
"147.32.84.165",1552,"209.85.225.27",25,6,372,6,372,0,0,15071.240142,9.015433999999004,330.1005808483905,0
"147.32.84.165",4730,"64.236.79.229",80,14,2618,10,1918,4,700,15071.240219,0.35851499999989755,42798.76713667318,15619.988006085101
"147.32.84.165",1562,"209.85.143.27",25,6,372,6,372,0,0,15071.240305,9.015396000000692,330.10197222615307,0
"147.32.84.165",4741,"77.238.167.32",80,13,2342,10,1390,3,952,15071.322914,0.14033000000017637,79241.78721574876,54272.072970786205
"147.32.84.165",1563,"98.139.175.224",25,6,372,6,372,0,0,15071.368793,8.986348000000362,331.16901326321664,0
"147.32.84.165",4823,"98.126.71.122",80,18,4863,14,1430,4,3433,15074.634915,17.598761999999624,650.0457248072474,1560.5643169673292
"147.32.84.165",4752,"64.236.79.229",80,5,306,4,244,1,62,15074.63505,0.11748699999952805,16614.604169038626,4221.7436822967
"147.32.84.165",4828,"174.133.57.141",80,17,3489,12,1428,5,2061,15076.942797,2.500426000000516,4568.821472820088,6594.076369385296
"147.32.84.165",1569,"74.125.113.27",25,6,372,6,372,0,0,15076.942898,8.930761999999959,333.23024395902763,0
"147.32.84.165",4830,"195.113.232.98",80,17,5674,12,2556,5,3118,15077.444928,14.788880000000063,1382.6604854458155,1686.6726892097233
"147.32.84.165",1662,"64.12.90.65",25,6,372,6,372,0,0,15077.445029,8.930388999999195,333.244162152429,0
"147.32.84.165",4839,"173.192.170.88",80,23,2371,18,1816,5,555,15079.151122,67.90066000000115,213.9596286692906,65.3896442243702
"147.32.84.165",4838,"195.113.232.99",80,16,2149,12,1714,4,435,15079.151253,13.08264699999927,1048.1059375828734,266.00121519752037
"147.32.84.165",1724,"205.188.190.1",25,6,372,6,372,0,0,15079.152177,8.928459999999177,333.3161597857048,0
"147.32.84.165",1789,"213.199.180.150",25,6,372,6,372,0,0,15079.152239,8.928424000001542,333.3175037385642,0
"147.32.84.165",4845,"212.117.174.7",4506,6,372,6,372,0,0,15080.856554,8.92967200000021,333.2709196933471,0
"147.32.84.165",4842,"87.101.19.76",6667,4,248,4,248,0,0,15082.762184,2.910280000000057,681.7213463996458,0
"147.32.84.165",1904,"209.85.225.27",25,6,372,6,372,0,0,15082.963138,8.929545000000871,333.27565962204227,0
"147.32.84.165",2182,"205.188.190.1",25,6,372,6,372,0,0,15084.669779,9.03558300000077,329.3644693430127,0
"147.32.84.165",1113,"212.117.171.138",65500,151,14865,92,7500,59,7365,15090.086967,38.81545200000073,1545.7761512090306,1517.952180487268
"147.32.84.165",1322,"174.133.57.141",80,17,3489,12,1428,5,2061,15090.0871,3.504562000000078,3259.751147218895,4704.724870040716
"147.32.84.165",2530,"65.54.188.72",25,6,372,6,372,0,0,15090.087154,9.026573999999528,329.69319256676516,0
"147.32.84.165",1114,"64.12.168.40",587,100,13798,62,10564,38,3234,15092.203162,35.729527999999846,2365.326516487997,724.1069627340197
"147.32.84.165",2545,"64.12.90.65",25,6,372,6,372,0,0,15092.304037,9.012405999999828,330.21148847489303,0
"147.32.84.165",2583,"98.139.175.224",25,6,372,6,372,0,0,15092.304175,9.012362000001303,330.2131006277344,0
"147.32.84.165",2185,"212.117.171.138",65500,351,336054,260,329218,91,6836,15092.320934,52.17630199999985,50477.78203982351,1048.1386741436784
"147.32.84.165",2707,"209.85.225.27",25,6,372,6,372,0,0,15092.320992,8.995568999998795,330.829545079405,0
"147.32.84.165",2727,"204.127.217.16",25,6,372,6,372,0,0,15092.321047,8.995538000001034,330.83068516854223,0
"147.32.84.165",3969,"173.192.170.88",80,6,372,6,372,0,0,15097.911873,9.012575000000652,330.20529648849356,0
"147.32.84.165",2579,"64.12.168.40",587,110,15196,70,11810,40,3386,15097.912005,31.085290999999415,3039.3796216995934,871.4089245617971
"147.32.84.165",2744,"212.117.174.7",4506,6,372,6,372,0,0,15097.91206,9.01241200000004,330.2112686370737,0
"147.32.84.165",2742,"168.95.5.36",25,6,372,6,372,0,0,15097.912121,9.012376000000586,330.21258766831374,0
"147.32.84.165",2755,"66.135.195.180",25,6,372,6,372,0,0,15098.412371,9.012950999998793,330.19152106789426,0
"147.32.84.165",2759,"205.188.103.1",25,6,372,6,372,0,0,15100.114679,9.01291300000048,330.19291321239217,0
"147.32.84.165",4573,"221.158.173.198",6667,6,372,6,372,0,0,15101.81732,9.01293699999951,330.19203396186634,0
"147.32.84.165",2767,"209.85.225.27",25,6,372,6,372,0,0,15101.817461,9.012918999998874,330.1926933993717,0
"147.32.84.165",2768,"98.139.175.224",25,6,372,6,372,0,0,15101.81752,9.012918000000354,330.1927300348104,0
"147.32.84.165",2769,"209.85.143.27",25,6,372,6,372,0,0,15101.817577,9.01292900000044,330.19232704483244,0
"147.32.84.165",4631,"174.133.57.141",80,17,3489,12,1428,5,2061,15103.920455,9.344605000000229,1222.523584463947,1764.440551526747
"147.32.84.165",2848,"195.130.217.42",25,6,372,6,372,0,0,15103.920591,9.012591000000612,330.20471027696675,0
"147.32.84.165",2865,"65.54.188.110",25,6,372,6,372,0,0,15105.722681,9.013161000000764,330.18382784904736,0
"147.32.84.165",4643,"212.117.174.7",4506,6,372,6,372,0,0,15111.13052,9.012807999999495,330.1967599886924,0
"147.32.84.165",2881,"64.12.90.65",25,6,372,6,372,0,0,15113.333699,9.012833999999202,330.19580744527894,0
"147.32.84.165",2899,"150.70.74.47",25,6,372,6,372,0,0,15113.333798,9.012807999999495,330.1967599886924,0
"147.32.84.165",2911,"207.115.37.23",25,6,372,6,372,0,0,15118.941967,9.013036999998803,330.1883704682889,0
"147.32.84.165",4752,"173.192.170.88",80,6,372,6,372,0,0,15119.442514,9.012784000000465,330.1976392643878,0
"147.32.84.165",2951,"209.85.225.27",25,6,372,6,372,0,0,15119.442612,9.012831999998525,330.19588071767976,0
"147.32.84.165",2963,"209.85.143.27",25,6,372,6,372,0,0,15121.144849,9.013016999999309,330.1891031604876,0
"147.32.84.165",2975,"64.12.139.193",25,6,372,6,372,0,0,15121.144959,9.013004000000365,330.1895794121338,0
"147.32.84.165",4809,"116.111.184.69",6667,6,372,6,372,0,0,15122.847421,9.01277200000004,330.1980789040249,0
"147.32.84.165",4813,"174.133.57.141",80,16,3429,12,1428,4,2001,15122.847529,0.48736300000018673,23440.433516692123,32846.15368830598
"147.32.84.165",3001,"98.139.175.224",25,6,372,6,372,0,0,15122.847559,9.012767000000167,330.1982620875415,0
"147.32.84.165",4822,"173.192.170.88",80,16,1848,14,1724,2,124,15124.95086,19.285311999999976,715.15565835803,51.43810999790935
"147.32.84.165",4828,"212.117.174.7",4506,6,372,6,372,0,0,15124.95099,9.012523000001238,330.2072016903137,0
"147.32.84.165",3912,"65.55.92.168",25,6,372,6,372,0,0,15124.951047,9.012515000000349,330.20749480027325,0
"147.32.84.165",4272,"216.17.3.48",25,6,372,6,372,0,0,15126.752972,9.012924999999086,330.19247358657725,0
"147.32.84.165",4849,"212.117.171.138",65500,131,13768,82,6852,49,6916,15132.161236,42.44739400000071,1291.386698556785,1303.448687568407
"147.32.84.165",4410,"74.6.136.65",25,6,372,6,372,0,0,15132.161374,10.098409000000174,294.6998878734213,0
"147.32.84.165",4850,"65.55.16.187",443,212,172605,142,11264,70,161341,15134.364519,10.276899999998932,8768.402923061367,125595.072444038
"147.32.84.165",4858,"174.133.57.141",80,17,3489,12,1428,5,2061,15134.364612,3.433576000001267,3327.14347956643,4801.9906942481875
"147.32.84.165",4427,"64.136.52.37",25,6,372,6,372,0,0,15134.364655,9.874711000000389,301.37590862151643,0
"147.32.84.165",4447,"209.85.225.27",25,6,372,6,372,0,0,15134.53064,9.711926999998468,306.4273444395195,0
"147.32.84.165",4856,"212.117.171.138",65500,146,14494,90,7364,56,7130,15134.530673,40.43394900000021,1456.9934784257578,1410.6957497522615
"147.32.84.165",4564,"205.188.103.1",25,6,372,6,372,0,0,15134.530707,9.71508200000062,306.3278313039262,0
"147.32.84.165",4866,"212.117.174.7",4506,6,372,6,372,0,0,15139.972132,8.912930999998935,333.896896542827,0
"147.32.84.165",4862,"205.188.186.167",587,104,15102,66,11860,38,3242,15140.472786,34.23015399999895,2771.825099004898,757.6945169455212
"147.32.84.165",4682,"64.12.139.193",25,6,372,6,372,0,0,15141.518868,8.868091000000277,335.58518964226994,0
"147.32.84.165",4689,"98.139.175.224",25,6,372,6,372,0,0,15141.518931,8.868115999999645,335.5842435980899,0
"147.32.84.165",4865,"212.117.171.138",65500,146,14521,92,7484,54,7037,15141.519044,33.32206099999894,1796.767612903713,1689.4513217535311
"147.32.84.165",4710,"168.95.6.58",25,6,372,6,372,0,0,15141.51911,8.867972000000009,335.5896928858139,0
"147.32.84.165",4773,"209.85.143.27",25,6,372,6,372,0,0,15142.175231,8.91284000000087,333.9003056264568,0
"147.32.84.165",4871,"93.180.203.85",6667,6,372,6,372,0,0,15143.777479,9.01293799999985,330.1919973265155,0
"147.32.84.165",4791,"65.55.37.72",25,6,372,6,372,0,0,15143.877556,9.01365000000078,330.1659150288443,0
"147.32.84.165",4872,"205.188.186.167",587,102,14608,64,11350,38,3258,15145.880415,29.1791460000004,3111.8114286140776,893.2406726365344
"147.32.84.165",4792,"209.85.225.27",25,6,372,6,372,0,0,15145.880569,9.012737999999445,330.19932455599877,0
"147.32.84.165",4906,"173.192.170.88",80,23,2371,18,1816,5,555,15147.683231,83.11839099999997,174.78682906650593,53.4177809096425
"147.32.84.165",4876,"174.133.57.141",80,17,3489,12,1428,5,2061,15147.683361,6.598980000000665,1731.1766363890856,2498.567960502735
"147.32.84.165",4811,"64.12.90.65",25,6,372,6,372,0,0,15147.683419,9.005851999998413,330.4517995632756,0
"147.32.84.165",4915,"212.117.171.138",65500,79,7837,50,4666,29,3171,15153.091133,41.876116999999795,891.3911478468785,605.7868259370878
"147.32.84.165",1049,"212.117.174.7",4506,6,372,6,372,0,0,15153.091265,9.015302000001611,330.1054141058689,0
"147.32.84.165",4965,"173.192.170.88",80,16,2023,12,1494,4,529,15153.091321,9.317445000000589,1282.7550900487468,454.2017688325214
"147.32.84.165",4812,"205.188.190.1",25,6,372,6,372,0,0,15153.091376,9.015320999998949,330.10471840108045,0
"147.32.84.165",4926,"205.188.186.167",587,108,15000,68,11622,40,3378,15155.29412,19.640889999998763,4733.797704686796,1375.9050633653414
"147.32.84.165",1533,"174.36.246.56",80,31,14333,22,2068,9,12265,15155.294238,0.500662000000375,33044.249413751415,195980.5217890044
"147.32.84.165",4820,"72.16.141.187",25,6,372,6,372,0,0,15155.394208,9.019651000000522,329.9462473658712,0
"147.32.84.165",4825,"207.154.15.61",25,6,372,6,372,0,0,15155.41515,8.998837999999523,330.7093649202439,0
"147.32.84.165",1322,"212.117.171.138",65500,89,8243,58,5162,31,3081,15160.902502,35.730507999998736,1155.7630246959116,689.8306623572458
"147.32.84.165",1551,"195.113.232.82",80,7,426,6,364,1,62,15160.902575,0.0009260000006179325,0,0
"147.32.84.165",4840,"75.126.136.141",25,6,372,6,372,0,0,15160.903337,9.028410000000804,329.6261467965827,0
"147.32.84.165",1537,"205.188.186.167",587,54,6903,34,4874,20,2029,15162.407171,32.654129999998986,1194.0909159117457,497.0887296645326
"147.32.84.165",1552,"195.113.232.82",80,70,46552,50,4434,20,42118,15162.40731,8.212555000000066,4319.240479972398,41027.91396830795
"147.32.84.165",4860,"209.85.225.27",25,6,372,6,372,0,0,15162.408262,9.042011999999886,329.13028648933863,0
"147.32.84.165",1562,"195.113.232.82",80,102,76940,76,6134,26,70806,15162.408328,8.211747999999716,5975.828776041556,68980.19763879987
"147.32.84.165",4878,"207.115.36.20",25,6,372,6,372,0,0,15162.408392,9.04201699999976,329.13010448886337,0
"147.32.84.165",1904,"212.117.171.138",65500,123,84508,74,4444,49,80064,15163.109931,2.0227629999990313,17575.95922014444,316652.0249778678
"147.32.84.165",1563,"174.36.246.56",80,17,7818,12,1890,5,5928,15163.110002,0.43455600000015693,34794.13470299464,109132.07963986891
"147.32.84.165",4880,"98.139.175.224",25,6,372,6,372,0,0,15163.230906,9.020547999998598,329.9134376315566,0
"147.32.84.165",2182,"205.188.186.167",587,55,6553,34,4456,21,2097,15163.410642,33.31639299999915,1069.9837764550593,503.53590198075847
"147.32.84.165",1569,"95.172.94.28",80,13,2064,10,1488,3,576,15163.410775,0.06873300000006566,173191.91654647153,67042.03221153737
"147.32.84.165",4883,"205.188.190.1",25,6,372,6,372,0,0,15163.428423,9.023661000001084,329.79962345655963,0
"147.32.84.165",2185,"61.28.22.201",6667,6,372,6,372,0,0,15163.428501,9.023671999999351,329.7992214256252,0
"147.32.84.165",2564,"74.125.232.192",80,23,6160,18,4886,5,1274,15164.915064,5.705197999999655,6851.295958528059,1786.4410665502962
"147.32.84.165",2583,"174.133.57.141",80,17,3489,12,1428,5,2061,15164.9233,6.326603999999861,1805.7080860443061,2606.1375107404165
"147.32.84.165",4884,"209.85.225.27",25,6,372,6,372,0,0,15165.085765,8.971669000000475,331.71085558326354,0
"147.32.84.165",2579,"174.36.246.56",80,17,7466,12,2120,5,5346,15165.085834,0.46566600000005565,36420.95407437514,91842.65117057052
"147.32.84.165",4886,"205.188.190.1",25,6,372,6,372,0,0,15165.20685,8.947570000000269,332.6042713272889,0
"147.32.84.165",2545,"212.117.171.138",65500,140,14197,86,7124,54,7073,15165.20691,33.77223699999922,1687.5399755130616,1675.4590464351327
"147.32.84.165",4887,"67.222.12.183",25,6,372,6,372,0,0,15165.206966,8.94757700000082,332.60401111940445,0
"147.32.84.165",2742,"212.117.174.7",4506,6,372,6,372,0,0,15166.92153,9.035302000000229,329.3747126548647,0
"147.32.84.165",2707,"174.36.246.56",80,36,21988,26,2956,10,19032,15168.72766,0.390557999999146,60549.26541013552,389842.22573941114
"147.32.84.165",4892,"209.85.143.27",25,6,372,6,372,0,0,15168.848651,9.011037000000215,330.26165578944233,0
"147.32.84.165",2768,"67.195.168.31",25,6,372,6,372,0,0,15174.154609,9.013904000001276,330.1566113860963,0
"147.32.84.165",4893,"213.199.180.150",25,6,372,6,372,0,0,15176.457709,9.012645999999222,330.20269519076385,0
"147.32.84.165",2769,"173.192.170.88",80,21,2605,16,2050,5,555,15176.457857,69.71972000000096,235.2275654578041,63.68356040442989
"147.32.84.165",4895,"74.6.136.65",25,6,372,6,372,0,0,15176.457931,9.012548999999126,330.20624908672215,0
"147.32.84.165",2865,"212.117.171.138",65500,161,15286,100,7996,61,7290,15181.965516,17.080638999999792,3745.0589524198,3414.3921664757804
"147.32.84.165",2951,"212.117.174.7",4506,6,372,6,372,0,0,15181.965594,8.912664000001314,333.90689921661595,0
"147.32.84.165",2898,"173.192.170.88",80,29,4429,22,2056,7,2373,15181.965621,112.62355399999979,146.04405043016163,168.56154264142683
"147.32.84.165",2975,"174.133.57.141",80,17,3489,12,1428,5,2061,15181.965649,0.7333440000002156,15577.955229737532,22483.30933367581
"147.32.84.165",4896,"98.139.175.224",25,6,372,6,372,0,0,15182.119644,8.859182000000146,335.9226619342453,0
"147.32.84.165",2899,"64.12.175.136",587,105,14912,66,11594,39,3318,15182.11968,16.954083000000537,5470.776567508668,1565.6405598580093
"147.32.84.165",4897,"64.12.90.65",25,6,372,6,372,0,0,15182.237924,8.840554000000338,336.63048718438756,0
"147.32.84.165",4898,"64.12.139.193",25,6,372,6,372,0,0,15183.467658,8.913311000000249,333.88266156088537,0
"147.32.84.165",3527,"212.117.171.138",65500,87,8198,56,5042,31,3156,15184.269099,46.313061000000744,870.9422164948103,545.1593881907221
"147.32.84.165",4899,"209.85.225.27",25,6,372,6,372,0,0,15184.269199,8.914639000000534,333.8329235765825,0
"147.32.84.165",3969,"64.12.175.136",587,116,15164,72,11530,44,3634,15185.971116,13.170173999998951,7003.703975361855,2207.411990153077
"147.32.84.165",4900,"207.115.37.23",25,6,372,6,372,0,0,15185.971258,8.91269099999954,333.90588768309743,0
"147.32.84.165",4272,"94.53.69.3",6667,6,372,6,372,0,0,15186.17202,8.912206000000879,333.9240587571367,0
"147.32.84.165",1302,"98.139.175.224",25,6,372,6,372,0,0,15187.974519,8.912274000000252,333.92151094096926,0
"147.32.84.165",1661,"205.188.190.1",25,6,372,6,372,0,0,15189.776676,9.013608999999633,330.1674168471387,0
"147.32.84.165",4809,"212.117.174.7",4506,6,372,6,372,0,0,15195.084325,9.014338000000862,330.1407158240256,0
"147.32.84.165",4631,"212.117.171.138",65500,45,4174,28,3094,17,1080,15197.387586,10.830965999999535,2285.2993906546344,797.7127801897237
"147.32.84.165",4758,"174.133.57.141",80,17,3489,12,1428,5,2061,15197.387717,6.996220000000903,1632.8817561481092,2356.701190070906
"147.32.84.165",1979,"64.136.44.37",25,6,372,6,372,0,0,15197.387781,9.013028999999733,330.18866354475153,0
"147.32.84.165",4752,"64.12.175.136",587,57,6821,38,4844,19,1977,15197.543207,33.134344000000056,1169.541790234324,477.3295043958007
"147.32.84.165",1996,"209.85.225.27",25,6,372,6,372,0,0,15197.543242,8.958007999999609,332.21671603777645,0
"147.32.84.165",2061,"68.6.19.3",25,6,372,6,372,0,0,15197.543269,8.958083999999872,332.2138975254131,0
"147.32.84.165",4845,"65.54.188.72",25,6,372,6,372,0,0,15203.095671,9.013451000000714,330.17320446960485,0
"147.32.84.165",4823,"173.192.170.88",80,6,372,6,372,0,0,15204.397819,9.013114999999743,330.1855129996771,0
"147.32.84.165",2080,"205.188.103.1",25,6,372,6,372,0,0,15204.397897,9.01316499999848,330.1836813151098,0
"147.32.84.165",4842,"212.117.171.138",65500,83,7884,54,4906,29,2978,15205.198741,38.242879999999786,1026.2825393903445,622.9656343873718
"147.32.84.165",2082,"208.65.145.12",25,6,372,6,372,0,0,15205.19888,9.013386000000537,330.17558551246145,0
"147.32.84.165",1322,"173.192.170.88",80,6,372,6,372,0,0,15206.901147,9.013042999999016,330.18815066125006,0
"147.32.84.165",4848,"64.12.175.136",587,24,2237,16,1054,8,1183,15206.901246,1.4130980000009004,5967.031302849928,6697.341585646551
"147.32.84.165",2652,"209.191.88.254",25,6,372,6,372,0,0,15206.901277,9.01304799999889,330.1879674889523,0
"147.32.84.165",1114,"178.125.252.68",6667,9,552,6,372,3,180,15207.001396,1.071063999999751,2778.545446397873,1344.457474063487
"147.32.84.165",1551,"212.117.174.7",4506,6,372,6,372,0,0,15208.072718,8.944166999999652,332.73081774972627,0
"147.32.84.165",2764,"209.85.143.27",25,6,372,6,372,0,0,15208.072781,8.944240999999238,332.7280649079395,0
"147.32.84.165",3039,"209.85.225.27",25,6,372,6,372,0,0,15208.904191,9.014380000000529,330.1391776250641,0
"147.32.84.165",1537,"212.117.171.138",65500,109,10773,68,5870,41,4903,15210.806948,39.81144099999983,1179.560418322969,985.2444175532397
"147.32.84.165",3041,"205.188.103.1",25,6,372,6,372,0,0,15210.807081,9.012844999999288,330.19540444778926,0
"147.32.84.165",1552,"64.12.175.136",587,54,6517,34,4488,20,2029,15210.807141,32.729740000000675,1096.9839662642985,495.94038938285684
"147.32.84.165",3050,"67.231.152.68",25,6,372,6,372,0,0,15210.80721,9.012805999998818,330.1968332615159,0
"147.32.84.165",1789,"173.192.170.88",80,18,2928,14,2400,4,528,15216.115497,10.143243999998958,1892.8855502245606,416.4348210494033
"147.32.84.165",1904,"174.133.57.141",80,17,2011,12,1428,5,583,15216.115645,210.94928600000094,54.155196334724494,22.10957945598346
"147.32.84.165",4903,"38.113.116.194",25,6,372,6,372,0,0,15216.27423,8.95332899999994,332.3903321323298,0
"147.32.84.165",2182,"212.117.171.138",65500,155,15066,98,7860,57,7206,15218.418077,31.76294599999892,1979.6652363418098,1814.9449991194758
"147.32.84.165",4905,"65.54.188.110",25,6,372,6,372,0,0,15218.418228,9.012638999998671,330.20295165494133,0
"147.32.84.165",2545,"64.12.175.136",587,76,10299,50,7848,26,2451,15218.51829,32.196255999999266,1950.0404022132707,609.0149115474932
"147.32.84.165",4907,"209.85.225.27",25,6,372,6,372,0,0,15218.518429,9.012571999999636,330.20540640342404,0
"147.32.84.165",2579,"178.123.10.51",6667,9,552,6,372,3,180,15218.518497,1.5508670000017446,1918.9266390971322,928.5128898857091
"147.32.84.165",4908,"205.188.190.1",25,6,372,6,372,0,0,15220.069611,8.956046999999671,332.2894576145156,0
"147.32.84.165",2744,"212.117.174.7",4506,6,372,6,372,0,0,15224.125977,9.013514000000214,330.1708967224025,0
"147.32.84.165",2742,"68.67.185.217",80,13,2276,10,1304,3,972,15225.428592,8.236638000000312,1266.5361765321732,944.0745119549633
"147.32.84.165",2768,"68.67.185.217",80,16,2560,12,1528,4,1032,15225.45265,10.083387000000585,1212.2910684673009,818.7725017396954
"147.32.84.165",2865,"173.192.170.88",80,22,3102,18,2856,4,246,15225.452681,45.369886999998926,503.5939366567199,43.37678866160823
"147.32.84.165",4909,"209.85.143.27",25,6,372,6,372,0,0,15225.452707,8.990550999998959,331.01419479188144,0
"147.32.84.165",2716,"212.117.171.138",65500,154,14996,94,7636,60,7360,15225.452734,24.857562999999573,2457.521680624969,2368.695595783103
"147.32.84.165",4910,"210.8.231.6",25,6,372,6,372,0,0,15225.452767,8.99062099999901,331.01161755126014,0
"147.32.84.165",2899,"64.12.175.136",587,108,14996,68,11610,40,3386,15226.228994,24.0465920000006,3862.5015968997886,1126.4797938934266
"147.32.84.165",2951,"68.67.185.209",80,13,2502,10,1680,3,822,15226.229156,7.436170000000857,1807.3820259620816,884.3262055600185
"147.32.84.165",2975,"68.67.185.209",80,16,2786,12,1904,4,882,15226.258509,14.823562000001402,1027.5532965692428,475.99895355781103
"147.32.84.165",4948,"41.208.31.213",25,6,372,6,372,0,0,15226.258545,8.98690600000009,331.14845086840455,0
"147.32.84.165",3969,"217.163.21.37",80,19,6539,12,1450,7,5089,15227.93255,0.18847699999969336,61545.971126550576,216005.13590552818
"147.32.84.165",4272,"217.163.21.37",80,21,6763,14,1674,7,5089,15227.979082,0.18845499999952153,71062.05725522805,216030.35207398777
"147.32.84.165",1993,"168.95.6.57",25,6,372,6,372,0,0,15227.979146,8.973267000001215,331.65178301276416,0
"147.32.84.165",4447,"212.117.171.138",65500,114,84022,74,4444,40,79578,15229.025762,8.274285999999847,4296.684934506815,76940.05259185043
"147.32.84.165",4564,"217.163.21.37",80,15,2336,10,1450,5,886,15229.025805,0.1573610000014014,73715.85081371301,45042.92677306878
"147.32.84.165",4689,"217.163.21.37",80,15,2440,10,1554,5,886,15229.071778,0.14070900000115216,88352.5574049862,50373.46580490204
"147.32.84.165",2083,"205.188.190.1",25,6,372,6,372,0,0,15229.071823,8.983954999999696,331.25722468557564,0
"147.32.84.165",4521,"64.12.175.136",587,118,15542,76,12028,42,3514,15229.07186,21.33305499999915,4510.558848697659,1317.7671927438953
"147.32.84.165",4682,"195.113.232.96",80,13,1772,10,1228,3,544,15229.071898,4.593521000000692,2138.664436278515,947.4213789377135
"147.32.84.165",4710,"195.113.232.96",80,13,1876,10,1332,3,544,15229.072935,13.018753000000288,818.511573266638,334.28700890169
"147.32.84.165",2091,"209.85.225.27",25,6,372,6,372,0,0,15229.072978,8.982928999999785,331.2950597739413,0
"147.32.84.165",2096,"64.12.139.193",25,6,372,6,372,0,0,15229.073023,8.982936999998856,331.29476473010766,0
"147.32.84.165",4758,"77.238.167.32",80,13,2615,10,1564,3,1051,15229.928878,0.14039299999967625,89121.25248430372,59889.025806268044
"147.32.84.165",4773,"77.238.167.32",80,13,2719,10,1668,3,1051,15229.975375,0.14115700000002107,94533.03768143279,59564.88165658625
"147.32.84.165",2098,"74.125.113.27",25,6,372,6,372,0,0,15229.975447,8.98341900000014,331.2769893066274,0
"147.32.84.165",4792,"80.191.187.36",6667,9,552,6,372,3,180,15231.835232,3.65398500000083,814.4532613022013,394.09028772687157
"147.32.84.165",4812,"173.192.170.88",80,6,372,6,372,0,0,15235.489433,8.894259999999122,334.59781926774053,0
"147.32.84.165",4840,"212.117.174.7",4506,6,372,6,372,0,0,15235.489465,8.894350999999006,334.59439592617076,0
"147.32.84.165",4811,"217.163.21.37",80,17,3792,12,1766,5,2026,15235.489492,0.25717599999916274,54935.141693027326,63022.98814839941
"147.32.84.165",2139,"161.58.16.34",25,6,372,6,372,0,0,15235.535423,8.848445999999967,336.3302437512769,0
"147.32.84.165",4856,"195.113.232.96",80,34,22982,28,2424,6,20558,15237.25377,4.838082000000213,4008.1999436965198,33993.63632116875
"147.32.84.165",2827,"165.21.74.122",25,6,372,6,372,0,0,15237.253904,8.932568000000174,333.16287096834213,0
"147.32.84.165",4853,"212.117.171.138",65500,105,76188,68,4084,37,72104,15239.460238,7.9793659999995725,4094.5608961917214,72290.45515646618
"147.32.84.165",4860,"217.163.21.34",80,15,1912,10,1238,5,674,15239.460336,0.1394639999998617,71014.74215575217,38662.3071187213
"147.32.84.165",4866,"173.192.170.88",80,26,2555,20,1936,6,619,15239.506197,89.60109499999999,172.85503039890307,55.26718172361622
"147.32.84.165",3056,"66.96.60.82",25,6,372,6,372,0,0,15239.50626,8.883367000000362,335.0081112262815,0
"147.32.84.165",4862,"69.16.175.10",80,13,1945,10,1250,3,695,15241.065108,1.0269009999992704,9738.037064923596,5414.348608097519
"147.32.84.165",3072,"209.85.143.27",25,6,372,6,372,0,0,15241.081889,8.909850000000006,334.01235711038885,0
"147.32.84.165",4878,"173.192.170.88",80,22,3540,18,3294,4,246,15245.084703,45.465682000000015,579.6019951927696,43.285394905106656
"147.32.84.165",3866,"205.188.103.1",25,6,372,6,372,0,0,15245.084802,9.01295300000129,330.19144779736166,0
"147.32.84.165",4892,"173.192.170.88",80,6,372,6,372,0,0,15246.386484,9.013392999999269,330.1753290908586,0
"147.32.84.165",4883,"173.192.170.88",80,6,372,6,372,0,0,15246.386616,9.013338000000658,330.1773438430671,0
"147.32.84.165",4884,"173.192.170.88",80,6,372,6,372,0,0,15246.386681,9.013301000000865,330.17869923568674,0
"147.32.84.165",4880,"188.72.216.51",6667,9,552,6,372,3,180,15246.386744,1.0216110000001208,2913.046159447821,1409.5384642489457
"147.32.84.165",4886,"173.192.170.88",80,81,9621,48,3772,33,5849,15247.187622,48.59081900000092,621.022666853988,962.9802699970774
"147.32.84.165",4894,"209.85.225.27",25,6,372,6,372,0,0,15247.18773,9.01372900000024,330.16302132002426,0
"147.32.84.165",4911,"205.188.103.1",25,6,372,6,372,0,0,15247.408615,8.992356999999174,330.9477148205163,0
"147.32.84.165",4896,"212.117.171.138",65500,87,8336,56,5042,31,3294,15247.408679,44.08187100000032,915.0246821420013,597.7967677460834
"147.32.84.165",4912,"80.179.55.150",25,6,372,6,372,0,0,15247.408738,8.99236000000019,330.94760441084844,0
"147.32.84.165",3061,"209.85.143.27",25,6,372,6,372,0,0,15248.890765,9.0122080000001,330.21874328688006,0
"147.32.84.165",3062,"205.188.190.1",25,6,372,6,372,0,0,15248.890867,9.01220900000044,330.2187066456021,0
"147.32.84.165",4918,"209.85.225.27",25,6,372,6,372,0,0,15249.991851,9.01332199999888,330.1779299574973,0
"147.32.84.165",3095,"77.238.177.9",25,6,372,6,372,0,0,15249.991882,9.013387999999395,330.1755122491343,0
"147.32.84.165",4898,"212.117.174.7",4506,6,372,6,372,0,0,15250.89349,9.01242099999945,330.2109388809269,0
"147.32.84.165",1302,"174.133.57.141",80,16,3429,12,1428,4,2001,15256.401173,0.5315460000001622,21492.025149274974,30115.92599698825
"147.32.84.165",3098,"64.12.90.65",25,6,372,6,372,0,0,15256.401234,9.012878999999884,330.19415882539175,0
"147.32.84.165",1322,"173.192.170.88",80,6,372,6,372,0,0,15258.204087,9.012502999999924,330.20793446615494,0
"147.32.84.165",4919,"209.85.143.27",25,6,372,6,372,0,0,15258.204229,9.012483999998949,330.20863060620655,0
"147.32.84.165",1533,"64.12.168.40",587,56,7027,36,4990,20,2037,15258.2043,33.38035300000047,1195.9130570009083,488.19136214646295
"147.32.84.165",3071,"98.139.175.225",25,6,372,6,372,0,0,15258.322145,8.994446000000607,330.87085074498185,0
"147.32.84.165",1551,"195.70.198.9",6667,4,248,4,248,0,0,15260.406738,3.0045650000010937,660.3285334147465,0
"147.32.84.165",1789,"212.117.174.7",4506,6,372,6,372,0,0,15262.009162,9.013343999999051,330.1771240507755,0
"147.32.84.165",3148,"205.188.103.1",25,6,372,6,372,0,0,15262.009277,9.01335300000028,330.1767943627535,0
"147.32.84.165",1661,"212.117.171.138",65500,162,15642,104,8220,58,7422,15262.009307,33.59263800000008,1957.5717751014329,1767.5301356207829
"147.32.84.165",4690,"24.113.32.85",25,6,372,6,372,0,0,15262.009336,9.013343000000532,330.1771606827594,0
"147.32.84.165",4921,"205.188.103.1",25,6,372,6,372,0,0,15266.115348,9.012408000000505,330.21141519556517,0
"147.32.84.165",2096,"173.192.170.88",80,22,3102,18,2856,4,246,15268.217913,45.39058300000033,503.3643211852959,43.35701085839734
"147.32.84.165",2181,"173.192.170.88",80,22,2782,18,2536,4,246,15268.218014,45.39052500000071,446.96552859874794,43.35706625997319
"147.32.84.165",2098,"173.192.170.88",80,43,6449,30,3134,13,3315,15268.218042,84.51240999999936,296.6664895723621,313.8000679426868
"147.32.84.165",2061,"212.117.171.138",65500,154,15192,98,7844,56,7348,15268.218069,27.792176999999356,2257.901567048938,2115.127577087659
"147.32.84.165",2083,"174.133.57.141",80,17,3489,12,1428,5,2061,15268.2181,5.026776000000609,2272.6296138914117,3280.0347578642854
"147.32.84.165",4904,"64.12.139.193",25,6,372,6,372,0,0,15268.218132,9.013189999999668,330.1827654803804,0
"147.32.84.165",2082,"64.12.168.40",587,116,15778,72,12152,44,3626,15268.418088,27.27870299999995,3563.805801177577,1063.3936664804062
"147.32.84.165",4920,"205.188.103.1",25,6,372,6,372,0,0,15268.418194,9.013116000000082,330.1854763657733,0
"147.32.84.165",3307,"209.85.225.27",25,6,372,6,372,0,0,15268.418226,9.013208000000304,330.18210608252906,0
"147.32.84.165",2652,"217.72.192.149",25,6,372,6,372,0,0,15269.920259,9.012973999999303,330.1906784597659,0
"147.32.84.165",4923,"205.188.103.1",25,6,372,6,372,0,0,15271.022749,9.012366999999358,330.21291742782023,0
"147.32.84.165",2579,"64.12.168.40",587,110,15504,70,12126,40,3378,15271.022812,25.082190000000992,3867.604862254698,1077.4178809744656
"147.32.84.165",4924,"207.115.37.23",25,6,372,6,372,0,0,15271.022868,9.012338000000454,330.2139799905252,0
"147.32.84.165",2707,"212.117.171.138",65500,115,11659,72,6206,43,5453,15271.923499,47.19661199999973,1051.9399146701521,924.303634337148
"147.32.84.165",3451,"209.85.225.27",25,6,372,6,372,0,0,15271.923599,9.012828000000809,330.19602726244557,0
"147.32.84.165",4925,"205.188.103.1",25,6,372,6,372,0,0,15271.923627,9.012894999999844,330.19357265340955,0
"147.32.84.165",4927,"205.178.149.7",25,6,372,6,372,0,0,15271.923654,9.012896000000183,330.19353601771724,0
"147.32.84.165",2769,"212.117.174.7",4506,6,372,6,372,0,0,15277.431497,9.013032000000749,330.1885536409671,0
"147.32.84.165",2742,"208.73.210.29",80,72,39308,44,6632,28,32676,15279.33576,12.19682400000056,4349.984881309885,21432.464713763842
"147.32.84.165",2146,"65.55.37.104",25,6,372,6,372,0,0,15279.52155,8.925334999999905,333.43286274409104,0
"147.32.84.165",2768,"212.117.171.138",65500,50,15340,32,10624,18,4716,15279.934685,30.313984000000346,2803.7225328085888,1244.5741213032102
"147.32.84.165",4922,"64.12.139.193",25,6,372,6,372,0,0,15279.934788,9.013130999999703,330.1849268583912,0
"147.32.84.165",2951,"120.63.27.163",6667,6,372,6,372,0,0,15279.934822,9.013238000001365,330.18100709196284,0
"147.32.84.165",3527,"74.125.232.217",80,13,2940,10,2066,3,874,15283.03923,8.493775999999343,1945.8954415564147,823.1910048016972
"147.32.84.165",4272,"174.133.57.141",80,17,3489,12,1428,5,2061,15283.047466,3.2517360000001645,3513.2003336062403,5070.522330225814
"147.32.84.165",4929,"124.108.110.37",25,6,372,6,372,0,0,15283.047529,9.00485099999969,330.48853334720394,0
"147.32.84.165",3050,"64.12.168.40",587,79,11385,50,8706,29,2679,15287.14566,32.070723000000726,2171.700338654617,668.2730539002664
"147.32.84.165",4447,"67.214.158.5",80,15,2553,10,1704,5,849,15287.145797,0.31494500000007974,43283.74795598136,21565.670196378036
"147.32.84.165",3508,"98.139.175.224",25,6,372,6,372,0,0,15287.249172,9.00919900000008,330.3290336910055,0
"147.32.84.165",4682,"212.117.174.7",4506,6,372,6,372,0,0,15289.248592,9.012536000000182,330.2067253878309,0
"147.32.84.165",4521,"195.113.232.83",80,13,2136,10,1548,3,588,15289.248692,2.2841070000013133,5421.812550809957,2059.448178214635
"147.32.84.165",4931,"124.108.110.37",25,6,372,6,372,0,0,15289.249466,9.011787999999797,330.23413333736517,0
"147.32.84.165",4564,"50.22.198.84",80,13,3359,10,2328,3,1031,15289.249544,0.36756599999898754,50668.45138029986,22439.507462667167
"147.32.84.165",4928,"209.85.225.27",25,6,372,6,372,0,0,15289.370544,8.991017000000284,330.9970384885165,0
"147.32.84.165",4752,"173.192.170.88",80,18,2885,14,2356,4,529,15289.370586,18.91709400000036,996.3475362547567,223.71300792816905
"147.32.84.165",4631,"67.214.158.5",80,15,2640,10,1748,5,892,15289.370625,0.3264630000012403,42834.86949500211,21858.526080973614
"147.32.84.165",3423,"209.131.7.142",25,6,372,6,372,0,0,15289.448812,9.012479999999414,330.2087771623564,0
"147.32.84.165",4935,"98.139.175.224",25,6,372,6,372,0,0,15289.47414,8.987277000000176,331.13478086854803,0
"147.32.84.165",4930,"209.85.225.27",25,6,372,6,372,0,0,15289.474203,8.98726600000009,331.1351861622845,0
"147.32.84.165",4792,"173.192.170.88",80,6,372,6,372,0,0,15290.95095,9.008169999999154,330.366767057047,0
"147.32.84.165",4758,"50.22.198.84",80,13,2952,10,2432,3,520,15290.951086,0.37071300000025076,52482.648302020265,11221.618880366175
"147.32.84.165",4936,"77.238.177.9",25,6,372,6,372,0,0,15291.072316,8.986245000000054,331.17280910992105,0
"147.32.84.165",4933,"205.188.103.1",25,6,372,6,372,0,0,15292.052516,9.009721000000354,330.30989527865324,0
"147.32.84.165",4938,"209.85.225.27",25,6,372,6,372,0,0,15292.953951,9.01057800000126,330.2784793605453,0
"147.32.84.165",4940,"98.139.175.224",25,6,372,6,372,0,0,15292.954056,9.010564000000159,330.27899252476846,0
"147.32.84.165",3687,"65.54.188.110",25,6,372,6,372,0,0,15292.954085,9.010557999999946,330.2792124527713,0
"147.32.84.165",4839,"174.36.246.56",80,27,14396,22,2056,5,12340,15298.46155,0.4197380000005069,39186.349579928756,235194.33551377474
"147.32.84.165",4850,"67.195.168.31",25,6,372,6,372,0,0,15298.582431,8.901794999999765,334.3145961011322,0
"147.32.84.165",4848,"173.192.170.88",80,6,372,6,372,0,0,15300.460363,8.945665999999619,332.675062985822,0
"147.32.84.165",4849,"174.133.57.141",80,17,3489,12,1428,5,2061,15300.460468,0.7712250000004133,14812.797821639442,21378.975007282133
"147.32.84.165",4942,"64.12.90.65",25,6,372,6,372,0,0,15300.4605,8.945666999999958,332.67502579740716,0
"147.32.84.165",4811,"212.117.171.138",65500,80,7868,50,4666,30,3202,15300.560344,44.58732200000122,837.1886519670093,574.5130869263531
"147.32.84.165",4860,"195.113.232.82",80,7,426,6,364,1,62,15300.560419,0.0010309999997843988,0,0
"147.32.84.165",3690,"66.52.116.75",25,6,372,6,372,0,0,15300.561228,9.045172000000093,329.01530230712797,0
"147.32.84.165",4907,"208.73.210.29",80,72,39409,44,6662,28,32747,15303.971099,19.624868999999308,2715.737873205772,13349.184649334946
"147.32.84.165",4905,"212.117.174.7",4506,6,372,6,372,0,0,15304.158451,8.948774000000412,332.5595215612622,0
"147.32.84.165",4856,"65.55.196.251",443,36,13772,26,8824,10,4948,15308.185899,2.142214999999851,32952.80819152368,18478.0705951563
"147.32.84.165",4948,"173.192.170.88",80,16,2113,12,1584,4,529,15308.286406,11.392959000000701,1112.265917923449,371.45749405398016
"147.32.84.165",4862,"195.113.232.82",80,53,39955,40,2822,13,37133,15308.286472,1.0902850000002218,20706.5125173651,272464.53908834804
"147.32.84.165",3723,"209.85.225.27",25,6,372,6,372,0,0,15308.287279,9.033747999999832,329.4313722277902,0
"147.32.84.165",1302,"74.125.232.217",80,13,2942,10,2068,3,874,15308.287341,15.308854000000792,1080.681806750469,456.72915817210344
"147.32.84.165",4895,"62.178.214.33",6667,2,124,2,124,0,0,15308.295465,7.0000005507608876e-06,0,0
"147.32.84.165",1979,"174.36.246.56",80,28,14971,22,2230,6,12741,15310.407625,0.4711650000008376,37863.593433231,216331.8582658279
"147.32.84.165",4939,"209.85.143.27",25,6,372,6,372,0,0,15310.407767,9.020317999998952,329.921849761876,0
"147.32.84.165",1533,"67.214.158.5",80,15,2555,10,1706,5,849,15310.528657,0.3185589999993681,42842.92705598358,21321.01117850531
"147.32.84.165",3757,"212.50.215.90",25,6,372,6,372,0,0,15310.632148,8.99648199999865,330.7959711363227,0
"147.32.84.165",1551,"50.22.198.84",80,14,3424,10,2332,4,1092,15312.004215,0.3823839999986376,48788.652245037636,22846.144190214876
"147.32.84.165",4903,"212.117.171.138",65500,78,7499,50,4552,28,2947,15312.125346,12.118030999999974,3005.108668231669,1945.530589911847
"147.32.84.165",2061,"195.113.232.82",80,7,426,6,364,1,62,15312.12547,0.0013249999992694939,0,0
"147.32.84.165",2545,"174.133.57.141",80,17,3489,12,1428,5,2061,15312.1263,4.696045000000595,2432.685376736925,3511.0396088619063
"147.32.84.165",3764,"205.188.103.1",25,6,372,6,372,0,0,15312.126375,9.00704500000029,330.40803060270093,0
"147.32.84.165",1569,"195.113.232.88",80,13,2138,10,1550,3,588,15312.126451,11.46993300000031,1081.0873960640977,410.11573476496096
"147.32.84.165",2139,"205.188.186.137",587,55,6895,34,4806,21,2089,15312.127253,33.11510499999895,1161.0411623336608,504.66395924157666
"147.32.84.165",2082,"195.113.232.82",80,126,103810,96,7100,30,96710,15312.244999,12.487827999999354,4548.42907829952,61954.72903695022
"147.32.84.165",4934,"180.222.96.138",25,6,372,6,372,0,0,15312.24618,8.987814000000071,331.1149963717514,0
"147.32.84.165",1996,"67.214.158.5",80,15,2642,10,1750,5,892,15313.006639,0.34505300000091665,40573.47711790017,20680.8809080954
"147.32.84.165",2083,"195.113.232.82",80,57,42383,42,3548,15,38835,15313.110585,11.622444000000542,2442.1713711848106,26731.038669662383
"147.32.84.165",3613,"209.85.225.27",25,6,372,6,372,0,0,15313.110662,9.025824000000284,329.7205883916977,0
"147.32.84.165",2652,"50.22.198.84",80,14,3016,10,2436,4,580,15313.909574,0.373304000000644,52204.101750761794,12429.548035895665
"147.32.84.165",2146,"95.172.94.36",80,13,2074,10,1498,3,576,15314.03064,0.05774399999972957,207536.7137720997,79800.49875349093
"147.32.84.165",2827,"173.192.170.88",80,6,372,6,372,0,0,15314.048571,8.991128000001481,330.992952163456,0
"147.32.84.165",3681,"98.139.175.224",25,6,372,6,372,0,0,15314.048648,8.991169999999329,330.99140601281283,0
"147.32.84.165",2742,"68.67.185.208",80,13,2066,10,1156,3,910,15319.529176,4.067700999999943,2273.52010386214,1789.70873227902
"147.32.84.165",2951,"212.117.171.138",65500,80,7793,52,4770,28,3023,15319.558272,44.77093799999966,852.3386309216995,540.1718409384272
"147.32.84.165",2182,"174.36.246.56",80,18,7972,14,2076,4,5896,15319.558308,0.39869700000053854,41655.693421263684,118305.37977445601
"147.32.84.165",3062,"212.117.174.7",4506,6,372,6,372,0,0,15319.679138,8.988837000000785,331.0773128937303,0
"147.32.84.165",3072,"65.54.188.72",25,6,372,6,372,0,0,15319.679202,8.988902000000962,331.0749188276479,0
"147.32.84.165",4947,"66.94.237.139",25,6,372,6,372,0,0,15320.330809,9.037543000000369,329.29303904832085,0
"147.32.84.165",2769,"68.67.185.208",80,13,2038,10,1156,3,882,15321.435383,2.161181999999826,4279.139841068797,3264.880051749722
"147.32.84.165",3056,"205.188.186.137",587,51,6328,32,4416,19,1912,15321.435516,2.9019900000002963,12173.715278135483,5270.865854120255
"147.32.84.165",3098,"74.125.232.196",80,18,4292,14,3402,4,890,15321.435574,3.297643000001699,8253.167489623946,2159.1178911714615
"147.32.84.165",4950,"98.139.175.224",25,6,372,6,372,0,0,15321.44373,9.026448999999047,329.6977582214572,0
"147.32.84.165",3095,"94.245.121.176",80,13,2280,10,1200,3,1080,15321.443763,0.13248600000042643,72460.48639078168,65214.4377517035
"147.32.84.165",3451,"78.249.161.87",6667,6,372,6,372,0,0,15321.480454,8.989816999999675,331.04122141753356,0
"147.32.84.165",3148,"174.36.246.56",80,19,8449,14,2284,5,6165,15321.63523,0.41567899999972724,43956.99566254728,118649.24617320664
"147.32.84.165",4272,"173.192.170.88",80,28,3029,22,2408,6,621,15321.756069,131.67325600000004,146.30153901563727,37.72975736242141
"147.32.84.165",3887,"212.27.48.7",25,6,372,6,372,0,0,15321.756134,9.014377999999851,330.13925087233406,0
"147.32.84.165",4564,"173.192.170.88",80,18,2523,14,1994,4,529,15325.162403,9.01101799999924,1770.2772317180306,469.64726959821377
"147.32.84.165",4951,"209.85.143.27",25,6,372,6,372,0,0,15325.162476,9.009711000000607,330.3102618940607,0
"147.32.84.165",3866,"212.117.171.138",65500,344,333034,254,326786,90,6248,15325.162507,19.876657000000705,131525.53771994493,2514.7085850502035
"147.32.84.165",4952,"98.139.175.224",25,6,372,6,372,0,0,15325.162538,9.009750999999596,330.3087954373138,0
"147.32.84.165",4953,"209.85.143.27",25,6,372,6,372,0,0,15325.162564,9.009750999999596,330.3087954373138,0
"147.32.84.165",4949,"205.188.190.1",25,6,372,6,372,0,0,15325.162594,9.0097480000004,330.3089054210915,0
"147.32.84.165",4878,"212.117.174.7",4506,6,372,6,372,0,0,15331.471899,9.89808500000072,300.66421939191105,0
"147.32.84.165",4839,"173.192.170.88",80,6,372,6,372,0,0,15331.671999,10.147985999999946,293.2601601933641,0
"147.32.84.165",4758,"205.188.186.137",587,52,6589,32,4568,20,2021,15331.672098,32.7518310000014,1115.7849464965313,493.65179003272544
"147.32.84.165",4849,"173.192.170.88",80,6,372,6,372,0,0,15331.672131,10.151074000001245,293.1709492019894,0
"147.32.84.165",4860,"174.36.246.56",80,27,15181,20,2286,7,12895,15331.672162,0.49269599999934144,37118.2230016571,209378.60262745767
"147.32.84.165",4822,"174.133.57.141",80,17,3489,12,1428,5,2061,15331.793029,1.6675869999999122,6850.61708924368,9887.340210736153
"147.32.84.165",3985,"65.54.188.110",25,6,372,6,372,0,0,15331.793062,10.033309999998892,296.61198547641095,0
"147.32.84.165",4884,"195.113.232.97",80,21,2997,16,2228,5,769,15333.269096,11.533325000000332,1545.4346426550442,533.4107900366827
"147.32.84.165",4955,"74.125.113.27",25,6,372,6,372,0,0,15333.270164,9.937824000000546,299.46193452408056,0
"147.32.84.165",4791,"212.117.171.138",65500,81,45626,56,3364,25,42262,15334.172383,8.984809999999925,2995.277585168771,37629.73284910898
"147.32.84.165",4886,"195.113.232.97",80,54,43743,42,2942,12,40801,15334.172417,10.59517600000072,2221.388299731727,30807.22774213263
"147.32.84.165",4046,"209.85.143.27",25,6,372,6,372,0,0,15334.172446,9.918723999999202,300.0385936739685,0
"147.32.84.165",4896,"65.55.196.251",443,200,169811,136,9848,64,159963,15334.974729,10.143151000000216,7767.211589376745,126164.34478792366
"147.32.84.165",4904,"173.192.170.88",80,6,372,6,372,0,0,15335.075239,9.711177000001044,306.45101000627216,0
"147.32.84.165",4892,"95.172.94.36",80,13,1965,10,1576,3,389,15335.07531,0.054662000000462285,230653.83630114837,56931.68929006771
"147.32.84.165",4959,"216.33.127.20",25,6,372,6,372,0,0,15335.093091,9.696498999999676,306.91489784097325,0
"147.32.84.165",4894,"174.36.246.56",80,18,7514,14,2230,4,5284,15340.593445,4.059037999999418,4395.130077620007,10414.290282575836
"147.32.84.165",4081,"209.85.225.27",25,6,372,6,372,0,0,15341.095555,9.03119499999957,329.5244981422881,0
"147.32.84.165",4911,"212.117.171.138",65500,335,332310,248,325714,87,6596,15341.295597,20.789671999998973,125336.84995127046,2538.1833825950985
"147.32.84.165",4960,"98.139.175.224",25,6,372,6,372,0,0,15341.295728,9.031196000001728,329.5244616548495,0
"147.32.84.165",4913,"79.113.190.202",6667,6,372,6,372,0,0,15341.927996,8.999949999999444,330.66850371392997,0
"147.32.84.165",4961,"98.139.175.224",25,6,372,6,372,0,0,15342.700114,9.030115000001388,329.5639092081931,0
"147.32.84.165",4956,"209.85.143.27",25,6,372,6,372,0,0,15342.70024,9.030045999999857,329.56642745784984,0
"147.32.84.165",4009,"17.148.17.53",25,6,372,6,372,0,0,15342.700317,9.029994999998962,329.56828879754,0
"147.32.84.165",4922,"212.117.174.7",4506,6,372,6,372,0,0,15346.120523,10.402855000000272,286.0753129789776,0
"147.32.84.165",4918,"174.133.57.141",80,17,3489,12,1428,5,2061,15346.120655,4.036511000000246,2830.166943679654,4084.715735941013
"147.32.84.165",3952,"76.96.62.116",25,6,372,6,372,0,0,15346.120714,10.405847999998514,285.9930300731305,0
"147.32.84.165",1302,"173.192.170.88",80,18,2429,14,1930,4,499,15352.429957,35.40151700000024,436.13950215748935,112.76352931429388
"147.32.84.165",4924,"212.117.171.138",65500,70,42046,46,2764,24,39282,15352.430052,4.543330000000424,4866.914795975185,69168.6494267356
"147.32.84.165",4132,"98.139.175.224",25,6,372,6,372,0,0,15352.43008,9.399293000000398,316.6195585135897,0
"147.32.84.165",4925,"65.55.196.251",443,210,171051,138,11024,72,160027,15352.430107,9.73494799999935,9059.31906364635,131507.22530824874
"147.32.84.165",4962,"63.236.74.14",25,6,372,6,372,0,0,15352.531954,9.300623999999516,319.97853047281075,0
"147.32.84.165",4964,"129.67.1.171",25,6,372,6,372,0,0,15352.730065,9.118172000000413,326.38120886509546,0
"147.32.84.165",1979,"173.192.170.88",80,16,1581,12,1084,4,497,15354.232654,82.50808599999982,105.10484996585691,48.18921626663366
"147.32.84.165",1996,"173.192.170.88",80,23,3093,18,2532,5,561,15354.232754,40.12236099999973,504.85563399422426,111.85782411957338
"147.32.84.165",4967,"12.102.252.75",25,6,372,6,372,0,0,15354.232783,9.012478000000556,330.2088504404467,0
"147.32.84.165",2082,"212.117.171.138",65500,13,786,10,604,3,182,15355.133599,7.210723000000144,670.1131079365972,201.92149941135875
"147.32.84.165",4066,"72.35.12.4",25,6,372,6,372,0,0,15355.133625,9.01287500000035,330.19430536869584,0
"147.32.84.165",4968,"209.85.143.27",25,6,372,6,372,0,0,15356.134981,9.013718000000154,330.16342423847175,0
"147.32.84.165",2096,"212.117.174.7",4506,6,372,6,372,0,0,15362.14391,9.012863999998444,330.1947083635694,0
"147.32.84.165",2146,"174.133.57.141",80,17,3489,12,1428,5,2061,15362.343936,1.3248160000002827,8623.084262265524,12445.501865916838
"147.32.84.165",3987,"98.139.175.224",25,6,372,6,372,0,0,15362.344068,9.01287500000035,330.19430536869584,0
"147.32.84.165",4271,"216.99.131.20",25,6,372,6,372,0,0,15363.746273,9.012955999998667,330.191337891857,0
"147.32.84.165",2545,"114.59.51.188",6667,6,372,6,372,0,0,15363.94643,9.017782999999326,330.01459449625503,0
"147.32.84.165",2707,"74.125.127.27",25,6,372,6,372,0,0,15367.151492,9.01253099999849,330.2069085810078,0
"147.32.84.165",3056,"174.133.57.141",80,17,2011,12,1428,5,583,15373.560573,220.3992159999998,51.833215232489806,21.161599776289606
"147.32.84.165",4966,"209.85.225.27",25,6,372,6,372,0,0,15373.716147,8.957234000001336,332.2454230848001,0
"147.32.84.165",2742,"212.117.171.138",65500,110,83788,72,4324,38,79464,15373.760366,1.5481920000001992,22343.48194538891,410615.73758288263
"147.32.84.165",2898,"212.117.174.7",4506,6,372,6,372,0,0,15373.783504,8.98976699999912,331.0430626289081,0
"147.32.84.165",4970,"65.55.92.136",25,6,372,6,372,0,0,15373.783566,8.989831000000777,331.0407058819841,0
"147.32.84.165",4316,"98.139.54.60",25,6,372,6,372,0,0,15375.262633,9.012791999999536,330.1973461719912,0
"147.32.84.165",3072,"212.117.171.138",65500,83,7860,54,4906,29,2954,15376.164118,41.74963899999966,940.0799848832302,566.0408225326257
"147.32.84.165",4973,"59.37.7.182",25,6,372,6,372,0,0,15376.186629,8.99017400000048,331.0280757635883,0
"147.32.84.165",4969,"64.12.138.161",25,6,372,6,372,0,0,15377.165342,9.013758999999482,330.1619224565657,0
"147.32.84.165",4974,"74.125.113.27",25,6,372,6,372,0,0,15383.174169,8.912537000000157,333.91165725314215,0
"147.32.84.165",3423,"212.117.171.138",65500,120,84364,76,4564,44,79800,15383.374624,4.853418000000602,7522.945684875169,131536.1668827867
"147.32.84.165",4347,"216.40.42.4",25,6,372,6,372,0,0,15383.374761,8.91222800000105,333.9232344594022,0
"147.32.84.165",3613,"64.12.175.136",587,52,6349,32,4320,20,2029,15384.77632,33.232483999998294,1039.9463368432457,488.4377586701263
"147.32.84.165",4389,"205.188.156.193",25,6,372,6,372,0,0,15384.894046,8.895238000000973,334.56103141924643,0
"147.32.84.165",3681,"195.225.94.189",6667,6,372,6,372,0,0,15384.976833,8.91413399999874,333.85183574763636,0
"147.32.84.165",4975,"209.85.225.27",25,6,372,6,372,0,0,15388.181838,8.912088999999469,333.9284425907526,0
"147.32.84.165",4976,"174.132.242.219",25,6,372,6,372,0,0,15388.181942,8.91211100000146,333.9276182713066,0
"147.32.84.165",3764,"212.117.174.7",4506,6,372,6,372,0,0,15394.590682,9.016708999999537,330.0539032589554,0
"147.32.84.165",3723,"212.117.171.138",65500,95,7343,64,4646,31,2697,15394.690881,14.788307999999233,2513.336887492601,1458.9904402857392
"147.32.84.165",4978,"64.12.138.161",25,6,372,6,372,0,0,15394.691018,9.015151999999944,330.11090661588605,0
"147.32.84.165",4235,"205.188.103.2",25,6,372,6,372,0,0,15394.691076,9.015219000000798,330.1084532721542,0
"147.32.84.165",4981,"205.188.156.193",25,6,372,6,372,0,0,15396.192668,9.004982000000382,330.4837255643458,0
"147.32.84.165",4980,"209.85.225.27",25,6,372,6,372,0,0,15396.192768,9.00499199999831,330.4833585638453,0
"147.32.84.165",4982,"205.188.146.194",25,6,372,6,372,0,0,15397.094119,9.007724000000962,330.3831245273148,0
"147.32.84.165",4984,"98.139.54.60",25,6,372,6,372,0,0,15398.095414,9.008708999999726,330.3470008854865,0
"147.32.84.165",4811,"98.126.71.122",80,18,4887,14,1454,4,3433,15404.104242,18.16430600000058,640.3767917144552,1511.976290203387
"147.32.84.165",4809,"212.117.174.7",4506,6,372,6,372,0,0,15404.279468,8.945173999998588,332.6933606881733,0
"147.32.84.165",4845,"98.126.71.122",80,18,4863,14,1430,4,3433,15404.2795,20.15905500000008,567.4869184096157,1362.3654481819653
"147.32.84.165",4985,"205.188.103.2",25,6,372,6,372,0,0,15404.279527,8.945222999998805,332.69153826577576,0
"147.32.84.165",4792,"212.117.171.138",65500,344,333190,252,326294,92,6896,15404.279561,23.756758999999875,109878.28769067422,2322.20228356908
"147.32.84.165",4686,"64.12.90.33",25,6,372,6,372,0,0,15404.279592,8.945184999998673,332.6929515712019,0
"147.32.84.165",4562,"67.195.168.31",25,6,372,6,372,0,0,15404.304421,9.019995999999082,329.9336274650568,0
"147.32.84.165",4860,"195.113.232.98",80,23,8643,16,4794,7,3849,15405.799683,16.472061000000394,2328.3060935725703,1869.3471326993788
"147.32.84.165",4850,"98.136.185.95",587,51,5093,34,3674,17,1419,15405.799818,3.8327380000009725,7668.669238542406,2961.85129273045
"147.32.84.165",4862,"195.113.232.98",80,18,5941,12,2556,6,3385,15405.799884,18.648262999999133,1096.5096320231514,1452.145971986842
"147.32.84.165",4441,"80.12.242.53",25,6,372,6,372,0,0,15405.799938,9.029603999999381,329.5825597667632,0
"147.32.84.165",4856,"83.99.172.192",6667,6,372,6,372,0,0,15405.976713,8.952879000000394,332.40703912114407,0
"147.32.84.165",4870,"195.113.232.83",80,13,2066,10,1694,3,372,15409.110445,15.334499000000505,883.7589020677854,194.07220281535783
"147.32.84.165",4586,"114.108.154.238",25,6,372,6,372,0,0,15409.111341,9.028613000000405,329.6187354580229,0
"147.32.84.165",4866,"195.113.232.96",80,13,2816,10,1794,3,1022,15415.632149,6.642796000000089,2160.5360152561975,1230.8070276431627
"147.32.84.165",4880,"195.113.232.81",80,13,3471,10,1616,3,1855,15415.633009,8.81833700000061,1466.0360564581626,1682.856983124933
"147.32.84.165",4894,"174.133.57.141",80,17,3489,12,1428,5,2061,15415.633871,7.943081999999777,1438.2326658594639,2075.7685744652345
"147.32.84.165",4991,"72.167.238.201",25,6,372,6,372,0,0,15415.633933,9.685403000001315,307.2665122968653,0
"147.32.84.165",4886,"212.117.171.138",65500,337,332418,250,325822,87,6596,15415.732597,31.574210999999195,82553.95518830436,1671.237327197229
"147.32.84.165",4903,"74.125.127.27",25,6,372,6,372,0,0,15415.732661,9.589891999999963,310.326748205299,0
"147.32.84.165",4896,"74.125.232.217",80,13,1871,10,1156,3,715,15417.237377,7.217219000000114,1281.3799886077802,792.5490413966806
"147.32.84.165",4992,"209.85.225.27",25,6,372,6,372,0,0,15417.245493,9.822638999999981,302.97356952647914,0
"147.32.84.165",4928,"195.113.232.81",80,13,4011,10,2156,3,1855,15418.140088,4.138043999999354,4168.1528760938,3586.2354291066786
"147.32.84.165",4919,"65.55.196.251",443,221,171899,144,11432,77,160467,15418.140146,9.975757000000158,9167.82555950376,128685.57243324789
"147.32.84.165",4900,"77.238.175.247",80,14,2274,10,1276,4,998,15418.241826,0.14184999999997672,71963.34155799559,56284.80789567367
"147.32.84.165",4993,"165.21.74.118",25,6,372,6,372,0,0,15418.290576,9.506795000001148,313.0392524504463,0
"147.32.84.165",4905,"68.67.179.211",80,13,1989,10,1250,3,739,15419.143853,5.313898000000336,1881.8577247811997,1112.5542868906452
"147.32.84.165",4987,"205.188.190.2",25,6,372,6,372,0,0,15419.168005,9.00890199999958,330.33992377763,0
"147.32.84.165",4938,"212.117.174.7",4506,6,372,6,372,0,0,15425.273289,8.912188000000242,333.9247331856015,0
"147.32.84.165",4988,"64.12.138.161",25,6,372,6,372,0,0,15425.373026,8.912626000001183,333.90832286686384,0
"147.32.84.165",4949,"173.192.170.88",80,22,4005,16,1692,6,2313,15426.174086,10.568122999999105,1280.8329350444867,1750.925873970389
"147.32.84.165",4942,"212.117.171.138",65500,351,333721,258,326642,93,7079,15426.17425,28.643770000000586,91228.7733074224,1977.1140460909594
"147.32.84.165",4626,"98.139.54.60",25,6,372,6,372,0,0,15426.174318,8.912744000001112,333.9039020978981,0
"147.32.84.165",4948,"61.17.216.12",6667,6,372,6,372,0,0,15426.875289,8.912411000001157,333.91637795873794,0
"147.32.84.165",4952,"173.192.170.88",80,21,1891,16,1334,5,557,15430.180293,57.46342800000093,185.71812318610415,77.54497347425789
"147.32.84.165",1934,"65.54.188.110",25,6,372,6,372,0,0,15430.180428,9.870479999999588,301.50509397720515,0
"147.32.84.165",4950,"65.55.196.251",443,229,172149,152,11864,77,160285,15436.589058,11.633866000000125,8158.25109211323,110219.59510277891
"147.32.84.165",4953,"212.117.174.7",4506,6,372,6,372,0,0,15436.689678,9.580445999999938,310.632720021596,0
"147.32.84.165",1996,"174.133.57.141",80,17,3489,12,1428,5,2061,15436.689733,3.827173000001494,2984.9708910455684,4308.140760815768
"147.32.84.165",4529,"209.85.143.27",25,6,372,6,372,0,0,15436.689772,9.583543000000645,310.5323365272947,0
"147.32.84.165",4537,"209.85.225.27",25,6,372,6,372,0,0,15436.689831,9.586675000000469,310.4308845350296,0
"147.32.84.165",4997,"62.28.115.202",25,6,372,6,372,0,0,15436.68987,9.589856000000509,310.3279131615576,0
"147.32.84.165",2098,"212.117.171.138",65500,338,332938,252,326320,86,6618,15438.191908,137.7937869999987,18945.411522799823,384.22632219260004
"147.32.84.165",4616,"209.85.143.27",25,6,372,6,372,0,0,15438.19199,9.552118000001428,311.55394018369066,0
"147.32.84.165",2146,"65.55.196.251",443,221,171935,144,11456,77,160479,15438.192025,16.704996000000392,5486.262912005357,76853.1761396393
"147.32.84.165",4994,"209.85.225.27",25,6,372,6,372,0,0,15438.192058,9.555264999999054,311.45133075851845,0
"147.32.84.165",4581,"67.195.168.31",25,6,372,6,372,0,0,15439.192763,9.891775000000052,300.85601421382756,0
"147.32.84.165",4999,"65.55.37.104",25,6,372,6,372,0,0,15440.094593,9.854733000000124,301.9868727037011,0
"147.32.84.165",1025,"211.29.133.14",25,6,372,6,372,0,0,15446.202849,9.012798000001567,330.1971263529353,0
"147.32.84.165",2198,"209.85.143.27",25,6,372,6,372,0,0,15446.303386,9.012413000000379,330.2112319974545,0
"147.32.84.165",2297,"207.36.208.206",25,6,372,6,372,0,0,15446.303514,9.012405000001309,330.2115251145025,0
"147.32.84.165",2707,"124.123.106.96",6667,6,372,6,372,0,0,15447.104186,9.012753999999404,330.19873836567564,0
"147.32.84.165",2441,"74.208.5.90",25,6,372,6,372,0,0,15448.405913,9.013033999999607,330.18848037188474,0
"147.32.84.165",2898,"174.133.57.141",80,17,3489,12,1428,5,2061,15451.109874,2.917822999999771,3915.2477720550205,5650.7882760542
"147.32.84.165",2498,"65.54.188.126",25,6,372,6,372,0,0,15451.109977,9.013420999999653,330.1743034082303,0
"147.32.84.165",3062,"212.117.174.7",4506,6,372,6,372,0,0,15457.725661,9.006502000000182,330.42795082929416,0
"147.32.84.165",1221,"98.139.54.60",25,6,372,6,372,0,0,15457.72581,9.006494999999632,330.42820764349744,0
"147.32.84.165",1454,"67.195.168.31",25,6,372,6,372,0,0,15459.221991,9.01237299999957,330.21269758809825,0
"147.32.84.165",1030,"64.136.44.37",25,6,372,6,372,0,0,15459.22209,9.012402000000293,330.2116350335796,0
"147.32.84.165",2178,"209.85.225.27",25,6,372,6,372,0,0,15460.223027,9.012876999999207,330.1942320970609,0
"147.32.84.165",1031,"205.188.146.194",25,6,372,6,372,0,0,15461.1274,9.009801000000152,330.3069623846242,0
"147.32.84.165",3723,"212.117.174.7",4506,6,372,6,372,0,0,15467.23348,9.012453999999707,330.20972978060104,0
"147.32.84.165",3690,"173.192.170.88",80,6,372,6,372,0,0,15467.233615,9.012520000000222,330.2073116065126,0
"147.32.84.165",3764,"174.133.57.141",80,17,3489,12,1428,5,2061,15467.23367,12.285874999999578,929.8483014030659,1342.0289560166098
"147.32.84.165",2180,"207.115.21.22",25,6,372,6,372,0,0,15467.233733,9.01250600000094,330.20782454954144,0
"147.32.84.165",2922,"216.32.181.178",25,6,372,6,372,0,0,15467.333207,9.012867999999798,330.194561819841,0
"147.32.84.165",3985,"178.123.10.51",6667,9,552,6,372,3,180,15469.436105,1.6104969999996683,1847.8767734436096,894.1339226340046
"147.32.84.165",2931,"67.195.168.31",25,6,372,6,372,0,0,15469.436177,9.013017999999647,330.1890665257871,0
"147.32.84.165",1033,"209.85.225.27",25,6,372,6,372,0,0,15471.046893,9.004933000000165,330.4855238789612,0
"147.32.84.165",2286,"67.225.245.224",25,6,372,6,372,0,0,15471.04693,9.005036999998993,330.48170707131277,0
"147.32.84.165",2377,"209.85.143.27",25,6,372,6,372,0,0,15472.140459,9.012501999999586,330.2079711050424,0
"147.32.84.165",2435,"209.85.225.27",25,6,372,6,372,0,0,15478.75002,9.012430000000677,330.210609125372,0
"147.32.84.165",3766,"207.115.21.22",25,6,372,6,372,0,0,15478.750188,9.012399999999616,330.2117083130051,0
"147.32.84.165",1038,"205.188.103.2",25,6,372,6,372,0,0,15478.75027,9.01238099999864,330.2124044689687,0
"147.32.84.165",4483,"60.234.40.20",25,6,372,6,372,0,0,15478.750426,9.01228699999956,330.21584865197315,0
"147.32.84.165",4086,"204.127.217.16",25,6,372,6,372,0,0,15480.252045,9.012752000000546,330.1988116393106,0
"147.32.84.165",4271,"59.94.130.46",6667,6,372,6,372,0,0,15481.253579,9.012983000000531,330.19034874467474,0
"147.32.84.165",1034,"64.12.138.161",25,6,372,6,372,0,0,15482.154582,9.013402000000497,330.17499940642125,0
"147.32.84.165",4347,"212.117.174.7",4506,6,372,6,372,0,0,15488.263115,9.01326599999993,330.17998137412377,0
"147.32.84.165",4441,"173.192.170.88",80,19,1767,14,1210,5,557,15488.363975,48.28987799999959,200.45608729846205,92.27606663243253
"147.32.84.165",4586,"174.133.57.141",80,17,3489,12,1428,5,2061,15490.466525,0.9060239999998885,12608.93751159065,18198.193425341968
"147.32.84.165",1041,"98.175.232.130",25,6,372,6,372,0,0,15490.466599,9.01304700000037,330.1880041233423,0
"147.32.84.165",2965,"209.85.225.27",25,6,372,6,372,0,0,15491.568382,9.01258400000006,330.20496674427443,0
"147.32.84.165",1043,"65.55.92.152",25,6,372,6,372,0,0,15492.06916,9.01268700000037,330.20119305151485,0
"147.32.84.165",4278,"74.125.43.27",25,6,372,6,372,0,0,15493.170218,9.012960000000021,330.19119135112027,0
"147.32.84.165",4839,"173.192.170.88",80,6,372,6,372,0,0,15499.779952,8.91257499999847,333.9102335745294,0
"147.32.84.165",4791,"212.117.174.7",4506,6,372,6,372,0,0,15499.780084,8.912569000000076,333.91045836503196,0
"147.32.84.165",3666,"207.115.21.22",25,6,372,6,372,0,0,15499.780141,8.912564000000202,333.91064569072745,0
"147.32.84.165",4519,"62.75.192.97",25,6,372,6,372,0,0,15499.780201,8.912559000000329,333.9108330166331,0
"147.32.84.165",4849,"174.133.57.141",80,17,3489,12,1428,5,2061,15501.282326,3.7132409999994707,3076.557648696012,4440.3258501137825
"147.32.84.165",4056,"98.139.54.60",25,6,372,6,372,0,0,15501.28246,8.912229999999909,333.9231595234897,0
"147.32.84.165",4856,"119.154.129.1",6667,6,372,6,372,0,0,15503.084765,9.013139000000592,330.18463378849526,0
"147.32.84.165",1048,"205.188.59.193",25,6,372,6,372,0,0,15503.685401,9.013004999998884,330.18954277739425,0
"147.32.84.165",4094,"209.85.225.27",25,6,372,6,372,0,0,15509.198805,9.007487999999285,330.39178070514623,0
"147.32.84.165",4500,"205.188.146.194",25,6,372,6,372,0,0,15509.198959,9.007406000000628,330.3947884662679,0
"147.32.84.165",1054,"65.54.188.110",25,6,372,6,372,0,0,15511.396459,9.013544000001275,330.16979780645426,0
"147.32.84.165",4878,"173.192.170.88",80,6,372,6,372,0,0,15512.498428,9.01258400000006,330.20496674427443,0
"147.32.84.165",4560,"66.94.237.139",25,6,372,6,372,0,0,15512.498568,9.012567999998282,330.2055529567785,0
"147.32.84.165",4304,"67.205.67.18",25,6,372,6,372,0,0,15512.998829,9.013307999999597,330.1784428092475,0
"147.32.84.165",1056,"64.12.90.34",25,6,372,6,372,0,0,15514.200745,9.012881999999081,330.1940489180157,0
"147.32.84.165",4884,"212.117.174.7",4506,6,372,6,372,0,0,15520.710029,9.012919000000693,330.1926933993051,0
"147.32.84.165",4394,"205.188.59.194",25,6,372,6,372,0,0,15520.710174,9.012899999999718,330.19338947509607,0
"147.32.84.165",4907,"173.192.170.88",80,29,5298,20,2088,9,3210,15522.212374,44.53447799999958,375.08017945107963,576.631885075654
"147.32.84.165",4089,"64.12.90.34",25,6,372,6,372,0,0,15522.212508,9.012574000000313,330.20533312679555,0
"147.32.84.165",4685,"209.85.225.27",25,6,372,6,372,0,0,15522.212567,9.01263999999901,330.20291501716775,0
"147.32.84.165",4911,"82.226.248.139",6667,6,372,6,372,0,0,15524.7159,9.012630000001081,330.20328139506927,0
"147.32.84.165",1059,"67.195.168.31",25,6,372,6,372,0,0,15524.71604,9.012614000001122,330.20386760152263,0
"147.32.84.165",4919,"212.117.174.7",4506,6,372,6,372,0,0,15530.223484,9.013111000000208,330.1856595353071,0
"147.32.84.165",4504,"168.95.5.58",25,6,372,6,372,0,0,15530.223628,9.013060999999652,330.1874912418894,0
"147.32.84.165",4924,"174.133.57.141",80,17,3489,12,1428,5,2061,15532.426889,4.143562999999631,2757.047497528339,3979.1840983234642
"147.32.84.165",1062,"209.85.225.27",25,6,372,6,372,0,0,15532.58737,8.952581999999893,332.4180666538475,0
"147.32.84.165",4724,"64.12.90.34",25,6,372,6,372,0,0,15532.587438,8.952637999998842,332.4159873324918,0
"147.32.84.165",4570,"209.85.225.27",25,6,372,6,372,0,0,15532.587498,8.952626999998756,332.4163957685731,0
"147.32.84.165",4642,"205.166.218.186",25,6,372,6,372,0,0,15532.587556,8.952621000000363,332.4166185522518,0
"147.32.84.165",4748,"212.59.31.115",25,6,372,6,372,0,0,15533.528935,9.012690999999904,330.20104650209703,0
"147.32.84.165",4709,"67.195.168.31",25,6,372,6,372,0,0,15534.029514,9.012441999999282,330.2101694524344,0
"147.32.84.165",1068,"206.46.232.11",25,6,372,6,372,0,0,15534.029614,9.012430000000677,330.210609125372,0
"147.32.84.165",4780,"94.245.120.86",25,6,372,6,372,0,0,15535.231258,9.01293699999951,330.19203396186634,0
"147.32.84.165",4933,"173.192.170.88",80,24,2431,18,1812,6,619,15541.740196,77.33977099999902,187.43267289995188,64.02915260765464
"147.32.84.165",4935,"208.73.210.29",80,70,39157,42,6640,28,32517,15541.740332,16.75448099999994,3170.4951051602366,15526.353815436056
"147.32.84.165",4804,"77.238.177.9",25,6,372,6,372,0,0,15541.740401,9.013171000000511,330.1834615142474,0
"147.32.84.165",4729,"64.12.90.66",25,6,372,6,372,0,0,15541.92239,8.930731000000378,333.23140065464673,0
"147.32.84.165",4959,"74.125.232.217",80,13,2942,10,2068,3,874,15543.242432,15.252599000001283,1084.667603206418,458.41367756402775
"147.32.84.165",4819,"216.32.180.22",25,6,372,6,372,0,0,15543.250651,9.004538999999568,330.4999845078291,0
"147.32.84.165",4968,"202.9.159.34",6667,6,372,6,372,0,0,15545.746013,9.013122000000294,330.18525656258765,0
"147.32.84.165",4966,"64.12.90.1",25,6,372,6,372,0,0,15545.74609,9.013107999999193,330.18576943716494,0
"147.32.84.165",4970,"174.133.57.141",80,17,3489,12,1428,5,2061,15551.254003,8.871393999999782,1287.7344868236357,1858.55796732739
"147.32.84.165",4960,"67.214.158.5",80,15,2555,10,1706,5,849,15551.412302,0.31663299999854644,43103.529954435115,21450.701601005516
"147.32.84.165",1073,"209.85.225.27",25,6,372,6,372,0,0,15551.516177,8.950863000000027,332.48190705186653,0
"147.32.84.165",4974,"212.117.174.7",4506,6,372,6,372,0,0,15553.557418,9.015885999999227,330.0840316747855,0
"147.32.84.165",4961,"50.22.198.84",80,14,3424,10,2332,4,1092,15554.558585,0.36814199999935227,50676.09781017331,23729.973760166922
"147.32.84.165",4732,"165.212.8.32",25,6,372,6,372,0,0,15554.67958,8.99207799999931,330.9579832381601,0
"147.32.84.165",4962,"195.113.232.88",80,13,2138,10,1550,3,588,15555.059371,3.435942000000068,3608.9084157997295,1369.0568699937037
"147.32.84.165",1075,"205.188.146.194",25,6,372,6,372,0,0,15555.060208,9.011967999998888,330.22753742582836,0
"147.32.84.165",4964,"94.127.76.180",80,7,424,6,364,1,60,15556.261028,0.014827999999397434,196385.217164711,32371.189642534784
"147.32.84.165",4764,"68.1.17.3",25,6,372,6,372,0,0,15556.275563,8.998524000000543,330.7209048950495,0
"147.32.84.165",4984,"212.117.174.7",4506,6,372,6,372,0,0,15562.770274,9.974828999998863,298.35097924990384,0
"147.32.84.165",4683,"210.87.250.216",25,6,372,6,372,0,0,15562.770407,9.97789499999999,298.25930218748573,0
"147.32.84.165",4798,"209.85.225.27",25,6,372,6,372,0,0,15562.870617,9.880866999999853,301.1881447245514,0
"147.32.84.165",1518,"64.12.90.34",25,6,372,6,372,0,0,15562.870755,9.883950999999797,301.0941677068271,0
"147.32.84.165",1031,"173.192.170.88",80,24,3751,16,1324,8,2427,15564.272457,47.9965200000006,220.6826661599605,404.5293283763022
"147.32.84.165",2148,"64.12.90.34",25,6,372,6,372,0,0,15564.272595,10.208512999999584,291.52139983561966,0
"147.32.84.165",1038,"212.117.171.138",65500,339,333002,250,326188,89,6814,15564.272651,41.617458000000624,62702.14773809493,1309.8349255257056
"147.32.84.165",1078,"213.4.149.253",25,6,372,6,372,0,0,15564.272708,10.211624999999913,291.4325584811453,0
"147.32.84.165",1041,"65.55.16.187",443,226,172412,144,11668,82,160744,15566.776203,9.355951000001369,9976.965462942928,137447.49197594257
"147.32.84.165",2669,"209.85.225.27",25,6,372,6,372,0,0,15566.776341,9.173965999998472,324.3962316843659,0
"147.32.84.165",1043,"212.42.113.170",6667,6,372,6,372,0,0,15566.776401,9.177102999999988,324.28534364276,0
"147.32.84.165",4841,"209.86.93.122",25,6,372,6,372,0,0,15566.942332,9.014376999999513,330.13928749598125,0
"147.32.84.165",1056,"174.133.57.141",80,16,3429,12,1428,4,2001,15572.384285,3.7154279999995197,3074.746704821484,4308.521117890609
"147.32.84.165",1083,"67.195.168.31",25,6,372,6,372,0,0,15573.77847,8.920885000001363,333.5991888696632,0
"147.32.84.165",1106,"216.32.180.22",25,6,372,6,372,0,0,15574.487143,9.013638999998875,330.16631795442123,0
"147.32.84.165",1084,"209.85.225.27",25,6,372,6,372,0,0,15575.588703,9.01767800000016,330.01843711872914,0
"147.32.84.165",1085,"77.238.184.241",25,6,372,6,372,0,0,15575.989423,9.013528999999835,330.17034726354734,0
"147.32.84.165",1086,"209.85.225.27",25,6,372,6,372,0,0,15577.191592,9.012454000001526,330.20972978053436,0
"147.32.84.165",2412,"64.12.138.161",25,6,372,6,372,0,0,15577.191738,9.012432999999874,330.2104992070445,0
"147.32.84.165",1979,"212.117.174.7",4506,6,372,6,372,0,0,15583.70036,9.013283999998748,330.1793219874591,0
"147.32.84.165",1087,"207.115.37.23",25,6,372,6,372,0,0,15583.80103,9.011446999998952,330.24662964786296,0
"147.32.84.165",2180,"174.133.57.141",80,17,3489,12,1428,5,2061,15585.203066,0.7118480000008276,16048.369876696595,23162.248120358323
"147.32.84.165",2296,"205.188.103.2",25,6,372,6,372,0,0,15585.363718,8.954493999999613,332.34708739546073,0
"147.32.84.165",2198,"183.83.68.80",6667,6,372,6,372,0,0,15587.806337,9.01926900000035,329.96022183171215,0
"147.32.84.165",2286,"98.126.71.122",80,18,4863,14,1430,4,3433,15587.806481,17.988573000000542,635.9592837074767,1526.7470076697675
"147.32.84.165",4644,"209.85.225.27",25,6,372,6,372,0,0,15587.981251,9.011626000001343,330.24006988301073,0
"147.32.84.165",1088,"170.163.248.2",25,6,372,6,372,0,0,15587.981313,9.014736999999514,330.12610351252187,0
"147.32.84.165",2435,"95.100.248.96",80,23,7905,16,3984,7,3921,15594.718426,12.273239000000103,2596.869497937727,2555.804543527567
"147.32.84.165",2441,"212.117.174.7",4506,6,372,6,372,0,0,15594.719074,9.867980999999418,301.58144811995237,0
"147.32.84.165",2707,"173.192.170.88",80,16,1752,14,1628,2,124,15594.719133,18.95836799999961,686.9789635901291,52.325179044948406
"147.32.84.165",1089,"205.188.146.194",25,6,372,6,372,0,0,15594.719193,9.874291000000085,301.38872755522135,0
"147.32.84.165",2965,"212.117.171.138",65500,338,332926,254,326428,84,6498,15595.521365,31.78738599999997,82152.83886507693,1635.3656761836298
"147.32.84.165",3056,"195.113.232.89",80,13,2792,10,1770,3,1022,15595.521499,11.470358999999007,1234.4862091937337,712.7937320881332
"147.32.84.165",2565,"66.94.237.139",25,6,372,6,372,0,0,15595.522397,9.501908000000185,313.2002540963291,0
"147.32.84.165",3062,"65.55.196.251",443,227,172636,146,11940,81,160696,15596.62496,9.347262000001137,10219.035264015107,137534.17845780333
"147.32.84.165",3690,"195.113.232.83",80,13,3379,10,1524,3,1855,15596.726522,10.265541999999186,1187.6625705687013,1445.6129057775202
"147.32.84.165",3666,"174.133.57.141",80,17,3489,12,1428,5,2061,15596.727309,6.570567000000665,1738.6627364120698,2509.3724788132185
"147.32.84.165",4784,"209.85.225.27",25,6,372,6,372,0,0,15596.887407,9.02005199999985,329.9315791084186,0
"147.32.84.165",3723,"77.238.175.247",80,14,2274,10,1276,4,998,15597.026254,0.13936300000023039,73247.56212181946,57289.23745891522
"147.32.84.165",3673,"205.188.146.194",25,6,372,6,372,0,0,15597.072387,8.983441000000312,331.2761780257584,0
"147.32.84.165",3764,"74.125.232.218",80,13,1871,10,1156,3,715,15597.07245,9.919804000001022,932.2764844949605,576.624296205793
"147.32.84.165",2417,"209.85.225.27",25,6,372,6,372,0,0,15597.080588,8.975364999998419,331.5742590970422,0
"147.32.84.165",3766,"68.67.185.216",80,13,1990,10,1250,3,740,15597.080662,9.911775000000489,1008.9010293312255,597.2694093640854
"147.32.84.165",2688,"209.85.225.27",25,6,372,6,372,0,0,15597.104716,8.951290000000881,332.46604679322274,0
"147.32.84.165",3985,"64.236.79.229",80,14,2274,10,1560,4,714,15597.104778,0.3558129999983066,35074.603794856834,16053.376352261397
"147.32.84.165",4859,"165.21.74.121",25,6,372,6,372,0,0,15597.222415,8.93395099999907,333.1112964465901,0
"147.32.84.165",4056,"64.236.79.229",80,14,2618,10,1918,4,700,15598.229712,2.5806419999989885,5945.807283616253,2170.002658254107
"147.32.84.165",1096,"76.162.254.117",25,6,372,6,372,0,0,15598.964045,9.007802999998603,330.38022700990035,0
"147.32.84.165",4086,"77.238.167.32",80,13,2342,10,1390,3,952,15604.750924,1.2057349999995495,9222.590370192584,6316.479160016791
"147.32.84.165",1092,"209.85.225.27",25,6,372,6,372,0,0,15604.850916,9.029647000001205,329.580990264581,0
"147.32.84.165",4089,"64.236.79.229",80,14,2601,10,1944,4,657,15604.851044,1.2203580000004877,12743.801409089616,4306.932883627509
"147.32.84.165",4080,"205.188.146.194",25,6,372,6,372,0,0,15605.504745,8.976432999999815,331.5348089825949,0
"147.32.84.165",4094,"64.236.79.229",80,14,2583,10,1926,4,657,15605.504802,0.64664300000004,23827.676167528367,8128.1325244372465
"147.32.84.165",1097,"212.227.15.134",25,6,372,6,372,0,0,15605.504858,8.976446000000578,331.5343288423735,0
"147.32.84.165",4271,"195.113.232.96",80,13,1965,10,1306,3,659,15605.607829,1.3847969999987981,7544.788153071582,3807.056196687728
"147.32.84.165",4506,"209.85.225.27",25,6,372,6,372,0,0,15605.822439,8.959434000000329,332.1638398139761,0
"147.32.84.165",4304,"74.217.252.37",80,12,2075,10,1278,2,797,15605.822507,1.1703039999993052,8736.191622011092,5448.157060049171
"147.32.84.165",1286,"205.188.146.194",25,6,372,6,372,0,0,15605.986477,8.995936999999685,330.8160117173013,0
"147.32.84.165",4441,"77.238.175.247",80,14,3055,10,1368,4,1687,15605.986509,0.14055399999961082,77863.31232145868,96020.03500460583
"147.32.84.165",1772,"209.85.225.27",25,6,372,6,372,0,0,15606.032535,8.949985999999626,332.5144866148533,0
"147.32.84.165",1100,"141.146.126.228",25,6,372,6,372,0,0,15606.032599,8.949950000000172,332.51582411074287,0
"147.32.84.165",4447,"64.236.79.229",80,14,2629,10,1972,4,657,15606.356683,0.3559449999993376,44321.454157325876,14766.326258297719
"147.32.84.165",4657,"64.12.138.161",25,6,372,6,372,0,0,15606.474232,9.008536999999706,330.35330820088734,0
"147.32.84.165",4786,"207.115.21.22",25,6,372,6,372,0,0,15606.970825,9.0134939999989,330.1716293371209,0
"147.32.84.165",4500,"117.224.41.27",6667,6,372,6,372,0,0,15608.973885,8.912694000000556,333.90577529081713,0
"147.32.84.165",4581,"174.133.57.141",80,17,3489,12,1428,5,2061,15615.783059,6.422029000001203,1778.8770496050174,2567.412884619006
"147.32.84.165",1102,"209.85.225.27",25,6,372,6,372,0,0,15615.942855,9.699029000001246,306.83483882764114,0
"147.32.84.165",4504,"212.117.174.7",4506,6,372,6,372,0,0,15615.942918,9.702132999998867,306.7366732655951,0
"147.32.84.165",4570,"173.192.170.88",80,15,1531,12,1094,3,437,15616.584462,38.503052000000025,227.3066561061184,90.79799700034162
"147.32.84.165",4844,"64.12.90.34",25,6,372,6,372,0,0,15616.584604,9.497628999999506,313.34136130187386,0
"147.32.84.165",4560,"212.117.171.138",65500,80,7589,52,4770,28,2819,15617.786225,76.42033600000104,499.34352552440333,295.10469569251427
"147.32.84.165",4685,"64.12.90.1",25,6,372,6,372,0,0,15617.786331,9.477108000000953,314.0198465607547,0
"147.32.84.165",1101,"64.12.90.34",25,6,372,6,372,0,0,15618.086524,9.18652800000018,323.9526402140114,0
"147.32.84.165",4642,"65.55.16.187",443,221,172178,144,11704,77,160474,15618.086622,9.36828499999865,9994.572112186328,137035.9676291002
"147.32.84.165",4484,"64.12.90.66",25,6,372,6,372,0,0,15618.252779,9.023474999999962,329.80642158370387,0
"147.32.84.165",4724,"173.192.170.88",80,6,372,6,372,0,0,15619.889233,9.012746000000334,330.1990314605437,0
"147.32.84.165",4827,"65.54.188.94",25,6,372,6,372,0,0,15619.889361,9.012743999999657,330.1991047343754,0
"147.32.84.165",4780,"212.117.174.7",4506,6,372,6,372,0,0,15626.398377,9.01311700000042,330.1854397318776,0
"147.32.84.165",1104,"205.188.146.194",25,6,372,6,372,0,0,15626.398484,9.013168999999834,330.18353478116904,0
"147.32.84.165",2756,"198.102.73.74",25,6,372,6,372,0,0,15626.89923,9.013222999999925,330.1815565863648,0
"147.32.84.165",4826,"98.139.54.60",25,6,372,6,372,0,0,15627.399779,9.013651000001119,330.1658783992891,0
"147.32.84.165",4867,"207.115.20.23",25,6,372,6,372,0,0,15627.90093,9.012558000000354,330.20591934053385,0
"147.32.84.165",4856,"80.191.196.145",6667,8,492,6,372,2,120,15629.803274,7.03101500000048,423.26747987307624,136.5378967332504
"147.32.84.165",4884,"174.133.57.141",80,17,3489,12,1428,5,2061,15636.813363,1.470141000001604,7770.683220172444,11215.250782055606
"147.32.84.165",1105,"74.125.93.27",25,6,372,6,372,0,0,15636.834528,8.99177200000122,330.96924610628434,0
"147.32.84.165",1107,"205.188.156.193",25,6,372,6,372,0,0,15636.967815,8.958781999999701,332.1880139510147,0
"147.32.84.165",1115,"76.96.62.116",25,6,372,6,372,0,0,15637.61444,9.013141999999789,330.1845238874601,0
"147.32.84.165",2774,"207.115.20.21",25,6,372,6,372,0,0,15638.816162,9.316338000000542,319.43881812787674,0
"147.32.84.165",4882,"209.85.225.27",25,6,372,6,372,0,0,15639.216933,9.319149000000834,319.3424635661189,0
"147.32.84.165",1116,"207.115.20.21",25,6,372,6,372,0,0,15640.919399,9.01341499999944,330.17452319683326,0
"147.32.84.165",4891,"80.12.242.9",25,6,372,6,372,0,0,15640.919498,9.01345500000025,330.1730579450297,0
"147.32.84.165",4938,"212.117.174.7",4506,6,372,6,372,0,0,15647.428961,9.012747000000672,330.19899482364013,0
"147.32.84.165",4935,"173.192.170.88",80,18,2429,14,1930,4,499,15647.92949,36.460730999999214,423.4692935805465,109.48765673403767
"147.32.84.165",4940,"217.72.192.149",25,6,372,6,372,0,0,15647.929568,9.01326599999993,330.17998137412377,0
"147.32.84.165",4962,"174.133.57.141",80,17,3489,12,1428,5,2061,15648.430125,1.3873100000000704,8234.641140047588,11884.87072103507
"147.32.84.165",4917,"209.85.225.27",25,6,372,6,372,0,0,15648.788412,8.95518500000071,332.3214428289046,0
"147.32.84.165",4953,"212.117.171.138",65500,14,846,10,604,4,242,15648.788453,26.769922000001316,180.50108625642474,72.31997164578607
"147.32.84.165",1961,"209.85.225.27",25,6,372,6,372,0,0,15648.788478,8.955259999998816,332.3186596481167,0
"147.32.84.165",4959,"112.205.111.114",6667,6,372,6,372,0,0,15648.788505,8.95530399999916,332.3170268703641,0
"147.32.84.165",2157,"195.110.124.132",25,6,372,6,372,0,0,15648.930879,9.01293799999985,330.1919973265155,0
"147.32.84.165",4964,"64.12.168.40",587,50,6073,30,4052,20,2021,15657.843618,36.4579679999988,889.1334810541571,443.46958667582714
"147.32.84.165",2441,"212.117.174.7",4506,6,372,6,372,0,0,15657.943924,9.012818000001062,330.1963936251292,0
"147.32.84.165",4968,"81.9.5.194",25,6,372,6,372,0,0,15657.943954,9.01287500000035,330.19430536869584,0
"147.32.84.165",4888,"203.188.197.119",25,6,372,6,372,0,0,15657.961694,8.995159000000058,330.84462431403165,0
"147.32.84.165",4978,"89.253.239.179",25,6,372,6,372,0,0,15658.645145,9.012752999999066,330.1987750025224,0
"147.32.84.165",1121,"72.4.117.21",25,6,372,6,372,0,0,15659.846615,9.01290599999993,330.19316966137484,0
"147.32.84.165",4982,"89.108.109.146",25,6,372,6,372,0,0,15660.247159,9.012853999998697,330.1950747233263,0
"147.32.84.165",2832,"64.12.139.193",25,6,372,6,372,0,0,15661.950303,9.012536000000182,330.2067253878309,0
"147.32.84.165",4987,"194.85.88.229",25,6,372,6,372,0,0,15668.459151,9.012735000000248,330.19943446688694,0
"147.32.84.165",3046,"66.94.237.139",25,6,372,6,372,0,0,15668.959761,9.01264699999956,330.2026585530472,0
"147.32.84.165",4988,"194.85.88.237",25,6,372,6,372,0,0,15669.460233,9.013269999999466,330.1798348435336,0
"147.32.84.165",3413,"209.85.225.27",25,6,372,6,372,0,0,15669.961349,9.012652000001253,330.20247536458595,0
"147.32.84.165",4917,"212.117.174.7",4506,6,372,6,372,0,0,15678.974145,8.913038000000597,333.89288814877716,0
"147.32.84.165",4953,"212.117.171.138",65500,24,1476,18,1092,6,384,15678.974209,64.91675199999918,134.5723519870512,47.32214575368834
"147.32.84.165",4991,"72.14.213.27",25,6,372,6,372,0,0,15678.97427,8.913038999999117,333.8928506876605,0
"147.32.84.165",4901,"205.188.190.1",25,6,372,6,372,0,0,15679.678594,8.90914199999861,334.0389007157439,0
"147.32.84.165",4992,"74.125.157.27",25,6,372,6,372,0,0,15680.876631,8.916352000000188,333.76878795273416,0
"147.32.84.165",1125,"209.85.225.27",25,6,372,6,372,0,0,15681.277677,8.912559000000329,333.9108330166331,0
"147.32.84.165",4993,"91.209.127.12",25,6,372,6,372,0,0,15681.277813,8.91255099999944,333.9111327385602,0
"147.32.84.165",3060,"205.188.190.1",25,6,372,6,372,0,0,15682.979659,8.912897999998677,333.8981327959146,0
"147.32.84.165",4994,"89.108.118.81",25,6,372,6,372,0,0,15682.979806,8.912878000001001,333.89888204457253,0
"147.32.84.165",1120,"209.85.225.27",25,6,372,6,372,0,0,15689.389146,9.012783000000127,330.19767590099065,0
"147.32.84.165",4982,"212.117.174.7",4506,6,372,6,372,0,0,15689.38928,9.01279600000089,330.1971996259214,0
"147.32.84.165",4997,"216.246.15.206",25,6,372,6,372,0,0,15689.38934,9.012854000000516,330.19507472325967,0
"147.32.84.165",1126,"205.188.190.1",25,6,372,6,372,0,0,15689.889901,9.013100999998642,330.18602587505103,0
"147.32.84.165",4999,"78.46.109.184",25,6,372,6,372,0,0,15689.890038,9.013111000000208,330.1856595353071,0
"147.32.84.165",4916,"64.12.90.65",25,6,372,6,372,0,0,15690.390496,9.013001999999688,330.18965268177055,0
"147.32.84.165",1031,"77.222.41.36",25,6,372,6,372,0,0,15690.891017,9.012883999999758,330.19397564642793,0
"147.32.84.165",4952,"147.32.84.171",139,33,4810,22,3278,11,1532,15699.904006,0.01564899999902991,1675762.0296265346,783181.0339804303
"147.32.84.165",1127,"209.85.225.27",25,6,372,6,372,0,0,15699.904057,9.013605000000098,330.1675633667071,0
"147.32.84.165",4964,"117.204.73.246",6667,9,552,6,372,3,180,15699.904209,2.214049000000159,1344.1436932966642,650.3921096596762
"147.32.84.165",1034,"77.222.41.41",25,6,372,6,372,0,0,15700.605159,9.012794999998732,330.19723626249333,0
"147.32.84.165",3085,"98.139.54.60",25,6,372,6,372,0,0,15701.807087,9.013139000000592,330.18463378849526,0
"147.32.84.165",1038,"78.108.81.249",25,6,372,6,372,0,0,15702.118527,9.002268999998705,330.58332293785355,0
"147.32.84.165",1128,"205.188.103.1",25,6,372,6,372,0,0,15702.207352,9.013361999999688,330.1764646754566,0
"147.32.84.165",1041,"94.75.207.42",25,6,372,6,372,0,0,15703.910068,9.012774000000718,330.19800563064854,0
"147.32.84.165",3153,"66.94.237.139",25,6,372,6,372,0,0,15710.419759,9.012795000000551,330.1972362624267,0
"147.32.84.165",4994,"212.117.174.7",4506,6,372,6,372,0,0,15710.920389,9.012552999998661,330.20610253281643,0
"147.32.84.165",1043,"81.177.24.26",25,6,372,6,372,0,0,15711.420563,9.013026000000536,330.18877344854246,0
"147.32.84.165",4843,"204.255.212.244",25,6,372,6,372,0,0,15711.921548,9.012746000000334,330.1990314605437,0
"147.32.84.165",3060,"212.117.171.138",65500,14,846,10,604,4,242,15720.934432,95.04640400000062,50.83832524584484,20.36899786340141
"147.32.84.165",1056,"92.53.96.75",25,6,372,6,372,0,0,15720.934494,9.012911000001623,330.1929864834418,0
"147.32.84.165",3507,"213.165.64.100",25,6,372,6,372,0,0,15721.635384,9.013006000001042,330.1895061425296,0
"147.32.84.165",4997,"173.227.72.50",25,6,372,6,372,0,0,15722.837016,9.01290599999993,330.19316966137484,0
"147.32.84.165",1073,"92.53.116.6",25,6,372,6,372,0,0,15723.137496,9.01283599999988,330.1957341729107,0
"147.32.84.165",1129,"62.112.192.40",25,6,372,6,372,0,0,15723.237587,9.01354100000026,330.1699076977532,0
"147.32.84.165",4916,"79.119.209.87",6667,9,552,6,372,3,180,15724.940761,1.053820999999516,2824.009011019297,1366.4559730738533
"147.32.84.165",1075,"92.63.103.10",25,6,372,6,372,0,0,15725.994814,8.960037000000739,332.14148557642727,0
"147.32.84.165",3434,"209.85.225.27",25,6,372,6,372,0,0,15731.449414,9.013043999999354,330.1881140267609,0
"147.32.84.165",1078,"77.88.21.89",25,6,372,6,372,0,0,15731.951829,9.011324999999488,330.25110069830674,0
"147.32.84.165",1130,"205.188.190.1",25,6,372,6,372,0,0,15732.453822,9.010232000000542,330.29116231411365,0
"147.32.84.165",1083,"89.253.239.179",25,6,372,6,372,0,0,15732.95188,9.012722999999824,330.19987411130444,0
"147.32.84.165",2682,"212.72.11.123",25,6,372,6,372,0,0,15741.964804,9.012729000000036,330.1996542889494,0
"147.32.84.165",4843,"31.42.162.114",6667,2,124,2,124,0,0,15742.665697,1.1000000085914508e-05,0,0
"147.32.84.165",1084,"188.120.234.114",25,6,372,6,372,0,0,15743.867357,9.012689000001046,330.20111977675634,0
"147.32.84.165",2873,"209.85.225.27",25,6,372,6,372,0,0,15744.167645,9.012942999999723,330.19181414994983,0
"147.32.84.165",1085,"78.108.90.240",25,6,372,6,372,0,0,15744.167754,9.012923000000228,330.1925468574318,0
"147.32.84.165",3538,"65.54.188.72",25,6,372,6,372,0,0,15744.268737,9.012023999999656,330.22548541816064,0
"147.32.84.165",2146,"212.117.174.7",4506,6,372,6,372,0,0,15746.972244,8.912457000000359,333.9146545110827,0
"147.32.84.165",1086,"46.17.40.43",25,6,372,6,372,0,0,15752.481924,8.910695000000487,333.9806827637841,0
"147.32.84.165",1131,"66.210.173.31",25,6,372,6,372,0,0,15752.980291,8.91289400000096,333.89828264530905,0
"147.32.84.165",4997,"212.117.174.7",4506,6,372,6,372,0,0,15753.481255,8.912671999998565,333.9065995024252,0
"147.32.84.165",1087,"72.14.213.27",25,6,372,6,372,0,0,15753.481355,8.91271500000039,333.90498854724626,0
"147.32.84.165",1130,"80.93.56.171",25,6,372,6,372,0,0,15753.981935,8.912705000000642,333.9053631865731,0
"147.32.84.165",3569,"161.58.16.34",25,6,372,6,372,0,0,15755.985033,9.013758999999482,330.1619224565657,0
"147.32.84.165",1088,"74.125.157.27",25,6,372,6,372,0,0,15762.89478,9.01316399999996,330.1837179485487,0
"147.32.84.165",1132,"193.163.255.163",25,6,372,6,372,0,0,15764.797533,9.01455199999873,330.13287848363615,0
"147.32.84.165",1089,"195.8.102.42",25,6,372,6,372,0,0,15765.097959,9.013366999999562,330.1762815161243,0
"147.32.84.165",2159,"66.94.237.139",25,6,372,6,372,0,0,15765.198115,9.013079000000289,330.1868318251626,0
"147.32.84.165",1092,"91.209.127.12",25,6,372,6,372,0,0,15767.902061,9.014618999999584,330.1304248133102,0
"147.32.84.165",3592,"216.32.180.22",25,6,372,6,372,0,0,15773.411642,9.011047000001781,330.2612892818572,0
"147.32.84.165",1096,"96.9.156.107",25,6,372,6,372,0,0,15773.912237,9.01285999999891,330.1948549073613,0
"147.32.84.165",1133,"205.188.190.1",25,6,372,6,372,0,0,15774.411475,9.013105999998515,330.18584270511076,0
"147.32.84.165",1097,"93.170.24.114",25,6,372,6,372,0,0,15774.9122,9.012634999999136,330.2030982060502,0
"147.32.84.165",3510,"209.85.225.27",25,6,372,6,372,0,0,15777.016682,9.011782999999923,330.23431656088763,0
"147.32.84.165",4997,"212.117.174.7",4506,6,372,6,372,0,0,15783.925043,9.012902000000395,330.1933162038009,0
"147.32.84.165",1100,"89.108.118.81",25,6,372,6,372,0,0,15785.827871,9.012660000000324,330.202182263604,0
"147.32.84.165",3569,"74.125.39.27",25,6,372,6,372,0,0,15786.1282,9.012766000001648,330.1982987242159,0
"147.32.84.165",1134,"212.227.15.134",25,6,372,6,372,0,0,15786.228787,9.012703000000329,330.2006068545576,0
"147.32.84.165",1101,"216.246.15.206",25,6,372,6,372,0,0,15788.932209,9.013100999998642,330.18602587505103,0
"147.32.84.165",2964,"74.125.159.27",25,6,372,6,372,0,0,15794.440436,9.012602999999217,330.20427061973754,0
"147.32.84.165",1102,"78.46.109.184",25,6,372,6,372,0,0,15794.940909,9.012776999999915,330.19789572071164,0
"147.32.84.165",2912,"205.188.190.1",25,6,372,6,372,0,0,15795.441746,9.012643000000025,330.2028051038959,0
"147.32.84.165",1104,"77.222.41.41",25,6,372,6,372,0,0,15795.942389,9.012628000000404,330.20335467078706,0
"147.32.84.165",2997,"65.54.188.126",25,6,372,6,372,0,0,15798.045156,9.013682999999219,330.16470625828066,0
"147.32.84.165",3510,"173.192.170.88",80,68,8643,42,2974,26,5669,15804.955164,52.72713399999884,451.2287734053689,860.1264009532738
"147.32.84.165",1106,"78.108.81.249",25,6,372,6,372,0,0,15806.857859,9.013385000000198,330.1756221441705,0
"147.32.84.165",1135,"66.231.249.35",25,6,372,6,372,0,0,15807.158706,9.012457000000722,330.2096198627923,0
"147.32.84.165",1286,"178.162.163.199",25,6,372,6,372,0,0,15807.25915,9.012591000000612,330.20471027696675,0
"147.32.84.165",1100,"74.125.39.27",25,6,372,6,372,0,0,15809.963227,9.012622000000192,330.2035744980691,0
"147.32.84.165",1138,"209.85.229.27",25,6,372,6,372,0,0,15814.169123,9.012173999999504,330.21998909476935,0
"147.32.84.165",1518,"74.125.39.27",25,6,372,6,372,0,0,15815.470237,9.013100000000122,330.1860625090102,0
"147.32.84.165",1134,"77.88.21.89",25,6,372,6,372,0,0,15815.47043,9.013050000001385,330.18789421999685,0
"147.32.84.165",3619,"209.85.227.27",25,6,372,6,372,0,0,15815.970918,9.013277999998536,330.17954178274357,0
"147.32.84.165",1772,"74.125.127.27",25,6,372,6,372,0,0,15816.47163,8.913092000000688,333.89086525750776,0
"147.32.84.165",4943,"209.85.225.27",25,6,372,6,372,0,0,15816.97291,8.912387000000308,333.91727715592884,0
"147.32.84.165",1979,"74.125.127.27",25,6,372,6,372,0,0,15819.075808,8.912556000001132,333.9109454122501,0
"147.32.84.165",1142,"67.195.168.230",25,6,372,6,372,0,0,15819.075951,8.913915999999517,333.8600004756788,0
"147.32.84.165",2098,"87.242.115.87",25,6,372,6,372,0,0,15827.788316,9.012881999999081,330.1940489180157,0
"147.32.84.165",2997,"88.84.206.202",25,6,372,6,372,0,0,15828.088703,9.013267000000269,330.1799447414474,0
"147.32.84.165",4945,"213.199.180.150",25,6,372,6,372,0,0,15828.188675,9.013421000001472,330.17430340816367,0
"147.32.84.165",2180,"91.184.8.16",25,6,372,6,372,0,0,15830.892377,9.013220000000729,330.18166648542467,0
"147.32.84.165",1100,"74.125.39.27",25,6,372,6,372,0,0,15835.099047,9.012324999999691,330.21445631400354,0
"147.32.84.165",3546,"209.85.225.27",25,6,372,6,372,0,0,15836.400398,9.0128820000009,330.1940489179491,0
"147.32.84.165",1138,"212.117.171.138",65500,14,846,10,604,4,242,15836.400527,72.46839899999941,66.67733890464504,26.715092739940562
"147.32.84.165",2148,"85.13.141.104",25,6,372,6,372,0,0,15836.423175,8.990240999999514,331.0256087684591,0
"147.32.84.165",1518,"77.88.21.89",25,6,372,6,372,0,0,15836.901684,9.012290999999095,330.21570208954626,0
"147.32.84.165",4946,"199.94.162.201",25,6,372,6,372,0,0,15837.401836,9.012998000000152,330.1897992210749,0
"147.32.84.165",2198,"209.85.225.27",25,6,372,6,372,0,0,15837.903127,9.012463000000935,330.209400027461,0
"147.32.84.165",1144,"67.211.234.195",25,6,372,6,372,0,0,15840.005945,9.01272599999902,330.19976420012364,0
"147.32.84.165",1142,"212.117.174.7",4506,6,372,6,372,0,0,15848.818621,9.01288999999997,330.19375583192624,0
"147.32.84.165",2286,"209.85.225.27",25,6,372,6,372,0,0,15849.118602,9.013397999999142,330.17514593278617,0
"147.32.84.165",1145,"67.195.168.31",25,6,372,6,372,0,0,15849.11867,9.01345500000025,330.1730579450297,0
"147.32.84.165",2296,"89.111.189.30",25,6,372,6,372,0,0,15849.218889,9.01315699999941,330.18397438324826,0
"147.32.84.165",3471,"192.115.106.58",25,6,372,6,372,0,0,15851.922938,9.0138850000003,330.1573073097672,0
"147.32.84.165",2997,"212.117.174.7",4506,6,372,6,372,0,0,15856.129074,9.012588999999934,330.20478355331875,0
"147.32.84.165",2412,"89.111.189.30",25,6,372,6,372,0,0,15856.129205,9.012583000001541,330.20500338243664,0
"147.32.84.165",3832,"74.125.244.13",25,6,372,6,372,0,0,15856.129262,9.012574999998833,330.2052964885602,0
"147.32.84.165",2417,"91.219.194.2",25,6,372,6,372,0,0,15857.432827,9.011961999998675,330.2277572853101,0
"147.32.84.165",1143,"68.1.17.3",25,6,372,6,372,0,0,15857.931558,9.014322999999422,330.1412651843284,0
"147.32.84.165",3546,"173.192.170.88",80,26,2551,20,1932,6,619,15858.432314,95.67923200000041,161.53975817866026,51.756268277738464
"147.32.84.165",1518,"77.88.21.89",25,6,372,6,372,0,0,15858.932889,9.391394000000219,316.88586380253355,0
"147.32.84.165",3846,"64.12.90.65",25,6,372,6,372,0,0,15861.036106,9.012979000000996,330.1904952845969,0
"147.32.84.165",3515,"209.85.225.27",25,6,372,6,372,0,0,15867.646483,9.011875000000146,330.2309452805273,0
"147.32.84.165",2688,"184.107.152.165",25,6,372,6,372,0,0,15869.848785,9.013148000000001,330.1843040855425,0
"147.32.84.165",3626,"65.54.188.110",25,6,372,6,372,0,0,15870.149089,9.013413999999102,330.1745598283066,0
"147.32.84.165",2707,"184.107.152.165",25,6,372,6,372,0,0,15870.249622,9.012555000001157,330.2060292558123,0
"147.32.84.165",1145,"46.4.77.44",25,6,372,6,372,0,0,15870.249754,9.012563000000227,330.2057361485212,0
"147.32.84.165",1148,"64.12.139.193",25,6,372,6,372,0,0,15872.953022,9.012925999999425,330.19243695112885,0
"147.32.84.165",2756,"88.198.65.167",25,6,372,6,372,0,0,15877.159214,9.012759000001097,330.198555181564,0
"147.32.84.165",2286,"78.46.43.119",25,6,372,6,372,0,0,15878.461141,9.012742000000799,330.1991780081729,0
"147.32.84.165",3540,"64.12.139.193",25,6,372,6,372,0,0,15878.961998,9.012683999999354,330.20130296371354,0
"147.32.84.165",2931,"74.125.39.27",25,6,372,6,372,0,0,15878.962132,9.012671999998929,330.2017426131067,0
"147.32.84.165",3564,"65.55.37.72",25,6,372,6,372,0,0,15879.963067,9.01303199999893,330.1885536410337,0
"147.32.84.165",2965,"94.229.67.92",25,6,372,6,372,0,0,15882.065925,9.01312599999983,330.1851100273153,0
"147.32.84.165",3762,"209.85.225.27",25,6,372,6,372,0,0,15888.675544,8.912732000000688,333.9043516622928,0
"147.32.84.165",3846,"212.117.174.7",4506,6,372,6,372,0,0,15890.87914,8.912302000000636,333.92046185147086,0
"147.32.84.165",3056,"94.229.67.92",25,6,372,6,372,0,0,15891.179073,8.912811000000147,333.90139205240087,0
"147.32.84.165",3951,"71.74.56.243",25,6,372,6,372,0,0,15891.179215,8.91279299999951,333.90206638930846,0
"147.32.84.165",3062,"91.219.194.2",25,6,372,6,372,0,0,15891.279807,8.912652999999409,333.9073113247197,0
"147.32.84.165",1145,"46.4.77.44",25,6,372,6,372,0,0,15893.983498,8.912489000000278,333.9134556014495,0
"147.32.84.165",4941,"74.208.5.3",25,6,372,6,372,0,0,15898.089402,9.013071000001219,330.1871248988938,0
"147.32.84.165",3666,"217.199.218.198",25,6,372,6,372,0,0,15899.390847,9.013032999999268,330.1885170064552,0
"147.32.84.165",2286,"78.46.43.119",25,6,372,6,372,0,0,15899.89161,9.012973999999303,330.1906784597659,0
"147.32.84.165",1152,"64.12.90.65",25,6,372,6,372,0,0,15900.89359,9.01242000000093,330.21097552041437,0
"147.32.84.165",3540,"212.117.174.7",4506,6,372,6,372,0,0,15902.996067,9.01319599999988,330.18254568080397,0
"147.32.84.165",3673,"81.177.159.2",25,6,372,6,372,0,0,15902.9962,9.01318800000081,330.18283874692645,0
"147.32.84.165",1153,"77.238.177.9",25,6,372,6,372,0,0,15909.605604,9.01312599999983,330.1851100273153,0
"147.32.84.165",1138,"212.117.171.138",65500,14,846,10,604,4,242,15911.809097,200.30504400000063,24.12320680252058,9.665258354652286
"147.32.84.165",3690,"93.170.48.156",25,6,372,6,372,0,0,15911.831807,8.990799999999581,331.00502736131807,0
"147.32.84.165",3596,"165.21.74.116",25,6,372,6,372,0,0,15912.109984,9.013106999998854,330.18580607113375,0
"147.32.84.165",3846,"173.192.170.88",80,27,5107,20,2092,7,3015,15912.209904,46.53833900000063,359.6174758192331,518.2823564029578
"147.32.84.165",3723,"194.85.88.230",25,6,372,6,372,0,0,15912.210036,9.01332100000036,330.17796658966,0
"147.32.84.165",3957,"65.54.188.126",25,6,372,6,372,0,0,15914.913481,9.012792999999874,330.1973095354616,0
"147.32.84.165",3764,"188.120.234.114",25,6,372,6,372,0,0,15919.119136,9.0134620000008,330.1728015272862,0
"147.32.84.165",1145,"46.4.77.44",25,6,372,6,372,0,0,15920.422345,9.012002999999822,330.22625491803086,0
"147.32.84.165",4017,"76.96.62.116",25,6,372,6,372,0,0,15920.922855,9.012056999999913,330.22427621130544,0
"147.32.84.165",3766,"78.108.90.240",25,6,372,6,372,0,0,15921.923597,9.012724999998682,330.199800837198,0
"147.32.84.165",2286,"78.46.43.119",25,6,372,6,372,0,0,15924.026249,9.01298399999905,330.1903121097645,0
"147.32.84.165",1149,"205.188.103.1",25,6,372,6,372,0,0,15930.635697,9.013049000001047,330.1879308544372,0
"147.32.84.165",3985,"46.17.40.43",25,6,372,6,372,0,0,15932.839037,9.015509000000748,330.09783474230386,0
"147.32.84.165",4954,"117.53.114.15",25,6,372,6,372,0,0,15933.140007,9.01291400000082,330.19287657684623,0
"147.32.84.165",4056,"74.125.43.27",25,6,372,6,372,0,0,15933.239591,9.012985000001208,330.19027547472905,0
"147.32.84.165",3596,"207.182.153.35",25,6,372,6,372,0,0,15935.943954,9.013055999999779,330.1876744136587,0
"147.32.84.165",3614,"64.72.88.19",25,6,372,6,372,0,0,15940.149859,9.01319500000136,330.18258231399085,0
"147.32.84.165",4080,"209.85.229.27",25,6,372,6,372,0,0,15941.451479,9.012838000000556,330.195660900575,0
"147.32.84.165",3957,"62.109.2.254",25,6,372,6,372,0,0,15941.952464,9.012539999999717,330.20657883350236,0
"147.32.84.165",1154,"65.55.37.120",25,6,372,6,372,0,0,15942.953476,9.013316999999006,330.1781131186586,0
"147.32.84.165",1145,"212.117.174.7",4506,6,372,6,372,0,0,15945.056993,9.013162999999622,330.18375458206236,0
"147.32.84.165",4086,"195.8.102.42",25,6,372,6,372,0,0,15951.666613,9.012786000001142,330.1975659912066,0
"147.32.84.165",1156,"64.12.139.193",25,6,372,6,372,0,0,15953.869196,9.013167000000976,330.18360804805656,0
"147.32.84.165",4089,"96.9.156.107",25,6,372,6,372,0,0,15954.169885,9.012604000001375,330.20423398160466,0
"147.32.84.165",1150,"66.94.237.139",25,6,372,6,372,0,0,15954.270137,9.01314900000034,330.184267451907,0
"147.32.84.165",3546,"61.17.216.19",6667,4,248,4,248,0,0,15956.973923,3.004268000000593,660.3938130684774,0
"147.32.84.165",3846,"212.117.174.7",4506,6,372,6,372,0,0,15961.180206,9.013083999998344,330.18664865439473,0
"147.32.84.165",4094,"93.170.24.114",25,6,372,6,372,0,0,15961.18034,9.013076999999612,330.1869050935799,0
"147.32.84.165",3596,"88.198.10.142",25,6,372,6,372,0,0,15962.481826,8.912631000001056,333.9081355437746,0
"147.32.84.165",3902,"209.85.225.27",25,6,372,6,372,0,0,15962.982426,8.912930999998935,333.896896542827,0
"147.32.84.165",4271,"92.38.209.166",25,6,372,6,372,0,0,15963.983723,8.913422999999966,333.8784662188714,0
"147.32.84.165",3957,"62.109.2.254",25,6,372,6,372,0,0,15965.986861,9.013234000000011,330.18115362366007,0
"147.32.84.165",1157,"209.85.225.27",25,6,372,6,372,0,0,15972.596066,9.013695999999982,330.164230078317,0
"147.32.84.165",4304,"46.188.12.33",25,6,372,6,372,0,0,15972.596203,9.013687000000573,330.1645597411815,0
"147.32.84.165",3656,"124.108.110.37",25,6,372,6,372,0,0,15974.799466,9.013316999999006,330.1781131186586,0
"147.32.84.165",4441,"217.199.219.174",25,6,372,6,372,0,0,15975.099927,9.01351700000123,330.1707868304452,0
"147.32.84.165",4957,"67.195.168.230",25,6,372,6,372,0,0,15975.199874,9.013009000000238,330.1893962382509,0
"147.32.84.165",4089,"188.129.211.240",6667,6,372,6,372,0,0,15977.102612,9.013365999999223,330.17631814798784,0
"147.32.84.165",4447,"89.108.118.80",25,6,372,6,372,0,0,15982.210874,9.01209100000051,330.2230303710683,0
"147.32.84.165",1158,"205.188.103.1",25,6,372,6,372,0,0,15983.412429,9.012624999999389,330.2034645844248,0
"147.32.84.165",4484,"88.198.65.167",25,6,372,6,372,0,0,15983.912936,9.01241999999911,330.21097552048104,0
"147.32.84.165",4094,"88.198.10.142",25,6,372,6,372,0,0,15984.914079,9.013308999999936,330.1784061769125,0
"147.32.84.165",1159,"67.195.168.31",25,6,372,6,372,0,0,15987.017033,9.013014000000112,330.18921306457116,0
"147.32.84.165",3957,"212.117.174.7",4506,6,372,6,372,0,0,15993.626425,9.012985999999728,330.1902388398351,0
"147.32.84.165",4500,"81.9.5.194",25,6,372,6,372,0,0,15995.830228,9.012821999998778,330.1962470800381,0
"147.32.84.165",3688,"64.12.139.193",25,6,372,6,372,0,0,15996.130111,9.013232999999673,330.18119025660474,0
"147.32.84.165",3656,"212.117.174.7",4506,6,372,6,372,0,0,15996.230466,9.012894999999844,330.19357265340955,0
"147.32.84.165",4504,"217.199.218.198",25,6,372,6,372,0,0,15996.230529,9.012955000000147,330.19137452699493,0
"147.32.84.165",4957,"188.120.233.150",25,6,372,6,372,0,0,15998.133094,9.012869000000137,330.1945251839292,0
"147.32.84.165",1161,"74.125.67.27",25,6,372,6,372,0,0,16003.240776,9.012754999999743,330.1987017288371,0
"147.32.84.165",4506,"89.108.109.146",25,6,372,6,372,0,0,16004.442009,9.012869000000137,330.1945251839292,0
"147.32.84.165",3694,"209.85.225.27",25,6,372,6,372,0,0,16004.943226,9.012416999999914,330.21108543912567,0
"147.32.84.165",4537,"81.177.159.2",25,6,372,6,372,0,0,16005.94424,9.0127569999986,330.1986284552509,0
"147.32.84.165",4094,"88.198.10.142",25,6,372,6,372,0,0,16008.047482,9.012736000000587,330.1993978298939,0
"147.32.84.165",1162,"64.12.139.193",25,6,372,6,372,0,0,16014.656589,9.01293699999951,330.19203396186634,0
"147.32.84.165",4581,"93.170.48.156",25,6,372,6,372,0,0,16014.656722,9.012936000000991,330.19207059715865,0
"147.32.84.165",3749,"67.195.168.230",25,6,372,6,372,0,0,16016.859979,9.01302299999952,330.1888833524732,0
"147.32.84.165",3957,"218.200.225.22",6667,6,372,6,372,0,0,16017.160246,9.012867999999798,330.194561819841,0
"147.32.84.165",4642,"74.125.43.27",25,6,372,6,372,0,0,16017.260245,9.012985999999728,330.1902388398351,0
"147.32.84.165",4020,"205.188.190.1",25,6,372,6,372,0,0,16019.163139,9.013144000000466,330.1844506200995,0
"147.32.84.165",4644,"92.38.209.166",25,6,372,6,372,0,0,16024.270361,9.01318099999844,330.18309518032703,0
"147.32.84.165",4957,"188.120.233.150",25,6,372,6,372,0,0,16025.472844,8.912564000000202,333.91064569072745,0
"147.32.84.165",4937,"206.46.232.11",25,6,372,6,372,0,0,16025.973146,8.912796999999046,333.9019165364496,0
"147.32.84.165",1161,"212.117.174.7",4506,6,372,6,372,0,0,16026.974717,8.912962000000334,333.89573522246457,0
"147.32.84.165",4657,"46.188.12.33",25,6,372,6,372,0,0,16029.077733,8.913047000000006,333.8925509985528,0
"147.32.84.165",3901,"74.220.207.122",25,6,372,6,372,0,0,16035.586747,9.013148000000001,330.1843040855425,0
"147.32.84.165",3957,"212.117.174.7",4506,6,372,6,372,0,0,16037.790219,9.012928000000102,330.19236368025645,0
"147.32.84.165",4683,"77.222.41.36",25,6,372,6,372,0,0,16037.790354,9.012917999998535,330.192730034877,0
"147.32.84.165",1163,"124.108.96.211",25,6,372,6,372,0,0,16038.190373,9.01309300000139,330.1863189472849,0
"147.32.84.165",4685,"92.63.103.10",25,6,372,6,372,0,0,16038.991987,9.012878000001365,330.19419546115563,0
"147.32.84.165",3819,"98.139.214.154",25,6,372,6,372,0,0,16040.093508,9.012767000000167,330.1982620875415,0
"147.32.84.165",4724,"77.88.21.89",25,6,372,6,372,0,0,16045.201135,9.012384000001475,330.2122945493127,0
"147.32.84.165",4138,"165.212.65.113",25,6,372,6,372,0,0,16046.40279,9.0123339999991,330.2141265514901,0
"147.32.84.165",4729,"178.162.163.199",25,6,372,6,372,0,0,16046.903166,9.012756000000081,330.1986650920066,0
"147.32.84.165",4972,"165.21.74.118",25,6,372,6,372,0,0,16047.904492,9.013200999999754,330.18236251472496,0
"147.32.84.165",4937,"65.15.167.21",6667,4,248,4,248,0,0,16050.007567,3.004899999999907,660.2549169689712,0
"147.32.84.165",4732,"91.184.8.16",25,6,372,6,372,0,0,16056.61752,9.014053000000786,330.1511539814266,0
"147.32.84.165",4937,"72.14.213.27",25,6,372,6,372,0,0,16058.820586,9.012373999999909,330.21266094816195,0
"147.32.84.165",1164,"64.12.139.193",25,6,372,6,372,0,0,16059.220657,9.012979000000996,330.1904952845969,0
"147.32.84.165",4780,"209.190.61.53",25,6,372,6,372,0,0,16060.022331,9.012355000000753,330.2133571080757,0
"147.32.84.165",1163,"174.133.57.141",80,16,3429,12,1428,4,2001,16061.123519,0.6484139999993204,17618.37344661277,24687.930859014115
"147.32.84.165",4148,"67.195.168.31",25,6,372,6,372,0,0,16061.283235,8.953561999998783,332.38168228470465,0
"147.32.84.165",4784,"209.190.61.53",25,6,372,6,372,0,0,16066.230889,9.013100000000122,330.1860625090102,0
"147.32.84.165",1166,"150.12.74.3",25,6,372,6,372,0,0,16066.230955,9.013157999999748,330.18393774968587,0
"147.32.84.165",4786,"195.144.198.78",25,6,372,6,372,0,0,16067.432871,9.013058999998975,330.1875645105994,0
"147.32.84.165",4179,"209.85.225.27",25,6,372,6,372,0,0,16067.933846,9.012640000000829,330.20291501710113,0
"147.32.84.165",4798,"195.144.198.78",25,6,372,6,372,0,0,16068.935273,9.01247400000102,330.20899699679165,0
"147.32.84.165",4395,"205.188.190.1",25,6,372,6,372,0,0,16068.935405,9.012405999999828,330.21148847489303,0
"147.32.84.165",4804,"46.4.24.50",25,6,372,6,372,0,0,16070.236664,9.013361999999688,330.1764646754566,0
"147.32.84.165",4972,"217.16.28.65",25,6,372,6,372,0,0,16077.647895,9.012319999999818,330.2146395156919,0
"147.32.84.165",1167,"66.94.237.139",25,6,372,6,372,0,0,16079.850327,9.013069000000542,330.18719816744124,0
"147.32.84.165",4819,"46.4.24.50",25,6,372,6,372,0,0,16080.251883,9.012061999999787,330.22409299892416,0
"147.32.84.165",4420,"205.188.103.1",25,6,372,6,372,0,0,16080.252017,9.01205299999856,330.22442278141017,0
"147.32.84.165",4826,"79.174.72.149",25,6,372,6,372,0,0,16081.052451,9.012688000000708,330.20115641413156,0
"147.32.84.165",3844,"62.24.139.61",25,6,372,6,372,0,0,16082.253889,9.012880000000223,330.19412218956944,0
"147.32.84.165",4827,"79.174.72.149",25,6,372,6,372,0,0,16087.261557,9.012441000000763,330.21020609175116,0
"147.32.84.165",1169,"85.18.41.100",25,6,372,6,372,0,0,16087.261692,9.012434000000212,330.21046256759604,0
"147.32.84.165",4841,"188.40.138.237",25,6,372,6,372,0,0,16088.462811,9.012792000001355,330.1973461719246,0
"147.32.84.165",3774,"209.85.225.27",25,6,372,6,372,0,0,16088.963537,9.013526000000638,330.1704571551454,0
"147.32.84.165",4844,"188.40.138.237",25,6,372,6,372,0,0,16089.964979,9.01312599999983,330.1851100273153,0
"147.32.84.165",3835,"67.195.168.31",25,6,372,6,372,0,0,16089.965111,9.013074000000415,330.1870149962003,0
"147.32.84.165",4856,"46.4.54.212",25,6,372,6,372,0,0,16091.266905,9.013020999998844,330.188956621801,0
"147.32.84.165",1170,"46.243.48.229",25,6,372,6,372,0,0,16098.67795,8.912295000000086,333.9207241232445,0
"147.32.84.165",4859,"46.4.54.212",25,6,372,6,372,0,0,16100.880941,8.912510000000111,333.91266882168577,0
"147.32.84.165",4972,"217.16.28.65",25,6,372,6,372,0,0,16100.88108,8.912496000000829,333.9131933410936,0
"147.32.84.165",3871,"74.125.113.27",25,6,372,6,372,0,0,16101.281283,8.912737000000561,333.90416434365926,0
"147.32.84.165",4867,"91.212.89.47",25,6,372,6,372,0,0,16102.082518,8.912594000001263,333.9095217396392,0
"147.32.84.165",3889,"209.86.93.226",25,6,372,6,372,0,0,16103.284287,9.013039999999819,330.1882605646996,0
"147.32.84.165",3844,"212.117.174.7",4506,6,372,6,372,0,0,16108.191066,9.012915000001158,330.1928399413084,0
"147.32.84.165",4827,"92.112.3.72",6667,6,372,6,372,0,0,16109.392886,9.012828000000809,330.19602726244557,0
"147.32.84.165",4884,"91.212.89.47",25,6,372,6,372,0,0,16109.893514,9.01341500000126,330.1745231967666,0
"147.32.84.165",4477,"65.55.92.168",25,6,372,6,372,0,0,16109.89365,9.013402000000497,330.17499940642125,0
"147.32.84.165",4907,"188.138.90.31",25,6,372,6,372,0,0,16110.895378,9.012597000000824,330.20449044817246,0
"147.32.84.165",1172,"74.114.196.20",25,6,372,6,372,0,0,16112.197257,9.013058000000456,330.18760114489993,0
"147.32.84.165",4922,"188.138.90.31",25,6,372,6,372,0,0,16119.607924,9.013157999999748,330.18393774968587,0
"147.32.84.165",4827,"91.224.107.33",25,6,372,6,372,0,0,16119.608056,9.013154000000213,330.1840842839177,0
"147.32.84.165",4069,"65.61.209.13",25,6,372,6,372,0,0,16121.810755,9.013285999999425,330.1792487224071,0
"147.32.84.165",4972,"212.117.171.138",65500,14,846,10,604,4,242,16122.211824,1.2648239999998623,3820.2943650662273,1530.6477422947469
"147.32.84.165",4933,"217.106.233.115",25,6,372,6,372,0,0,16122.234413,8.990405000000464,331.0195703085507,0
"147.32.84.165",4516,"64.12.139.193",25,6,372,6,372,0,0,16123.01257,9.012740999998641,330.1992146451838,0
"147.32.84.165",4966,"204.45.66.195",25,6,372,6,372,0,0,16124.314913,9.01225599999998,330.21698451530966,0
"147.32.84.165",4983,"209.85.225.27",25,6,372,6,372,0,0,16129.221956,9.012285000000702,330.2159219332021,0
"147.32.84.165",3889,"212.117.171.138",65500,24,1471,18,1092,6,379,16130.92376,14.655424000000494,596.0932962430637,206.88586014296808
"147.32.84.165",4970,"204.45.66.195",25,6,372,6,372,0,0,16130.923906,9.01296800000091,330.1908982701036,0
"147.32.84.165",1173,"205.188.103.1",25,6,372,6,372,0,0,16130.923965,9.013033999999607,330.18848037188474,0
"147.32.84.165",3844,"59.99.153.96",6667,6,372,6,372,0,0,16130.946526,8.99052599999959,331.0151152446626,0
"147.32.84.165",4974,"91.206.226.10",25,6,372,6,372,0,0,16131.925691,9.013026999999056,330.1887368139818,0
"147.32.84.165",3821,"89.121.3.94",25,6,372,6,372,0,0,16133.227714,9.012217999999848,330.2183768745996,0
"147.32.84.165",4570,"92.53.96.75",25,6,372,6,372,0,0,16140.637845,9.013168000001315,330.1835714145754,0
"147.32.84.165",4827,"91.224.107.33",25,6,372,6,372,0,0,16142.841272,9.012666000000536,330.20196243817566,0
"147.32.84.165",1174,"209.85.225.27",25,6,372,6,372,0,0,16143.241427,9.013251999998829,330.1804942323133,0
"147.32.84.165",4962,"92.53.116.6",25,6,372,6,372,0,0,16143.241561,9.013245999998617,330.1807140291585,0
"147.32.84.165",4120,"74.6.140.64",25,6,372,6,372,0,0,16144.04257,9.013229000000138,330.18133678839786,0
"147.32.84.165",1105,"85.112.111.18",25,6,372,6,372,0,0,16145.344844,9.013161000000764,330.18382784904736,0
"147.32.84.165",4527,"66.94.237.139",25,6,372,6,372,0,0,16150.251512,9.01329799999985,330.1788091329111,0
"147.32.84.165",4983,"182.2.117.2",6667,9,552,6,372,3,180,16151.954347,2.587807999998404,1150.0080376912954,556.4555021086913
"147.32.84.165",1107,"85.112.111.18",25,6,372,6,372,0,0,16151.954492,9.012699999999313,330.200716766366,0
"147.32.84.165",3958,"67.195.168.31",25,6,372,6,372,0,0,16151.954549,9.012769000000844,330.1981888140838,0
"147.32.84.165",4959,"46.4.74.165",25,6,372,6,372,0,0,16152.955794,9.012872999999672,330.19437864043,0
"147.32.84.165",1171,"150.214.76.100",25,6,372,6,372,0,0,16154.257346,9.01327499999934,330.1796516804622,0
"147.32.84.165",3821,"212.117.174.7",4506,6,372,6,372,0,0,16154.542497,8.928305999999793,333.3219089937183,0
"147.32.84.165",2774,"80.89.150.114",25,6,372,6,372,0,0,16161.668036,9.013076000001092,330.18694172773417,0
"147.32.84.165",1175,"64.12.139.193",25,6,372,6,372,0,0,16163.871103,9.480094000000463,313.9209379147353,0
"147.32.84.165",1116,"195.58.12.131",25,6,372,6,372,0,0,16164.271963,9.134846000000834,325.78545932791076,0
"147.32.84.165",4579,"208.108.226.104",25,6,372,6,372,0,0,16165.073037,8.913822000000437,333.86352116969067,0
"147.32.84.165",4827,"212.117.171.138",65500,24,1472,18,1092,6,380,16166.375185,82.64147999999841,105.70962669110195,36.785401229504345
"147.32.84.165",2441,"81.9.5.194",25,6,372,6,372,0,0,16166.397694,8.891352000000552,334.70725262027815,0
"147.32.84.165",3908,"67.195.168.31",25,6,372,6,372,0,0,16171.28251,8.912066000000777,333.92930438348867,0
"147.32.84.165",4962,"95.58.236.6",6667,9,552,6,372,3,180,16171.282636,2.3286410000000615,1277.9986266667647,618.3864322581119
"147.32.84.165",4888,"89.253.239.179",25,6,372,6,372,0,0,16172.984761,9.012402000000293,330.2116350335796,0
"147.32.84.165",4963,"66.94.237.139",25,6,372,6,372,0,0,16173.611529,8.986661999999342,331.15744199572856,0
"147.32.84.165",3958,"212.117.174.7",4506,6,372,6,372,0,0,16173.8854,9.013181000000259,330.1830951802604,0
"147.32.84.165",4978,"89.108.109.146",25,6,372,6,372,0,0,16173.885471,9.013237000001027,330.181043724875,0
"147.32.84.165",4962,"195.146.81.131",25,6,372,6,372,0,0,16175.187834,9.012891000000309,330.19371919619334,0
"147.32.84.165",1177,"205.188.103.1",25,6,372,6,372,0,0,16175.387659,9.013197000000218,330.1825090475586,0
"147.32.84.165",4987,"194.85.88.229",25,6,372,6,372,0,0,16182.598333,9.01259200000095,330.20467363880294,0
"147.32.84.165",1171,"62.109.2.254",25,6,372,6,372,0,0,16184.901726,9.012586000000738,330.20489346784115,0
"147.32.84.165",4010,"204.58.244.10",25,6,372,6,372,0,0,16185.202152,9.012633000000278,330.2031714816201,0
"147.32.84.165",1175,"212.117.174.7",4506,6,372,6,372,0,0,16186.002975,9.01300000000083,330.18972595137313,0
"147.32.84.165",4988,"194.85.88.237",25,6,372,6,372,0,0,16187.304965,9.013184999999794,330.1829486469065,0
"147.32.84.165",3821,"195.248.234.8",25,6,372,6,372,0,0,16194.014431,9.013129000000845,330.18500012589647,0
"147.32.84.165",4996,"66.94.237.139",25,6,372,6,372,0,0,16194.615895,9.012826999998651,330.1960638987573,0
"147.32.84.165",4917,"72.14.213.27",25,6,372,6,372,0,0,16194.915874,9.013323999999557,330.1778566930631,0
"147.32.84.165",4199,"195.50.106.142",25,6,372,6,372,0,0,16196.217719,9.013218000000052,330.1817397515497,0
"147.32.84.165",4992,"74.125.157.27",25,6,372,6,372,0,0,16196.418473,9.012370000000374,330.21280750788935,0
"147.32.84.165",3958,"195.146.81.131",25,6,372,6,372,0,0,16203.628859,9.012527999999293,330.2070184969449,0
"147.32.84.165",4650,"65.55.37.120",25,6,372,6,372,0,0,16205.931611,9.013365999999223,330.17631814798784,0
"147.32.84.165",4963,"222.23.80.7",6667,4,248,4,248,0,0,16206.23207,3.004345999999714,660.3766676675019,0
"147.32.84.165",4962,"212.117.174.7",4506,6,372,6,372,0,0,16207.033244,9.013284999999087,330.17928535492905,0
"147.32.84.165",4964,"91.209.127.12",25,6,372,6,372,0,0,16208.335118,9.0129769999985,330.1905685547068,0
"147.32.84.165",4978,"62.109.2.254",25,6,372,6,372,0,0,16215.044819,9.01278099999945,330.1977491742207,0
"147.32.84.165",1180,"205.188.190.1",25,6,372,6,372,0,0,16215.645605,9.012904999999591,330.1932062969858,0
"147.32.84.165",1177,"212.117.174.7",4506,6,372,6,372,0,0,16215.946348,9.013171000000511,330.1834615142474,0
"147.32.84.165",1125,"89.108.118.81",25,6,372,6,372,0,0,16215.946497,9.013113999999405,330.18554963358906,0
"147.32.84.165",4010,"195.248.234.8",25,6,372,6,372,0,0,16217.248152,9.01282799999899,330.19602726251225,0
"147.32.84.165",4986,"195.50.106.142",25,6,372,6,372,0,0,16217.448125,9.013387999999395,330.1755122491343,0
"147.32.84.165",1175,"212.117.171.138",65500,14,846,10,604,4,242,16224.658646,80.05269899999985,60.36023844742586,24.18406904681632
"147.32.84.165",1120,"216.246.15.206",25,6,372,6,372,0,0,16224.658706,9.012982000000193,330.19038537965974,0
"147.32.84.165",3958,"195.146.81.131",25,6,372,6,372,0,0,16226.461377,9.012791000001016,330.1973828084624,0
"147.32.84.165",1179,"209.85.225.27",25,6,372,6,372,0,0,16226.962218,9.012531999998828,330.20687194235614,0
"147.32.84.165",3821,"195.186.18.144",25,6,372,6,372,0,0,16228.063441,9.013191000000006,330.18272884708625,0
"147.32.84.165",4982,"78.46.109.184",25,6,372,6,372,0,0,16229.365738,9.013364999998885,330.1763547798595,0
"147.32.84.165",4964,"174.133.57.141",80,17,3489,12,1428,5,2061,16236.074896,0.6107219999994413,18705.728629409863,26997.553715135666
"147.32.84.165",4207,"77.238.184.241",25,6,372,6,372,0,0,16236.234087,8.853832999999213,336.1256079711764,0
"147.32.84.165",4996,"71.224.19.142",6667,6,372,6,372,0,0,16236.678077,8.91063799999938,333.9828191876055,0
"147.32.84.165",1031,"77.222.41.36",25,6,372,6,372,0,0,16236.976745,8.91236200000094,333.9182138247623,0
"147.32.84.165",1181,"205.188.190.1",25,6,372,6,372,0,0,16238.278757,8.912457000000359,333.9146545110827,0
"147.32.84.165",1180,"212.117.174.7",4506,6,372,6,372,0,0,16238.478865,8.912640000000465,333.90779836275726,0
"147.32.84.165",1034,"77.222.41.41",25,6,372,6,372,0,0,16245.588853,9.014555000001565,330.13276861691827,0
"147.32.84.165",4964,"195.248.234.8",25,6,372,6,372,0,0,16247.39164,9.01248300000043,330.20866724518186,0
"147.32.84.165",1176,"216.32.181.178",25,6,372,6,372,0,0,16247.892074,9.014780000001338,330.1245288292735,0
"147.32.84.165",1038,"78.108.81.249",25,6,372,6,372,0,0,16248.993472,9.013968999999634,330.1542306169592,0
"147.32.84.165",4070,"66.241.143.133",25,6,372,6,372,0,0,16250.29536,9.013521000000765,330.1706403080159,0
"147.32.84.165",1041,"94.75.207.42",25,6,372,6,372,0,0,16257.106892,9.011319999999614,330.2512839406577,0
"147.32.84.165",1184,"209.85.225.27",25,6,372,6,372,0,0,16257.606895,9.012338999998974,330.2139433503709,0
"147.32.84.165",1043,"81.177.24.26",25,6,372,6,372,0,0,16257.907287,9.012101000000257,330.2226639492739,0
"147.32.84.165",1433,"209.85.225.27",25,6,372,6,372,0,0,16259.208255,9.012904000001072,330.1932429325383,0
"147.32.84.165",1056,"92.53.96.75",25,6,372,6,372,0,0,16259.208352,9.012932999999975,330.19218050328436,0
"147.32.84.165",4083,"195.130.137.71",25,6,372,6,372,0,0,16259.40859,9.013027000000875,330.1887368139151,0
"147.32.84.165",1073,"92.53.116.6",25,6,372,6,372,0,0,16266.619309,9.012496999999712,330.2081542995349,0
"147.32.84.165",1804,"98.139.214.154",25,6,372,6,372,0,0,16268.421772,9.013175000000047,330.1833149805684,0
"147.32.84.165",4953,"92.63.103.10",25,6,372,6,372,0,0,16268.922464,9.013104000001476,330.18591597295585,0
"147.32.84.165",1185,"209.85.225.27",25,6,372,6,372,0,0,16270.023899,9.012914999999339,330.19283994137504,0
"147.32.84.165",4964,"212.117.174.7",4506,6,372,6,372,0,0,16270.024039,9.012919000000693,330.1926933993051,0
"147.32.84.165",1078,"77.88.21.89",25,6,372,6,372,0,0,16271.327334,9.011242000000493,330.25414254770175,0
"147.32.84.165",1186,"66.94.237.139",25,6,372,6,372,0,0,16278.135617,9.012899999999718,330.19338947509607,0
"147.32.84.165",1083,"89.253.239.179",25,6,372,6,372,0,0,16278.636359,9.013182999999117,330.1830219136005,0
"147.32.84.165",2105,"65.55.37.72",25,6,372,6,372,0,0,16278.936718,9.013273999999,330.1796883130736,0
"147.32.84.165",2682,"188.120.234.114",25,6,372,6,372,0,0,16280.23858,9.013546000000133,330.16972454569554,0
"147.32.84.165",4133,"64.12.90.65",25,6,372,6,372,0,0,16280.439244,9.013020000000324,330.18899325641047,0
"147.32.84.165",4083,"212.117.174.7",4506,6,372,6,372,0,0,16287.649678,9.013864000000467,330.1580764919291,0
"147.32.84.165",1084,"78.108.90.240",25,6,372,6,372,0,0,16287.649739,9.01393199999984,330.15558581982344,0
"147.32.84.165",1187,"205.188.103.1",25,6,372,6,372,0,0,16289.452404,9.012367999999697,330.21288078783516,0
"147.32.84.165",2146,"81.211.26.66",25,6,372,6,372,0,0,16289.952498,9.012998999998672,330.1897625862866,0
"147.32.84.165",4329,"66.94.237.139",25,6,372,6,372,0,0,16291.053952,9.012964999999895,330.19100817544887,0
"147.32.84.165",1086,"46.17.40.43",25,6,372,6,372,0,0,16291.054086,9.012957999999344,330.1912646214724,0
"147.32.84.165",5000,"67.195.168.230",25,6,372,6,372,0,0,16292.355868,9.013523999999961,330.1705304162959,0
"147.32.84.165",1131,"72.14.213.27",25,6,372,6,372,0,0,16299.165689,9.012932999999975,330.19218050328436,0
"147.32.84.165",1027,"209.85.225.27",25,6,372,6,372,0,0,16299.66704,9.012704999999187,330.20053358012586,0
"147.32.84.165",1088,"74.125.157.27",25,6,372,6,372,0,0,16299.966906,9.013286999999764,330.17921208989327,0
"147.32.84.165",1183,"74.125.244.13",25,6,372,6,372,0,0,16301.268741,9.013570999999502,330.1688087884552,0
"147.32.84.165",1089,"195.8.102.42",25,6,372,6,372,0,0,16301.46944,9.01281199999903,330.1966134432095,0
"147.32.84.165",1188,"217.16.18.217",25,6,372,6,372,0,0,16308.679899,8.912483000000066,333.9136803963585,0
"147.32.84.165",1175,"212.117.171.138",65500,14,846,10,604,4,242,16310.482397,28.4757869999994,169.6880230211057,67.98758538262844
"147.32.84.165",2159,"91.209.127.12",25,6,372,6,372,0,0,16310.50494,8.889788999998927,334.7661007477634,0
"147.32.84.165",4188,"205.188.190.1",25,6,372,6,372,0,0,16310.982661,8.912750999999844,333.903639852617,0
"147.32.84.165",2146,"212.117.174.7",4506,6,372,6,372,0,0,16312.084251,9.013020000000324,330.18899325641047,0
"147.32.84.165",1096,"96.9.156.107",25,6,372,6,372,0,0,16313.286626,9.012248000000909,330.2172776425704,0
"147.32.84.165",5000,"212.176.27.2",25,6,372,6,372,0,0,16320.096306,9.012917000000016,330.1927666703238,0
"147.32.84.165",4635,"67.195.168.31",25,6,372,6,372,0,0,16320.596531,9.012989000000744,330.19012893500195,0
"147.32.84.165",1097,"93.170.24.114",25,6,372,6,372,0,0,16320.897262,9.01267100000041,330.20177925055344,0
"147.32.84.165",1032,"209.85.225.27",25,6,372,6,372,0,0,16322.199096,9.012867999999798,330.194561819841,0
"147.32.84.165",4997,"89.108.118.81",25,6,372,6,372,0,0,16322.399081,9.01307000000088,330.1871615331634,0
"147.32.84.165",4124,"64.12.90.65",25,6,372,6,372,0,0,16329.609599,9.014027000001079,330.1521062672259,0
"147.32.84.165",1183,"212.117.174.7",4506,6,372,6,372,0,0,16331.412285,9.01277200000004,330.1980789040249,0
"147.32.84.165",1101,"216.246.15.206",25,6,372,6,372,0,0,16331.412345,9.012839999999414,330.1955876283384,0
"147.32.84.165",4201,"85.158.139.19",25,6,372,6,372,0,0,16331.912899,9.012956999999005,330.19130125666067,0
"147.32.84.165",1102,"78.46.109.184",25,6,372,6,372,0,0,16333.114683,9.012914999999339,330.19283994137504,0
"147.32.84.165",1190,"66.94.237.139",25,6,372,6,372,0,0,16334.316477,9.012795000000551,330.1972362624267,0
"147.32.84.165",1104,"77.222.41.41",25,6,372,6,372,0,0,16341.126074,9.013025000000198,330.18881008317794,0
"147.32.84.165",5000,"212.176.27.2",25,6,372,6,372,0,0,16341.627036,9.012722999999824,330.19987411130444,0
"147.32.84.165",2851,"205.188.103.1",25,6,372,6,372,0,0,16341.927262,9.013226000000941,330.18144668731145,0
"147.32.84.165",1097,"212.117.171.138",65500,14,846,10,604,4,242,16343.229184,237.4097040000015,20.353001240420944,8.154679304936868
"147.32.84.165",1106,"78.108.81.249",25,6,372,6,372,0,0,16343.251959,8.989996000000247,331.0346300487696,0
"147.32.84.165",4236,"64.12.139.193",25,6,372,6,372,0,0,16343.429301,9.013467000000674,330.17261837201795,0
"147.32.84.165",1135,"178.162.163.199",25,6,372,6,372,0,0,16350.639911,9.012663999999859,330.20203571330813,0
"147.32.84.165",1029,"209.85.225.27",25,6,372,6,372,0,0,16352.442945,9.012237999999343,330.2176440524781,0
"147.32.84.165",1134,"74.125.39.27",25,6,372,6,372,0,0,16352.943197,9.01359500000035,330.16792966623024,0
"147.32.84.165",1195,"67.195.168.230",25,6,372,6,372,0,0,16354.144645,9.01299199999994,330.1900190303087,0
"147.32.84.165",1772,"74.125.127.27",25,6,372,6,372,0,0,16355.346464,9.013210999999501,330.1819961831765,0
"147.32.84.165",1190,"95.163.17.112",25,6,372,6,372,0,0,16362.156643,9.012618999999177,330.2036844118532,0
"147.32.84.165",4440,"66.94.237.139",25,6,372,6,372,0,0,16362.656922,9.013221999999587,330.18159321939885,0
"147.32.84.165",1979,"74.125.127.27",25,6,372,6,372,0,0,16362.957452,9.013025000000198,330.18881008317794,0
"147.32.84.165",1035,"66.94.237.139",25,6,372,6,372,0,0,16362.957583,9.013018000001466,330.1890665257205,0
"147.32.84.165",2098,"87.242.115.87",25,6,372,6,372,0,0,16362.957642,9.013011000000915,330.18932296872794,0
"147.32.84.165",1189,"205.188.190.1",25,6,372,6,372,0,0,16364.25968,9.013089000000036,330.18646548369685,0
"147.32.84.165",2851,"212.117.174.7",4506,6,372,6,372,0,0,16364.459965,9.012672999999268,330.20170597560144,0
"147.32.84.165",2180,"91.184.8.16",25,6,372,6,372,0,0,16371.670247,9.012683000000834,330.2013396010627,0
"147.32.84.165",4277,"208.80.204.42",25,6,372,6,372,0,0,16373.472778,8.913178000000698,333.88764366646404,0
"147.32.84.165",2148,"85.13.141.104",25,6,372,6,372,0,0,16373.973827,8.912663000000975,333.9069366809532,0
"147.32.84.165",3475,"66.175.58.42",25,6,372,6,372,0,0,16375.175164,8.912649999998393,333.90742371803407,0
"147.32.84.165",1195,"88.250.200.14",6667,6,372,6,372,0,0,16376.376793,8.913226000000577,333.8858455961744,0
"147.32.84.165",2198,"209.85.225.27",25,6,372,6,372,0,0,16383.086481,9.01270100000147,330.20068012902175,0
"147.32.84.165",1190,"95.163.17.112",25,6,372,6,372,0,0,16383.587638,9.012676999998803,330.20155942572836,0
"147.32.84.165",4324,"209.85.225.27",25,6,372,6,372,0,0,16383.887558,9.013191000000006,330.18272884708625,0
"147.32.84.165",1037,"205.188.190.1",25,6,372,6,372,0,0,16383.887697,9.013185999998313,330.1829120136383,0
"147.32.84.165",1196,"206.46.232.11",25,6,372,6,372,0,0,16383.887761,9.013184000001274,330.18298528018283,0
"147.32.84.165",1142,"209.85.225.27",25,6,372,6,372,0,0,16385.189333,9.01306200000181,330.18745460747994,0
"147.32.84.165",4333,"205.188.103.1",25,6,372,6,372,0,0,16385.189486,9.013043999999354,330.1881140267609,0
"147.32.84.165",2296,"89.111.189.30",25,6,372,6,372,0,0,16385.389915,9.013123000000633,330.1852199287407,0
"147.32.84.165",1198,"66.94.237.139",25,6,372,6,372,0,0,16392.600458,9.012771999998222,330.1980789040916,0
"147.32.84.165",2412,"89.111.189.30",25,6,372,6,372,0,0,16394.40318,9.01282799999899,330.19602726251225,0
"147.32.84.165",2847,"161.58.16.34",25,6,372,6,372,0,0,16394.40325,9.012881999999081,330.1940489180157,0
"147.32.84.165",2417,"91.219.194.2",25,6,372,6,372,0,0,16394.903703,9.01289000000179,330.1937558318596,0
"147.32.84.165",4366,"209.85.225.27",25,6,372,6,372,0,0,16396.105231,9.0131029999975,330.18595260709054,0
"147.32.84.165",2148,"212.117.174.7",4506,6,372,6,372,0,0,16396.105376,9.013090000000375,330.1864288495817,0
"147.32.84.165",2688,"184.107.152.165",25,6,372,6,372,0,0,16398.308193,9.014139999999315,330.1479675266,0
"147.32.84.165",1191,"209.85.225.27",25,6,372,6,372,0,0,16404.116985,9.012466000000131,330.2092901099385,0
"147.32.84.165",2707,"184.107.152.165",25,6,372,6,372,0,0,16404.617347,9.081466999999975,327.7003594243098,0
"147.32.84.165",1199,"207.115.20.23",25,6,372,6,372,0,0,16404.617419,9.084618000000773,327.5866965457157,0
"147.32.84.165",1148,"217.72.192.149",25,6,372,6,372,0,0,16404.917656,9.013488999997207,330.1718124913585,0
"147.32.84.165",1190,"95.163.17.112",25,6,372,6,372,0,0,16406.220302,9.012440999998944,330.21020609181784,0
"147.32.84.165",4058,"66.94.237.139",25,6,372,6,372,0,0,16406.419853,9.012972000000445,330.1907517298237,0
"147.32.84.165",2756,"88.198.65.167",25,6,372,6,372,0,0,16406.420007,9.012944999998581,330.1917408794205,0
"147.32.84.165",1142,"174.133.57.141",80,17,3489,12,1428,5,2061,16413.63094,1.417460000000574,8059.486687451762,11632.074273696135
"147.32.84.165",4392,"205.188.103.1",25,6,372,6,372,0,0,16413.872407,8.970980000001873,331.73633203946264,0
"147.32.84.165",4333,"61.153.193.110",6667,2,124,2,124,0,0,16415.433018,9.999999747378752e-06,0,0
"147.32.84.165",2931,"74.125.39.27",25,6,372,6,372,0,0,16415.933505,9.012965999998414,330.1909715403923,0
"147.32.84.165",1202,"205.188.103.1",25,6,372,6,372,0,0,16417.135246,9.013030999998591,330.1885902756204,0
"147.32.84.165",2965,"94.229.67.92",25,6,372,6,372,0,0,16417.135379,9.013034999999945,330.1884437373225,0
"147.32.84.165",1203,"208.62.125.134",25,6,372,6,372,0,0,16419.338622,9.01301500000045,330.1891764298463,0
"147.32.84.165",3056,"94.229.67.92",25,6,372,6,372,0,0,16425.146909,9.012962000000698,330.19111808080066,0
"147.32.84.165",4538,"200.234.222.116",25,6,372,6,372,0,0,16425.14709,9.012902000002214,330.1933162037343,0
"147.32.84.165",3951,"91.219.194.2",25,6,372,6,372,0,0,16425.647905,9.0126479999999,330.2026219153387,0
"147.32.84.165",3461,"209.85.225.27",25,6,372,6,372,0,0,16425.947987,9.012974000001122,330.19067845969926,0
"147.32.84.165",3666,"217.199.218.198",25,6,372,6,372,0,0,16427.249997,9.012839999999414,330.1955876283384,0
"147.32.84.165",4365,"203.97.94.148",25,6,372,6,372,0,0,16427.450327,9.0128500000028,330.19522126731005,0
"147.32.84.165",1190,"119.154.131.100",6667,6,372,6,372,0,0,16429.55337,9.012731999999232,330.1995443779149,0
"147.32.84.165",3540,"81.177.159.2",25,6,372,6,372,0,0,16434.860843,9.013462000002619,330.1728015272195,0
"147.32.84.165",4397,"165.21.74.114",25,6,372,6,372,0,0,16436.963885,9.012986999998247,330.19020220494923,0
"147.32.84.165",3690,"93.170.48.156",25,6,372,6,372,0,0,16438.16557,9.013491999998223,330.1717025987915,0
"147.32.84.165",1197,"205.188.103.1",25,6,372,6,372,0,0,16440.369175,9.013171999999031,330.18342488086546,0
"147.32.84.165",3723,"194.85.88.230",25,6,372,6,372,0,0,16446.177061,8.913318000002619,333.88239934883126,0
"147.32.84.165",1204,"67.195.168.31",25,6,372,6,372,0,0,16446.678119,8.912497000001167,333.91315587535234,0
"147.32.84.165",3764,"188.120.234.114",25,6,372,6,372,0,0,16446.978501,8.912630999999237,333.9081355438427,0
"147.32.84.165",1205,"209.85.225.27",25,6,372,6,372,0,0,16448.280436,8.912476999998034,333.9139051916382,0
"147.32.84.165",3461,"212.117.174.7",4506,6,372,6,372,0,0,16448.480793,8.912490000002435,333.91341813558125,0
"147.32.84.165",4017,"78.108.90.240",25,6,372,6,372,0,0,16450.583678,8.912606000001688,333.90907216132257,0
"147.32.84.165",4263,"65.55.37.72",25,6,372,6,372,0,0,16455.790909,9.01293799999985,330.1919973265155,0
"147.32.84.165",3985,"46.17.40.43",25,6,372,6,372,0,0,16457.894057,9.01279599999907,330.19719962598805,0
"147.32.84.165",4465,"64.12.90.65",25,6,372,6,372,0,0,16459.095581,9.013100999996823,330.1860258751177,0
"147.32.84.165",4397,"178.121.31.113",6667,4,248,4,248,0,0,16461.299292,3.004209999999148,660.406562790405,0
"147.32.84.165",4954,"74.125.43.27",25,6,372,6,372,0,0,16467.107112,9.013717999998335,330.1634242385384,0
"147.32.84.165",1047,"205.188.190.1",25,6,372,6,372,0,0,16467.607982,9.01292900000044,330.19232704483244,0
"147.32.84.165",3723,"212.117.174.7",4506,6,372,6,372,0,0,16467.908963,9.01227999999901,330.21610513658334,0
"147.32.84.165",4080,"209.85.229.27",25,6,372,6,372,0,0,16467.909121,9.012252000000444,330.217131078875,0
"147.32.84.165",1050,"66.94.237.139",25,6,372,6,372,0,0,16469.210598,9.013334999999643,330.17745373938925,0
"147.32.84.165",4086,"195.8.102.42",25,6,372,6,372,0,0,16469.410711,9.012896000000183,330.19353601771724,0
"147.32.84.165",4397,"173.192.170.88",80,49,7562,32,2808,17,4754,16471.513842,43.583722999999736,515.4217779880837,872.6193492006231
"147.32.84.165",4480,"77.238.177.9",25,6,372,6,372,0,0,16471.714574,9.012649000000238,330.2025852776383,0
"147.32.84.165",1156,"96.9.156.107",25,6,372,6,372,0,0,16476.821264,9.012839000002714,330.19562426435266,0
"147.32.84.165",4491,"216.123.218.251",25,6,372,6,372,0,0,16478.924601,9.013105000001815,330.18587933896265,0
"147.32.84.165",3846,"93.170.24.114",25,6,372,6,372,0,0,16480.126002,9.013273000000481,330.17972494562645,0
"147.32.84.165",1211,"168.95.5.28",25,6,372,6,372,0,0,16481.22739,9.012894999999844,330.19357265340955,0
"147.32.84.165",4271,"92.38.209.166",25,6,372,6,372,0,0,16488.138,9.012886000000435,330.1939023748726,0
"147.32.84.165",4150,"205.188.190.1",25,6,372,6,372,0,0,16488.638539,9.014092000001256,330.14972556299466,0
"147.32.84.165",4304,"46.188.12.33",25,6,372,6,372,0,0,16488.938807,9.014108999999735,330.14910292299413,0
"147.32.84.165",4518,"209.85.225.27",25,6,372,6,372,0,0,16490.240422,9.013586000000942,330.1682593364826,0
"147.32.84.165",3723,"89.43.210.7",6667,6,372,6,372,0,0,16490.440587,9.013160999998945,330.18382784911404,0
"147.32.84.165",4954,"212.117.174.7",4506,6,372,6,372,0,0,16492.74437,9.01292199999807,330.1925834929712,0
"147.32.84.165",4441,"217.199.219.174",25,6,372,6,372,0,0,16497.852118,9.012257000002137,330.21694787435536,0
"147.32.84.165",1214,"67.195.168.31",25,6,372,6,372,0,0,16499.954909,9.012612999998964,330.20390423957423,0
"147.32.84.165",4447,"89.108.118.80",25,6,372,6,372,0,0,16501.15627,9.013594000000012,330.16796629624054,0
"147.32.84.165",4243,"209.85.225.27",25,6,372,6,372,0,0,16502.257977,9.01284499999747,330.1954044478559,0
"147.32.84.165",1158,"88.198.65.167",25,6,372,6,372,0,0,16502.258112,9.012910000001284,330.1930231190122,0
"147.32.84.165",4566,"205.188.103.1",25,6,372,6,372,0,0,16509.168371,9.01220000000103,330.2190364172632,0
"147.32.84.165",4500,"81.9.5.194",25,6,372,6,372,0,0,16509.668402,9.013447000001179,330.17335099431006,0
"147.32.84.165",4995,"66.89.154.179",25,6,372,6,372,0,0,16509.96882,9.012925000002724,330.19247358644395,0
"147.32.84.165",3688,"217.199.218.198",25,6,372,6,372,0,0,16511.271101,9.012958000002982,330.19126462133914,0
"147.32.84.165",1207,"208.65.145.3",25,6,372,6,372,0,0,16512.472852,8.912861000000703,333.8995189086608,0
"147.32.84.165",4506,"89.108.109.146",25,6,372,6,372,0,0,16513.7742,8.912793999999849,333.9020289260641,0
"147.32.84.165",1216,"209.85.225.27",25,6,372,6,372,0,0,16518.882056,8.912288999999873,333.9209489279401,0
"147.32.84.165",4537,"81.177.159.2",25,6,372,6,372,0,0,16520.884397,9.013519999996788,330.17067693876095,0
"147.32.84.165",1218,"66.94.237.139",25,6,372,6,372,0,0,16522.086657,9.012705000001006,330.20053358005924,0
"147.32.84.165",4581,"93.170.48.156",25,6,372,6,372,0,0,16523.188025,9.013224999998783,330.1814833203877,0
"147.32.84.165",4473,"67.195.168.31",25,6,372,6,372,0,0,16530.097674,9.012933999998495,330.1921438679676,0
"147.32.84.165",3749,"74.125.43.27",25,6,372,6,372,0,0,16530.598391,9.013192999998864,330.1826555805889,0
"147.32.84.165",4595,"216.230.254.1",25,6,372,6,372,0,0,16530.899254,9.013044999999693,330.1880773922799,0
"147.32.84.165",4566,"82.205.135.35",6667,6,372,6,372,0,0,16532.20139,9.012960000000021,330.19119135112027,0
"147.32.84.165",4644,"92.38.209.166",25,6,372,6,372,0,0,16533.403133,9.012327000000369,330.21438303335844,0
"147.32.84.165",1052,"208.65.144.3",25,6,372,6,372,0,0,16534.704301,9.013199999997596,330.18239914800444,0
"147.32.84.165",1207,"212.117.174.7",4506,6,372,6,372,0,0,16539.812665,9.012285999997403,330.21588529268354,0
"147.32.84.165",4657,"46.188.12.33",25,6,372,6,372,0,0,16541.915182,9.01241999999911,330.21097552048104,0
"147.32.84.165",1208,"209.85.225.27",25,6,372,6,372,0,0,16543.117116,9.012768999997206,330.1981888142171,0
"147.32.84.165",1218,"212.117.174.7",4506,6,372,6,372,0,0,16544.218002,9.013482999998814,330.1720322765785,0
"147.32.84.165",4683,"77.222.41.36",25,6,372,6,372,0,0,16544.218139,9.013471999998728,330.1724352170196,0
"147.32.84.165",1226,"174.143.82.82",25,6,372,6,372,0,0,16551.12839,9.012842999996792,330.1954777200778,0
"147.32.84.165",4685,"92.63.103.10",25,6,372,6,372,0,0,16551.629039,9.01307000000088,330.1871615331634,0
"147.32.84.165",4498,"205.188.103.1",25,6,372,6,372,0,0,16551.929197,9.013305999997101,330.1785160740085,0
"147.32.84.165",4724,"77.88.21.89",25,6,372,6,372,0,0,16553.331654,9.012627999996766,330.20335467092036,0
"147.32.84.165",4617,"206.46.232.11",25,6,372,6,372,0,0,16554.432802,9.012818999999581,330.19635698887754,0
"147.32.84.165",4729,"178.162.163.199",25,6,372,6,372,0,0,16555.734671,9.013380000000325,330.1758053027713,0
"147.32.84.165",4658,"66.94.237.139",25,6,372,6,372,0,0,16560.841949,9.013212999998359,330.1819229170044,0
"147.32.84.165",1207,"195.70.198.9",6667,6,372,6,372,0,0,16562.945283,9.012855999997555,330.19500145134987,0
"147.32.84.165",4732,"91.184.8.16",25,6,372,6,372,0,0,16564.146871,9.013214999999036,330.1818496507981,0
"147.32.84.165",1233,"209.85.225.27",25,6,372,6,372,0,0,16565.248198,9.013575999997556,330.1686256376833,0
"147.32.84.165",1218,"212.117.174.7",4506,6,372,6,372,0,0,16572.158471,9.013202000001911,330.18232588145355,0
"147.32.84.165",4937,"209.190.61.53",25,6,372,6,372,0,0,16572.659593,9.012711999999738,330.20027711970454,0
"147.32.84.165",2839,"205.188.103.1",25,6,372,6,372,0,0,16572.959479,9.013104999998177,330.1858793390959,0
"147.32.84.165",1166,"209.190.61.53",25,6,372,6,372,0,0,16574.361873,9.012549999999464,330.20621244821683,0
"147.32.84.165",4559,"209.85.225.27",25,6,372,6,372,0,0,16574.362005,9.012543000000733,330.20646891779137,0
"147.32.84.165",4786,"195.144.198.78",25,6,372,6,372,0,0,16574.36207,9.012526000002254,330.20709177418803,0
"147.32.84.165",4765,"205.188.103.1",25,6,372,6,372,0,0,16575.46295,9.015059999997902,330.1142754458309,0
"147.32.84.165",4724,"212.117.174.7",4506,6,372,6,372,0,0,16575.46308,9.015054999999847,330.1144585363096,0
"147.32.84.165",4395,"195.144.198.78",25,6,372,6,372,0,0,16575.463136,9.015050000001793,330.11464162699133,0
"147.32.84.165",1234,"209.85.225.27",25,6,372,6,372,0,0,16575.463193,9.015043999999762,330.11486133623737,0
"147.32.84.165",4804,"46.4.24.50",25,6,372,6,372,0,0,16575.463255,9.015032999999676,330.11526413714813,0
"147.32.84.165",1215,"66.175.58.41",25,6,372,6,372,0,0,16576.765072,9.01288900000145,330.1937924676007,0
"147.32.84.165",1097,"212.117.171.138",65500,14,846,10,604,4,242,16581.872515,94.00133199999982,51.403526920235656,20.595452838902364
"147.32.84.165",4420,"46.4.24.50",25,6,372,6,372,0,0,16581.895141,8.88999899999908,334.75819288622057,0
"147.32.84.165",1828,"205.188.103.1",25,6,372,6,372,0,0,16581.895205,8.890000999999756,334.7581175750241,0
"147.32.84.165",4819,"79.174.72.149",25,6,372,6,372,0,0,16581.895264,8.889971000000514,334.759247246119,0
"147.32.84.165",4675,"209.85.225.27",25,6,372,6,372,0,0,16584.577652,8.91135900000154,333.9557973143587,0
"147.32.84.165",4658,"117.207.49.181",6667,9,552,6,372,3,180,16584.577787,1.7896220000002359,1662.9209967242289,804.6391919633365
"147.32.84.165",1169,"79.174.72.149",25,6,372,6,372,0,0,16585.176994,8.913057999998273,333.89213892701883,0
"147.32.84.165",4998,"147.202.2.128",25,6,372,6,372,0,0,16585.177128,8.91305900000225,333.8921014658659,0
"147.32.84.165",4841,"188.40.138.237",25,6,372,6,372,0,0,16586.278665,8.91316899999947,333.8879808068462,0
"147.32.84.165",1235,"205.188.103.1",25,6,372,6,372,0,0,16586.367642,8.824326999998448,337.24951489224316,0
"147.32.84.165",3835,"188.40.138.237",25,6,372,6,372,0,0,16586.367705,8.824335999997857,337.2491709292034,0
"147.32.84.165",2132,"209.85.225.27",25,6,372,6,372,0,0,16586.367764,8.82434099999955,337.24897983885165,0
"147.32.84.165",4856,"46.4.54.212",25,6,372,6,372,0,0,16593.088531,9.012635999999475,330.2030615682441,0
"147.32.84.165",2206,"209.85.225.27",25,6,372,6,372,0,0,16593.588982,9.013202999998612,330.1822892483902,0
"147.32.84.165",4859,"46.4.54.212",25,6,372,6,372,0,0,16593.589134,9.013176999997086,330.18324171387763,0
"147.32.84.165",4711,"168.95.5.34",25,6,372,6,372,0,0,16593.589211,9.013152000003174,330.1841575509824,0
"147.32.84.165",4867,"91.212.89.47",25,6,372,6,372,0,0,16593.889593,9.013006000001042,330.1895061425296,0
"147.32.84.165",2839,"173.192.170.88",80,6,372,6,372,0,0,16595.291644,9.012732999999571,330.19950774089745,0
"147.32.84.165",1237,"63.68.14.49",25,6,372,6,372,0,0,16596.396953,9.011170000001584,330.2567813058101,0
"147.32.84.165",4559,"125.114.134.15",6667,6,372,6,372,0,0,16597.694923,9.012963000001037,330.1910814456531,0
"147.32.84.165",4765,"212.117.174.7",4506,6,372,6,372,0,0,16602.802527,9.01263299999846,330.20317148168675,0
"147.32.84.165",4884,"91.212.89.47",25,6,372,6,372,0,0,16606.107141,9.012977999998839,330.1905319196811,0
"147.32.84.165",1247,"174.37.109.44",25,6,372,6,372,0,0,16606.107275,9.012990000002901,330.1900923000072,0
"147.32.84.165",4907,"188.138.90.31",25,6,372,6,372,0,0,16607.208684,9.013413999997283,330.1745598283733,0
"147.32.84.165",3606,"67.195.168.31",25,6,372,6,372,0,0,16607.208759,9.013488999997207,330.1718124913585,0
"147.32.84.165",4841,"212.117.174.7",4506,6,372,6,372,0,0,16614.11899,9.012864000000263,330.1947083635028,0
"147.32.84.165",3844,"188.138.90.31",25,6,372,6,372,0,0,16614.119125,9.012865999997302,330.1946350917556,0
"147.32.84.165",1026,"205.188.103.1",25,6,372,6,372,0,0,16614.119185,9.012891000002128,330.19371919612666,0
"147.32.84.165",4933,"217.106.233.115",25,6,372,6,372,0,0,16614.619211,9.013284000000567,330.1793219873925,0
"147.32.84.165",1036,"64.12.90.65",25,6,372,6,372,0,0,16614.919702,9.012840999999753,330.19555099219895,0
"147.32.84.165",4711,"62.178.214.33",6667,6,372,6,372,0,0,16617.423379,9.013332999998966,330.1775270036447,0
"147.32.84.165",4966,"204.45.66.195",25,6,372,6,372,0,0,16618.825283,9.012983000000531,330.19034874467474,0
"147.32.84.165",1074,"66.94.237.139",25,6,372,6,372,0,0,16623.8327,9.012825000001612,330.1961371711386,0
"147.32.84.165",1173,"204.45.66.195",25,6,372,6,372,0,0,16625.43498,9.01308599999902,330.1865753860912,0
"147.32.84.165",4765,"174.133.57.141",80,17,3489,12,1428,5,2061,16625.435116,0.7648320000007516,14936.613530799932,21557.675411049484
"147.32.84.165",1095,"72.37.202.117",25,6,372,6,372,0,0,16625.59864,8.949462000000494,332.53395567240085,0
"147.32.84.165",4974,"91.206.226.10",25,6,372,6,372,0,0,16627.13726,9.013124000000971,330.1851832949019,0
"147.32.84.165",1249,"209.85.225.27",25,6,372,6,372,0,0,16628.238771,9.013244999998278,330.1807506620056,0
"147.32.84.165",4570,"92.53.96.75",25,6,372,6,372,0,0,16628.238912,9.013229000000138,330.18133678839786,0
"147.32.84.165",1250,"24.113.32.85",25,6,372,6,372,0,0,16635.148636,9.01396499999828,330.15437712489097,0
"147.32.84.165",4711,"212.117.174.7",4506,6,372,6,372,0,0,16635.64934,9.013510000000679,330.1710432450595,0
"147.32.84.165",1174,"92.53.116.6",25,6,372,6,372,0,0,16635.95019,9.013160999998945,330.18382784911404,0
"147.32.84.165",1026,"174.133.57.141",80,17,3489,12,1428,5,2061,16639.85579,2.498507000000245,4572.330595831382,6599.141007008739
"147.32.84.165",2502,"65.54.188.126",25,6,372,6,372,0,0,16639.855935,9.012797999999748,330.197126353002,0
"147.32.84.165",1105,"85.112.111.18",25,6,372,6,372,0,0,16640.008831,8.960308000001532,332.13144012454603,0
"147.32.84.165",4721,"209.85.225.27",25,6,372,6,372,0,0,16644.86316,9.012818999999581,330.19635698887754,0
"147.32.84.165",4966,"212.117.174.7",4506,6,372,6,372,0,0,16644.863293,9.012814000001526,330.19654017041694,0
"147.32.84.165",1107,"85.112.111.18",25,6,372,6,372,0,0,16644.863352,9.012808999999834,330.1967233522928,0
"147.32.84.165",1072,"67.195.168.31",25,6,372,6,372,0,0,16644.863414,9.012797999999748,330.197126353002,0
"147.32.84.165",4959,"46.4.74.165",25,6,372,6,372,0,0,16646.565284,9.013316000000486,330.1781497508619,0
"147.32.84.165",1077,"205.188.190.1",25,6,372,6,372,0,0,16648.167451,9.012909999997646,330.19302311914544,0
"147.32.84.165",2774,"80.89.150.114",25,6,372,6,372,0,0,16649.269372,9.014266000001953,330.14335276986003,0
"147.32.84.165",4733,"205.188.103.1",25,6,372,6,372,0,0,16649.269482,9.014279999999417,330.1428400271783,0
"147.32.84.165",1116,"195.58.12.131",25,6,372,6,372,0,0,16656.179069,8.912902000000031,333.89798294651837,0
"147.32.84.165",1040,"207.63.250.30",25,6,372,6,372,0,0,16656.679654,9.013050000001385,330.18789421999685,0
"147.32.84.165",4888,"89.108.109.146",25,6,372,6,372,0,0,16656.980085,8.912952999999106,333.89607237918773,0
"147.32.84.165",4711,"173.192.170.88",80,23,2735,18,2174,5,561,16660.785779,35.740311999998085,486.6213814809712,125.57249080534721
"147.32.84.165",1236,"209.85.225.27",25,6,372,6,372,0,0,16660.885967,9.012825000001612,330.1961371711386,0
"147.32.84.165",1174,"202.95.154.126",6667,8,492,6,372,2,120,16663.990919,8.1204089999992,366.48400345355674,118.2206462753409
"147.32.84.165",4987,"72.14.213.27",25,6,372,6,372,0,0,16665.792896,9.01313300000038,330.1848535908518,0
"147.32.84.165",1252,"64.12.139.193",25,6,372,6,372,0,0,16667.495231,9.013320999998541,330.1779665897267,0
"147.32.84.165",4721,"212.117.174.7",4506,6,372,6,372,0,0,16669.098015,9.012756000000081,330.1986650920066,0
"147.32.84.165",4962,"91.209.127.12",25,6,372,6,372,0,0,16670.199772,9.01251400000183,330.2075314389965,0
"147.32.84.165",2541,"209.85.225.27",25,6,372,6,372,0,0,16670.19996,9.012453999999707,330.20972978060104,0
"147.32.84.165",1125,"89.108.118.81",25,6,372,6,372,0,0,16670.200071,9.0123960000019,330.2118548718202,0
"147.32.84.165",1042,"65.54.188.126",25,6,372,6,372,0,0,16677.109777,9.012271999999939,330.21639826228284,0
"147.32.84.165",1174,"212.117.174.7",4506,6,372,6,372,0,0,16677.710236,9.012860000002547,330.194854907228,0
"147.32.84.165",1120,"216.246.15.206",25,6,372,6,372,0,0,16677.710373,9.012847999998485,330.195294539584,0
"147.32.84.165",1254,"66.94.237.139",25,6,372,6,372,0,0,16677.910502,9.012589000001753,330.2047835532521,0
"147.32.84.165",1040,"212.117.171.138",65500,14,846,10,604,4,242,16681.315115,3.70883799999865,1302.8339334319155,521.9963773021914
"147.32.84.165",3821,"78.46.109.184",25,6,372,6,372,0,0,16681.337828,8.990898000000016,331.0014194355219,0
"147.32.84.165",1260,"212.42.162.3",25,6,372,6,372,0,0,16681.918161,9.010817999998835,330.26968250833437,0
"147.32.84.165",1040,"212.117.171.138",65500,14,846,10,604,4,242,16686.823022,19.581578000001173,246.76254385625666,98.86843644571873
"147.32.84.165",4982,"74.125.157.27",25,6,372,6,372,0,0,16686.845817,8.990178000000014,331.02792847927986,0
"147.32.84.165",2920,"66.252.170.203",25,6,372,6,372,0,0,16688.527754,9.010916999999608,330.26605394324787,0
"147.32.84.165",1031,"77.222.41.36",25,6,372,6,372,0,0,16690.127806,9.013127999998687,330.18503675976126,0
"147.32.84.165",1045,"209.85.225.27",25,6,372,6,372,0,0,16691.229993,9.012472999998863,330.20903363598154,0
"147.32.84.165",1034,"77.222.41.41",25,6,372,6,372,0,0,16691.23014,9.012458000001061,330.20958322353897,0
"147.32.84.165",2541,"174.133.57.141",80,16,3429,12,1428,4,2001,16698.139389,0.480823000001692,23759.26276396886,33292.91652009922
"147.32.84.165",1263,"209.85.225.27",25,6,372,6,372,0,0,16698.29793,8.954842999999528,332.3341347246576,0
"147.32.84.165",1041,"94.75.207.42",25,6,372,6,372,0,0,16698.297967,8.954933000000892,332.330794658062,0
"147.32.84.165",1042,"173.192.170.88",80,40,7283,24,1886,16,5397,16698.740318,44.4854090000008,339.1673885700304,970.5654274191168
"147.32.84.165",3603,"77.238.177.9",25,6,372,6,372,0,0,16698.940649,9.013335999999981,330.17741710727375,0
"147.32.84.165",1056,"92.53.96.75",25,6,372,6,372,0,0,16698.941226,9.012885000000097,330.1939390106462,0
"147.32.84.165",1094,"205.188.103.1",25,6,372,6,372,0,0,16702.347062,9.012027000000671,330.2253754898624,0
"147.32.84.165",1120,"183.83.68.80",6667,4,248,4,248,0,0,16702.946383,3.004452000001038,660.3533689336074,0
"147.32.84.165",2541,"212.117.174.7",4506,6,372,6,372,0,0,16707.853234,9.015412000000651,330.1013863814305,0
"147.32.84.165",1073,"92.53.116.6",25,6,372,6,372,0,0,16709.555963,9.012684000001173,330.20130296364687,0
"147.32.84.165",3512,"209.85.225.27",25,6,372,6,372,0,0,16711.158769,9.012212999998155,330.21856008070483,0
"147.32.84.165",3821,"212.117.174.7",4506,6,372,6,372,0,0,16711.158904,9.01220000000103,330.2190364172632,0
"147.32.84.165",1040,"212.117.171.138",65500,24,1470,18,1092,6,378,16711.159005,53.099975999997696,164.51984837056008,56.94917828211695
"147.32.84.165",1078,"77.88.21.89",25,6,372,6,372,0,0,16711.181625,8.989535000000615,331.0516061175352,0
"147.32.84.165",4789,"66.94.237.139",25,6,372,6,372,0,0,16712.25966,9.013154000000213,330.1840842839177,0
"147.32.84.165",1083,"89.253.239.179",25,6,372,6,372,0,0,16712.259803,9.013135999997758,330.1847436897369,0
"147.32.84.165",1046,"209.85.225.27",25,6,372,6,372,0,0,16719.27005,9.012774999999237,330.19796899403923,0
"147.32.84.165",1084,"78.108.90.240",25,6,372,6,372,0,0,16719.971082,9.012750000001688,330.19888491297803,0
"147.32.84.165",1265,"64.12.139.193",25,6,372,6,372,0,0,16719.971222,9.012735000000248,330.19943446688694,0
"147.32.84.165",1056,"118.98.202.90",6667,6,372,6,372,0,0,16722.173805,8.91349000000264,333.8759565556386,0
"147.32.84.165",1187,"81.211.26.66",25,6,372,6,372,0,0,16723.375541,8.91288799999893,333.89850741985737,0
"147.32.84.165",2719,"65.55.92.152",25,6,372,6,372,0,0,16728.884155,8.912240000001475,333.92278484415897,0
"147.32.84.165",1086,"46.17.40.43",25,6,372,6,372,0,0,16730.485937,9.013444000000163,330.1734608879742,0
"147.32.84.165",2761,"216.32.181.178",25,6,372,6,372,0,0,16732.08855,9.012469999997847,330.2091435534,0
"147.32.84.165",1131,"72.14.213.27",25,6,372,6,372,0,0,16733.189649,9.01323499999853,330.1811169907902,0
"147.32.84.165",1268,"67.195.168.31",25,6,372,6,372,0,0,16733.18979,9.013215999999375,330.18181301770716,0
"147.32.84.165",1073,"212.117.171.138",65500,24,1467,18,1092,6,375,16740.199779,84.45074899999963,103.44490846374894,35.52366362079291
"147.32.84.165",1083,"212.117.174.7",4506,6,372,6,372,0,0,16740.199913,9.012962000000698,330.19111808080066,0
"147.32.84.165",1096,"96.9.156.107",25,6,372,6,372,0,0,16740.900725,9.013073000001896,330.1870516303789,0
"147.32.84.165",4495,"205.188.103.1",25,6,372,6,372,0,0,16740.900865,9.013057000000117,330.18763777927524,0
"147.32.84.165",1265,"212.117.174.7",4506,6,372,6,372,0,0,16743.204225,9.013144999997166,330.18441398656466,0
"147.32.84.165",3821,"75.180.133.40",25,6,372,6,372,0,0,16743.20436,9.013112000000547,330.1856229013707,0
"147.32.84.165",1032,"89.108.118.81",25,6,372,6,372,0,0,16744.305698,9.01354100000026,330.1699076977532,0
"147.32.84.165",1098,"80.12.242.53",25,6,372,6,372,0,0,16749.813587,9.015221999998175,330.1083434218927,0
"147.32.84.165",1084,"117.207.5.248",6667,6,368,4,248,2,120,16751.516634,1.003049999999348,1977.967200041164,957.0809032457245
"147.32.84.165",1101,"216.246.15.206",25,6,372,6,372,0,0,16753.118845,9.012756000000081,330.1986650920066,0
"147.32.84.165",1255,"167.138.239.80",25,6,372,6,372,0,0,16754.219886,9.013385000002017,330.1756221441039,0
"147.32.84.165",1102,"78.46.109.184",25,6,372,6,372,0,0,16754.220026,9.01338300000134,330.17569540754647,0
"147.32.84.165",1270,"205.188.190.1",25,6,372,6,372,0,0,16761.230301,9.012707000001683,330.2004603055935,0
"147.32.84.165",1104,"77.222.41.41",25,6,372,6,372,0,0,16761.931202,9.01276499999949,330.19833536103164,0
"147.32.84.165",4452,"209.85.225.27",25,6,372,6,372,0,0,16761.93134,9.012752000002365,330.19881163924396,0
"147.32.84.165",1083,"59.113.54.127",6667,6,372,6,372,0,0,16764.235507,9.012112999997044,330.22222424430055,0
"147.32.84.165",1106,"78.108.81.249",25,6,372,6,372,0,0,16764.235709,9.012037000000419,330.2250090628636,0
"147.32.84.165",4879,"66.94.237.139",25,6,372,6,372,0,0,16765.336356,9.01256099999955,330.20580942532854,0
"147.32.84.165",1040,"212.117.174.7",4506,6,372,6,372,0,0,16770.843826,9.014212999998563,330.14529388205875,0
"147.32.84.165",1035,"74.125.127.27",25,6,372,6,372,0,0,16774.148582,9.013227999999799,330.18137342138317,0
"147.32.84.165",1272,"205.188.103.1",25,6,372,6,372,0,0,16775.250792,9.014105000002019,330.1492494262418,0
"147.32.84.165",1083,"212.117.174.7",4506,6,372,6,372,0,0,16775.250931,9.014090000000579,330.14979881494514,0
"147.32.84.165",1275,"205.188.103.1",25,6,372,6,372,0,0,16775.250993,9.014080999997532,330.15012844912474,0
"147.32.84.165",4324,"209.85.225.27",25,6,372,6,372,0,0,16775.25105,9.014086000002862,330.14994531881047,0
"147.32.84.165",1103,"66.94.237.139",25,6,372,6,372,0,0,16775.251104,9.014085000002524,330.1499819448304,0
"147.32.84.165",2847,"91.219.194.2",25,6,372,6,372,0,0,16775.251159,9.014080000000831,330.1501650750521,0
"147.32.84.165",1276,"209.85.225.27",25,6,372,6,372,0,0,16782.2609,9.012429999998858,330.2106091254387,0
"147.32.84.165",2688,"184.107.152.165",25,6,372,6,372,0,0,16782.261032,9.012424000000465,330.2108289623132,0
"147.32.84.165",1273,"76.96.62.116",25,6,372,6,372,0,0,16782.961746,9.012630999997782,330.2032447573558,0
"147.32.84.165",1202,"94.229.67.92",25,6,372,6,372,0,0,16782.961885,9.01261599999998,330.2037943256438,0
"147.32.84.165",4863,"74.125.159.27",25,6,372,6,372,0,0,16785.264702,9.012831000000006,330.1959173538257,0
"147.32.84.165",4452,"87.101.19.76",6667,6,372,6,372,0,0,16785.264991,9.012684000001173,330.20130296364687,0
"147.32.84.165",3951,"91.219.194.2",25,6,372,6,372,0,0,16786.366088,9.013037000000622,330.1883704682223,0
"147.32.84.165",1106,"173.192.170.88",80,6,372,6,372,0,0,16786.366189,9.013079000000289,330.1868318251626,0
"147.32.84.165",4084,"80.207.73.84",25,6,372,6,372,0,0,16791.8746,8.912940000001981,333.8965593843713,0
"147.32.84.165",1204,"188.120.234.114",25,6,372,6,372,0,0,16795.17879,8.913108999997348,333.89022842656647,0
"147.32.84.165",1051,"205.188.103.1",25,6,372,6,372,0,0,16796.28044,8.912846999999601,333.900043386825,0
"147.32.84.165",4017,"78.108.90.240",25,6,372,6,372,0,0,16796.28061,8.91280099999858,333.9017666837253,0
"147.32.84.165",1053,"205.188.190.1",25,6,372,6,372,0,0,16803.190263,9.013082999998005,330.1866852885587,0
"147.32.84.165",1272,"212.117.174.7",4506,6,372,6,372,0,0,16803.893179,9.011232000000746,330.2545090393582,0
"147.32.84.165",1156,"96.9.156.107",25,6,372,6,372,0,0,16803.893333,9.011202000001504,330.2556085192079,0
"147.32.84.165",1060,"66.94.237.139",25,6,372,6,372,0,0,16806.194801,9.012839999999414,330.1955876283384,0
"147.32.84.165",1214,"89.108.118.80",25,6,372,6,372,0,0,16806.295152,9.013118000002578,330.18540309792337,0
"147.32.84.165",1278,"65.55.37.88",25,6,372,6,372,0,0,16807.296888,9.012400999999954,330.21167167328827,0
"147.32.84.165",1158,"88.198.65.167",25,6,372,6,372,0,0,16812.804731,9.01271899999847,330.20002065974825,0
"147.32.84.165",1106,"173.192.170.88",80,20,3517,14,1206,6,2311,16816.109214,35.14146500000061,274.5474612398724,526.102141729142
"147.32.84.165",1427,"209.85.225.27",25,6,372,6,372,0,0,16816.3102,9.013866000001144,330.1580032363053,0
"147.32.84.165",1204,"212.117.174.7",4506,6,372,6,372,0,0,16817.210627,9.013322999999218,330.17789332527616,0
"147.32.84.165",4995,"217.199.218.198",25,6,372,6,372,0,0,16817.210759,9.013287999998283,330.1791754574542,0
"147.32.84.165",3028,"209.86.93.121",25,6,372,6,372,0,0,16817.210826,9.013299000002007,330.17877250042824,0
"147.32.84.165",3749,"74.125.43.27",25,6,372,6,372,0,0,16824.220555,9.013114000001224,330.18554963352244,0
"147.32.84.165",1064,"64.12.139.193",25,6,372,6,372,0,0,16824.921526,9.013182000002416,330.18305854682643,0
"147.32.84.165",4017,"212.117.171.138",65500,14,846,10,604,4,242,16824.921675,104.24749999999767,46.351231444400185,18.571188757524578
"147.32.84.165",1166,"209.190.61.53",25,6,372,6,372,0,0,16824.944393,8.990441999998438,331.01820800362395,0
"147.32.84.165",1280,"209.85.225.27",25,6,372,6,372,0,0,16827.225156,9.012844000000769,330.1954410838295,0
"147.32.84.165",1053,"213.111.249.148",6667,4,248,4,248,0,0,16827.225217,3.0041019999989658,660.4303049632413,0
"147.32.84.165",1169,"79.174.72.149",25,6,372,6,372,0,0,16827.325032,9.013138999998773,330.1846337885619,0
"147.32.84.165",1281,"94.245.120.86",25,6,372,6,372,0,0,16828.327009,9.01307199999792,330.1870882647656,0
"147.32.84.165",3844,"188.138.90.31",25,6,372,6,372,0,0,16833.834584,9.01271899999847,330.20002065974825,0
"147.32.84.165",3036,"205.188.190.1",25,6,372,6,372,0,0,16837.340228,9.012731999999232,330.1995443779149,0
"147.32.84.165",1158,"212.117.174.7",4506,6,372,6,372,0,0,16838.240969,9.01283500000136,330.1957708090241,0
"147.32.84.165",4570,"92.53.96.75",25,6,372,6,372,0,0,16838.241107,9.01282099999662,330.1962837163987,0
"147.32.84.165",4889,"64.98.36.4",25,6,372,6,372,0,0,16845.250914,9.014439999999013,330.1369802228786,0
"147.32.84.165",1250,"92.53.116.6",25,6,372,6,372,0,0,16845.951832,9.0131020000008,330.18598924096676,0
"147.32.84.165",4665,"66.94.237.139",25,6,372,6,372,0,0,16845.951973,9.01308599999902,330.1865753860912,0
"147.32.84.165",1105,"85.112.111.18",25,6,372,6,372,0,0,16847.153617,9.01295200000095,330.1914844325906,0
"147.32.84.165",1284,"205.188.103.1",25,6,372,6,372,0,0,16848.355272,9.013033999999607,330.18848037188474,0
"147.32.84.165",1072,"85.112.111.18",25,6,372,6,372,0,0,16849.357728,9.01184700000158,330.23197131503434,0
"147.32.84.165",1108,"192.109.148.32",25,6,372,6,372,0,0,16849.357865,9.011834999997518,330.23241104623196,0
"147.32.84.165",1040,"178.63.93.194",25,6,372,6,372,0,0,16854.864722,9.013008000001719,330.18943287295787,0
"147.32.84.165",1106,"173.192.170.88",80,18,1707,14,1210,4,497,16858.369763,96.07781100000284,100.75167095553118,41.3831243511562
"147.32.84.165",1066,"67.195.168.31",25,6,372,6,372,0,0,16859.271127,9.013123000000633,330.1852199287407,0
"147.32.84.165",3844,"178.95.10.210",6667,9,552,6,372,3,180,16859.271268,2.3246519999993325,1280.1916157776968,619.4475560214662
"147.32.84.165",1273,"217.16.28.65",25,6,372,6,372,0,0,16861.575023,8.91229899999962,333.92057425363834,0
"147.32.84.165",1067,"205.188.190.1",25,6,372,6,372,0,0,16861.59615,8.891296999998303,334.70932306058023,0
"147.32.84.165",4570,"212.117.174.7",4506,6,372,6,372,0,0,16866.281167,8.912593999997625,333.9095217397755,0
"147.32.84.165",1287,"66.94.237.139",25,6,372,6,372,0,0,16866.981985,8.913151000000653,333.8886550895168,0
"147.32.84.165",4881,"91.217.56.202",25,6,372,6,372,0,0,16866.982118,8.913144999998622,333.88887985110307,0
"147.32.84.165",1288,"64.12.90.65",25,6,372,6,372,0,0,16866.982183,8.913128000000142,333.88951667696824,0
"147.32.84.165",1279,"62.239.224.235",25,6,372,6,372,0,0,16868.184032,8.912717999999586,333.90487615563944,0
"147.32.84.165",1105,"174.133.57.141",80,17,3489,12,1428,5,2061,16869.285353,6.8224929999996675,1674.4612270031728,2416.71189695626
"147.32.84.165",1118,"208.80.206.35",25,6,372,6,372,0,0,16869.447417,8.951097000001027,332.47321529413193,0
"147.32.84.165",4665,"212.117.174.7",4506,6,372,6,372,0,0,16870.287079,9.012785999999323,330.1975659912732,0
"147.32.84.165",4558,"160.114.120.249",25,6,372,6,372,0,0,16870.287213,9.012778000000253,330.19785908406004,0
"147.32.84.165",1284,"46.175.169.64",6667,4,248,4,248,0,0,16875.794998,3.0042709999979706,660.3931536140848,0
"147.32.84.165",1040,"178.63.93.194",25,6,372,6,372,0,0,16880.301255,9.013143000000127,330.1844872537757,0
"147.32.84.165",1072,"217.72.192.149",25,6,372,6,372,0,0,16882.504715,9.012989999999263,330.1900923001405,0
"147.32.84.165",1289,"205.188.103.1",25,6,372,6,372,0,0,16882.504853,9.012977000002138,330.1905685545735,0
"147.32.84.165",1067,"217.16.28.65",25,6,372,6,372,0,0,16887.211478,9.013010999999096,330.1893229687946,0
"147.32.84.165",3203,"66.94.237.139",25,6,372,6,372,0,0,16887.912401,9.012736999997287,330.19936119304225,0
"147.32.84.165",4726,"209.85.225.27",25,6,372,6,372,0,0,16887.912542,9.012721000002784,330.1999473853768,0
"147.32.84.165",1293,"69.78.67.53",25,6,372,6,372,0,0,16889.114464,9.012453000003006,330.2097664197536,0
"147.32.84.165",1071,"209.85.225.27",25,6,372,6,372,0,0,16890.415822,9.012867000001279,330.19459845569423,0
"147.32.84.165",3506,"205.188.190.1",25,6,372,6,372,0,0,16890.415956,9.012907000000268,330.19313302577194,0
"147.32.84.165",1069,"194.116.198.90",25,6,372,6,372,0,0,16891.316962,9.013098999999784,330.1860991430441,0
"147.32.84.165",1287,"212.117.174.7",4506,6,372,6,372,0,0,16894.621937,9.01274199999898,330.1991780082395,0
"147.32.84.165",1288,"187.38.130.143",6667,2,124,2,124,0,0,16901.331593,8.999999408842996e-06,0,0
"147.32.84.165",1040,"178.63.93.194",25,6,372,6,372,0,0,16903.534578,9.014202000002115,330.14569675710635,0
"147.32.84.165",4558,"173.192.170.88",80,19,3484,16,3298,3,186,16903.534716,10.411684000002424,2534.0761398438385,142.91636204091995
"147.32.84.165",4837,"209.85.225.27",25,6,372,6,372,0,0,16903.534774,9.014137999998638,330.1480407777704,0
"147.32.84.165",1110,"64.12.90.65",25,6,372,6,372,0,0,16903.534829,9.014189999998052,330.14613625857044,0
"147.32.84.165",1288,"212.117.174.7",4506,6,372,6,372,0,0,16908.241834,9.01272600000084,330.199764200057,0
"147.32.84.165",1136,"199.185.220.200",25,6,372,6,372,0,0,16908.241967,9.012722999999824,330.19987411130444,0
"147.32.84.165",1299,"209.85.225.27",25,6,372,6,372,0,0,16908.942413,9.013027000000875,330.1887368139151,0
"147.32.84.165",4749,"209.85.225.27",25,6,372,6,372,0,0,16908.942547,9.01303100000223,330.1885902754871,0
"147.32.84.165",1301,"64.12.139.193",25,6,372,6,372,0,0,16908.942607,9.013034999999945,330.1884437373225,0
"147.32.84.165",1304,"209.85.225.27",25,6,372,6,372,0,0,16908.94267,9.013033999999607,330.18848037188474,0
"147.32.84.165",4797,"72.4.117.21",25,6,372,6,372,0,0,16910.144132,9.012918000000354,330.1927300348104,0
"147.32.84.165",4807,"209.85.225.27",25,6,372,6,372,0,0,16911.448834,9.01036799999929,330.28617699079933,0
"147.32.84.165",1310,"64.12.90.65",25,6,372,6,372,0,0,16911.448995,9.010271000002831,330.28973268385215,0
"147.32.84.165",1140,"67.195.168.31",25,6,372,6,372,0,0,16911.449056,9.010237999998935,330.29094237026277,0
"147.32.84.165",1312,"67.50.48.18",25,6,372,6,372,0,0,16912.347289,9.013508000000002,330.17111650647,0
"147.32.84.165",1071,"186.90.182.143",6667,6,372,6,372,0,0,16915.051205,9.013119999999617,330.1853298303059,0
"147.32.84.165",1313,"66.94.237.139",25,6,372,6,372,0,0,16915.65198,9.013050000001385,330.18789421999685,0
"147.32.84.165",4558,"173.192.170.88",80,19,2125,14,1568,5,557,16924.564887,67.93923300000097,184.63558456716493,65.5880233443309
"147.32.84.165",4078,"77.238.177.9",25,6,372,6,372,0,0,16924.565025,9.012901000001875,330.1933528393778,0
"147.32.84.165",1309,"205.188.103.1",25,6,372,6,372,0,0,16924.565095,9.012974999997823,330.19064182478246,0
"147.32.84.165",1110,"212.117.174.7",4506,6,372,6,372,0,0,16929.271553,8.913118000000395,333.8898912815771,0
"147.32.84.165",4017,"212.117.171.138",65500,22,1338,16,972,6,366,16929.972914,102.9098849999973,75.56125439261936,28.452077271294947
"147.32.84.165",4837,"174.133.57.141",80,17,3489,12,1428,5,2061,16929.973055,2.225694000000658,5132.78105615445,7408.026440290141
"147.32.84.165",2588,"65.54.188.126",25,6,372,6,372,0,0,16929.995542,8.88994399999865,334.7602639567192,0
"147.32.84.165",1314,"209.85.225.27",25,6,372,6,372,0,0,16930.125482,8.86024499999985,335.88235991217516,0
"147.32.84.165",1315,"205.188.190.1",25,6,372,6,372,0,0,16931.174635,8.912776000001031,333.90270326547596,0
"147.32.84.165",4424,"66.94.237.139",25,6,372,6,372,0,0,16932.476234,8.912812999999005,333.90131712629136,0
"147.32.84.165",1316,"66.94.237.139",25,6,372,6,372,0,0,16932.476383,8.912744999997813,333.9038646343781,0
"147.32.84.165",1319,"209.85.225.27",25,6,372,6,372,0,0,16932.476456,8.912702000001445,333.9054755785078,0
"147.32.84.165",3702,"203.88.156.201",25,6,372,6,372,0,0,16932.476531,8.912650999998732,333.90738625358756,0
"147.32.84.165",1320,"64.12.90.65",25,6,372,6,372,0,0,16933.377584,8.912775999997393,333.9027032656122,0
"147.32.84.165",1304,"77.126.98.108",6667,6,372,6,372,0,0,16936.081735,8.914772000000085,333.8279431038698,0
"147.32.84.165",1299,"212.117.174.7",4506,6,372,6,372,0,0,16936.682267,8.913078999998106,333.89135224770615,0
"147.32.84.165",3892,"204.209.205.52",25,6,372,6,372,0,0,16936.682404,8.91306700000132,333.8918017781712,0
"147.32.84.165",4989,"62.36.20.20",25,6,372,6,372,0,0,16945.495406,9.012804000001779,330.1969065342387,0
"147.32.84.165",1271,"205.188.103.1",25,6,372,6,372,0,0,16945.495545,9.012732999999571,330.19950774089745,0
"147.32.84.165",1324,"65.55.92.168",25,6,372,6,372,0,0,16950.201635,9.012998999998672,330.1897625862866,0
"147.32.84.165",1326,"66.94.237.139",25,6,372,6,372,0,0,16950.902903,9.01542000000336,330.10109345974905,0
"147.32.84.165",2743,"209.85.225.27",25,6,372,6,372,0,0,16951.003533,9.014650000000984,330.12928954531515,0
"147.32.84.165",2531,"209.85.225.27",25,6,372,6,372,0,0,16952.104361,9.01307099999758,330.1871248990271,0
"147.32.84.165",1327,"66.94.237.139",25,6,372,6,372,0,0,16952.104495,9.013063999998849,330.187381338952,0
"147.32.84.165",4914,"207.115.20.22",25,6,372,6,372,0,0,16952.104555,9.013029999998253,330.1886269102152,0
"147.32.84.165",3870,"67.195.168.230",25,6,372,6,372,0,0,16953.406495,9.012790000000678,330.1974194450083,0
"147.32.84.165",1119,"64.12.90.65",25,6,372,6,372,0,0,16954.307988,9.012472999998863,330.20903363598154,0
"147.32.84.165",1106,"212.117.174.7",4506,6,372,6,372,0,0,16957.111778,9.012728000001516,330.19969092593266,0
"147.32.84.165",1329,"207.115.20.23",25,6,372,6,372,0,0,16957.61262,9.013059000000794,330.18756451053275,0
"147.32.84.165",4674,"209.85.225.27",25,6,372,6,372,0,0,16966.52734,9.011193999998795,330.2559017151776,0
"147.32.84.165",1328,"207.99.109.110",25,6,372,6,372,0,0,16966.527482,9.011131999999634,330.25817400079376,0
"147.32.84.165",1332,"205.188.190.1",25,6,372,6,372,0,0,16966.52756,9.011088999999629,330.2597499592028,0
"147.32.84.165",4989,"212.117.174.7",4506,6,372,6,372,0,0,16971.232009,9.01293799999985,330.1919973265155,0
"147.32.84.165",1333,"65.55.92.152",25,6,372,6,372,0,0,16971.232143,9.01293099999748,330.1922537741421,0
"147.32.84.165",4902,"209.85.225.27",25,6,372,6,372,0,0,16971.933004,9.013146000001143,330.18437735277143,0
"147.32.84.165",1334,"209.85.225.27",25,6,372,6,372,0,0,16971.933138,9.01314099999945,330.18456052115255,0
"147.32.84.165",1335,"77.238.177.9",25,6,372,6,372,0,0,16971.933196,9.01314899999852,330.1842674519736,0
"147.32.84.165",3504,"209.85.225.27",25,6,372,6,372,0,0,16972.033359,9.012838999999076,330.19562426448596,0
"147.32.84.165",4767,"64.12.139.193",25,6,372,6,372,0,0,16973.135163,9.012589000001753,330.2047835532521,0
"147.32.84.165",1339,"209.85.225.27",25,6,372,6,372,0,0,16974.438729,9.0113629999978,330.2497080631117,0
"147.32.84.165",3572,"205.188.156.193",25,6,372,6,372,0,0,16974.43888,9.011336999999912,330.25066091746754,0
"147.32.84.165",4455,"65.55.37.88",25,6,372,6,372,0,0,16975.338512,9.012334000002738,330.2141265513568,0
"147.32.84.165",2531,"115.137.250.215",6667,9,552,6,372,3,180,16978.141796,1.931520999998611,1540.7546695076783,745.5264529875863
"147.32.84.165",1341,"64.12.90.65",25,6,372,6,372,0,0,16978.64424,9.011800999996922,330.2336569572516,0
"147.32.84.165",1264,"209.85.225.27",25,6,372,6,372,0,0,16980.073584,8.983965999999782,331.2568190930456,0
"147.32.84.165",1342,"66.94.237.139",25,6,372,6,372,0,0,16980.073632,8.984001000000717,331.25552857794236,0
"147.32.84.165",1343,"76.96.62.116",25,6,372,6,372,0,0,16987.555643,9.013006000001042,330.1895061425296,0
"147.32.84.165",1336,"209.85.225.27",25,6,372,6,372,0,0,16987.555787,9.013027999997576,330.1887001794292,0
"147.32.84.165",1344,"64.12.90.65",25,6,372,6,372,0,0,16987.555845,9.013076999999612,330.1869050935799,0
"147.32.84.165",1345,"66.94.237.139",25,6,372,6,372,0,0,16987.5559,9.013158000001567,330.18393774961925,0
"147.32.84.165",1346,"63.84.77.70",25,6,372,6,372,0,0,16987.555956,9.013208000000304,330.18210608252906,0
"147.32.84.165",1332,"212.117.174.7",4506,6,372,6,372,0,0,16992.262246,9.012925000002724,330.19247358644395,0
"147.32.84.165",1333,"173.192.170.88",80,18,2429,14,1930,4,499,16992.966057,21.62734399999681,713.911056299945,184.58114875319822
"147.32.84.165",1303,"205.188.190.1",25,6,372,6,372,0,0,16993.066137,9.010556999997789,330.2792491075447,0
"147.32.84.165",1347,"209.85.225.27",25,6,372,6,372,0,0,16993.166835,9.009719000001496,330.30996860162963,0
"147.32.84.165",1348,"64.12.90.65",25,6,372,6,372,0,0,16994.164946,9.012866999997641,330.19459845582753,0
"147.32.84.165",3320,"77.238.184.241",25,6,372,6,372,0,0,16994.165094,9.01280499999848,330.1968698979399,0
"147.32.84.165",1331,"74.125.113.27",25,6,372,6,372,0,0,16995.467238,9.016779999998107,330.0513043459666,0
"147.32.84.165",1350,"209.85.225.27",25,6,372,6,372,0,0,16996.368196,9.013100000000122,330.1860625090102,0
"147.32.84.165",1349,"64.59.134.8",25,6,372,6,372,0,0,16996.368338,9.013095999998768,330.1862090451945,0
"147.32.84.165",3572,"212.117.174.7",4506,6,372,6,372,0,0,16999.672859,8.912700000000768,333.9055505065517,0
"147.32.84.165",1080,"64.12.90.65",25,6,372,6,372,0,0,16999.672992,8.91265900000144,333.907086538318,0
"147.32.84.165",1300,"66.94.237.139",25,6,372,6,372,0,0,17001.07499,8.912849000000278,333.8999684612526,0
"147.32.84.165",1352,"209.85.225.27",25,6,372,6,372,0,0,17008.485512,9.013568000002124,330.1689186789625,0
"147.32.84.165",4261,"82.194.66.206",25,6,372,6,372,0,0,17008.485645,9.013537999999244,330.17001758912534,0
"147.32.84.165",1353,"209.85.225.27",25,6,372,6,372,0,0,17008.485733,9.013472999999067,330.1723985860176,0
"147.32.84.165",1354,"67.195.168.31",25,6,372,6,372,0,0,17008.485792,9.013437000001431,330.1737173066753,0
"147.32.84.165",1336,"207.232.61.93",6667,4,248,4,248,0,0,17013.192286,3.004775999997946,660.2821641284928,0
"147.32.84.165",1472,"209.85.225.27",25,6,372,6,372,0,0,17013.993846,9.013025000000198,330.18881008317794,0
"147.32.84.165",1355,"209.249.171.237",25,6,372,6,372,0,0,17013.993927,9.013009000002057,330.18939623818426,0
"147.32.84.165",3905,"64.12.90.65",25,6,372,6,372,0,0,17014.093633,9.013113000000885,330.18558626744255,0
"147.32.84.165",1356,"65.55.92.184",25,6,372,6,372,0,0,17014.093778,9.013134000000719,330.18481695709426,0
"147.32.84.165",1298,"67.195.168.31",25,6,372,6,372,0,0,17015.095052,9.01305499999944,330.1877110480503,0
"147.32.84.165",2700,"64.12.139.193",25,6,372,6,372,0,0,17015.095126,9.01307799999995,330.1868684593672,0
"147.32.84.165",4958,"66.94.237.139",25,6,372,6,372,0,0,17016.398468,9.011334999999235,330.25073421421496,0
"147.32.84.165",1358,"85.158.136.3",25,6,372,6,372,0,0,17016.398602,9.011329999997542,330.25091745622586,0
"147.32.84.165",1325,"205.188.103.1",25,6,372,6,372,0,0,17017.298137,9.013026999997237,330.1887368140484,0
"147.32.84.165",1348,"212.117.174.7",4506,6,372,6,372,0,0,17020.606359,9.009756999999809,330.3085754699115,0
"147.32.84.165",1361,"75.101.133.30",25,6,372,6,372,0,0,17022.005114,9.012799000000086,330.1970897165211,0
"147.32.84.165",1362,"65.55.37.88",25,6,372,6,372,0,0,17029.515733,9.013111000000208,330.1856595353071,0
"147.32.84.165",3847,"77.238.177.9",25,6,372,6,372,0,0,17029.515813,9.013130999999703,330.1849268583912,0
"147.32.84.165",1352,"212.117.174.7",4506,6,372,6,372,0,0,17032.820656,9.012918000000354,330.1927300348104,0
"147.32.84.165",1363,"67.195.168.230",25,6,372,6,372,0,0,17032.82079,9.012908999997308,330.19305975472395,0
"147.32.84.165",4261,"212.117.171.138",65500,14,846,10,604,4,242,17035.023748,70.35600799999884,68.67928038213992,27.51719511999646
"147.32.84.165",1354,"193.233.112.1",25,6,372,6,372,0,0,17035.046525,8.990537999998196,331.01467342672896,0
"147.32.84.165",4212,"64.12.90.65",25,6,372,6,372,0,0,17035.124113,9.012949999996636,330.19155770320606,0
"147.32.84.165",4017,"217.21.62.243",25,6,372,6,372,0,0,17036.125272,9.013421999999991,330.17426677681385,0
"147.32.84.165",2900,"74.125.67.27",25,6,372,6,372,0,0,17037.427321,9.012785999999323,330.1975659912732,0
"147.32.84.165",2855,"67.195.168.31",25,6,372,6,372,0,0,17038.32864,9.012664000001678,330.2020357132415,0
"147.32.84.165",1365,"67.195.168.31",25,6,372,6,372,0,0,17041.6338,9.012257000002137,330.21694787435536,0
"147.32.84.165",3629,"64.12.90.65",25,6,372,6,372,0,0,17041.633931,9.012228999999934,330.2179738220169,0
"147.32.84.165",1261,"209.85.225.27",25,6,372,6,372,0,0,17041.633988,9.012197000000015,330.2191463413411,0
"147.32.84.165",1366,"209.85.225.27",25,6,372,6,372,0,0,17043.035203,9.013128999999026,330.1850001259631,0
"147.32.84.165",1291,"64.12.90.65",25,6,372,6,372,0,0,17043.035304,9.013089000000036,330.18646548369685,0
"147.32.84.165",1367,"207.69.189.42",25,6,372,6,372,0,0,17043.035334,9.01308599999902,330.1865753860912,0
"147.32.84.165",1370,"209.85.225.27",25,6,372,6,372,0,0,17050.548539,9.010634000002028,330.2764267197325,0
"147.32.84.165",1371,"168.95.5.8",25,6,372,6,372,0,0,17050.548673,9.01062599999932,330.2767199526675,0
"147.32.84.165",2155,"209.85.225.27",25,6,372,6,372,0,0,17050.548739,9.010609999997541,330.27730641996624,0
"147.32.84.165",1277,"195.222.122.13",25,6,372,6,372,0,0,17050.548802,9.010621999997966,330.27686656933025,0
"147.32.84.165",1362,"212.117.174.7",4506,6,372,6,372,0,0,17053.850783,9.013042999999016,330.18815066125006,0
"147.32.84.165",4319,"64.12.90.65",25,6,372,6,372,0,0,17056.054398,9.014306000000943,330.1418877947663,0
"147.32.84.165",1285,"66.94.237.139",25,6,372,6,372,0,0,17056.05453,9.014299999998912,330.1421075402815,0
"147.32.84.165",1363,"193.233.112.1",25,6,372,6,372,0,0,17056.15421,9.012877999997727,330.1941954612889,0
"147.32.84.165",1351,"216.32.181.178",25,6,372,6,372,0,0,17057.155431,9.013262000000395,330.1801279048439,0
"147.32.84.165",4212,"217.21.62.243",25,6,372,6,372,0,0,17058.457316,9.013166000000638,330.1836446815458,0
"147.32.84.165",1368,"67.195.168.31",25,6,372,6,372,0,0,17059.359062,9.014581999999791,330.131779820747,0
"147.32.84.165",2855,"84.229.253.152",6667,6,372,6,372,0,0,17062.663629,9.01328199999989,330.179395252477,0
"147.32.84.165",2900,"212.117.174.7",4506,6,372,6,372,0,0,17064.065416,9.013159999998607,330.18386448265204,0
"147.32.84.165",1372,"65.55.37.72",25,6,372,6,372,0,0,17064.065549,9.013118999999278,330.1853664641772,0
"147.32.84.165",4855,"62.101.93.149",25,6,372,6,372,0,0,17071.576513,8.91280800000095,333.9015044416622,0
"147.32.84.165",1373,"202.81.31.146",25,6,372,6,372,0,0,17071.576656,8.912795000000187,333.90199146282816,0
"147.32.84.165",1111,"209.85.225.27",25,6,372,6,372,0,0,17074.881269,8.914311000000453,333.8452068813674,0
"147.32.84.165",4817,"66.94.237.139",25,6,372,6,372,0,0,17077.084128,9.012903000002552,330.1932795680989,0
"147.32.84.165",3002,"69.56.0.57",25,6,372,6,372,0,0,17077.084275,9.012864000000263,330.1947083635028,0
"147.32.84.165",2855,"193.233.112.1",25,6,372,6,372,0,0,17078.085544,9.013265999998112,330.1799813741904,0
"147.32.84.165",1090,"65.55.37.72",25,6,372,6,372,0,0,17079.388057,9.013006000001042,330.1895061425296,0
"147.32.84.165",1375,"209.85.225.27",25,6,372,6,372,0,0,17079.388191,9.013001000002987,330.1896893164678,0
"147.32.84.165",4641,"209.85.225.27",25,6,372,6,372,0,0,17079.388248,9.01299199999994,330.1900190303087,0
"147.32.84.165",1317,"205.188.103.1",25,6,372,6,372,0,0,17079.388306,9.01298499999757,330.19027547486235,0
"147.32.84.165",1319,"212.117.174.7",4506,6,372,6,372,0,0,17080.288804,9.013008000001719,330.18943287295787,0
"147.32.84.165",4212,"78.138.22.163",6667,6,372,6,372,0,0,17083.896324,9.027173999998922,329.67127918442196,0
"147.32.84.165",1285,"217.21.62.243",25,6,372,6,372,0,0,17084.995998,9.012391000000207,330.21203807068866,0
"147.32.84.165",1377,"65.54.188.94",25,6,372,6,372,0,0,17092.506464,9.012754000003042,330.1987383655424,0
"147.32.84.165",4854,"65.55.88.22",25,6,372,6,372,0,0,17092.506605,9.012738000001264,330.19932455593215,0
"147.32.84.165",4855,"81.26.144.245",25,6,372,6,372,0,0,17095.810984,9.01314999999886,330.1842308183462,0
"147.32.84.165",1057,"209.85.225.27",25,6,372,6,372,0,0,17098.11444,9.013052999998763,330.18778431685786,0
"147.32.84.165",4212,"212.38.97.175",25,6,372,6,372,0,0,17098.114589,9.012995999997656,330.1898724908758,0
"147.32.84.165",1374,"80.67.18.126",25,6,372,6,372,0,0,17099.115887,9.013237999999546,330.1810070920295,0
"147.32.84.165",4817,"212.117.174.7",4506,6,372,6,372,0,0,17100.417735,9.013471000002028,330.17247184789636,0
"147.32.84.165",1111,"74.125.39.27",25,6,372,6,372,0,0,17100.417869,9.013464999999997,330.1726916341275,0
"147.32.84.165",1379,"83.146.216.28",25,6,372,6,372,0,0,17101.318944,9.013413000000583,330.1745964597215,0
"147.32.84.165",1317,"58.42.247.143",6667,15,1820,10,1262,5,558,17104.924216,2.671573999999964,3779.0456113138307,1670.9250801213293
"147.32.84.165",1090,"174.133.57.141",80,17,3489,12,1428,5,2061,17105.562964,9.450334000001021,1208.8461635322906,1744.7002402241253
"147.32.84.165",3680,"205.188.103.1",25,6,372,6,372,0,0,17105.716848,8.921328000000358,333.58262357351737,0
"147.32.84.165",4261,"212.117.171.138",65500,14,846,10,604,4,242,17106.025752,26.42413999999917,182.86309412530179,73.26633903695866
"147.32.84.165",1112,"209.85.225.27",25,6,372,6,372,0,0,17106.048867,8.98977499999819,331.0427680337494,0
"147.32.84.165",4890,"66.196.94.104",25,6,372,6,372,0,0,17106.048932,8.989834999996674,331.0405585865704,0
"147.32.84.165",1285,"212.117.174.7",4506,6,372,6,372,0,0,17113.536814,9.012775999999576,330.19793235737137,0
"147.32.84.165",1330,"205.188.103.1",25,6,372,6,372,0,0,17113.536957,9.012760000001435,330.1985185447661,0
"147.32.84.165",1383,"209.85.225.27",25,6,372,6,372,0,0,17113.537017,9.012752000002365,330.19881163924396,0
"147.32.84.165",1123,"209.85.225.27",25,6,372,6,372,0,0,17113.537073,9.01274900000135,330.19892154985723,0
"147.32.84.165",1290,"67.195.168.31",25,6,372,6,372,0,0,17113.537132,9.012743999999657,330.1991047343754,0
"147.32.84.165",1377,"173.192.170.88",80,48,7676,30,2688,18,4988,17116.841709,42.02234500000122,511.7277486537073,949.5900335880551
"147.32.84.165",4855,"81.26.144.245",25,6,372,6,372,0,0,17117.042537,9.012210999997478,330.2186333632039,0
"147.32.84.165",1384,"64.12.90.65",25,6,372,6,372,0,0,17119.144787,9.012846999998146,330.19533117566647,0
"147.32.84.165",4268,"209.85.225.27",25,6,372,6,372,0,0,17119.144925,9.012794999998732,330.19723626249333,0
"147.32.84.165",1057,"212.38.97.175",25,6,372,6,372,0,0,17120.146069,9.013012000003073,330.18928633391204,0
"147.32.84.165",1386,"66.94.237.139",25,6,372,6,372,0,0,17121.448526,9.012337000000116,330.21401663075426,0
"147.32.84.165",1111,"74.125.39.27",25,6,372,6,372,0,0,17122.349267,9.012805999998818,330.1968332615159,0
"147.32.84.165",1379,"174.133.57.141",80,16,3429,12,1428,4,2001,17126.65554,0.4784089999993739,23879.149430748483,33460.90897123789
"147.32.84.165",4772,"64.12.90.65",25,6,372,6,372,0,0,17126.814121,8.954995000000054,332.32849376241774,0
"147.32.84.165",1124,"205.188.190.1",25,6,372,6,372,0,0,17126.814184,8.955057999999553,332.32615578817564,0
"147.32.84.165",1382,"205.188.190.1",25,6,372,6,372,0,0,17127.055953,9.01363499999934,330.1664644730143,0
"147.32.84.165",1385,"66.94.237.139",25,6,372,6,372,0,0,17127.056086,9.013599999998405,330.1677465164337,0
"147.32.84.165",1387,"205.188.190.1",25,6,372,6,372,0,0,17127.056145,9.013567000001785,330.1689553091923,0
"147.32.84.165",4720,"209.85.225.27",25,6,372,6,372,0,0,17127.0562,9.013538999999582,330.16998095865983,0
"147.32.84.165",1168,"64.12.139.193",25,6,372,6,372,0,0,17127.05626,9.01350900000034,330.17107987576065,0
"147.32.84.165",4261,"212.117.171.138",65500,14,846,10,604,4,242,17134.566854,25.809956000000966,187.2145771964826,75.00981404229931
"147.32.84.165",4890,"212.117.174.7",4506,6,372,6,372,0,0,17134.56696,9.012744999999995,330.1990680974555,0
"147.32.84.165",1388,"209.85.225.27",25,6,372,6,372,0,0,17134.589477,8.990352999997413,331.0214849184294,0
"147.32.84.165",4260,"66.94.237.139",25,6,372,6,372,0,0,17134.589508,8.990374000000884,331.02071170784524,0
"147.32.84.165",1061,"66.46.182.96",25,6,372,6,372,0,0,17134.589538,8.990397000001394,331.0198648624236,0
"147.32.84.165",1383,"221.226.242.228",6667,6,372,6,372,0,0,17138.072447,8.912216000000626,333.9236840758562,0
"147.32.84.165",1123,"208.73.210.29",80,66,35638,40,4158,26,31480,17140.17478,14.561601999997947,2284.3640418138534,17294.800393530568
"147.32.84.165",1070,"209.85.225.27",25,6,372,6,372,0,0,17140.174878,8.912812999999005,333.90131712629136,0
"147.32.84.165",4855,"212.117.174.7",4506,6,372,6,372,0,0,17140.367651,8.820177999998123,337.4081566155052,0
"147.32.84.165",1384,"89.188.114.91",25,6,372,6,372,0,0,17140.367731,8.820190000002185,337.40769756652213,0
"147.32.84.165",1378,"66.94.237.139",25,6,372,6,372,0,0,17141.177057,8.912455999998201,333.91469197722836,0
"147.32.84.165",4268,"188.120.234.65",25,6,372,6,372,0,0,17141.177132,8.912514999999985,333.91248149372035,0
"147.32.84.165",3034,"64.12.90.65",25,6,372,6,372,0,0,17142.478491,8.912477999998373,333.91386772573725,0
"147.32.84.165",1057,"212.38.97.175",25,6,372,6,372,0,0,17143.380043,8.912287999999535,333.92098639543013,0
"147.32.84.165",1111,"89.108.70.32",25,6,372,6,372,0,0,17147.685632,9.013046000000031,330.188040757807,0
"147.32.84.165",1390,"74.125.43.27",25,6,372,6,372,0,0,17147.986082,9.012902999998914,330.1932795682322,0
"147.32.84.165",1386,"74.125.39.27",25,6,372,6,372,0,0,17155.496906,9.012893999999505,330.19360928910993,0
"147.32.84.165",4772,"212.59.117.29",25,6,372,6,372,0,0,17155.497051,9.01287500000035,330.19430536869584,0
"147.32.84.165",4818,"209.85.225.27",25,6,372,6,372,0,0,17159.6028,9.01314899999852,330.1842674519736,0
"147.32.84.165",1377,"173.192.170.88",80,16,1585,12,1088,4,497,17159.602955,41.32621800000197,210.6169018418183,96.2101104920806
"147.32.84.165",4890,"218.200.225.22",6667,4,248,4,248,0,0,17161.104893,3.00438099999883,660.368974507818,0
"147.32.84.165",1070,"91.226.92.20",25,6,372,6,372,0,0,17161.205553,9.012418999998772,330.2110121600433,0
"147.32.84.165",1168,"212.59.117.29",25,6,372,6,372,0,0,17162.106381,9.012925999999425,330.19243695112885,0
"147.32.84.165",4944,"74.125.45.27",25,6,372,6,372,0,0,17162.106516,9.012915999999677,330.19280330584536,0
"147.32.84.165",4268,"212.117.171.138",65500,23,1398,16,972,7,426,17162.808031,6.13987300000008,1266.4757072336674,555.060340824632
"147.32.84.165",1382,"188.138.90.25",25,6,372,6,372,0,0,17162.830744,8.989625000001979,331.04829178073,0
"147.32.84.165",1392,"216.32.181.178",25,6,372,6,372,0,0,17163.408292,9.012944999998581,330.1917408794205,0
"147.32.84.165",1383,"188.138.90.25",25,6,372,6,372,0,0,17164.309434,9.013032000002568,330.18855364090047,0
"147.32.84.165",1305,"206.46.232.11",25,6,372,6,372,0,0,17164.309566,9.013025000000198,330.18881008317794,0
"147.32.84.165",1385,"89.108.67.8",25,6,372,6,372,0,0,17168.715998,9.013169000001653,330.1835347811024,0
"147.32.84.165",1393,"209.85.225.27",25,6,372,6,372,0,0,17169.016282,9.012974000001122,330.19067845969926,0
"147.32.84.165",1057,"212.117.171.138",65500,17,1039,12,724,5,315,17176.527445,34.44940000000133,168.13064959040727,73.15076605107498
"147.32.84.165",4890,"212.117.174.7",4506,6,372,6,372,0,0,17176.527591,9.012539000003017,330.2066154719557,0
"147.32.84.165",1390,"217.16.28.65",25,6,372,6,372,0,0,17176.550066,8.990190000000439,331.02748662707404,0
"147.32.84.165",1387,"89.175.251.94",25,6,372,6,372,0,0,17180.633458,9.012643999998545,330.2027684662215,0
"147.32.84.165",4772,"174.133.57.141",80,17,3489,12,1428,5,2061,17182.235457,8.381692000002658,1362.97062693265,1967.1445813082573
"147.32.84.165",2591,"77.238.177.9",25,6,372,6,372,0,0,17182.394373,8.95422999999937,332.35688607509627,0
"147.32.84.165",4818,"212.117.174.7",4506,6,372,6,372,0,0,17183.138566,9.011144000000058,330.25773420111597,0
"147.32.84.165",4268,"217.16.28.65",25,6,372,6,372,0,0,17183.138702,9.011134000000311,330.2581007007439,0
"147.32.84.165",4720,"83.69.223.194",25,6,372,6,372,0,0,17183.138761,9.01112600000124,330.2583939010053,0
"147.32.84.165",1394,"72.4.117.21",25,6,372,6,372,0,0,17183.837785,9.012963000001037,330.1910814456531,0
"147.32.84.165",1070,"91.226.92.20",25,6,372,6,372,0,0,17184.438608,9.013028000001214,330.18870017929595,0
"147.32.84.165",1388,"72.14.213.27",25,6,372,6,372,0,0,17185.340052,9.01270199999999,330.2006434918189,0
"147.32.84.165",1389,"206.46.232.11",25,6,372,6,372,0,0,17189.746235,9.035354999999981,329.37278059356896,0
"147.32.84.165",1384,"89.188.114.91",25,6,372,6,372,0,0,17190.046612,9.013496999999916,330.1715194446759,0
"147.32.84.165",1151,"67.195.168.230",25,6,372,6,372,0,0,17197.55743,9.012924999999086,330.19247358657725,0
"147.32.84.165",1378,"188.120.234.65",25,6,372,6,372,0,0,17197.557509,9.013018000001466,330.1890665257205,0
"147.32.84.165",3233,"85.18.95.21",25,6,372,6,372,0,0,17201.663546,9.013288000001921,330.179175457321,0
"147.32.84.165",1390,"217.16.28.65",25,6,372,6,372,0,0,17203.366027,9.013167000000976,330.18360804805656,0
"147.32.84.165",1111,"89.108.70.32",25,6,372,6,372,0,0,17204.166973,9.012802000001102,330.19697980712726,0
"147.32.84.165",1311,"64.12.139.193",25,6,372,6,372,0,0,17204.867984,9.015236999999615,330.107794171149,0
"147.32.84.165",2591,"217.16.28.65",25,6,372,6,372,0,0,17205.469075,9.012517999999545,330.2073848840191,0
"147.32.84.165",1386,"212.59.117.29",25,6,372,6,372,0,0,17205.469256,9.012438999998267,330.21027937060904,0
"147.32.84.165",1306,"205.188.103.1",25,6,372,6,372,0,0,17206.370235,9.149525000000722,325.2627868659592,0
"147.32.84.165",4818,"91.226.92.20",25,6,372,6,372,0,0,17210.778702,8.910704000001715,333.98034543616615,0
"147.32.84.165",1168,"212.59.117.29",25,6,372,6,372,0,0,17211.076812,8.913210999999137,333.88640749111494,0
"147.32.84.165",1396,"180.222.96.138",25,6,372,6,372,0,0,17211.076962,8.913156999999046,333.88843032836945,0
"147.32.84.165",1394,"212.117.171.138",65500,6,366,4,244,2,122,17218.487903,50.32593300000008,38.78715969359171,19.393579846795856
"147.32.84.165",4944,"188.138.90.25",25,6,372,6,372,0,0,17218.488037,9.012323999999353,330.21449295433825,0
"147.32.84.165",1400,"74.125.93.27",25,6,372,6,372,0,0,17218.488104,9.012382000000798,330.2123678290308,0
"147.32.84.165",1389,"199.49.1.56",25,4,248,4,248,0,0,17222.593384,3.0042739999989863,660.3924941602096,0
"147.32.84.165",1305,"188.138.90.25",25,4,248,4,248,0,0,17224.295765,3.0043060000025434,660.3854600690876,0
"147.32.84.165",1232,"64.12.139.193",25,4,248,4,248,0,0,17224.295897,3.0042990000001737,660.3869987640662,0
"147.32.84.165",1385,"89.108.67.8",25,4,248,4,248,0,0,17224.295957,3.004296000002796,660.3876582061666,0
"147.32.84.165",1401,"207.115.21.22",25,4,248,4,248,0,0,17225.097371,3.003917999998521,660.4707585230279,0
"147.32.84.165",1390,"217.16.28.65",25,4,248,4,248,0,0,17225.797904,3.0043299999997544,660.380184600281,0
"147.32.84.165",1387,"89.175.251.94",25,2,124,2,124,0,0,17226.398826,8.999999408842996e-06,0,0
"147.32.84.165",1081,"202.59.166.29",25,2,124,2,124,0,0,17227.300317,4.999998054699972e-06,0,0
"147.32.84.165",1040,"147.32.84.171",139,22,3058,11,1635,11,1423,84728.003115,0.015410000007250346,848799.4804572297,738741.0768750078
"147.32.84.165",1041,"147.32.84.19",139,10,876,5,499,5,377,84728.037917,0.04720800000359304,84561.93864802926,63887.47669400206
"147.32.84.165",1042,"147.32.84.19",139,10,876,5,499,5,377,84728.081916,0.06280400000105146,63562.830391904434,48022.41895340275
"147.32.84.165",1043,"147.32.84.171",139,34,5412,17,2797,17,2615,84743.126113,0.06920199999876786,323343.25598101795,302303.4016411734
"147.32.84.165",1047,"60.190.222.139",65520,9,751,6,565,3,186,84744.674777,21.539584000012837,209.8462068718368,69.08211412064009
"147.32.84.165",1049,"147.32.84.95",139,3,186,3,186,0,0,84747.68968,8.904739000005065,167.1020340965809,0
"147.32.84.165",1048,"147.32.84.95",445,3,186,3,186,0,0,84752.799238,9.003106999996817,165.27627629001034,0
"147.32.84.165",1050,"147.32.84.171",445,54,15866,28,8088,26,7778,84773.822146,10.952690999998595,5907.589285592765,5681.16091287593
"147.32.84.165",1053,"147.32.84.102",139,5,370,3,248,2,122,84773.954421,0.001747999995131977,0,0
"147.32.84.165",1052,"147.32.84.102",445,14,2001,8,1189,6,812,84773.9554,10.81250599998748,879.7220551841557,600.7857937843015
"147.32.84.165",1055,"147.32.84.227",139,157,23969,80,12074,77,11895,84773.965015,10.806418000007397,8938.391981499686,8805.878136486564
"147.32.84.165",1054,"147.32.84.227",445,3,184,2,122,1,62,84773.973644,0.012801999997464009,76238.0878138837,38743.946266072046
"147.32.84.165",1056,"147.32.84.218",445,6,366,3,186,3,180,84775.095097,0.9276380000083009,1604.0740029911287,1552.3296803139956
"147.32.84.165",1057,"147.32.84.218",139,6,428,3,248,3,180,84775.348957,0.0010529999999562278,0,0
"147.32.84.165",1058,"147.32.84.218",139,6,428,3,248,3,180,84775.350303,0.008728000000701286,227314.39044919657,164986.25113248138
"147.32.84.165",1059,"147.32.84.218",139,6,428,3,248,3,180,84775.359313,0.009870000008959323,201013.17104347094,145896.65640251923
"147.32.84.165",1061,"147.32.84.68",139,14,2415,8,1255,6,1160,84776.026308,8.743264000004274,1148.3125752573744,1061.3885157757404
"147.32.84.165",1063,"147.32.84.181",139,14,2159,8,1255,6,904,84776.102626,8.669462999998359,1158.0878769540743,834.1923830808631
"147.32.84.165",1066,"60.190.222.139",65520,8,628,5,442,3,186,84796.212107,9.553608999995049,370.12190890393697,155.75265849803682
"147.32.84.165",1067,"60.190.222.139",65520,9,751,6,565,3,186,84835.769347,21.574698000011267,209.5046707025813,68.96967920474358
"147.32.84.165",1068,"60.190.222.139",65520,9,751,6,565,3,186,84887.342985,21.465148000002955,210.57390333387767,69.32167437186061
"147.32.84.165",1069,"137.254.16.78",80,7,948,5,639,2,309,84923.000287,0.47637899999972433,10730.951616261334,5189.145617253133
"147.32.84.165",1070,"83.133.119.197",65520,397,25048,132,8357,265,16691,84938.847871,12027.867388999992,5.558425100458185,11.101552393412415
"147.32.84.165",1071,"94.63.149.152",80,27,27450,16,1046,11,26404,84950.415174,0.21900900000764523,38208.47544944677,964490.0437544861
"147.32.84.165",1072,"94.63.149.152",80,124,140585,66,4045,58,136540,84959.637098,0.36637099999643397,88325.76814298886,2981458.685350729
"147.32.84.165",1073,"60.190.223.75",2012,56,59414,30,1897,26,57517,84964.430908,2.7096680000104243,5600.686135696926,169812.68553868216
"147.32.84.165",1074,"94.63.150.52",80,10,932,5,462,5,470,84965.35024,0.3954010000015842,9347.472565788128,9509.333562598313
"147.32.84.165",1075,"94.63.150.52",80,139,140361,68,4242,71,136119,84965.350455,1.375408999985666,24673.38806155381,791729.5873528155
"147.32.84.165",1076,"94.63.150.52",80,10,934,5,464,5,470,84965.615753,0.4069329999911133,9121.894759287312,9239.850294967751
"147.32.84.165",1077,"94.63.150.52",80,24,17830,12,882,12,16948,84965.888147,0.7969259999954375,8854.021577963822,170133.73889266537
"147.32.84.165",1078,"94.63.150.52",80,10,934,5,464,5,470,84966.554557,0.40995200000179466,9054.718601162453,9171.80547962576
"147.32.84.165",1079,"94.63.150.52",80,18,11619,9,705,9,10914,84966.59197,0.6671120000100927,8454.35249240708,130880.57177607217
"147.32.84.165",1080,"94.63.150.52",80,77,70972,38,2446,39,68526,84966.830252,1.2329089999984717,15871.406567738784,444645.95521703514
"147.32.84.165",1081,"195.88.191.59",80,56,45179,25,1660,31,43519,84966.90072,20.397964999996475,651.0453371207517,17067.977124191562
"147.32.84.165",1082,"94.63.150.52",80,107,99621,51,3225,56,96396,84967.12558,1.3570619999954943,19011.659010484163,568262.9091394206
"147.32.84.165",1087,"207.57.18.92",80,3,186,3,186,0,0,84967.789032,8.92258800000127,166.76775841267,0
"147.32.84.165",1088,"207.57.18.92",80,3,186,3,186,0,0,84967.789181,8.922558999998728,166.76830043939324,0
"147.32.84.165",1089,"207.57.18.92",80,3,186,3,186,0,0,84967.789343,8.922445999996853,166.7704125080191,0
"147.32.84.165",1090,"207.57.18.92",80,3,186,3,186,0,0,84967.789486,8.922338000003947,166.7724311721145,0
"147.32.84.165",1091,"94.63.150.52",80,145,140188,70,4365,75,135823,84967.928754,1.486021000004257,23498.99496702938,731203.6640107288
"147.32.84.165",1092,"94.63.150.52",80,10,932,5,462,5,470,84968.379808,0.405270000002929,9119.84602850763,9277.765440256682
"147.32.84.165",1093,"94.63.150.52",80,10,934,5,464,5,470,84968.65138,0.3970630000112578,9348.642406607401,9469.530023934221
"147.32.84.165",1094,"94.63.150.52",80,156,142838,80,4964,76,137874,84968.920618,1.2314119999937247,32249.157877462923,895713.213778671
"147.32.84.165",1095,"94.63.150.52",80,10,961,5,491,5,470,84969.278372,0.4037229999958072,9729.443207448656,9313.31630855574
"147.32.84.165",1096,"94.63.150.52",80,10,925,5,455,5,470,84969.489856,0.4085590000031516,8909.361928073844,9203.077156471882
"147.32.84.165",1097,"96.9.142.101",80,10,2483,5,844,5,1639,84970.440477,0.406528999999864,16608.901210005333,32253.541567771023
"147.32.84.165",1100,"64.20.55.244",80,451,418953,178,11323,273,407630,84971.90115,1.4737909999967087,61463.26039458939,2212688.230561377
"147.32.84.165",1101,"98.143.147.237",80,220,230929,106,6977,114,223952,84973.514077,3.4414059999980964,16218.952370057725,520605.822155535
"147.32.84.165",1102,"60.190.223.75",888,8,2535,5,611,3,1924,84973.53784,0.7921930000011344,6170.213571683921,19429.6086938132
"147.32.84.165",1103,"122.224.6.164",82,121,135870,59,3721,62,132149,84974.865863,9.403195000006235,3165.7324983668063,112429.02013616638
"147.32.84.165",1104,"69.64.58.224",80,239,265695,119,7786,120,257909,84977.186501,1.7588949999917531,35413.14291091398,1173050.1252261642
"147.32.84.165",1106,"60.199.114.56",10298,49,46212,23,1531,26,44681,84986.124901,16.935098999994807,723.2316740518468,21106.93300346869
"147.32.84.165",1107,"77.79.4.96",41422,47,46115,24,1590,23,44525,84986.167859,15.33255000000645,829.6075995183221,23231.62161544232
"147.32.84.165",1108,"60.199.114.56",10298,51,45818,25,1649,26,44169,84986.168009,17.02784399999655,774.7310816332752,20751.423374566482
"147.32.84.165",1109,"77.79.4.96",41422,47,46112,24,1587,23,44525,84986.168152,15.343019000007189,827.4773041729304,23215.76998632623
"147.32.84.165",1110,"60.190.223.75",888,11,1327,6,840,5,487,84986.490152,0.9886510000069393,6797.140750328309,3940.723268345103
"147.32.84.165",1111,"50.16.214.154",80,10,1371,5,854,5,517,84986.699189,0.36589799998910166,18671.870303208798,11303.696658968323
"147.32.84.165",1112,"184.82.155.107",80,10,1785,5,857,5,928,84989.098144,0.3443310000002384,19911.07393756372,21560.649491317537
"147.32.84.165",1115,"184.82.155.108",80,10,1507,5,596,5,911,84989.604991,0.32309299999906216,14757.360883751242,22556.972760230507
"147.32.84.165",1114,"174.123.157.154",80,9,1153,5,654,4,499,84989.616781,0.46480899999733083,11256.236432663836,8588.473975381123
"147.32.84.165",1116,"60.190.223.75",888,11,1327,6,840,5,487,84989.774288,0.9905500000022585,6784.109837953338,3933.168441765804
"147.32.84.165",1117,"217.163.21.37",80,13,6077,6,749,7,5328,84990.069581,0.1867379999894183,32087.737901977864,228255.63089684653
"147.32.84.165",1118,"94.63.150.20",80,16,9157,8,777,8,8380,84990.168649,0.7801529999997001,7967.667880534189,85931.86208349615
"147.32.84.165",1119,"217.163.21.37",80,10,1448,5,699,5,749,84990.296388,0.13901099999202415,40227.03239542802,43104.50252385635
"147.32.84.165",1120,"217.163.21.36",80,10,1497,5,691,5,806,84990.391626,0.14335500000743195,38561.61277746442,44979.24732074721
"147.32.84.165",1121,"77.238.167.32",80,8,1719,5,748,3,971,84990.552239,0.1396590000076685,42847.22072814087,55621.1916136695
"147.32.84.165",1122,"217.163.21.36",80,11,2608,6,797,5,1811,84990.646449,0.23863999999593943,26718.069058449928,60710.69393331595
"147.32.84.165",1123,"61.147.99.179",81,41,37047,21,1441,20,35606,84990.721038,2.8328590000019176,4069.387145633509,100551.42172618092
"147.32.84.165",1124,"217.163.21.37",80,10,2274,5,1154,5,1120,84990.841021,0.14076500000373926,65584.48477785502,63652.18626620245
"147.32.84.165",1125,"195.113.232.96",80,8,1229,5,610,3,619,84990.853904,66.00531599999522,73.933438936954,75.02426016717136
"147.32.84.165",1126,"217.163.21.36",80,11,3169,6,1376,5,1793,84990.935004,0.14985000000160653,73460.12679267257,95722.38905469616
"147.32.84.165",1127,"195.113.232.90",80,168,201623,109,16464,59,185159,84991.081893,89.90004300000146,1465.0938487315057,16476.877547210694
"147.32.84.165",1128,"195.113.232.73",80,11,2010,6,685,5,1325,84991.106225,0.02128100000845734,257506.69601156798,498096.89374500373
"147.32.84.165",1129,"195.88.191.59",80,38,30855,16,1140,22,29715,84991.365627,4.689389999999548,1944.8158502493668,50693.160517684155
"147.32.84.165",1130,"38.102.130.89",80,8,1364,5,659,3,705,84991.367637,0.5652569999947445,9326.731026858608,9977.762327671197
"147.32.84.165",1131,"217.163.21.36",80,14,6030,7,1020,7,5010,84991.446759,0.19065600000612903,42799.59717888595,210221.55084923393
"147.32.84.165",1132,"195.113.232.74",80,14,3648,9,2170,5,1478,84991.449956,89.52874999999767,193.9041927872382,132.06930734540924
"147.32.84.165",1133,"217.163.21.36",80,11,3392,6,963,5,2429,84991.597594,0.2257019999960903,34133.50346976744,86095.82547047261
"147.32.84.165",1134,"195.113.232.88",80,45,57127,31,4089,14,53038,84991.811983,89.16352399998868,366.87648191208945,4758.717253033357
"147.32.84.165",1135,"60.190.223.75",888,11,1324,6,837,5,487,84993.793999,0.9717760000057751,6890.476817661896,4009.15437300041
"147.32.84.165",1136,"60.190.223.75",888,11,1328,6,841,5,487,84994.883775,0.9870610000070883,6816.194743740949,3947.0711536288254
"147.32.84.165",1137,"94.63.150.20",80,10,1305,5,763,5,542,84995.923926,0.31104200000118,19624.35941119477,13940.239581739928
"147.32.84.165",1138,"184.82.155.107",80,10,1897,5,969,5,928,84997.554809,0.3428940000012517,22607.5696861762,21651.005850125403
"147.32.84.165",1139,"184.82.155.108",80,10,1508,5,596,5,912,84997.791987,0.3041149999917252,15678.279598604919,23990.924486455846
"147.32.84.165",1140,"217.163.21.37",80,14,6141,7,810,7,5331,84998.007944,0.18863299999793526,34352.41977846363,226089.8146160365
"147.32.84.165",1141,"217.163.21.37",80,10,1451,5,701,5,750,84998.159239,0.14002500000060536,40049.99107284953,42849.4911621072
"147.32.84.165",1142,"217.163.21.36",80,9,2578,5,997,4,1581,84998.253667,0.22876800000085495,34865.0160860356,55287.452790393465
"147.32.84.165",1143,"217.163.21.37",80,10,2277,5,1156,5,1121,84998.440201,0.14439000000129454,64048.756838542045,62109.5643737073
"147.32.84.165",1144,"217.163.21.36",80,11,3379,6,1512,5,1867,84998.539494,0.1784780000016326,67773.0588637779,83685.38419224428
"147.32.84.165",1145,"195.113.232.73",80,11,1965,6,788,5,1177,84998.660675,0.012005999989924021,525070.7983750293,784274.5300601644
"147.32.84.165",1146,"217.163.21.36",80,14,6098,7,1086,7,5012,84998.933172,0.18965999998908956,45808.2885189275,211409.89139674458
"147.32.84.165",1147,"217.163.21.36",80,11,3478,6,1030,5,2448,84999.08183,0.2417810000042664,34080.42815545721,80998.92050928083
"147.32.84.165",1148,"184.82.155.107",80,10,1897,5,969,5,928,85005.792062,0.3396140000113519,22825.91412527423,21860.111773224446
"147.32.84.165",1149,"184.82.155.108",80,10,1507,5,596,5,911,85006.025924,0.34079400000337046,13990.856646398835,21385.35302830426
"147.32.84.165",1150,"217.163.21.37",80,14,6137,7,809,7,5328,85006.266144,0.19062500000291038,33951.47540931771,223601.31147199598
"147.32.84.165",1151,"217.163.21.37",80,10,1448,5,699,5,749,85006.417898,0.14011599999503233,39909.78903335992,42764.56650355734
"147.32.84.165",1152,"217.163.21.36",80,9,2619,5,1040,4,1579,85006.512964,0.23798700000043027,34959.89276718879,53078.529499414515
"147.32.84.165",1153,"217.163.21.37",80,10,2274,5,1154,5,1120,85006.711613,0.13900599999760743,66414.39937958722,64457.649311211164
"147.32.84.165",1154,"217.163.21.36",80,11,3453,6,1555,5,1898,85006.805325,0.15208700000948738,81795.28821808555,99837.59295043496
"147.32.84.165",1155,"195.113.232.73",80,11,1978,6,801,5,1177,85006.958856,0.013139000002411194,487708.34909993457,716645.1022354844
"147.32.84.165",1156,"94.63.150.20",80,10,1308,5,766,5,542,85006.993226,0.3805129999964265,16104.57461389637,11395.142873018058
"147.32.84.165",1157,"217.163.21.36",80,13,6066,6,1055,7,5011,85007.270045,0.18767300000763498,44971.83931442797,213605.57990957212
"147.32.84.165",1158,"217.163.21.36",80,11,3538,6,1059,5,2479,85007.415058,0.23691799999505747,35759.207827926715,83708.28725725242
"147.32.84.165",1159,"195.88.191.59",80,175,127354,75,4852,100,122502,85007.549752,17.709957999992184,2191.761267870716,55337.00305785211
"147.32.84.165",1160,"74.3.164.222",443,145,117255,67,4270,78,112985,85010.496915,114.67145000000892,297.8945500383691,7882.345605640547
"147.32.84.165",1161,"88.135.194.91",3128,3,186,3,186,0,0,85010.886214,8.93207199999597,166.59068578944186,0
"147.32.84.165",1162,"82.227.106.170",3128,3,186,3,186,0,0,85010.888531,8.92987799999537,166.6316157959573,0
"147.32.84.165",1163,"217.19.6.21",3128,3,186,3,186,0,0,85010.891332,9.027600000001257,164.82786122555194,0
"147.32.84.165",1164,"92.47.5.149",3128,3,186,3,186,0,0,85010.900479,9.01861800000188,164.9920198415866,0
"147.32.84.165",1165,"80.98.120.34",3128,3,186,3,186,0,0,85010.901664,9.017481999995653,165.01280512683223,0
"147.32.84.165",1166,"93.177.150.210",3128,3,186,3,186,0,0,85010.902474,9.016718999992008,165.02676860633218,0
"147.32.84.165",1167,"210.212.249.136",3128,3,186,3,186,0,0,85010.902651,9.016585000004852,165.02922115182182,0
"147.32.84.165",1168,"94.177.75.85",3128,3,186,3,186,0,0,85010.904075,9.015209000004688,165.05440972019906,0
"147.32.84.165",1169,"60.190.222.152",3128,3,186,3,186,0,0,85010.904219,9.01511500000197,165.05613073151866,0
"147.32.84.165",1170,"118.86.12.94",3128,3,186,3,186,0,0,85011.597616,9.02275400000508,164.9163880561481,0
"147.32.84.165",1211,"184.82.155.107",80,10,1897,5,969,5,928,85035.772267,0.30596200001309626,25336.479692472225,24264.451139952762
"147.32.84.165",1212,"94.63.150.20",80,10,1301,5,759,5,542,85035.772394,0.3007249999936903,20191.204589333778,14418.488652725835
"147.32.84.165",1213,"173.236.31.226",7212,7,424,4,242,3,182,85035.772447,0.43559100000129547,4444.536273693079,3342.585131455126
"147.32.84.165",1171,"111.92.142.42",3128,3,186,3,186,0,0,85035.772494,8.929250000001048,166.64333510651235,0
"147.32.84.165",1214,"184.154.10.50",8339,7,424,4,242,3,182,85035.772547,0.47273999999742955,4095.2743580203214,3079.9170791723077
"147.32.84.165",1172,"184.164.142.139",3128,3,186,3,186,0,0,85035.772598,8.929268000007141,166.64299917964271,0
"147.32.84.165",1215,"69.175.13.98",7691,7,424,4,242,3,182,85035.772651,0.47132299999066163,4107.586517183244,3089.176636889878
"147.32.84.165",1173,"111.88.31.68",3128,3,186,3,186,0,0,85035.772702,8.929212999995798,166.644025626973,0
"147.32.84.165",1174,"82.103.123.207",3128,3,186,3,186,0,0,85035.772753,8.929205000007642,166.6441749292044,0
"147.32.84.165",1175,"113.193.156.31",3128,3,186,3,186,0,0,85035.772805,8.929199999998673,166.64426824354044,0
"147.32.84.165",1176,"89.236.212.138",3128,3,186,3,186,0,0,85035.869736,8.832315000006929,168.47225217837368,0
"147.32.84.165",1177,"46.175.169.64",3128,3,186,3,186,0,0,85035.872946,8.928684999991674,166.65388016279974,0
"147.32.84.165",1178,"119.154.130.96",3128,3,186,3,186,0,0,85035.909246,8.892487000004621,167.33226599029345,0
"147.32.84.165",1179,"113.21.74.83",3128,3,186,3,186,0,0,85035.912775,8.888981999989483,167.39824650356593,0
"147.32.84.165",1180,"82.230.33.111",3128,3,186,3,186,0,0,85035.91435,8.887427999987267,167.42751671261155,0
"147.32.84.165",1268,"94.63.150.20",80,10,1312,5,770,5,542,85056.739631,0.3089019999897573,19941.59960182924,14036.814265183699
"147.32.84.165",1266,"184.82.155.108",80,10,1508,5,596,5,912,85056.739764,0.3406059999979334,13998.579003390809,21420.644381027545
"147.32.84.165",1267,"31.192.109.161",80,10,1174,5,540,5,634,85056.739823,0.24215299999923445,17839.960686068964,20945.4353240143
"147.32.84.165",1181,"111.88.72.94",3128,3,186,3,186,0,0,85056.739878,9.029936000006273,164.78522106900493,0
"147.32.84.165",1319,"184.82.155.107",80,10,1912,5,981,5,931,85056.739935,0.32163500000024214,24400.32956610472,23156.683818596834
"147.32.84.165",1182,"78.227.180.250",3128,3,186,3,186,0,0,85056.739988,9.029949999996461,164.7849655868065,0
"147.32.84.165",1183,"78.56.242.233",3128,3,186,3,186,0,0,85056.821998,8.947987999999896,166.2943669571324,0
"147.32.84.165",1184,"58.252.109.240",3128,3,186,3,186,0,0,85056.839729,9.030406999998377,164.7766263469927,0
"147.32.84.165",1185,"46.98.83.57",3128,3,186,3,186,0,0,85056.839861,9.030396000001929,164.77682706269826,0
"147.32.84.165",1186,"178.125.172.9",3128,3,186,3,186,0,0,85056.83992,9.030385999998543,164.77700953206653,0
"147.32.84.165",1187,"220.143.177.200",3128,3,186,3,186,0,0,85056.839975,9.030374000009033,164.77722849557634,0
"147.32.84.165",1188,"59.48.7.162",3128,3,186,3,186,0,0,85056.840067,9.03033000000869,164.77803136746587,0
"147.32.84.165",1189,"94.177.75.85",3128,3,186,3,186,0,0,85056.84614,9.024304000005941,164.88806228148127,0
"147.32.84.165",1190,"119.63.45.53",3128,3,186,3,186,0,0,85056.852825,9.017669000008027,165.00938324512416,0
"147.32.84.165",1427,"217.163.21.37",80,15,6198,7,810,8,5388,85080.924283,1.5436480000062147,4197.848214083723,27923.464416645806
"147.32.84.165",1370,"72.20.15.61",80,8,686,5,504,3,182,85080.924411,3.7303790000005392,1080.8553232793283,390.30886673975743
"147.32.84.165",1873,"218.200.225.22",6667,3,186,3,186,0,0,85080.924464,9.031195000003208,164.7622490710777,0
"147.32.84.165",1871,"184.82.155.108",80,10,1510,5,599,5,911,85080.924518,1.2525409999943804,3825.8228672925675,5818.5720068506325
"147.32.84.165",1371,"72.20.15.61",80,3,186,3,186,0,0,85080.924567,9.031159000005573,164.76290584620222,0
"147.32.84.165",1872,"184.82.155.107",80,10,1913,5,985,5,928,85080.924618,1.4218309999996563,5542.149524100899,5221.436302909273
"147.32.84.165",1372,"193.23.181.44",80,10,1020,6,574,4,446,85080.92467,0.8504200000024866,5399.68486158201,4195.573951682189
"147.32.84.165",1373,"72.20.15.61",80,3,186,3,186,0,0,85080.92472,9.031037000007927,164.7651316231673,0
"147.32.84.165",1374,"174.128.246.102",80,8,652,4,410,4,242,85080.924772,0.8158570000086911,4020.3123831321655,2372.9648700438634
"147.32.84.165",1375,"174.37.196.55",80,3,186,3,186,0,0,85080.924824,9.030962000004365,164.766499958618,0
"147.32.84.165",1376,"72.20.15.61",80,3,186,3,186,0,0,85080.924871,9.030943000005209,164.7668466071751,0
"147.32.84.165",1377,"174.37.196.55",80,3,186,3,186,0,0,85080.924921,9.030920000004699,164.7672662363553,0
"147.32.84.165",1378,"72.20.15.61",80,8,629,5,447,3,182,85080.924971,3.7522120000066934,953.0378347475092,388.0377761164355
"147.32.84.165",1379,"174.37.196.55",80,3,186,3,186,0,0,85080.925019,9.030849999995553,164.76854338193334,0
"147.32.84.165",1380,"67.19.72.206",80,3,186,3,186,0,0,85080.92507,9.030827000009594,164.7689630194908,0
"147.32.84.165",1381,"174.37.196.55",80,3,186,3,186,0,0,85080.925119,9.030804999987595,164.76936441458363,0
"147.32.84.165",1382,"174.128.246.102",80,9,706,6,524,3,182,85080.925169,9.506894999998622,440.9431260154454,153.15200178399058
"147.32.84.165",1383,"72.20.15.61",80,3,186,3,186,0,0,85080.925218,9.030761000001803,164.77016720957437,0
"147.32.84.165",1384,"174.128.246.102",80,8,629,6,507,2,122,85080.925268,9.491990999988047,427.3076112277295,102.82352775105129
"147.32.84.165",1385,"72.20.15.61",80,3,186,3,186,0,0,85080.925317,9.03071700000146,164.77097001265344,0
"147.32.84.165",1386,"67.19.72.206",80,3,186,3,186,0,0,85080.970242,8.985820000001695,165.59423625219728,0
"147.32.84.165",1387,"72.20.15.61",80,3,186,3,186,0,0,85080.970302,8.9857869999978,165.59484439152234,0
"147.32.84.165",1388,"193.23.181.44",179,10,742,5,442,5,300,85080.970355,1.1538129999971716,3064.621390128789,2080.059767055739
"147.32.84.165",1389,"193.23.181.44",80,10,945,6,501,4,444,85080.970406,1.107097000000067,3620.278981877611,3208.3909539993197
"147.32.84.165",1390,"193.23.181.44",179,10,728,5,428,5,300,85080.970459,1.1580379999941215,2956.7250815753723,2072.470851571523
"147.32.84.165",1391,"174.37.196.55",80,3,186,3,186,0,0,85080.97051,8.985606000002008,165.5981800225458,0
"147.32.84.165",1392,"72.20.15.61",80,7,593,4,411,3,182,85080.970561,0.9955590000026859,3302.6671447811023,1462.4949400247217
"147.32.84.165",1393,"67.19.72.206",80,3,186,3,186,0,0,85080.970612,8.985530999998446,165.59956222957302,0
"147.32.84.165",1394,"193.23.181.44",80,10,981,6,537,4,444,85080.970662,1.1196339999878546,3836.968152134181,3172.465287798094
"147.32.84.165",1395,"72.20.15.61",80,3,186,3,186,0,0,85080.970713,8.985457000002498,165.6009260296484,0
"147.32.84.165",1396,"174.128.246.102",80,3,186,3,186,0,0,85080.970766,8.985431000008248,165.60140520790088,0
"147.32.84.165",1397,"72.20.15.61",80,3,186,3,186,0,0,85080.970819,8.985413000002154,165.60173694850124,0
"147.32.84.165",1398,"174.128.246.102",80,3,186,3,186,0,0,85080.970869,8.985396000003675,165.60205026015453,0
"147.32.84.165",1399,"193.23.181.44",80,10,953,6,507,4,446,85080.970919,1.0045660000032512,4037.5644805685965,3551.7825608157673
"147.32.84.165",1400,"193.23.181.44",80,10,1012,6,568,4,444,85080.97097,1.112914000012097,4082.9749647776994,3191.621275283976
"147.32.84.165",1401,"193.23.181.44",179,10,775,5,475,5,300,85080.97102,1.1878989999968326,3198.9251611543846,2020.373785992243
"147.32.84.165",1402,"67.19.72.206",80,3,186,3,186,0,0,85080.971069,8.985224999996717,165.60520187313548,0
"147.32.84.165",1403,"193.23.181.44",179,10,756,5,456,5,300,85080.971119,1.3191490000026533,2765.4192210225397,1819.3547506727236
"147.32.84.165",1404,"193.23.181.44",80,10,961,6,515,4,446,85080.97117,1.2695329999987734,3245.2878341909823,2810.482279707142
"147.32.84.165",1405,"67.19.72.206",80,3,186,3,186,0,0,85080.971223,8.985102000006009,165.6074688967365,0
"147.32.84.165",1406,"67.19.72.206",80,3,186,3,186,0,0,85081.007485,8.948868000006769,166.27801415764256,0
"147.32.84.165",1407,"67.19.72.206",80,3,186,3,186,0,0,85081.010684,8.945697000002838,166.33695507454902,0
"147.32.84.165",1408,"174.37.196.55",80,3,186,3,186,0,0,85081.013885,8.942524000012781,166.39597500637103,0
"147.32.84.165",1409,"174.37.196.55",80,3,186,3,186,0,0,85081.017085,8.94177600000694,166.40989441010882,0
"147.32.84.165",1410,"67.19.72.206",80,3,186,3,186,0,0,85081.020285,8.941777000000002,166.40987579985497,0
"147.32.84.165",1411,"174.128.246.102",80,8,708,4,466,4,242,85081.023484,0.9701609999901848,3842.6611665875216,1995.5450693437344
"147.32.84.165",1412,"72.20.15.61",80,3,186,3,186,0,0,85081.026714,8.938546999997925,166.47000905184538,0
"147.32.84.165",1413,"193.23.181.44",179,10,812,5,512,5,300,85081.029915,1.3421539999981178,3051.8107460140523,1788.1703589926087
"147.32.84.165",1414,"193.23.181.44",80,10,950,6,506,4,444,85081.033084,1.2812280000071041,3159.468884521377,2772.34028602271
"147.32.84.165",1415,"193.23.181.44",179,10,736,5,436,5,300,85081.036284,1.3449620000028517,2593.381820447421,1784.4370324179504
"147.32.84.165",1416,"72.20.15.61",80,3,186,3,186,0,0,85081.039484,8.928976000010152,166.64844882529735,0
"147.32.84.165",1417,"174.37.196.55",80,3,186,3,186,0,0,85081.042703,8.928956999996444,166.64880343813869,0
"147.32.84.165",1418,"193.23.181.44",179,10,736,5,436,5,300,85081.045902,1.3416390000056708,2599.805163673132,1788.8567639952742
"147.32.84.165",1419,"193.23.181.44",179,10,756,5,456,5,300,85081.049086,1.4149100000067847,2578.2558607844367,1696.2209610423927
"147.32.84.165",1420,"193.23.181.44",179,10,750,5,450,5,300,85081.052286,1.3331130000005942,2700.446248741401,1800.297499160934
"147.32.84.165",1421,"174.128.246.102",80,8,607,4,365,4,242,85081.055499,0.967134000005899,3019.2300136094786,2001.7908583383394
"147.32.84.165",1422,"72.20.15.61",80,3,186,3,186,0,0,85081.058731,8.916156999999657,166.88804380632342,0
"147.32.84.165",1423,"67.19.72.206",80,3,186,3,186,0,0,85081.061942,8.916119000001345,166.88875507379115,0
"147.32.84.165",1424,"193.23.181.44",179,10,756,5,456,5,300,85081.065132,1.3989839999994729,2607.6066631222193,1715.5306994225125
"147.32.84.165",1425,"67.19.72.206",80,3,186,3,186,0,0,85081.068329,8.912931999991997,166.94842954050768,0
"147.32.84.165",1875,"1.22.16.143",6667,2,124,2,124,0,0,85081.091504,2.9935830000031274,331.3754788155076,0
"147.32.84.165",1426,"72.20.15.61",80,3,186,3,186,0,0,85081.094685,8.960767999989912,166.05719509775003,0
"147.32.84.165",1428,"174.128.246.102",80,8,622,4,380,4,242,85081.097892,1.0018139999883715,3034.4954253337314,1932.494455080955
"147.32.84.165",1429,"174.37.196.55",80,3,186,3,186,0,0,85081.101101,8.95447100000456,166.17397052257385,0
"147.32.84.165",1430,"72.20.15.61",80,3,186,3,186,0,0,85081.104286,8.951335000005201,166.2321877126859,0
"147.32.84.165",1431,"193.23.181.44",179,10,781,5,481,5,300,85081.107485,1.4167969999980414,2715.9854234624436,1693.9618025753286
"147.32.84.165",1432,"174.37.196.55",80,3,186,3,186,0,0,85081.110701,8.944969000003766,166.35049266234165,0
"147.32.84.165",1433,"174.37.196.55",80,3,186,3,186,0,0,85081.113889,8.94182799999544,166.4089266759279,0
"147.32.84.165",1434,"67.19.72.206",80,3,186,3,186,0,0,85081.117102,8.938660999992862,166.46788596202364,0
"147.32.84.165",1435,"67.19.72.206",80,3,186,3,186,0,0,85081.120285,8.935524000000441,166.5263279467356,0
"147.32.84.165",1436,"174.128.246.102",80,8,654,4,412,4,242,85081.123485,0.9993129999929806,3298.2659087024304,1937.3309463737576
"147.32.84.165",1437,"174.37.196.55",80,3,186,3,186,0,0,85081.126708,8.929147000002558,166.6452573800805,0
"147.32.84.165",1438,"174.37.196.55",80,3,186,3,186,0,0,85081.129906,8.925997999991523,166.70404810772007,0
"147.32.84.165",1439,"72.20.15.61",80,3,186,3,186,0,0,85081.133085,8.922867000001133,166.76254392224058,0
"147.32.84.165",1440,"193.23.181.44",179,10,742,5,442,5,300,85081.136286,1.3909130000101868,2542.215077416131,1725.4853466625323
"147.32.84.165",1441,"193.23.181.44",80,3,186,3,186,0,0,85081.139487,8.916502000007313,166.88158652336753,0
"147.32.84.165",1442,"67.19.72.206",80,3,186,3,186,0,0,85081.142688,8.913346999994246,166.94065652340927,0
"147.32.84.165",1443,"72.20.15.61",80,3,186,3,186,0,0,85081.145888,8.910193000003346,166.99974961254387,0
"147.32.84.165",1444,"72.20.15.61",80,3,186,3,186,0,0,85081.149084,8.907041999991634,167.0588282845638,0
"147.32.84.165",1445,"193.23.181.44",179,3,186,3,186,0,0,85081.152284,8.903888000000734,167.1180050782172,0
"147.32.84.165",1446,"174.37.196.55",80,3,186,3,186,0,0,85081.155484,8.900733999995282,167.1772238110687,0
"147.32.84.165",1447,"174.128.246.102",80,33,2168,17,1206,16,962,85081.158684,627.6438360000029,15.371775275428588,12.261731189852654
"147.32.84.165",1448,"193.23.181.44",179,3,186,3,186,0,0,85081.161884,8.894379000004847,167.29667130208745,0
"147.32.84.165",1449,"193.23.181.44",179,3,186,3,186,0,0,85081.165084,8.891225000013947,167.35601674658622,0
"147.32.84.165",1450,"193.23.181.44",179,3,186,3,186,0,0,85081.168284,8.888070999993943,167.41540431000317,0
"147.32.84.165",1451,"72.20.15.61",80,3,186,3,186,0,0,85081.171484,8.884915999995428,167.47485288558335,0
"147.32.84.165",1452,"193.23.181.44",80,3,186,3,186,0,0,85081.174685,8.883376999991015,167.50386705433138,0
"147.32.84.165",1453,"193.23.181.44",80,3,186,3,186,0,0,85081.177886,8.88340099999914,167.50341451434468,0
"147.32.84.165",1454,"174.128.246.102",80,7,563,5,441,2,122,85081.181106,3.5636819999926956,989.9873221031594,273.87404375642956
"147.32.84.165",1455,"174.37.196.55",80,3,186,3,186,0,0,85081.184337,8.880126999996719,167.56517108376374,0
"147.32.84.165",1456,"174.128.246.102",80,8,610,5,428,3,182,85081.187504,3.578211999993073,956.9024976738742,406.90713686132034
"147.32.84.165",1457,"72.20.15.61",80,3,186,3,186,0,0,85081.190688,8.876974999991944,167.6246694399106,0
"147.32.84.165",1458,"193.23.181.44",80,3,186,3,186,0,0,85081.193901,8.876968999989913,167.62478273853282,0
"147.32.84.165",1459,"174.37.196.55",80,3,186,3,186,0,0,85081.197139,8.87693900000886,167.6253492333917,0
"147.32.84.165",1460,"193.23.181.44",179,3,186,3,186,0,0,85081.200301,8.876978000000236,167.62461279051954,0
"147.32.84.165",1461,"67.19.72.206",80,3,186,3,186,0,0,85081.203507,8.876961000001756,167.6249338033259,0
"147.32.84.165",1462,"174.128.246.102",80,3,186,3,186,0,0,85081.206715,8.876963000002434,167.6248960370334,0
"147.32.84.165",1463,"174.128.246.102",80,9,723,5,481,4,242,85081.209883,3.645380000001751,1055.5826827376438,531.0831792567772
"147.32.84.165",1464,"174.128.246.102",80,9,725,6,543,3,182,85081.213083,9.313817000002018,466.4038385120793,156.32688509981296
"147.32.84.165",1465,"193.23.181.44",80,3,186,3,186,0,0,85081.216286,8.873776000007638,167.68509820382206,0
"147.32.84.165",1466,"193.23.181.44",179,3,186,3,186,0,0,85081.366334,8.726926999996067,170.50675455411402,0
"147.32.84.165",1467,"174.128.246.102",80,3,186,3,186,0,0,85081.369486,8.726978000006056,170.50575812142156,0
"147.32.84.165",1468,"67.19.72.206",80,3,186,3,186,0,0,85081.372706,8.726957000006223,170.50616841574205,0
"147.32.84.165",1469,"67.19.72.206",80,3,186,3,186,0,0,85081.375887,8.726974999997765,170.5058167349375,0
"147.32.84.165",1470,"193.23.181.44",179,3,186,3,186,0,0,85081.379086,8.72697600000538,170.5057971969996,0
"147.32.84.165",1471,"193.23.181.44",80,3,186,3,186,0,0,85081.382304,8.726955000005546,170.50620749150812,0
"147.32.84.165",1472,"174.37.196.55",80,3,186,3,186,0,0,85081.385529,8.726963999986765,170.50603165112824,0
"147.32.84.165",1473,"72.20.15.61",80,3,186,3,186,0,0,85081.388697,8.72696499999438,170.50601211314108,0
"147.32.84.165",1474,"193.23.181.44",80,3,186,3,186,0,0,85081.39193,8.726932000005036,170.50665686396334,0
"147.32.84.165",1475,"174.37.196.55",80,3,186,3,186,0,0,85081.395135,8.72692499999539,170.50679363014876,0
"147.32.84.165",1476,"72.20.15.61",80,3,186,3,186,0,0,85081.398285,8.726977999991504,170.50575812170587,0
"147.32.84.165",1477,"67.19.72.206",80,3,186,3,186,0,0,85081.401486,8.727006000000983,170.50521106549397,0
"147.32.84.165",1478,"174.128.246.102",80,3,186,3,186,0,0,85081.404701,8.726991999996244,170.50548459316113,0
"147.32.84.165",1479,"72.20.15.61",80,3,186,3,186,0,0,85081.407887,8.72697300001164,170.50585581025808,0
"147.32.84.165",1480,"174.37.196.55",80,3,186,3,186,0,0,85081.411104,8.726984000008088,170.50564089479494,0
"147.32.84.165",1481,"67.19.72.206",80,3,186,3,186,0,0,85081.414285,8.726974999997765,170.5058167349375,0
"147.32.84.165",1482,"174.37.196.55",80,3,186,3,186,0,0,85081.417486,8.727004000000306,170.50525014082126,0
"147.32.84.165",1483,"67.19.72.206",80,3,186,3,186,0,0,85081.420706,8.726983999993536,170.50564089507924,0
"147.32.84.165",1484,"193.23.181.44",80,3,186,3,186,0,0,85081.423935,8.726953000004869,170.50624656729212,0
"147.32.84.165",1485,"72.20.15.61",80,3,186,3,186,0,0,85081.427087,8.727002999992692,170.5052696786338,0
"147.32.84.165",1486,"67.19.72.206",80,3,186,3,186,0,0,85081.505134,8.652127999986988,171.98081211954306,0
"147.32.84.165",1487,"193.23.181.44",80,3,186,3,186,0,0,85081.508308,8.652180999997654,171.97975862969156,0
"147.32.84.165",1488,"174.128.246.102",80,3,186,3,186,0,0,85081.511537,8.65215399999579,171.98029531151712,0
"147.32.84.165",1489,"193.23.181.44",80,3,186,3,186,0,0,85081.514738,8.652136000004248,171.98065310106887,0
"147.32.84.165",1490,"174.128.246.102",80,3,186,3,186,0,0,85081.517933,8.652126000000862,171.980851873846,0
"147.32.84.165",1491,"174.37.196.55",80,3,186,3,186,0,0,85081.521129,8.652149000001373,171.9803946972901,0
"147.32.84.165",1492,"193.23.181.44",80,3,186,3,186,0,0,85081.524302,8.65215999999782,171.9801760485676,0
"147.32.84.165",1493,"193.23.181.44",179,3,186,3,186,0,0,85081.52751,8.652172000001883,171.97993752316484,0
"147.32.84.165",1494,"174.37.196.55",80,3,186,3,186,0,0,85081.530704,8.652178999996977,171.97979838379672,0
"147.32.84.165",1495,"193.23.181.44",80,3,186,3,186,0,0,85081.533886,8.65217999999004,171.97977850688648,0
"147.32.84.165",1496,"174.37.196.55",80,3,186,3,186,0,0,85081.537109,8.652157999997144,171.98021580286573,0
"147.32.84.165",1497,"193.23.181.44",80,3,186,3,186,0,0,85081.54029,8.652193000001716,171.97952010544665,0
"147.32.84.165",1498,"67.19.72.206",80,3,186,3,186,0,0,85081.543501,8.652163000006112,171.98011641701027,0
"147.32.84.165",1499,"174.37.196.55",80,3,186,3,186,0,0,85081.546686,8.65219700000307,171.97944059751205,0
"147.32.84.165",1500,"67.19.72.206",80,3,186,3,186,0,0,85081.549885,8.652197999996133,171.97942072068452,0
"147.32.84.165",1501,"193.23.181.44",179,3,186,3,186,0,0,85081.553085,8.652193999994779,171.97950022860073,0
"147.32.84.165",1502,"72.20.15.61",80,3,186,3,186,0,0,85081.556287,8.652205000005779,171.97928158186338,0
"147.32.84.165",1503,"67.19.72.206",80,3,186,3,186,0,0,85081.559489,8.652191999994102,171.97953998258643,0
"147.32.84.165",1504,"174.37.196.55",80,3,186,3,186,0,0,85081.562687,8.652194000009331,171.97950022831148,0
"147.32.84.165",1505,"174.128.246.102",80,3,186,3,186,0,0,85081.565888,8.65217400000256,171.97989776899536,0
"147.32.84.165",1506,"174.128.246.102",80,3,186,3,186,0,0,85081.690685,8.596992999999202,173.08377475707357,0
"147.32.84.165",1507,"174.128.246.102",80,3,186,3,186,0,0,85081.693902,8.597009000004618,173.08345262860612,0
"147.32.84.165",1508,"67.19.72.206",80,3,186,3,186,0,0,85081.697089,8.597025000010035,173.08313050133773,0
"147.32.84.165",1509,"193.23.181.44",80,3,186,3,186,0,0,85081.700304,8.596984000003431,173.08395595471694,0
"147.32.84.165",1510,"174.128.246.102",80,3,186,3,186,0,0,85081.703501,8.59699200000614,173.0837948899961,0
"147.32.84.165",1511,"174.37.196.55",80,3,186,3,186,0,0,85081.706687,8.597003000002587,173.08357342664092,0
"147.32.84.165",1512,"174.128.246.102",80,3,186,3,186,0,0,85081.709888,8.59702699999616,173.08309023580648,0
"147.32.84.165",1513,"174.128.246.102",80,3,186,3,186,0,0,85081.713087,8.596974000000046,173.0841572860395,0
"147.32.84.165",1514,"193.23.181.44",80,3,186,3,186,0,0,85081.716289,8.596970999991754,173.08421768567408,0
"147.32.84.165",1515,"72.20.15.61",80,3,186,3,186,0,0,85081.719484,8.596980000002077,173.08403648718976,0
"147.32.84.165",1516,"174.37.196.55",80,3,186,3,186,0,0,85081.722684,8.597006000010879,173.08351302745595,0
"147.32.84.165",1517,"67.19.72.206",80,3,186,3,186,0,0,85081.725883,8.597031999990577,173.08298957147431,0
"147.32.84.165",1518,"67.19.72.206",80,3,186,3,186,0,0,85081.729084,8.596978999994462,173.08405662046616,0
"147.32.84.165",1519,"67.19.72.206",80,3,186,3,186,0,0,85081.732314,8.5969780000014,173.08407675345427,0
"147.32.84.165",1520,"193.23.181.44",179,3,186,3,186,0,0,85081.735513,8.596979999987525,173.08403648748273,0
"147.32.84.165",1521,"174.37.196.55",80,3,186,3,186,0,0,85081.738712,8.596997000000556,173.0836942248443,0
"147.32.84.165",1522,"193.23.181.44",80,3,186,3,186,0,0,85081.741922,8.596965999997337,173.08431835143477,0
"147.32.84.165",1523,"174.37.196.55",80,3,186,3,186,0,0,85081.745084,8.597026000003098,173.08311036856978,0
"147.32.84.165",1524,"174.37.196.55",80,3,186,3,186,0,0,85081.748284,8.59700399999565,173.08355329376988,0
"147.32.84.165",1525,"174.37.196.55",80,3,186,3,186,0,0,85081.751501,8.597008999990067,173.08345262889912,0
"147.32.84.165",1526,"174.128.246.102",80,3,186,3,186,0,0,85081.867485,8.508997000011732,174.87372483477765,0
"147.32.84.165",1527,"193.23.181.44",179,3,186,3,186,0,0,85081.870684,8.508998000004794,174.87370428329652,0
"147.32.84.165",1528,"174.37.196.55",80,3,186,3,186,0,0,85081.873884,8.509028000000399,174.8730877369225,0
"147.32.84.165",1529,"67.19.72.206",80,3,186,3,186,0,0,85081.877116,8.50899400000344,174.87378648984807,0
"147.32.84.165",1530,"67.19.72.206",80,3,186,3,186,0,0,85081.880311,8.508952000003774,174.8746496630067,0
"147.32.84.165",1531,"72.20.15.61",80,3,186,3,186,0,0,85081.883484,8.509001999991597,174.87362207712133,0
"147.32.84.165",1532,"174.128.246.102",80,3,186,3,186,0,0,85081.886683,8.508978999991086,174.8740947652543,0
"147.32.84.165",1533,"174.128.246.102",80,3,186,3,186,0,0,85081.889886,8.508998999997857,174.87368373182025,0
"147.32.84.165",1534,"174.128.246.102",80,3,186,3,186,0,0,85081.893085,8.509028999993461,174.87306718559114,0
"147.32.84.165",1535,"72.20.15.61",80,3,186,3,186,0,0,85081.896316,8.508967000001576,174.87434138594313,0
"147.32.84.165",1536,"174.128.246.102",80,3,186,3,186,0,0,85081.899521,8.508960999999545,174.87446469669794,0
"147.32.84.165",1537,"174.128.246.102",80,3,186,3,186,0,0,85081.902704,8.50900500001444,174.87356042186775,0
"147.32.84.165",1538,"193.23.181.44",80,3,186,3,186,0,0,85081.905905,8.508984000000055,174.87399200656512,0
"147.32.84.165",1539,"67.19.72.206",80,3,186,3,186,0,0,85081.909086,8.50899699999718,174.8737248350767,0
"147.32.84.165",1540,"193.23.181.44",179,3,186,3,186,0,0,85081.91231,8.5089799999987,174.87407421338716,0
"147.32.84.165",1541,"174.37.196.55",80,3,186,3,186,0,0,85081.915486,8.509025999999722,174.87312883989878,0
"147.32.84.165",1542,"174.128.246.102",80,3,186,3,186,0,0,85081.918683,8.50899699999718,174.8737248350767,0
"147.32.84.165",1543,"72.20.15.61",80,7,595,4,413,3,182,85081.921885,0.889658000000054,3713.7866461042327,1636.5839457408483
"147.32.84.165",1544,"67.19.72.206",80,3,186,3,186,0,0,85081.925107,8.505755999998655,174.94035803522172,0
"147.32.84.165",1545,"174.37.196.55",80,3,186,3,186,0,0,85081.928283,8.505816999997478,174.93910343949807,0
"147.32.84.165",1900,"217.163.21.37",80,10,1449,5,700,5,749,85081.997542,1.2340970000077505,4537.730826640718,4855.371984505568
"147.32.84.165",1546,"67.19.72.206",80,3,186,3,186,0,0,85082.000688,8.439773999998579,176.30803858020968,0
"147.32.84.165",1547,"193.23.181.44",179,3,186,3,186,0,0,85082.003887,8.439826999994693,176.30693140996084,0
"147.32.84.165",1548,"72.20.15.61",80,3,186,3,186,0,0,85082.007088,8.439815000005183,176.30718208859867,0
"147.32.84.165",1549,"193.23.181.44",179,3,186,3,186,0,0,85082.010287,8.43980000000738,176.30749543812635,0
"147.32.84.165",1550,"193.23.181.44",80,3,186,3,186,0,0,85082.0135,8.439790000003995,176.3077043385316,0
"147.32.84.165",1551,"67.19.72.206",80,3,186,3,186,0,0,85082.016736,8.439723999996204,176.3090830933179,0
"147.32.84.165",1552,"67.19.72.206",80,3,186,3,186,0,0,85082.019883,8.439777999999933,176.30795501967134,0
"147.32.84.165",1553,"67.19.72.206",80,3,186,3,186,0,0,85082.023115,8.439749999990454,176.308539945103,0
"147.32.84.165",1554,"193.23.181.44",80,3,186,3,186,0,0,85082.026315,8.439747000011266,176.30860261545917,0
"147.32.84.165",1555,"193.23.181.44",179,3,186,3,186,0,0,85082.029484,8.43977700000687,176.3079759096465,0
"147.32.84.165",1556,"193.23.181.44",80,3,186,3,186,0,0,85082.032684,8.439776999992318,176.3079759099505,0
"147.32.84.165",1557,"67.19.72.206",80,3,186,3,186,0,0,85082.035914,8.439747000011266,176.30860261545917,0
"147.32.84.165",1558,"72.20.15.61",80,3,186,3,186,0,0,85082.039087,8.439773999998579,176.30803858020968,0
"147.32.84.165",1559,"174.128.246.102",80,3,186,3,186,0,0,85082.042336,8.439759000000777,176.30835193278185,0
"147.32.84.165",1560,"72.20.15.61",80,3,186,3,186,0,0,85082.045484,8.439777999999933,176.30795501967134,0
"147.32.84.165",1561,"67.19.72.206",80,3,186,3,186,0,0,85082.048684,8.439775000006193,176.3080176899157,0
"147.32.84.165",1562,"193.23.181.44",179,3,186,3,186,0,0,85082.051884,8.439777999999933,176.30795501967134,0
"147.32.84.165",1563,"72.20.15.61",80,3,186,3,186,0,0,85082.055085,8.439775999999256,176.3079967999306,0
"147.32.84.165",1564,"174.37.196.55",80,8,652,5,470,3,182,85082.058305,3.043705999996746,1235.3361329918264,478.3642046904519
"147.32.84.165",1902,"217.163.21.37",80,15,6197,7,809,8,5388,85082.096738,1.6432960000092862,3938.426187347518,26230.21050361981
"147.32.84.165",1565,"67.19.72.206",80,3,186,3,186,0,0,85082.099937,8.39812399999937,177.1824278850981,0
"147.32.84.165",1566,"72.20.15.61",80,3,186,3,186,0,0,85082.103084,8.398176999995485,177.18130970576115,0
"147.32.84.165",1567,"193.23.181.44",179,3,186,3,186,0,0,85082.106307,8.398154000009526,177.18179495140384,0
"147.32.84.165",1568,"174.128.246.102",80,8,674,4,432,4,242,85082.109504,0.8583880000078352,4026.1513441106517,2255.390336284208
"147.32.84.165",1569,"174.128.246.102",80,3,186,3,186,0,0,85082.112702,8.39495899999747,177.24922778067747,0
"147.32.84.165",1570,"193.23.181.44",179,3,186,3,186,0,0,85082.115886,8.395000999997137,177.24834100680957,0
"147.32.84.165",1571,"67.19.72.206",80,3,186,3,186,0,0,85082.119087,8.394973999995273,177.24891107474994,0
"147.32.84.165",1572,"67.19.72.206",80,3,186,3,186,0,0,85082.122307,8.394981999997981,177.2487421653028,0
"147.32.84.165",1573,"193.23.181.44",179,3,186,3,186,0,0,85082.125486,8.395003999990877,177.24827766629022,0
"147.32.84.165",1574,"72.20.15.61",80,3,186,3,186,0,0,85082.128683,8.395032000000356,177.24768648885876,0
"147.32.84.165",1575,"72.20.15.61",80,3,186,3,186,0,0,85082.131905,8.394986999992398,177.2486365972154,0
"147.32.84.165",1576,"174.37.196.55",80,3,186,3,186,0,0,85082.135083,8.394977999996627,177.24882661998612,0
"147.32.84.165",1577,"174.128.246.102",80,8,649,4,407,4,242,85082.138303,0.8495600000023842,3832.5721549871255,2278.8266867491016
"147.32.84.165",1578,"174.37.196.55",80,3,186,3,186,0,0,85082.141502,8.391761000006227,177.31677534654477,0
"147.32.84.165",1579,"174.37.196.55",80,3,186,3,186,0,0,85082.144687,8.391779999990831,177.3163738803479,0
"147.32.84.165",1580,"174.37.196.55",80,3,186,3,186,0,0,85082.147903,8.391759999998612,177.316796476573,0
"147.32.84.165",1581,"193.23.181.44",179,3,186,3,186,0,0,85082.151131,8.391731999989133,177.3173881151027,0
"147.32.84.165",1582,"174.37.196.55",80,3,186,3,186,0,0,85082.154354,8.391709000003175,177.31787410638728,0
"147.32.84.165",1583,"193.23.181.44",179,3,186,3,186,0,0,85082.157539,8.391725999987102,177.3175148953013,0
"147.32.84.165",1584,"193.23.181.44",179,3,186,3,186,0,0,85082.160686,8.401375999994343,177.11384420849654,0
"147.32.84.165",1585,"72.20.15.61",80,3,186,3,186,0,0,85082.163907,8.40136600000551,177.11405502379304,0
"147.32.84.165",1586,"193.23.181.44",80,3,186,3,186,0,0,85082.1671,8.40136399999028,177.11409718728072,0
"147.32.84.165",1587,"174.37.196.55",80,3,186,3,186,0,0,85082.170284,8.401381999996374,177.11371771937547,0
"147.32.84.165",1588,"174.37.196.55",80,3,186,3,186,0,0,85082.173483,8.40137799999502,177.1138020454361,0
"147.32.84.165",1589,"193.23.181.44",80,3,186,3,186,0,0,85082.176683,8.401394000000437,177.11346474167533,0
"147.32.84.165",1590,"174.128.246.102",80,6,541,4,419,2,122,85082.179884,0.883668000009493,3793.2798290353285,1104.4872055902388
"147.32.84.165",1591,"193.23.181.44",179,3,186,3,186,0,0,85082.183083,8.398180000003777,177.1812464128336,0
"147.32.84.165",1592,"174.37.196.55",80,3,186,3,186,0,0,85082.186283,8.398178999996162,177.18126751057343,0
"147.32.84.165",1593,"174.37.196.55",80,3,186,3,186,0,0,85082.189484,8.398176999995485,177.18130970576115,0
"147.32.84.165",1594,"72.20.15.61",80,3,186,3,186,0,0,85082.192684,8.398194000008516,177.18095104715266,0
"147.32.84.165",1595,"174.37.196.55",80,3,186,3,186,0,0,85082.195884,8.398195999994641,177.18090885244277,0
"147.32.84.165",1596,"72.20.15.61",80,3,186,3,186,0,0,85082.199083,8.398199999995995,177.18082446246927,0
"147.32.84.165",1597,"193.23.181.44",179,3,186,3,186,0,0,85082.202335,8.398150000008172,177.1818793423018,0
"147.32.84.165",1598,"193.23.181.44",80,3,186,3,186,0,0,85082.205515,8.398194000008516,177.18095104715266,0
"147.32.84.165",1599,"67.19.72.206",80,3,186,3,186,0,0,85082.208734,8.398144000006141,177.1820059287995,0
"147.32.84.165",1600,"72.20.15.61",80,3,186,3,186,0,0,85082.211937,8.398151000001235,177.1818582447233,0
"147.32.84.165",1601,"67.19.72.206",80,3,186,3,186,0,0,85082.215179,8.398132999995141,177.18223800466853,0
"147.32.84.165",1602,"174.128.246.102",80,7,556,4,374,3,182,85082.218306,0.8819090000033611,3392.6402837351666,1650.963988341712
"147.32.84.165",1603,"193.23.181.44",179,3,186,3,186,0,0,85082.221486,8.394985000006272,177.24867882418945,0
"147.32.84.165",1903,"184.82.155.108",80,10,1507,5,596,5,911,85082.243929,1.3447480000031646,3545.6457269233933,5419.60278058257
"147.32.84.165",1604,"67.19.72.206",80,3,186,3,186,0,0,85082.247085,8.410574000008637,176.92014837494705,0
"147.32.84.165",1605,"174.37.196.55",80,9,687,6,505,3,182,85082.250311,8.720677000004798,463.26678536514737,166.95951472565707
"147.32.84.165",1606,"174.37.196.55",80,9,667,6,485,3,182,85082.253506,8.70520700000634,445.7102513469438,167.25621803122425
"147.32.84.165",1607,"193.23.181.44",179,3,186,3,186,0,0,85082.256731,8.401146999996854,177.11867200997165,0
"147.32.84.165",1608,"193.23.181.44",179,3,186,3,186,0,0,85082.259905,8.3989600000059,177.16479183124514,0
"147.32.84.165",1609,"72.20.15.61",80,3,186,3,186,0,0,85082.263134,8.398927000002004,177.16548792478432,0
"147.32.84.165",1610,"193.23.181.44",179,3,186,3,186,0,0,85082.266305,8.398956000004546,177.16487620594685,0
"147.32.84.165",1611,"174.37.196.55",80,9,670,6,488,3,182,85082.269504,8.724022000009427,447.50001776655097,166.89549842932843
"147.32.84.165",1612,"72.20.15.61",80,3,186,3,186,0,0,85082.272703,8.39898600000015,177.1642433979499,0
"147.32.84.165",1613,"174.128.246.102",80,8,692,4,450,4,242,85082.275906,0.9177190000045812,3922.7693879957037,2109.5782042110227
"147.32.84.165",1614,"174.128.246.102",80,6,510,4,388,2,122,85082.279086,0.923850000006496,3359.852789931455,1056.4485576588595
"147.32.84.165",1615,"67.19.72.206",80,3,186,3,186,0,0,85082.282306,8.392609000002267,177.2988590317502,0
"147.32.84.165",1616,"193.23.181.44",179,3,186,3,186,0,0,85082.285537,8.392535999999382,177.3004012136629,0
"147.32.84.165",1617,"193.23.181.44",179,3,186,3,186,0,0,85082.288704,8.392605999993975,177.29892240873315,0
"147.32.84.165",1618,"72.20.15.61",80,3,186,3,186,0,0,85082.291936,8.392574000012246,177.2995984304492,0
"147.32.84.165",1619,"72.20.15.61",80,3,186,3,186,0,0,85082.295143,8.392517000000225,177.3008026078422,0
"147.32.84.165",1620,"72.20.15.61",80,3,186,3,186,0,0,85082.298306,8.392603000000236,177.29898578545397,0
"147.32.84.165",1621,"174.37.196.55",80,3,186,3,186,0,0,85082.301485,8.392575999998371,177.2995561792099,0
"147.32.84.165",1622,"174.37.196.55",80,3,186,3,186,0,0,85082.304687,8.392573000004631,177.29961955638382,0
"147.32.84.165",1623,"174.37.196.55",80,3,186,3,186,0,0,85082.327136,8.442945999995572,176.2417999594905,0
"147.32.84.165",1624,"193.23.181.44",179,3,186,3,186,0,0,85082.330284,8.442980000007083,176.24109023102645,0
"147.32.84.165",1625,"193.23.181.44",179,3,186,3,186,0,0,85082.333484,8.442997999998624,176.24071449504578,0
"147.32.84.165",1626,"72.20.15.61",80,3,186,3,186,0,0,85082.336684,8.442980000007083,176.24109023102645,0
"147.32.84.165",1627,"174.37.196.55",80,3,186,3,186,0,0,85082.339916,8.44296800000302,176.2413407227728,0
"147.32.84.165",1628,"193.23.181.44",179,3,186,3,186,0,0,85082.343118,8.442960000000312,176.24150771766597,0
"147.32.84.165",1629,"174.128.246.102",80,3,186,3,186,0,0,85082.346284,8.442978999999468,176.24111110546335,0
"147.32.84.165",1630,"174.37.196.55",80,3,186,3,186,0,0,85082.349484,8.443000999992364,176.24065187263932,0
"147.32.84.165",1631,"193.23.181.44",80,3,186,3,186,0,0,85082.352713,8.442968999996083,176.2413198485853,0
"147.32.84.165",1632,"193.23.181.44",80,3,186,3,186,0,0,85082.355912,8.442972000004374,176.2412572254449,0
"147.32.84.165",1633,"193.23.181.44",179,3,186,3,186,0,0,85082.359084,8.442999000006239,176.24069362070284,0
"147.32.84.165",1634,"193.23.181.44",179,3,186,3,186,0,0,85082.362332,8.442948999989312,176.24173733631267,0
"147.32.84.165",1635,"72.20.15.61",80,3,186,3,186,0,0,85082.365531,8.442954999991343,176.24161208978677,0
"147.32.84.165",1636,"72.20.15.61",80,3,186,3,186,0,0,85082.368705,8.443006999994395,176.2405266276562,0
"147.32.84.165",1637,"174.128.246.102",80,3,186,3,186,0,0,85082.371903,8.442978999999468,176.24111110546335,0
"147.32.84.165",1638,"193.23.181.44",179,3,186,3,186,0,0,85082.375133,8.442976999998791,176.24115285404818,0
"147.32.84.165",1639,"174.37.196.55",80,3,186,3,186,0,0,85082.378307,8.44295699999202,176.24157034098437,0
"147.32.84.165",1640,"72.20.15.61",80,8,640,5,458,3,182,85082.381501,3.007054000001517,1218.4683081840737,484.1948298897411
"147.32.84.165",1641,"174.37.196.55",80,3,186,3,186,0,0,85082.384737,8.439778999992996,176.30793412970115,0
"147.32.84.165",1642,"193.23.181.44",80,3,186,3,186,0,0,85082.387904,8.439805000001797,176.30739098826135,0
"147.32.84.165",1643,"193.23.181.44",179,3,186,3,186,0,0,85082.397509,8.490552000002936,175.25362308592958,0
"147.32.84.165",1644,"174.37.196.55",80,3,186,3,186,0,0,85082.400735,8.490571999995154,175.25321026673458,0
"147.32.84.165",1645,"72.20.15.61",80,3,186,3,186,0,0,85082.403931,8.4905790000048,175.2530657802205,0
"147.32.84.165",1646,"174.128.246.102",80,3,186,3,186,0,0,85082.407087,8.49062199999753,175.25217822680517,0
"147.32.84.165",1647,"174.128.246.102",80,3,186,3,186,0,0,85082.410303,8.490611000001081,175.25240527446263,0
"147.32.84.165",1648,"193.23.181.44",80,3,186,3,186,0,0,85082.413485,8.490625999998883,175.2520956641119,0
"147.32.84.165",1649,"174.128.246.102",80,3,186,3,186,0,0,85082.416702,8.490611999994144,175.25238463387873,0
"147.32.84.165",1650,"174.128.246.102",80,3,186,3,186,0,0,85082.419885,8.490594000002602,175.25275616753598,0
"147.32.84.165",1651,"174.37.196.55",80,3,186,3,186,0,0,85082.423103,8.490606000006665,175.25250847805586,0
"147.32.84.165",1652,"193.23.181.44",80,3,186,3,186,0,0,85082.426302,8.490561999991769,175.25341667623917,0
"147.32.84.165",1653,"193.23.181.44",80,3,186,3,186,0,0,85082.429484,8.490601000012248,175.25261168177065,0
"147.32.84.165",1654,"193.23.181.44",80,3,186,3,186,0,0,85082.432704,8.49055899999803,175.25347859903516,0
"147.32.84.165",1655,"174.128.246.102",80,3,186,3,186,0,0,85082.435904,8.490577000004123,175.25310706201444,0
"147.32.84.165",1656,"193.23.181.44",179,3,186,3,186,0,0,85082.439086,8.490581000005477,175.253024498446,0
"147.32.84.165",1657,"67.19.72.206",80,3,186,3,186,0,0,85082.442308,8.490556999997352,175.25351988102358,0
"147.32.84.165",1658,"193.23.181.44",80,3,186,3,186,0,0,85082.445504,8.490569000001415,175.25327218938472,0
"147.32.84.165",1659,"67.19.72.206",80,3,186,3,186,0,0,85082.448703,8.490560999998706,175.2534373170662,0
"147.32.84.165",1660,"174.128.246.102",80,3,186,3,186,0,0,85082.451905,8.490560999998706,175.2534373170662,0
"147.32.84.165",1661,"174.128.246.102",80,3,186,3,186,0,0,85082.455105,8.49055899999803,175.25347859903516,0
"147.32.84.165",1662,"67.19.72.206",80,3,186,3,186,0,0,85082.458306,8.49055600000429,175.25354052187492,0
"147.32.84.165",1663,"72.20.15.61",80,3,186,3,186,0,0,85082.471088,8.487374999996973,175.31922414180247,0
"147.32.84.165",1664,"67.19.72.206",80,3,186,3,186,0,0,85082.474286,8.487374999996973,175.31922414180247,0
"147.32.84.165",1665,"72.20.15.61",80,3,186,3,186,0,0,85082.477531,8.487330000003567,175.32015368783524,0
"147.32.84.165",1666,"67.19.72.206",80,3,186,3,186,0,0,85082.480731,8.487330000003567,175.32015368783524,0
"147.32.84.165",1667,"193.23.181.44",80,3,186,3,186,0,0,85082.483932,8.487330000003567,175.32015368783524,0
"147.32.84.165",1668,"67.19.72.206",80,3,186,3,186,0,0,85082.487134,8.48732800000289,175.32019500124107,0
"147.32.84.165",1669,"174.128.246.102",80,3,186,3,186,0,0,85082.490283,8.487395999996806,175.31879035696696,0
"147.32.84.165",1670,"67.19.72.206",80,3,186,3,186,0,0,85082.493505,8.487377999990713,175.31916217253766,0
"147.32.84.165",1671,"174.37.196.55",80,3,186,3,186,0,0,85082.496712,8.487369000009494,175.31934808046353,0
"147.32.84.165",1672,"67.19.72.206",80,3,186,3,186,0,0,85082.499916,8.487364000000525,175.3194513632157,0
"147.32.84.165",1673,"174.37.196.55",80,3,186,3,186,0,0,85082.503133,8.487329999989015,175.32015368813583,0
"147.32.84.165",1674,"193.23.181.44",80,3,186,3,186,0,0,85082.506284,8.487377999990713,175.31916217253766,0
"147.32.84.165",1675,"174.128.246.102",80,9,723,6,541,3,182,85082.509484,14.184803000011016,305.11527019420987,102.64506317069538
"147.32.84.165",1676,"72.20.15.61",80,3,186,3,186,0,0,85082.512684,8.484196000004886,175.3849156713427,0
"147.32.84.165",1677,"193.23.181.44",179,3,186,3,186,0,0,85082.515884,8.484182000000146,175.38520507928453,0
"147.32.84.165",1678,"67.19.72.206",80,3,186,3,186,0,0,85082.519088,8.484175000005052,175.3853497834632,0
"147.32.84.165",1679,"174.37.196.55",80,3,186,3,186,0,0,85082.522284,8.48417999999947,175.38524642335418,0
"147.32.84.165",1680,"72.20.15.61",80,10,783,6,541,4,242,85082.525531,8.950379999994766,483.5548881726285,216.30366531936434
"147.32.84.165",1681,"193.23.181.44",80,3,186,3,186,0,0,85082.528711,8.48416899998847,175.38547381623613,0
"147.32.84.165",1682,"72.20.15.61",80,3,186,3,186,0,0,85082.531886,8.484194999997271,175.3849363434573,0
"147.32.84.165",1683,"193.23.181.44",179,3,186,3,186,0,0,85082.535101,8.536561000000802,174.30906895644046,0
"147.32.84.165",1684,"193.23.181.44",80,3,186,3,186,0,0,85082.538283,8.536577999999281,174.30872183211181,0
"147.32.84.165",1685,"174.37.196.55",80,3,186,3,186,0,0,85082.541489,8.536598999999114,174.30829303334434,0
"147.32.84.165",1686,"193.23.181.44",179,3,186,3,186,0,0,85082.54469,8.536596999998437,174.30833387124545,0
"147.32.84.165",1687,"193.23.181.44",179,3,186,3,186,0,0,85082.54789,8.536601999992854,174.30823177667713,0
"147.32.84.165",1688,"67.19.72.206",80,3,186,3,186,0,0,85082.551086,8.53657499999099,174.3087830894206,0
"147.32.84.165",1689,"193.23.181.44",179,3,186,3,186,0,0,85082.554285,8.536575999998604,174.30876267021384,0
"147.32.84.165",1690,"193.23.181.44",179,3,186,3,186,0,0,85082.557485,8.536575000005541,174.30878308912347,0
"147.32.84.165",1691,"72.20.15.61",80,3,186,3,186,0,0,85082.560685,8.536605999994208,174.30815010098974,0
"147.32.84.165",1692,"174.128.246.102",80,9,698,5,456,4,242,85082.56389,2.9768439999897964,1225.4589088351638,650.3531928467316
"147.32.84.165",1693,"174.37.196.55",80,3,186,3,186,0,0,85082.567085,8.53340699999535,174.3734946664106,0
"147.32.84.165",1694,"72.20.15.61",80,3,186,3,186,0,0,85082.570288,8.533373999991454,174.3741689982755,0
"147.32.84.165",1695,"193.23.181.44",80,3,186,3,186,0,0,85082.573503,8.533358999993652,174.37447551440258,0
"147.32.84.165",1696,"193.23.181.44",179,3,186,3,186,0,0,85082.576687,8.53337500001362,174.37414856344938,0
"147.32.84.165",1697,"193.23.181.44",179,3,186,3,186,0,0,85082.579888,8.533373000012944,174.3741894322143,0
"147.32.84.165",1698,"174.128.246.102",80,3,186,3,186,0,0,85082.58309,8.533402999993996,174.3735764033466,0
"147.32.84.165",1699,"174.128.246.102",80,8,626,5,444,3,182,85082.586305,3.0409179999987828,1168.0683267360125,478.80278258097815
"147.32.84.165",1700,"67.19.72.206",80,3,186,3,186,0,0,85082.589505,8.530188000004273,174.43929723462773,0
"147.32.84.165",1701,"72.20.15.61",80,3,186,3,186,0,0,85082.592706,8.530156000007992,174.4399516255747,0
"147.32.84.165",1702,"193.23.181.44",80,3,186,3,186,0,0,85082.595932,8.530133000007481,174.4404219721656,0
"147.32.84.165",1703,"67.19.72.206",80,3,186,3,186,0,0,85082.643532,8.515132999993511,174.74771092842988,0
"147.32.84.165",1704,"174.128.246.102",80,10,785,6,543,4,242,85082.646685,8.886943000004976,488.80700596341933,217.84768958222372
"147.32.84.165",1705,"174.128.246.102",80,8,665,6,543,2,122,85082.649884,8.90832699999737,487.6336488322984,109.56041465477054
"147.32.84.165",1706,"174.37.196.55",80,7,591,4,409,3,182,85082.653084,0.727839999992284,4495.493515105913,2000.4396570886945
"147.32.84.165",1707,"174.37.196.55",80,7,604,4,422,3,182,85082.656313,0.7422019999939948,4548.6269237044835,1961.730095057384
"147.32.84.165",1708,"174.37.196.55",80,7,568,4,386,3,182,85082.659516,0.7576549999939743,4075.7336782896687,1921.7189882091184
"147.32.84.165",1709,"174.37.196.55",80,7,599,4,417,3,182,85082.662732,0.7711859999981243,4325.804669701101,1888.0010788623513
"147.32.84.165",1710,"67.19.72.206",80,3,186,3,186,0,0,85082.665934,8.492875999989337,175.20566649058202,0
"147.32.84.165",1711,"193.23.181.44",179,3,186,3,186,0,0,85082.669084,8.489750000007916,175.27017874479372,0
"147.32.84.165",1712,"193.23.181.44",80,3,186,3,186,0,0,85082.672317,8.486538999990444,175.3364946536716,0
"147.32.84.165",1713,"72.20.15.61",80,3,186,3,186,0,0,85082.675556,8.485727999999654,175.35325195434743,0
"147.32.84.165",1714,"174.37.196.55",80,7,630,4,448,3,182,85082.678732,0.7736449999938486,4632.615734643793,1882.0001421990407
"147.32.84.165",1715,"193.23.181.44",179,3,186,3,186,0,0,85082.681935,8.48254199999792,175.41911375155757,0
"147.32.84.165",1716,"72.20.15.61",80,3,186,3,186,0,0,85082.685134,8.482527000000118,175.41942395231743,0
"147.32.84.165",1717,"193.23.181.44",179,3,186,3,186,0,0,85082.688313,8.482547999999952,175.41898967150064,0
"147.32.84.165",1718,"174.128.246.102",80,3,186,3,186,0,0,85082.691511,8.482552000001306,175.41890695156022,0
"147.32.84.165",1719,"174.128.246.102",80,3,186,3,186,0,0,85082.694735,8.482528000007733,175.41940327207215,0
"147.32.84.165",1720,"193.23.181.44",80,3,186,3,186,0,0,85082.697935,8.482527000000118,175.41942395231743,0
"147.32.84.165",1721,"174.128.246.102",80,3,186,3,186,0,0,85082.701134,8.482547999999952,175.41898967150064,0
"147.32.84.165",1722,"72.20.15.61",80,3,186,3,186,0,0,85082.704332,8.482529000000795,175.41938259213265,0
"147.32.84.165",1723,"193.23.181.44",179,3,186,3,186,0,0,85082.733107,8.564571000009892,173.73899988665883,0
"147.32.84.165",1724,"67.19.72.206",80,3,186,3,186,0,0,85082.736303,8.56459399999585,173.73853331526527,0
"147.32.84.165",1725,"72.20.15.61",80,3,186,3,186,0,0,85082.739507,8.564555999997538,173.73930417413675,0
"147.32.84.165",1726,"193.23.181.44",179,3,186,3,186,0,0,85082.742734,8.56454500000109,173.73952731870878,0
"147.32.84.165",1727,"193.23.181.44",80,3,186,3,186,0,0,85082.745906,8.564578000004985,173.73885788641704,0
"147.32.84.165",1728,"174.37.196.55",80,3,186,3,186,0,0,85082.749087,8.564595000003465,173.7385130294425,0
"147.32.84.165",1729,"72.20.15.61",80,3,186,3,186,0,0,85082.752333,8.56453099999635,173.73981132190823,0
"147.32.84.165",1730,"174.37.196.55",80,3,186,3,186,0,0,85082.755548,8.564534000004642,173.73975046385402,0
"147.32.84.165",1731,"193.23.181.44",179,3,186,3,186,0,0,85082.758734,8.564545999994152,173.7395070329491,0
"147.32.84.165",1732,"193.23.181.44",179,3,186,3,186,0,0,85082.761905,8.564578999998048,173.73883760081367,0
"147.32.84.165",1733,"193.23.181.44",179,3,186,3,186,0,0,85082.765105,8.564559999998892,173.73922303074443,0
"147.32.84.165",1734,"174.128.246.102",80,3,186,3,186,0,0,85082.768302,8.564564000000246,173.73914188742793,0
"147.32.84.165",1735,"72.20.15.61",80,3,186,3,186,0,0,85082.771485,8.564580999998725,173.73879702932595,0
"147.32.84.165",1736,"193.23.181.44",80,3,186,3,186,0,0,85082.774688,8.56459699998959,173.73847245840156,0
"147.32.84.165",1737,"193.23.181.44",80,3,186,3,186,0,0,85082.777884,8.564601000005496,173.73839131549096,0
"147.32.84.165",1738,"174.128.246.102",80,3,186,3,186,0,0,85082.781085,8.564624999999069,173.73790446168533,0
"147.32.84.165",1739,"72.20.15.61",80,3,186,3,186,0,0,85082.784285,8.564626999999746,173.73786389063343,0
"147.32.84.165",1740,"193.23.181.44",80,3,186,3,186,0,0,85082.787501,8.564610000001267,173.738208745031,0
"147.32.84.165",1741,"72.20.15.61",80,3,186,3,186,0,0,85082.790704,8.564610000001267,173.738208745031,0
"147.32.84.165",1742,"193.23.181.44",80,3,186,3,186,0,0,85082.793935,8.5645790000126,173.73883760051848,0
"147.32.84.165",1743,"193.23.181.44",179,3,186,3,186,0,0,85082.834284,8.584977000005892,173.32603220707273,0
"147.32.84.165",1744,"174.128.246.102",80,3,186,3,186,0,0,85082.837484,8.58497699999134,173.32603220736652,0
"147.32.84.165",1745,"67.19.72.206",80,3,186,3,186,0,0,85082.840684,8.584975999998278,173.32605239668678,0
"147.32.84.165",1746,"67.19.72.206",80,3,186,3,186,0,0,85082.843884,8.58502800000133,173.3250025509258,0
"147.32.84.165",1747,"193.23.181.44",80,3,186,3,186,0,0,85082.847111,8.584950000004028,173.32657732418963,0
"147.32.84.165",1748,"72.20.15.61",80,3,186,3,186,0,0,85082.850317,8.584944000001997,173.326698461825,0
"147.32.84.165",1749,"193.23.181.44",80,3,186,3,186,0,0,85082.853534,8.584927000003518,173.32704168589788,0
"147.32.84.165",1750,"193.23.181.44",80,3,186,3,186,0,0,85082.856683,8.584977999998955,173.3260120177572,0
"147.32.84.165",1751,"193.23.181.44",179,3,186,3,186,0,0,85082.859928,8.584932999990997,173.32692054807654,0
"147.32.84.165",1752,"67.19.72.206",80,3,186,3,186,0,0,85082.863114,8.584946999995736,173.32663789313307,0
"147.32.84.165",1753,"67.19.72.206",80,3,186,3,186,0,0,85082.866331,8.584929999997257,173.32698111696607,0
"147.32.84.165",1754,"67.19.72.206",80,3,186,3,186,0,0,85082.869518,8.584962999986601,173.32631486033458,0
"147.32.84.165",1755,"193.23.181.44",80,3,186,3,186,0,0,85082.872711,8.584951999990153,173.32653694530927,0
"147.32.84.165",1756,"72.20.15.61",80,3,186,3,186,0,0,85082.875911,8.584954000005382,173.3264965658601,0
"147.32.84.165",1757,"193.23.181.44",80,3,186,3,186,0,0,85082.879087,8.584975000005215,173.32607258601172,0
"147.32.84.165",1758,"67.19.72.206",80,3,186,3,186,0,0,85082.882326,8.584934999991674,173.32688016874246,0
"147.32.84.165",1759,"174.128.246.102",80,3,186,3,186,0,0,85082.885486,8.584994999997434,173.32566879776223,0
"147.32.84.165",1760,"193.23.181.44",179,3,186,3,186,0,0,85082.888683,8.585021000006236,173.32514387546857,0
"147.32.84.165",1761,"193.23.181.44",179,3,186,3,186,0,0,85082.891886,8.585003000000142,173.32550728287168,0
"147.32.84.165",1762,"174.128.246.102",80,3,186,3,186,0,0,85082.895083,8.584994999997434,173.32566879776223,0
"147.32.84.165",1763,"193.23.181.44",179,3,186,3,186,0,0,85082.953884,8.532664999991539,174.38865817437758,0
"147.32.84.165",1764,"193.23.181.44",80,3,186,3,186,0,0,85082.957087,8.532596999997622,174.39004795379586,0
"147.32.84.165",1765,"72.20.15.61",80,3,186,3,186,0,0,85082.960285,8.532627000007778,174.3894348128242,0
"147.32.84.165",1766,"193.23.181.44",80,3,186,3,186,0,0,85082.963484,8.532634999995935,174.38927130959064,0
"147.32.84.165",1767,"193.23.181.44",179,3,186,3,186,0,0,85082.966684,8.53259600000456,174.3900683917538,0
"147.32.84.165",1768,"193.23.181.44",80,3,186,3,186,0,0,85082.969905,8.532577999998466,174.39043627849256,0
"147.32.84.165",1769,"193.23.181.44",80,3,186,3,186,0,0,85082.973106,8.532559999992372,174.39080416678348,0
"147.32.84.165",1770,"67.19.72.206",80,3,186,3,186,0,0,85082.976302,8.532563000000664,174.39074285181184,0
"147.32.84.165",1771,"174.37.196.55",80,3,186,3,186,0,0,85082.979509,8.532604000007268,174.3899048870348,0
"147.32.84.165",1772,"174.128.246.102",80,3,186,3,186,0,0,85082.982705,8.532557999991695,174.39084504335608,0
"147.32.84.165",1773,"67.19.72.206",80,3,186,3,186,0,0,85082.985903,8.5326100000093,174.38978225869673,0
"147.32.84.165",1774,"174.128.246.102",80,3,186,3,186,0,0,85082.989086,8.532634000002872,174.38929174736654,0
"147.32.84.165",1775,"193.23.181.44",80,3,186,3,186,0,0,85082.992336,8.532577000005404,174.3904567165415,0
"147.32.84.165",1776,"174.128.246.102",80,3,186,3,186,0,0,85082.995515,8.532565999994404,174.3906815371807,0
"147.32.84.165",1777,"174.128.246.102",80,3,186,3,186,0,0,85082.998736,8.532579999999143,174.3903954021116,0
"147.32.84.165",1778,"67.19.72.206",80,3,186,3,186,0,0,85083.001934,8.53253300000506,174.3913560016841,0
"147.32.84.165",1779,"174.128.246.102",80,3,186,3,186,0,0,85083.005136,8.532530999989831,174.3913968788128,0
"147.32.84.165",1780,"193.23.181.44",179,3,186,3,186,0,0,85083.008334,8.53253300000506,174.3913560016841,0
"147.32.84.165",1781,"174.37.196.55",80,3,186,3,186,0,0,85083.011484,8.532582999992883,174.3903340877248,0
"147.32.84.165",1782,"193.23.181.44",179,3,186,3,186,0,0,85083.014684,8.532583000007435,174.3903340874274,0
"147.32.84.165",1783,"72.20.15.61",80,3,186,3,186,0,0,85083.054684,8.552975999991759,173.97453237346085,0
"147.32.84.165",1784,"174.37.196.55",80,3,186,3,186,0,0,85083.057883,8.5530049999943,173.973942491673,0
"147.32.84.165",1785,"67.19.72.206",80,3,186,3,186,0,0,85083.061082,8.552979999993113,173.9744510101974,0
"147.32.84.165",1786,"67.19.72.206",80,3,186,3,186,0,0,85083.064301,8.552960000000894,173.97485782697973,0
"147.32.84.165",1787,"72.20.15.61",80,3,186,3,186,0,0,85083.067506,8.552954999991925,173.97495953169457,0
"147.32.84.165",1788,"67.19.72.206",80,3,186,3,186,0,0,85083.070705,8.55295599999954,173.9749391906237,0
"147.32.84.165",1789,"193.23.181.44",80,3,186,3,186,0,0,85083.073902,8.552987000002759,173.97430862452148,0
"147.32.84.165",1790,"174.37.196.55",80,9,720,6,538,3,182,85083.077109,8.813876999993226,488.32086038905555,165.19404570782177
"147.32.84.165",1791,"67.19.72.206",80,3,186,3,186,0,0,85083.080304,8.553008000002592,173.97388146948407,0
"147.32.84.165",1792,"193.23.181.44",80,3,186,3,186,0,0,85083.083537,8.552972000004956,173.9746137365044,0
"147.32.84.165",1793,"174.37.196.55",80,9,724,6,542,3,182,85083.086734,8.825706000003265,491.292141387714,164.9726378829593
"147.32.84.165",1794,"72.20.15.61",80,3,186,3,186,0,0,85083.089905,8.552958000000217,173.9748985087922,0
"147.32.84.165",1795,"174.128.246.102",80,8,692,4,450,4,242,85083.093104,0.7017590000032214,5129.9662704482225,2758.7818609966
"147.32.84.165",1796,"67.19.72.206",80,3,186,3,186,0,0,85083.096301,8.54977900000813,174.0395862862169,0
"147.32.84.165",1797,"67.19.72.206",80,3,186,3,186,0,0,85083.099504,8.54977900000813,174.0395862862169,0
"147.32.84.165",1798,"67.19.72.206",80,3,186,3,186,0,0,85083.102705,8.549809000003734,174.03897560744926,0
"147.32.84.165",1799,"174.37.196.55",80,9,720,6,538,3,182,85083.105936,8.891969999996945,484.0322223311008,163.7432424986252
"147.32.84.165",1800,"193.23.181.44",80,3,186,3,186,0,0,85083.109087,8.549824000001536,174.03867026967254,0
"147.32.84.165",1801,"67.19.72.206",80,4,246,3,186,1,60,85083.112339,8.707976000005146,170.8778251110385,55.121879068076936
"147.32.84.165",1802,"174.128.246.102",80,7,648,4,466,3,182,85083.115537,0.6921309999888763,5386.263583136596,2103.6480088645076
"147.32.84.165",1803,"193.23.181.44",179,3,186,3,186,0,0,85083.118732,8.552977999992436,173.97449169181962,0
"147.32.84.165",1804,"174.128.246.102",80,7,603,4,421,3,182,85083.121932,0.7119959999981802,4730.363653740482,2044.9553087429163
"147.32.84.165",1805,"67.19.72.206",80,3,186,3,186,0,0,85083.12513,8.549778999993578,174.0395862865131,0
"147.32.84.165",1806,"193.23.181.44",179,3,186,3,186,0,0,85083.128305,8.549805999995442,174.0390366753109,0
"147.32.84.165",1807,"72.20.15.61",80,3,186,3,186,0,0,85083.131486,8.549792999998317,174.03930130241667,0
"147.32.84.165",1808,"174.128.246.102",80,3,186,3,186,0,0,85083.134708,8.549771000005421,174.03974913469102,0
"147.32.84.165",1809,"174.37.196.55",80,8,630,5,448,3,182,85083.137936,2.7445319999969797,1305.8692702449614,530.5093910370156
"147.32.84.165",1810,"72.20.15.61",80,3,186,3,186,0,0,85083.141104,8.546557000008761,174.10519815154507,0
"147.32.84.165",1811,"193.23.181.44",80,3,186,3,186,0,0,85083.144306,8.546571999992011,174.10489258165623,0
"147.32.84.165",1812,"193.23.181.44",80,3,186,3,186,0,0,85083.147536,8.54652599999099,174.10582966711488,0
"147.32.84.165",1813,"193.23.181.44",179,3,186,3,186,0,0,85083.150743,8.546518999995897,174.10597226785717,0
"147.32.84.165",1814,"193.23.181.44",179,3,186,3,186,0,0,85083.153933,8.546528999999282,174.1057685523708,0
"147.32.84.165",1815,"174.37.196.55",80,8,653,5,471,3,182,85083.157101,2.725844999993569,1382.3236464321667,534.14629225192
"147.32.84.165",1816,"174.37.196.55",80,8,624,5,442,3,182,85083.16033,2.722626000002492,1298.7461370003678,534.7778211177985
"147.32.84.165",1817,"72.20.15.61",80,3,186,3,186,0,0,85083.163533,8.540145000006305,174.23591753991315,0
"147.32.84.165",1818,"67.19.72.206",80,3,186,3,186,0,0,85083.166727,8.54014399999869,174.23593794205672,0
"147.32.84.165",1819,"174.37.196.55",80,8,664,5,482,3,182,85083.169888,2.7370709999959217,1408.80525203977,531.9555101063032
"147.32.84.165",1820,"174.37.196.55",80,8,731,5,549,3,182,85083.173088,2.755447000003187,1593.9337610176933,528.4079134885613
"147.32.84.165",1821,"193.23.181.44",179,3,186,3,186,0,0,85083.17632,8.533762999999453,174.3662203883674,0
"147.32.84.165",1822,"193.23.181.44",179,3,186,3,186,0,0,85083.179518,8.533786999993026,174.3657300095744,0
"147.32.84.165",1911,"217.163.21.36",80,11,3124,6,1116,5,2008,85083.189087,0.6108180000010179,14616.465133616104,26299.15948772503
"147.32.84.165",1823,"72.20.15.61",80,3,186,3,186,0,0,85083.192284,8.611011000000872,172.80200896269315,0
"147.32.84.165",1824,"174.128.246.102",80,3,186,3,186,0,0,85083.195484,8.61097600001085,172.80271133006582,0
"147.32.84.165",1825,"193.23.181.44",80,3,186,3,186,0,0,85083.198684,8.610977000003913,172.80269126248086,0
"147.32.84.165",1826,"193.23.181.44",80,3,186,3,186,0,0,85083.201914,8.610946000000695,172.8033133641623,0
"147.32.84.165",1827,"174.128.246.102",80,3,186,3,186,0,0,85083.205113,8.610946999993757,172.80329329643752,0
"147.32.84.165",1828,"193.23.181.44",179,3,186,3,186,0,0,85083.208316,8.610946000000695,172.8033133641623,0
"147.32.84.165",1829,"72.20.15.61",80,3,186,3,186,0,0,85083.211514,8.610967000000528,172.8028919400003,0
"147.32.84.165",1830,"174.128.246.102",80,3,186,3,186,0,0,85083.214718,8.610964999999851,172.80293207556014,0
"147.32.84.165",1831,"174.37.196.55",80,3,186,3,186,0,0,85083.217886,8.611000000004424,172.80222970610097,0
"147.32.84.165",1832,"67.19.72.206",80,3,186,3,186,0,0,85083.221116,8.610946999993757,172.80329329643752,0
"147.32.84.165",1833,"174.37.196.55",80,3,186,3,186,0,0,85083.224313,8.610973999995622,172.80275146583378,0
"147.32.84.165",1834,"67.19.72.206",80,3,186,3,186,0,0,85083.227519,8.610965000014403,172.80293207526813,0
"147.32.84.165",1835,"193.23.181.44",179,3,186,3,186,0,0,85083.230711,8.61097300000256,172.80277153343272,0
"147.32.84.165",1836,"193.23.181.44",80,3,186,3,186,0,0,85083.233916,8.610966000007465,172.8029120076319,0
"147.32.84.165",1837,"67.19.72.206",80,3,186,3,186,0,0,85083.237084,8.610998000003747,172.8022698413532,0
"147.32.84.165",1838,"72.20.15.61",80,3,186,3,186,0,0,85083.240284,8.611025999998674,172.801707949811,0
"147.32.84.165",1839,"67.19.72.206",80,3,186,3,186,0,0,85083.243484,8.611025999998674,172.801707949811,0
"147.32.84.165",1840,"193.23.181.44",179,3,186,3,186,0,0,85083.246682,8.61099899999681,172.80224977387076,0
"147.32.84.165",1841,"193.23.181.44",80,3,186,3,186,0,0,85083.249901,8.61100799999258,172.80206916557066,0
"147.32.84.165",1842,"193.23.181.44",179,3,186,3,186,0,0,85083.347933,8.553346000000602,173.96700659600293,0
"147.32.84.165",1843,"72.20.15.61",80,3,186,3,186,0,0,85083.351132,8.553349000008893,173.9669455786795,0
"147.32.84.165",1844,"67.19.72.206",80,3,186,3,186,0,0,85083.354332,8.55333399999654,173.9672506651327,0
"147.32.84.165",1845,"72.20.15.61",80,3,186,3,186,0,0,85083.357506,8.553358000004664,173.96676252755802,0
"147.32.84.165",1846,"174.128.246.102",80,3,186,3,186,0,0,85083.360736,8.553327000001445,173.96739303895998,0
"147.32.84.165",1847,"193.23.181.44",80,3,186,3,186,0,0,85083.363938,8.553327000001445,173.96739303895998,0
"147.32.84.165",1848,"72.20.15.61",80,9,721,6,539,3,182,85083.367132,8.922718999994686,483.2607638997225,163.17895923886735
"147.32.84.165",1849,"72.20.15.61",80,3,186,3,186,0,0,85083.370333,8.5533310000028,173.96731168237415,0
"147.32.84.165",1850,"193.23.181.44",179,3,186,3,186,0,0,85083.373484,8.553413000001456,173.96564388972527,0
"147.32.84.165",1851,"174.37.196.55",80,3,186,3,186,0,0,85083.376714,8.553348000001279,173.96696591788123,0
"147.32.84.165",1852,"193.23.181.44",80,3,186,3,186,0,0,85083.379916,8.553346000000602,173.96700659600293,0
"147.32.84.165",1853,"193.23.181.44",80,3,186,3,186,0,0,85083.383132,8.553329000002122,173.96735236065757,0
"147.32.84.165",1854,"174.37.196.55",80,3,186,3,186,0,0,85083.386312,8.553348999994341,173.9669455789755,0
"147.32.84.165",1855,"67.19.72.206",80,3,186,3,186,0,0,85083.389483,8.553377999996883,173.96635574863433,0
"147.32.84.165",1856,"67.19.72.206",80,3,186,3,186,0,0,85083.392733,8.553327999994508,173.96737269995438,0
"147.32.84.165",1857,"67.19.72.206",80,3,186,3,186,0,0,85083.395935,8.553329000002122,173.96735236065757,0
"147.32.84.165",1858,"193.23.181.44",80,3,186,3,186,0,0,85083.399083,8.55337700000382,173.96637608740212,0
"147.32.84.165",1859,"193.23.181.44",80,3,186,3,186,0,0,85083.402334,8.553327000001445,173.96739303895998,0
"147.32.84.165",1860,"193.23.181.44",80,3,186,3,186,0,0,85083.405536,8.553325000000768,173.96743371728144,0
"147.32.84.165",1861,"174.128.246.102",80,3,186,3,186,0,0,85083.408732,8.553327000001445,173.96739303895998,0
"147.32.84.165",1862,"174.128.246.102",80,3,186,3,186,0,0,85083.411934,8.556526999993366,173.90233210286763,0
"147.32.84.165",1863,"193.23.181.44",80,3,186,3,186,0,0,85083.415084,8.556577000010293,173.90131591151578,0
"147.32.84.165",1864,"174.37.196.55",80,3,186,3,186,0,0,85083.418284,8.556576999995741,173.90131591181154,0
"147.32.84.165",1865,"174.128.246.102",80,3,186,3,186,0,0,85083.421486,8.556604999990668,173.90074685013775,0
"147.32.84.165",1866,"174.128.246.102",80,3,186,3,186,0,0,85083.424705,8.55658499999845,173.90115332229735,0
"147.32.84.165",1867,"193.23.181.44",80,3,186,3,186,0,0,85083.427933,8.556557999996585,173.90170206297836,0
"147.32.84.165",1868,"174.37.196.55",80,3,186,3,186,0,0,85083.431107,8.556634000007762,173.90015746830474,0
"147.32.84.165",1869,"174.128.246.102",80,3,186,3,186,0,0,85083.434311,8.556581999990158,173.9012142934774,0
"147.32.84.165",1870,"67.19.72.206",80,3,186,3,186,0,0,85083.437531,8.556578999996418,173.9012752644045,0
"147.32.84.165",1874,"174.37.196.55",80,3,186,3,186,0,0,85083.440713,8.55659399999422,173.90097040960518,0
"147.32.84.165",1876,"174.37.196.55",80,3,186,3,186,0,0,85083.443954,8.556526000000304,173.90235242666793,0
"147.32.84.165",1877,"174.37.196.55",80,3,186,3,186,0,0,85083.447121,8.556608999992022,173.9006655558747,0
"147.32.84.165",1878,"174.128.246.102",80,3,186,3,186,0,0,85083.450306,8.55656799999997,173.90149882523053,0
"147.32.84.165",1879,"67.19.72.206",80,3,186,3,186,0,0,85083.453501,8.5565590000042,173.9016817390343,0
"147.32.84.165",1880,"72.20.15.61",80,3,186,3,186,0,0,85083.456733,8.55654499999946,173.90196627261284,0
"147.32.84.165",1881,"174.128.246.102",80,3,186,3,186,0,0,85083.459935,8.556542999998783,173.9020069203429,0
"147.32.84.165",1882,"193.23.181.44",80,3,186,3,186,0,0,85083.463135,8.556549000000814,173.90188497720968,0
"147.32.84.165",1883,"174.128.246.102",80,3,186,3,186,0,0,85083.466306,8.556576000002678,173.90133623537432,0
"147.32.84.165",1884,"193.23.181.44",80,3,186,3,186,0,0,85083.469506,8.55657900001097,173.90127526410873,0
"147.32.84.165",1885,"193.23.181.44",179,3,186,3,186,0,0,85083.472737,8.556541999991168,173.90202724436296,0
"147.32.84.165",1886,"174.128.246.102",80,3,186,3,186,0,0,85083.485533,8.576207999998587,173.50325458527186,0
"147.32.84.165",1887,"174.128.246.102",80,3,186,3,186,0,0,85083.488736,8.573126000002958,173.56562822003158,0
"147.32.84.165",1888,"67.19.72.206",80,3,186,3,186,0,0,85083.491932,8.569977999999537,173.6293838794079,0
"147.32.84.165",1889,"174.37.196.55",80,3,186,3,186,0,0,85083.495133,8.566821000000346,173.6933688704293,0
"147.32.84.165",1890,"193.23.181.44",179,3,186,3,186,0,0,85083.498307,8.56369700000505,173.75673146762696,0
"147.32.84.165",1891,"193.23.181.44",179,3,186,3,186,0,0,85083.50153,8.560519999999087,173.821216468177,0
"147.32.84.165",1892,"174.128.246.102",80,3,186,3,186,0,0,85083.504751,8.557348000002094,173.88564774970422,0
"147.32.84.165",1893,"174.37.196.55",80,3,186,3,186,0,0,85083.507932,8.554217000011704,173.94929307942084,0
"147.32.84.165",1894,"193.23.181.44",80,3,186,3,186,0,0,85083.511134,8.551063000006252,174.01345306412924,0
"147.32.84.165",1895,"193.23.181.44",179,3,186,3,186,0,0,85083.514305,8.547938999996404,174.07704945023895,0
"147.32.84.165",1896,"72.20.15.61",80,3,186,3,186,0,0,85083.517537,8.54694399998698,174.09731478318648,0
"147.32.84.165",1897,"174.128.246.102",80,3,186,3,186,0,0,85083.520736,8.546942999993917,174.0973351525872,0
"147.32.84.165",1898,"193.23.181.44",80,3,186,3,186,0,0,85083.523902,8.546979999999166,174.09658148259913,0
"147.32.84.165",1899,"72.20.15.61",80,3,186,3,186,0,0,85083.527137,8.546925999995437,174.09768143550025,0
"147.32.84.165",1901,"67.19.72.206",80,3,186,3,186,0,0,85083.530332,8.546950000003562,174.0971925656965,0
"147.32.84.165",1904,"193.23.181.44",179,3,186,3,186,0,0,85083.53349,8.546988999994937,174.0963981585657,0
"147.32.84.165",1905,"193.23.181.44",80,3,186,3,186,0,0,85083.536689,8.54702399999951,174.09568523501108,0
"147.32.84.165",1906,"193.23.181.44",179,3,186,3,186,0,0,85083.539886,8.54702100000577,174.09574634238004,0
"147.32.84.165",1907,"193.23.181.44",80,3,186,3,186,0,0,85083.543086,8.546997999990708,174.09621483491838,0
"147.32.84.165",1908,"174.37.196.55",80,3,186,3,186,0,0,85083.546286,8.54699800000526,174.09621483462197,0
"147.32.84.165",1917,"217.163.21.37",80,13,6074,6,749,7,5325,85083.549483,0.3741160000063246,16016.422713539925,113868.42583391201
"147.32.84.165",1909,"72.20.15.61",80,3,186,3,186,0,0,85083.552683,8.60979000000225,172.8265149323748,0
"147.32.84.165",1910,"174.37.196.55",80,3,186,3,186,0,0,85083.555885,8.606651000009151,172.88954786227742,0
"147.32.84.165",1912,"193.23.181.44",179,3,186,3,186,0,0,85083.559084,8.603474000003189,172.953390688395,0
"147.32.84.165",1913,"193.23.181.44",80,3,186,3,186,0,0,85083.562284,8.600300000005518,173.01722032941237,0
"147.32.84.165",1914,"72.20.15.61",80,3,186,3,186,0,0,85083.565484,8.597121999991941,173.08117763146723,0
"147.32.84.165",1915,"72.20.15.61",80,3,186,3,186,0,0,85083.568684,8.593944000007468,173.14518223515384,0
"147.32.84.165",1916,"67.19.72.206",80,3,186,3,186,0,0,85083.571884,8.590765999993891,173.20923419414032,0
"147.32.84.165",1918,"72.20.15.61",80,3,186,3,186,0,0,85083.63913,8.623270000010962,172.556350432969,0
"147.32.84.165",1919,"174.37.196.55",80,7,559,4,377,3,182,85083.663085,0.2642350000096485,11414.08216129533,5510.246560625331
"147.32.84.165",1920,"174.37.196.55",80,7,636,4,454,3,182,85083.684686,0.2754270000004908,13186.797227554045,5286.337214570123
"147.32.84.165",1921,"217.163.21.37",80,10,1448,5,699,5,749,85083.697506,0.21015800000168383,26608.551660917954,28511.881536520097
"147.32.84.165",1922,"195.113.232.88",80,31,30632,19,1871,12,28761,85083.735911,37.606864000001224,398.01244794034176,6118.244797013453
"147.32.84.165",1923,"193.23.181.44",80,3,186,3,186,0,0,85083.819502,8.944505000006757,166.35912216482365,0
"147.32.84.165",1924,"193.23.181.44",80,3,186,3,186,0,0,85083.855516,8.908514000009745,167.0312242870553,0
"147.32.84.165",1925,"217.163.21.36",80,11,3375,6,1236,5,2139,85083.865132,0.838752999989083,11788.929518140261,20401.715403966035
"147.32.84.165",1926,"217.163.21.37",80,10,1446,5,698,5,748,85083.881134,0.24318099999800324,22962.320247247317,24607.18559447134
"147.32.84.165",1927,"217.163.21.36",80,11,3540,6,1235,5,2305,85084.081904,0.9171819999901345,10772.125924959575,20105.06093686787
"147.32.84.165",1928,"193.23.181.44",179,3,186,3,186,0,0,85084.486285,8.678569999989122,171.45681834701628,0
"147.32.84.165",1929,"67.19.72.206",80,3,186,3,186,0,0,85084.506284,8.658593999993172,171.8523815761743,0
"147.32.84.165",1930,"193.23.181.44",179,3,186,3,186,0,0,85084.586707,8.678831000011996,171.45166209572963,0
"147.32.84.165",1931,"72.20.15.61",80,3,186,3,186,0,0,85084.605503,8.660092999998596,171.8226351611052,0
"147.32.84.165",1932,"193.23.181.44",80,3,186,3,186,0,0,85084.700685,8.664869999993243,171.72790820879717,0
"147.32.84.165",1933,"195.113.232.88",80,17,16366,11,1026,6,15340,85084.767885,36.575096000000485,224.4149953837412,3355.28852747231
"147.32.84.165",1934,"174.37.196.55",80,3,186,3,186,0,0,85084.995905,8.77187799999956,169.63300219178544,0
"147.32.84.165",1935,"72.20.15.61",80,3,186,3,186,0,0,85085.217914,8.850309000001289,168.1297229282936,0
"147.32.84.165",1936,"72.20.15.61",80,3,186,3,186,0,0,85085.367501,8.901261000006343,167.16732606750207,0
"147.32.84.165",1937,"193.23.181.44",80,3,186,3,186,0,0,85085.387915,8.880896999995457,167.55064268854386,0
"147.32.84.165",1938,"193.23.181.44",179,3,186,3,186,0,0,85085.471506,8.897620999996434,167.23571390606506,0
"147.32.84.165",1939,"72.20.15.61",80,3,186,3,186,0,0,85085.772851,8.99775700000464,165.37454834568578,0
"147.32.84.165",1940,"72.20.15.61",80,3,186,3,186,0,0,85085.77605,8.994604999999865,165.43250092694703,0
"147.32.84.165",1941,"67.19.72.206",80,3,186,3,186,0,0,85085.779282,8.99141599998984,165.49117513878585,0
"147.32.84.165",1942,"174.128.246.102",80,3,186,3,186,0,0,85085.800883,8.969861999998102,165.8888397614495,0
"147.32.84.165",1943,"72.20.15.61",80,3,186,3,186,0,0,85085.82605,8.944739999991725,166.35475150774383,0
"147.32.84.165",1944,"184.82.155.107",80,10,1912,5,981,5,931,85089.559545,0.34262999999918975,22905.17467827849,21737.73458254564
"147.32.84.165",1945,"184.82.155.108",80,10,1511,5,599,5,912,85089.794906,0.3076300000102492,15577.154373241709,23716.802651746973
"147.32.84.165",1946,"217.163.21.37",80,13,6081,6,750,7,5331,85090.014336,0.5869800000073155,10221.81334956084,72656.64928867845
"147.32.84.165",1947,"193.23.181.44",179,12,923,7,623,5,300,85090.263663,9.037031999992905,551.5085041199271,265.5739185168188
"147.32.84.165",1948,"193.23.181.44",80,10,932,7,548,3,384,85090.284482,8.92649800000072,491.1220503269755,344.1439184772967
"147.32.84.165",1949,"193.23.181.44",179,13,925,7,565,6,360,85090.373261,9.006322000001092,501.86968664893976,319.7753755639262
"147.32.84.165",1950,"217.163.21.37",80,10,1451,5,701,5,750,85090.558882,0.19043499999679625,29448.368210120752,31506.81334891664
"147.32.84.165",1951,"217.163.21.36",80,9,2948,5,1378,4,1570,85090.70689,0.3123699999996461,35291.481256242565,40208.72683040699
"147.32.84.165",1952,"174.37.196.55",80,3,186,3,186,0,0,85090.862861,8.92385700000159,166.74404352285507,0
"147.32.84.165",1953,"174.37.196.55",80,3,186,3,186,0,0,85090.866061,8.920716000007815,166.80275439759504,0
"147.32.84.165",1954,"67.19.72.206",80,3,186,3,186,0,0,85090.884889,8.901910000000498,167.15513861631007,0
"147.32.84.165",1955,"217.163.21.37",80,10,2277,5,1156,5,1121,85090.955262,0.22595199999341276,40929.04687840607,39689.845632087556
"147.32.84.165",1956,"112.205.182.117",6667,6,366,3,186,3,180,85091.12926,2.0215549999993527,736.0670375035438,712.3229395195585
"147.32.84.165",1957,"217.163.21.36",80,13,4408,7,1947,6,2461,85091.138887,0.34439800000109244,45226.74347688021,57166.4179232677
"147.32.84.165",1958,"67.19.72.206",80,3,186,3,186,0,0,85091.294482,8.89267899999686,167.32865315396242,0
"147.32.84.165",1959,"174.37.196.55",80,3,186,3,186,0,0,85091.380081,8.908695000005537,167.02783067543285,0
"147.32.84.165",1960,"174.37.196.55",80,3,186,3,186,0,0,85091.401661,8.88723600000958,167.43113381915322,0
"147.32.84.165",1961,"92.240.244.181",80,10,1766,6,1316,4,450,85091.550463,5.1999699999869335,2024.6270651612326,692.3116864153151
"147.32.84.165",1962,"173.241.240.4",80,9,2148,5,1118,4,1030,85091.668463,0.2264170000125887,39502.33418649093,36393.02702333243
"147.32.84.165",1963,"193.23.181.44",80,10,984,7,600,3,384,85091.784888,9.0264060000045,531.7731110253192,340.33479105620427
"147.32.84.165",1964,"193.23.181.44",80,10,984,7,600,3,384,85091.870483,9.04462399998738,530.7019949095394,339.6492767421052
"147.32.84.165",1965,"67.19.72.206",80,3,186,3,186,0,0,85091.891684,8.89814699999988,167.22582802914135,0
"147.32.84.165",1966,"174.128.246.102",80,9,744,5,502,4,242,85091.898063,3.1885889999975916,1259.49126714137,607.1651128450428
"147.32.84.165",1967,"174.128.246.102",80,8,621,4,379,4,242,85092.114864,0.32995600000140257,9189.104001706626,5867.448993174152
"147.32.84.165",1968,"174.37.196.55",80,3,186,3,186,0,0,85092.281792,9.00917100001243,165.16503016736468,0
"147.32.84.165",1969,"193.23.181.44",80,3,186,3,186,0,0,85094.92893,8.870829999999842,167.74078637512235,0
"147.32.84.165",1970,"178.150.146.54",6667,2,124,2,124,0,0,85096.180308,3.0040359999984503,330.2224074546749,0
"147.32.84.165",1971,"184.82.155.107",80,10,1913,5,985,5,928,85097.791517,0.3395719999971334,23205.682447511932,21862.815544457942
"147.32.84.165",1972,"184.82.155.108",80,10,1507,5,596,5,911,85098.030756,0.3264210000052117,14606.903354636723,22326.994892741703
"147.32.84.165",1973,"217.163.21.37",80,13,6077,6,749,7,5328,85098.262827,0.1873219999979483,31987.700323857473,227544.0151208446
"147.32.84.165",1974,"217.163.21.37",80,10,1448,5,699,5,749,85098.411081,0.1474739999976009,37918.54835490303,40630.8908695599
"147.32.84.165",1975,"217.163.21.36",80,9,3031,5,1463,4,1568,85098.513219,0.2215929999947548,52817.552902289506,56608.28636417632
"147.32.84.165",1976,"217.163.21.37",80,10,2274,5,1154,5,1120,85098.690895,0.14000499999383464,65940.50212782792,63997.71437016227
"147.32.84.165",1977,"217.163.21.36",80,13,4521,7,2032,6,2489,85098.78542,0.17216600000392646,94420.50114209113,115655.82054265002
"147.32.84.165",1978,"173.241.240.4",80,9,2194,5,1164,4,1030,85098.890756,0.08634200000960846,107850.1771902866,95434.43514260757
"147.32.84.165",1979,"92.240.244.181",80,10,1764,6,1314,4,450,85098.892249,5.055218000008608,2079.435545604977,712.1354608236222
"147.32.84.165",1980,"174.37.196.55",80,3,186,3,186,0,0,85099.148663,8.865147999997134,167.84829762576788,0
"147.32.84.165",1981,"67.19.72.206",80,3,186,3,186,0,0,85099.157036,8.85683699999936,168.00580161971,0
"147.32.84.165",1982,"72.20.15.61",80,3,186,3,186,0,0,85099.249832,8.864329000003636,167.8638055964969,0
"147.32.84.165",1983,"72.20.15.61",80,3,186,3,186,0,0,85100.751312,8.867157000000589,167.81026883812942,0
"147.32.84.165",1984,"193.23.181.44",80,8,861,5,477,3,384,85100.853588,0.12836000000243075,29728.88750333232,23932.68931085872
"147.32.84.165",1985,"72.20.15.61",80,3,186,3,186,0,0,85100.918586,8.901012999995146,167.17198368329667,0
"147.32.84.165",1986,"174.37.196.55",80,3,186,3,186,0,0,85101.893753,9.029751000009128,164.78859716048603,0
"147.32.84.165",1987,"193.23.181.44",80,10,983,6,537,4,446,85101.894115,0.5444580000039423,7890.415789590554,6553.306223756773
"147.32.84.165",1989,"174.37.196.55",80,3,186,3,186,0,0,85101.897603,9.025978999998188,164.8574631073592,0
"147.32.84.165",1990,"174.37.196.55",80,3,186,3,186,0,0,85101.897825,9.025789000006625,164.860933487245,0
"147.32.84.165",1991,"193.23.181.44",80,8,863,5,477,3,386,85101.898094,0.44165999999677297,8640.130417126029,6991.8036499175
"147.32.84.165",1992,"72.20.15.61",80,3,186,3,186,0,0,85101.898315,9.02533200000471,164.86928126291903,0
"147.32.84.165",1993,"174.37.196.55",80,3,186,3,186,0,0,85101.898531,9.02514599999995,164.87267906801821,0
"147.32.84.165",1988,"174.128.246.102",80,8,672,6,550,2,122,85101.898791,9.460907999993651,465.07164005853906,103.16134561298503
"147.32.84.165",1995,"174.37.196.55",80,3,186,3,186,0,0,85101.899096,9.024643000011565,164.88186845707838,0
"147.32.84.165",1994,"193.23.181.44",80,8,810,5,424,3,386,85101.899313,0.4372409999923548,7757.7354366569225,7062.466694692387
"147.32.84.165",1996,"67.19.72.206",80,3,186,3,186,0,0,85101.899535,9.024234999989858,164.8893230286747,0
"147.32.84.165",1997,"67.19.72.206",80,3,186,3,186,0,0,85101.899848,9.023950999995577,164.8945123927124,0
"147.32.84.165",1998,"67.19.72.206",80,3,186,3,186,0,0,85101.900635,9.023195000001579,164.90832792594415,0
"147.32.84.165",1999,"193.23.181.44",80,10,944,6,498,4,446,85101.900955,0.466852999990806,8533.73545865285,7642.662679837694
"147.32.84.165",2000,"193.23.181.44",179,10,786,5,486,5,300,85101.901174,0.5509759999986272,7056.5687071844995,4355.906609373148
"147.32.84.165",2001,"193.23.181.44",179,10,741,5,441,5,300,85101.90139,0.6897069999977248,5115.215591565169,3479.7384976633807
"147.32.84.165",2002,"174.37.196.55",80,3,186,3,186,0,0,85101.901608,9.022251999995206,164.92556403886644,0
"147.32.84.165",2003,"67.19.72.206",80,3,186,3,186,0,0,85101.901823,9.022068000005675,164.92892760274742,0
"147.32.84.165",2004,"174.128.246.102",80,16,2032,12,1784,4,248,85101.902037,93.29885699998704,152.97079148570901,21.264997919538025
"147.32.84.165",2005,"72.20.15.61",80,3,186,3,186,0,0,85101.902305,9.021615000005113,164.93720913596476,0
"147.32.84.165",2006,"72.20.15.61",80,3,186,3,186,0,0,85101.902521,9.021430000007967,164.94059145819298,0
"147.32.84.165",2007,"174.128.246.102",80,6,509,4,387,2,122,85101.902735,0.674354000002495,4591.060481569836,1447.311056205478
"147.32.84.165",2008,"193.23.181.44",179,10,818,5,518,5,300,85101.903003,0.6012469999986934,6892.342082387116,3991.7039087184066
"147.32.84.165",2009,"72.20.15.61",80,3,186,3,186,0,0,85101.903235,9.020745999994688,164.95309811415555,0
"147.32.84.165",2010,"174.37.196.55",80,3,186,3,186,0,0,85101.903451,9.020559999989928,164.95649937494585,0
"147.32.84.165",2011,"67.19.72.206",80,3,186,3,186,0,0,85101.903716,9.020325999998022,164.96077857943564,0
"147.32.84.165",2012,"193.23.181.44",179,10,818,5,518,5,300,85101.903934,0.6058559999946738,6839.909153390296,3961.337347523337
"147.32.84.165",2013,"193.23.181.44",179,10,802,5,502,5,300,85101.90415,0.6022430000011809,6668.404614071273,3985.102359006736
"147.32.84.165",2014,"72.20.15.61",80,3,186,3,186,0,0,85101.90438,9.019690999994054,164.97239206985924,0
"147.32.84.165",2015,"67.19.72.206",80,3,186,3,186,0,0,85101.906558,9.017542999994475,165.01168888253835,0
"147.32.84.165",2016,"174.37.196.55",80,3,186,3,186,0,0,85101.909754,9.01437900000019,165.06960712434753,0
"147.32.84.165",2017,"67.19.72.206",80,3,186,3,186,0,0,85101.960747,8.963414999991073,166.00815648962833,0
"147.32.84.165",2018,"193.23.181.44",80,10,983,6,537,4,446,85101.960931,0.7584230000065872,5664.385178142919,4704.498676818886
"147.32.84.165",2019,"193.23.181.44",80,10,946,6,500,4,446,85101.969752,0.7772029999905499,5146.660525047686,4590.821188342536
"147.32.84.165",2020,"174.37.196.55",80,3,186,3,186,0,0,85102.010153,8.914041000010911,166.92765940813808,0
"147.32.84.165",2021,"72.20.15.61",80,3,186,3,186,0,0,85102.013377,8.91084700000647,166.98749288355188,0
"147.32.84.165",2022,"72.20.15.61",80,3,186,3,186,0,0,85102.076974,8.847279000008712,168.1873036894773,0
"147.32.84.165",2023,"193.23.181.44",80,3,186,3,186,0,0,85102.080173,8.844110000005458,168.24756815542568,0
"147.32.84.165",2024,"193.23.181.44",179,3,186,3,186,0,0,85102.083355,8.840959000008297,168.30753315320246,0
"147.32.84.165",2025,"174.37.196.55",80,3,186,3,186,0,0,85102.102958,8.82377999999153,168.6352107601763,0
"147.32.84.165",2026,"174.37.196.55",80,3,186,3,186,0,0,85102.112553,8.911118999996688,166.9823958136518,0
"147.32.84.165",2027,"72.20.15.61",80,3,186,3,186,0,0,85102.115754,8.907978000002913,167.04127468652408,0
"147.32.84.165",2028,"193.23.181.44",80,3,186,3,186,0,0,85102.118952,8.904801999990013,167.1008518776351,0
"147.32.84.165",2029,"193.23.181.44",179,3,186,3,186,0,0,85102.122183,8.901595999996061,167.16103494257192,0
"147.32.84.165",2030,"193.23.181.44",179,3,186,3,186,0,0,85102.125353,8.898449000000255,167.22015263558373,0
"147.32.84.165",2031,"72.20.15.61",80,3,186,3,186,0,0,85102.128582,8.895242999991751,167.28042168172132,0
"147.32.84.165",2032,"72.20.15.61",80,3,186,3,186,0,0,85102.131806,8.892041999992216,167.34064009159005,0
"147.32.84.165",2033,"193.23.181.44",80,3,186,3,186,0,0,85102.13498,8.88889200000267,167.3999414099702,0
"147.32.84.165",2034,"193.23.181.44",179,3,186,3,186,0,0,85102.138202,8.885691999996197,167.46022707073763,0
"147.32.84.165",2035,"193.23.181.44",80,3,186,3,186,0,0,85102.14138,8.882536999997683,167.51970748901897,0
"147.32.84.165",2036,"174.128.246.102",80,3,186,3,186,0,0,85102.144552,8.8793880000012,167.57911693911777,0
"147.32.84.165",2037,"67.19.72.206",80,3,186,3,186,0,0,85102.147752,8.876212000002852,167.63907847170864,0
"147.32.84.165",2038,"193.23.181.44",179,3,186,3,186,0,0,85102.150954,8.873034000003827,167.69912072909426,0
"147.32.84.165",2039,"174.128.246.102",80,3,186,3,186,0,0,85102.154154,8.869860999999219,167.75911144494046,0
"147.32.84.165",2040,"67.19.72.206",80,3,186,3,186,0,0,85102.157354,8.866684000007808,167.81922080438298,0
"147.32.84.165",2041,"193.23.181.44",179,3,186,3,186,0,0,85102.160553,8.863507000001846,167.87937325481778,0
"147.32.84.165",2042,"193.23.181.44",80,3,186,3,186,0,0,85102.163754,8.860329000002821,167.93958779629133,0
"147.32.84.165",2043,"174.37.196.55",80,3,186,3,186,0,0,85102.166954,8.857151999996859,167.99982658088376,0
"147.32.84.165",2044,"174.37.196.55",80,3,186,3,186,0,0,85102.170152,8.853977999999188,168.06005165137483,0
"147.32.84.165",2045,"174.128.246.102",80,3,186,3,186,0,0,85102.173385,8.850768000003882,168.12100373655116,0
"147.32.84.165",2046,"67.19.72.206",80,3,186,3,186,0,0,85102.176587,8.847589000011794,168.1814107773334,0
"147.32.84.165",2047,"193.23.181.44",80,3,186,3,186,0,0,85102.179754,8.844444000002113,168.24121448444293,0
"147.32.84.165",2048,"67.19.72.206",80,3,186,3,186,0,0,85102.182958,8.84126399998786,168.30172699311356,0
"147.32.84.165",2049,"193.23.181.44",179,3,186,3,186,0,0,85102.186191,8.838053999992553,168.36285453802995,0
"147.32.84.165",2050,"174.37.196.55",80,3,186,3,186,0,0,85102.189356,8.834911999991164,168.42273018695468,0
"147.32.84.165",2051,"193.23.181.44",80,3,186,3,186,0,0,85102.192555,8.831735999992816,168.48329705521206,0
"147.32.84.165",2052,"193.23.181.44",179,3,186,3,186,0,0,85102.195754,8.83114999999816,168.49447693678738,0
"147.32.84.165",2053,"72.20.15.61",80,3,186,3,186,0,0,85102.199006,8.831067999999505,168.49604147540066,0
"147.32.84.165",2054,"193.23.181.44",80,3,186,3,186,0,0,85102.202176,8.831096999987494,168.4954881598636,0
"147.32.84.165",2055,"193.23.181.44",179,3,186,3,186,0,0,85102.205371,8.831135000000359,168.49476313066663,0
"147.32.84.165",2056,"67.19.72.206",80,3,186,3,186,0,0,85102.208603,8.831133999992744,168.49478221044123,0
"147.32.84.165",2057,"67.19.72.206",80,3,186,3,186,0,0,85102.211792,8.831110999992234,168.49522104311774,0
"147.32.84.165",2058,"193.23.181.44",80,3,186,3,186,0,0,85102.214955,8.831154999992577,168.49438153913624,0
"147.32.84.165",2059,"193.23.181.44",179,3,186,3,186,0,0,85102.218155,8.831119000009494,168.49506840507985,0
"147.32.84.165",2060,"174.37.196.55",80,3,186,3,186,0,0,85102.221353,8.831120000002556,168.4950493255181,0
"147.32.84.165",2061,"174.37.196.55",80,3,186,3,186,0,0,85102.224575,8.831130999999004,168.49483944923563,0
"147.32.84.165",2062,"174.128.246.102",80,6,544,4,422,2,122,85102.227778,0.5925480000005336,5697.428731506915,1647.123946075459
"147.32.84.165",2063,"72.20.15.61",80,3,186,3,186,0,0,85102.23098,8.82792400001199,168.55605009716658,0
"147.32.84.165",2064,"174.37.196.55",80,3,186,3,186,0,0,85102.234174,8.82792999999947,168.55593553642694,0
"147.32.84.165",2065,"72.20.15.61",80,3,186,3,186,0,0,85102.237371,8.827902999997605,168.55645106209298,0
"147.32.84.165",2066,"193.23.181.44",179,3,186,3,186,0,0,85102.240575,8.827927999998792,168.55597372341546,0
"147.32.84.165",2067,"193.23.181.44",80,3,186,3,186,0,0,85102.243753,8.82794799999101,168.55559185458674,0
"147.32.84.165",2068,"174.37.196.55",80,3,186,3,186,0,0,85102.246971,8.8279360000015,168.55582097556518,0
"147.32.84.165",2069,"193.23.181.44",80,3,186,3,186,0,0,85102.250171,8.827934999993886,168.55584006917027,0
"147.32.84.165",2070,"174.37.196.55",80,3,186,3,186,0,0,85102.253351,8.827956999986782,168.55542001419218,0
"147.32.84.165",2071,"72.20.15.61",80,3,186,3,186,0,0,85102.256553,8.827921000003698,168.55610737787262,0
"147.32.84.165",2072,"193.23.181.44",80,3,186,3,186,0,0,85102.259772,8.82790199998999,168.5564701558408,0
"147.32.84.165",2073,"193.23.181.44",80,3,186,3,186,0,0,85102.262955,8.827917999995407,168.5561646586176,0
"147.32.84.165",2074,"72.20.15.61",80,3,186,3,186,0,0,85102.266175,8.827898000003188,168.55654653004177,0
"147.32.84.165",2075,"174.37.196.55",80,3,186,3,186,0,0,85102.269354,8.827917999995407,168.5561646586176,0
"147.32.84.165",2076,"67.19.72.206",80,3,186,3,186,0,0,85102.272552,8.827921000003698,168.55610737787262,0
"147.32.84.165",2077,"174.128.246.102",80,6,536,4,414,2,122,85102.275752,0.6283089999924414,5271.291673427952,1553.3758071454354
"147.32.84.165",2078,"67.19.72.206",80,3,186,3,186,0,0,85102.279015,8.824658000012278,168.61843257811574,0
"147.32.84.165",2079,"174.37.196.55",80,3,186,3,186,0,0,85102.282171,8.82470199999807,168.61759184619783,0
"147.32.84.165",2080,"174.128.246.102",80,7,601,4,419,3,182,85102.285355,0.6341839999950025,5285.532274586578,2295.8636610376066
"147.32.84.165",2081,"72.20.15.61",80,3,186,3,186,0,0,85102.28857,8.821502999999211,168.6787387591585,0
"147.32.84.165",2082,"174.128.246.102",80,3,186,3,186,0,0,85102.291762,8.821510000008857,168.6786049098744,0
"147.32.84.165",2083,"174.37.196.55",80,3,186,3,186,0,0,85102.294958,8.821513999995659,168.6785284250223,0
"147.32.84.165",2084,"193.23.181.44",179,3,186,3,186,0,0,85102.298157,8.821515999996336,168.67849018248316,0
"147.32.84.165",2085,"174.128.246.102",80,3,186,3,186,0,0,85102.301354,8.821552000008523,168.67780181974354,0
"147.32.84.165",2086,"174.37.196.55",80,3,186,3,186,0,0,85102.304554,8.821519000004628,168.6784328185678,0
"147.32.84.165",2087,"193.23.181.44",179,3,186,3,186,0,0,85102.307754,8.821520000012242,168.6784136971786,0
"147.32.84.165",2088,"174.128.246.102",80,3,186,3,186,0,0,85102.310954,8.821519000004628,168.6784328185678,0
"147.32.84.165",2089,"67.19.72.206",80,3,186,3,186,0,0,85102.314154,8.821517999997013,168.67845193996132,0
"147.32.84.165",2090,"193.23.181.44",179,3,186,3,186,0,0,85102.317354,8.821551999993972,168.67780182002178,0
"147.32.84.165",2091,"67.19.72.206",80,3,186,3,186,0,0,85102.320554,8.821549000000232,168.6778591832297,0
"147.32.84.165",2092,"193.23.181.44",80,3,186,3,186,0,0,85102.323754,8.821550000007846,168.67784006197056,0
"147.32.84.165",2093,"174.128.246.102",80,3,186,3,186,0,0,85102.326954,8.821551000000909,168.67782094099402,0
"147.32.84.165",2094,"174.128.246.102",80,3,186,3,186,0,0,85102.330154,8.82151999999769,168.67841369745685,0
"147.32.84.165",2095,"193.23.181.44",179,3,186,3,186,0,0,85102.333354,8.821519000004628,168.6784328185678,0
"147.32.84.165",2096,"174.37.196.55",80,3,186,3,186,0,0,85102.364585,8.793487999995705,169.21612902647126,0
"147.32.84.165",2097,"193.23.181.44",80,3,186,3,186,0,0,85102.387371,8.773902000000817,169.59387054925637,0
"147.32.84.165",2098,"72.20.15.61",80,3,186,3,186,0,0,85102.412176,8.75229699999909,170.0125121439726,0
"147.32.84.165",2099,"72.20.15.61",80,3,186,3,186,0,0,85102.435371,8.732302000003983,170.4018024112452,0
"147.32.84.165",2100,"174.37.196.55",80,3,186,3,186,0,0,85102.454573,8.750299999999697,170.05131252643355,0
"147.32.84.165",2101,"174.128.246.102",80,3,186,3,186,0,0,85102.457772,8.750301000007312,170.05129309251836,0
"147.32.84.165",2102,"193.23.181.44",179,3,186,3,186,0,0,85102.460973,8.750299999999697,170.05131252643355,0
"147.32.84.165",2103,"72.20.15.61",80,3,186,3,186,0,0,85102.464198,8.750274000005447,170.051817805828,0
"147.32.84.165",2104,"72.20.15.61",80,3,186,3,186,0,0,85102.467374,8.75029799999902,170.05135139399442,0
"147.32.84.165",2106,"174.128.246.102",80,3,186,3,186,0,0,85102.470599,8.750274000005447,170.051817805828,0
"147.32.84.165",2105,"67.19.72.206",80,3,186,3,186,0,0,85102.4738,8.750272999997833,170.0518372398631,0
"147.32.84.165",2107,"67.19.72.206",80,3,186,3,186,0,0,85102.476974,8.750299999999697,170.05131252643355,0
"147.32.84.165",2108,"193.23.181.44",80,3,186,3,186,0,0,85102.480203,8.750270000004093,170.05189554142945,0
"147.32.84.165",2109,"193.23.181.44",179,3,186,3,186,0,0,85102.483387,8.750287000002572,170.05156516575542,0
"147.32.84.165",2110,"174.37.196.55",80,3,186,3,186,0,0,85102.486604,8.750268999996479,170.05191497548233,0
"147.32.84.165",2111,"174.37.196.55",80,3,186,3,186,0,0,85102.489784,8.75032099999953,170.05090441825845,0
"147.32.84.165",2112,"193.23.181.44",179,3,186,3,186,0,0,85102.493002,8.750272999997833,170.0518372398631,0
"147.32.84.165",2113,"193.23.181.44",179,3,186,3,186,0,0,85102.496155,8.750320000006468,170.050923851802,0
"147.32.84.165",2114,"72.20.15.61",80,3,186,3,186,0,0,85102.499354,8.75032099999953,170.05090441825845,0
"147.32.84.165",2115,"72.20.15.61",80,3,186,3,186,0,0,85102.502554,8.750319999991916,170.0509238520848,0
"147.32.84.165",2116,"193.23.181.44",179,3,186,3,186,0,0,85102.505754,8.75032099999953,170.05090441825845,0
"147.32.84.165",2117,"174.128.246.102",80,3,186,3,186,0,0,85102.509047,8.750259000007645,170.05210931455858,0
"147.32.84.165",2118,"174.37.196.55",80,3,186,3,186,0,0,85102.512154,8.75034900000901,170.05036027688357,0
"147.32.84.165",2119,"67.19.72.206",80,3,186,3,186,0,0,85102.515354,8.750352999995812,170.05028254296852,0
"147.32.84.165",2121,"72.20.15.61",80,3,186,3,186,0,0,85102.521754,8.750350000002072,170.05034084346886,0
"147.32.84.165",2122,"174.37.196.55",80,3,186,3,186,0,0,85102.524953,8.75032099999953,170.05090441825845,0
"147.32.84.165",2120,"67.19.72.206",80,3,186,3,186,0,0,85102.528154,8.750318999998854,170.05094328563277,0
"147.32.84.165",2123,"174.37.196.55",80,3,186,3,186,0,0,85102.531352,8.75032399999327,170.0508461173717,0
"147.32.84.165",2124,"193.23.181.44",179,3,186,3,186,0,0,85102.534554,8.750320000006468,170.050923851802,0
"147.32.84.165",2125,"193.23.181.44",80,3,186,3,186,0,0,85102.537754,8.750319999991916,170.0509238520848,0
"147.32.84.165",2126,"193.23.181.44",179,3,186,3,186,0,0,85102.540954,8.750320000006468,170.050923851802,0
"147.32.84.165",2127,"193.23.181.44",179,3,186,3,186,0,0,85102.544155,8.750318000005791,170.0509627191852,0
"147.32.84.165",2128,"193.23.181.44",80,3,186,3,186,0,0,85102.547356,8.750316000005114,170.05100158658618,0
"147.32.84.165",2129,"174.128.246.102",80,3,186,3,186,0,0,85102.550555,8.750318999998854,170.05094328563277,0
"147.32.84.165",2130,"174.37.196.55",80,3,186,3,186,0,0,85102.553753,8.750321999992593,170.05088498471937,0
"147.32.84.165",2131,"72.20.15.61",80,3,186,3,186,0,0,85102.556976,8.750298999992083,170.05133196035317,0
"147.32.84.165",2132,"193.23.181.44",179,3,186,3,186,0,0,85102.560153,8.75032099999953,170.05090441825845,0
"147.32.84.165",2133,"174.37.196.55",80,3,186,3,186,0,0,85102.563352,8.750323000000208,170.0508655509019,0
"147.32.84.165",2134,"193.23.181.44",80,3,186,3,186,0,0,85102.566555,8.750320000006468,170.050923851802,0
"147.32.84.165",2135,"193.23.181.44",179,3,186,3,186,0,0,85102.569755,8.750319999991916,170.0509238520848,0
"147.32.84.165",2136,"72.20.15.61",80,3,186,3,186,0,0,85102.572973,8.750299999999697,170.05131252643355,0
"147.32.84.165",2137,"174.37.196.55",80,3,186,3,186,0,0,85102.576155,8.750317999991239,170.050962719468,0
"147.32.84.165",2138,"174.37.196.55",80,3,186,3,186,0,0,85102.579375,8.75029799999902,170.05135139399442,0
"147.32.84.165",2140,"174.37.196.55",80,3,186,3,186,0,0,85102.582577,8.750296000012895,170.05139026129027,0
"147.32.84.165",2139,"193.23.181.44",80,3,186,3,186,0,0,85102.585802,8.750270000004093,170.05189554142945,0
"147.32.84.165",2141,"174.37.196.55",80,3,186,3,186,0,0,85102.589035,8.750238000007812,170.05251742851698,0
"147.32.84.165",2142,"174.128.246.102",80,3,186,3,186,0,0,85102.592172,8.750329999995301,170.0507295154353,0
"147.32.84.165",2143,"174.128.246.102",80,3,186,3,186,0,0,85102.595376,8.750329999995301,170.0507295154353,0
"147.32.84.165",2144,"67.19.72.206",80,3,186,3,186,0,0,85102.598558,8.750369000001228,170.0499716068878,0
"147.32.84.165",2145,"174.37.196.55",80,3,186,3,186,0,0,85102.601756,8.750369999994291,170.0499521735619,0
"147.32.84.165",2146,"67.19.72.206",80,3,186,3,186,0,0,85102.604955,8.750367999993614,170.0499910405009,0
"147.32.84.165",2147,"174.37.196.55",80,3,186,3,186,0,0,85102.608162,8.750362999999197,170.0500882077848,0
"147.32.84.165",2148,"67.19.72.206",80,3,186,3,186,0,0,85102.611373,8.750330999988364,170.0507100819362,0
"147.32.84.165",2149,"174.128.246.102",80,3,186,3,186,0,0,85102.614604,8.750308000002406,170.0511570563677,0
"147.32.84.165",2150,"174.37.196.55",80,8,729,4,487,4,242,85102.6178,0.45674499998858664,8529.923699432627,4238.688984112311
"147.32.84.165",2151,"174.128.246.102",80,3,186,3,186,0,0,85102.620974,8.747130999996443,170.11292045364416,0
"147.32.84.165",2152,"72.20.15.61",80,3,186,3,186,0,0,85102.624225,8.747076999992714,170.11397064427803,0
"147.32.84.165",2153,"174.128.246.102",80,3,186,3,186,0,0,85102.627405,8.747100999986287,170.1135038914416,0
"147.32.84.165",2154,"193.23.181.44",179,3,186,3,186,0,0,85102.630574,8.747153000003891,170.1124926018029,0
"147.32.84.165",2155,"174.128.246.102",80,3,186,3,186,0,0,85102.633774,8.747155000004568,170.11245370628768,0
"147.32.84.165",2156,"174.37.196.55",80,8,603,4,361,4,242,85102.637004,0.45641600000089966,6327.560821694041,4241.74437354559
"147.32.84.165",2157,"193.23.181.44",80,3,186,3,186,0,0,85102.658606,8.725468999997247,170.53524572724623,0
"147.32.84.165",2159,"174.37.196.55",80,7,577,4,395,3,182,85102.661774,0.4415990000125021,7155.813305534065,3297.1089154612655
"147.32.84.165",2160,"193.23.181.44",80,3,186,3,186,0,0,85102.664975,8.759831999996095,169.86627140802054,0
"147.32.84.165",2158,"72.20.15.61",80,3,186,3,186,0,0,85102.668205,8.756663000007393,169.92774530648762,0
"147.32.84.165",2161,"174.37.196.55",80,7,595,4,413,3,182,85102.671402,0.45242799998959526,7302.819454313137,3218.191623934603
"147.32.84.165",2162,"72.20.15.61",80,3,186,3,186,0,0,85102.674603,8.750287999995635,170.0515457320653,0
"147.32.84.165",2163,"67.19.72.206",80,3,186,3,186,0,0,85102.677773,8.747140999999829,170.1127259752677,0
"147.32.84.165",2164,"174.37.196.55",80,7,590,4,408,3,182,85102.68098,0.5278509999916423,6183.5631647030705,2758.3541568038204
"147.32.84.165",2165,"174.128.246.102",80,3,186,3,186,0,0,85102.684186,8.74075100000482,170.23708832332363,0
"147.32.84.165",2166,"193.23.181.44",80,3,186,3,186,0,0,85102.687404,8.73756000000867,170.29925974740357,0
"147.32.84.165",2167,"67.19.72.206",80,3,186,3,186,0,0,85102.690554,8.734433000005083,170.36022830550468,0
"147.32.84.165",2168,"67.19.72.206",80,3,186,3,186,0,0,85102.693754,8.731253999998444,170.4222554973507,0
"147.32.84.165",2169,"193.23.181.44",179,3,186,3,186,0,0,85102.696954,8.728078000000096,170.48426927440195,0
"147.32.84.165",2170,"193.23.181.44",179,3,186,3,186,0,0,85102.700154,8.724901999987196,170.54632819969595,0
"147.32.84.165",2171,"174.128.246.102",80,3,186,3,186,0,0,85102.703354,8.721724000002723,170.60847144435382,0
"147.32.84.165",2172,"193.23.181.44",80,3,186,3,186,0,0,85102.706553,8.718548000004375,170.67062084182518,0
"147.32.84.165",2173,"174.37.196.55",80,3,186,3,186,0,0,85102.709754,8.715919000009308,170.72210056087155,0
"147.32.84.165",2174,"174.128.246.102",80,3,186,3,186,0,0,85102.712954,8.715918999994756,170.7221005611566,0
"147.32.84.165",2175,"174.37.196.55",80,3,186,3,186,0,0,85102.743774,8.68829900000128,171.26482410420968,0
"147.32.84.165",2176,"72.20.15.61",80,3,186,3,186,0,0,85102.768554,8.666718000007677,171.69129075143346,0
"147.32.84.165",2177,"72.20.15.61",80,3,186,3,186,0,0,85102.771755,8.753177000005962,169.9954199485497,0
"147.32.84.165",2179,"174.128.246.102",80,3,186,3,186,0,0,85102.774978,8.750012999997125,170.05689020124757,0
"147.32.84.165",2180,"174.128.246.102",80,3,186,3,186,0,0,85102.778155,8.746862999993027,170.1181326380882,0
"147.32.84.165",2181,"72.20.15.61",80,3,186,3,186,0,0,85102.781378,8.743663999994169,170.18037289641876,0
"147.32.84.165",2178,"67.19.72.206",80,3,186,3,186,0,0,85102.784556,8.740510000003269,170.24178223003503,0
"147.32.84.165",2182,"193.23.181.44",80,3,186,3,186,0,0,85102.787758,8.737331999989692,170.30370369373117,0
"147.32.84.165",2183,"67.19.72.206",80,3,186,3,186,0,0,85102.790957,8.734157999992021,170.36559219576282,0
"147.32.84.165",2184,"67.19.72.206",80,3,186,3,186,0,0,85102.794153,8.73098600000958,170.42748665481395,0
"147.32.84.165",2185,"72.20.15.61",80,3,186,3,186,0,0,85102.797352,8.727810000011232,170.48950423967582,0
"147.32.84.165",2186,"72.20.15.61",80,3,186,3,186,0,0,85102.800555,8.724631000004592,170.55162562167004,0
"147.32.84.165",2187,"72.20.15.61",80,3,186,3,186,0,0,85102.803774,8.721436000007088,170.6141052916963,0
"147.32.84.165",2188,"174.128.246.102",80,3,186,3,186,0,0,85102.806955,8.71828000000096,170.6758672582019,0
"147.32.84.165",2189,"67.19.72.206",80,3,186,3,186,0,0,85102.81016,8.715100000001257,170.73814414060485,0
"147.32.84.165",2190,"67.19.72.206",80,3,186,3,186,0,0,85102.813376,8.711906999989878,170.80072135776115,0
"147.32.84.165",2191,"174.37.196.55",80,3,186,3,186,0,0,85102.81656,8.708746999996947,170.86269701031867,0
"147.32.84.165",2192,"174.128.246.102",80,3,186,3,186,0,0,85102.819777,8.70555400000012,170.9253655769615,0
"147.32.84.165",2193,"174.37.196.55",80,3,186,3,186,0,0,85102.822972,8.702382000003126,170.9876675144191,0
"147.32.84.165",2194,"174.128.246.102",80,3,186,3,186,0,0,85102.826159,8.699219000001904,171.04983792219443,0
"147.32.84.165",2196,"193.23.181.44",179,3,186,3,186,0,0,85102.829356,8.796768999993219,169.1530151583095,0
"147.32.84.165",2197,"174.37.196.55",80,35,2242,19,1280,16,962,85102.832572,617.5173030000005,16.582531291434908,12.462808673719048
"147.32.84.165",2195,"193.23.181.44",179,3,186,3,186,0,0,85102.835772,8.790436999988742,169.27486085184452,0
"147.32.84.165",2198,"72.20.15.61",80,3,186,3,186,0,0,85102.838969,8.787261999998009,169.33602298421707,0
"147.32.84.165",2199,"193.23.181.44",80,3,186,3,186,0,0,85102.84217,8.78408299999137,169.39730646915132,0
"147.32.84.165",2200,"174.128.246.102",80,3,186,3,186,0,0,85102.845375,8.780904999992345,169.45861502900866,0
"147.32.84.165",2201,"174.37.196.55",80,35,2244,19,1282,16,962,85102.848555,617.4983240000001,16.608951962110908,12.46319172195842
"147.32.84.165",2202,"174.37.196.55",80,35,2304,19,1342,16,962,85102.851774,617.4960960000026,17.386344738930877,12.463236690649406
"147.32.84.165",2203,"193.23.181.44",179,3,186,3,186,0,0,85102.854954,8.771393000002718,169.64238177442726,0
"147.32.84.165",2204,"67.19.72.206",80,3,186,3,186,0,0,85102.858159,8.768212000009953,169.70392595415245,0
"147.32.84.165",2205,"72.20.15.61",80,3,186,3,186,0,0,85102.861354,8.76504000001296,169.7653404887827,0
"147.32.84.165",2206,"193.23.181.44",179,3,186,3,186,0,0,85102.864554,8.761861999999383,169.82691578572053,0
"147.32.84.165",2207,"174.37.196.55",80,35,2261,19,1299,16,962,85102.867754,617.4831759999943,16.829608326041416,12.463497467014504
"147.32.84.165",2208,"174.37.196.55",80,35,2281,19,1319,16,962,85102.870953,617.4769279999891,17.088897611410324,12.463623580118828
"147.32.84.165",2209,"72.20.15.61",80,3,186,3,186,0,0,85102.874154,8.851492000001599,168.1072524270181,0
"147.32.84.165",2210,"193.23.181.44",179,3,186,3,186,0,0,85102.877382,8.84833599999547,168.16721245675592,0
"147.32.84.165",2211,"174.128.246.102",80,3,186,3,186,0,0,85102.880601,8.845138999997289,168.22799506038922,0
"147.32.84.165",2212,"193.23.181.44",80,3,186,3,186,0,0,85102.883754,8.842011000000639,168.28750835074652,0
"147.32.84.165",2213,"72.20.15.61",80,3,186,3,186,0,0,85102.886954,8.838833999994677,168.34799703228913,0
"147.32.84.165",2215,"174.37.196.55",80,3,186,3,186,0,0,85102.890154,8.835655000002589,168.40856733310252,0
"147.32.84.165",2216,"193.23.181.44",179,3,186,3,186,0,0,85102.893381,8.832450999994762,168.46965808255064,0
"147.32.84.165",2214,"67.19.72.206",80,3,186,3,186,0,0,85102.896585,8.82926800000132,168.5303923269491,0
"147.32.84.165",2217,"72.20.15.61",80,3,186,3,186,0,0,85102.899754,8.8261199999979,168.59050182870322,0
"147.32.84.165",2218,"72.20.15.61",80,3,186,3,186,0,0,85102.902954,8.822944999992615,168.65117032932264,0
"147.32.84.165",2219,"72.20.15.61",80,3,186,3,186,0,0,85102.906184,8.819737999991048,168.71249463436558,0
"147.32.84.165",2220,"174.128.246.102",80,3,186,3,186,0,0,85102.909353,8.81659000000218,168.77273412959343,0
"147.32.84.165",2221,"193.23.181.44",80,3,186,3,186,0,0,85102.912583,8.81338200000755,168.83416604417297,0
"147.32.84.165",2222,"174.128.246.102",80,3,186,3,186,0,0,85102.915753,8.810237000012421,168.89443496218118,0
"147.32.84.165",2223,"72.20.15.61",80,3,186,3,186,0,0,85102.918955,8.807058999998844,168.95537999690876,0
"147.32.84.165",2224,"174.37.196.55",80,3,186,3,186,0,0,85102.9222,8.803835999991861,169.0172329427054,0
"147.32.84.165",2225,"193.23.181.44",179,3,186,3,186,0,0,85102.925352,8.800705000001471,169.07736368844897,0
"147.32.84.165",2226,"174.37.196.55",80,3,186,3,186,0,0,85102.928552,8.797527000002447,169.13844083679268,0
"147.32.84.165",2227,"174.37.196.55",80,3,186,3,186,0,0,85102.931757,8.794345000002068,169.19963908621395,0
"147.32.84.165",2228,"67.19.72.206",80,3,186,3,186,0,0,85102.956954,8.769169999999576,169.68538641628248,0
"147.32.84.165",2229,"174.128.246.102",80,3,186,3,186,0,0,85102.975754,8.750392999994801,170.04950520518153,0
"147.32.84.165",2230,"174.128.246.102",80,3,186,3,186,0,0,85102.996175,8.729994000008446,170.44685254062722,0
"147.32.84.165",2231,"174.37.196.55",80,3,186,3,186,0,0,85103.017373,8.708817000006093,170.86132364464186,0
"147.32.84.165",2232,"193.23.181.44",80,3,186,3,186,0,0,85103.020556,8.81189299999096,168.8626949965832,0
"147.32.84.165",2233,"72.20.15.61",80,3,186,3,186,0,0,85103.023754,8.81192700000247,168.86204345537394,0
"147.32.84.165",2234,"193.23.181.44",179,3,186,3,186,0,0,85103.026982,8.811868000004324,168.86317407379116,0
"147.32.84.165",2235,"193.23.181.44",179,3,186,3,186,0,0,85103.030158,8.811923000001116,168.86212010701996,0
"147.32.84.165",2236,"72.20.15.61",80,3,186,3,186,0,0,85103.033358,8.811919999992824,168.86217759593956,0
"147.32.84.165",2237,"174.37.196.55",80,3,186,3,186,0,0,85103.036557,8.811916999999085,168.86223508461944,0
"147.32.84.165",2238,"174.37.196.55",80,3,186,3,186,0,0,85103.039754,8.811893999998574,168.86267583339526,0
"147.32.84.165",2239,"193.23.181.44",80,3,186,3,186,0,0,85103.042954,8.811930999989272,168.8619668040764,0
"147.32.84.165",2240,"193.23.181.44",80,3,186,3,186,0,0,85103.046154,8.811893999998574,168.86267583339526,0
"147.32.84.165",2241,"67.19.72.206",80,3,186,3,186,0,0,85103.049354,8.811894999991637,168.86265667049054,0
"147.32.84.165",2242,"67.19.72.206",80,3,186,3,186,0,0,85103.052554,8.811895999999251,168.8626375073113,0
"147.32.84.165",2243,"193.23.181.44",179,3,186,3,186,0,0,85103.055754,8.811895000006189,168.8626566702117,0
"147.32.84.165",2244,"193.23.181.44",179,3,186,3,186,0,0,85103.058954,8.811895000006189,168.8626566702117,0
"147.32.84.165",2245,"193.23.181.44",179,3,186,3,186,0,0,85103.062154,8.811895000006189,168.8626566702117,0
"147.32.84.165",2246,"193.23.181.44",80,3,186,3,186,0,0,85103.065354,8.811894999991637,168.86265667049054,0
"147.32.84.165",2247,"67.19.72.206",80,3,186,3,186,0,0,85103.068553,8.811894999991637,168.86265667049054,0
"147.32.84.165",2248,"72.20.15.61",80,3,186,3,186,0,0,85103.071785,8.811896000013803,168.86263750703245,0
"147.32.84.165",2249,"193.23.181.44",80,3,186,3,186,0,0,85103.074953,8.811944999994012,168.8616985241069,0
"147.32.84.165",2250,"174.37.196.55",80,3,186,3,186,0,0,85103.078181,8.81186699999671,168.86319323709216,0
"147.32.84.165",2251,"67.19.72.206",80,3,186,3,186,0,0,85103.081353,8.811929000003147,168.86200512957703,0
"147.32.84.165",2252,"67.19.72.206",80,3,186,3,186,0,0,85103.102554,8.793925999998464,169.20770086082825,0
"147.32.84.165",2253,"193.23.181.44",80,3,186,3,186,0,0,85103.105754,8.820319999998901,168.7013623088715,0
"147.32.84.165",2255,"193.23.181.44",179,3,186,3,186,0,0,85103.108955,8.817194000002928,168.76117277214337,0
"147.32.84.165",2254,"174.37.196.55",80,3,186,3,186,0,0,85103.112172,8.814007000008132,168.82219403713057,0
"147.32.84.165",2256,"193.23.181.44",179,3,186,3,186,0,0,85103.115353,8.81085300000268,168.88262691473201,0
"147.32.84.165",2257,"193.23.181.44",80,3,186,3,186,0,0,85103.118575,8.807662999999593,168.94379360337342,0
"147.32.84.165",2258,"72.20.15.61",80,3,186,3,186,0,0,85103.121777,8.8044910000026,169.00465909949372,0
"147.32.84.165",2259,"193.23.181.44",80,3,186,3,186,0,0,85103.124978,8.801319999998668,169.0655492585459,0
"147.32.84.165",2260,"193.23.181.44",80,3,186,3,186,0,0,85103.128181,8.798146000000997,169.12654097804597,0
"147.32.84.165",2261,"193.23.181.44",80,3,186,3,186,0,0,85103.131371,8.794991000002483,169.18721122052085,0
"147.32.84.165",2262,"67.19.72.206",80,3,186,3,186,0,0,85103.134555,8.793894000002183,169.20831658871833,0
"147.32.84.165",2263,"174.37.196.55",80,3,186,3,186,0,0,85103.137772,8.793879000004381,169.20860521270063,0
"147.32.84.165",2264,"174.128.246.102",80,3,186,3,186,0,0,85103.140955,8.79389300000912,169.20833583015585,0
"147.32.84.165",2265,"193.23.181.44",80,3,186,3,186,0,0,85103.144155,8.7938989999966,169.20822038103637,0
"147.32.84.165",2266,"67.19.72.206",80,3,186,3,186,0,0,85103.147355,8.793894000002183,169.20831658871833,0
"147.32.84.165",2267,"193.23.181.44",80,3,186,3,186,0,0,85103.150555,8.793892999994569,169.20833583043586,0
"147.32.84.165",2268,"67.19.72.206",80,3,186,3,186,0,0,85103.153776,8.793871999994735,169.20873990443468,0
"147.32.84.165",2269,"193.23.181.44",179,3,186,3,186,0,0,85103.156972,8.793877000003704,169.20864369599136,0
"147.32.84.165",2270,"72.20.15.61",80,3,186,3,186,0,0,85103.160176,8.793871999994735,169.20873990443468,0
"147.32.84.165",2271,"174.37.196.55",80,3,186,3,186,0,0,85103.163417,8.86360899999272,167.87744134485422,0
"147.32.84.165",2272,"67.19.72.206",80,3,186,3,186,0,0,85103.166602,8.860488000005716,167.93657414795211,0
"147.32.84.165",2273,"67.19.72.206",80,3,186,3,186,0,0,85103.169775,8.857336999994004,167.996317629216,0
"147.32.84.165",2274,"174.37.196.55",80,3,186,3,186,0,0,85103.173001,8.854135999994469,168.05705265888503,0
"147.32.84.165",2275,"67.19.72.206",80,3,186,3,186,0,0,85103.176172,8.850987999991048,168.11682492412203,0
"147.32.84.165",2276,"67.19.72.206",80,3,186,3,186,0,0,85103.179378,8.847804999997607,168.1773049926397,0
"147.32.84.165",2277,"67.19.72.206",80,3,186,3,186,0,0,85103.182603,8.844605000005686,168.23815195806296,0
"147.32.84.165",2278,"174.128.246.102",80,3,186,3,186,0,0,85103.185792,8.841438999996171,168.29839577026368,0
"147.32.84.165",2279,"193.23.181.44",179,3,186,3,186,0,0,85103.189,8.838254999995115,168.35902562223225,0
"147.32.84.165",2280,"193.23.181.44",179,3,186,3,186,0,0,85103.192204,8.835074999995413,168.41962292349217,0
"147.32.84.165",2281,"174.37.196.55",80,3,186,3,186,0,0,85103.195356,8.831944999998086,168.47931005008778,0
"147.32.84.165",2282,"174.37.196.55",80,3,186,3,186,0,0,85103.198559,8.828766000005999,168.53997489558438,0
"147.32.84.165",2283,"72.20.15.61",80,3,186,3,186,0,0,85103.201758,8.825591000000713,168.6006070301558,0
"147.32.84.165",2284,"174.128.246.102",80,3,186,3,186,0,0,85103.204956,8.822415000002366,168.6613019223876,0
"147.32.84.165",2285,"193.23.181.44",80,3,186,3,186,0,0,85103.208156,8.819238000010955,168.7220596607271,0
"147.32.84.165",2286,"193.23.181.44",179,3,186,3,186,0,0,85103.211358,8.81606300000567,168.7828228994102,0
"147.32.84.165",2287,"174.37.196.55",80,3,186,3,186,0,0,85103.214557,8.812888000000385,168.84362992017316,0
"147.32.84.165",2288,"67.19.72.206",80,3,186,3,186,0,0,85103.217758,8.809710999994422,168.9045191154332,0
"147.32.84.165",2289,"193.23.181.44",179,3,186,3,186,0,0,85103.220954,8.906344999995781,167.07190211031627,0
"147.32.84.165",2291,"174.128.246.102",80,16,1798,12,1550,4,248,85103.224154,93.08142899999802,133.21669137675426,21.31467062028068
"147.32.84.165",2290,"174.37.196.55",80,3,186,3,186,0,0,85103.227354,8.900007000003825,167.19087973743848,0
"147.32.84.165",2292,"174.128.246.102",80,3,186,3,186,0,0,85103.230554,8.8968290000048,167.25060130965733,0
"147.32.84.165",2293,"174.37.196.55",80,3,186,3,186,0,0,85103.233754,8.893653000006452,167.31032793824096,0
"147.32.84.165",2294,"174.128.246.102",80,3,186,3,186,0,0,85103.236954,8.890475999985938,167.3701160660412,0
"147.32.84.165",2295,"193.23.181.44",179,3,186,3,186,0,0,85103.240154,8.887298999994528,167.42994693898746,0
"147.32.84.165",2296,"174.128.246.102",80,3,186,3,186,0,0,85103.243354,8.884128999998211,167.48968863467647,0
"147.32.84.165",2297,"67.19.72.206",80,3,186,3,186,0,0,85103.246552,8.88095500000054,167.54954844382272,0
"147.32.84.165",2298,"193.23.181.44",80,3,186,3,186,0,0,85103.249753,8.87777800000913,167.6095076942079,0
"147.32.84.165",2299,"193.23.181.44",179,3,186,3,186,0,0,85103.252982,8.874572000000626,167.67005777854922,0
"147.32.84.165",2300,"174.128.246.102",80,6,511,4,389,2,122,85103.256201,0.3826930000068387,8131.844585462469,2550.3471450550674
"147.32.84.165",2301,"67.19.72.206",80,3,186,3,186,0,0,85103.259354,8.868223000012222,167.79009729434514,0
"147.32.84.165",2302,"72.20.15.61",80,3,186,3,186,0,0,85103.265781,8.961275000008754,166.04780011756657,0
"147.32.84.165",2304,"193.23.181.44",80,3,186,3,186,0,0,85103.26903,8.958090000000084,166.10683750665444,0
"147.32.84.165",2305,"67.19.72.206",80,3,186,3,186,0,0,85103.272186,8.954954999993788,166.16498910391311,0
"147.32.84.165",2303,"193.23.181.44",179,3,186,3,186,0,0,85103.275355,8.951809999998659,166.22336711795973,0
"147.32.84.165",2306,"174.37.196.55",80,3,186,3,186,0,0,85103.278607,8.94858199999726,166.2833284648289,0
"147.32.84.165",2307,"67.19.72.206",80,3,186,3,186,0,0,85103.281801,8.945410000000265,166.34229174514704,0
"147.32.84.165",2308,"193.23.181.44",179,3,186,3,186,0,0,85103.285006,8.942228999992949,166.40146433301734,0
"147.32.84.165",2309,"174.37.196.55",80,3,186,3,186,0,0,85103.288202,8.939056000002893,166.460530060391,0
"147.32.84.165",2310,"174.128.246.102",80,3,186,3,186,0,0,85103.291355,8.935926000005566,166.51883643609776,0
"147.32.84.165",2311,"72.20.15.61",80,3,186,3,186,0,0,85103.294575,8.932729999985895,166.57841443795454,0
"147.32.84.165",2312,"174.128.246.102",80,18,2168,14,1920,4,248,85103.297755,309.12302099999215,49.68895538841279,6.418156737669985
"147.32.84.165",2313,"193.23.181.44",80,3,186,3,186,0,0,85103.300955,8.926397000002908,166.69659662230072,0
"147.32.84.165",2314,"174.128.246.102",80,3,186,3,186,0,0,85103.304156,8.923219000003883,166.75596553209695,0
"147.32.84.165",2315,"174.37.196.55",80,3,186,3,186,0,0,85103.307356,8.92004199999792,166.81535804431715,0
"147.32.84.165",2316,"174.128.246.102",80,3,186,3,186,0,0,85103.310556,8.91686500000651,166.87479287831695,0
"147.32.84.165",2317,"193.23.181.44",179,3,186,3,186,0,0,85103.313771,8.913673999995808,166.9345322703859,0
"147.32.84.165",2318,"193.23.181.44",179,3,186,3,186,0,0,85103.316975,8.910493000003044,166.99412703646047,0
"147.32.84.165",2319,"72.20.15.61",80,3,186,3,186,0,0,85103.320156,8.907336000003852,167.05331425685037,0
"147.32.84.165",2320,"67.19.72.206",80,3,186,3,186,0,0,85103.323354,8.904162000006181,167.1128625017118,0
"147.32.84.165",2321,"67.19.72.206",80,3,186,3,186,0,0,85103.326573,8.900966000001063,167.17286640571623,0
"147.32.84.165",2322,"72.20.15.61",80,3,186,3,186,0,0,85103.329774,8.99830400000792,165.36449535364557,0
"147.32.84.165",2323,"174.128.246.102",80,3,186,3,186,0,0,85103.332976,8.995160999998916,165.42227537674748,0
"147.32.84.165",2324,"174.128.246.102",80,3,186,3,186,0,0,85103.336172,8.991987000001245,165.48066628652754,0
"147.32.84.165",2325,"193.23.181.44",80,3,186,3,186,0,0,85103.339354,8.98883200000273,165.53874852701085,0
"147.32.84.165",2326,"67.19.72.206",80,3,186,3,186,0,0,85103.342555,8.985654000003706,165.5972954221681,0
"147.32.84.165",2327,"72.20.15.61",80,3,186,3,186,0,0,85103.345755,8.982476999997743,165.65586530312004,0
"147.32.84.165",2328,"72.20.15.61",80,3,186,3,186,0,0,85103.349,8.979254999998375,165.71530711626625,0
"147.32.84.165",2329,"193.23.181.44",80,3,186,3,186,0,0,85103.352202,8.976076000006287,165.77399745712466,0
"147.32.84.165",2330,"67.19.72.206",80,3,186,3,186,0,0,85103.355397,8.972904999987804,165.8325815331849,0
"147.32.84.165",2331,"193.23.181.44",179,3,186,3,186,0,0,85103.358603,8.969721999994363,165.8914289652383,0
"147.32.84.165",2332,"174.37.196.55",80,3,186,3,186,0,0,85103.361803,8.966545999996015,165.95018862342994,0
"147.32.84.165",2333,"67.19.72.206",80,3,186,3,186,0,0,85103.364999,8.963373000005959,166.00893435975618,0
"147.32.84.165",2334,"174.128.246.102",80,3,186,3,186,0,0,85103.368207,8.960187999997288,166.06794411015153,0
"147.32.84.165",2335,"174.37.196.55",80,3,186,3,186,0,0,85103.371401,8.957018000000971,166.12671761961835,0
"147.32.84.165",2336,"193.23.181.44",80,3,186,3,186,0,0,85103.374599,8.953842999995686,166.1856255465633,0
"147.32.84.165",2337,"72.20.15.61",80,3,186,3,186,0,0,85103.377805,8.950661000009859,166.2447052791253,0
"147.32.84.165",2338,"193.23.181.44",179,3,186,3,186,0,0,85103.381,8.947489000012865,166.30364116657316,0
"147.32.84.165",2339,"174.37.196.55",80,3,186,3,186,0,0,85103.384201,8.944312000006903,166.36271185518257,0
"147.32.84.165",2340,"193.23.181.44",179,3,186,3,186,0,0,85103.387358,8.94117799999367,166.42102416494265,0
"147.32.84.165",2341,"193.23.181.44",80,3,186,3,186,0,0,85103.390558,8.93800100000226,166.48017828590798,0
"147.32.84.165",2342,"193.23.181.44",80,3,186,3,186,0,0,85103.410182,8.91840099998808,166.8460523362864,0
"147.32.84.165",2343,"72.20.15.61",80,3,186,3,186,0,0,85103.413381,9.014237999988836,165.0721891303339,0
"147.32.84.165",2344,"174.128.246.102",80,3,186,3,186,0,0,85103.416585,9.011092000000644,165.1298200040454,0
"147.32.84.165",2345,"174.128.246.102",80,3,186,3,186,0,0,85103.419754,9.007943999997224,165.18752780883835,0
"147.32.84.165",2346,"174.128.246.102",80,3,186,3,186,0,0,85103.422953,9.004767999998876,165.245789786054,0
"147.32.84.165",2347,"174.37.196.55",80,3,186,3,186,0,0,85103.426152,9.001594999994268,165.30403778452015,0
"147.32.84.165",2348,"174.128.246.102",80,3,186,3,186,0,0,85103.429381,8.998389000000316,165.36293329838796,0
"147.32.84.165",2349,"193.23.181.44",179,3,186,3,186,0,0,85103.432574,8.995218999989447,165.42120875564515,0
"147.32.84.165",2351,"174.128.246.102",80,3,186,3,186,0,0,85103.435783,8.992032000009203,165.4798381498728,0
"147.32.84.165",2352,"67.19.72.206",80,3,186,3,186,0,0,85103.439089,8.988749999989523,165.5402586568471,0
"147.32.84.165",2350,"72.20.15.61",80,3,186,3,186,0,0,85103.442181,8.985680999991018,165.59679783886023,0
"147.32.84.165",2353,"193.23.181.44",179,3,186,3,186,0,0,85103.445384,8.982500999991316,165.65542269368393,0
"147.32.84.165",2354,"193.23.181.44",80,3,186,3,186,0,0,85103.448601,8.979307000001427,165.7143474434902,0
"147.32.84.165",2355,"174.37.196.55",80,3,186,3,186,0,0,85103.451789,8.976141999999527,165.7727785500807,0
"147.32.84.165",2356,"193.23.181.44",80,3,186,3,186,0,0,85103.454967,8.972988000008627,165.8310475839898,0
"147.32.84.165",2357,"193.23.181.44",179,3,186,3,186,0,0,85103.458189,8.969789000009769,165.8901898359459,0
"147.32.84.165",2358,"67.19.72.206",80,3,186,3,186,0,0,85103.461385,8.966627000001608,165.94868951276027,0
"147.32.84.165",2359,"193.23.181.44",179,3,186,3,186,0,0,85103.46458,8.963457000005292,166.00737862625118,0
"147.32.84.165",2360,"193.23.181.44",80,3,186,3,186,0,0,85103.467754,8.960306000008131,166.0657571291259,0
"147.32.84.165",2361,"72.20.15.61",80,3,186,3,186,0,0,85103.470954,8.957129000002169,166.1246589168962,0
"147.32.84.165",2362,"67.19.72.206",80,3,186,3,186,0,0,85103.474187,8.953919999999925,166.184196419,0
"147.32.84.165",2363,"174.128.246.102",80,3,186,3,186,0,0,85103.494203,8.93392799999856,166.55607701340776,0
"147.32.84.165",2364,"174.128.246.102",80,3,186,3,186,0,0,85103.49806,9.02987500000745,164.7863342514456,0
"147.32.84.165",2365,"72.20.15.61",80,3,186,3,186,0,0,85103.500556,9.027440999998362,164.83076433291228,0
"147.32.84.165",2367,"193.23.181.44",80,3,186,3,186,0,0,85103.503756,9.024274999988847,164.8885921585766,0
"147.32.84.165",2366,"193.23.181.44",179,3,186,3,186,0,0,85103.506956,9.021099000005051,164.9466434188525,0
"147.32.84.165",2368,"67.19.72.206",80,3,186,3,186,0,0,85103.510176,9.017902999999933,165.0051015186137,0
"147.32.84.165",2369,"174.37.196.55",80,3,186,3,186,0,0,85103.513372,9.01473100000294,165.06316161841266,0
"147.32.84.165",2370,"67.19.72.206",80,3,186,3,186,0,0,85103.516602,9.011524999994435,165.1218855855051,0
"147.32.84.165",2371,"72.20.15.61",80,3,186,3,186,0,0,85103.519777,9.008373000004212,165.17966118846368,0
"147.32.84.165",2372,"174.128.246.102",80,3,186,3,186,0,0,85103.523002,9.005172000004677,165.23837634630712,0
"147.32.84.165",2373,"174.128.246.102",80,3,186,3,186,0,0,85103.526174,9.002023000008194,165.2961784255212,0
"147.32.84.165",2374,"174.128.246.102",80,3,186,3,186,0,0,85103.529356,8.998863999993773,165.35420470861985,0
"147.32.84.165",2375,"174.128.246.102",80,3,186,3,186,0,0,85103.53256,8.995683999994071,165.41265789249385,0
"147.32.84.165",2376,"193.23.181.44",80,3,186,3,186,0,0,85103.53576,8.99250700000266,165.47109721455428,0
"147.32.84.165",2377,"72.20.15.61",80,3,186,3,186,0,0,85103.538957,8.98933300000499,165.5295226018631,0
"147.32.84.165",2378,"193.23.181.44",80,3,186,3,186,0,0,85103.598717,9.029490999993868,164.79334217189103,0
"147.32.84.165",2380,"193.23.181.44",179,3,186,3,186,0,0,85103.599599,9.028671000007307,164.8083089968386,0
"147.32.84.165",2379,"174.128.246.102",80,3,186,3,186,0,0,85103.59976,9.02853199999663,164.81084632590938,0
"147.32.84.165",2381,"193.23.181.44",80,3,186,3,186,0,0,85103.599992,9.02832299999136,164.81466159345695,0
"147.32.84.165",2382,"193.23.181.44",80,3,186,3,186,0,0,85103.600103,9.028234999990673,164.81626807471642,0
"147.32.84.165",2383,"193.23.181.44",80,3,186,3,186,0,0,85103.600212,9.028149999998277,164.81781981915276,0
"147.32.84.165",2384,"174.128.246.102",80,3,186,3,186,0,0,85103.600319,9.028065999998944,164.81935333660323,0
"147.32.84.165",2385,"174.37.196.55",80,36,2307,19,1285,17,1022,85103.600426,620.7571749999915,16.56042074745272,13.171011676184188
"147.32.84.165",2386,"174.37.196.55",80,35,2253,19,1291,16,962,85103.600563,620.7579779999942,16.637724146978417,12.397746420908781
"147.32.84.165",2387,"193.23.181.44",179,3,186,3,186,0,0,85103.600671,9.02778400000534,164.82450178239972,0
"147.32.84.165",2388,"67.19.72.206",80,3,186,3,186,0,0,85103.600778,9.02770099999907,164.82601716651376,0
"147.32.84.165",2389,"174.128.246.102",80,3,186,3,186,0,0,85103.600894,9.027608000003966,164.8277151599124,0
"147.32.84.165",2390,"67.19.72.206",80,3,186,3,186,0,0,85103.601001,9.027524999997695,164.82923060311435,0
"147.32.84.165",2391,"174.128.246.102",80,3,186,3,186,0,0,85103.601107,9.027442999999039,164.83072781519178,0
"147.32.84.165",2392,"72.20.15.61",80,3,186,3,186,0,0,85103.698748,9.029885000010836,164.78615176142492,0
"147.32.84.165",2393,"193.23.181.44",80,3,186,3,186,0,0,85103.698931,9.029760999997961,164.78841466571882,0
"147.32.84.165",2394,"72.20.15.61",80,3,186,3,186,0,0,85103.699405,9.02931099999114,164.79662733972285,0
"147.32.84.165",2395,"193.23.181.44",179,3,186,3,186,0,0,85103.699755,9.02898400000413,164.8025957294109,0
"147.32.84.165",2396,"174.37.196.55",80,3,186,3,186,0,0,85103.700191,9.028571000002557,164.81013440549768,0
"147.32.84.165",2397,"174.128.246.102",80,3,186,3,186,0,0,85103.70055,9.028237000005902,164.81623156315317,0
"147.32.84.165",2398,"174.37.196.55",80,3,186,3,186,0,0,85103.700922,9.027888999989955,164.8225847705544,0
"147.32.84.165",2400,"193.23.181.44",80,3,186,3,186,0,0,85103.702498,9.026339999996708,164.85086978781464,0
"147.32.84.165",2401,"193.23.181.44",179,3,186,3,186,0,0,85103.702798,9.02606299999752,164.85592888066577,0
"147.32.84.165",2399,"67.19.72.206",80,3,186,3,186,0,0,85103.703065,9.02581900000223,164.8603855228686,0
"147.32.84.165",2402,"174.37.196.55",80,3,186,3,186,0,0,85103.703389,9.025517999994918,164.8658835981312,0
"147.32.84.165",2403,"174.37.196.55",80,3,186,3,186,0,0,85103.703687,9.025242999996408,164.87090707702743,0
"147.32.84.165",2404,"72.20.15.61",80,3,186,3,186,0,0,85103.703937,9.02503400000569,164.87472512558534,0
"147.32.84.165",2405,"67.19.72.206",80,3,186,3,186,0,0,85103.704185,9.024836000011419,164.8783423873982,0
"147.32.84.165",2406,"174.37.196.55",80,3,186,3,186,0,0,85103.704443,9.024623999997857,164.8822155915142,0
"147.32.84.165",2407,"193.23.181.44",179,3,186,3,186,0,0,85103.704694,9.024420000001555,164.8859428084845,0
"147.32.84.165",2408,"193.23.181.44",179,3,186,3,186,0,0,85103.704932,9.024233000003733,164.8893595720971,0
"147.32.84.165",2409,"174.128.246.102",80,3,186,3,186,0,0,85103.705235,9.023979000005056,164.89400075057426,0
"147.32.84.165",2410,"174.128.246.102",80,3,186,3,186,0,0,85103.705471,9.02378800000588,164.89749094272057,0
"147.32.84.165",2411,"72.20.15.61",80,3,186,3,186,0,0,85103.800005,9.029000000009546,164.80230368794184,0
"147.32.84.165",2413,"193.23.181.44",80,3,186,3,186,0,0,85103.801146,9.027920000007725,164.82201880374734,0
"147.32.84.165",2412,"67.19.72.206",80,3,186,3,186,0,0,85103.801255,9.027841000002809,164.8234611131872,0
"147.32.84.165",2414,"67.19.72.206",80,3,186,3,186,0,0,85103.801373,9.027744999999413,164.8252138269409,0
"147.32.84.165",2415,"193.23.181.44",179,3,186,3,186,0,0,85103.801513,9.027625999995507,164.82738651343558,0
"147.32.84.165",2416,"193.23.181.44",80,3,186,3,186,0,0,85103.80164,9.02752399999008,164.82924886177372,0
"147.32.84.165",2417,"174.37.196.55",80,3,186,3,186,0,0,85103.801798,9.027388000002247,164.83173205800279,0
"147.32.84.165",2418,"193.23.181.44",179,3,186,3,186,0,0,85103.801919,9.02728899999056,164.8335397262186,0
"147.32.84.165",2419,"193.23.181.44",179,3,186,3,186,0,0,85103.802051,9.027177999989362,164.835566552665,0
"147.32.84.165",2420,"67.19.72.206",80,3,186,3,186,0,0,85103.802181,9.027068999988842,164.8375569082101,0
"147.32.84.165",2421,"174.128.246.102",80,3,186,3,186,0,0,85103.802309,9.026962999996613,164.83949252927684,0
"147.32.84.165",2422,"174.37.196.55",80,3,186,3,186,0,0,85103.802427,9.026868999993894,164.8412090616366,0
"147.32.84.165",2423,"174.37.196.55",80,3,186,3,186,0,0,85103.802548,9.026769999996759,164.8430169374576,0
"147.32.84.165",2424,"72.20.15.61",80,3,186,3,186,0,0,85103.802686,9.026656000001822,164.84509878294904,0
"147.32.84.165",2425,"193.23.181.44",179,3,186,3,186,0,0,85103.802815,9.026547000001301,164.84708936870163,0
"147.32.84.165",2426,"193.23.181.44",179,3,186,3,186,0,0,85103.802942,9.026442000002135,164.84900695087256,0
"147.32.84.165",2427,"193.23.181.44",80,3,186,3,186,0,0,85103.803062,9.026344999991124,164.85077847140377,0
"147.32.84.165",2428,"174.128.246.102",80,3,186,3,186,0,0,85103.80321,9.02621999999974,164.85306141441745,0
"147.32.84.165",2429,"193.23.181.44",80,3,186,3,186,0,0,85103.803331,9.026121000002604,164.8548695502277,0
"147.32.84.165",2430,"67.19.72.206",80,3,186,3,186,0,0,85103.901523,9.027645000009215,164.8270396098297,0
"147.32.84.165",2431,"67.19.72.206",80,3,186,3,186,0,0,85103.901938,9.027385000008508,164.8317868351242,0
"147.32.84.165",2432,"67.19.72.206",80,3,186,3,186,0,0,85103.902518,9.026868000000832,164.84122732268412,0
"147.32.84.165",2433,"174.128.246.102",80,3,186,3,186,0,0,85103.902741,9.026708999997936,164.8441309009009,0
"147.32.84.165",2434,"72.20.15.61",80,9,720,5,478,4,242,85103.902959,3.3771490000071935,1132.316045277201,573.2646086968257
"147.32.84.165",2435,"67.19.72.206",80,3,186,3,186,0,0,85103.903175,9.026333999994677,164.85097936780065,0
"147.32.84.165",2436,"174.37.196.55",80,3,186,3,186,0,0,85103.903392,9.026178000000073,164.8538284975089,0
"147.32.84.165",2437,"174.128.246.102",80,3,186,3,186,0,0,85103.903672,9.025957999998354,164.8578466684945,0
"147.32.84.165",2438,"193.23.181.44",80,3,186,3,186,0,0,85103.903895,9.025789999999688,164.86091522183116,0
"147.32.84.165",2439,"193.23.181.44",179,3,186,3,186,0,0,85103.904113,9.025638000006438,164.86369163032447,0
"147.32.84.165",2440,"193.23.181.44",179,3,186,3,186,0,0,85103.90433,9.025481999997282,164.86654119973295,0
"147.32.84.165",2441,"193.23.181.44",179,3,186,3,186,0,0,85103.904545,9.025326000002678,164.86939086738346,0
"147.32.84.165",2442,"193.23.181.44",179,3,186,3,186,0,0,85103.90476,9.025169999993523,164.87224063381277,0
"147.32.84.165",2443,"67.19.72.206",80,3,186,3,186,0,0,85103.90503,9.024960000009742,164.87607701290574,0
"147.32.84.165",2444,"193.23.181.44",80,3,186,3,186,0,0,85103.905273,9.024772000004305,164.87951163744526,0
"147.32.84.165",2445,"174.128.246.102",80,3,186,3,186,0,0,85103.905487,9.024619999996503,164.88228867260634,0
"147.32.84.165",2446,"193.23.181.44",80,3,186,3,186,0,0,85103.905706,9.02445599999919,164.88528505209993,0
"147.32.84.165",2447,"174.37.196.55",80,3,186,3,186,0,0,85103.905919,9.024304000005941,164.88806228148127,0
"147.32.84.165",2448,"193.23.181.44",80,3,186,3,186,0,0,85103.906133,9.024151000005077,164.89085787673133,0
"147.32.84.165",2449,"67.19.72.206",80,3,186,3,186,0,0,85103.906355,9.023988000000827,164.89383629497996,0
"147.32.84.165",2450,"193.23.181.44",80,3,186,3,186,0,0,85104.002205,9.027163000006112,164.83584045164494,0
"147.32.84.165",2451,"72.20.15.61",80,7,597,4,415,3,182,85104.002361,0.36571999998704996,9077.983156834629,3981.1877940816926
"147.32.84.165",2452,"174.37.196.55",80,3,186,3,186,0,0,85104.002787,9.026702999995905,164.84424047192812,0
"147.32.84.165",2453,"174.37.196.55",80,3,186,3,186,0,0,85104.002897,9.026641999997082,164.84535445190815,0
"147.32.84.165",2454,"72.20.15.61",80,3,186,3,186,0,0,85104.003028,9.026554999989457,164.846943269247,0
"147.32.84.165",2455,"193.23.181.44",179,3,186,3,186,0,0,85104.003139,9.02649200000451,164.84809381089096,0
"147.32.84.165",2456,"67.19.72.206",80,3,186,3,186,0,0,85104.003245,9.026433999999426,164.84915305425093,0
"147.32.84.165",2457,"174.37.196.55",80,3,186,3,186,0,0,85104.003351,9.026374999986729,164.85023057453162,0
"147.32.84.165",2458,"72.20.15.61",80,3,186,3,186,0,0,85104.003457,9.02631200000178,164.85138116206335,0
"147.32.84.165",2459,"67.19.72.206",80,3,186,3,186,0,0,85104.003565,9.026253999996698,164.85244044767015,0
"147.32.84.165",2460,"174.37.196.55",80,3,186,3,186,0,0,85104.00368,9.026185000009718,164.8537006496541,0
"147.32.84.165",2461,"193.23.181.44",80,3,186,3,186,0,0,85104.00379,9.026123999996344,164.85481475776345,0
"147.32.84.165",2462,"174.37.196.55",80,3,186,3,186,0,0,85104.003896,9.026064999998198,164.85589235179418,0
"147.32.84.165",2463,"174.128.246.102",80,3,186,3,186,0,0,85104.00406,9.025957999998354,164.8578466684945,0
"147.32.84.165",2464,"72.20.15.61",80,3,186,3,186,0,0,85104.004167,9.025900999986334,164.8588877722294,0
"147.32.84.165",2465,"174.37.196.55",80,3,186,3,186,0,0,85104.004273,9.025842999995803,164.85994715404334,0
"147.32.84.165",2466,"67.19.72.206",80,3,186,3,186,0,0,85104.004379,9.025779999996303,164.8610978774809,0
"147.32.84.165",2467,"174.37.196.55",80,3,186,3,186,0,0,85104.004488,9.02571899999748,164.86221208531038,0
"147.32.84.165",2468,"174.128.246.102",80,3,186,3,186,0,0,85104.004594,9.025659999999334,164.8632897760507,0
"147.32.84.165",2469,"67.19.72.206",80,3,186,3,186,0,0,85104.0047,9.025596999999834,164.86444054615194,0
"147.32.84.165",2470,"174.128.246.102",80,3,186,3,186,0,0,85104.102358,9.027986999994027,164.8207955993938,0
"147.32.84.165",2471,"72.20.15.61",80,3,186,3,186,0,0,85104.102672,9.027792000008048,164.8243557227142,0
"147.32.84.165",2472,"193.23.181.44",80,3,186,3,186,0,0,85104.103014,9.027499000003445,164.82970532585296,0
"147.32.84.165",2473,"193.23.181.44",179,3,186,3,186,0,0,85104.103234,9.027321000001393,164.8329554249561,0
"147.32.84.165",2474,"174.37.196.55",80,3,186,3,186,0,0,85104.103454,9.027147000000696,164.8361326119853,0
"147.32.84.165",2475,"193.23.181.44",179,3,186,3,186,0,0,85104.103671,9.026975000000675,164.83927339999155,0
"147.32.84.165",2476,"67.19.72.206",80,3,186,3,186,0,0,85104.103887,9.026805999994394,164.84235952350411,0
"147.32.84.165",2477,"174.128.246.102",80,3,186,3,186,0,0,85104.18698,8.943755000000237,166.37307260764192,0
"147.32.84.165",2478,"67.19.72.206",80,3,186,3,186,0,0,85104.201652,9.028283999999985,164.81537355271527,0
"147.32.84.165",2479,"67.19.72.206",80,3,186,3,186,0,0,85104.703349,9.029138999991119,164.79976662242808,0
"147.32.84.165",2480,"193.23.181.44",80,3,186,3,186,0,0,85104.703476,9.02907299999788,164.80097126253708,0
"147.32.84.165",2481,"174.128.246.102",80,3,186,3,186,0,0,85105.230117,8.902946999995038,167.13566867250017,0
"147.32.84.165",2482,"174.37.196.55",80,3,186,3,186,0,0,85105.233289,8.899873000002117,167.19339702933357,0
"147.32.84.165",2483,"193.23.181.44",179,3,186,3,186,0,0,85105.297307,8.936101999992388,166.51555678317766,0
"147.32.84.165",2484,"67.19.72.206",80,3,186,3,186,0,0,85105.300514,8.933015000002342,166.57309989959828,0
"147.32.84.165",2485,"193.23.181.44",179,3,186,3,186,0,0,85105.361339,8.97237600000517,165.84235881322212,0
"147.32.84.165",2486,"174.128.246.102",80,3,186,3,186,0,0,85105.707804,9.027293999999529,164.8334484287404,0
"147.32.84.165",2487,"193.23.181.44",179,3,186,3,186,0,0,85106.007956,9.028365999998641,164.8138766195593,0
"147.32.84.165",2488,"184.82.155.107",80,10,1912,5,981,5,931,85106.022538,0.322041999999783,24369.49217805531,23127.41816286391
"147.32.84.165",2489,"77.120.37.254",6667,2,124,2,124,0,0,85106.181766,2.9352600000129314,337.9598400126836,0
"147.32.84.165",2490,"174.128.246.102",80,3,186,3,186,0,0,85106.208037,9.028575999996974,164.81004313421062,0
"147.32.84.165",2491,"174.37.196.55",80,3,186,3,186,0,0,85106.208163,9.02847199999087,164.81194160002985,0
"147.32.84.165",2492,"193.23.181.44",179,3,186,3,186,0,0,85106.309407,9.028063000005204,164.81940810549753,0
"147.32.84.165",2493,"193.23.181.44",80,3,186,3,186,0,0,85106.710553,9.027608000003966,164.8277151599124,0
"147.32.84.165",2494,"193.23.181.44",179,3,186,3,186,0,0,85106.710762,9.027421999999206,164.83111125193116,0
"147.32.84.165",2495,"174.128.246.102",80,3,186,3,186,0,0,85106.710908,9.027299000008497,164.83335713136336,0
"147.32.84.165",2496,"72.20.15.61",80,3,186,3,186,0,0,85106.711025,9.027205000005779,164.83507353594467,0
"147.32.84.165",2497,"193.23.181.44",80,3,186,3,186,0,0,85106.71117,9.027084000001196,164.8372830029944,0
"147.32.84.165",2498,"174.128.246.102",80,3,186,3,186,0,0,85107.096255,8.942500000004657,166.39642158224493,0
"147.32.84.165",2499,"193.23.181.44",179,12,900,7,600,5,300,85111.201674,9.035673999998835,531.2276649202504,265.6138324601252
"147.32.84.165",2500,"193.23.181.44",179,12,880,7,580,5,300,85111.726568,9.223159000001033,503.08142795754475,260.2145317021783
"147.32.84.165",2501,"193.23.181.44",80,10,980,7,596,3,384,85111.726688,9.152790000007371,520.9340539874902,335.6353636429467
"147.32.84.165",2502,"67.19.72.206",80,3,186,3,186,0,0,85111.726826,9.027335999999195,164.83268153529818,0
"147.32.84.165",2503,"67.19.72.206",80,3,186,3,186,0,0,85111.816479,8.937722999995458,166.4853565053153,0
"147.32.84.165",2504,"193.23.181.44",179,12,932,7,632,5,300,85111.819681,9.146979000011925,552.7508043905434,262.3817109448782
"147.32.84.165",2505,"67.19.72.206",80,3,186,3,186,0,0,85111.822877,8.931406999996398,166.60308952448366,0
"147.32.84.165",2506,"174.128.246.102",80,3,186,3,186,0,0,85111.826048,8.92827699999907,166.66149582950382,0
"147.32.84.165",2507,"193.23.181.44",179,12,917,7,617,5,300,85111.82925,9.12471300001198,540.9485207911218,263.0219712112424
"147.32.84.165",2508,"174.128.246.102",80,18,2168,14,1920,4,248,85112.127781,309.122835999995,49.68898512564193,6.418160578728749
"147.32.84.165",2509,"193.23.181.44",80,10,951,7,565,3,386,85112.227799,9.169888999997056,492.9176350991218,336.75434893497527
"147.32.84.165",2510,"174.37.196.55",80,3,186,3,186,0,0,85112.227915,9.02792400000908,164.82194577607248,0
"147.32.84.165",2511,"174.37.196.55",80,3,186,3,186,0,0,85112.388753,8.967097999993712,165.93997299918473,0
"147.32.84.165",2512,"72.20.15.61",80,3,186,3,186,0,0,85112.72959,9.028378999995766,164.81363930343397,0
"147.32.84.165",2513,"174.37.196.55",80,3,186,3,186,0,0,85112.750843,9.007259999998496,165.2000719419944,0
"147.32.84.165",2514,"72.20.15.61",80,3,186,3,186,0,0,85112.751103,9.007048999992548,165.20394193494795,0
"147.32.84.165",2515,"67.19.72.206",80,3,186,3,186,0,0,85113.230309,9.028366999991704,164.81385836457105,0
"147.32.84.165",2516,"174.37.196.55",80,3,186,3,186,0,0,85115.83871,9.0291189999989,164.80013166292096,0
"147.32.84.165",2517,"178.122.89.175",6667,2,124,2,124,0,0,85116.183327,2.965763000000152,334.4839085253775,0
"147.32.84.165",2518,"184.82.148.43",80,10,1891,5,951,5,940,85116.658532,0.34090300000389107,22317.198733695986,22059.060788300972
"147.32.84.165",2520,"184.82.148.44",80,10,1514,5,596,5,918,85117.10856,0.30705300001136493,15528.263849640038,23917.694989881802
"147.32.84.165",2521,"217.163.21.36",80,14,6141,7,810,7,5331,85117.351994,0.18833400000585243,34406.957850407445,226448.75592657048
"147.32.84.165",2522,"31.192.109.161",80,10,1174,5,540,5,634,85117.480104,0.24284500000067055,17789.124750306044,20885.750169803763
"147.32.84.165",2523,"217.163.21.36",80,10,1451,5,701,5,750,85117.523676,0.14854700000432786,37752.361204444474,40391.25663813603
"147.32.84.165",2524,"217.163.21.35",80,9,3075,5,1495,4,1580,85117.628522,0.2323469999973895,51474.733911496056,54401.39102352092
"147.32.84.165",2525,"217.163.21.36",80,10,2277,5,1156,5,1121,85117.81882,0.13945899999816902,66313.39676981348,64305.638217094216
"147.32.84.165",2526,"195.113.232.96",80,20,6376,12,3099,8,3277,85117.827482,79.13953300000867,313.2694755729388,331.2630111173025
"147.32.84.165",2527,"195.113.232.89",80,13,4207,8,1665,5,2542,85117.835044,70.94665600000008,187.74669238815125,286.63789312353185
"147.32.84.165",2528,"217.163.21.35",80,13,4570,7,2064,6,2506,85117.912897,0.21131400000012945,78139.64053489066,94873.03254866085
"147.32.84.165",2529,"92.240.244.181",80,10,1766,6,1316,4,450,85118.066044,5.380583999998635,1956.6649270790442,669.0723534844756
"147.32.84.165",2530,"173.241.240.4",80,9,2195,5,1165,4,1030,85118.06645,0.07718200000817887,120753.54355953942,106760.64366208206
"147.32.84.165",2531,"72.20.15.61",80,3,186,3,186,0,0,85120.052183,9.029475999996066,164.79361593083013,0
"147.32.84.165",2532,"174.128.246.102",80,9,672,6,488,3,184,85120.052433,6.724938999992446,580.5257118323876,218.88674380565436
"147.32.84.165",2533,"67.19.72.206",80,3,186,3,186,0,0,85120.113648,8.968131999994512,165.9208405943301,0
"147.32.84.165",2534,"72.20.15.61",80,3,186,3,186,0,0,85120.15275,9.029399999999441,164.7950029902421,0
"147.32.84.165",2535,"174.37.196.55",80,3,186,3,186,0,0,85120.817364,8.966675999996369,165.9477826566503,0
"147.32.84.165",2536,"174.37.196.55",80,3,186,3,186,0,0,85120.819308,8.964780999987852,165.98286115433456,0
"147.32.84.165",2537,"67.19.72.206",80,3,186,3,186,0,0,85120.821722,8.962410000007367,166.026771816819,0
"147.32.84.165",2538,"72.20.15.61",80,3,186,3,186,0,0,85120.826629,8.957550999999512,166.11683260302743,0
"147.32.84.165",2539,"193.23.181.44",179,10,728,5,428,5,300,85121.315114,0.19164600000658538,17866.274275916763,12523.089445736048
"147.32.84.165",2540,"193.23.181.44",179,10,800,5,500,5,300,85121.327208,0.21066899999277666,18987.131472296114,11392.27888337767
"147.32.84.165",2541,"193.23.181.44",179,10,776,5,476,5,300,85121.379271,0.1941860000079032,19610.064576462864,12359.284396930376
"147.32.84.165",2542,"174.37.196.55",80,3,186,3,186,0,0,85121.398002,8.98755199999141,165.56232442398354,0
"147.32.84.165",2543,"67.19.72.206",80,3,186,3,186,0,0,85121.446018,8.939558999991277,166.45116386629942,0
"147.32.84.165",2544,"174.128.246.102",80,3,186,3,186,0,0,85121.657114,9.029263000003994,164.79750340635132,0
"147.32.84.165",2545,"174.128.246.102",80,3,186,3,186,0,0,85121.857329,9.029985000001034,164.78432688424508,0
"147.32.84.165",2547,"72.20.15.61",80,8,654,5,472,3,182,85122.963788,3.626733000011882,1041.1574273561437,401.4632452941063
"147.32.84.165",2546,"67.19.72.206",80,3,186,3,186,0,0,85122.964104,9.027021000001696,164.8384334100608,0
"147.32.84.165",2548,"72.20.15.61",80,3,186,3,186,0,0,85122.965057,9.02619400000549,164.85353627443584,0
"147.32.84.165",2549,"72.20.15.61",80,9,732,5,490,4,242,85122.965501,3.6615529999980936,1070.5839844465015,528.7373964001089
"147.32.84.165",2550,"193.23.181.44",179,10,812,5,512,5,300,85122.965724,0.42619700000796,9610.579145145319,5631.198717858586
"147.32.84.165",2551,"174.128.246.102",80,3,186,3,186,0,0,85122.965942,9.02535799999896,164.86880631218966,0
"147.32.84.165",2552,"193.23.181.44",179,10,800,5,500,5,300,85122.966163,0.5313000000023749,7528.703180843441,4517.221908506065
"147.32.84.165",2553,"193.23.181.44",179,10,781,5,481,5,300,85122.96638,0.538644000000204,7143.864964612143,4455.633034061628
"147.32.84.165",2554,"67.19.72.206",80,3,186,3,186,0,0,85122.966596,9.02474799999618,164.8799501105881,0
"147.32.84.165",2555,"174.37.196.55",80,3,186,3,186,0,0,85122.966864,9.024533999996493,164.88385993122506,0
"147.32.84.165",2556,"174.128.246.102",80,3,186,3,186,0,0,85122.967082,9.024361999996472,164.88700253830484,0
"147.32.84.165",2557,"72.20.15.61",80,3,186,3,186,0,0,85122.967296,9.024195999998483,164.89003563311903,0
"147.32.84.165",2558,"72.20.15.61",80,3,186,3,186,0,0,85122.967527,9.0240119999944,164.89339774824361,0
"147.32.84.165",2559,"193.23.181.44",179,10,749,5,449,5,300,85122.967746,0.5477060000121128,6558.263009571853,4381.912923990102
"147.32.84.165",2560,"193.23.181.44",179,10,772,5,472,5,300,85122.96796,0.5441720000089845,6938.982527468625,4410.37025050972
"147.32.84.165",2561,"193.23.181.44",179,10,785,5,485,5,300,85122.968233,0.5503409999946598,7050.174346519066,4360.932585475711
"147.32.84.165",2562,"174.128.246.102",80,3,186,3,186,0,0,85122.968451,9.023131000009016,164.9094976010559,0
"147.32.84.165",2563,"193.23.181.44",179,11,805,5,445,6,360,85122.968698,0.5318180000031134,6694.01938253154,5415.386466767089
"147.32.84.165",2564,"193.23.181.44",179,10,781,5,481,5,300,85122.968917,0.6410609999875305,6002.548899519466,3743.793492423784
"147.32.84.165",2565,"193.23.181.44",80,10,1030,6,584,4,446,85122.969202,0.5606090000073891,8333.79414161817,6364.507169797438
"147.32.84.165",2567,"67.19.72.206",80,3,186,3,186,0,0,85122.969444,9.022184000001289,164.9268070790606,0
"147.32.84.165",2568,"174.37.196.55",80,3,186,3,186,0,0,85122.969664,9.022010000000591,164.9299878851722,0
"147.32.84.165",2569,"67.19.72.206",80,3,186,3,186,0,0,85122.969879,9.021844000002602,164.93302256163716,0
"147.32.84.165",2566,"67.19.72.206",80,3,186,3,186,0,0,85122.970089,9.021680999998352,164.936002503333,0
"147.32.84.165",2571,"67.19.72.206",80,3,186,3,186,0,0,85122.970309,9.0215029999963,164.9392567957479,0
"147.32.84.165",2570,"193.23.181.44",80,10,983,6,537,4,446,85122.97052,0.5657050000008894,7594.06404396858,6307.17423391059
"147.32.84.165",2572,"193.23.181.44",179,3,186,3,186,0,0,85123.027581,8.96427899999253,165.9921562014346,0
"147.32.84.165",2573,"174.37.196.55",80,3,186,3,186,0,0,85123.030285,8.961622000002535,166.04137063575982,0
"147.32.84.165",2574,"174.128.246.102",80,3,186,3,186,0,0,85123.030408,8.961540999996942,166.04287142138924,0
"147.32.84.165",2575,"193.23.181.44",179,3,186,3,186,0,0,85123.051389,8.94061099999817,166.43157833399803,0
"147.32.84.165",2576,"193.23.181.44",179,3,186,3,186,0,0,85123.12902,8.863029000000097,167.8884273085402,0
"147.32.84.165",2577,"193.23.181.44",179,3,186,3,186,0,0,85123.132211,8.859885999991093,167.94798488394727,0
"147.32.84.165",2578,"174.37.196.55",80,3,186,3,186,0,0,85123.135409,8.856735000008484,168.00773648512398,0
"147.32.84.165",2579,"72.20.15.61",80,3,186,3,186,0,0,85123.138642,8.8535489999922,168.06819502566836,0
"147.32.84.165",2580,"193.23.181.44",80,3,186,3,186,0,0,85123.160207,8.832031000012648,168.4776695188082,0
"147.32.84.165",2581,"193.23.181.44",80,3,186,3,186,0,0,85123.18181,8.810475000005681,168.88987256635318,0
"147.32.84.165",2582,"174.37.196.55",80,3,186,3,186,0,0,85123.20661,8.88506500000949,167.4720443799129,0
"147.32.84.165",2583,"174.37.196.55",80,3,186,3,186,0,0,85123.209806,8.881928000002517,167.53119367772157,0
"147.32.84.165",2584,"193.23.181.44",80,3,186,3,186,0,0,85123.212993,8.878762000007555,167.59093215909311,0
"147.32.84.165",2586,"72.20.15.61",80,3,186,3,186,0,0,85123.216193,8.875585999994655,167.65090214898441,0
"147.32.84.165",2585,"67.19.72.206",80,3,186,3,186,0,0,85123.219393,8.872408999988693,167.71093397541708,0
"147.32.84.165",2587,"193.23.181.44",179,3,186,3,186,0,0,85123.222591,8.869237999999314,167.7708953125528,0
"147.32.84.165",2588,"193.23.181.44",80,3,186,3,186,0,0,85123.225795,8.866056999991997,167.83108883704935,0
"147.32.84.165",2589,"193.23.181.44",80,3,186,3,186,0,0,85123.22899,8.862882999994326,167.8911929674523,0
"147.32.84.165",2590,"193.23.181.44",80,3,186,3,186,0,0,85123.232189,8.859706000002916,167.95139703275822,0
"147.32.84.165",2591,"72.20.15.61",80,3,186,3,186,0,0,85123.235389,8.856529000011506,168.0116442906772,0
"147.32.84.165",2592,"174.128.246.102",80,3,186,3,186,0,0,85123.238589,8.853350000004866,168.071972755983,0
"147.32.84.165",2596,"174.128.246.102",80,3,186,3,186,0,0,85123.241789,8.850177000000258,168.13223057572256,0
"147.32.84.165",2597,"193.23.181.44",80,3,186,3,186,0,0,85123.245041,8.846950999999535,168.1935392204702,0
"147.32.84.165",2599,"174.37.196.55",80,3,186,3,186,0,0,85123.248221,8.843790999992052,168.25363693028672,0
"147.32.84.165",2601,"174.128.246.102",80,3,186,3,186,0,0,85123.251417,8.840615999986767,168.31406318317946,0
"147.32.84.165",2603,"72.20.15.61",80,3,186,3,186,0,0,85123.254615,8.837438999995356,168.3745709589375,0
"147.32.84.165",2604,"72.20.15.61",80,3,186,3,186,0,0,85123.257841,8.834235999995144,168.43561797543308,0
"147.32.84.165",2605,"72.20.15.61",80,3,186,3,186,0,0,85123.261016,8.831085999991046,168.49569803776214,0
"147.32.84.165",2607,"193.23.181.44",179,3,186,3,186,0,0,85123.264189,8.827938000002177,168.5557827886459,0
"147.32.84.165",2610,"174.128.246.102",80,3,186,3,186,0,0,85123.267389,8.824758999995538,168.61650272837505,0
"147.32.84.165",2612,"174.128.246.102",80,6,611,4,489,2,122,85123.270589,0.5720909999945434,6838.072963981802,1706.0222936723512
"147.32.84.165",2613,"174.128.246.102",80,3,186,3,186,0,0,85123.273789,8.818381999997655,168.73843750479347,0
"147.32.84.165",2614,"72.20.15.61",80,3,186,3,186,0,0,85123.276989,8.815205999999307,168.79923169125226,0
"147.32.84.165",2616,"72.20.15.61",80,3,186,3,186,0,0,85123.280189,8.812029000007897,168.86008886247043,0
"147.32.84.165",2617,"193.23.181.44",80,3,186,3,186,0,0,85123.283389,8.808854000002611,168.92095157889537,0
"147.32.84.165",2618,"174.128.246.102",80,3,186,3,186,0,0,85123.286589,8.805677000011201,168.98189656492139,0
"147.32.84.165",2619,"193.23.181.44",80,3,186,3,186,0,0,85123.28982,8.802477999997791,169.043308032167,0
"147.32.84.165",2623,"193.23.181.44",179,3,186,3,186,0,0,85123.293041,8.801837999999407,169.05559952365635,0
"147.32.84.165",2628,"193.23.181.44",179,3,186,3,186,0,0,85123.296233,8.801846000002115,169.05544586892822,0
"147.32.84.165",2629,"193.23.181.44",179,3,186,3,186,0,0,85123.299414,8.801865000001271,169.05508094020814,0
"147.32.84.165",2627,"67.19.72.206",80,3,186,3,186,0,0,85123.302611,8.801867999995011,169.0550233201456,0
"147.32.84.165",2626,"174.128.246.102",80,6,516,4,394,2,122,85123.30581,0.6113509999995586,5155.794298205574,1596.4642243174621
"147.32.84.165",2625,"72.20.15.61",80,3,186,3,186,0,0,85123.309081,8.798597000000882,169.11787186068995,0
"147.32.84.165",2624,"72.20.15.61",80,3,186,3,186,0,0,85123.312246,8.798632999998517,169.1171799074073,0
"147.32.84.165",2622,"72.20.15.61",80,3,186,3,186,0,0,85123.315436,8.798643000001903,169.1169876990893,0
"147.32.84.165",2621,"174.128.246.102",80,8,665,6,543,2,122,85123.318611,9.153717000008328,474.5613175495865,106.62335311427172
"147.32.84.165",2620,"174.37.196.55",80,3,186,3,186,0,0,85123.321838,8.798645999995642,169.11693003681896,0
"147.32.84.165",2615,"174.37.196.55",80,3,186,3,186,0,0,85123.325065,8.798623000009684,169.1173721158825,0
"147.32.84.165",2611,"174.128.246.102",80,3,186,3,186,0,0,85123.328247,8.798651000004611,169.1168339327495,0
"147.32.84.165",2609,"193.23.181.44",80,3,186,3,186,0,0,85123.334649,8.795452000005753,169.17834353470712,0
"147.32.84.165",2608,"174.128.246.102",80,3,186,3,186,0,0,85123.337833,8.79548899999645,169.1776318520324,0
"147.32.84.165",2606,"174.37.196.55",80,3,186,3,186,0,0,85123.341045,8.79549400000542,169.1775356789605,0
"147.32.84.165",2602,"174.37.196.55",80,3,186,3,186,0,0,85123.344207,8.795507999995607,169.17726639561275,0
"147.32.84.165",2600,"193.23.181.44",179,3,186,3,186,0,0,85123.34744,8.79550000000745,169.17742027158656,0
"147.32.84.165",2598,"174.128.246.102",80,10,1017,7,833,3,184,85123.350591,9.303343999999925,716.3015793031037,158.2226777812378
"147.32.84.165",2595,"193.23.181.44",179,3,186,3,186,0,0,85123.353812,8.792285000003176,169.23928193859305,0
"147.32.84.165",2594,"193.23.181.44",80,3,186,3,186,0,0,85123.356991,8.792330000011134,169.23841575533626,0
"147.32.84.165",2593,"193.23.181.44",80,3,186,3,186,0,0,85123.360206,8.792318000007072,169.2386467367085,0
"147.32.84.165",2631,"67.19.72.206",80,3,186,3,186,0,0,85123.36339,8.792339000006905,169.23824251986093,0
"147.32.84.165",2632,"174.37.196.55",80,3,186,3,186,0,0,85123.366591,8.792333999997936,169.23833876196574,0
"147.32.84.165",2633,"193.23.181.44",80,3,186,3,186,0,0,85123.369812,8.79232399999455,169.23853124622366,0
"147.32.84.165",2634,"174.37.196.55",80,3,186,3,186,0,0,85123.373038,8.792287999996915,169.23922419289747,0
"147.32.84.165",2635,"72.20.15.61",80,3,186,3,186,0,0,85123.376194,8.792322000008426,169.2385697428477,0
"147.32.84.165",2636,"174.128.246.102",80,3,186,3,186,0,0,85123.379391,8.792341000007582,169.23820402310565,0
"147.32.84.165",2637,"67.19.72.206",80,3,186,3,186,0,0,85123.382611,8.792318000007072,169.2386467367085,0
"147.32.84.165",2638,"193.23.181.44",80,3,186,3,186,0,0,85123.385808,8.79227499999979,169.23947442499642,0
"147.32.84.165",2639,"193.23.181.44",179,3,186,3,186,0,0,85123.388995,8.792285999996238,169.23926269011685,0
"147.32.84.165",2640,"67.19.72.206",80,3,186,3,186,0,0,85123.392208,8.792271999991499,169.23953217114288,0
"147.32.84.165",2641,"193.23.181.44",80,3,186,3,186,0,0,85123.395411,8.792267999990145,169.2396091658794,0
"147.32.84.165",2642,"174.37.196.55",80,3,186,3,186,0,0,85123.398592,8.792329999996582,169.23841575561636,0
"147.32.84.165",2643,"174.128.246.102",80,3,186,3,186,0,0,85123.401793,8.792287000003853,169.23924344136492,0
"147.32.84.165",2644,"72.20.15.61",80,3,186,3,186,0,0,85123.404992,8.792308999996749,169.23881997329147,0
"147.32.84.165",2645,"67.19.72.206",80,3,186,3,186,0,0,85123.408192,8.792287999996915,169.23922419289747,0
"147.32.84.165",2646,"174.128.246.102",80,3,186,3,186,0,0,85123.411389,8.792291000005207,169.23916644696118,0
"147.32.84.165",2647,"67.19.72.206",80,3,186,3,186,0,0,85123.414589,8.792290999990655,169.23916644724127,0
"147.32.84.165",2648,"193.23.181.44",80,3,186,3,186,0,0,85123.417789,8.792289999997593,169.2391856956956,0
"147.32.84.165",2649,"67.19.72.206",80,3,186,3,186,0,0,85123.420989,8.792290999990655,169.23916644724127,0
"147.32.84.165",2650,"193.23.181.44",80,3,186,3,186,0,0,85123.424189,8.792310999997426,169.2387814762735,0
"147.32.84.165",2651,"72.20.15.61",80,3,186,3,186,0,0,85123.427417,8.792262000002665,169.23972465783535,0
"147.32.84.165",2652,"67.19.72.206",80,3,186,3,186,0,0,85123.430617,8.792260999995051,169.23974390669676,0
"147.32.84.165",2630,"67.19.72.206",80,3,186,3,186,0,0,85123.433843,8.792239999995218,169.24014813071634,0
"147.32.84.165",2653,"193.23.181.44",80,3,186,3,186,0,0,85123.462639,8.766640000001644,169.7343566063761,0
"147.32.84.165",2654,"193.23.181.44",179,3,186,3,186,0,0,85123.465789,8.766689000010956,169.73340790327345,0
"147.32.84.165",2655,"174.128.246.102",80,3,186,3,186,0,0,85123.469061,8.76661600000807,169.7348212809401,0
"147.32.84.165",2656,"193.23.181.44",179,3,186,3,186,0,0,85123.472189,8.766689000010956,169.73340790327345,0
"147.32.84.165",2657,"193.23.181.44",80,3,186,3,186,0,0,85123.475389,8.766715000005206,169.73290451430398,0
"147.32.84.165",2658,"174.128.246.102",80,3,186,3,186,0,0,85123.478587,8.766717999998946,169.73284643126183,0
"147.32.84.165",2659,"193.23.181.44",179,3,186,3,186,0,0,85123.481806,8.76667300000554,169.7337176827583,0
"147.32.84.165",2660,"174.37.196.55",80,3,186,3,186,0,0,85123.48501,8.766668999989633,169.73379512808793,0
"147.32.84.165",2661,"174.37.196.55",80,3,186,3,186,0,0,85123.488236,8.766695999991498,169.733272375527,0
"147.32.84.165",2662,"193.23.181.44",80,3,186,3,186,0,0,85123.49144,8.76668499999505,169.7334853483204,0
"147.32.84.165",2663,"72.20.15.61",80,3,186,3,186,0,0,85123.494633,8.766645000010612,169.73425979929593,0
"147.32.84.165",2664,"174.128.246.102",80,3,186,3,186,0,0,85123.497811,8.766667000003508,169.73383385035663,0
"147.32.84.165",2665,"193.23.181.44",179,3,186,3,186,0,0,85123.501012,8.76671900000656,169.7328270700688,0
"147.32.84.165",2666,"193.23.181.44",179,3,186,3,186,0,0,85123.504206,8.766688000003342,169.733427264599,0
"147.32.84.165",2667,"67.19.72.206",80,3,186,3,186,0,0,85123.507409,8.766671000004862,169.73375640527343,0
"147.32.84.165",2668,"72.20.15.61",80,3,186,3,186,0,0,85123.510637,8.766671999997925,169.7337370441545,0
"147.32.84.165",2669,"193.23.181.44",80,3,186,3,186,0,0,85123.513793,8.766711999996915,169.7329625976676,0
"147.32.84.165",2670,"174.128.246.102",80,3,186,3,186,0,0,85123.517036,8.766642999995383,169.73429852234014,0
"147.32.84.165",2671,"174.37.196.55",80,3,186,3,186,0,0,85123.520208,8.766669000004185,169.7337951278062,0
"147.32.84.165",2672,"193.23.181.44",179,3,186,3,186,0,0,85123.523439,8.766675000006217,169.73367896026085,0
"147.32.84.165",2673,"67.19.72.206",80,3,186,3,186,0,0,85123.542591,8.772335999994539,169.62414572366202,0
"147.32.84.165",2674,"72.20.15.61",80,3,186,3,186,0,0,85123.545791,8.772335000001476,169.62416505978734,0
"147.32.84.165",2675,"193.23.181.44",80,3,186,3,186,0,0,85123.549019,8.77227899999707,169.62524789743884,0
"147.32.84.165",2676,"72.20.15.61",80,3,186,3,186,0,0,85123.552221,8.772307999999612,169.6246871404955,0
"147.32.84.165",2677,"67.19.72.206",80,3,186,3,186,0,0,85123.555423,8.772280000004685,169.62522856078527,0
"147.32.84.165",2678,"193.23.181.44",179,3,186,3,186,0,0,85123.558591,8.772338000009768,169.62410705086182,0
"147.32.84.165",2679,"72.20.15.61",80,3,186,3,186,0,0,85123.561791,8.772337999995216,169.6241070511432,0
"147.32.84.165",2680,"193.23.181.44",179,3,186,3,186,0,0,85123.564993,8.772337999995216,169.6241070511432,0
"147.32.84.165",2681,"174.37.196.55",80,3,186,3,186,0,0,85123.568193,8.772307999999612,169.6246871404955,0
"147.32.84.165",2682,"193.23.181.44",179,3,186,3,186,0,0,85123.571391,8.772319999989122,169.6244551044473,0
"147.32.84.165",2683,"72.20.15.61",80,3,186,3,186,0,0,85123.574621,8.772307999999612,169.6246871404955,0
"147.32.84.165",2684,"72.20.15.61",80,3,186,3,186,0,0,85123.577811,8.772294000009424,169.62495785006766,0
"147.32.84.165",2685,"174.128.246.102",80,3,186,3,186,0,0,85123.581006,8.772294000009424,169.62495785006766,0
"147.32.84.165",2686,"193.23.181.44",80,3,186,3,186,0,0,85123.584237,8.772287999992841,169.62507386912222,0
"147.32.84.165",2687,"72.20.15.61",80,3,186,3,186,0,0,85123.587407,8.77229000000807,169.62503519589882,0
"147.32.84.165",2688,"174.128.246.102",80,3,186,3,186,0,0,85123.590638,8.77229000000807,169.62503519589882,0
"147.32.84.165",2689,"174.37.196.55",80,3,186,3,186,0,0,85123.593833,8.772289999993518,169.6250351961802,0
"147.32.84.165",2690,"67.19.72.206",80,3,186,3,186,0,0,85123.59704,8.772263000006205,169.62555728196332,0
"147.32.84.165",2691,"67.19.72.206",80,3,186,3,186,0,0,85123.600189,8.77234199999657,169.6240297061585,0
"147.32.84.165",2692,"193.23.181.44",80,3,186,3,186,0,0,85123.619029,8.756655000004685,169.9279005509757,0
"147.32.84.165",2693,"193.23.181.44",179,3,186,3,186,0,0,85123.62222,8.769904000000679,169.67118454202975,0
"147.32.84.165",2694,"174.128.246.102",80,3,186,3,186,0,0,85123.625456,8.7667960000108,169.7313362827385,0
"147.32.84.165",2695,"193.23.181.44",80,3,186,3,186,0,0,85123.628642,8.763644000006025,169.79238316834608,0
"147.32.84.165",2696,"174.128.246.102",80,3,186,3,186,0,0,85123.631837,8.760498000003281,169.85335765152195,0
"147.32.84.165",2697,"193.23.181.44",80,3,186,3,186,0,0,85123.635048,8.757330000007642,169.91480279933515,0
"147.32.84.165",2698,"174.37.196.55",80,7,563,4,381,3,182,85123.638239,0.36912399998982437,8257.387761521939,3944.473943824128
"147.32.84.165",2699,"193.23.181.44",179,3,186,3,186,0,0,85123.641415,8.753467999995337,169.9897686266509,0
"147.32.84.165",2700,"174.37.196.55",80,8,678,4,436,4,242,85123.644641,0.4199159999989206,8306.423189421137,4610.445898715401
"147.32.84.165",2701,"193.23.181.44",179,3,186,3,186,0,0,85123.647789,8.750292000011541,170.05146799650086,0
"147.32.84.165",2702,"72.20.15.61",80,3,186,3,186,0,0,85123.650989,8.750293000004604,170.05144856283295,0
"147.32.84.165",2703,"72.20.15.61",80,3,186,3,186,0,0,85123.654189,8.750292000011541,170.05146799650086,0
"147.32.84.165",2704,"193.23.181.44",179,3,186,3,186,0,0,85123.657389,8.750293000004604,170.05144856283295,0
"147.32.84.165",2705,"193.23.181.44",179,3,186,3,186,0,0,85123.660589,8.750302999993437,170.05125422526694,0
"147.32.84.165",2706,"72.20.15.61",80,3,186,3,186,0,0,85123.66379,8.750319999991916,170.0509238520848,0
"147.32.84.165",2708,"72.20.15.61",80,3,186,3,186,0,0,85123.666991,8.75032099999953,170.05090441825845,0
"147.32.84.165",2709,"67.19.72.206",80,3,186,3,186,0,0,85123.670208,8.750297000005958,170.0513708276401,0
"147.32.84.165",2707,"67.19.72.206",80,6,366,3,186,3,180,85123.673441,1.3473850000009406,1104.3614111771774,1068.7368495263008
"147.32.84.165",2710,"72.20.15.61",80,3,186,3,186,0,0,85123.701837,8.721875999995973,170.60549817501268,0
"147.32.84.165",2711,"72.20.15.61",80,3,186,3,186,0,0,85123.705006,8.787404000002425,169.33328659972722,0
"147.32.84.165",2712,"193.23.181.44",80,3,186,3,186,0,0,85123.708189,8.784341999999015,169.3923119113722,0
"147.32.84.165",2713,"67.19.72.206",80,3,186,3,186,0,0,85123.71141,8.781168999994406,169.45352036852358,0
"147.32.84.165",2714,"67.19.72.206",80,3,186,3,186,0,0,85123.714611,8.778011999995215,169.51446409515174,0
"147.32.84.165",2715,"193.23.181.44",80,3,186,3,186,0,0,85123.717814,8.774852000002284,169.5755096495773,0
"147.32.84.165",2716,"174.37.196.55",80,8,639,5,457,3,182,85123.721038,3.1918250000016997,1145.426206010058,456.1653599427364
"147.32.84.165",2717,"72.20.15.61",80,3,186,3,186,0,0,85123.724235,8.768479000005755,169.6987584732795,0
"147.32.84.165",2718,"72.20.15.61",80,3,186,3,186,0,0,85123.72741,8.765353999988292,169.759259010188,0
"147.32.84.165",2719,"193.23.181.44",80,3,186,3,186,0,0,85123.730617,8.76219600001059,169.8204422724853,0
"147.32.84.165",2720,"193.23.181.44",179,3,186,3,186,0,0,85123.733806,8.759053999994649,169.88135933411405,0
"147.32.84.165",2722,"174.128.246.102",80,3,186,3,186,0,0,85123.754238,8.738670999999158,170.27760857459256,0
"147.32.84.165",2723,"67.19.72.206",80,3,186,3,186,0,0,85123.757438,8.735518999994383,170.33904911671038,0
"147.32.84.165",2721,"174.128.246.102",80,3,186,3,186,0,0,85123.760614,8.732386000003316,170.40016325428525,0
"147.32.84.165",2725,"72.20.15.61",80,3,186,3,186,0,0,85123.763789,8.729257999992114,170.46122362305528,0
"147.32.84.165",2726,"174.128.246.102",80,3,186,3,186,0,0,85123.766989,8.726101000007475,170.52289447471733,0
"147.32.84.165",2727,"67.19.72.206",80,5,306,3,186,2,120,85123.770206,3.659958000003826,406.562042514817,262.2980919450432
"147.32.84.165",2724,"193.23.181.44",80,3,186,3,186,0,0,85123.773437,8.719700000001467,170.6480727547679,0
"147.32.84.165",2728,"174.128.246.102",80,3,186,3,186,0,0,85123.793015,8.700165000002016,171.0312390626678,0
"147.32.84.165",2729,"72.20.15.61",80,3,186,3,186,0,0,85123.79622,8.797542999993311,169.13813322664421,0
"147.32.84.165",2730,"174.128.246.102",80,3,186,3,186,0,0,85123.799395,8.794426000007661,169.19808069323724,0
"147.32.84.165",2731,"72.20.15.61",80,3,186,3,186,0,0,85123.802587,8.791255999996793,169.25909107874267,0
"147.32.84.165",2732,"193.23.181.44",80,3,186,3,186,0,0,85123.80579,8.788079000005382,169.32028034785404,0
"147.32.84.165",2733,"174.37.196.55",80,3,186,3,186,0,0,85123.808988,8.78490199999942,169.38151387461104,0
"147.32.84.165",2734,"193.23.181.44",80,3,186,3,186,0,0,85123.812188,8.781726000001072,169.44277241168973,0
"147.32.84.165",2735,"67.19.72.206",80,3,186,3,186,0,0,85123.815419,8.778516999998828,169.50471247024964,0
"147.32.84.165",2736,"174.37.196.55",80,3,186,3,186,0,0,85123.818615,8.775345000001835,169.5659828758515,0
"147.32.84.165",2737,"193.23.181.44",80,3,186,3,186,0,0,85123.821821,8.772159999993164,169.62754897324714,0
"147.32.84.165",2738,"193.23.181.44",80,3,186,3,186,0,0,85123.825018,8.768985999995493,169.68894693192175,0
"147.32.84.165",2739,"193.23.181.44",179,3,186,3,186,0,0,85123.828219,8.765805999995791,169.7505055440098,0
"147.32.84.165",2740,"193.23.181.44",179,3,186,3,186,0,0,85123.831415,8.76263400001335,169.81195380267314,0
"147.32.84.165",2741,"193.23.181.44",179,3,186,3,186,0,0,85123.834638,8.7594320000062,169.8740283615361,0
"147.32.84.165",2742,"72.20.15.61",80,3,186,3,186,0,0,85123.837788,8.756303000001935,169.93473158702608,0
"147.32.84.165",2743,"72.20.15.61",80,3,186,3,186,0,0,85123.841017,8.753098000001046,169.99695422121655,0
"147.32.84.165",2744,"67.19.72.206",80,3,186,3,186,0,0,85123.844223,8.749915000007604,170.05879485671653,0
"147.32.84.165",2745,"72.20.15.61",80,3,186,3,186,0,0,85123.847421,8.746738000001642,170.1205638032968,0
"147.32.84.165",2746,"67.19.72.206",80,3,186,3,186,0,0,85123.850611,8.743570999999065,170.18218300053366,0
"147.32.84.165",2747,"193.23.181.44",80,3,186,3,186,0,0,85123.853809,8.839307000002009,168.33898856546807,0
"147.32.84.165",2748,"174.128.246.102",80,3,186,3,186,0,0,85123.857057,8.836156999997911,168.39899970092787,0
"147.32.84.165",2749,"72.20.15.61",80,3,186,3,186,0,0,85123.860216,8.833020999998553,168.45878663712492,0
"147.32.84.165",2750,"174.128.246.102",80,3,186,3,186,0,0,85123.863409,8.829849000001559,168.51930310470058,0
"147.32.84.165",2751,"174.128.246.102",80,3,186,3,186,0,0,85123.866588,8.826690999994753,168.579595683239,0
"147.32.84.165",2752,"174.128.246.102",80,3,186,3,186,0,0,85123.869808,8.823499999998603,168.6405621352338,0
"147.32.84.165",2753,"193.23.181.44",179,3,186,3,186,0,0,85123.873009,8.820321999999578,168.70132405597792,0
"147.32.84.165",2754,"174.37.196.55",80,3,186,3,186,0,0,85123.876236,8.817116000005626,168.76266570600302,0
"147.32.84.165",2755,"193.23.181.44",179,3,186,3,186,0,0,85123.879407,8.813968000002205,168.82294104081473,0
"147.32.84.165",2756,"193.23.181.44",80,3,186,3,186,0,0,85123.898995,8.794404000000213,169.19850395773994,0
"147.32.84.165",2757,"193.23.181.44",80,3,186,3,186,0,0,85123.914989,8.879391000009491,167.5790603205118,0
"147.32.84.165",2758,"193.23.181.44",179,3,186,3,186,0,0,85123.918189,8.876212999995914,167.63905958551072,0
"147.32.84.165",2760,"174.37.196.55",80,3,186,3,186,0,0,85123.921394,8.873028000001796,167.6992341283831,0
"147.32.84.165",2759,"67.19.72.206",80,3,186,3,186,0,0,85123.924594,8.869856000004802,167.75920601182187,0
"147.32.84.165",2761,"67.19.72.206",80,3,186,3,186,0,0,85123.946989,8.847483999998076,168.18340671769778,0
"147.32.84.165",2762,"193.23.181.44",179,3,186,3,186,0,0,85123.950189,8.844305999999051,168.24383959579865,0
"147.32.84.165",2763,"174.128.246.102",80,3,186,3,186,0,0,85123.953389,8.841128999993089,168.3042968834821,0
"147.32.84.165",2764,"67.19.72.206",80,3,186,3,186,0,0,85123.95659,8.837952000001678,168.36479763634352,0
"147.32.84.165",2765,"174.128.246.102",80,3,186,3,186,0,0,85123.959788,8.834777000010945,168.42530377372927,0
"147.32.84.165",2766,"174.37.196.55",80,3,186,3,186,0,0,85123.962989,8.831601999991108,168.4858534161184,0
"147.32.84.165",2767,"72.20.15.61",80,3,186,3,186,0,0,85123.966188,8.82842599999276,168.54646570081917,0
"147.32.84.165",2768,"174.128.246.102",80,3,186,3,186,0,0,85123.96939,8.825251000002027,168.60710250616762,0
"147.32.84.165",2769,"174.128.246.102",80,3,186,3,186,0,0,85123.972589,8.822073999996064,168.66782119495528,0
"147.32.84.165",2770,"174.128.246.102",80,3,186,3,186,0,0,85123.97579,8.81889599999704,168.72860276394002,0
"147.32.84.165",2771,"193.23.181.44",179,3,186,3,186,0,0,85123.979026,8.815682999993442,168.79009828292453,0
"147.32.84.165",2772,"72.20.15.61",80,3,186,3,186,0,0,85123.982219,8.81251400000474,168.85079558446088,0
"147.32.84.165",2773,"174.128.246.102",80,3,186,3,186,0,0,85123.985417,8.80933799999184,168.91167077496382,0
"147.32.84.165",2774,"174.37.196.55",80,3,186,3,186,0,0,85123.988641,8.806136999992304,168.97306957651242,0
"147.32.84.165",2775,"193.23.181.44",80,3,186,3,186,0,0,85123.991838,8.802962999994634,169.03399457670184,0
"147.32.84.165",2776,"174.37.196.55",80,3,186,3,186,0,0,85123.994989,8.799836000005598,169.09406038919968,0
"147.32.84.165",2778,"67.19.72.206",80,3,186,3,186,0,0,85123.998189,8.796658999999636,169.15513037393646,0
"147.32.84.165",2779,"67.19.72.206",80,3,186,3,186,0,0,85124.001389,8.793482000008225,169.216244486383,0
"147.32.84.165",2780,"174.128.246.102",80,3,186,3,186,0,0,85124.004589,8.790305000002263,169.27740277494544,0
"147.32.84.165",2777,"72.20.15.61",80,3,186,3,186,0,0,85124.007789,8.787127000003238,169.33862455833992,0
"147.32.84.165",2781,"174.128.246.102",80,3,186,3,186,0,0,85124.027018,8.86652999999933,167.82213560435846,0
"147.32.84.165",2782,"174.128.246.102",80,3,186,3,186,0,0,85124.030221,8.863437000007252,167.8806991011255,0
"147.32.84.165",2783,"193.23.181.44",80,3,186,3,186,0,0,85124.033409,8.860281000001123,167.9404975981926,0
"147.32.84.165",2784,"174.128.246.102",80,3,186,3,186,0,0,85124.036611,8.857108999989578,168.00064219620091,0
"147.32.84.165",2785,"72.20.15.61",80,3,186,3,186,0,0,85124.039791,8.853956999999355,168.06045025970968,0
"147.32.84.165",2786,"193.23.181.44",80,3,186,3,186,0,0,85124.043037,8.850744000010309,168.12145961947004,0
"147.32.84.165",2787,"193.23.181.44",80,3,186,3,186,0,0,85124.046197,8.847614999991492,168.18091655224947,0
"147.32.84.165",2788,"174.128.246.102",80,3,186,3,186,0,0,85124.049422,8.844422000009217,168.24163297482292,0
"147.32.84.165",2789,"193.23.181.44",179,3,186,3,186,0,0,85124.05259,8.841287999995984,168.30127013175863,0
"147.32.84.165",2790,"193.23.181.44",80,3,186,3,186,0,0,85124.055792,8.838117000006605,168.36165441110228,0
"147.32.84.165",2791,"174.128.246.102",80,3,186,3,186,0,0,85124.058991,8.834950000004028,168.42200578377032,0
"147.32.84.165",2792,"193.23.181.44",179,3,186,3,186,0,0,85124.062214,8.831758999993326,168.48285828464347,0
"147.32.84.165",2793,"193.23.181.44",179,3,186,3,186,0,0,85124.065417,8.828587999989395,168.54337296086163,0
"147.32.84.165",2794,"193.23.181.44",179,3,186,3,186,0,0,85124.068589,8.825448000003234,168.60333888992997,0
"147.32.84.165",2795,"193.23.181.44",80,3,186,3,186,0,0,85124.071788,8.82228199999372,168.6638445700397,0
"147.32.84.165",2796,"174.37.196.55",80,3,186,3,186,0,0,85124.075009,8.8190930000128,168.7248337213181,0
"147.32.84.165",2797,"174.128.246.102",80,3,186,3,186,0,0,85124.078214,8.815919000000576,168.78557981305212,0
"147.32.84.165",2799,"72.20.15.61",80,3,186,3,186,0,0,85124.081444,8.812721000009333,168.84682948642356,0
"147.32.84.165",2800,"174.37.196.55",80,3,186,3,186,0,0,85124.084644,8.809551999991527,168.90756760405424,0
"147.32.84.165",2801,"193.23.181.44",80,3,186,3,186,0,0,85124.087813,8.806415999992169,168.96771626520066,0
"147.32.84.165",2798,"67.19.72.206",80,3,186,3,186,0,0,85124.091037,8.803223999988404,169.0289830182624,0
"147.32.84.165",2802,"174.128.246.102",80,3,186,3,186,0,0,85124.100638,8.895063000003574,167.28380675880564,0
"147.32.84.165",2803,"174.37.196.55",80,3,186,3,186,0,0,85124.103807,8.89195999999356,167.34218327579944,0
"147.32.84.165",2804,"174.37.196.55",80,3,186,3,186,0,0,85124.107007,8.888781999994535,167.40201300930937,0
"147.32.84.165",2805,"174.128.246.102",80,3,186,3,186,0,0,85124.110239,8.885571999999229,167.46248862764594,0
"147.32.84.165",2806,"174.128.246.102",80,3,186,3,186,0,0,85124.113463,8.88237300000037,167.52280049486077,0
"147.32.84.165",2807,"193.23.181.44",179,3,186,3,186,0,0,85124.116635,8.87922200000321,167.582249886247,0
"147.32.84.165",2808,"174.37.196.55",80,3,186,3,186,0,0,85124.11981,8.876069999998435,167.64176037370845,0
"147.32.84.165",2809,"72.20.15.61",80,3,186,3,186,0,0,85124.123036,8.872866999998223,167.70227706560888,0
"147.32.84.165",2810,"193.23.181.44",179,3,186,3,186,0,0,85124.126193,8.869732999999542,167.76153239337384,0
"147.32.84.165",2811,"193.23.181.44",80,3,186,3,186,0,0,85124.12941,8.866548000005423,167.82179490812996,0
"147.32.84.165",2812,"193.23.181.44",179,3,186,3,186,0,0,85124.132636,8.86334500000521,167.88244167400967,0
"147.32.84.165",2813,"174.128.246.102",80,3,186,3,186,0,0,85124.13584,8.860165999998571,167.94267737198604,0
"147.32.84.165",2814,"67.19.72.206",80,3,186,3,186,0,0,85124.138996,8.857033000007505,168.00208376763857,0
"147.32.84.165",2815,"72.20.15.61",80,3,186,3,186,0,0,85124.142242,8.853810000000522,168.06324057099852,0
"147.32.84.165",2816,"174.128.246.102",80,3,186,3,186,0,0,85124.145437,8.85063899999659,168.12345413710503,0
"147.32.84.165",2817,"174.128.246.102",80,3,186,3,186,0,0,85124.148589,8.847508999999263,168.182931489544,0
"147.32.84.165",2818,"193.23.181.44",179,3,186,3,186,0,0,85124.151789,8.844335000001593,168.2432879351282,0
"147.32.84.165",2819,"174.128.246.102",80,6,501,4,379,2,122,85124.154989,0.3291389999940293,9211.91350783408,2965.312527587752
"147.32.84.165",2820,"67.19.72.206",80,3,186,3,186,0,0,85124.161788,8.933208999995259,166.56948247833336,0
"147.32.84.165",2821,"193.23.181.44",80,3,186,3,186,0,0,85124.164989,8.930139999996754,166.6267270166583,0
"147.32.84.165",2822,"174.37.196.55",80,3,186,3,186,0,0,85124.16819,8.927012000000104,166.68511255501647,0
"147.32.84.165",2823,"67.19.72.206",80,3,186,3,186,0,0,85124.171389,8.92387100000633,166.7437819303915,0
"147.32.84.165",2824,"193.23.181.44",179,3,186,3,186,0,0,85124.174589,8.920727000004263,166.80254871596105,0
"147.32.84.165",2825,"174.37.196.55",80,3,186,3,186,0,0,85124.177798,8.917571999991196,166.86156276635265,0
"147.32.84.165",2826,"193.23.181.44",179,3,186,3,186,0,0,85124.181039,8.914386999997078,166.92118033472048,0
"147.32.84.165",2827,"174.128.246.102",80,3,186,3,186,0,0,85124.184216,8.911263000001782,166.97969749065902,0
"147.32.84.165",2828,"174.128.246.102",80,19,2222,14,1914,5,308,85124.187428,309.2664470000018,49.51070556968604,7.967239976731086
"147.32.84.165",2829,"193.23.181.44",80,3,186,3,186,0,0,85124.190637,8.904953999997815,167.09799960789974,0
"147.32.84.165",2830,"72.20.15.61",80,3,186,3,186,0,0,85124.193837,8.901809000002686,167.15703515988167,0
"147.32.84.165",2831,"174.37.196.55",80,3,186,3,186,0,0,85124.197039,8.898661999992328,167.21615002359712,0
"147.32.84.165",2832,"72.20.15.61",80,3,186,3,186,0,0,85124.200219,8.89553499998874,167.27493062551983,0
"147.32.84.165",2833,"174.128.246.102",80,3,186,3,186,0,0,85124.203416,8.89239500000258,167.33399719643228,0
"147.32.84.165",2834,"174.37.196.55",80,3,186,3,186,0,0,85124.206636,8.889230999993742,167.39355744057585,0
"147.32.84.165",2835,"174.37.196.55",80,3,186,3,186,0,0,85124.209818,8.886103999990155,167.4524628567985,0
"147.32.84.165",2836,"67.19.72.206",80,3,186,3,186,0,0,85124.213014,8.88301100001263,167.51076858937634,0
"147.32.84.165",2837,"67.19.72.206",80,3,186,3,186,0,0,85124.216191,8.879889999996522,167.56964331771934,0
"147.32.84.165",2838,"193.23.181.44",179,3,186,3,186,0,0,85124.219388,8.876751000003424,167.62889935736916,0
"147.32.84.165",2839,"193.23.181.44",179,3,186,3,186,0,0,85124.222607,8.873586000001524,167.688688654141,0
"147.32.84.165",2840,"67.19.72.206",80,3,186,3,186,0,0,85124.22579,8.87045699999726,167.74783982386248,0
"147.32.84.165",2841,"72.20.15.61",80,3,186,3,186,0,0,85124.228994,8.867306999993161,167.80743014774922,0
"147.32.84.165",2842,"193.23.181.44",179,3,186,3,186,0,0,85124.232245,8.86410999999498,167.8679529023041,0
"147.32.84.165",2843,"174.37.196.55",80,3,186,3,186,0,0,85124.235447,8.860962999999174,167.92757175491408,0
"147.32.84.165",2844,"174.128.246.102",80,3,186,3,186,0,0,85124.238636,8.857826000006753,167.9870433217886,0
"147.32.84.165",2845,"72.20.15.61",80,3,186,3,186,0,0,85124.241842,8.85467499999504,168.04682272368365,0
"147.32.84.165",2846,"193.23.181.44",179,3,186,3,186,0,0,85124.245039,8.853161999999429,168.07554182337293,0
"147.32.84.165",2847,"67.19.72.206",80,3,186,3,186,0,0,85124.24826,8.853161000006367,168.07556080804696,0
"147.32.84.165",2848,"193.23.181.44",179,3,186,3,186,0,0,85124.251441,8.85315900000569,168.07559877768418,0
"147.32.84.165",2849,"193.23.181.44",80,3,186,3,186,0,0,85124.265414,8.930808000004617,166.61426379329066,0
"147.32.84.165",2850,"174.37.196.55",80,3,186,3,186,0,0,85124.265792,8.930529999997816,166.61945035741036,0
"147.32.84.165",2851,"174.37.196.55",80,3,186,3,186,0,0,85124.268992,8.927353999999468,166.6787269777908,0
"147.32.84.165",2852,"67.19.72.206",80,3,186,3,186,0,0,85124.272195,8.924173999999766,166.7381205252205,0
"147.32.84.165",2853,"67.19.72.206",80,3,186,3,186,0,0,85124.27539,8.92100100000971,166.79742553536093,0
"147.32.84.165",2854,"193.23.181.44",179,3,186,3,186,0,0,85124.278611,8.917803000003914,166.8572405108463,0
"147.32.84.165",2855,"72.20.15.61",80,3,186,3,186,0,0,85124.28179,8.914647000012337,166.9163119973164,0
"147.32.84.165",2856,"174.128.246.102",80,3,186,3,186,0,0,85124.285036,8.911424000005354,166.97668071894077,0
"147.32.84.165",2857,"72.20.15.61",80,3,186,3,186,0,0,85124.288192,8.908290999999736,167.03540555646916,0
"147.32.84.165",2858,"193.23.181.44",179,3,186,3,186,0,0,85124.291412,8.90509299999394,167.09539136772773,0
"147.32.84.165",2859,"72.20.15.61",80,3,186,3,186,0,0,85124.294606,8.901920000003884,167.15495084199262,0
"147.32.84.165",2860,"174.128.246.102",80,3,186,3,186,0,0,85124.297841,8.898707999993348,167.21528563484858,0
"147.32.84.165",2861,"174.37.196.55",80,3,186,3,186,0,0,85124.301033,8.895543999999063,167.2747613861678,0
"147.32.84.165",2862,"67.19.72.206",80,3,186,3,186,0,0,85124.304209,8.892390000008163,167.3340912846416,0
"147.32.84.165",2863,"193.23.181.44",80,3,186,3,186,0,0,85124.307395,8.88922700000694,167.39363276456302,0
"147.32.84.165",2864,"174.37.196.55",80,3,186,3,186,0,0,85124.310637,8.886008000001311,167.45427192950766,0
"147.32.84.165",2865,"72.20.15.61",80,3,186,3,186,0,0,85124.313837,8.882831000009901,167.5141629958221,0
"147.32.84.165",2866,"67.19.72.206",80,3,186,3,186,0,0,85124.316993,8.879698999997345,167.57324769684703,0
"147.32.84.165",2867,"67.19.72.206",80,3,186,3,186,0,0,85124.320201,8.876520000005257,167.6332616835335,0
"147.32.84.165",2868,"174.37.196.55",80,3,186,3,186,0,0,85124.339821,8.856929999994463,168.00403751649048,0
"147.32.84.165",2869,"72.20.15.61",80,3,186,3,186,0,0,85124.378989,8.916801999992458,166.8759719012779,0
"147.32.84.165",2870,"174.37.196.55",80,3,186,3,186,0,0,85124.382189,8.91372300000512,166.93361460740311,0
"147.32.84.165",2871,"72.20.15.61",80,3,186,3,186,0,0,85124.385389,8.910571000000346,166.99266522874262,0
"147.32.84.165",2872,"72.20.15.61",80,3,186,3,186,0,0,85124.388589,8.907418000002508,167.0517763957615,0
"147.32.84.165",2873,"174.37.196.55",80,3,186,3,186,0,0,85124.391789,8.904263999997056,167.11094819296596,0
"147.32.84.165",2874,"174.37.196.55",80,3,186,3,186,0,0,85124.394989,8.901112999999896,167.1701055811804,0
"147.32.84.165",2875,"193.23.181.44",179,3,186,3,186,0,0,85124.398189,8.897958000001381,167.22938004424938,0
"147.32.84.165",2876,"174.37.196.55",80,3,186,3,186,0,0,85124.40139,8.894803000002867,167.2886965568007,0
"147.32.84.165",2877,"174.37.196.55",80,3,186,3,186,0,0,85124.404609,8.891629999998258,167.34839393905185,0
"147.32.84.165",2878,"174.37.196.55",80,3,186,3,186,0,0,85124.407795,8.888490999990609,167.40749357810816,0
"147.32.84.165",2879,"174.128.246.102",80,12,873,8,627,4,246,85124.41099,18.37027699999453,273.0497749163768,107.12957676144927
"147.32.84.165",2880,"174.37.196.55",80,3,186,3,186,0,0,85124.414239,8.882141999987653,167.52715730080294,0
"147.32.84.165",2881,"174.37.196.55",80,3,186,3,186,0,0,85124.417436,8.87899299999117,167.586572035982,0
"147.32.84.165",2882,"193.23.181.44",179,3,186,3,186,0,0,85124.420607,8.878421000001254,167.59736894654915,0
"147.32.84.165",2883,"174.128.246.102",80,3,186,3,186,0,0,85124.423838,8.878408999997191,167.59759547014232,0
"147.32.84.165",2885,"174.37.196.55",80,3,186,3,186,0,0,85124.427005,8.87842300000193,167.5973311926765,0
"147.32.84.165",2886,"67.19.72.206",80,3,186,3,186,0,0,85124.430211,8.8784169999999,167.5974444543455,0
"147.32.84.165",2887,"174.128.246.102",80,3,186,3,186,0,0,85124.433436,8.878387999997358,167.59799188776643,0
"147.32.84.165",2888,"67.19.72.206",80,3,186,3,186,0,0,85124.436643,8.87841100001242,167.5975577158929,0
"147.32.84.165",2889,"174.128.246.102",80,3,186,3,186,0,0,85124.439807,8.878448000003118,167.59685927084075,0
"147.32.84.165",2884,"193.23.181.44",179,3,186,3,186,0,0,85124.443044,8.878410000004806,167.59757659301548,0
"147.32.84.165",2890,"193.23.181.44",80,3,186,3,186,0,0,85124.465888,8.93031099998916,166.62353640335775,0
"147.32.84.165",2891,"193.23.181.44",179,3,186,3,186,0,0,85124.466241,8.930016999991494,166.62902209496548,0
"147.32.84.165",2892,"174.128.246.102",80,3,186,3,186,0,0,85124.466606,8.929673999999068,166.63542252496063,0
"147.32.84.165",2893,"174.37.196.55",80,3,186,3,186,0,0,85124.466967,8.929338000001735,166.64169281078966,0
"147.32.84.165",2895,"174.37.196.55",80,3,186,3,186,0,0,85124.46889,8.927437999998801,166.67715866525197,0
"147.32.84.165",2894,"67.19.72.206",80,3,186,3,186,0,0,85124.470992,8.92536399999517,166.71588968257262,0
"147.32.84.165",2896,"193.23.181.44",80,3,186,3,186,0,0,85124.474193,8.922185999996145,166.77527233803946,0
"147.32.84.165",2897,"174.37.196.55",80,3,186,3,186,0,0,85124.477391,8.91901000001235,166.83465990036333,0
"147.32.84.165",2898,"193.23.181.44",80,3,186,3,186,0,0,85124.480611,8.915812999999616,166.89448286993726,0
"147.32.84.165",2899,"193.23.181.44",80,3,186,3,186,0,0,85124.483808,8.912639999995008,166.95389918148084,0
"147.32.84.165",2900,"174.128.246.102",80,3,186,3,186,0,0,85124.48699,8.909484999996494,167.01302039350037,0
"147.32.84.165",2901,"174.37.196.55",80,3,186,3,186,0,0,85124.49021,8.906287999998312,167.07297136588014,0
"147.32.84.165",2902,"193.23.181.44",80,3,186,3,186,0,0,85124.49339,8.903131999992183,167.13219572632488,0
"147.32.84.165",2903,"174.128.246.102",80,3,186,3,186,0,0,85124.496611,8.899935000008554,167.1922323026595,0
"147.32.84.165",2904,"174.128.246.102",80,3,186,3,186,0,0,85124.499809,8.896764000004623,167.25182324710724,0
"147.32.84.165",2905,"193.23.181.44",179,3,186,3,186,0,0,85124.503009,8.893586000005598,167.3115883738082,0
"147.32.84.165",2906,"72.20.15.61",80,3,186,3,186,0,0,85124.50619,8.890427999998792,167.3710197079603,0
"147.32.84.165",2907,"174.37.196.55",80,3,186,3,186,0,0,85124.509388,8.887252999993507,167.43081354847072,0
"147.32.84.165",2908,"67.19.72.206",80,3,186,3,186,0,0,85124.512617,8.884047999992617,167.49121571621816,0
"147.32.84.165",2909,"72.20.15.61",80,3,186,3,186,0,0,85124.515817,8.88242999999784,167.52172547381312,0
"147.32.84.165",2910,"174.37.196.55",80,3,186,3,186,0,0,85124.518988,8.882468000010704,167.5210088005053,0
"147.32.84.165",2911,"72.20.15.61",80,3,186,3,186,0,0,85124.566252,8.931484000000637,166.60165320789847,0
"147.32.84.165",2913,"174.128.246.102",80,3,186,3,186,0,0,85124.56712,8.930735999994795,166.61560704524993,0
"147.32.84.165",2912,"67.19.72.206",80,3,186,3,186,0,0,85124.567262,8.930640999999014,166.61737942440686,0
"147.32.84.165",2914,"72.20.15.61",80,3,186,3,186,0,0,85124.567564,8.930388000007952,166.62209973392814,0
"147.32.84.165",2915,"174.128.246.102",80,3,186,3,186,0,0,85124.567777,8.930219999994733,166.62523431683402,0
"147.32.84.165",2916,"72.20.15.61",80,3,186,3,186,0,0,85124.567897,8.9301470000064,166.6265964041727,0
"147.32.84.165",2917,"193.23.181.44",80,3,186,3,186,0,0,85124.568025,8.930066000000807,166.62810778776614,0
"147.32.84.165",2918,"174.37.196.55",80,3,186,3,186,0,0,85124.568162,8.929975999999442,166.62978713493663,0
"147.32.84.165",2919,"72.20.15.61",80,3,186,3,186,0,0,85124.568283,8.92990099999588,166.6311866168154,0
"147.32.84.165",2920,"67.19.72.206",80,3,186,3,186,0,0,85124.568401,8.929829000000609,166.63253014138328,0
"147.32.84.165",2921,"193.23.181.44",179,3,186,3,186,0,0,85124.568522,8.929753999997047,166.63392966933827,0
"147.32.84.165",2922,"174.37.196.55",80,3,186,3,186,0,0,85124.568644,8.929680000001099,166.6353105598204,0
"147.32.84.165",2923,"67.19.72.206",80,3,186,3,186,0,0,85124.568764,8.929657000000589,166.635739760206,0
"147.32.84.165",2924,"193.23.181.44",179,3,186,3,186,0,0,85124.568915,8.92955700001039,166.63760587431923,0
"147.32.84.165",2925,"94.100.176.20",25,3,186,3,186,0,0,85124.624504,8.874013999986346,167.6806009098351,0
"147.32.84.165",2926,"193.23.181.44",179,3,186,3,186,0,0,85124.666578,8.930590999996639,166.61831227077357,0
"147.32.84.165",2927,"72.20.15.61",80,3,186,3,186,0,0,85124.666764,8.930530000012368,166.61945035713885,0
"147.32.84.165",2928,"174.128.246.102",80,3,186,3,186,0,0,85124.667415,8.929927999997744,166.6306828006201,0
"147.32.84.165",2929,"67.19.72.206",80,3,186,3,186,0,0,85124.667721,8.929668999990099,166.6355158294949,0
"147.32.84.165",2930,"193.23.181.44",179,3,186,3,186,0,0,85124.667834,8.92960299999686,166.63674745680444,0
"147.32.84.165",2931,"72.20.15.61",80,3,186,3,186,0,0,85124.667942,8.929541999998037,166.63788579529916,0
"147.32.84.165",2932,"174.128.246.102",80,3,186,3,186,0,0,85124.668086,8.929445000001579,166.6396959721166,0
"147.32.84.165",2933,"193.23.181.44",179,3,186,3,186,0,0,85124.668194,8.929384000002756,166.64083435089597,0
"147.32.84.165",2934,"193.23.181.44",80,3,186,3,186,0,0,85124.668302,8.929325999997673,166.64191675837435,0
"147.32.84.165",2935,"67.19.72.206",80,3,186,3,186,0,0,85124.66841,8.929266000006464,166.64303650478357,0
"147.32.84.165",2936,"67.19.72.206",80,6,366,3,186,3,180,85124.668516,1.3565019999950891,1096.9390387963947,1061.55390851264
"147.32.84.165",2937,"72.20.15.61",80,3,186,3,186,0,0,85124.668623,8.929095999992569,166.64620920205564,0
"147.32.84.165",2939,"174.128.246.102",80,3,186,3,186,0,0,85124.767786,8.929767000008724,166.63368708260208,0
"147.32.84.165",2938,"67.19.72.206",80,3,186,3,186,0,0,85124.767943,8.929667999997037,166.63553449025136,0
"147.32.84.165",2940,"174.128.246.102",80,3,186,3,186,0,0,85124.768287,8.929344999996829,166.64156217511234,0
"147.32.84.165",2941,"174.128.246.102",80,3,186,3,186,0,0,85124.768497,8.92916200000036,166.64497743460583,0
"147.32.84.165",2942,"174.37.196.55",80,9,715,6,533,3,182,85124.768625,9.171117000005324,464.9379132331999,158.7592874454829
"147.32.84.165",2943,"174.37.196.55",80,3,186,3,186,0,0,85124.768737,8.928967999992892,166.64859813599784,0
"147.32.84.165",2944,"174.128.246.102",80,3,186,3,186,0,0,85124.768845,8.928882000007434,166.65020323919177,0
"147.32.84.165",2945,"174.37.196.55",80,3,186,3,186,0,0,85124.768997,8.928753000000142,166.65261095250102,0
"147.32.84.165",2946,"174.128.246.102",80,3,186,3,186,0,0,85124.769224,8.92854900000384,166.65641864085194,0
"147.32.84.165",2947,"67.19.72.206",80,3,186,3,186,0,0,85124.769495,8.928299999999581,166.66106649642933,0
"147.32.84.165",2948,"193.23.181.44",179,3,186,3,186,0,0,85124.769712,8.928106999999727,166.66466922943974,0
"147.32.84.165",2949,"174.128.246.102",80,3,186,3,186,0,0,85124.769927,8.927914999992936,166.66825345012552,0
"147.32.84.165",2951,"67.19.72.206",80,3,186,3,186,0,0,85124.770201,8.927664999995613,166.67292063498473,0
"147.32.84.165",2952,"174.37.196.55",80,3,186,3,186,0,0,85124.77042,8.927467999994406,166.67659856086098,0
"147.32.84.165",2953,"67.19.72.206",80,3,186,3,186,0,0,85124.770635,8.927284000004875,166.68003392736105,0
"147.32.84.165",2954,"72.20.15.61",80,3,186,3,186,0,0,85124.770871,8.927077999993344,166.68388021266415,0
"147.32.84.165",2955,"67.19.72.206",80,3,186,3,186,0,0,85124.771086,8.926892000003136,166.68735322433355,0
"147.32.84.165",2956,"67.19.72.206",80,3,186,3,186,0,0,85124.771299,8.926707999999053,166.69078903445234,0
"147.32.84.165",2950,"193.23.181.44",80,3,186,3,186,0,0,85124.771638,8.92639799999597,166.69657794786562,0
"147.32.84.165",2957,"193.23.181.44",179,3,186,3,186,0,0,85124.8683,8.929590999992797,166.63697139109735,0
"147.32.84.165",2958,"174.128.246.102",80,3,186,3,186,0,0,85124.870387,8.927622999995947,166.6737047476888,0
"147.32.84.165",2959,"193.23.181.44",80,3,186,3,186,0,0,85124.871067,8.926991000000271,166.6855046678052,0
"147.32.84.165",2960,"72.20.15.61",80,3,186,3,186,0,0,85124.87129,8.926812000005157,166.6888470373455,0
"147.32.84.165",2961,"174.37.196.55",80,3,186,3,186,0,0,85124.871598,8.926552999997512,166.69368344089983,0
"147.32.84.165",2962,"193.23.181.44",80,3,186,3,186,0,0,85124.87187,8.926326999993762,166.69790385239526,0
"147.32.84.165",2963,"72.20.15.61",80,3,186,3,186,0,0,85124.872087,8.92615700000897,166.70107863871368,0
"147.32.84.165",2964,"193.23.181.44",179,3,186,3,186,0,0,85124.872301,8.925991000010981,166.70417884111347,0
"147.32.84.165",2965,"72.20.15.61",80,3,186,3,186,0,0,85124.872533,8.925806999992346,166.7076153451756,0
"147.32.84.165",2966,"72.20.15.61",80,3,186,3,186,0,0,85124.872748,8.925639000008232,166.71075314592352,0
"147.32.84.165",2967,"72.20.15.61",80,3,186,3,186,0,0,85124.872963,8.925470999995014,166.71389106533775,0
"147.32.84.165",2968,"174.128.246.102",80,3,186,3,186,0,0,85124.873234,8.925250000000233,166.718019103102,0
"147.32.84.165",2969,"72.20.15.61",80,3,186,3,186,0,0,85124.873451,8.925080999993952,166.72117597599487,0
"147.32.84.165",2970,"174.128.246.102",80,3,186,3,186,0,0,85124.873666,8.924914999995963,166.7242769259621,0
"147.32.84.165",2971,"174.37.196.55",80,3,186,3,186,0,0,85124.873934,8.924696000001859,166.72836811468872,0
"147.32.84.165",2972,"193.23.181.44",80,3,186,3,186,0,0,85124.87415,8.924528000003193,166.73150669698921,0
"147.32.84.165",2973,"67.19.72.206",80,3,186,3,186,0,0,85124.874376,8.924347999985912,166.7348695952185,0
"147.32.84.165",2974,"72.20.15.61",80,3,186,3,186,0,0,85124.874646,8.924125000005006,166.73903603985437,0
"147.32.84.165",2975,"67.19.72.206",80,3,186,3,186,0,0,85124.874862,8.923953999998048,166.74223107832307,0
"147.32.84.165",2976,"184.82.148.43",80,10,1919,5,979,5,940,85124.915422,0.32319599999755155,24232.973180544726,23267.61469837798
"147.32.84.165",2977,"174.128.246.102",80,3,186,3,186,0,0,85124.968645,8.929466000001412,166.6393040748198,0
"147.32.84.165",2978,"193.23.181.44",179,3,186,3,186,0,0,85124.968947,8.929221999991569,166.64385766211268,0
"147.32.84.165",2979,"72.20.15.61",80,7,558,4,376,3,182,85124.969856,0.36633699999947567,8211.018816019963,3974.482512009663
"147.32.84.165",2980,"72.20.15.61",80,8,650,5,468,3,182,85124.970208,3.3778929999971297,1108.3832436383218,431.03792808156953
"147.32.84.165",2981,"174.37.196.55",80,3,186,3,186,0,0,85124.970436,8.927754000003915,166.67125908703886,0
"147.32.84.165",2982,"174.37.196.55",80,3,186,3,186,0,0,85124.970656,8.929298999995808,166.64242064250493,0
"147.32.84.165",2983,"67.19.72.206",80,3,186,3,186,0,0,85124.970889,8.932266000003438,166.58706760405784,0
"147.32.84.165",2985,"193.23.181.44",179,3,186,3,186,0,0,85124.971138,8.93521700000565,166.53204952930176,0
"147.32.84.165",2987,"67.19.72.206",80,3,186,3,186,0,0,85124.971461,8.941341000012471,166.41799032135387,0
"147.32.84.165",2988,"193.23.181.44",179,3,186,3,186,0,0,85124.97171,8.944319000001997,166.36258165654286,0
"147.32.84.165",2989,"193.23.181.44",80,3,186,3,186,0,0,85124.971926,8.947259000007762,166.30791620078386,0
"147.32.84.165",2990,"67.19.72.206",80,3,186,3,186,0,0,85124.972144,8.950257000004058,166.25220929402647,0
"147.32.84.165",2991,"174.37.196.55",80,3,186,3,186,0,0,85124.972358,8.95319699999527,166.19761633758154,0
"147.32.84.165",2992,"174.37.196.55",80,3,186,3,186,0,0,85124.972575,8.956180999986827,166.1422429942169,0
"147.32.84.165",2993,"174.37.196.55",80,3,186,3,186,0,0,85124.972848,8.959107999995467,166.08796322142257,0
"147.32.84.165",2994,"193.23.181.44",80,3,186,3,186,0,0,85124.973067,8.962088000000222,166.0327370139596,0
"147.32.84.165",2995,"193.23.181.44",80,3,186,3,186,0,0,85124.973309,8.965107000010903,165.9768254855397,0
"147.32.84.165",2984,"174.128.246.102",80,3,186,3,186,0,0,85124.973527,8.96802800000296,165.92276473707585,0
"147.32.84.165",2986,"193.23.181.44",179,3,186,3,186,0,0,85124.973716,8.935840000005555,166.520439040882,0
"147.32.84.165",2996,"174.128.246.102",80,3,186,3,186,0,0,85125.021293,8.923460999998497,166.7514431900639,0
"147.32.84.165",2997,"193.23.181.44",179,3,186,3,186,0,0,85125.069037,8.929360000009183,166.64128224178103,0
"147.32.84.165",2998,"174.37.196.55",80,3,186,3,186,0,0,85125.069612,8.928907999987132,166.64971797247148,0
"147.32.84.165",2999,"67.19.72.206",80,3,186,3,186,0,0,85125.069723,8.928847000002861,166.65085648791197,0
"147.32.84.165",3000,"72.20.15.61",80,3,186,3,186,0,0,85125.069837,8.928776000000653,166.6521816652015,0
"147.32.84.165",3001,"174.128.246.102",80,3,186,3,186,0,0,85125.069955,8.928708000006736,166.6534508686898,0
"147.32.84.165",3002,"193.23.181.44",80,3,186,3,186,0,0,85125.070063,8.928646000000299,166.65460810070755,0
"147.32.84.165",3003,"193.23.181.44",179,3,186,3,186,0,0,85125.070169,8.928589999995893,166.65565335631769,0
"147.32.84.165",3004,"72.20.15.61",80,3,186,3,186,0,0,85125.070314,8.92849400000705,166.65744525323365,0
"147.32.84.165",3005,"72.20.15.61",80,3,186,3,186,0,0,85125.070422,8.928434000001289,166.65856520861163,0
"147.32.84.165",3006,"193.23.181.44",80,3,186,3,186,0,0,85125.070528,8.928375999996206,166.65964784644288,0
"147.32.84.165",3007,"174.37.196.55",80,3,186,3,186,0,0,85125.070635,8.928387000007206,166.65944251731014,0
"147.32.84.165",3008,"193.23.181.44",80,3,186,3,186,0,0,85125.070741,8.928354999996372,166.6600398394334,0
"147.32.84.165",3009,"72.20.15.61",80,3,186,3,186,0,0,85125.070847,8.928297000005841,166.66112249615202,0
"147.32.84.165",3010,"67.19.72.206",80,3,186,3,186,0,0,85125.070954,8.928238000007696,166.66222383394322,0
"147.32.84.165",3011,"67.19.72.206",80,3,186,3,186,0,0,85125.071061,8.928174000000581,166.6634185220744,0
"147.32.84.165",3012,"67.19.72.206",80,3,186,3,186,0,0,85125.071166,8.928112000008696,166.6645758922548,0
"147.32.84.165",3013,"72.20.15.61",80,3,186,3,186,0,0,85125.071272,8.92805600000429,166.66562127290476,0
"147.32.84.165",3014,"174.37.196.55",80,3,186,3,186,0,0,85125.07138,8.930996000010055,166.61075651565903,0
"147.32.84.165",3015,"193.23.181.44",80,3,186,3,186,0,0,85125.071489,8.934084000007715,166.55316874105,0
"147.32.84.165",3016,"184.82.148.44",80,10,1513,5,596,5,917,85125.137946,0.3405530000018189,14000.75759125462,21541.43407916189
"147.32.84.165",3017,"193.23.181.44",179,3,186,3,186,0,0,85125.153465,8.855311000006623,168.03475338120674,0
"147.32.84.165",3018,"174.37.196.55",80,3,186,3,186,0,0,85125.169419,8.929256999996142,166.64320446826014,0
"147.32.84.165",3019,"67.19.72.206",80,3,186,3,186,0,0,85125.169959,8.928776000000653,166.6521816652015,0
"147.32.84.165",3020,"193.23.181.44",179,3,186,3,186,0,0,85125.17018,8.928576000005705,166.6559146720652,0
"147.32.84.165",3021,"193.23.181.44",179,3,186,3,186,0,0,85125.170461,8.928320999999414,166.66067449860927,0
"147.32.84.165",3022,"67.19.72.206",80,3,186,3,186,0,0,85125.170733,8.92807099998754,166.6653412592795,0
"147.32.84.165",3023,"67.19.72.206",80,3,186,3,186,0,0,85125.170964,8.927867999998853,166.66913086082715,0
"147.32.84.165",3024,"72.20.15.61",80,3,186,3,186,0,0,85125.171178,8.927675999992061,166.67271527341754,0
"147.32.84.165",3025,"67.19.72.206",80,3,186,3,186,0,0,85125.171415,8.927461999992374,166.67671058149236,0
"147.32.84.165",3026,"67.19.72.206",80,3,186,3,186,0,0,85125.26917,8.9299469999969,166.630328265164,0
"147.32.84.165",3027,"217.163.21.36",80,14,6134,7,809,7,5325,85125.377776,0.18849600000248756,34334.94609919887,225999.49070239055
"147.32.84.165",3028,"217.163.21.36",80,10,1446,5,698,5,748,85125.528815,0.1388089999963995,40227.93911161985,43109.59664110552
"147.32.84.165",3029,"217.163.21.35",80,9,3074,5,1507,4,1567,85125.622272,0.24785200000042096,48641.9314751526,50578.57108265702
"147.32.84.165",3030,"174.37.196.55",80,3,186,3,186,0,0,85125.770178,8.930630999995628,166.61756599289888,0
"147.32.84.165",3031,"72.20.15.61",80,3,186,3,186,0,0,85125.77044,8.930471000014222,166.62055114423757,0
"147.32.84.165",3032,"217.163.21.36",80,10,2272,5,1153,5,1119,85125.824404,0.14186099999642465,65021.39418326724,63104.02436346578
"147.32.84.165",3033,"217.163.21.35",80,13,4215,7,2076,6,2139,85125.921308,0.40949499999987893,40557.27176157196,41788.05602023238
"147.32.84.165",3034,"193.23.181.44",80,3,186,3,186,0,0,85126.089961,8.810889999993378,168.88191771786032,0
"147.32.84.165",3035,"217.70.144.134",80,7,1634,5,1022,2,612,85126.327578,62.453928000002634,130.91250241297323,78.39378813770999
"147.32.84.165",3036,"193.23.181.44",179,3,186,3,186,0,0,85126.397959,8.704163000002154,170.9526809182723,0
"147.32.84.165",3037,"174.37.196.55",80,3,186,3,186,0,0,85126.401159,8.701012000004994,171.014590026901,0
"147.32.84.165",3038,"72.20.15.61",80,3,186,3,186,0,0,85126.422408,8.679806000000099,171.4324029822767,0
"147.32.84.165",3039,"220.194.21.2",6667,2,124,2,124,0,0,85126.425579,2.756526999990456,359.8731302118335,0
"147.32.84.165",3040,"193.23.181.44",179,3,186,3,186,0,0,85126.447605,8.654659000007086,171.93051742405814,0
"147.32.84.165",3041,"72.20.15.61",80,3,186,3,186,0,0,85126.514809,8.687405999997281,171.28242884014693,0
"147.32.84.165",3042,"67.19.72.206",80,3,186,3,186,0,0,85126.518025,8.68424899999809,171.34469543656883,0
"147.32.84.165",3043,"174.37.196.55",80,3,186,3,186,0,0,85126.611577,8.691116999994847,171.2092933510022,0
"147.32.84.165",3044,"217.110.110.231",80,8,1754,5,1021,3,733,85126.785191,0.23915999999735504,34152.86837301528,24519.15035986307
"147.32.84.165",3045,"174.37.196.55",80,8,661,5,479,3,182,85126.80556,3.120459000012488,1228.0244669084466,466.59802291719683
"147.32.84.165",3046,"193.23.181.44",179,3,186,3,186,0,0,85126.885609,8.819220999997924,168.72238489095014,0
"147.32.84.165",3047,"217.110.110.231",80,44,53309,28,2581,16,50728,85127.004835,61.77657000000181,334.23675027602525,6569.221955831929
"147.32.84.165",3048,"193.23.181.44",179,3,186,3,186,0,0,85127.171161,8.833585999993375,168.44801194001124,0
"147.32.84.165",3049,"193.23.181.44",80,3,186,3,186,0,0,85127.340759,8.864367999995011,167.86306705687733,0
"147.32.84.165",3050,"174.37.196.55",80,3,186,3,186,0,0,85127.343989,8.861181999993278,167.9234215030375,0
"147.32.84.165",3051,"193.23.181.44",80,3,186,3,186,0,0,85127.424011,8.882051000007777,167.52887368004272,0
"147.32.84.165",3052,"72.20.15.61",80,3,186,3,186,0,0,85127.430635,8.875448000006145,167.6535088706474,0
"147.32.84.165",3053,"193.23.181.44",179,3,186,3,186,0,0,85127.77958,8.927859000003082,166.66929887663844,0
"147.32.84.165",3054,"174.128.246.102",80,3,186,3,186,0,0,85127.779949,8.92751500000304,166.6757210712604,0
"147.32.84.165",3055,"174.128.246.102",80,3,186,3,186,0,0,85127.780248,8.927239000011468,166.68087411999258,0
"147.32.84.165",3056,"67.19.72.206",80,3,186,3,186,0,0,85127.780496,8.92701399998623,166.68507521129632,0
"147.32.84.165",3057,"193.23.181.44",179,3,186,3,186,0,0,85127.780746,8.926788999990094,166.68927651383393,0
"147.32.84.165",3058,"193.23.181.44",179,3,186,3,186,0,0,85128.079713,8.928348000001279,166.66017050408283,0
"147.32.84.165",3059,"174.37.196.55",80,3,186,3,186,0,0,85128.163601,8.844584000005852,168.2385514116905,0
"147.32.84.165",3060,"67.19.72.206",80,3,186,3,186,0,0,85129.805536,8.907961999997497,167.0415747171371,0
"147.32.84.165",3061,"174.37.196.55",80,3,186,3,186,0,0,85132.311704,8.80904899998859,168.91721228953628,0
"147.32.84.165",3062,"174.128.246.102",80,3,186,3,186,0,0,85132.795207,8.928161000003456,166.6636611951133,0
"147.32.84.165",3063,"67.19.72.206",80,3,186,3,186,0,0,85132.797525,8.925963000001502,166.7047017783683,0
"147.32.84.165",3064,"193.23.181.44",80,11,1045,7,601,4,444,85132.800724,9.064310999994632,530.4319324439384,391.8665191432756
"147.32.84.165",3065,"174.37.196.55",80,3,186,3,186,0,0,85132.803924,8.919654999990598,166.82259571716264,0
"147.32.84.165",3066,"184.82.148.43",80,10,1919,5,979,5,940,85133.139879,0.3037600000097882,25783.51329914283,24756.386620218855
"147.32.84.165",3067,"174.37.196.55",80,3,186,3,186,0,0,85133.199858,9.024944999997388,164.87635104706243,0
"147.32.84.165",3068,"174.128.246.102",80,3,186,3,186,0,0,85133.25465,8.970272999998997,165.88123906598676,0
"147.32.84.165",3069,"67.19.72.206",80,3,186,3,186,0,0,85133.324677,9.000320000006468,165.32745502370256,0
"147.32.84.165",3070,"184.82.148.44",80,10,1514,5,596,5,918,85133.350163,0.33922700000402983,14055.484970074194,21649.220138469984
"147.32.84.165",3071,"67.19.72.206",80,3,186,3,186,0,0,85133.456428,8.974702999999863,165.79935848573737,0
"147.32.84.165",3072,"217.163.21.36",80,14,6141,7,810,7,5331,85133.589369,0.18732400001317728,34592.4707968235,227669.70594798282
"147.32.84.165",3073,"193.23.181.44",179,13,970,7,610,6,360,85133.698345,9.236564000006183,528.3349955672621,311.80425967903994
"147.32.84.165",3074,"72.20.15.61",80,3,186,3,186,0,0,85133.698473,9.02778699999908,164.82444701012017,0
"147.32.84.165",3075,"193.23.181.44",80,10,988,7,602,3,386,85133.698609,9.152897000007215,526.1722053680057,337.37952038546547
"147.32.84.165",3076,"217.163.21.36",80,10,1451,5,701,5,750,85133.734913,0.14016900000569876,40008.846462284804,42805.47053739458
"147.32.84.165",3077,"174.128.246.102",80,3,186,3,186,0,0,85133.819985,9.007144000002882,165.20219949847854,0
"147.32.84.165",3078,"217.163.21.35",80,9,3115,5,1545,4,1570,85133.829888,0.2780650000058813,44450.03865908538,45169.29494806734
"147.32.84.165",3079,"217.163.21.36",80,10,2277,5,1156,5,1121,85134.064182,0.14079499999934342,65684.1507158857,63695.44373054314
"147.32.84.165",3080,"217.163.21.35",80,13,4661,7,2114,6,2547,85134.158772,0.19880600000033155,85067.85509477479,102491.87650255032
"147.32.84.165",3081,"67.19.72.206",80,3,186,3,186,0,0,85134.199404,9.028648000006797,164.80872883723896,0
"147.32.84.165",3082,"173.241.240.4",80,9,2195,5,1165,4,1030,85134.284872,0.09244100000069011,100821.06424563151,89137.93662918494
"147.32.84.165",3083,"92.240.244.181",80,10,1760,6,1366,4,394,85134.286442,5.058845000006841,2160.176878316142,623.0671230282284
"147.32.84.165",3084,"182.177.235.90",6667,2,124,2,124,0,0,85136.187079,2.9274050000094576,338.8666754332917,0
"147.32.84.165",3085,"72.20.15.61",80,3,186,3,186,0,0,85136.80821,9.027892999991309,164.82251174237803,0
"147.32.84.165",3086,"174.37.196.55",80,3,186,3,186,0,0,85141.021595,9.028310000008787,164.81489891226062,0
"147.32.84.165",3087,"193.23.181.44",80,8,822,5,438,3,384,85141.021734,0.12570899999991525,27873.89924350971,24437.391117597555
"147.32.84.165",3088,"174.128.246.102",80,3,186,3,186,0,0,85141.085238,8.964695000002393,165.98445345877386,0
"147.32.84.165",3089,"174.128.246.102",80,7,561,4,379,3,182,85141.121147,0.3145210000075167,9640.055830699821,4629.2616390168005
"147.32.84.165",3090,"193.23.181.44",80,8,863,5,477,3,386,85141.279493,0.12537600001087412,30436.447164282083,24629.913218894933
"147.32.84.165",3091,"174.128.246.102",80,3,186,3,186,0,0,85141.342503,9.008225999990827,165.18235665951488,0
"147.32.84.165",3092,"184.82.148.43",80,10,1919,5,979,5,940,85141.349128,0.3224449999979697,24289.41369861314,23321.80681991456
"147.32.84.165",3093,"184.82.148.44",80,10,1513,5,596,5,917,85141.572123,0.32253900000068825,14782.70844762905,22744.536319590334
"147.32.84.165",3094,"174.128.246.102",80,3,186,3,186,0,0,85141.72425,9.049606999993557,164.42702981478195,0
"147.32.84.165",3095,"67.19.72.206",80,3,186,3,186,0,0,85141.724508,9.052498000004562,164.37451850298672,0
"147.32.84.165",3096,"193.23.181.44",80,8,866,5,482,3,384,85141.724766,0.12659100000746548,30460.301283445104,24267.12799345004
"147.32.84.165",3097,"67.19.72.206",80,3,186,3,186,0,0,85141.725165,9.055011000004015,164.32890031821498,0
"147.32.84.165",3098,"174.37.196.55",80,3,186,3,186,0,0,85141.789574,8.993802000011783,165.44727135398918,0
"147.32.84.165",3099,"174.128.246.102",80,3,186,3,186,0,0,85141.794579,8.991996000011568,165.48050065837282,0
"147.32.84.165",3100,"217.163.21.36",80,14,6137,7,809,7,5328,85141.800262,0.18740799999795854,34534.278152856336,227439.59703141972
"147.32.84.165",3101,"217.163.21.36",80,10,1448,5,699,5,749,85141.946249,0.14044400000420865,39816.581696850175,42664.691975594826
"147.32.84.165",3102,"217.163.21.35",80,9,3122,5,1554,4,1568,85142.040078,0.2539639999886276,48951.81994517608,49392.82733206956
"147.32.84.165",3103,"217.163.21.36",80,10,2274,5,1154,5,1120,85142.252348,0.13938800001051277,66232.38728802848,64280.99979427375
"147.32.84.165",3104,"72.20.15.61",80,3,186,3,186,0,0,85142.32528,9.028393000000506,164.81338373284333,0
"147.32.84.165",3105,"193.23.181.44",179,10,785,5,485,5,300,85142.325443,0.1985220000060508,19544.43336195354,12089.340223888787
"147.32.84.165",3106,"217.163.21.35",80,13,4687,7,2123,6,2564,85142.346367,0.229114000001573,74129.03619981055,89527.48413392098
"147.32.84.165",3107,"193.23.181.44",80,10,979,6,535,4,444,85142.42468,0.20663800000329502,20712.550450216087,17189.48112130083
"147.32.84.165",3108,"173.241.240.4",80,9,2194,5,1164,4,1030,85142.459146,0.13618100000894628,68379.58305041274,60507.70665113842
"147.32.84.165",3109,"92.240.244.181",80,10,1764,6,1314,4,450,85142.460639,5.08140199999616,2068.72040433092,708.4658918941506
"147.32.84.165",3110,"193.23.181.44",80,8,931,5,547,3,384,85142.57228,0.12509900001168717,34980.29560261217,24556.551209146382
"147.32.84.165",3111,"193.23.181.44",80,8,863,5,479,3,384,85142.626913,0.1235339999984717,31019.800217328084,24867.647773390363
"147.32.84.165",3112,"67.19.72.206",80,3,186,3,186,0,0,85142.635404,9.019771000006585,164.97092886270767,0
"147.32.84.165",3113,"174.128.246.102",80,8,608,4,366,4,242,85142.689116,0.3321400000131689,8815.559703389861,5828.867344864335
"147.32.84.165",3114,"67.19.72.206",80,3,186,3,186,0,0,85142.790407,8.964446000012686,165.98906390845505,0
"147.32.84.165",3115,"67.19.72.206",80,3,186,3,186,0,0,85142.793724,8.961152000003494,166.05007927545697,0
"147.32.84.165",3116,"193.23.181.44",80,8,852,5,468,3,384,85142.827515,0.12552200000209268,29827.440607523626,24473.797421557847
"147.32.84.165",3117,"174.128.246.102",80,3,186,3,186,0,0,85142.855729,9.000505000003614,165.32405681674558,0
"147.32.84.165",3118,"193.23.181.44",80,8,808,5,424,3,384,85142.891242,0.14158100000349805,23958.016964961356,21697.82668524802
"147.32.84.165",3119,"174.128.246.102",80,3,186,3,186,0,0,85142.96277,8.992805000001681,165.46561389908064,0
"147.32.84.165",3120,"193.23.181.44",179,10,728,5,428,5,300,85143.931282,0.44346899999072775,7720.9455453968385,5411.877718736102
"147.32.84.165",3121,"174.128.246.102",80,6,541,4,419,2,122,85143.932035,0.5511369999876479,6081.97235909606,1770.8845532451535
"147.32.84.165",3122,"193.23.181.44",179,10,776,5,476,5,300,85143.932386,0.4205999999976484,9053.732762770544,5706.134094183116
"147.32.84.165",3123,"193.23.181.44",179,11,818,5,458,6,360,85143.93251,0.42433799999707844,8634.626170706433,6787.042404922087
"147.32.84.165",3124,"174.37.196.55",80,3,186,3,186,0,0,85143.932626,9.026551000002655,164.84701631880907,0
"147.32.84.165",3125,"174.128.246.102",80,3,186,3,186,0,0,85143.932742,9.02649499999825,164.84803902293066,0
"147.32.84.165",3126,"174.128.246.102",80,3,186,3,186,0,0,85143.932859,9.026408000005176,164.84962789175347,0
"147.32.84.165",3127,"174.128.246.102",80,7,565,4,383,3,182,85143.933003,0.5626279999996768,5445.87187271476,2587.8555635354733
"147.32.84.165",3129,"174.37.196.55",80,3,186,3,186,0,0,85143.93312,9.026171000004979,164.85395634529627,0
"147.32.84.165",3130,"193.23.181.44",80,8,810,5,424,3,386,85143.933238,0.36770000000251457,9224.91161266468,8398.15066624662
"147.32.84.165",3131,"72.20.15.61",80,9,756,5,514,4,242,85143.933355,3.473606999992626,1183.7838880474185,557.3457216098741
"147.32.84.165",3132,"193.23.181.44",179,11,816,5,456,6,360,85143.933472,0.4277670000010403,8528.007069248279,6732.637159932851
"147.32.84.165",3133,"67.19.72.206",80,3,186,3,186,0,0,85143.93359,9.02572799999325,164.86204769311823,0
"147.32.84.165",3135,"72.20.15.61",80,9,719,5,477,4,242,85143.949031,3.4411610000097426,1108.9280623572092,562.6008198961104
"147.32.84.165",3136,"193.23.181.44",179,10,751,5,451,5,300,85143.949165,0.41850699999486096,8621.12222745212,5734.671104735335
"147.32.84.165",3137,"72.20.15.61",80,7,597,4,415,3,182,85143.949282,0.604605000000447,5491.1884618842805,2408.183855573347
"147.32.84.165",3138,"193.23.181.44",80,10,983,6,537,4,446,85143.949401,0.40591899999708403,10583.392253210273,8789.930996148569
"147.32.84.165",3134,"67.19.72.206",80,3,186,3,186,0,0,85143.949519,9.009823000000324,165.1530779239444,0
"147.32.84.165",3140,"72.20.15.61",80,7,544,4,362,3,182,85143.969164,0.6626680000044871,4370.2125347540405,2197.1786776940203
"147.32.84.165",3141,"193.23.181.44",179,3,186,3,186,0,0,85143.969303,8.990062999990187,165.5160814781414,0
"147.32.84.165",3139,"174.128.246.102",80,3,186,3,186,0,0,85143.96941,8.989981999999145,165.5175727826976,0
"147.32.84.165",3142,"67.19.72.206",80,3,186,3,186,0,0,85143.989373,8.970040999993216,165.88552939737124,0
"147.32.84.165",3144,"67.19.72.206",80,3,186,3,186,0,0,85143.999288,8.960147999998298,166.06868547263758,0
"147.32.84.165",3145,"72.20.15.61",80,7,544,4,362,3,182,85143.999727,0.6492829999915557,4460.304674599002,2242.4736209309904
"147.32.84.165",3146,"72.20.15.61",80,3,186,3,186,0,0,85143.999836,8.959621999994852,166.0784350055008,0
"147.32.84.165",3147,"193.23.181.44",179,3,186,3,186,0,0,85143.999944,8.959537000002456,166.08001060764548,0
"147.32.84.165",3143,"174.37.196.55",80,3,186,3,186,0,0,85144.002907,8.956596000003628,166.1345448649685,0
"147.32.84.165",3148,"67.19.72.206",80,3,186,3,186,0,0,85144.006113,8.95341400000325,166.19358827810933,0
"147.32.84.165",3149,"193.23.181.44",179,3,186,3,186,0,0,85144.025307,8.934242999996059,166.55020464527956,0
"147.32.84.165",3150,"193.23.181.44",80,3,186,3,186,0,0,85144.045684,8.913893000004464,166.9304309575238,0
"147.32.84.165",3151,"193.23.181.44",80,3,186,3,186,0,0,85144.067363,8.892237000007299,167.3369704382349,0
"147.32.84.165",3152,"193.23.181.44",179,3,186,3,186,0,0,85144.076905,8.982400000008056,165.65728535788492,0
"147.32.84.165",3153,"193.23.181.44",80,3,186,3,186,0,0,85144.080087,8.979266000009375,165.71510410744557,0
"147.32.84.165",3154,"193.23.181.44",80,3,186,3,186,0,0,85144.083307,8.976090000011027,165.77373889947316,0
"147.32.84.165",3155,"174.37.196.55",80,3,186,3,186,0,0,85144.086502,8.972945000001346,165.83184227695332,0
"147.32.84.165",3156,"193.23.181.44",179,3,186,3,186,0,0,85144.089711,8.969783000007737,165.89030080200564,0
"147.32.84.165",3157,"67.19.72.206",80,3,186,3,186,0,0,85144.092906,8.966633999996702,165.94855996135755,0
"147.32.84.165",3158,"72.20.15.61",80,3,186,3,186,0,0,85144.096088,8.963499999998021,166.00658225027374,0
"147.32.84.165",3159,"67.19.72.206",80,3,186,3,186,0,0,85144.099288,8.960346000007121,166.06501579278495,0
"147.32.84.165",3160,"193.23.181.44",80,3,186,3,186,0,0,85144.102489,8.957192000001669,166.12349048671982,0
"147.32.84.165",3161,"193.23.181.44",80,3,186,3,186,0,0,85144.105687,8.954041999997571,166.1819321375088,0
"147.32.84.165",3162,"174.128.246.102",80,3,186,3,186,0,0,85144.108903,8.950868999992963,166.240842090435,0
"147.32.84.165",3163,"72.20.15.61",80,3,186,3,186,0,0,85144.112084,8.947738000002573,166.29901322541764,0
"147.32.84.165",3164,"67.19.72.206",80,3,186,3,186,0,0,85144.115336,8.94453199999407,166.35861999274937,0
"147.32.84.165",3165,"174.128.246.102",80,3,186,3,186,0,0,85144.118485,8.941430000006221,166.416333852523,0
"147.32.84.165",3166,"67.19.72.206",80,3,186,3,186,0,0,85144.121721,8.938236999994842,166.47578264045345,0
"147.32.84.165",3167,"193.23.181.44",179,3,186,3,186,0,0,85144.124916,8.935087000005296,166.53447246782466,0
"147.32.84.165",3168,"193.23.181.44",80,3,186,3,186,0,0,85144.128085,8.93195499999274,166.5928679668907,0
"147.32.84.165",3169,"193.23.181.44",80,3,186,3,186,0,0,85144.131285,8.928803000002517,166.6516777220396,0
"147.32.84.165",3170,"193.23.181.44",179,3,186,3,186,0,0,85144.134484,8.925646000003326,166.71062240194667,0
"147.32.84.165",3171,"72.20.15.61",80,3,186,3,186,0,0,85144.137686,8.922491000004811,166.76957141219842,0
"147.32.84.165",3172,"174.37.196.55",80,3,186,3,186,0,0,85144.140885,8.919339999993099,166.82848730972822,0
"147.32.84.165",3174,"174.128.246.102",80,6,544,4,422,2,122,85144.144113,0.5588500000012573,6040.97700633874,1746.4435895102517
"147.32.84.165",3175,"174.128.246.102",80,3,186,3,186,0,0,85144.147313,8.912956000000122,166.94797999675748,0
"147.32.84.165",3176,"174.37.196.55",80,3,186,3,186,0,0,85144.150516,8.909800000008545,167.00711576001402,0
"147.32.84.165",3177,"193.23.181.44",80,3,186,3,186,0,0,85144.153685,8.906677999999374,167.0656556799409,0
"147.32.84.165",3178,"174.128.246.102",80,3,186,3,186,0,0,85144.156916,8.903493999998318,167.12540043271565,0
"147.32.84.165",3179,"193.23.181.44",80,3,186,3,186,0,0,85144.160085,8.902301000009174,167.14779695704138,0
"147.32.84.165",3180,"174.128.246.102",80,3,186,3,186,0,0,85144.163285,8.90232300000207,167.14738389066022,0
"147.32.84.165",3181,"72.20.15.61",80,3,186,3,186,0,0,85144.166485,8.90232300000207,167.14738389066022,0
"147.32.84.165",3182,"193.23.181.44",179,3,186,3,186,0,0,85144.169751,8.90225700000883,167.1486230962018,0
"147.32.84.165",3183,"174.128.246.102",80,3,186,3,186,0,0,85144.172884,8.902304000002914,167.14774062978674,0
"147.32.84.165",3184,"174.128.246.102",80,3,186,3,186,0,0,85144.176085,8.902327999996487,167.14729001229648,0
"147.32.84.165",3185,"193.23.181.44",179,3,186,3,186,0,0,85144.179285,8.90230599998904,167.14770307848687,0
"147.32.84.165",3186,"193.23.181.44",179,3,186,3,186,0,0,85144.182485,8.902302000002237,167.14777818137668,0
"147.32.84.165",3187,"174.128.246.102",80,8,668,6,546,2,122,85144.185687,9.26801400000113,471.2983817244414,105.30842961608398
"147.32.84.165",3173,"67.19.72.206",80,3,186,3,186,0,0,85144.188902,8.902284000010695,167.1481161461724,0
"147.32.84.165",3189,"193.23.181.44",80,3,186,3,186,0,0,85144.192106,8.902312999998685,167.14757164797732,0
"147.32.84.165",3190,"193.23.181.44",179,3,186,3,186,0,0,85144.195286,8.90231700000004,167.14749654499985,0
"147.32.84.165",3191,"174.37.196.55",80,3,186,3,186,0,0,85144.198504,8.902281999995466,167.1481536982043,0
"147.32.84.165",3192,"193.23.181.44",80,3,186,3,186,0,0,85144.201707,8.902302000002237,167.14777818137668,0
"147.32.84.165",3188,"193.23.181.44",80,3,186,3,186,0,0,85144.204938,8.902258000001893,167.14860432035147,0
"147.32.84.165",3194,"72.20.15.61",80,3,186,3,186,0,0,85144.208103,8.902285000003758,167.148097370436,0
"147.32.84.165",3195,"174.128.246.102",80,3,186,3,186,0,0,85144.211335,8.90225400000054,167.14867942432443,0
"147.32.84.165",3196,"174.128.246.102",80,3,186,3,186,0,0,85144.214538,8.902264999996987,167.14847288869782,0
"147.32.84.165",3193,"67.19.72.206",80,3,186,3,186,0,0,85144.217735,8.9022510000068,167.14873575221182,0
"147.32.84.165",3198,"174.37.196.55",80,3,186,3,186,0,0,85144.22089,8.90229700000782,167.14787206028882,0
"147.32.84.165",3199,"193.23.181.44",80,3,186,3,186,0,0,85144.224137,8.902249000006123,167.14877330424892,0
"147.32.84.165",3200,"193.23.181.44",80,3,186,3,186,0,0,85144.227334,8.9022510000068,167.14873575221182,0
"147.32.84.165",3197,"67.19.72.206",80,3,186,3,186,0,0,85144.23053,8.902254999993602,167.1486606484615,0
"147.32.84.165",3201,"193.23.181.44",80,3,186,3,186,0,0,85144.233688,8.90229700000782,167.14787206028882,0
"147.32.84.165",3202,"174.128.246.102",80,3,186,3,186,0,0,85144.236886,8.902299000008497,167.14783450865667,0
"147.32.84.165",3203,"72.20.15.61",80,3,186,3,186,0,0,85144.240107,8.902277999994112,167.14822880177232,0
"147.32.84.165",3204,"193.23.181.44",80,3,186,3,186,0,0,85144.243287,8.902298000000883,167.14785328460724,0
"147.32.84.165",3205,"174.128.246.102",80,3,186,3,186,0,0,85144.246506,8.902279000001727,167.1482100257374,0
"147.32.84.165",3206,"174.37.196.55",80,3,186,3,186,0,0,85144.249687,8.902298000000883,167.14785328460724,0
"147.32.84.165",3207,"193.23.181.44",179,3,186,3,186,0,0,85144.252909,8.902304000002914,167.14774062978674,0
"147.32.84.165",3208,"174.37.196.55",80,3,186,3,186,0,0,85144.256107,8.90227700000105,167.14824757753826,0
"147.32.84.165",3209,"72.20.15.61",80,3,186,3,186,0,0,85144.259287,8.902298000000883,167.14785328460724,0
"147.32.84.165",3210,"193.23.181.44",179,3,186,3,186,0,0,85144.262532,8.902253000007477,167.1486982001916,0
"147.32.84.165",3211,"72.20.15.61",80,3,186,3,186,0,0,85144.265685,8.902299999987008,167.14781573325675,0
"147.32.84.165",3212,"174.128.246.102",80,3,186,3,186,0,0,85144.268887,8.902329999997164,167.14725246092584,0
"147.32.84.165",3214,"174.37.196.55",80,3,186,3,186,0,0,85144.272095,8.90232000000833,167.14744021767444,0
"147.32.84.165",3215,"67.19.72.206",80,3,186,3,186,0,0,85144.275286,8.902329999997164,167.14725246092584,0
"147.32.84.165",3216,"72.20.15.61",80,3,186,3,186,0,0,85144.278507,8.902308000004268,167.14766552665742,0
"147.32.84.165",3217,"67.19.72.206",80,3,186,3,186,0,0,85144.281704,8.902328000011039,167.14729001202323,0
"147.32.84.165",3218,"67.19.72.206",80,3,186,3,186,0,0,85144.284903,8.90231199999107,167.14759042386882,0
"147.32.84.165",3213,"72.20.15.61",80,3,186,3,186,0,0,85144.288137,8.902247999998508,167.1487920804104,0
"147.32.84.165",3219,"67.19.72.206",80,3,186,3,186,0,0,85144.328939,8.86464800000249,167.8577649106408,0
"147.32.84.165",3220,"72.20.15.61",80,3,186,3,186,0,0,85144.34892,8.84786599999643,168.17614552487578,0
"147.32.84.165",3221,"193.23.181.44",179,3,186,3,186,0,0,85144.358519,8.841482999996515,168.2975582264408,0
"147.32.84.165",3222,"193.23.181.44",80,3,186,3,186,0,0,85144.361709,8.841497000001254,168.29729173688446,0
"147.32.84.165",3223,"174.128.246.102",80,3,186,3,186,0,0,85144.368105,8.838327999998,168.35763506404567,0
"147.32.84.165",3225,"193.23.181.44",80,3,186,3,186,0,0,85144.386485,8.82311800000025,168.6478634877101,0
"147.32.84.165",3224,"67.19.72.206",80,3,186,3,186,0,0,85144.389687,8.823115999999573,168.64790171636326,0
"147.32.84.165",3226,"72.20.15.61",80,3,186,3,186,0,0,85144.392923,8.823108999989927,168.6480355169248,0
"147.32.84.165",3227,"67.19.72.206",80,3,186,3,186,0,0,85144.396136,8.823071000006166,168.64876186522358,0
"147.32.84.165",3228,"174.128.246.102",80,3,186,3,186,0,0,85144.399317,8.82311800000025,168.6478634877101,0
"147.32.84.165",3229,"72.20.15.61",80,3,186,3,186,0,0,85144.402535,8.823055999993812,168.64904858373828,0
"147.32.84.165",3230,"193.23.181.44",179,3,186,3,186,0,0,85144.405709,8.823128000003635,168.6476723447044,0
"147.32.84.165",3231,"174.128.246.102",80,3,186,3,186,0,0,85144.408887,8.823147000002791,168.64730917432627,0
"147.32.84.165",3232,"193.23.181.44",80,3,186,3,186,0,0,85144.412133,8.823097999993479,168.6482457750214,0
"147.32.84.165",3233,"72.20.15.61",80,3,186,3,186,0,0,85144.415339,8.82306900000549,168.648800094284,0
"147.32.84.165",3234,"193.23.181.44",80,3,186,3,186,0,0,85144.418537,8.823065999997198,168.6488574380462,0
"147.32.84.165",3235,"174.37.196.55",80,3,186,3,186,0,0,85144.421751,8.823082000002614,168.64855160584014,0
"147.32.84.165",3236,"67.19.72.206",80,3,186,3,186,0,0,85144.424936,8.82305500000075,168.64906769819225,0
"147.32.84.165",3237,"193.23.181.44",179,3,186,3,186,0,0,85144.428139,8.823046999998041,168.64922061509253,0
"147.32.84.165",3238,"193.23.181.44",179,3,186,3,186,0,0,85144.43131,8.823076999993646,168.64864717842445,0
"147.32.84.165",3239,"174.37.196.55",80,3,186,3,186,0,0,85144.434485,8.823150999989593,168.64723271785275,0
"147.32.84.165",3240,"67.19.72.206",80,3,186,3,186,0,0,85144.437707,8.823103000002448,168.64815020289203,0
"147.32.84.165",3241,"67.19.72.206",80,3,186,3,186,0,0,85144.440935,8.823072999992291,168.64872363645864,0
"147.32.84.165",3242,"67.19.72.206",80,3,186,3,186,0,0,85144.459707,8.807526999997208,168.94640232161328,0
"147.32.84.165",3243,"174.128.246.102",80,3,186,3,186,0,0,85144.478506,8.791903000004822,169.2466352277981,0
"147.32.84.165",3244,"174.128.246.102",80,3,186,3,186,0,0,85144.481706,8.81670199999644,168.77059018220203,0
"147.32.84.165",3245,"193.23.181.44",80,3,186,3,186,0,0,85144.484907,8.816681999989669,168.7709730261048,0
"147.32.84.165",3246,"67.19.72.206",80,3,186,3,186,0,0,85144.488141,8.816662000012002,168.77135587118735,0
"147.32.84.165",3247,"174.128.246.102",80,3,186,3,186,0,0,85144.491336,8.816660999989836,168.77137501393275,0
"147.32.84.165",3248,"174.128.246.102",80,3,186,3,186,0,0,85144.494504,8.816708999991533,168.77045618738566,0
"147.32.84.165",3249,"174.128.246.102",80,3,186,3,186,0,0,85144.497687,8.816728999998304,168.7700733458277,0
"147.32.84.165",3250,"67.19.72.206",80,3,186,3,186,0,0,85144.500885,8.816747000004398,168.76972878991057,0
"147.32.84.165",3252,"193.23.181.44",80,3,186,3,186,0,0,85144.504085,8.816754000014043,168.76959479618347,0
"147.32.84.165",3253,"174.37.196.55",80,3,186,3,186,0,0,85144.507285,8.816755000007106,168.769575654399,0
"147.32.84.165",3254,"193.23.181.44",179,3,186,3,186,0,0,85144.510484,8.816737000001012,168.76992020969087,0
"147.32.84.165",3255,"72.20.15.61",80,3,186,3,186,0,0,85144.513685,8.816726999997627,168.77011162990536,0
"147.32.84.165",3256,"72.20.15.61",80,3,186,3,186,0,0,85144.516885,8.816699999995762,168.77062846651413,0
"147.32.84.165",3257,"72.20.15.61",80,3,186,3,186,0,0,85144.520118,8.816667000006419,168.77126015975387,0
"147.32.84.165",3258,"174.128.246.102",80,3,186,3,186,0,0,85144.523284,8.816701000003377,168.77060932421662,0
"147.32.84.165",3259,"72.20.15.61",80,3,186,3,186,0,0,85144.526519,8.816665999998804,168.77127930219902,0
"147.32.84.165",3251,"67.19.72.206",80,3,186,3,186,0,0,85144.529721,8.816716000001179,168.77032219250353,0
"147.32.84.165",3260,"67.19.72.206",80,3,186,3,186,0,0,85144.532885,8.816732999999658,168.76999677772454,0
"147.32.84.165",3261,"174.128.246.102",80,3,186,3,186,0,0,85144.536085,8.816751000005752,168.76965222212007,0
"147.32.84.165",3263,"67.19.72.206",80,3,186,3,186,0,0,85144.539287,8.816725999990012,168.77013077208994,0
"147.32.84.165",3262,"193.23.181.44",80,3,186,3,186,0,0,85144.542485,8.816730999998981,168.77003506176746,0
"147.32.84.165",3264,"174.128.246.102",80,3,186,3,186,0,0,85144.564085,8.798299999994924,169.1235806918221,0
"147.32.84.165",3265,"193.23.181.44",179,3,186,3,186,0,0,85144.570484,8.795129999998608,169.18453735194768,0
"147.32.84.165",3266,"193.23.181.44",179,3,186,3,186,0,0,85144.573708,8.79512799999793,169.18457582429158,0
"147.32.84.165",3267,"174.128.246.102",80,3,186,3,186,0,0,85144.576904,8.795132999992347,169.18447964360456,0
"147.32.84.165",3268,"193.23.181.44",80,3,186,3,186,0,0,85144.580086,8.795100000003004,169.1851144386638,0
"147.32.84.165",3269,"67.19.72.206",80,3,186,3,186,0,0,85144.583286,8.795098000002326,169.18515291127017,0
"147.32.84.165",3270,"193.23.181.44",80,3,186,3,186,0,0,85144.58651,8.795125000004191,169.18463353270033,0
"147.32.84.165",3271,"193.23.181.44",80,3,186,3,186,0,0,85144.589708,8.795127000004868,169.18459506033017,0
"147.32.84.165",3272,"174.37.196.55",80,3,186,3,186,0,0,85144.592903,8.795089000006556,169.18532603807543,0
"147.32.84.165",3273,"193.23.181.44",80,3,186,3,186,0,0,85144.596105,8.79512799999793,169.18457582429158,0
"147.32.84.165",3274,"72.20.15.61",80,3,186,3,186,0,0,85144.599309,8.795125000004191,169.18463353270033,0
"147.32.84.165",3275,"67.19.72.206",80,3,186,3,186,0,0,85144.602525,8.795110000006389,169.18492207589435,0
"147.32.84.165",3276,"72.20.15.61",80,3,186,3,186,0,0,85144.60571,8.79513099999167,169.18451811592223,0
"147.32.84.165",3277,"174.37.196.55",80,3,186,3,186,0,0,85144.608937,8.795047999999952,169.1861147318364,0
"147.32.84.165",3278,"193.23.181.44",80,3,186,3,186,0,0,85144.612106,8.795127000004868,169.18459506033017,0
"147.32.84.165",3279,"193.23.181.44",80,3,186,3,186,0,0,85144.615307,8.795100999996066,169.1850952025071,0
"147.32.84.165",3280,"193.23.181.44",80,3,186,3,186,0,0,85144.618509,8.84163599999738,168.29464592304421,0
"147.32.84.165",3281,"174.37.196.55",80,7,599,4,417,3,182,85144.621737,0.32901200000196695,10139.447801235385,4425.370503177074
"147.32.84.165",3282,"174.37.196.55",80,7,602,4,420,3,182,85144.624939,0.3443180000031134,9758.420994457501,4228.649097598251
"147.32.84.165",3283,"174.37.196.55",80,7,559,4,377,3,182,85144.628111,0.3596079999988433,8386.910191123949,4048.85319571501
"147.32.84.165",3284,"67.19.72.206",80,3,186,3,186,0,0,85144.631289,8.828913999997894,168.53714964268028,0
"147.32.84.165",3285,"67.19.72.206",80,3,186,3,186,0,0,85144.634487,8.825736999991932,168.5978179500885,0
"147.32.84.165",3286,"174.128.246.102",80,3,186,3,186,0,0,85144.637708,8.822539000000688,168.65893140284038,0
"147.32.84.165",3288,"67.19.72.206",80,3,186,3,186,0,0,85144.640904,8.81936599999608,168.71961091088195,0
"147.32.84.165",3289,"67.19.72.206",80,3,186,3,186,0,0,85144.644109,8.816181999995024,168.7805446848579,0
"147.32.84.165",3287,"67.19.72.206",80,3,186,3,186,0,0,85144.647286,8.813030999997864,168.84089026809968,0
"147.32.84.165",3291,"174.128.246.102",80,3,186,3,186,0,0,85144.650508,8.809831999999005,168.9021992701073,0
"147.32.84.165",3290,"67.19.72.206",80,3,186,3,186,0,0,85144.653737,8.806624000004376,168.96372548654975,0
"147.32.84.165",3293,"193.23.181.44",80,3,186,3,186,0,0,85144.656935,8.803447999991477,169.0246821474314,0
"147.32.84.165",3292,"67.19.72.206",80,3,186,3,186,0,0,85144.660103,8.800304000003962,169.08506797030307,0
"147.32.84.165",3294,"72.20.15.61",80,3,186,3,186,0,0,85144.663333,8.797095000001718,169.146746738521,0
"147.32.84.165",3295,"193.23.181.44",179,3,186,3,186,0,0,85144.666534,8.793915000002016,169.20791251674126,0
"147.32.84.165",3296,"72.20.15.61",80,3,186,3,186,0,0,85144.669709,8.891243000005488,167.3556779405401,0
"147.32.84.165",3297,"72.20.15.61",80,3,186,3,186,0,0,85144.672938,8.88811299999361,167.41461320317035,0
"147.32.84.165",3298,"174.128.246.102",80,3,186,3,186,0,0,85144.676087,8.88499099999899,167.47343919652468,0
"147.32.84.165",3299,"174.37.196.55",80,8,659,4,417,4,242,85144.679289,0.3716019999992568,8977.346731198088,5209.875081414718
"147.32.84.165",3300,"193.23.181.44",80,3,186,3,186,0,0,85144.682489,8.87861200000043,167.59376352969676,0
"147.32.84.165",3301,"67.19.72.206",80,3,186,3,186,0,0,85144.685688,8.875434000001405,167.65377332531168,0
"147.32.84.165",3302,"174.128.246.102",80,3,186,3,186,0,0,85144.688889,8.872255000009318,167.71384501442273,0
"147.32.84.165",3303,"72.20.15.61",80,3,186,3,186,0,0,85144.692085,8.869083999990835,167.77380843405447,0
"147.32.84.165",3304,"174.37.196.55",80,3,186,3,186,0,0,85144.695285,8.865908000007039,167.833909397528,0
"147.32.84.165",3305,"174.128.246.102",80,3,186,3,186,0,0,85144.698485,8.862731000001077,167.89407238015227,0
"147.32.84.165",3306,"174.128.246.102",80,3,186,3,186,0,0,85144.701685,8.859551999994437,167.9543164260376,0
"147.32.84.165",3307,"193.23.181.44",179,3,186,3,186,0,0,85144.704885,8.856375000003027,168.01456577883067,0
"147.32.84.165",3308,"174.37.196.55",80,3,186,3,186,0,0,85144.708085,8.853197999997064,168.07485837326732,0
"147.32.84.165",3309,"174.128.246.102",80,3,186,3,186,0,0,85144.711318,8.849988000001758,168.1358212010801,0
"147.32.84.165",3310,"193.23.181.44",179,3,186,3,186,0,0,85144.714515,8.846814000004088,168.19614383204083,0
"147.32.84.165",3311,"174.128.246.102",80,3,186,3,186,0,0,85144.717738,8.84361299999,168.25702345881513,0
"147.32.84.165",3312,"72.20.15.61",80,3,186,3,186,0,0,85144.720916,8.8404589999991,168.3170523159659,0
"147.32.84.165",3313,"174.37.196.55",80,3,186,3,186,0,0,85144.724114,8.83728200000769,168.37756224127568,0
"147.32.84.165",3314,"174.128.246.102",80,3,186,3,186,0,0,85144.727333,8.935346999991452,166.52962666155253,0
"147.32.84.165",3315,"174.37.196.55",80,8,631,5,449,3,182,85144.730535,3.1545590000023367,1138.6694621965667,461.55421407522306
"147.32.84.165",3316,"193.23.181.44",179,3,186,3,186,0,0,85144.733685,8.92911599999934,166.64583593718683,0
"147.32.84.165",3317,"193.23.181.44",179,3,186,3,186,0,0,85144.736892,8.925956999999471,166.7048138367783,0
"147.32.84.165",3318,"193.23.181.44",80,3,186,3,186,0,0,85144.740083,8.922808000002988,166.76364660087964,0
"147.32.84.165",3319,"174.37.196.55",80,8,662,5,480,3,182,85144.743283,3.152779999989434,1217.9727098030528,461.8146524669909
"147.32.84.165",3320,"72.20.15.61",80,3,186,3,186,0,0,85144.746497,8.916440999993938,166.88272820972085,0
"147.32.84.165",3321,"193.23.181.44",179,3,186,3,186,0,0,85144.749685,8.913297999999486,166.9415742635426,0
"147.32.84.165",3322,"72.20.15.61",80,3,186,3,186,0,0,85144.752885,8.910144000008586,167.00066800251108,0
"147.32.84.165",3323,"174.128.246.102",80,3,186,3,186,0,0,85144.756083,8.906992999996874,167.05974732443624,0
"147.32.84.165",3324,"174.37.196.55",80,3,186,3,186,0,0,85144.775304,8.986184000008507,165.58752858817397,0
"147.32.84.165",3325,"193.23.181.44",179,3,186,3,186,0,0,85144.778511,8.983001000000513,165.64620219901067,0
"147.32.84.165",3326,"193.23.181.44",179,3,186,3,186,0,0,85144.781702,8.979831000004197,165.70467751556845,0
"147.32.84.165",3327,"193.23.181.44",80,3,186,3,186,0,0,85144.784906,8.976647999996203,165.76343419064995,0
"147.32.84.165",3328,"193.23.181.44",179,3,186,3,186,0,0,85144.788139,8.973440000001574,165.82269452960503,0
"147.32.84.165",3329,"193.23.181.44",179,3,186,3,186,0,0,85144.791338,8.970264000003226,165.88140549703607,0
"147.32.84.165",3330,"193.23.181.44",179,3,186,3,186,0,0,85144.794487,8.96714099998644,165.93917726979535,0
"147.32.84.165",3331,"193.23.181.44",80,3,186,3,186,0,0,85144.797692,8.963959000000614,165.99808187430332,0
"147.32.84.165",3332,"174.37.196.55",80,3,186,3,186,0,0,85144.800884,8.96078700000362,166.05684299820973,0
"147.32.84.165",3333,"193.23.181.44",80,3,186,3,186,0,0,85144.804108,8.957588000004762,166.11614644469125,0
"147.32.84.165",3334,"67.19.72.206",80,3,186,3,186,0,0,85144.807302,8.954417999993893,166.17495408423136,0
"147.32.84.165",3335,"193.23.181.44",179,3,186,3,186,0,0,85144.810506,8.95123400000739,166.2340633703433,0
"147.32.84.165",3336,"72.20.15.61",80,3,186,3,186,0,0,85144.813704,8.948057000001427,166.29308463276024,0
"147.32.84.165",3337,"174.37.196.55",80,3,186,3,186,0,0,85144.816937,8.944849000006798,166.35272434435385,0
"147.32.84.165",3338,"72.20.15.61",80,3,186,3,186,0,0,85144.820103,8.941705999997794,166.41119714743107,0
"147.32.84.165",3339,"67.19.72.206",80,3,186,3,186,0,0,85144.823306,8.938523999997415,166.4704374011224,0
"147.32.84.165",3341,"193.23.181.44",80,3,186,3,186,0,0,85144.879718,8.88213500000711,167.5272893283888,0
"147.32.84.165",3342,"193.23.181.44",179,3,186,3,186,0,0,85144.882936,8.87894100000267,167.58755351562226,0
"147.32.84.165",3343,"193.23.181.44",179,3,186,3,186,0,0,85144.886113,8.875784000003478,167.64716221118235,0
"147.32.84.165",3344,"193.23.181.44",179,3,186,3,186,0,0,85144.889284,8.87263399999938,167.70668101491665,0
"147.32.84.165",3345,"193.23.181.44",80,3,186,3,186,0,0,85144.892513,8.869426999997813,167.7673202564683,0
"147.32.84.165",3340,"67.19.72.206",80,3,186,3,186,0,0,85144.895735,8.866227999998955,167.82785193434856,0
"147.32.84.165",3347,"67.19.72.206",80,3,186,3,186,0,0,85144.898885,8.863100000002305,167.88708239776298,0
"147.32.84.165",3348,"174.37.196.55",80,3,186,3,186,0,0,85144.902085,8.859921000010218,167.94732142626148,0
"147.32.84.165",3349,"174.128.246.102",80,3,186,3,186,0,0,85144.905285,8.85674800000561,168.00748988218447,0
"147.32.84.165",3350,"174.128.246.102",80,3,186,3,186,0,0,85144.908485,8.856118999989121,168.01942250344962,0
"147.32.84.165",3346,"193.23.181.44",179,3,186,3,186,0,0,85144.911684,8.856116999988444,168.01946044772689,0
"147.32.84.165",3351,"193.23.181.44",80,3,186,3,186,0,0,85144.933284,8.837714000008418,168.36933170711143,0
"147.32.84.165",3352,"174.37.196.55",80,3,186,3,186,0,0,85144.936485,8.92531500000041,166.71680495309485,0
"147.32.84.165",3353,"174.128.246.102",80,3,186,3,186,0,0,85144.939683,8.922174999999697,166.77547795241077,0
"147.32.84.165",3354,"193.23.181.44",179,3,186,3,186,0,0,85144.942885,8.918994000006933,166.83495918921386,0
"147.32.84.165",3355,"72.20.15.61",80,3,186,3,186,0,0,85144.946085,8.915813999992679,166.89446415113883,0
"147.32.84.165",3356,"174.128.246.102",80,3,186,3,186,0,0,85144.949285,8.912641000002623,166.95388044907926,0
"147.32.84.165",3357,"72.20.15.61",80,3,186,3,186,0,0,85144.952488,8.90946100000292,167.0134702873173,0
"147.32.84.165",3358,"193.23.181.44",80,3,186,3,186,0,0,85144.955685,8.906291999999667,167.07289632992672,0
"147.32.84.165",3359,"193.23.181.44",179,3,186,3,186,0,0,85144.958885,8.903135999993538,167.13212063716426,0
"147.32.84.165",3360,"67.19.72.206",80,3,186,3,186,0,0,85144.962086,8.899957999994513,167.19180023107046,0
"147.32.84.165",3361,"193.23.181.44",179,3,186,3,186,0,0,85144.965317,8.896749000006821,167.25210523516614,0
"147.32.84.165",3362,"67.19.72.206",80,3,186,3,186,0,0,85144.968515,8.893574000001536,167.31181412554088,0
"147.32.84.165",3363,"174.128.246.102",80,3,186,3,186,0,0,85144.971706,8.89041000000725,167.37135857612714,0
"147.32.84.165",3364,"174.128.246.102",80,3,186,3,186,0,0,85144.974904,8.88723399999435,167.43117149846015,0
"147.32.84.165",3365,"174.128.246.102",80,3,186,3,186,0,0,85144.978087,8.88407400000142,167.49072553872944,0
"147.32.84.165",3366,"174.37.196.55",80,3,186,3,186,0,0,85144.981301,8.880886999992072,167.55083135291872,0
"147.32.84.165",3367,"174.37.196.55",80,3,186,3,186,0,0,85144.984486,8.877724999998463,167.61050832282567,0
"147.32.84.165",3368,"193.23.181.44",80,3,186,3,186,0,0,85144.987708,8.874523000005865,167.67098355585046,0
"147.32.84.165",3370,"193.23.181.44",179,3,186,3,186,0,0,85144.99094,8.87131099999533,167.73169151670854,0
"147.32.84.165",3369,"67.19.72.206",80,3,186,3,186,0,0,85144.994107,8.868166999993264,167.7911568423475,0
"147.32.84.165",3371,"72.20.15.61",80,3,186,3,186,0,0,85144.997303,8.864994000003207,167.85121343561673,0
"147.32.84.165",3372,"193.23.181.44",179,3,186,3,186,0,0,85145.000487,8.8618320000096,167.91110461114454,0
"147.32.84.165",3373,"174.37.196.55",80,3,186,3,186,0,0,85145.03389,9.029174999988754,164.79910955340364,0
"147.32.84.165",3374,"193.23.181.44",80,3,186,3,186,0,0,85145.034247,9.028879999998026,164.804494023658,0
"147.32.84.165",3375,"174.128.246.102",80,3,186,3,186,0,0,85145.035452,9.027696999997715,164.82609019779647,0
"147.32.84.165",3376,"193.23.181.44",179,3,186,3,186,0,0,85145.036825,9.026350999993156,164.85066889168482,0
"147.32.84.165",3377,"193.23.181.44",179,3,186,3,186,0,0,85145.037051,9.026147999989917,164.8543764185633,0
"147.32.84.165",3378,"67.19.72.206",80,3,186,3,186,0,0,85145.03742,9.025805000012042,164.86064123898254,0
"147.32.84.165",3379,"174.128.246.102",80,3,186,3,186,0,0,85145.03764,9.02563000000373,164.86383775973368,0
"147.32.84.165",3381,"193.23.181.44",179,3,186,3,186,0,0,85145.037923,9.025370000003022,164.868587104961,0
"147.32.84.165",3382,"193.23.181.44",80,3,186,3,186,0,0,85145.038192,9.02512299999944,164.8730992364417,0
"147.32.84.165",3383,"174.128.246.102",80,3,186,3,186,0,0,85145.038407,9.024932000000263,164.87658854382025,0
"147.32.84.165",3384,"193.23.181.44",80,3,186,3,186,0,0,85145.038621,9.024743999994826,164.880023189672,0
"147.32.84.165",3380,"67.19.72.206",80,3,186,3,186,0,0,85145.038903,9.024485000001732,164.88475519652528,0
"147.32.84.165",3385,"72.20.15.61",80,3,186,3,186,0,0,85145.04209,9.02132200000051,164.94256606735863,0
"147.32.84.165",3386,"174.128.246.102",80,3,186,3,186,0,0,85145.045289,9.018146000002162,165.00065534530526,0
"147.32.84.165",3387,"174.37.196.55",80,3,186,3,186,0,0,85145.048487,9.014974000005168,165.05871231565914,0
"147.32.84.165",3390,"67.19.72.206",80,3,186,3,186,0,0,85145.051689,9.011794999998529,165.11693841240762,0
"147.32.84.165",3388,"174.128.246.102",80,3,186,3,186,0,0,85145.054906,9.008600000001024,165.17549896763435,0
"147.32.84.165",3391,"174.37.196.55",80,3,186,3,186,0,0,85145.13483,9.028017000004184,164.82024790153923,0
"147.32.84.165",3392,"193.23.181.44",179,3,186,3,186,0,0,85145.135619,9.027348000003258,164.8324624241209,0
"147.32.84.165",3393,"174.128.246.102",80,3,186,3,186,0,0,85145.136026,9.026989000005415,164.83901774989505,0
"147.32.84.165",3394,"193.23.181.44",179,3,186,3,186,0,0,85145.136201,9.026857999997446,164.8414099347105,0
"147.32.84.165",3395,"174.37.196.55",80,3,186,3,186,0,0,85145.136308,9.026798000006238,164.84250561483393,0
"147.32.84.165",3396,"67.19.72.206",80,3,186,3,186,0,0,85145.136414,9.026739000008092,164.84358304794966,0
"147.32.84.165",3398,"193.23.181.44",80,3,186,3,186,0,0,85145.136577,9.026618999996572,164.8457744810726,0
"147.32.84.165",3399,"193.23.181.44",179,3,186,3,186,0,0,85145.136685,9.026557999997749,164.84688848178575,0
"147.32.84.165",3400,"174.128.246.102",80,10,788,6,546,4,242,85145.13679,9.352692999993451,467.0312604084255,206.99920333120693
"147.32.84.165",3401,"193.23.181.44",80,3,186,3,186,0,0,85145.136897,9.026444999995874,164.84895216230532,0
"147.32.84.165",3397,"174.37.196.55",80,3,186,3,186,0,0,85145.137,9.026388999991468,164.84997489044693,0
"147.32.84.165",3403,"193.23.181.44",179,3,186,3,186,0,0,85145.137107,9.026327999992645,164.85108894793237,0
"147.32.84.165",3402,"67.19.72.206",80,3,186,3,186,0,0,85145.137211,9.026271000009729,164.852129965785,0
"147.32.84.165",3405,"193.23.181.44",80,3,186,3,186,0,0,85145.137318,9.026210000010906,164.85324405239876,0
"147.32.84.165",3404,"67.19.72.206",80,3,186,3,186,0,0,85145.137421,9.026152999998885,164.85428509800175,0
"147.32.84.165",3406,"174.37.196.55",80,3,186,3,186,0,0,85145.137526,9.026094999993802,164.85534442092862,0
"147.32.84.165",3407,"193.23.181.44",179,3,186,3,186,0,0,85145.137634,9.026031999994302,164.85649508011264,0
"147.32.84.165",3408,"193.23.181.44",80,3,186,3,186,0,0,85145.137739,9.025974000003771,164.85755443117588,0
"147.32.84.165",3410,"67.19.72.206",80,3,186,3,186,0,0,85145.137846,9.02591399999801,164.85865032619722,0
"147.32.84.165",3411,"193.23.181.44",179,3,186,3,186,0,0,85145.137952,9.025852999999188,164.85976450094344,0
"147.32.84.165",3412,"174.37.196.55",80,3,186,3,186,0,0,85145.138091,9.025760999997146,164.86144492419757,0
"147.32.84.165",3413,"72.20.15.61",80,3,186,3,186,0,0,85145.138197,9.025698000012198,164.8625956682784,0
"147.32.84.165",3414,"174.128.246.102",80,3,186,3,186,0,0,85145.138305,9.025636000005761,164.8637281626525,0
"147.32.84.165",3409,"174.128.246.102",80,3,186,3,186,0,0,85145.138419,9.025615000005928,164.86411175294123,0
"147.32.84.165",3415,"174.128.246.102",80,6,536,4,414,2,122,85145.138533,0.32685399999900255,10132.964565249644,2986.0426979721174
"147.32.84.165",3417,"67.19.72.206",80,3,186,3,186,0,0,85145.138639,9.02544399999897,164.867235340463,0
"147.32.84.165",3418,"67.19.72.206",80,3,186,3,186,0,0,85145.141304,9.022826999993413,164.91505378536974,0
"147.32.84.165",3416,"174.128.246.102",80,3,186,3,186,0,0,85145.144508,9.0215659999958,164.9381049809637,0
"147.32.84.165",3419,"174.128.246.102",80,3,186,3,186,0,0,85145.235641,9.027272999999695,164.83383187813752,0
"147.32.84.165",3420,"193.23.181.44",179,3,186,3,186,0,0,85145.23601,9.026969000013196,164.83938296429562,0
"147.32.84.165",3421,"193.23.181.44",179,3,186,3,186,0,0,85145.237418,9.025591999990866,164.864531877965,0
"147.32.84.165",3422,"174.37.196.55",80,3,186,3,186,0,0,85145.238478,9.024562000005972,164.88334835519058,0
"147.32.84.165",3423,"67.19.72.206",80,3,186,3,186,0,0,85145.239029,9.024039999989327,164.89288611328848,0
"147.32.84.165",3424,"174.37.196.55",80,3,186,3,186,0,0,85145.239283,9.023814999993192,164.89699755603618,0
"147.32.84.165",3425,"174.128.246.102",80,3,186,3,186,0,0,85145.239458,9.023669000001973,164.89966553512485,0
"147.32.84.165",3427,"72.20.15.61",80,3,186,3,186,0,0,85145.251856,9.011298999990686,165.1260267805494,0
"147.32.84.165",3428,"72.20.15.61",80,3,186,3,186,0,0,85145.251971,9.011212999990676,165.1276026880665,0
"147.32.84.165",3429,"174.37.196.55",80,3,186,3,186,0,0,85145.252085,9.011127000005217,165.1291786253971,0
"147.32.84.165",3430,"174.37.196.55",80,3,186,3,186,0,0,85145.252196,9.01104499999201,165.13068129182793,0
"147.32.84.165",3431,"174.128.246.102",80,3,186,3,186,0,0,85145.252309,9.010959999999614,165.1322389623374,0
"147.32.84.165",3432,"174.128.246.102",80,3,186,3,186,0,0,85145.252422,9.010874999992666,165.1337966625007,0
"147.32.84.165",3433,"174.128.246.102",80,3,186,3,186,0,0,85145.252557,9.010768000007374,165.13575757347013,0
"147.32.84.165",3434,"193.23.181.44",80,3,186,3,186,0,0,85145.252671,9.010682000007364,165.13733366672844,0
"147.32.84.165",3426,"193.23.181.44",179,3,186,3,186,0,0,85145.252782,9.010599000001093,165.13885480863362,0
"147.32.84.165",3435,"174.128.246.102",80,3,186,3,186,0,0,85145.272006,8.991403000007267,165.49141440983095,0
"147.32.84.165",3436,"174.128.246.102",80,3,186,3,186,0,0,85145.292201,8.971235999997589,165.86343286481372,0
"147.32.84.165",3438,"67.19.72.206",80,3,186,3,186,0,0,85145.311802,8.95166400000744,166.22607819046416,0
"147.32.84.165",3439,"193.23.181.44",179,3,186,3,186,0,0,85145.311913,8.95158100000117,166.22761945625086,0
"147.32.84.165",3437,"193.23.181.44",179,3,186,3,186,0,0,85145.312019,8.951501999996253,166.22908647069764,0
"147.32.84.165",3440,"174.128.246.102",80,3,186,3,186,0,0,85145.334896,9.028584999992745,164.8098788460424,0
"147.32.84.165",3441,"193.23.181.44",80,3,186,3,186,0,0,85145.335248,9.028332000001683,164.8144972958153,0
"147.32.84.165",3442,"72.20.15.61",80,3,186,3,186,0,0,85145.336629,9.026975000000675,164.83927339999155,0
"147.32.84.165",3443,"174.128.246.102",80,3,186,3,186,0,0,85145.336984,9.026640000010957,164.84539097584414,0
"147.32.84.165",3444,"67.19.72.206",80,3,186,3,186,0,0,85145.337247,9.026396999994176,164.8498287856118,0
"147.32.84.165",3445,"174.128.246.102",80,3,186,3,186,0,0,85145.337554,9.026112999999896,164.85501566399813,0
"147.32.84.165",3446,"174.37.196.55",80,3,186,3,186,0,0,85145.33781,9.025880000001052,164.85927133972825,0
"147.32.84.165",3447,"193.23.181.44",80,3,186,3,186,0,0,85145.338073,9.025639999992563,164.86365509827846,0
"147.32.84.165",3448,"193.23.181.44",179,3,186,3,186,0,0,85145.338387,9.025351000003866,164.86893418320935,0
"147.32.84.165",3449,"193.23.181.44",80,3,186,3,186,0,0,85145.338658,9.02510300000722,164.87346460187874,0
"147.32.84.165",3450,"193.23.181.44",80,3,186,3,186,0,0,85145.338933,9.024850999994669,164.87806834715377,0
"147.32.84.165",3451,"193.23.181.44",179,3,186,3,186,0,0,85145.339267,9.02453899999091,164.88376857826188,0
"147.32.84.165",3452,"193.23.181.44",179,3,186,3,186,0,0,85145.339558,9.024270999987493,164.88866524532145,0
"147.32.84.165",3453,"193.23.181.44",80,3,186,3,186,0,0,85145.339823,9.024038000003202,164.89292265829022,0
"147.32.84.165",3454,"174.128.246.102",80,3,186,3,186,0,0,85145.340086,9.023799000002327,164.8972899329447,0
"147.32.84.165",3455,"67.19.72.206",80,3,186,3,186,0,0,85145.340457,9.023449000000255,164.90368594092547,0
"147.32.84.165",3456,"174.37.196.55",80,3,186,3,186,0,0,85145.340804,9.023126000000047,164.90958898279735,0
"147.32.84.165",3457,"174.37.196.55",80,3,186,3,186,0,0,85145.341197,9.022755999991205,164.91635150074438,0
"147.32.84.165",3458,"174.37.196.55",80,3,186,3,186,0,0,85145.341545,9.022429999997257,164.92231028674672,0
"147.32.84.165",3459,"174.128.246.102",80,3,186,3,186,0,0,85145.341893,9.022105999989435,164.92823294270124,0
"147.32.84.165",3460,"174.37.196.55",80,3,186,3,186,0,0,85145.435999,9.02826800000912,164.81566564024206,0
"147.32.84.165",3461,"174.37.196.55",80,3,186,3,186,0,0,85145.43641,9.027916000006371,164.8220918314869,0
"147.32.84.165",3462,"174.128.246.102",80,3,186,3,186,0,0,85145.436756,9.027591000005486,164.82802554957306,0
"147.32.84.165",3464,"193.23.181.44",80,3,186,3,186,0,0,85145.43831,9.026064000005135,164.85591061609506,0
"147.32.84.165",3463,"67.19.72.206",80,3,186,3,186,0,0,85145.438533,9.025864000010188,164.85956358286813,0
"147.32.84.165",3465,"67.19.72.206",80,3,186,3,186,0,0,85145.439528,9.024888999992982,164.87737411520044,0
"147.32.84.165",3466,"72.20.15.61",80,3,186,3,186,0,0,85145.439698,9.024743000001763,164.88004145932015,0
"147.32.84.165",3467,"67.19.72.206",80,3,186,3,186,0,0,85145.439808,9.02465600000869,164.88163094510938,0
"147.32.84.165",3468,"174.37.196.55",80,3,186,3,186,0,0,85145.439914,9.024571000001743,164.88318392084375,0
"147.32.84.165",3470,"72.20.15.61",80,3,186,3,186,0,0,85145.452378,9.012128000002122,165.11083730719866,0
"147.32.84.165",3471,"67.19.72.206",80,3,186,3,186,0,0,85145.452488,9.012041000009049,165.1124312459859,0
"147.32.84.165",3472,"174.37.196.55",80,3,186,3,186,0,0,85145.452593,9.011959000010393,165.11393360736372,0
"147.32.84.165",3473,"174.128.246.102",80,3,186,3,186,0,0,85145.452699,9.011874000003445,165.115490962194,0
"147.32.84.165",3474,"174.37.196.55",80,3,186,3,186,0,0,85145.452804,9.011792000004789,165.11699337925347,0
"147.32.84.165",3475,"72.20.15.61",80,3,186,3,186,0,0,85145.45291,9.011711999992258,165.11845917859762,0
"147.32.84.165",3476,"193.23.181.44",80,3,186,3,186,0,0,85145.453026,9.011619999990216,165.12014487979025,0
"147.32.84.165",3469,"174.128.246.102",80,3,186,3,186,0,0,85145.453138,9.011530999996467,165.1217756450689,0
"147.32.84.165",3477,"193.23.181.44",80,3,186,3,186,0,0,85145.472081,8.99261000000115,165.46920193356652,0
"147.32.84.165",3478,"72.20.15.61",80,3,186,3,186,0,0,85145.492757,8.971957000001566,165.85010382904647,0
"147.32.84.165",3479,"193.23.181.44",179,3,186,3,186,0,0,85145.501848,8.962889000002178,166.01789891625774,0
"147.32.84.165",3480,"193.23.181.44",179,3,186,3,186,0,0,85145.501973,8.962786999996752,166.01978826458102,0
"147.32.84.165",3481,"174.128.246.102",80,3,186,3,186,0,0,85145.535203,9.028870999987703,164.80465830135645,0
"147.32.84.165",3482,"193.23.181.44",179,3,186,3,186,0,0,85145.535383,9.028786000009859,164.80620982692193,0
"147.32.84.165",3483,"174.37.196.55",80,3,186,3,186,0,0,85145.535876,9.028320000012172,164.81471635896753,0
"147.32.84.165",3484,"193.23.181.44",179,3,186,3,186,0,0,85145.536299,9.027920000007725,164.82201880374734,0
"147.32.84.165",3485,"193.23.181.44",80,3,186,3,186,0,0,85145.536473,9.027768999992986,164.82477564514068,0
"147.32.84.165",3486,"67.19.72.206",80,3,186,3,186,0,0,85145.536611,9.027653999990434,164.82687528804013,0
"147.32.84.165",3487,"72.20.15.61",80,3,186,3,186,0,0,85145.536759,9.027530999999726,164.82912105204016,0
"147.32.84.165",3488,"74.125.93.27",25,3,186,3,186,0,0,85145.53687,9.027444000006653,164.83070955620477,0
"147.32.84.165",3489,"193.23.181.44",80,3,186,3,186,0,0,85145.536978,9.027358999999706,164.83226157285299,0
"147.32.84.165",3490,"174.37.196.55",80,3,186,3,186,0,0,85145.537084,9.027275000000373,164.8337953590578,0
"147.32.84.165",3491,"193.23.181.44",179,3,186,3,186,0,0,85145.53719,9.027193999994779,164.83527439433124,0
"147.32.84.165",3492,"174.128.246.102",80,3,186,3,186,0,0,85145.537297,9.02711699999054,164.83668041541495,0
"147.32.84.165",3493,"174.128.246.102",80,3,186,3,186,0,0,85145.537426,9.027012000005925,164.8385977551623,0
"147.32.84.165",3495,"67.19.72.206",80,3,186,3,186,0,0,85145.537534,9.02692799999204,164.84013165955375,0
"147.32.84.165",3494,"174.37.196.55",80,3,186,3,186,0,0,85145.537638,9.026849000001675,164.8415742857473,0
"147.32.84.165",3496,"193.23.181.44",80,3,186,3,186,0,0,85145.635724,9.028522999986308,164.81101061627209,0
"147.32.84.165",3497,"193.23.181.44",179,3,186,3,186,0,0,85145.635912,9.028453999999329,164.8122701849188,0
"147.32.84.165",3498,"174.128.246.102",80,3,186,3,186,0,0,85145.636334,9.028080000003683,164.8190977482912,0
"147.32.84.165",3499,"174.128.246.102",80,3,186,3,186,0,0,85145.636667,9.027793999994174,164.82431920809893,0
"147.32.84.165",3500,"72.20.15.61",80,3,186,3,186,0,0,85145.636776,9.027730999994674,164.82546943422193,0
"147.32.84.165",3502,"193.23.181.44",179,3,186,3,186,0,0,85145.641815,9.022741000007954,164.91662566826292,0
"147.32.84.165",3503,"174.37.196.55",80,7,599,4,417,3,182,85145.641925,0.24239099999249447,13762.887236338385,6006.8236858839
"147.32.84.165",3504,"193.23.181.44",179,3,186,3,186,0,0,85145.64203,9.022572999994736,164.91969641042175,0
"147.32.84.165",3505,"174.128.246.102",80,3,186,3,186,0,0,85145.642136,9.022514000011142,164.9207748525702,0
"147.32.84.165",3501,"193.23.181.44",80,3,186,3,186,0,0,85145.642241,9.022458000006736,164.9217984720892,0
"147.32.84.165",3506,"174.37.196.55",80,7,601,4,419,3,182,85145.662673,0.24301700000069104,13793.273721552272,5991.350399337741
"147.32.84.165",3507,"174.37.196.55",80,3,186,3,186,0,0,85145.736197,9.028105999997933,164.8186230866519,0
"147.32.84.165",3508,"72.20.15.61",80,3,186,3,186,0,0,85145.736953,9.02740900000208,164.8313486183751,0
"147.32.84.165",3509,"174.128.246.102",80,3,186,3,186,0,0,85145.737557,9.026826000001165,164.8419942956481,0
"147.32.84.165",3510,"72.20.15.61",80,3,186,3,186,0,0,85145.737667,9.0267359999998,164.8436378332138,0
"147.32.84.165",3511,"193.23.181.44",80,3,186,3,186,0,0,85145.737822,9.026608000000124,164.84597536527338,0
"147.32.84.165",3512,"193.23.181.44",179,3,186,3,186,0,0,85145.73793,9.0265209999925,164.84756419458134,0
"147.32.84.165",3513,"174.128.246.102",80,3,186,3,186,0,0,85145.738046,9.026427000004333,164.84928089478657,0
"147.32.84.165",3514,"174.128.246.102",80,3,186,3,186,0,0,85145.738153,9.026339999996708,164.85086978781464,0
"147.32.84.165",3515,"72.20.15.61",80,3,186,3,186,0,0,85145.738258,9.026259999998729,164.8523308657417,0
"147.32.84.165",3516,"67.19.72.206",80,3,186,3,186,0,0,85145.738387,9.026153999991948,164.85426683406104,0
"147.32.84.165",3517,"174.37.196.55",80,3,186,3,186,0,0,85145.738493,9.026072000007844,164.8557645007382,0
"147.32.84.165",3518,"67.19.72.206",80,3,186,3,186,0,0,85145.738603,9.025981999991927,164.8574083131709,0
"147.32.84.165",3519,"67.19.72.206",80,3,186,3,186,0,0,85145.73871,9.025899999993271,164.858906037194,0
"147.32.84.165",3520,"193.23.181.44",179,3,186,3,186,0,0,85145.738817,9.025815999993938,164.8604403193018,0
"147.32.84.165",3521,"174.37.196.55",80,3,186,3,186,0,0,85145.739,9.025653999997303,164.86339937254903,0
"147.32.84.165",3523,"67.19.72.206",80,3,186,3,186,0,0,85145.739252,9.025424999999814,164.86758241301996,0
"147.32.84.165",3524,"67.19.72.206",80,3,186,3,186,0,0,85145.739469,9.02523199999996,164.87110802248702,0
"147.32.84.165",3522,"174.128.246.102",80,3,186,3,186,0,0,85145.73968,9.025041000000783,164.8745972455827,0
"147.32.84.165",3525,"193.23.181.44",80,3,186,3,186,0,0,85145.764868,8.999874000001,165.3356480323874,0
"147.32.84.165",3526,"193.23.181.44",80,3,186,3,186,0,0,85145.785067,8.979697999995551,165.7071317989466,0
"147.32.84.165",3527,"174.128.246.102",80,3,186,3,186,0,0,85145.836318,9.028753999999026,164.80679393858338,0
"147.32.84.165",3528,"72.20.15.61",80,3,186,3,186,0,0,85145.837049,9.028081000011298,164.8190794918807,0
"147.32.84.165",3529,"193.23.181.44",179,3,186,3,186,0,0,85145.837488,9.027663000000757,164.82671096604682,0
"147.32.84.165",3530,"193.23.181.44",179,3,186,3,186,0,0,85145.837762,9.027415999997174,164.8312208056509,0
"147.32.84.165",3531,"174.128.246.102",80,3,186,3,186,0,0,85145.837889,9.02731199999107,164.83311975940035,0
"147.32.84.165",3532,"174.128.246.102",80,3,186,3,186,0,0,85145.838001,9.02722299999732,164.83474486012383,0
"147.32.84.165",3533,"72.20.15.61",80,3,186,3,186,0,0,85145.838122,9.027132000002894,164.83640651311214,0
"147.32.84.165",3534,"174.37.196.55",80,3,186,3,186,0,0,85145.838228,9.027051000011852,164.8378855949796,0
"147.32.84.165",3535,"174.37.196.55",80,3,186,3,186,0,0,85145.838333,9.026969999991707,164.83936470392248,0
"147.32.84.165",3536,"174.128.246.102",80,3,186,3,186,0,0,85145.838439,9.026891000001342,164.84080731669172,0
"147.32.84.165",3537,"174.128.246.102",80,3,186,3,186,0,0,85145.838545,9.026806999987457,164.84234126220574,0
"147.32.84.165",3538,"174.128.246.102",80,3,186,3,186,0,0,85145.83866,9.026714999999967,164.84402133001933,0
"147.32.84.165",3539,"193.23.181.44",80,3,186,3,186,0,0,85145.838773,9.02662400000554,164.84568317004084,0
"147.32.84.165",3540,"193.23.181.44",80,3,186,3,186,0,0,85145.838881,9.02654099999927,164.84719894366185,0
"147.32.84.165",3542,"72.20.15.61",80,3,186,3,186,0,0,85145.84235,9.023098999998183,164.91008244510004,0
"147.32.84.165",3543,"193.23.181.44",179,3,186,3,186,0,0,85145.842466,9.023006000003079,164.91178217098516,0
"147.32.84.165",3544,"193.23.181.44",179,3,186,3,186,0,0,85145.842577,9.022920999996131,164.9133357147467,0
"147.32.84.165",3541,"67.19.72.206",80,3,186,3,186,0,0,85145.84269,9.022830999994767,164.91498067522966,0
"147.32.84.165",3545,"193.23.181.44",80,3,186,3,186,0,0,85145.863232,9.002311000003829,165.29089030576338,0
"147.32.84.165",3546,"72.20.15.61",80,7,572,4,390,3,182,85145.937662,0.3696429999981774,8440.576448128015,3938.9356757930736
"147.32.84.165",3547,"67.19.72.206",80,3,186,3,186,0,0,85145.93891,9.026660999996238,164.84500747293157,0
"147.32.84.165",3548,"72.20.15.61",80,3,186,3,186,0,0,85145.939178,9.026459000000614,164.84869648218628,0
"147.32.84.165",3549,"193.23.181.44",179,3,186,3,186,0,0,85145.939401,9.026259999998729,164.8523308657417,0
"147.32.84.165",3550,"174.37.196.55",80,3,186,3,186,0,0,85145.939619,9.026066000005812,164.85587408723157,0
"147.32.84.165",3551,"193.23.181.44",179,3,186,3,186,0,0,85145.940084,9.025624999994761,164.86392909087888,0
"147.32.84.165",3552,"193.23.181.44",80,3,186,3,186,0,0,85145.940312,9.025421999991522,164.86763721423748,0
"147.32.84.165",3553,"174.37.196.55",80,3,186,3,186,0,0,85145.940577,9.025179999996908,164.87205795347126,0
"147.32.84.165",3554,"193.23.181.44",80,3,186,3,186,0,0,85145.940792,9.024987000011606,164.87558375409145,0
"147.32.84.165",3555,"72.20.15.61",80,3,186,3,186,0,0,85145.941006,9.024797000005492,164.87905489720094,0
"147.32.84.165",3556,"193.23.181.44",80,3,186,3,186,0,0,85145.941245,9.024582000012742,164.8829829456809,0
"147.32.84.165",3557,"193.23.181.44",179,3,186,3,186,0,0,85145.941484,9.024365000004764,164.8869477242127,0
"147.32.84.165",3558,"193.23.181.44",80,3,186,3,186,0,0,85145.941701,9.024171999990358,164.8904741622378,0
"147.32.84.165",3559,"72.20.15.61",80,3,186,3,186,0,0,85145.941966,9.023933000004035,164.89484130692622,0
"147.32.84.165",3560,"174.128.246.102",80,3,186,3,186,0,0,85145.942181,9.023742999997921,164.8983132609542,0
"147.32.84.165",3561,"174.128.246.102",80,3,186,3,186,0,0,85145.942395,9.023551999998745,164.90180363566444,0
"147.32.84.165",3563,"67.19.72.206",80,3,186,3,186,0,0,85145.942627,9.023342000000412,164.90564139095383,0
"147.32.84.165",3562,"174.128.246.102",80,3,186,3,186,0,0,85145.942842,9.023151000001235,164.9091320759008,0
"147.32.84.165",3564,"174.128.246.102",80,3,186,3,186,0,0,85146.037428,9.028266000008443,164.8157021512889,0
"147.32.84.165",3565,"174.37.196.55",80,3,186,3,186,0,0,85146.038003,9.027827000012621,164.82371671476645,0
"147.32.84.165",3566,"72.20.15.61",80,3,186,3,186,0,0,85146.038112,9.027767999999924,164.8247939025474,0
"147.32.84.165",3567,"174.37.196.55",80,3,186,3,186,0,0,85146.038218,9.027711999995518,164.82581633095282,0
"147.32.84.165",3568,"72.20.15.61",80,3,186,3,186,0,0,85146.038415,9.02756099999533,164.8285732991192,0
"147.32.84.165",3569,"174.128.246.102",80,3,186,3,186,0,0,85146.038522,9.027501000004122,164.8296688086017,0
"147.32.84.165",3570,"174.37.196.55",80,3,186,3,186,0,0,85146.038627,9.027443999992101,164.83070955647045,0
"147.32.84.165",3571,"72.20.15.61",80,3,186,3,186,0,0,85146.038738,9.027379999999539,164.83187813076174,0
"147.32.84.165",3572,"193.23.181.44",179,3,186,3,186,0,0,85146.038843,9.027321999994456,164.83293716574127,0
"147.32.84.165",3573,"193.23.181.44",80,3,186,3,186,0,0,85146.039053,9.027159000004758,164.83591349163294,0
"147.32.84.165",3574,"72.20.15.61",80,3,186,3,186,0,0,85146.039206,9.027052999997977,164.8378490743694,0
"147.32.84.165",3575,"193.23.181.44",179,3,186,3,186,0,0,85146.039313,9.026994999992894,164.83890818607648,0
"147.32.84.165",3576,"193.23.181.44",80,3,186,3,186,0,0,85146.039421,9.0269360000093,164.83998557190026,0
"147.32.84.165",3577,"72.20.15.61",80,3,186,3,186,0,0,85146.039527,9.02687899999728,164.84102645005527,0
"147.32.84.165",3578,"174.37.196.55",80,3,186,3,186,0,0,85146.043644,9.022807000001194,164.91541933677658,0
"147.32.84.165",3579,"193.23.181.44",80,3,186,3,186,0,0,85146.063091,9.003409999990254,165.2707140962825,0
"147.32.84.165",3580,"72.20.15.61",80,3,186,3,186,0,0,85146.065543,9.001004999998258,165.3148731725277,0
"147.32.84.165",3581,"174.37.196.55",80,3,186,3,186,0,0,85146.065652,9.000941999998759,165.31603025552272,0
"147.32.84.165",3583,"67.19.72.206",80,3,186,3,186,0,0,85146.06576,9.000880000006873,165.31716898779493,0
"147.32.84.165",3582,"174.128.246.102",80,3,186,3,186,0,0,85146.065875,9.000811000005342,165.3184363052526,0
"147.32.84.165",3584,"72.20.15.61",80,3,186,3,186,0,0,85146.123181,8.943551000003936,166.37686753274457,0
"147.32.84.165",3585,"72.20.15.61",80,3,186,3,186,0,0,85146.137771,9.029041000001598,164.80155533680008,0
"147.32.84.165",3586,"174.37.196.55",80,3,186,3,186,0,0,85146.138327,9.02854300000763,164.81064552705155,0
"147.32.84.165",3587,"72.20.15.61",80,3,186,3,186,0,0,85146.138547,9.028346000006422,164.81424172256374,0
"147.32.84.165",3588,"67.19.72.206",80,3,186,3,186,0,0,85146.138803,9.028116000001319,164.81844052510874,0
"147.32.84.165",3589,"193.23.181.44",80,3,186,3,186,0,0,85146.139185,9.027756999988924,164.82499473588243,0
"147.32.84.165",3590,"174.37.196.55",80,3,186,3,186,0,0,85146.139401,9.027564000003622,164.8285185238679,0
"147.32.84.165",3591,"67.19.72.206",80,3,186,3,186,0,0,85146.139614,9.027373000004445,164.83200594450537,0
"147.32.84.165",3592,"174.37.196.55",80,3,186,3,186,0,0,85146.13985,9.027161999998498,164.83585871176874,0
"147.32.84.165",3593,"77.127.115.133",6667,2,124,2,124,0,0,85146.188208,2.9593339999992168,335.21055751066376,0
"147.32.84.165",3594,"72.20.15.61",80,3,186,3,186,0,0,85146.237966,9.027923000001465,164.82196403311798,0
"147.32.84.165",3595,"174.37.196.55",80,3,186,3,186,0,0,85146.739445,9.028340999997454,164.81433299876684,0
"147.32.84.165",3596,"174.128.246.102",80,16,2314,12,2066,4,248,85146.739568,93.10547399999632,177.5191005418291,21.309165989532243
"147.32.84.165",3597,"193.23.181.44",80,3,186,3,186,0,0,85146.902242,8.966519000008702,165.950688332736,0
"147.32.84.165",3598,"72.20.15.61",80,8,634,5,452,3,182,85146.940504,3.377747000005911,1070.5360703432411,431.0565592974998
"147.32.84.165",3599,"174.128.246.102",80,3,186,3,186,0,0,85147.2275,8.841623000000254,168.29489336968533,0
"147.32.84.165",3600,"72.20.15.61",80,3,186,3,186,0,0,85147.23072,8.838464000000386,168.35504449641195,0
"147.32.84.165",3601,"72.20.15.61",80,3,186,3,186,0,0,85147.307553,8.861183000000892,167.9234025524414,0
"147.32.84.165",3602,"72.20.15.61",80,3,186,3,186,0,0,85147.3107,8.858055999997305,167.98268152746525,0
"147.32.84.165",3603,"67.19.72.206",80,3,186,3,186,0,0,85147.31393,8.854869000002509,168.04314101084708,0
"147.32.84.165",3604,"174.37.196.55",80,3,186,3,186,0,0,85147.31715,8.85165299999062,168.10419477600138,0
"147.32.84.165",3605,"193.23.181.44",80,3,186,3,186,0,0,85147.387518,8.881655999997747,167.53632430713117,0
"147.32.84.165",3606,"174.37.196.55",80,3,186,3,186,0,0,85147.390701,8.878531000009389,167.59529250936066,0
"147.32.84.165",3607,"193.23.181.44",179,3,186,3,186,0,0,85147.441918,8.927926000003936,166.66804809978757,0
"147.32.84.165",3608,"72.20.15.61",80,3,186,3,186,0,0,85147.751859,9.02022500000021,164.96262565512117,0
"147.32.84.165",3609,"193.23.181.44",179,3,186,3,186,0,0,85147.79027,8.981838000006974,165.66765065222114,0
"147.32.84.165",3610,"193.23.181.44",179,3,186,3,186,0,0,85147.793466,8.978665000002366,165.72619648907806,0
"147.32.84.165",3611,"193.23.181.44",179,3,186,3,186,0,0,85148.044891,9.027285000003758,164.83361276390195,0
"147.32.84.165",3612,"174.128.246.102",80,3,186,3,186,0,0,85148.24481,9.02804499999911,164.8197367204247,0
"147.32.84.165",3613,"174.37.196.55",80,3,186,3,186,0,0,85148.244921,9.027953999990132,164.8213980711052,0
"147.32.84.165",3614,"72.20.15.61",80,3,186,3,186,0,0,85148.350447,9.022570000000997,164.91975124602365,0
"147.32.84.165",3615,"67.19.72.206",80,3,186,3,186,0,0,85148.353647,9.019393000009586,164.9778427437876,0
"147.32.84.165",3617,"72.20.15.61",80,3,186,3,186,0,0,85148.747136,9.027021999994759,164.83841514963228,0
"147.32.84.165",3616,"72.20.15.61",80,3,186,3,186,0,0,85148.747244,9.026937000002363,164.83996731112785,0
"147.32.84.165",3618,"193.23.181.44",179,3,186,3,186,0,0,85148.747379,9.026823000007425,164.84204907959045,0
"147.32.84.165",3619,"193.23.181.44",80,3,186,3,186,0,0,85148.747507,9.026718000008259,164.8439665445003,0
"147.32.84.165",3620,"67.19.72.206",80,3,186,3,186,0,0,85148.74764,9.026608000000124,164.84597536527338,0
"147.32.84.165",3621,"193.23.181.44",179,3,186,3,186,0,0,85149.047883,9.027697999990778,164.82607194010257,0
"147.32.84.165",3622,"174.37.196.55",80,3,186,3,186,0,0,85149.048204,9.027439999990747,164.83078259191146,0
"147.32.84.165",3623,"184.82.148.43",80,10,1919,5,979,5,940,85149.571365,0.3417920000065351,22914.52111181728,22001.68523504417
"147.32.84.165",3624,"184.82.148.44",80,10,1514,5,596,5,918,85149.811251,0.3438859999878332,13865.05993314265,21355.91446078012
"147.32.84.165",3625,"217.163.21.36",80,13,6081,6,750,7,5331,85150.055118,0.18680399999720976,32119.226569503975,228303.46245603426
"147.32.84.165",3626,"193.23.181.44",80,3,186,3,186,0,0,85150.134796,8.943173000006936,166.38389976341125,0
"147.32.84.165",3627,"217.163.21.36",80,10,1451,5,701,5,750,85150.200955,0.139050000012503,40330.816249519914,43149.94605868749
"147.32.84.165",3628,"217.163.21.35",80,9,3155,5,1575,4,1580,85150.29475,0.23465699999360368,53695.39370376104,53865.855271074564
"147.32.84.165",3629,"217.163.21.36",80,10,2277,5,1156,5,1121,85150.485223,0.13904600001114886,66510.36347150213,64496.64139407776
"147.32.84.165",3630,"217.163.21.35",80,13,4725,7,2144,6,2581,85150.579894,0.1778830000112066,96422.9296724219,116076.2973341982
"147.32.84.165",3631,"173.241.240.4",80,9,2195,5,1165,4,1030,85150.692768,0.10020800000347663,93006.54638029549,82228.96375253593
"147.32.84.165",3632,"92.240.244.181",80,10,1766,6,1316,4,450,85150.695996,5.046565000011469,2086.171484955821,713.3565108131608
"147.32.84.165",3633,"174.37.196.55",80,3,186,3,186,0,0,85150.789776,8.990893999987748,165.50078334835533,0
"147.32.84.165",3634,"67.19.72.206",80,3,186,3,186,0,0,85153.273629,8.914093999992474,166.9266669165993,0
"147.32.84.165",3635,"72.20.15.61",80,3,186,3,186,0,0,85153.295232,8.89260999999533,167.3299514991416,0
"147.32.84.165",3636,"174.37.196.55",80,3,186,3,186,0,0,85153.774198,9.015969000000041,165.04049647907988,0
"147.32.84.165",3637,"72.20.15.61",80,3,186,3,186,0,0,85153.777397,9.012893000006443,165.09682296227595,0
"147.32.84.165",3638,"193.23.181.44",179,12,908,7,608,5,300,85153.780618,9.19839900000079,528.7876727243058,260.91497009422983
"147.32.84.165",3639,"72.20.15.61",80,3,186,3,186,0,0,85154.263833,9.027992999996059,164.82068605953168,0
"147.32.84.165",3640,"67.19.72.206",80,3,186,3,186,0,0,85154.26395,9.027976000012131,164.820996422454,0
"147.32.84.165",3641,"67.19.72.206",80,3,186,3,186,0,0,85154.326903,8.96504600001208,165.97795482566346,0
"147.32.84.165",3642,"174.128.246.102",80,3,186,3,186,0,0,85154.364167,9.027992999996059,164.82068605953168,0
"147.32.84.165",3643,"174.37.196.55",80,3,186,3,186,0,0,85154.464947,9.027291000005789,164.8335032070026,0
"147.32.84.165",3644,"174.128.246.102",80,3,186,3,186,0,0,85154.764944,9.028623999998672,164.80916693398893,0
"147.32.84.165",3645,"193.23.181.44",80,10,1018,7,632,3,386,85154.867543,9.15323399999761,552.3730738230138,337.3670988855749
"147.32.84.165",3646,"174.128.246.102",80,7,561,4,379,3,182,85155.266313,0.3281649999989895,9239.25464327194,4436.79246721766
"147.32.84.165",3647,"193.23.181.44",179,12,908,7,608,5,300,85155.431349,9.157152999992832,531.1694584554618,262.0901933168397
"147.32.84.165",3648,"173.236.31.226",7212,7,424,4,242,3,182,85156.088299,0.48903000001155306,3958.8573297226408,2977.322454584796
"147.32.84.165",3649,"69.175.13.98",7691,7,424,4,242,3,182,85156.120204,0.43591399998695124,4441.242997604923,3340.108370099571
"147.32.84.165",3650,"184.154.10.50",8339,7,424,4,242,3,182,85156.120886,0.48048800000105985,4029.236942432963,3030.252576540493
"147.32.84.165",3651,"119.63.45.53",6667,2,124,2,124,0,0,85156.189087,3.0209150000009686,328.37732938519684,0
"147.32.84.165",3652,"184.82.148.43",80,10,1915,5,979,5,936,85157.809662,0.32668899999407586,23973.871174548345,22920.88194011977
"147.32.84.165",3653,"72.20.15.61",80,3,186,3,186,0,0,85157.874627,8.979950000008103,165.70248163950328,0
"147.32.84.165",3654,"184.82.148.44",80,10,1498,5,592,5,906,85158.03568,0.30398699999204837,15579.613602304978,23843.12487109512
"147.32.84.165",3655,"217.163.21.35",80,13,6942,6,1635,7,5307,85158.251052,0.18779799999902025,69649.30403981,226072.695131053
"147.32.84.165",3656,"217.163.21.35",80,9,3138,5,1578,4,1560,85158.399708,0.2207369999960065,57190.23090931013,56537.870860914954
"147.32.84.165",3657,"217.163.21.35",80,13,5057,7,2147,6,2910,85158.578508,0.1570519999950193,109365.05106935739,148231.15911123893
"147.32.84.165",3658,"74.121.139.103",80,10,3746,6,1534,4,2212,85158.71852,13.659115000002203,898.4476666312584,1295.545135976756
"147.32.84.165",3659,"74.125.232.219",80,9,3981,5,1301,4,2680,85158.990516,63.09623899999133,164.95436439565646,339.7983832285621
"147.32.84.165",3660,"94.127.76.145",80,10,1939,6,1181,4,758,85159.024395,63.06215399999928,149.82044539741074,96.15910043288514
"147.32.84.165",3662,"74.125.232.219",80,8,1889,5,1019,3,870,85159.13528,62.95086899999296,129.4978151930025,110.56241336399626
"147.32.84.165",3661,"74.125.232.219",80,54,42951,24,2174,30,40777,85159.135519,62.95083699999668,276.2790906179836,5182.075656913302
"147.32.84.165",3663,"193.23.181.44",179,10,783,5,483,5,300,85162.088687,0.1918020000011893,20145.77533068498,12512.903932102472
"147.32.84.165",3664,"174.37.196.55",80,3,186,3,186,0,0,85162.088838,8.928131000007852,166.6642212125574,0
"147.32.84.165",3665,"174.37.196.55",80,3,186,3,186,0,0,85162.153361,8.863635000001523,167.87694890411714,0
"147.32.84.165",3666,"193.23.181.44",179,10,741,5,441,5,300,85162.389222,0.1964529999968363,17958.493889412814,12216.662509804635
"147.32.84.165",3667,"193.23.181.44",80,9,950,5,498,4,452,85162.45487,0.13896999999997206,28668.057854218903,26020.004317483825
"147.32.84.165",3668,"174.128.246.102",80,3,186,3,186,0,0,85162.524609,8.893251000001328,167.3178908365206,0
"147.32.84.165",3669,"67.19.72.206",80,3,186,3,186,0,0,85162.791315,8.927550000007614,166.67506762759447,0
"147.32.84.165",3670,"67.19.72.206",80,3,186,3,186,0,0,85162.791576,8.927311999999802,166.67951114512778,0
"147.32.84.165",3671,"174.128.246.102",80,3,186,3,186,0,0,85162.7918,8.92711099999724,166.68326404818538,0
"147.32.84.165",3672,"72.20.15.61",80,3,186,3,186,0,0,85162.792017,8.926917000004323,166.6868864132241,0
"147.32.84.165",3673,"67.19.72.206",80,3,186,3,186,0,0,85162.792256,8.92677299999923,166.68957528102578,0
"147.32.84.165",3674,"174.37.196.55",80,3,186,3,186,0,0,85162.852498,8.866559000001871,167.82158670569788,0
"147.32.84.165",3675,"174.128.246.102",80,3,186,3,186,0,0,85163.392395,8.928228999997373,166.66239183610074,0
"147.32.84.165",3676,"174.37.196.55",80,7,546,4,364,3,182,85163.693408,0.24271899998711888,11997.412646535871,5998.706323267936
"147.32.84.165",3677,"67.19.72.206",80,3,186,3,186,0,0,85163.793957,8.928814999992028,166.65145374849055,0
"147.32.84.165",3678,"193.23.181.44",179,11,843,5,483,6,360,85163.794253,0.19990300000063144,19329.37474669112,14406.9873888381
"147.32.84.165",3679,"174.128.246.102",80,3,186,3,186,0,0,85163.815344,8.907470999998623,167.050782427496,0
"147.32.84.165",3680,"72.20.15.61",80,3,186,3,186,0,0,85163.865966,8.856895999997505,168.00468245313246,0
"147.32.84.165",3681,"193.23.181.44",179,10,812,5,512,5,300,85163.894618,0.1978429999871878,20703.284929288653,12130.831013255069
"147.32.84.165",3682,"174.128.246.102",80,3,186,3,186,0,0,85163.957682,8.865572000009706,167.84027020460394,0
"147.32.84.165",3683,"67.19.72.206",80,3,186,3,186,0,0,85163.959973,8.863339999996242,167.88253638026194,0
"147.32.84.165",3684,"72.20.15.61",80,3,186,3,186,0,0,85163.994311,8.928750999999465,166.65264828194773,0
"147.32.84.165",3685,"193.23.181.44",80,8,882,5,496,3,386,85164.459202,0.13328300000284798,29771.238641951426,23168.74620119607
"147.32.84.165",3686,"193.23.181.44",179,10,741,5,441,5,300,85164.526391,0.191938999996637,18380.83974628301,12503.972616519055
"147.32.84.165",3687,"174.37.196.55",80,3,186,3,186,0,0,85164.59145,8.934451999986777,166.54630860428847,0
"147.32.84.165",3688,"193.23.181.44",80,8,933,5,547,3,386,85164.897858,0.263942000005045,16579.4000193844,11699.540050242009
"147.32.84.165",3689,"174.37.196.55",80,3,186,3,186,0,0,85164.898171,9.02890100001241,164.80411071047902,0
"147.32.84.165",3690,"193.23.181.44",80,8,834,5,450,3,384,85164.898283,0.30667199999152217,11738.926279867483,10017.217092153585
"147.32.84.165",3691,"67.19.72.206",80,3,186,3,186,0,0,85164.898454,9.028685000012047,164.80805344277871,0
"147.32.84.165",3692,"174.37.196.55",80,3,186,3,186,0,0,85164.898586,9.028575000003912,164.8100613883537,0
"147.32.84.165",3693,"67.19.72.206",80,3,186,3,186,0,0,85164.898695,9.028491000004578,164.81159476143304,0
"147.32.84.165",3694,"67.19.72.206",80,3,186,3,186,0,0,85164.898803,9.028412999992725,164.81301863364016,0
"147.32.84.165",3695,"174.37.196.55",80,3,186,3,186,0,0,85164.898915,9.028330000001006,164.81453380634449,0
"147.32.84.165",3696,"174.37.196.55",80,3,186,3,186,0,0,85164.899127,9.028151999998954,164.81778330716767,0
"147.32.84.165",3697,"67.19.72.206",80,3,186,3,186,0,0,85164.899285,9.028030999994371,164.81999231071845,0
"147.32.84.165",3698,"67.19.72.206",80,3,186,3,186,0,0,85164.899441,9.027906999996048,164.82225614427034,0
"147.32.84.165",3699,"193.23.181.44",179,10,781,5,481,5,300,85164.899597,0.3317349999997532,11599.62017876577,7234.690340186551
"147.32.84.165",3700,"67.19.72.206",80,3,186,3,186,0,0,85164.899752,9.027625999995507,164.82738651343558,0
"147.32.84.165",3701,"174.128.246.102",80,3,186,3,186,0,0,85164.89991,9.027496000009705,164.82976010162733,0
"147.32.84.165",3702,"174.37.196.55",80,3,186,3,186,0,0,85164.900067,9.027368000010028,164.83209724011994,0
"147.32.84.165",3703,"174.128.246.102",80,6,546,4,424,2,122,85164.900239,0.4971349999977974,6823.096342070118,1963.2494191805529
"147.32.84.165",3704,"174.37.196.55",80,3,186,3,186,0,0,85164.900395,9.027068999988842,164.8375569082101,0
"147.32.84.165",3705,"174.37.196.55",80,3,186,3,186,0,0,85164.962845,8.964647000000696,165.98534220029907,0
"147.32.84.165",3706,"193.23.181.44",179,10,812,5,512,5,300,85164.964001,0.6477840000006836,6323.095352765239,3704.938683260882
"147.32.84.165",3707,"193.23.181.44",80,10,956,6,510,4,446,85164.964418,0.5817399999941699,7013.442431396997,6133.324165496198
"147.32.84.165",3708,"193.23.181.44",80,10,944,6,500,4,444,85164.998273,0.6338790000008885,6310.352606718938,5603.593114766417
"147.32.84.165",3709,"72.20.15.61",80,7,575,4,393,3,182,85164.998632,0.6494739999907324,4840.840434020242,2241.814145017008
"147.32.84.165",3710,"174.128.246.102",80,3,186,3,186,0,0,85164.999083,9.027933999997913,164.82176320743417,0
"147.32.84.165",3711,"67.19.72.206",80,3,186,3,186,0,0,85165.002283,9.024807000008877,164.87887220175858,0
"147.32.84.165",3712,"67.19.72.206",80,3,186,3,186,0,0,85165.003669,9.02345300000161,164.9036128408642,0
"147.32.84.165",3713,"193.23.181.44",179,10,788,5,488,5,300,85165.003781,0.679281999997329,5747.24488506298,3533.1423473747827
"147.32.84.165",3714,"174.128.246.102",80,6,501,4,379,2,122,85165.003892,0.57770100000198,5248.389737926035,1689.4552718389875
"147.32.84.165",3715,"193.23.181.44",179,3,186,3,186,0,0,85165.004,9.023176000002422,164.90867517153612,0
"147.32.84.165",3716,"72.20.15.61",80,8,679,5,497,3,182,85165.004108,3.4340480000100797,1157.81724658139,423.98941424107244
"147.32.84.165",3717,"193.23.181.44",179,3,186,3,186,0,0,85165.004215,9.02303799999936,164.911197315151,0
"147.32.84.165",3718,"174.37.196.55",80,3,186,3,186,0,0,85165.004325,9.022985999996308,164.91214770815435,0
"147.32.84.165",3719,"193.23.181.44",179,10,756,5,456,5,300,85165.004434,0.6978430000017397,5227.536852832092,3439.1689821263762
"147.32.84.165",3720,"174.128.246.102",80,3,186,3,186,0,0,85165.00454,9.022827000007965,164.91505378510377,0
"147.32.84.165",3721,"72.20.15.61",80,3,186,3,186,0,0,85165.004647,9.022776000012527,164.91598594467314,0
"147.32.84.165",3722,"174.37.196.55",80,3,186,3,186,0,0,85165.004753,9.022725000002538,164.91691811504634,0
"147.32.84.165",3723,"193.23.181.44",179,10,751,5,451,5,300,85165.00486,0.6932819999929052,5204.231467190729,3461.794767532636
"147.32.84.165",3724,"174.128.246.102",80,6,541,4,419,2,122,85165.004998,0.5667839999950957,5914.069557413414,1721.9963866454334
"147.32.84.165",3725,"174.128.246.102",80,7,601,4,419,3,182,85165.008151,0.6104829999967478,5490.734385753341,2384.9967976303296
"147.32.84.165",3726,"193.23.181.44",80,3,186,3,186,0,0,85165.011352,9.016181999992114,165.036597531117,0
"147.32.84.165",3727,"67.19.72.206",80,3,186,3,186,0,0,85165.014552,9.013038000004599,165.09416691677555,0
"147.32.84.165",3728,"72.20.15.61",80,8,628,5,446,3,182,85165.017752,3.436671000003116,1038.2140158300765,423.66580915039
"147.32.84.165",3729,"174.37.196.55",80,3,186,3,186,0,0,85165.02095,9.006694999989122,165.21043512651391,0
"147.32.84.165",3730,"193.23.181.44",179,3,186,3,186,0,0,85165.024152,9.003548000007868,165.26818094363463,0
"147.32.84.165",3731,"174.37.196.55",80,3,186,3,186,0,0,85165.027351,9.000404999998864,165.32589366813914,0
"147.32.84.165",3732,"193.23.181.44",179,3,186,3,186,0,0,85165.030552,8.997259000010672,165.38370185833654,0
"147.32.84.165",3733,"174.128.246.102",80,3,186,3,186,0,0,85165.033752,8.994114000000991,165.44153209530543,0
"147.32.84.165",3734,"174.37.196.55",80,3,186,3,186,0,0,85165.036952,8.991021000008914,165.4984456157454,0
"147.32.84.165",3735,"193.23.181.44",179,3,186,3,186,0,0,85165.040152,8.987878999992972,165.5563008804595,0
"147.32.84.165",3736,"174.37.196.55",80,3,186,3,186,0,0,85165.043352,8.984735000005458,165.61423347478765,0
"147.32.84.165",3737,"174.37.196.55",80,3,186,3,186,0,0,85165.046552,8.981589999995776,165.67222507381206,0
"147.32.84.165",3738,"174.37.196.55",80,3,186,3,186,0,0,85165.049781,8.978415000005043,165.73081106177028,0
"147.32.84.165",3739,"193.23.181.44",179,3,186,3,186,0,0,85165.053004,8.975246999994852,165.7893091968225,0
"147.32.84.165",3740,"67.19.72.206",80,3,186,3,186,0,0,85165.056204,8.97210100000666,165.84744197584217,0
"147.32.84.165",3741,"193.23.181.44",80,3,186,3,186,0,0,85165.059381,8.96897899999749,165.90517159204148,0
"147.32.84.165",3742,"174.128.246.102",80,3,186,3,186,0,0,85165.062552,8.96586299999035,165.96283034902515,0
"147.32.84.165",3743,"72.20.15.61",80,3,186,3,186,0,0,85165.065752,8.96433600000455,165.99110073509567,0
"147.32.84.165",3744,"193.23.181.44",179,3,186,3,186,0,0,85165.068957,8.964332000003196,165.9911748024805,0
"147.32.84.165",3745,"67.19.72.206",80,3,186,3,186,0,0,85165.072152,8.964337000012165,165.9910822181251,0
"147.32.84.165",3746,"193.23.181.44",179,3,186,3,186,0,0,85165.075352,8.964351999995415,165.99080446648694,0
"147.32.84.165",3747,"174.37.196.55",80,3,186,3,186,0,0,85165.078552,8.964354999989155,165.99074891632475,0
"147.32.84.165",3748,"174.128.246.102",80,3,186,3,186,0,0,85165.081752,8.96435300000303,165.99078594958243,0
"147.32.84.165",3749,"193.23.181.44",179,3,186,3,186,0,0,85165.084951,8.964357999997446,165.99069336593027,0
"147.32.84.165",3750,"193.23.181.44",179,3,186,3,186,0,0,85165.088173,8.964372000002186,165.9904341318764,0
"147.32.84.165",3751,"67.19.72.206",80,3,186,3,186,0,0,85165.09138,8.964328000001842,165.99124886993138,0
"147.32.84.165",3752,"72.20.15.61",80,3,186,3,186,0,0,85165.094574,8.964332999996259,165.9911562857628,0
"147.32.84.165",3753,"174.128.246.102",80,9,794,6,610,3,184,85165.097803,3.421142000006512,1426.4242758677399,430.26568321256417
"147.32.84.165",3754,"193.23.181.44",80,3,186,3,186,0,0,85165.100954,8.961181999999098,166.0495233776247,0
"147.32.84.165",3755,"193.23.181.44",80,3,186,3,186,0,0,85165.104152,8.961137999998755,166.05033869584497,0
"147.32.84.165",3756,"67.19.72.206",80,3,186,3,186,0,0,85165.107353,8.961135999998078,166.05037575596657,0
"147.32.84.165",3757,"193.23.181.44",179,3,186,3,186,0,0,85165.110553,8.961137999998755,166.05033869584497,0
"147.32.84.165",3758,"72.20.15.61",80,3,186,3,186,0,0,85165.1138,8.96109099999012,166.05120961294116,0
"147.32.84.165",3759,"193.23.181.44",80,3,186,3,186,0,0,85165.116975,8.961131999996724,166.0504498762594,0
"147.32.84.165",3760,"193.23.181.44",179,3,186,3,186,0,0,85165.120178,8.961160000006203,166.0499310355992,0
"147.32.84.165",3761,"174.128.246.102",80,3,186,3,186,0,0,85165.123426,8.961100000000442,166.05104284071447,0
"147.32.84.165",3762,"174.128.246.102",80,3,186,3,186,0,0,85165.126573,8.961162999999942,166.04987544585558,0
"147.32.84.165",3763,"174.128.246.102",80,3,186,3,186,0,0,85165.129775,8.961162999999942,166.04987544585558,0
"147.32.84.165",3764,"174.128.246.102",80,3,186,3,186,0,0,85165.13299,8.961095999999088,166.05111696160284,0
"147.32.84.165",3765,"193.23.181.44",80,3,186,3,186,0,0,85165.136176,8.96111099999689,166.05083900874752,0
"147.32.84.165",3766,"67.19.72.206",80,3,186,3,186,0,0,85165.139379,8.96110800000315,166.05089459913626,0
"147.32.84.165",3767,"193.23.181.44",80,3,186,3,186,0,0,85165.142603,8.961083999995026,166.05133932466495,0
"147.32.84.165",3768,"174.128.246.102",80,3,186,3,186,0,0,85165.145812,8.961074999999255,166.05150609721755,0
"147.32.84.165",3770,"174.37.196.55",80,3,186,3,186,0,0,85165.149018,8.961068000004161,166.05163580940453,0
"147.32.84.165",3771,"67.19.72.206",80,3,186,3,186,0,0,85165.152204,8.961083000001963,166.05135785481218,0
"147.32.84.165",3772,"174.37.196.55",80,3,186,3,186,0,0,85165.1554,8.961087000003317,166.05128373370877,0
"147.32.84.165",3769,"72.20.15.61",80,3,186,3,186,0,0,85165.158608,8.961079000000609,166.05143197598179,0
"147.32.84.165",3774,"67.19.72.206",80,3,186,3,186,0,0,85165.208209,8.914678000001004,166.9157315608968,0
"147.32.84.165",3775,"67.19.72.206",80,3,186,3,186,0,0,85165.211405,8.914682000002358,166.91565666611623,0
"147.32.84.165",3776,"174.37.196.55",80,3,186,3,186,0,0,85165.21458,8.914707000003546,166.9151885753966,0
"147.32.84.165",3773,"174.128.246.102",80,3,186,3,186,0,0,85165.217802,8.914684999996098,166.91560049521115,0
"147.32.84.165",3777,"174.37.196.55",80,3,186,3,186,0,0,85165.239752,8.89596700000402,167.26680753192176,0
"147.32.84.165",3778,"67.19.72.206",80,3,186,3,186,0,0,85165.261752,8.877183999997214,167.62072296805687,0
"147.32.84.165",3779,"193.23.181.44",80,3,186,3,186,0,0,85165.281374,8.860738999996101,167.93181697380487,0
"147.32.84.165",3780,"174.128.246.102",80,3,186,3,186,0,0,85165.301755,8.843565000002855,168.2579367030739,0
"147.32.84.165",3781,"174.128.246.102",80,3,186,3,186,0,0,85165.322201,8.82628599999589,168.58733107002118,0
"147.32.84.165",3783,"174.128.246.102",80,3,186,3,186,0,0,85165.325417,8.829469000003883,168.52655578714254,0
"147.32.84.165",3782,"67.19.72.206",80,3,186,3,186,0,0,85165.328601,8.82950599999458,168.52584957764492,0
"147.32.84.165",3784,"174.37.196.55",80,3,186,3,186,0,0,85165.331799,8.829535999990185,168.5252769796345,0
"147.32.84.165",3785,"72.20.15.61",80,3,186,3,186,0,0,85165.335002,8.829528999995091,168.52541058541485,0
"147.32.84.165",3786,"193.23.181.44",179,3,186,3,186,0,0,85165.33817,8.82956600000034,168.52470438523736,0
"147.32.84.165",3787,"193.23.181.44",80,3,186,3,186,0,0,85165.341354,8.829555999996956,168.52489524960407,0
"147.32.84.165",3788,"193.23.181.44",80,3,186,3,186,0,0,85165.344571,8.829570000001695,168.5246280396117,0
"147.32.84.165",3789,"174.37.196.55",80,3,186,3,186,0,0,85165.347771,8.82954599999357,168.5250861144031,0
"147.32.84.165",3790,"193.23.181.44",80,3,186,3,186,0,0,85165.350955,8.829584999999497,168.52434174427052,0
"147.32.84.165",3791,"174.37.196.55",80,3,186,3,186,0,0,85165.354156,8.829553000003216,168.5249525088595,0
"147.32.84.165",3792,"174.128.246.102",80,3,186,3,186,0,0,85165.357355,8.829555000003893,168.52491433592564,0
"147.32.84.165",3794,"193.23.181.44",80,3,186,3,186,0,0,85165.360573,8.829538999998476,168.52521971988082,0
"147.32.84.165",3793,"67.19.72.206",80,3,186,3,186,0,0,85165.363773,8.82956600000034,168.52470438523736,0
"147.32.84.165",3796,"193.23.181.44",179,3,186,3,186,0,0,85165.366972,8.829570000001695,168.5246280396117,0
"147.32.84.165",3795,"67.19.72.206",80,3,186,3,186,0,0,85165.370175,8.8295369999978,168.52525789295305,0
"147.32.84.165",3797,"67.19.72.206",80,3,186,3,186,0,0,85165.37336,8.829576000003726,168.52451352130296,0
"147.32.84.165",3799,"193.23.181.44",179,3,186,3,186,0,0,85165.376568,8.829569999987143,168.52462803988945,0
"147.32.84.165",3798,"67.19.72.206",80,3,186,3,186,0,0,85165.379769,8.829535999990185,168.5252769796345,0
"147.32.84.165",3800,"72.20.15.61",80,3,186,3,186,0,0,85165.382995,8.829510999988997,168.52575414446557,0
"147.32.84.165",3801,"193.23.181.44",80,3,186,3,186,0,0,85165.386175,8.82955999999831,168.5248189038055,0
"147.32.84.165",3803,"67.19.72.206",80,3,186,3,186,0,0,85165.389351,8.82958299999882,168.52437991694498,0
"147.32.84.165",3804,"193.23.181.44",179,3,186,3,186,0,0,85165.392551,8.829555999996956,168.52489524960407,0
"147.32.84.165",3802,"193.23.181.44",80,3,186,3,186,0,0,85165.395803,8.829518999991706,168.5256014513812,0
"147.32.84.165",3805,"67.19.72.206",80,3,186,3,186,0,0,85165.417381,8.811106999986805,168.87775849302798,0
"147.32.84.165",3806,"174.128.246.102",80,3,186,3,186,0,0,85165.436952,8.794738999989931,169.19205902548143,0
"147.32.84.165",3807,"174.37.196.55",80,3,186,3,186,0,0,85165.458606,8.776301000005333,169.54751210095185,0
"147.32.84.165",3808,"193.23.181.44",179,3,186,3,186,0,0,85165.478955,8.759153999999398,169.87941986179285,0
"147.32.84.165",3809,"174.128.246.102",80,3,186,3,186,0,0,85165.482157,8.765549999996438,169.7554631484168,0
"147.32.84.165",3810,"193.23.181.44",80,3,186,3,186,0,0,85165.485403,8.76548499999626,169.75672196126453,0
"147.32.84.165",3811,"72.20.15.61",80,3,186,3,186,0,0,85165.488553,8.765553999997792,169.75538568359454,0
"147.32.84.165",3812,"193.23.181.44",80,3,186,3,186,0,0,85165.491784,8.765507000003709,169.7562958992983,0
"147.32.84.165",3813,"174.37.196.55",80,3,186,3,186,0,0,85165.49497,8.765518000000156,169.75608286925808,0
"147.32.84.165",3814,"67.19.72.206",80,3,186,3,186,0,0,85165.498174,8.76551300000574,169.7561797009514,0
"147.32.84.165",3815,"193.23.181.44",80,3,186,3,186,0,0,85165.501353,8.765534000005573,169.75577300813094,0
"147.32.84.165",3816,"72.20.15.61",80,3,186,3,186,0,0,85165.504556,8.765530999997281,169.755831107147,0
"147.32.84.165",3817,"174.37.196.55",80,3,186,3,186,0,0,85165.507779,8.765507999996771,169.756276533037,0
"147.32.84.165",3818,"193.23.181.44",179,3,186,3,186,0,0,85165.510953,8.765532999997959,169.75579237455915,0
"147.32.84.165",3819,"67.19.72.206",80,3,186,3,186,0,0,85165.514179,8.765505999996094,169.7563152658458,0
"147.32.84.165",3820,"67.19.72.206",80,3,186,3,186,0,0,85165.517353,8.765531999990344,169.7558117409918,0
"147.32.84.165",3821,"72.20.15.61",80,3,186,3,186,0,0,85165.520553,8.765563000008115,169.7552113878621,0
"147.32.84.165",3822,"174.37.196.55",80,3,186,3,186,0,0,85165.523787,8.765528000003542,169.75588920592105,0
"147.32.84.165",3823,"67.19.72.206",80,3,186,3,186,0,0,85165.526969,8.765545999995084,169.75554061330973,0
"147.32.84.165",3824,"72.20.15.61",80,3,186,3,186,0,0,85165.530172,8.765543000001344,169.75559871188491,0
"147.32.84.165",3825,"67.19.72.206",80,3,186,3,186,0,0,85165.533357,8.765558000013698,169.75530821856117,0
"147.32.84.165",3826,"67.19.72.206",80,3,186,3,186,0,0,85165.536557,8.765599999998813,169.75449484350204,0
"147.32.84.165",3827,"174.128.246.102",80,3,186,3,186,0,0,85165.542958,8.762400999999954,169.81646925311998,0
"147.32.84.165",3828,"193.23.181.44",179,3,186,3,186,0,0,85165.568174,8.740380000002915,170.24431432037323,0
"147.32.84.165",3830,"193.23.181.44",179,3,186,3,186,0,0,85165.57135,8.740336999995634,170.2451518746638,0
"147.32.84.165",3829,"174.128.246.102",80,3,186,3,186,0,0,85165.574582,8.740304999999353,170.24577517605053,0
"147.32.84.165",3831,"193.23.181.44",179,3,186,3,186,0,0,85165.57775,8.750325000000885,170.05082668356312,0
"147.32.84.165",3833,"193.23.181.44",80,3,186,3,186,0,0,85165.58098,8.747157000005245,170.11241481079026,0
"147.32.84.165",3832,"67.19.72.206",80,3,186,3,186,0,0,85165.584178,8.743980999992345,170.17420326065468,0
"147.32.84.165",3834,"174.128.246.102",80,3,186,3,186,0,0,85165.587383,8.743503999998211,170.18348707798435,0
"147.32.84.165",3835,"193.23.181.44",80,3,186,3,186,0,0,85165.590552,8.743554000000586,170.182513883931,0
"147.32.84.165",3836,"193.23.181.44",179,3,186,3,186,0,0,85165.593752,8.743554000000586,170.182513883931,0
"147.32.84.165",3837,"193.23.181.44",80,3,186,3,186,0,0,85165.596952,8.743553999986034,170.18251388421422,0
"147.32.84.165",3838,"193.23.181.44",80,3,186,3,186,0,0,85165.600151,8.743588999990607,170.18183265494278,0
"147.32.84.165",3840,"193.23.181.44",80,3,186,3,186,0,0,85165.603352,8.743541999996523,170.18274744955667,0
"147.32.84.165",3841,"193.23.181.44",80,3,186,3,186,0,0,85165.606552,8.74353500000143,170.18288369632612,0
"147.32.84.165",3839,"67.19.72.206",80,3,186,3,186,0,0,85165.609783,8.743501999997534,170.18352600598934,0
"147.32.84.165",3842,"174.128.246.102",80,3,186,3,186,0,0,85165.61298,8.743522999997367,170.1831172629669,0
"147.32.84.165",3843,"193.23.181.44",80,3,186,3,186,0,0,85165.616205,8.743501999997534,170.18352600598934,0
"147.32.84.165",3845,"67.19.72.206",80,3,186,3,186,0,0,85165.61935,8.743556000001263,170.18247495638903,0
"147.32.84.165",3844,"174.128.246.102",80,3,186,3,186,0,0,85165.625766,8.740365999998176,170.24458701160918,0
"147.32.84.165",3846,"72.20.15.61",80,3,186,3,186,0,0,85165.644953,8.782904000006965,169.42004603475343,0
"147.32.84.165",3848,"174.128.246.102",80,3,186,3,186,0,0,85165.648153,8.779836000001524,169.4792476761231,0
"147.32.84.165",3847,"174.37.196.55",80,7,558,4,376,3,182,85165.651372,0.34850700000242796,8631.103535880324,4177.821392367604
"147.32.84.165",3849,"67.19.72.206",80,3,186,3,186,0,0,85165.654603,8.77343600000313,169.60287850728827,0
"147.32.84.165",3850,"193.23.181.44",80,3,186,3,186,0,0,85165.657774,8.770312999986345,169.66327199523172,0
"147.32.84.165",3851,"193.23.181.44",80,3,186,3,186,0,0,85165.661014,8.76712000000407,169.72506364682008,0
"147.32.84.165",3852,"174.128.246.102",80,3,186,3,186,0,0,85165.664173,8.764007999998285,169.78533109512122,0
"147.32.84.165",3853,"193.23.181.44",179,3,186,3,186,0,0,85165.667372,8.760856000008062,169.8464168339978,0
"147.32.84.165",3854,"67.19.72.206",80,3,186,3,186,0,0,85165.670604,8.757673000000068,169.90814797492308,0
"147.32.84.165",3855,"193.23.181.44",80,3,186,3,186,0,0,85165.673797,8.754528999998001,169.96916681643748,0
"147.32.84.165",3856,"193.23.181.44",80,3,186,3,186,0,0,85165.67701,8.751363000003039,170.03065693875152,0
"147.32.84.165",3857,"193.23.181.44",80,3,186,3,186,0,0,85165.680176,8.74824400000216,170.09127774666922,0
"147.32.84.165",3858,"174.128.246.102",80,3,186,3,186,0,0,85165.683386,8.745079999993322,170.1528173557173,0
"147.32.84.165",3859,"174.128.246.102",80,3,186,3,186,0,0,85165.686596,8.842107000004034,168.28568122952154,0
"147.32.84.165",3860,"174.128.246.102",80,3,186,3,186,0,0,85165.689771,8.839026000001468,168.34434020216173,0
"147.32.84.165",3862,"193.23.181.44",80,3,186,3,186,0,0,85165.693006,8.835816999999224,168.40547965175497,0
"147.32.84.165",3861,"193.23.181.44",80,3,186,3,186,0,0,85165.696202,8.83264799999597,168.4659005997611,0
"147.32.84.165",3863,"67.19.72.206",80,3,186,3,186,0,0,85165.699372,8.829501000000164,168.52594501093236,0
"147.32.84.165",3864,"174.128.246.102",80,3,186,3,186,0,0,85165.702551,8.826345000008587,168.5862041420942,0
"147.32.84.165",3865,"67.19.72.206",80,3,186,3,186,0,0,85165.705753,8.82316699999501,168.64692689153924,0
"147.32.84.165",3866,"193.23.181.44",80,3,186,3,186,0,0,85165.709035,8.819908999998006,168.70922364395557,0
"147.32.84.165",3867,"67.19.72.206",80,3,186,3,186,0,0,85165.712172,8.816842000000179,168.7679103243508,0
"147.32.84.165",3868,"193.23.181.44",179,3,186,3,186,0,0,85165.715402,8.81368300000031,168.8284001137717,0
"147.32.84.165",3869,"72.20.15.61",80,3,186,3,186,0,0,85165.71857,8.81058099999791,168.8878406543624,0
"147.32.84.165",3870,"67.19.72.206",80,3,186,3,186,0,0,85165.721805,8.807414000009885,168.94856992056123,0
"147.32.84.165",3871,"193.23.181.44",80,3,186,3,186,0,0,85165.72497,8.80432500000461,169.00784557580744,0
"147.32.84.165",3872,"174.128.246.102",80,3,186,3,186,0,0,85165.728203,8.801166999997804,169.0684883039228,0
"147.32.84.165",3873,"174.37.196.55",80,3,186,3,186,0,0,85165.731369,8.798072999998112,169.12794426692292,0
"147.32.84.165",3874,"174.128.246.102",80,3,186,3,186,0,0,85165.734601,8.794914999991306,169.18867322782208,0
"147.32.84.165",3875,"72.20.15.61",80,3,186,3,186,0,0,85165.737798,8.791792000003625,169.24877203639332,0
"147.32.84.165",3876,"174.128.246.102",80,3,186,3,186,0,0,85165.740974,8.888640999997733,167.40466849773543,0
"147.32.84.165",3877,"174.128.246.102",80,3,186,3,186,0,0,85165.744197,8.885476999988896,167.4642790704269,0
"147.32.84.165",3878,"174.37.196.55",80,9,693,6,511,3,182,85165.747398,9.12826299999142,447.83985737525774,159.50460673639316
"147.32.84.165",3879,"72.20.15.61",80,3,186,3,186,0,0,85165.750572,8.879149999993388,167.58360879150686,0
"147.32.84.165",3880,"193.23.181.44",179,3,186,3,186,0,0,85165.753804,8.875940999991144,167.64419682391812,0
"147.32.84.165",3881,"67.19.72.206",80,3,186,3,186,0,0,85165.756998,8.872768000001088,167.70414824323342,0
"147.32.84.165",3882,"67.19.72.206",80,3,186,3,186,0,0,85165.760184,8.869604999999865,167.7639534116821,0
"147.32.84.165",3883,"67.19.72.206",80,3,186,3,186,0,0,85165.763399,8.866414000003715,167.82433123463179,0
"147.32.84.165",3884,"174.128.246.102",80,3,186,3,186,0,0,85165.785836,8.943373000001884,166.38017893245495,0
"147.32.84.165",3885,"193.23.181.44",179,3,186,3,186,0,0,85165.789026,8.940207000006922,166.4390992287816,0
"147.32.84.165",3886,"174.37.196.55",80,3,186,3,186,0,0,85165.792151,8.937103000003844,166.49690621215396,0
"147.32.84.165",3887,"72.20.15.61",80,3,186,3,186,0,0,85165.795351,8.933930000013788,166.55603972694027,0
"147.32.84.165",3888,"174.128.246.102",80,3,186,3,186,0,0,85165.798582,8.93072299999767,166.6158495790753,0
"147.32.84.165",3889,"174.37.196.55",80,3,186,3,186,0,0,85165.801752,8.927574000001187,166.67461955507758,0
"147.32.84.165",3890,"174.128.246.102",80,3,186,3,186,0,0,85165.804952,8.924396999995224,166.73395412606547,0
"147.32.84.165",3891,"193.23.181.44",179,3,186,3,186,0,0,85165.808152,8.921220999996876,166.79331226079043,0
"147.32.84.165",3892,"193.23.181.44",80,3,186,3,186,0,0,85165.81135,8.918045999991591,166.85269396473208,0
"147.32.84.165",3893,"67.19.72.206",80,3,186,3,186,0,0,85165.814552,8.914873000001535,166.9120805197947,0
"147.32.84.165",3894,"193.23.181.44",179,3,186,3,186,0,0,85165.817752,8.911699999996927,166.97150936415198,0
"147.32.84.165",3895,"174.37.196.55",80,3,186,3,186,0,0,85165.820981,8.908494000002975,167.03159928036132,0
"147.32.84.165",3896,"67.19.72.206",80,3,186,3,186,0,0,85165.824152,8.90536200000497,167.09034399715244,0
"147.32.84.165",3897,"174.128.246.102",80,3,186,3,186,0,0,85165.827384,8.902160999990883,167.15042561031237,0
"147.32.84.165",3898,"174.37.196.55",80,3,186,3,186,0,0,85165.830552,8.899015999995754,167.20949821875925,0
"147.32.84.165",3899,"193.23.181.44",80,3,186,3,186,0,0,85165.833807,8.895785000000615,167.2702296649365,0
"147.32.84.165",3900,"193.23.181.44",80,3,186,3,186,0,0,85165.837003,8.892614000011235,167.3298762319066,0
"147.32.84.165",3901,"193.23.181.44",179,3,186,3,186,0,0,85165.840172,8.889473000002909,167.38900045025315,0
"147.32.84.165",3902,"174.128.246.102",80,3,186,3,186,0,0,85165.843403,8.886264999993728,167.44942897843472,0
"147.32.84.165",3903,"193.23.181.44",179,3,186,3,186,0,0,85165.846602,8.883092999996734,167.50922229459346,0
"147.32.84.165",3904,"193.23.181.44",179,3,186,3,186,0,0,85165.849771,8.879947000008542,167.56856769511896,0
"147.32.84.165",3906,"174.128.246.102",80,3,186,3,186,0,0,85165.853001,8.876740000006976,167.62910708197273,0
"147.32.84.165",3907,"193.23.181.44",179,3,186,3,186,0,0,85165.856205,8.87355899999966,167.68919888852457,0
"147.32.84.165",3905,"193.23.181.44",80,3,186,3,186,0,0,85165.85937,8.870417999991332,167.7485773501828,0
"147.32.84.165",3908,"72.20.15.61",80,3,186,3,186,0,0,85165.862609,8.86720300000161,167.80939829614027,0
"147.32.84.165",3909,"174.37.196.55",80,3,186,3,186,0,0,85165.865754,8.866578000001027,167.82122708443185,0
"147.32.84.165",3910,"193.23.181.44",80,3,186,3,186,0,0,85165.868999,8.86651300000085,167.82245737415118,0
"147.32.84.165",3911,"67.19.72.206",80,3,186,3,186,0,0,85165.872204,8.866521000003559,167.82230595285375,0
"147.32.84.165",3912,"193.23.181.44",179,3,186,3,186,0,0,85165.891776,8.850149999998393,168.13274351285233,0
"147.32.84.165",3913,"72.20.15.61",80,3,186,3,186,0,0,85165.895001,8.934808999998495,166.53965406538077,0
"147.32.84.165",3914,"174.128.246.102",80,3,186,3,186,0,0,85165.898203,8.931665999989491,166.59825837662882,0
"147.32.84.165",3915,"174.37.196.55",80,3,186,3,186,0,0,85165.901372,8.928518000000622,166.65699727546007,0
"147.32.84.165",3916,"193.23.181.44",179,3,186,3,186,0,0,85165.904573,8.925339999987045,166.71633797728262,0
"147.32.84.165",3917,"174.128.246.102",80,3,186,3,186,0,0,85165.90777,8.922165999989375,166.7756461829753,0
"147.32.84.165",3918,"174.37.196.55",80,3,186,3,186,0,0,85165.911009,8.918953999993391,166.83570741603808,0
"147.32.84.165",3919,"174.37.196.55",80,3,186,3,186,0,0,85165.914202,8.915783999997075,166.8950257207317,0
"147.32.84.165",3920,"174.37.196.55",80,3,186,3,186,0,0,85165.917355,8.91265199999907,166.95367439457473,0
"147.32.84.165",3921,"72.20.15.61",80,3,186,3,186,0,0,85165.920575,8.90945500000089,167.01358276121843,0
"147.32.84.165",3922,"67.19.72.206",80,3,186,3,186,0,0,85165.92377,8.906283000003896,167.07306516078023,0
"147.32.84.165",3923,"193.23.181.44",179,3,186,3,186,0,0,85165.926957,8.903116999994381,167.1324773111416,0
"147.32.84.165",3924,"174.128.246.102",80,3,186,3,186,0,0,85165.930158,8.89993699999468,167.19219473136602,0
"147.32.84.165",3925,"67.19.72.206",80,3,186,3,186,0,0,85165.933355,8.896760999996332,167.25187964480708,0
"147.32.84.165",3926,"67.19.72.206",80,3,186,3,186,0,0,85165.936557,8.893585000012536,167.31160718629243,0
"147.32.84.165",3927,"174.37.196.55",80,3,186,3,186,0,0,85165.939756,8.890406999998959,167.371415054471,0
"147.32.84.165",3928,"174.128.246.102",80,3,186,3,186,0,0,85165.942956,8.890153000000282,167.37619701257702,0
"147.32.84.165",3929,"193.23.181.44",179,3,186,3,186,0,0,85165.946153,8.89015500000096,167.37615935828333,0
"147.32.84.165",3930,"174.37.196.55",80,3,186,3,186,0,0,85165.949352,8.89015800000925,167.37610287673758,0
"147.32.84.165",3931,"174.37.196.55",80,3,186,3,186,0,0,85165.952552,8.890155999994022,167.37614053127984,0
"147.32.84.165",3932,"72.20.15.61",80,3,186,3,186,0,0,85165.955751,8.890157000001636,167.37612170400658,0
"147.32.84.165",3933,"72.20.15.61",80,8,627,4,385,4,242,85165.958959,0.3853840000083437,7992.028729613364,5023.560915756972
"147.32.84.165",3935,"72.20.15.61",80,3,186,3,186,0,0,85166.001797,9.02856900000188,164.81017091409393,0
"147.32.84.165",3934,"67.19.72.206",80,3,186,3,186,0,0,85166.001961,9.0284629999951,164.81210589231054,0
"147.32.84.165",3936,"174.128.246.102",80,3,186,3,186,0,0,85166.002362,9.0280849999981,164.81900646707615,0
"147.32.84.165",3937,"72.20.15.61",80,3,186,3,186,0,0,85166.002497,9.027971000003163,164.8210877061389,0
"147.32.84.165",3938,"193.23.181.44",179,3,186,3,186,0,0,85166.002608,9.027886000010767,164.82263954133066,0
"147.32.84.165",3939,"193.23.181.44",179,3,186,3,186,0,0,85166.002716,9.027799000003142,164.82422792083455,0
"147.32.84.165",3940,"174.128.246.102",80,3,186,3,186,0,0,85166.002823,9.027715000003809,164.8257615575339,0
"147.32.84.165",3941,"193.23.181.44",80,3,186,3,186,0,0,85166.00294,9.027619000000414,164.82751432021354,0
"147.32.84.165",3942,"72.20.15.61",80,3,186,3,186,0,0,85166.003047,9.02753500000108,164.8290480180716,0
"147.32.84.165",3943,"193.23.181.44",179,3,186,3,186,0,0,85166.003154,9.027451000001747,164.8305817444716,0
"147.32.84.165",3944,"193.23.181.44",179,3,186,3,186,0,0,85166.003268,9.027358000006643,164.83227983191816,0
"147.32.84.165",3945,"193.23.181.44",179,3,186,3,186,0,0,85166.003376,9.02727400000731,164.83381361846278,0
"147.32.84.165",3946,"193.23.181.44",179,3,186,3,186,0,0,85166.003483,9.027190000007977,164.83534743355187,0
"147.32.84.165",3947,"67.19.72.206",80,3,186,3,186,0,0,85166.00375,9.026946999991196,164.83978470256346,0
"147.32.84.165",3948,"174.128.246.102",80,3,186,3,186,0,0,85166.006952,9.023767999999109,164.89785641653762,0
"147.32.84.165",3949,"193.23.181.44",179,3,186,3,186,0,0,85166.010152,9.020590999993146,164.95593248836252,0
"147.32.84.165",3950,"67.19.72.206",80,3,186,3,186,0,0,85166.013352,9.017413000008673,165.01406778180936,0
"147.32.84.165",3951,"184.82.148.43",80,10,1919,5,979,5,940,85166.034403,0.3252420000062557,24080.530804291448,23121.24510320119
"147.32.84.165",3952,"193.23.181.44",179,3,186,3,186,0,0,85166.104537,9.026159999993979,164.85415724970449,0
"147.32.84.165",3953,"67.19.72.206",80,3,186,3,186,0,0,85166.105073,9.02574199999799,164.86179197237539,0
"147.32.84.165",3954,"174.37.196.55",80,3,186,3,186,0,0,85166.105249,9.025615000005928,164.86411175294123,0
"147.32.84.165",3955,"67.19.72.206",80,3,186,3,186,0,0,85166.10537,9.025536999994074,164.86553653272674,0
"147.32.84.165",3956,"193.23.181.44",179,3,186,3,186,0,0,85166.10548,9.025470000007772,164.86676040125542,0
"147.32.84.165",3957,"193.23.181.44",80,3,186,3,186,0,0,85166.105589,9.025408000001335,164.86789295284822,0
"147.32.84.165",3958,"174.128.246.102",80,3,186,3,186,0,0,85166.105696,9.025349000003189,164.8689707178608,0
"147.32.84.165",3959,"193.23.181.44",80,3,186,3,186,0,0,85166.105803,9.025288999997429,164.87006676466802,0
"147.32.84.165",3960,"72.20.15.61",80,3,186,3,186,0,0,85166.105912,9.025227999998606,164.87118109373301,0
"147.32.84.165",3961,"174.37.196.55",80,3,186,3,186,0,0,85166.106019,9.025166999999783,164.87229543786123,0
"147.32.84.165",3962,"193.23.181.44",179,3,186,3,186,0,0,85166.106127,9.028258999998798,164.81582994021306,0
"147.32.84.165",3963,"174.37.196.55",80,3,186,3,186,0,0,85166.106233,9.03133600000001,164.7596767521437,0
"147.32.84.165",3964,"72.20.15.61",80,3,186,3,186,0,0,85166.106339,9.034450999999535,164.70286905093366,0
"147.32.84.165",3965,"193.23.181.44",179,3,186,3,186,0,0,85166.106446,9.037538999997196,164.64659239649885,0
"147.32.84.165",3966,"193.23.181.44",80,3,186,3,186,0,0,85166.106553,9.040638999998919,164.59013571940855,0
"147.32.84.165",3967,"193.23.181.44",179,3,186,3,186,0,0,85166.106687,9.043702999988454,164.53437270130385,0
"147.32.84.165",3968,"174.128.246.102",80,3,186,3,186,0,0,85166.106795,9.046824999997625,164.4775929677418,0
"147.32.84.165",3969,"174.37.196.55",80,3,186,3,186,0,0,85166.106902,9.04986800000188,164.42228770626167,0
"147.32.84.165",3970,"174.37.196.55",80,3,186,3,186,0,0,85166.107009,9.052978000006988,164.3658031643125,0
"147.32.84.165",3971,"67.19.72.206",80,3,186,3,186,0,0,85166.107116,9.056085999996867,164.30939370501946,0
"147.32.84.165",3972,"67.19.72.206",80,3,186,3,186,0,0,85166.107223,9.059166000006371,164.2535306229021,0
"147.32.84.165",3973,"193.23.181.44",179,3,186,3,186,0,0,85166.107346,9.062246000001323,164.19770551359815,0
"147.32.84.165",3974,"174.128.246.102",80,3,186,3,186,0,0,85166.107457,9.065326999989338,164.14190023170153,0
"147.32.84.165",3975,"174.128.246.102",80,3,186,3,186,0,0,85166.107563,9.068406999998842,164.0861509634702,0
"147.32.84.165",3976,"67.19.72.206",80,3,186,3,186,0,0,85166.107691,9.071477000004961,164.03062037187397,0
"147.32.84.165",3977,"67.19.72.206",80,3,186,3,186,0,0,85166.107822,9.074596999998903,163.9742238691349,0
"147.32.84.165",3978,"193.23.181.44",179,3,186,3,186,0,0,85166.164974,9.0205949999945,164.95585934197325,0
"147.32.84.165",3979,"41.212.41.40",6667,2,124,2,124,0,0,85166.190346,2.927572999993572,338.84722942935264,0
"147.32.84.165",3980,"193.23.181.44",80,3,186,3,186,0,0,85166.201548,9.029374999998254,164.79545926493117,0
"147.32.84.165",3981,"193.23.181.44",179,3,186,3,186,0,0,85166.201729,9.029252000007546,164.79770417292113,0
"147.32.84.165",3982,"174.37.196.55",80,3,186,3,186,0,0,85166.202141,9.02886099999887,164.80484083210345,0
"147.32.84.165",3983,"193.23.181.44",179,3,186,3,186,0,0,85166.202321,9.02870699999039,164.80765185995998,0
"147.32.84.165",3985,"174.37.196.55",80,3,186,3,186,0,0,85166.203243,9.027807999998913,164.82406360438537,0
"147.32.84.165",3984,"67.19.72.206",80,3,186,3,186,0,0,85166.203373,9.027698999998393,164.826053682147,0
"147.32.84.165",3986,"67.19.72.206",80,3,186,3,186,0,0,85166.203591,9.027503000004799,164.8296322913666,0
"147.32.84.165",3987,"193.23.181.44",80,3,186,3,186,0,0,85166.203701,9.027416999990237,164.83120254682035,0
"147.32.84.165",3988,"174.128.246.102",80,6,516,4,394,2,122,85166.203832,0.3159730000043055,9975.535884259258,3088.8715174609883
"147.32.84.165",3989,"67.19.72.206",80,3,186,3,186,0,0,85166.20394,9.028026999993017,164.82006533666225,0
"147.32.84.165",3990,"174.37.196.55",80,3,186,3,186,0,0,85166.204091,9.031076999992365,164.76440185387168,0
"147.32.84.165",3991,"67.19.72.206",80,3,186,3,186,0,0,85166.206539,9.031829999992624,164.75066514772922,0
"147.32.84.165",3992,"174.128.246.102",80,7,578,5,456,2,122,85166.209758,3.3266640000074403,1096.594065403612,293.38700872640493
"147.32.84.165",3993,"67.19.72.206",80,3,186,3,186,0,0,85166.212961,9.028640000004089,164.80887486923015,0
"147.32.84.165",3994,"193.23.181.44",179,3,186,3,186,0,0,85166.216164,9.02863200000138,164.80902090148015,0
"147.32.84.165",3995,"174.37.196.55",80,3,186,3,186,0,0,85166.219372,9.028596999996807,164.80965979548387,0
"147.32.84.165",3996,"67.19.72.206",80,3,186,3,186,0,0,85166.222559,9.02860900000087,164.8094407455076,0
"147.32.84.165",3997,"72.20.15.61",80,3,186,3,186,0,0,85166.225763,9.02862300000561,164.8091851879379,0
"147.32.84.165",3998,"193.23.181.44",80,3,186,3,186,0,0,85166.228985,9.028608000007807,164.80945899951723,0
"147.32.84.165",4000,"67.19.72.206",80,3,186,3,186,0,0,85166.232157,9.028644999998505,164.80878359933814,0
"147.32.84.165",3999,"193.23.181.44",80,3,186,3,186,0,0,85166.235365,9.028604999999516,164.80951376210166,0
"147.32.84.165",4001,"184.82.148.44",80,10,1514,5,596,5,918,85166.258213,0.30716900000697933,15522.399720973353,23908.66265747238
"147.32.84.165",4003,"193.23.181.44",80,3,186,3,186,0,0,85166.302327,9.04206000000704,164.56426964639047,0
"147.32.84.165",4002,"67.19.72.206",80,3,186,3,186,0,0,85166.30246,9.045155999992858,164.50794215170805,0
"147.32.84.165",4004,"193.23.181.44",80,3,186,3,186,0,0,85166.302988,9.047830000010435,164.45932339558587,0
"147.32.84.165",4005,"193.23.181.44",179,3,186,3,186,0,0,85166.303234,9.05073899999843,164.4064644887294,0
"147.32.84.165",4006,"67.19.72.206",80,3,186,3,186,0,0,85166.303407,9.05376399999659,164.3515337930788,0
"147.32.84.165",4007,"193.23.181.44",80,3,186,3,186,0,0,85166.303517,9.056895000001532,164.29471689798197,0
"147.32.84.165",4009,"193.23.181.44",80,3,186,3,186,0,0,85166.303627,9.059991999994963,164.23855561912495,0
"147.32.84.165",4010,"67.19.72.206",80,3,186,3,186,0,0,85166.303765,9.063025999988895,164.18357400738157,0
"147.32.84.165",4011,"174.128.246.102",80,3,186,3,186,0,0,85166.303891,9.066141000002972,164.1271628137608,0
"147.32.84.165",4012,"72.20.15.61",80,3,186,3,186,0,0,85166.303998,9.069204999992508,164.0717130113642,0
"147.32.84.165",4013,"193.23.181.44",80,3,186,3,186,0,0,85166.304105,9.072291999997105,164.0158848503195,0
"147.32.84.165",4014,"193.23.181.44",80,3,186,3,186,0,0,85166.30422,9.075377999994089,163.96011273590688,0
"147.32.84.165",4015,"193.23.181.44",179,3,186,3,186,0,0,85166.304331,9.078436999989208,163.90486600301008,0
"147.32.84.165",4016,"193.23.181.44",80,3,186,3,186,0,0,85166.304441,9.081556000004639,163.84857396675636,0
"147.32.84.165",4008,"174.37.196.55",80,3,186,3,186,0,0,85166.304546,9.084661000000779,163.79257299748141,0
"147.32.84.165",4017,"67.19.72.206",80,3,186,3,186,0,0,85166.304665,9.087752999999793,163.73684452031586,0
"147.32.84.165",4018,"174.37.196.55",80,3,186,3,186,0,0,85166.304773,9.090846000006422,163.68113594696783,0
"147.32.84.165",4019,"193.23.181.44",80,3,186,3,186,0,0,85166.305741,9.09302800000296,163.6418583556012,0
"147.32.84.165",4020,"193.23.181.44",80,3,186,3,186,0,0,85166.308941,9.09302800000296,163.6418583556012,0
"147.32.84.165",4021,"72.20.15.61",80,3,186,3,186,0,0,85166.312144,9.09302500000922,163.6419123447358,0
"147.32.84.165",4022,"193.23.181.44",80,3,186,3,186,0,0,85166.363702,9.04466699999466,164.51683627499813,0
"147.32.84.165",4023,"174.37.196.55",80,3,186,3,186,0,0,85166.401906,9.030270999995992,164.77910795818426,0
"147.32.84.165",4024,"174.128.246.102",80,3,186,3,186,0,0,85166.40209,9.030145999990054,164.78138891681695,0
"147.32.84.165",4026,"72.20.15.61",80,3,186,3,186,0,0,85166.403033,9.029223999998067,164.79821521764424,0
"147.32.84.165",4025,"67.19.72.206",80,3,186,3,186,0,0,85166.403149,9.029131999996025,164.7998943863768,0
"147.32.84.165",4027,"72.20.15.61",80,3,186,3,186,0,0,85166.403712,9.02859200000239,164.80975106634634,0
"147.32.84.165",4028,"67.19.72.206",80,3,186,3,186,0,0,85166.403862,9.028467999989516,164.81201461883987,0
"147.32.84.165",4029,"174.128.246.102",80,3,186,3,186,0,0,85166.404008,9.02996100000746,164.78476485100774,0
"147.32.84.165",4030,"174.37.196.55",80,3,186,3,186,0,0,85166.404124,9.033044000010705,164.72852340786082,0
"147.32.84.165",4031,"174.37.196.55",80,3,186,3,186,0,0,85166.404228,9.036139999996522,164.672083433919,0
"147.32.84.165",4032,"174.128.246.102",80,3,186,3,186,0,0,85166.404335,9.039235000003828,164.61570033297838,0
"147.32.84.165",4033,"174.128.246.102",80,3,186,3,186,0,0,85166.40444,9.042398999998113,164.55810012368516,0
"147.32.84.165",4034,"174.128.246.102",80,3,186,3,186,0,0,85166.404547,9.045444000003044,164.50270434480598,0
"147.32.84.165",4035,"67.19.72.206",80,3,186,3,186,0,0,85166.404656,9.048534000001382,164.44652802318836,0
"147.32.84.165",4036,"193.23.181.44",179,3,186,3,186,0,0,85166.404764,9.051655999996001,164.38980889250072,0
"147.32.84.165",4037,"193.23.181.44",80,3,186,3,186,0,0,85166.404871,9.054718999992474,164.33419965890016,0
"147.32.84.165",4038,"67.19.72.206",80,3,186,3,186,0,0,85166.404978,9.057843999995384,164.2775035649497,0
"147.32.84.165",4039,"193.23.181.44",179,3,186,3,186,0,0,85166.408165,9.057847999996739,164.27743101899432,0
"147.32.84.165",4041,"174.128.246.102",80,3,186,3,186,0,0,85166.411359,9.057858999993186,164.27723151807942,0
"147.32.84.165",4040,"174.128.246.102",80,3,186,3,186,0,0,85166.414562,9.057860000000801,164.27721338151267,0
"147.32.84.165",4043,"67.19.72.206",80,3,186,3,186,0,0,85166.417758,9.057813000006718,164.2780657978804,0
"147.32.84.165",4042,"193.23.181.44",179,3,186,3,186,0,0,85166.420965,9.057824999996228,164.27784815898073,0
"147.32.84.165",4044,"217.163.21.36",80,14,6141,7,810,7,5331,85166.477576,0.18897499999729916,34290.250033563236,225680.6455912662
"147.32.84.165",4045,"193.23.181.44",80,3,186,3,186,0,0,85166.502364,9.028974000000744,164.8027782558547,0
"147.32.84.165",4046,"193.23.181.44",179,3,186,3,186,0,0,85166.502546,9.028913000001921,164.8038916755188,0
"147.32.84.165",4047,"193.23.181.44",179,3,186,3,186,0,0,85166.503187,9.028319000004558,164.81473461441146,0
"147.32.84.165",4048,"174.37.196.55",80,3,186,3,186,0,0,85166.503702,9.027853999999934,164.8232237694596,0
"147.32.84.165",4049,"67.19.72.206",80,3,186,3,186,0,0,85166.503814,9.027788000006694,164.8244287525246,0
"147.32.84.165",4050,"74.125.39.27",25,3,186,3,186,0,0,85166.503977,9.027673000004143,164.82652838658615,0
"147.32.84.165",4051,"174.37.196.55",80,3,186,3,186,0,0,85166.504088,9.027608999997028,164.8276969018585,0
"147.32.84.165",4052,"193.23.181.44",80,3,186,3,186,0,0,85166.504196,9.02755199999956,164.8287376245601,0
"147.32.84.165",4053,"174.128.246.102",80,3,186,3,186,0,0,85166.504313,9.027490000007674,164.829869653551,0
"147.32.84.165",4054,"193.23.181.44",80,3,186,3,186,0,0,85166.504421,9.027412999988883,164.83127558269823,0
"147.32.84.165",4055,"174.128.246.102",80,10,1191,7,1007,3,184,85166.504527,9.293130000005476,866.8769295162397,158.39657897814112
"147.32.84.165",4056,"67.19.72.206",80,3,186,3,186,0,0,85166.504634,9.027245000004768,164.83434314668693,0
"147.32.84.165",4057,"72.20.15.61",80,3,186,3,186,0,0,85166.512673,9.019251999998232,164.98042187980684,0
"147.32.84.165",4058,"193.23.181.44",179,3,186,3,186,0,0,85166.532278,8.999697000006563,165.33889974283744,0
"147.32.84.165",4059,"174.37.196.55",80,3,186,3,186,0,0,85166.553058,8.978963999994448,165.72067779767465,0
"147.32.84.165",4060,"174.128.246.102",80,9,810,6,626,3,184,85166.602692,3.3886970000021392,1477.8541722664606,434.3852519121865
"147.32.84.165",4061,"193.23.181.44",80,3,186,3,186,0,0,85166.603047,9.029261000003316,164.79753990935177,0
"147.32.84.165",4063,"174.37.196.55",80,9,714,6,532,3,182,85166.603953,9.27072300000873,459.0796208662466,157.05355450687384
"147.32.84.165",4062,"174.128.246.102",80,3,186,3,186,0,0,85166.604172,9.028263000000152,164.81575691802232,0
"147.32.84.165",4064,"67.19.72.206",80,3,186,3,186,0,0,85166.604491,9.027973999996902,164.82103293612838,0
"147.32.84.165",4065,"72.20.15.61",80,3,186,3,186,0,0,85166.604767,9.027727000007872,164.8255424647536,0
"147.32.84.165",4066,"67.19.72.206",80,3,186,3,186,0,0,85166.605154,9.02737199999683,164.8320242037796,0
"147.32.84.165",4067,"174.128.246.102",80,7,564,4,382,3,182,85166.605398,0.32700499999918975,9345.422852884732,4452.531306871784
"147.32.84.165",4068,"193.23.181.44",80,3,186,3,186,0,0,85166.605639,9.02691899999627,164.8402960080416,0
"147.32.84.165",4069,"217.163.21.36",80,10,1451,5,701,5,750,85166.624997,0.13982899999246,40106.129631924705,42909.553814470084
"147.32.84.165",4070,"67.19.72.206",80,6,366,3,186,3,180,85166.67043,1.4915840000030585,997.5971852721327,965.4166309085156
"147.32.84.165",4071,"174.128.246.102",80,3,186,3,186,0,0,85166.70307,9.029939000000013,164.78516632282873,0
"147.32.84.165",4072,"193.23.181.44",179,3,186,3,186,0,0,85166.703985,9.029083000001265,164.80078874009592,0
"147.32.84.165",4073,"72.20.15.61",80,3,186,3,186,0,0,85166.704514,9.028575999996974,164.81004313421062,0
"147.32.84.165",4074,"72.20.15.61",80,3,186,3,186,0,0,85166.704625,9.028489999996964,164.81161301618548,0
"147.32.84.165",4075,"193.23.181.44",80,3,186,3,186,0,0,85166.704754,9.028383999990183,164.81354802826485,0
"147.32.84.165",4076,"72.20.15.61",80,3,186,3,186,0,0,85166.704892,9.028273000003537,164.81557436282853,0
"147.32.84.165",4077,"193.23.181.44",179,3,186,3,186,0,0,85166.705005,9.02818200000911,164.81723562933252,0
"147.32.84.165",4078,"174.128.246.102",80,3,186,3,186,0,0,85166.705112,9.0280960000091,164.81880564833384,0
"147.32.84.165",4079,"193.23.181.44",179,3,186,3,186,0,0,85166.70522,9.028011000002152,164.82035744081895,0
"147.32.84.165",4080,"174.128.246.102",80,3,186,3,186,0,0,85166.705328,9.027926000009757,164.82190926225934,0
"147.32.84.165",4081,"174.37.196.55",80,3,186,3,186,0,0,85166.705434,9.027841000002809,164.8234611131872,0
"147.32.84.165",4082,"174.128.246.102",80,3,186,3,186,0,0,85166.705543,9.027751999994507,164.82508602373053,0
"147.32.84.165",4083,"67.19.72.206",80,3,186,3,186,0,0,85166.70566,9.027658999999403,164.82678399794437,0
"147.32.84.165",4084,"174.128.246.102",80,3,186,3,186,0,0,85166.705777,9.027564000003622,164.8285185238679,0
"147.32.84.165",4086,"72.20.15.61",80,3,186,3,186,0,0,85166.722397,9.010970999996061,165.13203737983957,0
"147.32.84.165",4087,"193.23.181.44",179,3,186,3,186,0,0,85166.72251,9.010879999987083,165.13370503237564,0
"147.32.84.165",4088,"174.37.196.55",80,3,186,3,186,0,0,85166.722621,9.01079000000027,165.13535439178534,0
"147.32.84.165",4089,"72.20.15.61",80,3,186,3,186,0,0,85166.722729,9.010706000000937,165.1368938238408,0
"147.32.84.165",4085,"67.19.72.206",80,3,186,3,186,0,0,85166.722834,9.01062400000228,165.13839663042464,0
"147.32.84.165",4091,"217.163.21.35",80,11,3549,6,1919,5,1630,85166.741777,0.3079980000038631,49844.47950898202,42337.93725880182
"147.32.84.165",4090,"193.23.181.44",80,3,186,3,186,0,0,85166.741907,8.991573999999673,165.48826712654025,0
"147.32.84.165",4092,"193.23.181.44",80,3,186,3,186,0,0,85166.766967,8.966534999999567,165.95039220836944,0
"147.32.84.165",4093,"67.19.72.206",80,3,186,3,186,0,0,85166.769053,8.964474000007613,165.98854545160557,0
"147.32.84.165",4094,"72.20.15.61",80,3,186,3,186,0,0,85166.857773,8.97487700000056,165.7961440585656,0
"147.32.84.165",4095,"174.37.196.55",80,3,186,3,186,0,0,85166.860975,8.971775999991223,165.85344975191708,0
"147.32.84.165",4096,"174.128.246.102",80,3,186,3,186,0,0,85166.864169,8.968606000009459,165.91207150792783,0
"147.32.84.165",4097,"193.23.181.44",80,3,186,3,186,0,0,85166.867369,8.96542700000282,165.97090133013543,0
"147.32.84.165",4098,"72.20.15.61",80,3,186,3,186,0,0,85166.870554,8.96226800000295,166.02940237889675,0
"147.32.84.165",4099,"72.20.15.61",80,3,186,3,186,0,0,85166.873762,8.95908299999428,166.08842668395303,0
"147.32.84.165",4100,"67.19.72.206",80,3,186,3,186,0,0,85166.876954,8.955911999990349,166.14723324677638,0
"147.32.84.165",4101,"193.23.181.44",80,3,186,3,186,0,0,85166.880153,8.952734999998938,166.20619285616925,0
"147.32.84.165",4102,"174.128.246.102",80,3,186,3,186,0,0,85166.883353,8.94955900000059,166.26517574775494,0
"147.32.84.165",4103,"67.19.72.206",80,3,186,3,186,0,0,85166.886552,8.94638200000918,166.3242191087384,0
"147.32.84.165",4104,"67.19.72.206",80,3,186,3,186,0,0,85166.889753,8.943206000010832,166.3832858147512,0
"147.32.84.165",4105,"72.20.15.61",80,3,186,3,186,0,0,85166.892953,8.940030999990995,166.4423758711238,0
"147.32.84.165",4106,"174.37.196.55",80,3,186,3,186,0,0,85166.896152,8.936854999992647,166.50152654387077,0
"147.32.84.165",4107,"174.37.196.55",80,3,186,3,186,0,0,85166.899386,8.93364199998905,166.56140910972522,0
"147.32.84.165",4108,"193.23.181.44",179,3,186,3,186,0,0,85166.902552,8.930500000002212,166.62001007778193,0
"147.32.84.165",4109,"67.19.72.206",80,3,186,3,186,0,0,85166.905753,8.927322000003187,166.67932443788504,0
"147.32.84.165",4110,"67.19.72.206",80,3,186,3,186,0,0,85166.909047,8.924050000001444,166.74043735745084,0
"147.32.84.165",4111,"174.128.246.102",80,3,186,3,186,0,0,85166.912153,8.9209669999982,166.79806124160086,0
"147.32.84.165",4112,"193.23.181.44",80,3,186,3,186,0,0,85166.915352,8.917788999999175,166.8575024594255,0
"147.32.84.165",4113,"193.23.181.44",179,3,186,3,186,0,0,85166.921803,9.011765999995987,165.1174697612724,0
"147.32.84.165",4114,"174.37.196.55",80,3,186,3,186,0,0,85166.924952,9.008680999992066,165.17401382081468,0
"147.32.84.165",4115,"174.128.246.102",80,3,186,3,186,0,0,85166.928151,9.005506000001333,165.23224791586168,0
"147.32.84.165",4116,"72.20.15.61",80,3,186,3,186,0,0,85166.931354,9.002326999994693,165.2905965314165,0
"147.32.84.165",4117,"72.20.15.61",80,3,186,3,186,0,0,85166.93455,8.9991549999977,165.34885775390916,0
"147.32.84.165",4118,"193.23.181.44",179,3,186,3,186,0,0,85166.93775,8.99597800000629,165.40725199627653,0
"147.32.84.165",4119,"193.23.181.44",80,3,186,3,186,0,0,85166.940953,8.99279899999965,165.46572429785854,0
"147.32.84.165",4120,"193.23.181.44",179,3,186,3,186,0,0,85166.944153,8.989621000000625,165.5242195416132,0
"147.32.84.165",4121,"174.128.246.102",80,3,186,3,186,0,0,85166.947353,8.986445000002277,165.58271930664716,0
"147.32.84.165",4122,"193.23.181.44",179,3,186,3,186,0,0,85166.950553,8.98326900000393,165.6412604364123,0
"147.32.84.165",4123,"174.128.246.102",80,3,186,3,186,0,0,85166.953756,8.980089000004227,165.69991678248397,0
"147.32.84.165",4124,"193.23.181.44",179,3,186,3,186,0,0,85166.956953,8.976915999999619,165.75848543086101,0
"147.32.84.165",4125,"193.23.181.44",179,3,186,3,186,0,0,85166.960153,8.97373999998672,165.81715093174108,0
"147.32.84.165",4126,"193.23.181.44",179,3,186,3,186,0,0,85166.963372,8.970543999996153,165.87622779628953,0
"147.32.84.165",4127,"67.19.72.206",80,3,186,3,186,0,0,85166.966554,8.967388000004576,165.93460659884917,0
"147.32.84.165",4128,"174.128.246.102",80,3,186,3,186,0,0,85166.969776,8.964183000003686,165.99393385871173,0
"147.32.84.165",4129,"193.23.181.44",80,3,186,3,186,0,0,85166.972953,8.961028999998234,166.05235849591529,0
"147.32.84.165",4130,"217.163.21.36",80,10,2277,5,1156,5,1121,85166.979371,0.1716300000116462,53883.35372238224,52251.93730345198
"147.32.84.165",4131,"193.23.181.44",80,3,186,3,186,0,0,85167.005857,9.027799000003142,164.82422792083455,0
"147.32.84.165",4132,"174.37.196.55",80,3,186,3,186,0,0,85167.006801,9.026975000000675,164.83927339999155,0
"147.32.84.165",4133,"67.19.72.206",80,3,186,3,186,0,0,85167.00716,9.02667800000927,164.84469701904422,0
"147.32.84.165",4134,"72.20.15.61",80,3,186,3,186,0,0,85167.00743,9.02645499999926,164.84876953356795,0
"147.32.84.165",4135,"174.37.196.55",80,3,186,3,186,0,0,85167.007665,9.02626600000076,164.85222128395893,0
"147.32.84.165",4136,"174.128.246.102",80,3,186,3,186,0,0,85167.007961,9.026017000011052,164.8567690486488,0
"147.32.84.165",4137,"174.37.196.55",80,3,186,3,186,0,0,85167.008193,9.025831999999355,164.8601480727878,0
"147.32.84.165",4138,"174.128.246.102",80,3,186,3,186,0,0,85167.008443,9.025628999996115,164.86385602606094,0
"147.32.84.165",4139,"72.20.15.61",80,7,558,4,376,3,182,85167.008678,0.42540599999483675,7070.892277110593,3422.6127511545956
"147.32.84.165",4140,"193.23.181.44",80,3,186,3,186,0,0,85167.011354,9.022767999995267,164.91613216706676,0
"147.32.84.165",4141,"193.23.181.44",179,3,186,3,186,0,0,85167.014629,9.019538000007742,164.97519052513806,0
"147.32.84.165",4142,"67.19.72.206",80,3,186,3,186,0,0,85167.017756,9.016459000005852,165.0315273433877,0
"147.32.84.165",4143,"174.37.196.55",80,3,186,3,186,0,0,85167.020953,9.013309000001755,165.08920308842295,0
"147.32.84.165",4144,"174.128.246.102",80,3,186,3,186,0,0,85167.024156,9.010152000002563,165.14704746374719,0
"147.32.84.165",4145,"174.37.196.55",80,3,186,3,186,0,0,85167.027354,9.007002999991528,165.2047856541626,0
"147.32.84.165",4146,"174.37.196.55",80,3,186,3,186,0,0,85167.030573,9.003833000009763,165.26294967914072,0
"147.32.84.165",4147,"174.128.246.102",80,3,186,3,186,0,0,85167.033773,9.000680999990436,165.32082405782197,0
"147.32.84.165",4148,"193.23.181.44",80,3,186,3,186,0,0,85167.036972,8.997573000000557,165.37793024851345,0
"147.32.84.165",4149,"193.23.181.44",80,3,186,3,186,0,0,85167.040175,8.99442000000272,165.4359035935113,0
"147.32.84.165",4150,"174.128.246.102",80,3,186,3,186,0,0,85167.04337,8.991273000006913,165.49380716155054,0
"147.32.84.165",4151,"193.23.181.44",80,3,186,3,186,0,0,85167.046573,8.988117000000784,165.55191704779435,0
"147.32.84.165",4152,"217.163.21.35",80,13,5301,7,2434,6,2867,85167.108553,0.28400100000726525,68563.13886043314,80760.27901103608
"147.32.84.165",4153,"193.23.181.44",80,3,186,3,186,0,0,85167.111753,9.022369999991497,164.92340704287258,0
"147.32.84.165",4154,"193.23.181.44",80,3,186,3,186,0,0,85167.114954,9.019227999990107,164.98086088982694,0
"147.32.84.165",4155,"174.37.196.55",80,3,186,3,186,0,0,85167.118184,9.016018999987864,165.03958121672136,0
"147.32.84.165",4156,"193.23.181.44",179,3,186,3,186,0,0,85167.121383,9.012844999990193,165.09770222406124,0
"147.32.84.165",4157,"174.37.196.55",80,3,186,3,186,0,0,85167.124553,9.009699000002001,165.15535091679195,0
"147.32.84.165",4158,"193.23.181.44",179,3,186,3,186,0,0,85167.127781,9.006492000000435,165.21415885340576,0
"147.32.84.165",4159,"67.19.72.206",80,3,186,3,186,0,0,85167.130979,9.003315000009025,165.27245797781245,0
"147.32.84.165",4160,"193.23.181.44",179,3,186,3,186,0,0,85167.13418,9.000138000003062,165.33079826103707,0
"147.32.84.165",4161,"72.20.15.61",80,3,186,3,186,0,0,85167.264153,8.87018800000078,167.75292699544462,0
"147.32.84.165",4162,"67.19.72.206",80,3,186,3,186,0,0,85167.267353,8.966887999995379,165.94385922973132,0
"147.32.84.165",4163,"173.241.240.4",80,9,2195,5,1165,4,1030,85167.276954,0.13515800000459421,68956.33258618209,60965.68460409233
"147.32.84.165",4164,"92.240.244.181",80,10,1760,6,1366,4,394,85167.280153,5.0976990000053775,2143.712290582177,618.3181863026191
"147.32.84.165",4165,"174.128.246.102",80,6,578,4,456,2,122,85167.705875,0.31766200000129174,11483.904275567005,3072.4480737262597
"147.32.84.165",4166,"174.37.196.55",80,3,186,3,186,0,0,85167.807061,9.029032000005827,164.80171960837438,0
"147.32.84.165",4167,"193.23.181.44",80,3,186,3,186,0,0,85167.865089,8.971069000006537,165.8665204780964,0
"147.32.84.165",4168,"72.20.15.61",80,8,671,5,489,3,182,85168.138304,3.2482310000050347,1204.3478434858655,448.24398264709106
"147.32.84.165",4169,"67.19.72.206",80,3,186,3,186,0,0,85168.141521,8.89486400000169,167.2875493093225,0
"147.32.84.165",4170,"72.20.15.61",80,3,186,3,186,0,0,85168.231101,8.90662500000326,167.06664982520937,0
"147.32.84.165",4171,"67.19.72.206",80,3,186,3,186,0,0,85168.234302,8.903447000004235,167.12628266325305,0
"147.32.84.165",4172,"193.23.181.44",80,3,186,3,186,0,0,85168.237468,8.900304999988293,167.18528185292047,0
"147.32.84.165",4173,"67.19.72.206",80,3,186,3,186,0,0,85168.240688,8.897108999997727,167.2453377833609,0
"147.32.84.165",4174,"67.19.72.206",80,3,186,3,186,0,0,85168.243899,8.893921000009868,167.30528638587515,0
"147.32.84.165",4175,"174.128.246.102",80,9,725,6,543,3,182,85168.283124,9.180298000006587,473.1872538339042,158.60051601799367
"147.32.84.165",4176,"193.23.181.44",80,3,186,3,186,0,0,85168.286313,8.851553999993484,168.10607493340663,0
"147.32.84.165",4177,"174.37.196.55",80,3,186,3,186,0,0,85168.369072,8.867926999999327,167.79569791227567,0
"147.32.84.165",4178,"174.37.196.55",80,3,186,3,186,0,0,85168.37229,8.864814999993541,167.85460271884796,0
"147.32.84.165",4179,"67.19.72.206",80,3,186,3,186,0,0,85168.429869,8.90811499999836,167.03870571947868,0
"147.32.84.165",4180,"72.20.15.61",80,3,186,3,186,0,0,85168.721671,9.018291000000318,164.99800239313055,0
"147.32.84.165",4181,"174.37.196.55",80,3,186,3,186,0,0,85168.72487,9.015119999996386,165.0560391875645,0
"147.32.84.165",4182,"174.128.246.102",80,3,186,3,186,0,0,85168.728118,9.011903000005987,165.11495962606472,0
"147.32.84.165",4183,"174.37.196.55",80,3,186,3,186,0,0,85169.010877,9.029905000003055,164.7857867828617,0
"147.32.84.165",4184,"193.23.181.44",80,3,186,3,186,0,0,85169.211907,9.030102999997325,164.7821735810146,0
"147.32.84.165",4185,"193.23.181.44",80,3,186,3,186,0,0,85169.212127,9.029905999996117,164.78576853409547,0
"147.32.84.165",4186,"174.128.246.102",80,3,186,3,186,0,0,85169.311808,9.02987500000745,164.7863342514456,0
"147.32.84.165",4187,"67.19.72.206",80,3,186,3,186,0,0,85169.311933,9.02979799998866,164.78773943801056,0
"147.32.84.165",4188,"67.19.72.206",80,3,186,3,186,0,0,85169.374173,8.967600999996648,165.93066529170468,0
"147.32.84.165",4189,"72.20.15.61",80,3,186,3,186,0,0,85169.713445,9.03004699999292,164.7831954807286,0
"147.32.84.165",4190,"193.23.181.44",80,3,186,3,186,0,0,85169.715697,9.027837999994517,164.8235158850772,0
"147.32.84.165",4191,"72.20.15.61",80,3,186,3,186,0,0,85169.718897,9.024686000004294,164.88108284313626,0
"147.32.84.165",4192,"193.23.181.44",179,3,186,3,186,0,0,85169.722126,9.021502000003238,164.93927507852527,0
"147.32.84.165",4193,"174.37.196.55",80,3,186,3,186,0,0,85169.725346,9.018326999997953,164.99734374239677,0
"147.32.84.165",4194,"174.37.196.55",80,3,186,3,186,0,0,85170.014677,9.028908000007505,164.80398293999266,0
"147.32.84.165",4195,"72.20.15.61",80,3,186,3,186,0,0,85170.015033,9.028613000002224,164.80936772897826,0
"147.32.84.165",4196,"193.23.181.44",80,3,186,3,186,0,0,85171.017218,9.03016700000444,164.78100571110903,0
"147.32.84.165",4197,"67.19.72.206",80,3,186,3,186,0,0,85171.202168,8.945720000003348,166.33652741192918,0
"147.32.84.165",4198,"174.128.246.102",80,3,186,3,186,0,0,85171.719261,9.030369000000064,164.77731973078724,0
"147.32.84.165",4199,"174.37.196.55",80,3,186,3,186,0,0,85174.241309,8.916736999992281,166.8771883707334,0
"147.32.84.165",4200,"193.23.181.44",179,3,186,3,186,0,0,85174.244523,8.913618999999017,166.9355623120266,0
"147.32.84.165",4201,"184.82.148.43",80,10,1919,5,979,5,940,85174.318087,0.3600449999939883,21752.83645136239,20886.27810447461
"147.32.84.165",4202,"184.82.148.44",80,10,1513,5,596,5,917,85174.570209,0.30874300000141375,15443.265110393328,23760.86259434678
"147.32.84.165",4203,"72.20.15.61",80,3,186,3,186,0,0,85174.745125,9.079469999996945,163.88621802819995,0
"147.32.84.165",4204,"174.128.246.102",80,10,805,6,563,4,242,85174.74833,9.406124000001,478.83697897237175,205.8233550822628
"147.32.84.165",4205,"72.20.15.61",80,3,186,3,186,0,0,85174.768326,9.06266599999799,164.19009593869288,0
"147.32.84.165",4206,"217.163.21.36",80,13,6074,6,749,7,5325,85174.786019,0.20681399999011774,28972.893519231377,205982.18690241265
"147.32.84.165",4207,"217.163.21.36",80,10,1446,5,698,5,748,85174.95459,0.13862200001312885,40282.20628378714,43167.751146522605
"147.32.84.165",4208,"173.192.170.88",80,26,4416,12,943,14,3473,85174.955508,34.85961600000155,216.41087497922135,797.0254176064005
"147.32.84.165",4209,"217.163.21.35",80,13,4761,7,1992,6,2769,85175.047756,0.2934149999928195,54312.15173181326,75497.16272358982
"147.32.84.165",4210,"193.23.181.44",179,13,966,7,606,6,360,85175.26719,9.19720999999845,527.1163755096184,313.138440896803
"147.32.84.165",4211,"193.23.181.44",179,13,962,7,602,6,360,85175.270389,9.180366000000504,524.5978210454502,313.71298268498686
"147.32.84.165",4212,"67.19.72.206",80,3,186,3,186,0,0,85175.27359,8.988397000008263,165.5467598948547,0
"147.32.84.165",4213,"195.113.232.88",80,187,253783,130,14167,57,239616,85175.28799,338.02947200000926,335.2843742571562,5670.890140608649
"147.32.84.165",4214,"174.37.196.55",80,3,186,3,186,0,0,85175.411569,8.951493000000482,166.2292536004798,0
"147.32.84.165",4215,"174.37.196.55",80,3,186,3,186,0,0,85175.482018,8.980114000005415,165.6994554856545,0
"147.32.84.165",4216,"174.128.246.102",80,3,186,3,186,0,0,85175.733743,9.030434000000241,164.77613368305003,0
"147.32.84.165",4217,"67.19.72.206",80,3,186,3,186,0,0,85175.753825,9.010410999995656,165.1423003901506,0
"147.32.84.165",4218,"114.120.50.74",6667,2,124,2,124,0,0,85176.191132,2.9532749999925727,335.89828241612946,0
"147.32.84.165",4220,"193.23.181.44",179,3,186,3,186,0,0,85177.302063,9.047889000008581,164.45825097971348,0
"147.32.84.165",4221,"31.192.109.161",80,10,1174,5,540,5,634,85177.594584,0.24646899999061134,17527.5592474695,20578.652894251227
"147.32.84.165",4222,"193.23.181.44",80,3,186,3,186,0,0,85178.843616,9.031499999997322,164.75668493610598,0
"147.32.84.165",4223,"184.82.148.43",80,10,1919,5,979,5,940,85182.56801,0.3578189999971073,21888.16133314138,21016.212107408475
"147.32.84.165",4224,"184.82.148.44",80,10,1513,5,596,5,917,85182.816206,0.32279199999175034,14771.121961268733,22726.709460542665
"147.32.84.165",4225,"217.163.21.36",80,14,6137,7,809,7,5328,85183.046419,0.18730399999185465,34553.4532112579,227565.8822120916
"147.32.84.165",4226,"72.20.15.61",80,3,186,3,186,0,0,85183.058183,9.030517999999574,164.77460096974173,0
"147.32.84.165",4227,"174.37.196.55",80,3,186,3,186,0,0,85183.058323,9.030472999991616,164.77542206276254,0
"147.32.84.165",4228,"217.163.21.36",80,10,1448,5,699,5,749,85183.195207,0.13851900000008754,40369.91315268278,43257.60365001345
"147.32.84.165",4229,"217.163.21.35",80,11,3576,6,1948,5,1628,85183.28838,0.22295999999914784,69895.94546133639,58414.06530341666
"147.32.84.165",4230,"193.23.181.44",80,8,894,5,508,3,386,85183.459221,0.13395000000309665,30339.678983994392,23053.378125633535
"147.32.84.165",4231,"217.163.21.36",80,10,2274,5,1154,5,1120,85183.467211,0.1390830000018468,66377.63062255929,64421.96386244922
"147.32.84.165",4232,"193.23.181.44",179,10,740,5,440,5,300,85183.527276,0.1850150000100257,19025.484419151184,12971.921194875807
"147.32.84.165",4233,"217.163.21.35",80,13,5353,7,2463,6,2890,85183.561328,0.2364380000071833,83336.85786295506,97784.62006656115
"147.32.84.165",4234,"193.23.181.44",80,10,993,6,549,4,444,85183.590257,0.22792999999364838,19269.073838996137,15583.731847931303
"147.32.84.165",4235,"193.23.181.44",179,10,751,5,451,5,300,85183.672544,0.2551870000024792,14138.651263445818,9404.867802735576
"147.32.84.165",4236,"173.241.240.4",80,9,2194,5,1164,4,1030,85183.682175,0.1873770000092918,49696.60096777208,43975.51460206636
"147.32.84.165",4237,"92.240.244.181",80,10,1758,6,1364,4,394,85183.685343,5.096260999998776,2141.1776202205147,618.4926556941956
"147.32.84.165",4238,"67.19.72.206",80,5,306,3,186,2,120,85183.8214,3.606379000004381,412.6022251122781,266.19498394340525
"147.32.84.165",4239,"72.20.15.61",80,3,186,3,186,0,0,85183.834144,8.956934000001638,166.1282755907019,0
"147.32.84.165",4240,"67.19.72.206",80,3,186,3,186,0,0,85183.837344,8.953756999995676,166.18722174398061,0
"147.32.84.165",4241,"193.23.181.44",80,8,854,5,470,3,384,85183.840544,0.12144799999077804,30959.7523243323,25294.776367114053
"147.32.84.165",4242,"72.20.15.61",80,3,186,3,186,0,0,85183.843744,8.947379999997793,166.30566713388356,0
"147.32.84.165",4243,"193.23.181.44",179,10,779,5,479,5,300,85183.846944,0.19273199999588542,19882.53118362186,12452.524749658785
"147.32.84.165",4244,"72.20.15.61",80,3,186,3,186,0,0,85183.850144,8.941004000007524,166.4242628678779,0
"147.32.84.165",4245,"67.19.72.206",80,3,186,3,186,0,0,85183.901888,8.989833000014187,165.52031611684575,0
"147.32.84.165",4246,"174.37.196.55",80,3,186,3,186,0,0,85183.911146,8.980638000008184,165.68978729558455,0
"147.32.84.165",4247,"174.37.196.55",80,3,186,3,186,0,0,85183.992831,8.998187999997754,165.36662714764034,0
"147.32.84.165",4248,"174.37.196.55",80,3,186,3,186,0,0,85184.326858,8.966073999996297,165.9589247200742,0
"147.32.84.165",4249,"174.128.246.102",80,8,661,4,419,4,242,85184.331566,0.31505699999979697,10639.344626534754,6144.919808165658
"147.32.84.165",4250,"72.20.15.61",80,3,186,3,186,0,0,85184.363263,9.029618999993545,164.7910061322702,0
"147.32.84.165",4251,"72.20.15.61",80,3,186,3,186,0,0,85184.489933,9.003352999992785,165.27176042094456,0
"147.32.84.165",4252,"193.23.181.44",80,8,892,5,508,3,384,85184.76443,0.1217880000040168,33369.46168642199,25224.16001493316
"147.32.84.165",4253,"193.23.181.44",80,8,808,5,424,3,384,85184.764656,0.12136200000531971,27949.440515575854,25312.700844295116
"147.32.84.165",4254,"193.23.181.44",179,10,751,5,451,5,300,85184.764792,0.19111299999349285,18878.8831744719,12558.015415391506
"147.32.84.165",4255,"193.23.181.44",179,3,186,3,186,0,0,85184.826163,8.968865999995614,165.90726185458982,0
"147.32.84.165",4256,"72.20.15.61",80,3,186,3,186,0,0,85184.826497,8.968555999992532,165.91299647359497,0
"147.32.84.165",4257,"174.37.196.55",80,3,186,3,186,0,0,85184.829215,8.965863999997964,165.96281183836135,0
"147.32.84.165",4258,"72.20.15.61",80,3,186,3,186,0,0,85184.863608,9.030968000006396,164.76639049091372,0
"147.32.84.165",4259,"193.23.181.44",80,3,186,3,186,0,0,85184.863886,9.030810999989626,164.76925494307315,0
"147.32.84.165",4260,"193.23.181.44",179,3,186,3,186,0,0,85184.96491,9.030482000001939,164.7752578433444,0
"147.32.84.165",4261,"193.23.181.44",80,3,186,3,186,0,0,85185.565596,9.030855000004522,164.7684521564409,0
"147.32.84.165",4262,"174.37.196.55",80,3,186,3,186,0,0,85185.969501,9.028512000004412,164.8112114154883,0
"147.32.84.165",4263,"193.23.181.44",179,3,186,3,186,0,0,85185.970533,9.027606999996351,164.82773341823602,0
"147.32.84.165",4264,"193.23.181.44",179,3,186,3,186,0,0,85185.97076,9.027430000001914,164.8309651805314,0
"147.32.84.165",4265,"72.20.15.61",80,9,669,6,487,3,182,85185.970979,9.428012999997009,413.23659608882974,154.43338909274541
"147.32.84.165",4266,"174.37.196.55",80,3,186,3,186,0,0,85185.971196,9.02708800000255,164.83720996179272,0
"147.32.84.165",4267,"193.23.181.44",179,3,186,3,186,0,0,85185.971411,9.026919999989332,164.84027774720045,0
"147.32.84.165",4268,"72.20.15.61",80,3,186,3,186,0,0,85185.971626,9.026750999997603,164.84336390805453,0
"147.32.84.165",4269,"193.23.181.44",80,3,186,3,186,0,0,85185.9719,9.02652400000079,164.84750940670736,0
"147.32.84.165",4270,"67.19.72.206",80,3,186,3,186,0,0,85185.972116,9.026354000001447,164.8506141017471,0
"147.32.84.165",4271,"67.19.72.206",80,3,186,3,186,0,0,85185.972372,9.026144999996177,164.85443121073618,0
"147.32.84.165",4272,"174.37.196.55",80,3,186,3,186,0,0,85185.972588,9.02597699999751,164.8574996369269,0
"147.32.84.165",4273,"193.23.181.44",80,3,186,3,186,0,0,85185.972804,9.02580799999123,164.86058644294735,0
"147.32.84.165",4274,"174.37.196.55",80,3,186,3,186,0,0,85185.973257,9.025401999999303,164.86800255546677,0
"147.32.84.165",4275,"174.37.196.55",80,3,186,3,186,0,0,85185.973521,9.025184999991325,164.87196661358524,0
"147.32.84.165",4276,"193.23.181.44",80,3,186,3,186,0,0,85186.069599,9.029013000006671,164.80206640514314,0
"147.32.84.165",4277,"193.23.181.44",80,3,186,3,186,0,0,85186.072228,9.026433999999426,164.84915305425093,0
"147.32.84.165",4278,"72.20.15.61",80,3,186,3,186,0,0,85186.073929,9.024781999993138,164.87932894125657,0
"147.32.84.165",4279,"67.19.72.206",80,3,186,3,186,0,0,85186.074068,9.024688999998034,164.8810280332457,0
"147.32.84.165",4280,"174.37.196.55",80,3,186,3,186,0,0,85186.074177,9.024627999999211,164.88214251048686,0
"147.32.84.165",4281,"174.37.196.55",80,3,186,3,186,0,0,85186.074285,9.024568000008003,164.88323873216763,0
"147.32.84.165",4282,"193.23.181.44",179,3,186,3,186,0,0,85186.074393,9.024508999995305,164.88431669809117,0
"147.32.84.165",4283,"72.20.15.61",80,3,186,3,186,0,0,85186.0745,9.024454999991576,164.88530332318007,0
"147.32.84.165",4284,"193.23.181.44",80,3,186,3,186,0,0,85186.074608,9.024425000010524,164.88585145294738,0
"147.32.84.165",4285,"174.37.196.55",80,3,186,3,186,0,0,85186.074717,9.02436700000544,164.88691118159343,0
"147.32.84.165",4286,"174.37.196.55",80,3,186,3,186,0,0,85186.074825,9.024319999996806,164.88776993729465,0
"147.32.84.165",4287,"193.23.181.44",179,3,186,3,186,0,0,85186.074936,9.024235999997472,164.8893047567037,0
"147.32.84.165",4288,"193.23.181.44",179,3,186,3,186,0,0,85186.075048,9.024147999996785,164.89091269342325,0
"147.32.84.165",4289,"174.128.246.102",80,3,186,3,186,0,0,85186.075159,9.024059999996098,164.89252066150308,0
"147.32.84.165",4290,"193.23.181.44",179,3,186,3,186,0,0,85186.075277,9.023965000000317,164.89425657124642,0
"147.32.84.165",4291,"72.20.15.61",80,3,186,3,186,0,0,85186.075391,9.023873999991338,164.89591942456514,0
"147.32.84.165",4292,"72.20.15.61",80,3,186,3,186,0,0,85186.075507,9.023780999996234,164.8976188585052,0
"147.32.84.165",4293,"174.128.246.102",80,8,663,4,421,4,242,85186.075624,0.3809389999951236,8841.310551146284,5082.1785115852745
"147.32.84.165",4294,"174.128.246.102",80,8,661,4,419,4,242,85186.075737,0.4005929999984801,8367.595040384425,4832.835321654012
"147.32.84.165",4296,"193.23.181.44",179,3,186,3,186,0,0,85186.078254,9.021057000005385,164.94741137309205,0
"147.32.84.165",4297,"174.37.196.55",80,3,186,3,186,0,0,85186.078368,9.02096700000402,164.94905701343734,0
"147.32.84.165",4298,"174.37.196.55",80,3,186,3,186,0,0,85186.078477,9.020881999997073,164.95061125957338,0
"147.32.84.165",4299,"72.20.15.61",80,3,186,3,186,0,0,85186.078586,9.020795999997063,164.95218382063894,0
"147.32.84.165",4300,"193.23.181.44",179,3,186,3,186,0,0,85186.078695,9.020708999989438,164.95377469794695,0
"147.32.84.165",4301,"67.19.72.206",80,3,186,3,186,0,0,85186.078804,9.020623999997042,164.9553290327241,0
"147.32.84.165",4302,"174.128.246.102",80,7,594,5,472,2,122,85186.078924,3.6503609999926994,1034.4182397323311,267.3708162020008
"147.32.84.165",4303,"193.23.181.44",179,3,186,3,186,0,0,85186.079107,9.020344000004116,164.96044940185442,0
"147.32.84.165",4304,"174.37.196.55",80,3,186,3,186,0,0,85186.08193,9.017542999994475,165.01168888253835,0
"147.32.84.165",4305,"174.37.196.55",80,3,186,3,186,0,0,85186.085153,9.016539999996894,165.0300447844198,0
"147.32.84.165",4306,"193.23.181.44",179,3,186,3,186,0,0,85186.088335,9.016557000009925,165.0297336331775,0
"147.32.84.165",4295,"174.37.196.55",80,3,186,3,186,0,0,85186.091548,9.016543000005186,165.0299898751821,0
"147.32.84.165",4307,"72.20.15.61",80,3,186,3,186,0,0,85186.09478,9.016541999997571,165.03000817834607,0
"147.32.84.165",4309,"174.37.196.55",80,3,186,3,186,0,0,85186.097938,9.016579999995884,165.0293126662969,0
"147.32.84.165",4310,"174.128.246.102",80,8,631,4,389,4,242,85186.101183,0.3976039999979548,7826.883029386041,4869.166306199028
"147.32.84.165",4311,"72.20.15.61",80,3,186,3,186,0,0,85186.10438,9.013339999990421,165.0886352896464,0
"147.32.84.165",4312,"67.19.72.206",80,3,186,3,186,0,0,85186.107554,9.013338999997359,165.0886536055546,0
"147.32.84.165",4313,"67.19.72.206",80,3,186,3,186,0,0,85186.110784,9.013316999989911,165.08905655949587,0
"147.32.84.165",4314,"67.19.72.206",80,3,186,3,186,0,0,85186.113961,9.013363999998546,165.08819570586965,0
"147.32.84.165",4315,"72.20.15.61",80,3,186,3,186,0,0,85186.117152,9.0133679999999,165.08812244213445,0
"147.32.84.165",4316,"67.19.72.206",80,3,186,3,186,0,0,85186.12035,9.013372000001254,165.08804917846427,0
"147.32.84.165",4317,"67.19.72.206",80,3,186,3,186,0,0,85186.123532,9.013390000007348,165.08771949275322,0
"147.32.84.165",4318,"174.128.246.102",80,8,663,5,481,3,182,85186.126732,3.621594999989611,1062.5152729697932,402.03280598857043
"147.32.84.165",4319,"174.37.196.55",80,3,186,3,186,0,0,85186.12993,9.010189000007813,165.14636929355308,0
"147.32.84.165",4320,"193.23.181.44",179,3,186,3,186,0,0,85186.133151,9.010167000000365,165.14677252929272,0
"147.32.84.165",4321,"72.20.15.61",80,3,186,3,186,0,0,85186.136382,9.010143000006792,165.14721242480596,0
"147.32.84.165",4322,"174.37.196.55",80,3,186,3,186,0,0,85186.139554,9.010166000007303,165.1467908581034,0
"147.32.84.165",4323,"193.23.181.44",179,3,186,3,186,0,0,85186.142781,9.010140999991563,165.14724908316012,0
"147.32.84.165",4324,"193.23.181.44",80,3,186,3,186,0,0,85186.145984,9.0101399999985,165.1472674120766,0
"147.32.84.165",4308,"67.19.72.206",80,3,186,3,186,0,0,85186.149169,9.010122000006959,165.14759733540242,0
"147.32.84.165",4326,"72.20.15.61",80,3,186,3,186,0,0,85186.152331,9.010186999992584,165.14640595153296,0
"147.32.84.165",4327,"174.37.196.55",80,3,186,3,186,0,0,85186.155547,9.010161999991396,165.146864174187,0
"147.32.84.165",4328,"174.37.196.55",80,3,186,3,186,0,0,85186.158784,9.010129000002053,165.1474690317598,0
"147.32.84.165",4329,"67.19.72.206",80,3,186,3,186,0,0,85186.161985,9.010158000004594,165.1469374898022,0
"147.32.84.165",4330,"174.37.196.55",80,3,186,3,186,0,0,85186.16518,9.010146000000532,165.14715743783864,0
"147.32.84.165",4325,"67.19.72.206",80,3,186,3,186,0,0,85186.168378,9.01014299999224,165.14721242507267,0
"147.32.84.165",4332,"174.128.246.102",80,8,638,5,456,3,182,85186.171534,3.656853000007686,997.579065932465,398.1565570169049
"147.32.84.165",4333,"72.20.15.61",80,3,186,3,186,0,0,85186.174732,9.006961000006413,165.20555601372544,0
"147.32.84.165",4334,"193.23.181.44",179,3,186,3,186,0,0,85186.177935,9.006955999997444,165.20564772387277,0
"147.32.84.165",4335,"174.128.246.102",80,7,594,5,472,2,122,85186.181135,3.6564499999949476,1032.6956474190042,266.92556988372564
"147.32.84.165",4331,"67.19.72.206",80,3,186,3,186,0,0,85186.184335,9.00377799999842,165.26395919582438,0
"147.32.84.165",4336,"193.23.181.44",179,3,186,3,186,0,0,85186.187535,9.003782999992836,165.26386742119217,0
"147.32.84.165",4338,"67.19.72.206",80,3,186,3,186,0,0,85186.190731,9.003779999999097,165.26392248590585,0
"147.32.84.165",4337,"174.128.246.102",80,3,186,3,186,0,0,85186.193931,9.00378400000045,165.2638490661177,0
"147.32.84.165",4339,"174.37.196.55",80,3,186,3,186,0,0,85186.197131,9.037777000005008,164.642256607922,0
"147.32.84.165",4340,"72.20.15.61",80,3,186,3,186,0,0,85186.200331,9.037784000000102,164.6421290882791,0
"147.32.84.165",4341,"174.128.246.102",80,3,186,3,186,0,0,85186.203531,9.037784000000102,164.6421290882791,0
"147.32.84.165",4342,"174.128.246.102",80,3,186,3,186,0,0,85186.206731,9.037784000000102,164.6421290882791,0
"147.32.84.165",4343,"72.20.15.61",80,3,186,3,186,0,0,85186.209931,9.03777799999807,164.64223839093168,0
"147.32.84.165",4344,"72.20.15.61",80,3,186,3,186,0,0,85186.213131,9.037781999999424,164.6421655224805,0
"147.32.84.165",4345,"193.23.181.44",80,3,186,3,186,0,0,85186.216331,9.03778099999181,164.6421837397198,0
"147.32.84.165",4346,"174.128.246.102",80,3,186,3,186,0,0,85186.219531,9.037785000007716,164.64211087105187,0
"147.32.84.165",4347,"193.23.181.44",80,3,186,3,186,0,0,85186.222731,9.03777799999807,164.64223839093168,0
"147.32.84.165",4348,"67.19.72.206",80,3,186,3,186,0,0,85186.225931,9.037783000007039,164.64214730524523,0
"147.32.84.165",4349,"174.37.196.55",80,3,186,3,186,0,0,85186.229131,9.037765999994008,164.64245699667225,0
"147.32.84.165",4350,"174.128.246.102",80,3,186,3,186,0,0,85186.232331,9.037764999986393,164.64247521397604,0
"147.32.84.165",4351,"72.20.15.61",80,3,186,3,186,0,0,85186.23553,9.037765000000945,164.64247521371095,0
"147.32.84.165",4352,"193.23.181.44",80,3,186,3,186,0,0,85186.23873,9.037781999999424,164.6421655224805,0
"147.32.84.165",4353,"193.23.181.44",80,3,186,3,186,0,0,85186.241929,9.037784000000102,164.6421290882791,0
"147.32.84.165",4354,"193.23.181.44",179,3,186,3,186,0,0,85186.245169,9.037727000002633,164.64316746894065,0
"147.32.84.165",4355,"72.20.15.61",80,3,186,3,186,0,0,85186.248361,9.03773499999079,164.64302173072306,0
"147.32.84.165",4356,"174.128.246.102",80,3,186,3,186,0,0,85186.251563,9.03772900000331,164.64313103429578,0
"147.32.84.165",4357,"72.20.15.61",80,3,186,3,186,0,0,85186.254781,9.037710999997216,164.64345894668,0
"147.32.84.165",4358,"174.128.246.102",80,3,186,3,186,0,0,85186.257932,9.037760000006529,164.64256629949514,0
"147.32.84.165",4359,"67.19.72.206",80,3,186,3,186,0,0,85186.261131,9.037760999999591,164.64254808243626,0
"147.32.84.165",4360,"174.128.246.102",80,3,186,3,186,0,0,85186.264361,9.037731000003987,164.64309459966705,0
"147.32.84.165",4361,"193.23.181.44",80,3,186,3,186,0,0,85186.26756,9.037732000011601,164.64307638222618,0
"147.32.84.165",4362,"67.19.72.206",80,3,186,3,186,0,0,85186.270763,9.03772900000331,164.64313103429578,0
"147.32.84.165",4363,"67.19.72.206",80,3,186,3,186,0,0,85186.27393,9.037762000007206,164.64252986511636,0
"147.32.84.165",4365,"174.128.246.102",80,3,186,3,186,0,0,85186.277151,9.03774099999282,164.64291242703038,0
"147.32.84.165",4364,"193.23.181.44",179,3,186,3,186,0,0,85186.280376,9.037716000006185,164.64336785964304,0
"147.32.84.165",4366,"101.0.32.121",6667,2,124,2,124,0,0,85186.28358,3.1267729999963194,317.2599993671327,0
"147.32.84.165",4367,"193.23.181.44",179,3,186,3,186,0,0,85186.323553,8.997738999998546,165.37487917800686,0
"147.32.84.165",4368,"67.19.72.206",80,3,186,3,186,0,0,85186.326732,8.99775999999838,165.37449320722803,0
"147.32.84.165",4369,"174.37.196.55",80,3,186,3,186,0,0,85186.346756,8.980964999995194,165.6837544741346,0
"147.32.84.165",4370,"193.23.181.44",179,3,186,3,186,0,0,85186.353147,8.984196999997948,165.62415093973783,0
"147.32.84.165",4371,"72.20.15.61",80,3,186,3,186,0,0,85186.356381,8.984163999994053,165.62475929880455,0
"147.32.84.165",4372,"174.37.196.55",80,3,186,3,186,0,0,85186.359552,8.984168000009959,165.62468555778906,0
"147.32.84.165",4373,"174.128.246.102",80,3,186,3,186,0,0,85186.362751,8.984193000011146,165.62422467974073,0
"147.32.84.165",4374,"174.37.196.55",80,3,186,3,186,0,0,85186.365978,8.984113999991678,165.62568106341686,0
"147.32.84.165",4375,"174.37.196.55",80,3,186,3,186,0,0,85186.369135,8.984207000001334,165.6239665893472,0
"147.32.84.165",4376,"193.23.181.44",80,3,186,3,186,0,0,85186.372368,8.984175999998115,165.62453807675988,0
"147.32.84.165",4377,"174.128.246.102",80,3,186,3,186,0,0,85186.375535,8.984181000007084,165.62444590094822,0
"147.32.84.165",4378,"72.20.15.61",80,3,186,3,186,0,0,85186.378751,8.984188000002177,165.62431685530618,0
"147.32.84.165",4379,"193.23.181.44",179,3,186,3,186,0,0,85186.381957,8.984153999990667,165.62494365095986,0
"147.32.84.165",4380,"67.19.72.206",80,3,186,3,186,0,0,85186.385131,8.984178999991855,165.6244827714752,0
"147.32.84.165",4381,"174.37.196.55",80,3,186,3,186,0,0,85186.388331,8.984181000007084,165.62444590094822,0
"147.32.84.165",4382,"67.19.72.206",80,3,186,3,186,0,0,85186.391531,8.984215999997105,165.6238006744806,0
"147.32.84.165",4383,"193.23.181.44",179,3,186,3,186,0,0,85186.394731,8.984212000010302,165.62387441417164,0
"147.32.84.165",4384,"193.23.181.44",80,3,186,3,186,0,0,85186.397931,8.984184000000823,165.62439059572506,0
"147.32.84.165",4385,"67.19.72.206",80,3,186,3,186,0,0,85186.401131,8.984208999987459,165.62392971958656,0
"147.32.84.165",4386,"72.20.15.61",80,3,186,3,186,0,0,85186.404331,8.98417999999947,165.62446433620963,0
"147.32.84.165",4387,"67.19.72.206",80,3,186,3,186,0,0,85186.407531,8.984161999993376,165.62479616920277,0
"147.32.84.165",4388,"67.19.72.206",80,3,186,3,186,0,0,85186.410731,8.984211000002688,165.62389284930583,0
"147.32.84.165",4389,"174.37.196.55",80,3,186,3,186,0,0,85186.413931,8.984186999994563,165.62433529053888,0
"147.32.84.165",4390,"174.37.196.55",80,3,186,3,186,0,0,85186.417161,8.984178999991855,165.6244827714752,0
"147.32.84.165",4391,"193.23.181.44",80,3,186,3,186,0,0,85186.420357,8.984158000006573,165.62486990978022,0
"147.32.84.165",4392,"193.23.181.44",80,3,186,3,186,0,0,85186.423529,8.984212999988813,165.62385597957805,0
"147.32.84.165",4393,"174.128.246.102",80,3,186,3,186,0,0,85186.426784,8.984129999997094,165.6253860975388,0
"147.32.84.165",4394,"174.128.246.102",80,3,186,3,186,0,0,85186.42996,8.984155000012834,165.62492521532346,0
"147.32.84.165",4395,"174.37.196.55",80,3,186,3,186,0,0,85186.43318,8.984133999998448,165.62531235623345,0
"147.32.84.165",4396,"174.37.196.55",80,8,681,5,499,3,182,85186.436383,3.5529390000010608,1123.5768472238922,409.8015755405779
"147.32.84.165",4397,"174.37.196.55",80,8,664,5,482,3,182,85186.439531,3.5718720000004396,1079.54596357303,407.6293887350445
"147.32.84.165",4398,"193.23.181.44",179,3,186,3,186,0,0,85186.442731,8.97778400000243,165.74245938636943,0
"147.32.84.165",4399,"67.19.72.206",80,3,186,3,186,0,0,85186.44593,8.977813999998034,165.74190554630846,0
"147.32.84.165",4400,"174.37.196.55",80,8,642,5,460,3,182,85186.449131,3.5844079999951646,1026.668839039798,406.20375805487663
"147.32.84.165",4401,"193.23.181.44",179,3,186,3,186,0,0,85186.45233,8.974583000002895,165.8015754046199,0
"147.32.84.165",4402,"67.19.72.206",80,3,186,3,186,0,0,85186.455532,8.974580999987666,165.80161235405254,0
"147.32.84.165",4403,"193.23.181.44",80,3,186,3,186,0,0,85186.458732,8.974562000003061,165.80196337152637,0
"147.32.84.165",4404,"67.19.72.206",80,3,186,3,186,0,0,85186.461931,8.974608999997145,165.80109506725847,0
"147.32.84.165",4405,"193.23.181.44",80,3,186,3,186,0,0,85186.465132,8.974581000002217,165.8016123537837,0
"147.32.84.165",4406,"174.37.196.55",80,9,721,5,479,4,242,85186.468332,3.5969570000015665,1065.3449568616836,538.2327339468214
"147.32.84.165",4408,"193.23.181.44",179,3,186,3,186,0,0,85186.471559,9.028002999999444,164.82050349341839,0
"147.32.84.165",4407,"67.19.72.206",80,3,186,3,186,0,0,85186.474732,9.024888999992982,164.87737411520044,0
"147.32.84.165",4409,"174.37.196.55",80,3,186,3,186,0,0,85186.477982,9.021661000006134,164.93636814761587,0
"147.32.84.165",4410,"72.20.15.61",80,3,186,3,186,0,0,85186.481191,9.018477000005078,164.9945994206297,0
"147.32.84.165",4411,"174.128.246.102",80,3,186,3,186,0,0,85186.484332,9.015358999997261,165.0516635000838,0
"147.32.84.165",4412,"174.37.196.55",80,3,186,3,186,0,0,85186.48753,9.012188000007882,165.10973805680692,0
"147.32.84.165",4413,"174.37.196.55",80,3,186,3,186,0,0,85186.49073,9.009009999994305,165.1679818316264,0
"147.32.84.165",4414,"72.20.15.61",80,3,186,3,186,0,0,85186.493957,9.005804000000353,165.2267804184881,0
"147.32.84.165",4415,"72.20.15.61",80,3,186,3,186,0,0,85186.497155,9.002628000002005,165.28507009282941,0
"147.32.84.165",4416,"193.23.181.44",80,3,186,3,186,0,0,85186.500332,8.999477000004845,165.3429415952948,0
"147.32.84.165",4417,"174.128.246.102",80,3,186,3,186,0,0,85186.503549,8.996291999996174,165.40147874264562,0
"147.32.84.165",4418,"193.23.181.44",80,3,186,3,186,0,0,85186.50678,8.99309699999867,165.46024133846439,0
"147.32.84.165",4421,"72.20.15.61",80,3,186,3,186,0,0,85186.570661,8.929242999991402,166.64346574524097,0
"147.32.84.165",4420,"67.19.72.206",80,3,186,3,186,0,0,85186.570808,8.929122000001371,166.64572395805226,0
"147.32.84.165",4422,"193.23.181.44",80,3,186,3,186,0,0,85186.571296,8.928657000011299,166.65440278399282,0
"147.32.84.165",4423,"67.19.72.206",80,3,186,3,186,0,0,85186.571582,8.928397999989102,166.6592371892266,0
"147.32.84.165",4424,"193.23.181.44",80,3,186,3,186,0,0,85186.571702,8.928300999992643,166.661047829954,0
"147.32.84.165",4425,"72.20.15.61",80,3,186,3,186,0,0,85186.571819,8.928205999996862,166.66282117600366,0
"147.32.84.165",4426,"174.37.196.55",80,3,186,3,186,0,0,85186.571938,8.92855400001281,166.6563253129079,0
"147.32.84.165",4427,"174.128.246.102",80,3,186,3,186,0,0,85186.572054,8.931666999997105,166.59823972394875,0
"147.32.84.165",4429,"72.20.15.61",80,3,186,3,186,0,0,85186.584565,8.92235900000378,166.77203865024592,0
"147.32.84.165",4428,"174.37.196.55",80,3,186,3,186,0,0,85186.584684,8.925434999997378,166.7145634919124,0
"147.32.84.165",4431,"174.128.246.102",80,3,186,3,186,0,0,85186.604764,8.908574999994016,167.03008056855327,0
"147.32.84.165",4430,"72.20.15.61",80,3,186,3,186,0,0,85186.604883,8.91163799999049,166.97267101756017,0
"147.32.84.165",4433,"67.19.72.206",80,3,186,3,186,0,0,85186.624933,8.894790999998804,167.28892224676218,0
"147.32.84.165",4434,"67.19.72.206",80,3,186,3,186,0,0,85186.625053,8.89784000000509,167.23159778093884,0
"147.32.84.165",4435,"72.20.15.61",80,3,186,3,186,0,0,85186.625179,8.900917000006302,167.17378670073504,0
"147.32.84.165",4436,"67.19.72.206",80,3,186,3,186,0,0,85186.625306,8.904014999992796,167.11562143608293,0
"147.32.84.165",4432,"193.23.181.44",80,3,186,3,186,0,0,85186.625429,8.907064999992144,167.0583969019326,0
"147.32.84.165",4437,"193.23.181.44",80,3,186,3,186,0,0,85186.670265,8.929401000001235,166.6405170962525,0
"147.32.84.165",4438,"193.23.181.44",179,3,186,3,186,0,0,85186.670461,8.929327000005287,166.64189809591684,0
"147.32.84.165",4439,"174.128.246.102",80,3,186,3,186,0,0,85186.670651,8.929189000002225,166.644473535013,0
"147.32.84.165",4440,"174.128.246.102",80,3,186,3,186,0,0,85186.670874,8.929008999999496,166.6478329230135,0
"147.32.84.165",4441,"72.20.15.61",80,3,186,3,186,0,0,85186.671132,8.928799000001163,166.65175238011363,0
"147.32.84.165",4442,"67.19.72.206",80,3,186,3,186,0,0,85186.671277,8.928700000004028,166.6536001880821,0
"147.32.84.165",4443,"67.19.72.206",80,3,186,3,186,0,0,85186.671486,8.928533999991487,166.65669862503955,0
"147.32.84.165",4445,"193.23.181.44",80,3,186,3,186,0,0,85186.773508,8.926668000000063,166.69153596840272,0
"147.32.84.165",4444,"67.19.72.206",80,3,186,3,186,0,0,85186.773652,8.926544999994803,166.69383283239665,0
"147.32.84.165",4446,"193.23.181.44",179,3,186,3,186,0,0,85186.774253,8.92597100000421,166.70455236738928,0
"147.32.84.165",4447,"174.128.246.102",80,3,186,3,186,0,0,85186.77451,8.925736999997753,166.7089227478218,0
"147.32.84.165",4448,"193.23.181.44",80,3,186,3,186,0,0,85186.774655,8.92561299999943,166.71123876870922,0
"147.32.84.165",4449,"174.128.246.102",80,3,186,3,186,0,0,85186.774773,8.925516999996034,166.7130318614217,0
"147.32.84.165",4450,"174.128.246.102",80,3,186,3,186,0,0,85186.77489,8.925422999993316,166.71478763539994,0
"147.32.84.165",4451,"193.23.181.44",80,3,186,3,186,0,0,85186.775006,8.925327999997535,166.71656212526992,0
"147.32.84.165",4452,"193.23.181.44",80,3,186,3,186,0,0,85186.775129,8.925225999992108,166.718467409264,0
"147.32.84.165",4453,"193.23.181.44",179,3,186,3,186,0,0,85186.77525,8.925127999988035,166.72029801723792,0
"147.32.84.165",4454,"193.23.181.44",179,3,186,3,186,0,0,85186.775377,8.925023999996483,166.72224074698133,0
"147.32.84.165",4455,"193.23.181.44",80,3,186,3,186,0,0,85186.775502,8.924920999997994,166.72416484138452,0
"147.32.84.165",4456,"193.23.181.44",179,3,186,3,186,0,0,85186.775627,8.924817999999505,166.7260889801991,0
"147.32.84.165",4457,"67.19.72.206",80,3,186,3,186,0,0,85186.775752,8.924717000001692,166.72797580020944,0
"147.32.84.165",4458,"193.23.181.44",179,3,186,3,186,0,0,85186.775877,8.924614000003203,166.72990002698896,0
"147.32.84.165",4459,"72.20.15.61",80,8,659,5,477,3,182,85186.776031,3.7350710000027902,1021.6673257341425,389.81856034300614
"147.32.84.165",4460,"174.128.246.102",80,3,186,3,186,0,0,85186.776161,8.924350999994203,166.7348135456535,0
"147.32.84.165",4461,"67.19.72.206",80,3,186,3,186,0,0,85186.776277,8.9242579999991,166.7365510947969,0
"147.32.84.165",4462,"174.37.196.55",80,3,186,3,186,0,0,85186.776394,8.924163000003318,166.73832604799426,0
"147.32.84.165",4463,"67.19.72.206",80,3,186,3,186,0,0,85186.77651,8.9240690000006,166.740082354798,0
"147.32.84.165",4464,"193.23.181.44",179,3,186,3,186,0,0,85186.776632,8.923971000011079,166.74191343720778,0
"147.32.84.165",4466,"174.128.246.102",80,3,186,3,186,0,0,85186.794189,8.90643600000476,167.07019508131026,0
"147.32.84.165",4467,"174.37.196.55",80,3,186,3,186,0,0,85186.794309,8.90633600000001,167.07207093916043,0
"147.32.84.165",4468,"174.37.196.55",80,3,186,3,186,0,0,85186.794427,8.906241999997292,167.073834283916,0
"147.32.84.165",4469,"193.23.181.44",179,3,186,3,186,0,0,85186.794545,8.906146000008448,167.07563518480256,0
"147.32.84.165",4470,"67.19.72.206",80,3,186,3,186,0,0,85186.794666,8.906046000003698,167.07751116481793,0
"147.32.84.165",4471,"193.23.181.44",80,3,186,3,186,0,0,85186.794785,8.90853599998809,167.0308117969091,0
"147.32.84.165",4465,"67.19.72.206",80,3,186,3,186,0,0,85186.794901,8.911619000005885,166.97302701103104,0
"147.32.84.165",4472,"193.23.181.44",80,3,186,3,186,0,0,85186.814346,8.89537399999972,167.27795818366343,0
"147.32.84.165",4474,"193.23.181.44",179,3,186,3,186,0,0,85186.87354,8.92700799999875,166.68518724305034,0
"147.32.84.165",4473,"67.19.72.206",80,3,186,3,186,0,0,85186.873863,8.926743999996688,166.69011679964746,0
"147.32.84.165",4475,"174.37.196.55",80,3,186,3,186,0,0,85186.874559,8.926068999993731,166.70272210544698,0
"147.32.84.165",4476,"174.128.246.102",80,3,186,3,186,0,0,85186.874882,8.925772999995388,166.70825036674907,0
"147.32.84.165",4477,"174.37.196.55",80,3,186,3,186,0,0,85186.875102,8.92557599999418,166.71192985203086,0
"147.32.84.165",4478,"174.128.246.102",80,3,186,3,186,0,0,85186.875317,8.925382000001264,166.7155534631223,0
"147.32.84.165",4479,"72.20.15.61",80,3,186,3,186,0,0,85186.875532,8.92518900000141,166.71915855224634,0
"147.32.84.165",4480,"174.128.246.102",80,3,186,3,186,0,0,85186.875751,8.92499400000088,166.72280115816923,0
"147.32.84.165",4481,"193.23.181.44",80,3,186,3,186,0,0,85186.875967,8.924799000000348,166.7264439232684,0
"147.32.84.165",4482,"67.19.72.206",80,3,186,3,186,0,0,85186.876223,8.924566000001505,166.73079676924897,0
"147.32.84.165",4483,"174.37.196.55",80,3,186,3,186,0,0,85186.876442,8.924370000007912,166.73445856667539,0
"147.32.84.165",4484,"193.23.181.44",80,3,186,3,186,0,0,85186.876656,8.924177000008058,166.73806447346982,0
"147.32.84.165",4485,"193.23.181.44",80,3,186,3,186,0,0,85186.876871,8.923985000001267,166.74165185169952,0
"147.32.84.165",4486,"174.128.246.102",80,3,186,3,186,0,0,85186.877088,8.923789000007673,166.7453141259526,0
"147.32.84.165",4487,"193.23.181.44",80,3,186,3,186,0,0,85186.877303,8.923595000000205,166.7489391887424,0
"147.32.84.165",4488,"174.128.246.102",80,3,186,3,186,0,0,85186.877517,8.923402999993414,166.75252703493257,0
"147.32.84.165",4489,"193.23.181.44",179,3,186,3,186,0,0,85186.877735,8.923207999992883,166.75617109913685,0
"147.32.84.165",4490,"174.37.196.55",80,3,186,3,186,0,0,85186.877999,8.922965999998269,166.76069369762126,0
"147.32.84.165",4491,"174.37.196.55",80,3,186,3,186,0,0,85186.878223,8.92276299999503,166.76448763693813,0
"147.32.84.165",4492,"193.23.181.44",80,3,186,3,186,0,0,85186.878443,8.922567000001436,166.7681509143905,0
"147.32.84.165",4493,"193.23.181.44",179,3,186,3,186,0,0,85187.071946,8.929409999997006,166.64034913846479,0
"147.32.84.165",4494,"174.128.246.102",80,3,186,3,186,0,0,85187.073573,8.927890999999363,166.6687014884149,0
"147.32.84.165",4495,"72.20.15.61",80,3,186,3,186,0,0,85187.074697,8.926791999998386,166.6892204949179,0
"147.32.84.165",4496,"193.23.181.44",80,3,186,3,186,0,0,85187.074936,8.926574999990407,166.69327261593602,0
"147.32.84.165",4497,"193.23.181.44",80,3,186,3,186,0,0,85187.075155,8.926380000004428,166.69691409051168,0
"147.32.84.165",4498,"174.128.246.102",80,7,603,5,481,2,122,85187.075371,3.5168439999979455,1094.162834633054,277.5215505722091
"147.32.84.165",4499,"174.128.246.102",80,3,186,3,186,0,0,85187.07559,8.92596800001047,166.70460839633913,0
"147.32.84.165",4500,"72.20.15.61",80,3,186,3,186,0,0,85187.075804,8.925775000010617,166.70821301211717,0
"147.32.84.165",4501,"67.19.72.206",80,3,186,3,186,0,0,85187.07602,8.925583000003826,166.7117991059365,0
"147.32.84.165",4502,"67.19.72.206",80,3,186,3,186,0,0,85187.076239,8.925388000003295,166.71544139027353,0
"147.32.84.165",4504,"193.23.181.44",80,3,186,3,186,0,0,85187.076479,8.925171000009868,166.719494785966,0
"147.32.84.165",4503,"67.19.72.206",80,3,186,3,186,0,0,85187.076691,8.924982000011369,166.72302532353618,0
"147.32.84.165",4506,"67.19.72.206",80,3,186,3,186,0,0,85187.076912,8.924784000002546,166.7267241425199,0
"147.32.84.165",4507,"67.19.72.206",80,3,186,3,186,0,0,85187.077127,8.924592000010307,166.73031103251347,0
"147.32.84.165",4508,"174.128.246.102",80,3,186,3,186,0,0,85187.077345,8.924396000002162,166.73397280887576,0
"147.32.84.165",4509,"174.37.196.55",80,3,186,3,186,0,0,85187.077614,8.924150000006193,166.73856893922306,0
"147.32.84.165",4505,"72.20.15.61",80,3,186,3,186,0,0,85187.077829,8.923957999999402,166.74215633916023,0
"147.32.84.165",4510,"174.128.246.102",80,8,673,4,431,4,242,85187.173509,0.3294190000015078,10466.912958828172,5877.013772706306
"147.32.84.165",4511,"72.20.15.61",80,3,186,3,186,0,0,85187.173949,8.92806500000006,166.66545326450805,0
"147.32.84.165",4512,"67.19.72.206",80,3,186,3,186,0,0,85187.174327,8.927746000001207,166.67140843834477,0
"147.32.84.165",4513,"193.23.181.44",179,3,186,3,186,0,0,85187.17444,8.927653999999166,166.67312599705804,0
"147.32.84.165",4514,"193.23.181.44",80,3,186,3,186,0,0,85187.174548,8.927573000008124,166.67463822459317,0
"147.32.84.165",4515,"193.23.181.44",179,3,186,3,186,0,0,85187.174656,8.927488000001176,166.67622515984382,0
"147.32.84.165",4516,"174.128.246.102",80,7,602,4,420,3,182,85187.174763,0.3246159999980591,10350.69127837226,4485.299553961312
"147.32.84.165",4517,"174.128.246.102",80,6,541,4,419,2,122,85187.174869,0.3124880000104895,10726.811909217255,3123.3199353806804
"147.32.84.165",4518,"174.37.196.55",80,3,186,3,186,0,0,85187.174976,8.927189000009093,166.68180767747657,0
"147.32.84.165",4519,"72.20.15.61",80,3,186,3,186,0,0,85187.175102,8.92708500000299,166.6837495105627,0
"147.32.84.165",4520,"193.23.181.44",179,3,186,3,186,0,0,85187.175216,8.926995000001625,166.68542997948683,0
"147.32.84.165",4521,"174.128.246.102",80,3,186,3,186,0,0,85187.175332,8.926900000005844,166.68720384445058,0
"147.32.84.165",4522,"193.23.181.44",179,3,186,3,186,0,0,85187.175443,8.92681600000651,166.68877234603187,0
"147.32.84.165",4523,"174.37.196.55",80,3,186,3,186,0,0,85187.175556,8.926727999991272,166.69041557012324,0
"147.32.84.165",4524,"67.19.72.206",80,3,186,3,186,0,0,85187.175671,8.926633999988553,166.69217086775464,0
"147.32.84.165",4525,"193.23.181.44",80,3,186,3,186,0,0,85187.175788,8.926537000006647,166.69398222388952,0
"147.32.84.165",4526,"174.37.196.55",80,3,186,3,186,0,0,85187.175901,8.926447000005282,166.69566289914894,0
"147.32.84.165",4527,"67.19.72.206",80,3,186,3,186,0,0,85187.176017,8.926353999995627,166.69739963267523,0
"147.32.84.165",4528,"67.19.72.206",80,3,186,3,186,0,0,85187.176134,8.926262000008137,166.69911772684284,0
"147.32.84.165",4529,"174.37.196.55",80,3,186,3,186,0,0,85187.176247,8.926172000006773,166.70079850566077,0
"147.32.84.165",4530,"193.23.181.44",80,3,186,3,186,0,0,85187.17636,8.926080999997794,166.70249799440177,0
"147.32.84.165",4531,"193.23.181.44",179,3,186,3,186,0,0,85187.176476,8.925987000009627,166.70425354623472,0
"147.32.84.165",4532,"174.128.246.102",80,8,653,4,411,4,242,85187.176589,0.31290000000444707,10508.149568402907,6187.280281152077
"147.32.84.165",4533,"72.20.15.61",80,3,186,3,186,0,0,85187.176705,8.925777999989805,166.70815698101606,0
"147.32.84.165",4534,"193.23.181.44",80,3,186,3,186,0,0,85187.176818,8.925690999996732,166.70978190938325,0
"147.32.84.165",4535,"193.23.181.44",80,3,186,3,186,0,0,85187.176935,8.92559600000095,166.71155629269367,0
"147.32.84.165",4536,"193.23.181.44",80,3,186,3,186,0,0,85187.177048,8.925505000006524,166.713256000519,0
"147.32.84.165",4537,"193.23.181.44",179,3,186,3,186,0,0,85187.272639,8.928813999998965,166.6514724128168,0
"147.32.84.165",4538,"174.37.196.55",80,3,186,3,186,0,0,85187.272998,8.928576999998768,166.6558960067439,0
"147.32.84.165",4539,"193.23.181.44",179,3,186,3,186,0,0,85187.273421,8.928201999995508,166.6628958440623,0
"147.32.84.165",4540,"193.23.181.44",179,3,186,3,186,0,0,85187.273774,8.927891999992426,166.6686828202293,0
"147.32.84.165",4541,"67.19.72.206",80,3,186,3,186,0,0,85187.275534,8.926179000001866,166.7006677772974,0
"147.32.84.165",4542,"72.20.15.61",80,3,186,3,186,0,0,85187.275974,8.925783999991836,166.7080449181115,0
"147.32.84.165",4543,"72.20.15.61",80,3,186,3,186,0,0,85187.276602,8.925203999999212,166.71887835842534,0
"147.32.84.165",4544,"174.128.246.102",80,7,604,5,482,2,122,85187.276827,3.5674910000088857,1080.8716826448604,273.5816292171638
"147.32.84.165",4545,"193.23.181.44",80,3,186,3,186,0,0,85187.27705,8.924801000001025,166.72640656075458,0
"147.32.84.165",4546,"72.20.15.61",80,3,186,3,186,0,0,85187.277266,8.924629000001005,166.72961979706187,0
"147.32.84.165",4547,"193.23.181.44",179,3,186,3,186,0,0,85187.277535,8.92440699999861,166.7337672968335,0
"147.32.84.165",4548,"72.20.15.61",80,3,186,3,186,0,0,85187.277752,8.924233000012464,166.73701818385084,0
"147.32.84.165",4549,"174.128.246.102",80,3,186,3,186,0,0,85187.277978,8.924054000002798,166.74036261989602,0
"147.32.84.165",4550,"67.19.72.206",80,3,186,3,186,0,0,85187.278201,8.92387700000836,166.74366981958693,0
"147.32.84.165",4551,"72.20.15.61",80,3,186,3,186,0,0,85187.278417,8.923706000001403,166.74686503564394,0
"147.32.84.165",4552,"174.128.246.102",80,3,186,3,186,0,0,85187.278633,8.92353900001035,166.749985627706,0
"147.32.84.165",4553,"193.23.181.44",80,3,186,3,186,0,0,85187.278902,8.92331600000034,166.75415282838165,0
"147.32.84.165",4554,"174.37.196.55",80,3,186,3,186,0,0,85187.279183,8.923081999993883,166.7585258099186,0
"147.32.84.165",4555,"193.23.181.44",80,3,186,3,186,0,0,85187.279402,8.922907999993186,166.76177766274586,0
"147.32.84.165",4556,"174.128.246.102",80,3,186,3,186,0,0,85187.331836,8.870521000004373,167.74662953836267,0
"147.32.84.165",4557,"72.20.15.61",80,3,186,3,186,0,0,85187.333911,8.868488000007346,167.7850835451057,0
"147.32.84.165",4558,"72.20.15.61",80,3,186,3,186,0,0,85187.33958,8.862865999995847,167.89151500211074,0
"147.32.84.165",4559,"67.19.72.206",80,3,186,3,186,0,0,85187.342779,8.85971299999801,167.95126433557547,0
"147.32.84.165",4560,"72.20.15.61",80,3,186,3,186,0,0,85187.373133,8.930045999994036,166.62848097322163,0
"147.32.84.165",4561,"174.128.246.102",80,3,186,3,186,0,0,85187.37427,8.928971999994246,166.64852348074996,0
"147.32.84.165",4562,"72.20.15.61",80,3,186,3,186,0,0,85187.374706,8.928557999999612,166.65625065100824,0
"147.32.84.165",4563,"72.20.15.61",80,3,186,3,186,0,0,85187.37486,8.928427000006195,166.65869587094878,0
"147.32.84.165",4564,"193.23.181.44",179,3,186,3,186,0,0,85187.374973,8.928337999997893,166.66035716841714,0
"147.32.84.165",4565,"67.19.72.206",80,3,186,3,186,0,0,85187.375112,8.928220000001602,166.66255983832534,0
"147.32.84.165",4566,"72.20.15.61",80,3,186,3,186,0,0,85187.375229,8.928125999998883,166.66431454934508,0
"147.32.84.165",4567,"193.23.181.44",80,3,186,3,186,0,0,85187.375346,8.928031999996165,166.66606929731427,0
"147.32.84.165",4568,"174.37.196.55",80,3,186,3,186,0,0,85187.375461,8.92793900000106,166.66780541397327,0
"147.32.84.165",4569,"174.37.196.55",80,3,186,3,186,0,0,85187.377978,8.925445000000764,166.71437670613315,0
"147.32.84.165",4570,"72.20.15.61",80,3,186,3,186,0,0,85187.381208,8.922237999999197,166.77430034932198,0
"147.32.84.165",4571,"193.23.181.44",80,3,186,3,186,0,0,85187.38441,8.919057999999495,166.83376204079894,0
"147.32.84.165",4572,"174.37.196.55",80,3,186,3,186,0,0,85187.387607,8.915884000001824,166.89315383642221,0
"147.32.84.165",4573,"67.19.72.206",80,3,186,3,186,0,0,85187.39081,8.912704000002122,166.95270032524874,0
"147.32.84.165",4574,"193.23.181.44",80,3,186,3,186,0,0,85187.393978,8.909559000006993,167.011633235588,0
"147.32.84.165",4575,"67.19.72.206",80,3,186,3,186,0,0,85187.397182,8.906377999999677,167.07128307377633,0
"147.32.84.165",4576,"67.19.72.206",80,3,186,3,186,0,0,85187.400398,8.90318500000285,167.13120080055887,0
"147.32.84.165",4577,"72.20.15.61",80,3,186,3,186,0,0,85187.403604,8.900002999987919,167.19095487968036,0
"147.32.84.165",4578,"174.128.246.102",80,3,186,3,186,0,0,85187.406805,8.896824999988894,167.25067650559131,0
"147.32.84.165",4579,"67.19.72.206",80,3,186,3,186,0,0,85187.410002,8.893650999991223,167.3103655631943,0
"147.32.84.165",4580,"174.37.196.55",80,3,186,3,186,0,0,85187.413221,8.890455000000657,167.37051140800895,0
"147.32.84.165",4581,"72.20.15.61",80,3,186,3,186,0,0,85187.428277,8.875423000004957,167.65398111156716,0
"147.32.84.165",4582,"193.23.181.44",80,3,186,3,186,0,0,85187.473361,8.928662999998778,166.65429079361644,0
"147.32.84.165",4583,"174.128.246.102",80,3,186,3,186,0,0,85187.473717,8.92840000000433,166.6591998565564,0
"147.32.84.165",4584,"174.128.246.102",80,3,186,3,186,0,0,85187.47408,8.928060999998706,166.66552793492514,0
"147.32.84.165",4585,"72.20.15.61",80,3,186,3,186,0,0,85187.475819,8.926342000006116,166.69762372974063,0
"147.32.84.165",4586,"193.23.181.44",80,3,186,3,186,0,0,85187.4771,8.925082000001566,166.72115729578044,0
"147.32.84.165",4587,"67.19.72.206",80,3,186,3,186,0,0,85187.477348,8.92486299999291,166.72524833167546,0
"147.32.84.165",4588,"174.128.246.102",80,3,186,3,186,0,0,85187.477553,8.924679999996442,166.72866702230144,0
"147.32.84.165",4589,"193.23.181.44",179,3,186,3,186,0,0,85187.477664,8.924589999995078,166.7303483970491,0
"147.32.84.165",4590,"67.19.72.206",80,3,186,3,186,0,0,85187.477781,8.924496999999974,166.73208585313037,0
"147.32.84.165",4591,"174.128.246.102",80,3,186,3,186,0,0,85187.477896,8.924406000005547,166.73378597960192,0
"147.32.84.165",4592,"193.23.181.44",80,3,186,3,186,0,0,85187.478046,8.924277999991318,166.7361774253836,0
"147.32.84.165",4593,"193.23.181.44",80,3,186,3,186,0,0,85187.478226,8.924118999988423,166.7391481446998,0
"147.32.84.165",4594,"174.37.196.55",80,8,661,5,479,3,182,85187.478443,3.427865000005113,1117.8970000260465,424.75418372597176
"147.32.84.165",4595,"174.128.246.102",80,3,186,3,186,0,0,85187.478559,8.923806999999215,166.74497778808202,0
"147.32.84.165",4596,"174.128.246.102",80,3,186,3,186,0,0,85187.478701,8.923691999996663,166.74712663778135,0
"147.32.84.165",4597,"72.20.15.61",80,3,186,3,186,0,0,85187.478814,8.923603999995976,166.7487710123254,0
"147.32.84.165",4598,"174.37.196.55",80,8,664,5,482,3,182,85187.478925,3.529222999990452,1092.5917687860563,412.5553981723283
"147.32.84.165",4599,"72.20.15.61",80,3,186,3,186,0,0,85187.479165,8.923274000000674,166.7549377055874,0
"147.32.84.165",4600,"193.23.181.44",80,3,186,3,186,0,0,85187.480381,8.922080999996979,166.777235041971,0
"147.32.84.165",4601,"174.37.196.55",80,8,624,5,442,3,182,85187.48358,3.542637000005925,998.1265368125738,410.99327986400095
"147.32.84.165",4602,"193.23.181.44",80,3,186,3,186,0,0,85187.486778,8.915706999992835,166.8964671002755,0
"147.32.84.165",4603,"208.73.210.29",80,46,33830,20,2075,26,31755,85187.489984,19.16309000000183,866.2486060441408,13256.734691533346
"147.32.84.165",4604,"174.128.246.102",80,3,186,3,186,0,0,85187.573555,8.929489000001922,166.6388748560729,0
"147.32.84.165",4605,"193.23.181.44",179,3,186,3,186,0,0,85187.573738,8.929369999998016,166.64109562044473,0
"147.32.84.165",4606,"72.20.15.61",80,3,186,3,186,0,0,85187.574373,8.928757000001497,166.65253629365773,0
"147.32.84.165",4607,"66.111.4.72",25,3,186,3,186,0,0,85187.574676,8.928474999993341,166.65779990436326,0
"147.32.84.165",4608,"72.20.15.61",80,3,186,3,186,0,0,85187.574791,8.928383999998914,166.65949851621312,0
"147.32.84.165",4609,"193.23.181.44",80,3,186,3,186,0,0,85187.574953,8.928243000002112,166.66213049976886,0
"147.32.84.165",4610,"174.128.246.102",80,3,186,3,186,0,0,85187.575064,8.92815399999381,166.66379186571285,0
"147.32.84.165",4611,"193.23.181.44",80,3,186,3,186,0,0,85187.575178,8.928062999999383,166.66549059970822,0
"147.32.84.165",4612,"174.128.246.102",80,3,186,3,186,0,0,85187.575289,8.927972999998019,166.667170700486,0
"147.32.84.165",4613,"193.23.181.44",80,3,186,3,186,0,0,85187.575399,8.927885000011884,166.66881349815992,0
"147.32.84.165",4614,"67.19.72.206",80,3,186,3,186,0,0,85187.575538,8.927769000001717,166.6709790541975,0
"147.32.84.165",4616,"72.20.15.61",80,3,186,3,186,0,0,85187.576248,8.92708200000925,166.68380552552986,0
"147.32.84.165",4617,"174.37.196.55",80,3,186,3,186,0,0,85187.576359,8.926993000000948,166.68546732363765,0
"147.32.84.165",4615,"193.23.181.44",80,3,186,3,186,0,0,85187.576464,8.926909000001615,166.68703579253813,0
"147.32.84.165",4618,"174.128.246.102",80,3,186,3,186,0,0,85187.681531,8.921163999999408,166.7943779533813,0
"147.32.84.165",4619,"174.128.246.102",80,3,186,3,186,0,0,85187.681859,8.920958000002429,166.7982295174571,0
"147.32.84.165",4620,"72.20.15.61",80,3,186,3,186,0,0,85187.682062,8.92080399999395,166.80110895845365,0
"147.32.84.165",4621,"67.19.72.206",80,3,186,3,186,0,0,85187.682274,8.920635999995284,166.80425028000096,0
"147.32.84.165",4622,"72.20.15.61",80,3,186,3,186,0,0,85187.682461,8.920495999991545,166.80686813843204,0
"147.32.84.165",4623,"67.19.72.206",80,3,186,3,186,0,0,85187.682636,8.92036800000642,166.809261680564,0
"147.32.84.165",4624,"193.23.181.44",80,3,186,3,186,0,0,85187.774434,8.928464999989956,166.6579865633873,0
"147.32.84.165",4625,"193.23.181.44",80,3,186,3,186,0,0,85187.77642,8.92653799999971,166.69396355004017,0
"147.32.84.165",4626,"193.23.181.44",80,3,186,3,186,0,0,85187.777597,8.925382000001264,166.7155534631223,0
"147.32.84.165",4627,"72.20.15.61",80,3,186,3,186,0,0,85187.777802,8.925199999997858,166.71895307672176,0
"147.32.84.165",4628,"72.20.15.61",80,3,186,3,186,0,0,85187.777971,8.925053999992087,166.7216803395609,0
"147.32.84.165",4629,"174.37.196.55",80,3,186,3,186,0,0,85187.778158,8.924893000003067,166.72468790376408,0
"147.32.84.165",4630,"193.23.181.44",80,3,186,3,186,0,0,85187.77838,8.924694000001182,166.7284054780817,0
"147.32.84.165",4631,"193.23.181.44",80,3,186,3,186,0,0,85187.778596,8.924499000000651,166.73204848808786,0
"147.32.84.165",4632,"174.37.196.55",80,3,186,3,186,0,0,85187.778812,8.924304999993183,166.73567297410125,0
"147.32.84.165",4633,"174.37.196.55",80,3,186,3,186,0,0,85187.77893,8.924211000005016,166.73742922474196,0
"147.32.84.165",4634,"72.20.15.61",80,3,186,3,186,0,0,85187.779089,8.924075000002631,166.73997024896823,0
"147.32.84.165",4635,"193.23.181.44",179,3,186,3,186,0,0,85187.779287,8.923902000009548,166.74320269299326,0
"147.32.84.165",4636,"193.23.181.44",179,3,186,3,186,0,0,85187.779524,8.923687999995309,166.74720138139995,0
"147.32.84.165",4637,"193.23.181.44",80,3,186,3,186,0,0,85187.77974,8.923498000003747,166.75075177910895,0
"147.32.84.165",4638,"67.19.72.206",80,3,186,3,186,0,0,85187.779958,8.923303000003216,166.75439576572305,0
"147.32.84.165",4639,"174.128.246.102",80,3,186,3,186,0,0,85187.780222,8.923062000001664,166.75889957950784,0
"147.32.84.165",4640,"174.128.246.102",80,3,186,3,186,0,0,85187.780444,8.92286299999978,166.76261867968125,0
"147.32.84.165",4641,"72.20.15.61",80,3,186,3,186,0,0,85187.780661,8.922669000006863,166.7662444946524,0
"147.32.84.165",4642,"193.23.181.44",179,3,186,3,186,0,0,85187.780925,8.922428000005311,166.7707489485053,0
"147.32.84.165",4644,"72.20.15.61",80,3,186,3,186,0,0,85187.78124,8.922136000008322,166.77620695297765,0
"147.32.84.165",4643,"67.19.72.206",80,3,186,3,186,0,0,85187.781455,8.921948000002885,166.77972119984545,0
"147.32.84.165",4645,"174.128.246.102",80,3,186,3,186,0,0,85187.781674,8.921753000002354,166.78336645271477,0
"147.32.84.165",4646,"174.128.246.102",80,3,186,3,186,0,0,85187.875552,8.928369000001112,166.65977851047762,0
"147.32.84.165",4647,"193.23.181.44",80,3,186,3,186,0,0,85187.877308,8.926734000007855,166.69030353079756,0
"147.32.84.165",4648,"193.23.181.44",179,3,186,3,186,0,0,85187.878157,8.925933000005898,166.7052620716531,0
"147.32.84.165",4649,"174.128.246.102",80,3,186,3,186,0,0,85187.878689,8.92544399999315,166.71439538482815,0
"147.32.84.165",4650,"174.37.196.55",80,3,186,3,186,0,0,85187.87889,8.925290999992285,166.71725325272715,0
"147.32.84.165",4651,"193.23.181.44",80,3,186,3,186,0,0,85187.879121,8.925104999987525,166.72072765553793,0
"147.32.84.165",4652,"193.23.181.44",179,3,186,3,186,0,0,85187.87923,8.925041999988025,166.7219045021857,0
"147.32.84.165",4653,"72.20.15.61",80,3,186,3,186,0,0,85187.879337,8.924980999989202,166.72304400444105,0
"147.32.84.165",4654,"193.23.181.44",80,3,186,3,186,0,0,85187.879443,8.924922000005608,166.72414616050034,0
"147.32.84.165",4655,"174.37.196.55",80,3,186,3,186,0,0,85187.87955,8.924861000006786,166.72528569339832,0
"147.32.84.165",4656,"174.37.196.55",80,3,186,3,186,0,0,85187.879656,8.924801000001025,166.72640656075458,0
"147.32.84.165",4658,"72.20.15.61",80,3,186,3,186,0,0,85187.885396,8.919103000007453,166.83292030585997,0
"147.32.84.165",4659,"72.20.15.61",80,3,186,3,186,0,0,85187.885507,8.919041999994079,166.8340613264281,0
"147.32.84.165",4657,"67.19.72.206",80,3,186,3,186,0,0,85187.885612,8.91898200000287,166.83518365655644,0
"147.32.84.165",4661,"174.128.246.102",80,3,186,3,186,0,0,85187.906273,8.898367999994662,167.2216748060872,0
"147.32.84.165",4662,"174.128.246.102",80,3,186,3,186,0,0,85187.906386,8.898300999993808,167.22293390626317,0
"147.32.84.165",4663,"67.19.72.206",80,3,186,3,186,0,0,85187.906501,8.898231999992277,167.2242306113497,0
"147.32.84.165",4660,"174.37.196.55",80,3,186,3,186,0,0,85187.906614,8.8981669999921,167.22545216349852,0
"147.32.84.165",4664,"67.19.72.206",80,3,186,3,186,0,0,85187.925802,8.87902700000268,167.58593030515067,0
"147.32.84.165",4665,"174.128.246.102",80,3,186,3,186,0,0,85187.974909,8.928723999997601,166.65315223097946,0
"147.32.84.165",4666,"72.20.15.61",80,7,544,4,362,3,182,85187.975758,0.3691560000006575,7844.92193001019,3944.132020060372
"147.32.84.165",4667,"174.128.246.102",80,3,186,3,186,0,0,85187.976066,8.927624999996624,166.67366740880834,0
"147.32.84.165",4668,"67.19.72.206",80,3,186,3,186,0,0,85187.976396,8.927316000001156,166.6794364621805,0
"147.32.84.165",4669,"193.23.181.44",80,3,186,3,186,0,0,85187.976506,8.927233999987948,166.6809674757051,0
"147.32.84.165",4670,"174.128.246.102",80,3,186,3,186,0,0,85187.976617,8.927146000001812,166.6826105453745,0
"147.32.84.165",4671,"72.20.15.61",80,3,186,3,186,0,0,85187.976735,8.927048999990802,166.68442169428366,0
"147.32.84.165",4672,"193.23.181.44",179,3,186,3,186,0,0,85187.976848,8.926957999996375,166.68612084884953,0
"147.32.84.165",4673,"67.19.72.206",80,3,186,3,186,0,0,85187.977091,8.926739000002271,166.6902101651702,0
"147.32.84.165",4674,"72.20.15.61",80,3,186,3,186,0,0,85187.97731,8.92654400000174,166.69385150621673,0
"147.32.84.165",4675,"174.128.246.102",80,3,186,3,186,0,0,85187.977441,8.926437000001897,166.69584964299685,0
"147.32.84.165",4676,"174.37.196.55",80,3,186,3,186,0,0,85187.977559,8.926344999999856,166.69756770548574,0
"147.32.84.165",4677,"67.19.72.206",80,3,186,3,186,0,0,85187.977674,8.926250000004075,166.69934182879942,0
"147.32.84.165",4678,"72.20.15.61",80,3,186,3,186,0,0,85187.97779,8.926156000001356,166.70109731442895,0
"147.32.84.165",4679,"174.37.196.55",80,3,186,3,186,0,0,85187.977906,8.926063999999315,166.7028154850911,0
"147.32.84.165",4680,"193.23.181.44",80,3,186,3,186,0,0,85187.978057,8.92593399999896,166.70524339527643,0
"147.32.84.165",4681,"67.19.72.206",80,3,186,3,186,0,0,85187.978196,8.925820000004023,166.70737254384798,0
"147.32.84.165",4683,"72.20.15.61",80,3,186,3,186,0,0,85188.07652,8.927913999999873,166.668272118215,0
"147.32.84.165",4682,"193.23.181.44",179,3,186,3,186,0,0,85188.076747,8.927744999993593,166.67142710741268,0
"147.32.84.165",4684,"193.23.181.44",80,3,186,3,186,0,0,85188.077003,8.927510000008624,166.67581442065733,0
"147.32.84.165",4685,"72.20.15.61",80,3,186,3,186,0,0,85188.07726,8.927279999988968,166.68010861111546,0
"147.32.84.165",4686,"174.37.196.55",80,3,186,3,186,0,0,85188.077543,8.92701999998826,166.6849631794212,0
"147.32.84.165",4687,"72.20.15.61",80,3,186,3,186,0,0,85188.077692,8.926892999996198,166.6873345519694,0
"147.32.84.165",4688,"67.19.72.206",80,3,186,3,186,0,0,85188.077861,8.926745999997365,166.6900794534133,0
"147.32.84.165",4689,"72.20.15.61",80,3,186,3,186,0,0,85188.07802,8.926611000002595,166.69260036082758,0
"147.32.84.165",4690,"72.20.15.61",80,3,186,3,186,0,0,85188.078167,8.926485000003595,166.69495327661457,0
"147.32.84.165",4691,"72.20.15.61",80,3,186,3,186,0,0,85188.078315,8.926362999991397,166.69723156020365,0
"147.32.84.165",4692,"72.20.15.61",80,3,186,3,186,0,0,85188.078456,8.926248000003397,166.6993791791841,0
"147.32.84.165",4693,"174.128.246.102",80,3,186,3,186,0,0,85188.078601,8.926124000005075,166.70169493490724,0
"147.32.84.165",4694,"193.23.181.44",179,3,186,3,186,0,0,85188.07874,8.926006000008783,166.703898697641,0
"147.32.84.165",4695,"72.20.15.61",80,3,186,3,186,0,0,85188.078882,8.92588799999794,166.7061025189139,0
"147.32.84.165",4696,"174.128.246.102",80,3,186,3,186,0,0,85188.079126,8.925666000010096,166.71024884846878,0
"147.32.84.165",4697,"193.23.181.44",80,3,186,3,186,0,0,85188.079283,8.925530000007711,166.71278904431608,0
"147.32.84.165",4698,"72.20.15.61",80,3,186,3,186,0,0,85188.079417,8.925418999991962,166.71486235002973,0
"147.32.84.165",4699,"174.37.196.55",80,3,186,3,186,0,0,85188.079603,8.925255999987712,166.71790702721003,0
"147.32.84.165",4700,"174.37.196.55",80,3,186,3,186,0,0,85188.079794,8.925087999989046,166.72104521566916,0
"147.32.84.165",4701,"67.19.72.206",80,3,186,3,186,0,0,85188.079927,8.924979000003077,166.72308136517597,0
"147.32.84.165",4702,"174.37.196.55",80,3,186,3,186,0,0,85188.161194,8.843737999995938,168.25464526433095,0
"147.32.84.165",4703,"174.128.246.102",80,8,648,4,406,4,242,85188.175312,0.31556499999715015,10292.649691915556,6135.0276488757745
"147.32.84.165",4704,"174.128.246.102",80,7,632,4,450,3,182,85188.175626,0.31950500000675675,11267.429304467438,4557.049185362386
"147.32.84.165",4705,"67.19.72.206",80,3,186,3,186,0,0,85188.175792,8.9289240000071,166.64941934759628,0
"147.32.84.165",4706,"72.20.15.61",80,3,186,3,186,0,0,85188.175932,8.928839000000153,166.65100580265525,0
"147.32.84.165",4707,"193.23.181.44",179,3,186,3,186,0,0,85188.176047,8.928769000005559,166.65231231752927,0
"147.32.84.165",4709,"193.23.181.44",80,3,186,3,186,0,0,85188.176167,8.928696999995736,166.653656183059,0
"147.32.84.165",4710,"72.20.15.61",80,3,186,3,186,0,0,85188.176275,8.928636999989976,166.65477608751152,0
"147.32.84.165",4708,"67.19.72.206",80,3,186,3,186,0,0,85188.176381,8.928578000006382,166.65587734115516,0
"147.32.84.165",4711,"193.23.181.44",80,3,186,3,186,0,0,85188.17649,8.928511999998591,166.6571092697456,0
"147.32.84.165",4712,"193.23.181.44",80,3,186,3,186,0,0,85188.276137,8.929549000007682,166.63775516531908,0
"147.32.84.165",4713,"174.37.196.55",80,3,186,3,186,0,0,85188.333116,8.87263399999938,167.70668101491665,0
"147.32.84.165",4714,"174.128.246.102",80,8,673,4,431,4,242,85188.335426,0.31758699999772944,10856.86756707501,6095.967404250934
"147.32.84.165",4715,"72.20.15.61",80,3,186,3,186,0,0,85188.495512,8.910733000011533,166.98962924801745,0
"147.32.84.165",4716,"74.125.232.220",80,9,2921,5,787,4,2134,85188.604633,18.048832000000402,348.83143684864814,945.8783814930307
"147.32.84.165",4717,"74.125.232.217",80,8,1905,5,1031,3,874,85188.648156,18.0054850000015,458.08263426390977,388.32611284835804
"147.32.84.165",4718,"94.127.76.180",80,24,15249,15,3227,9,12022,85188.759207,1.025565000003553,25172.4659089483,93778.55133479282
"147.32.84.165",4719,"94.127.76.180",80,17,7642,10,2465,7,5177,85188.759549,17.894270000004326,1102.028749985064,2314.483910212039
"147.32.84.165",4720,"208.73.210.29",80,8,2446,5,1476,3,970,85188.791333,17.86283499999263,661.0372877544282,434.42152379525436
"147.32.84.165",4721,"72.20.15.61",80,3,186,3,186,0,0,85188.909149,8.897681999995257,167.23456738516765,0
"147.32.84.165",4722,"72.20.15.61",80,3,186,3,186,0,0,85188.912349,8.894541000001482,167.29362425781747,0
"147.32.84.165",4723,"174.128.246.102",80,8,692,4,450,4,242,85189.287949,0.5883859999885317,6118.432457723617,3290.357010598034
"147.32.84.165",4724,"195.113.232.75",80,8,2458,5,743,3,1715,85189.291149,17.362118000004557,342.35454453186185,790.2261694106905
"147.32.84.165",4725,"72.20.15.61",80,3,186,3,186,0,0,85189.426353,8.68205499999749,171.38799512332395,0
"147.32.84.165",4726,"174.37.196.55",80,3,186,3,186,0,0,85189.429551,8.678906000001007,171.450180472035,0
"147.32.84.165",4727,"193.23.181.44",80,3,186,3,186,0,0,85189.432796,8.675708000009763,171.51337965712142,0
"147.32.84.165",4728,"193.23.181.44",179,3,186,3,186,0,0,85189.435951,8.672598999997717,171.57486469746746,0
"147.32.84.165",4729,"193.23.181.44",80,3,186,3,186,0,0,85189.439189,8.669410000002244,171.63797767086973,0
"147.32.84.165",4730,"72.20.15.61",80,3,186,3,186,0,0,85189.442396,8.666251000002376,171.70054271444388,0
"147.32.84.165",4731,"67.214.158.5",80,10,1710,5,855,5,855,85189.44875,0.8995779999968363,7603.565227277741,7603.565227277741
"147.32.84.165",4732,"193.23.181.44",179,3,186,3,186,0,0,85189.52237,8.685845999993035,171.3131915994358,0
"147.32.84.165",4733,"193.23.181.44",179,3,186,3,186,0,0,85189.525601,8.682673000002978,171.37579637048287,0
"147.32.84.165",4734,"193.23.181.44",80,3,186,3,186,0,0,85189.578354,8.62994400000025,172.4229033235855,0
"147.32.84.165",4735,"193.23.181.44",179,3,186,3,186,0,0,85189.59995,8.608370999994804,172.8550035774362,0
"147.32.84.165",4736,"72.20.15.61",80,3,186,3,186,0,0,85189.654349,8.654809999992722,171.9275177619441,0
"147.32.84.165",4737,"193.23.181.44",80,3,186,3,186,0,0,85189.674749,8.634518999999273,172.33154504612537,0
"147.32.84.165",4738,"193.23.181.44",80,3,186,3,186,0,0,85189.695949,8.613343000004534,172.7552240749285,0
"147.32.84.165",4739,"67.19.72.206",80,3,186,3,186,0,0,85189.719171,8.590142000000924,173.22181635645137,0
"147.32.84.165",4740,"174.128.246.102",80,3,186,3,186,0,0,85189.883949,8.725321999998414,170.5381188224653,0
"147.32.84.165",4741,"67.19.72.206",80,3,186,3,186,0,0,85189.905598,8.703797000009217,170.95986958317437,0
"147.32.84.165",4742,"193.23.181.44",80,3,186,3,186,0,0,85189.925963,8.683481000000029,171.35984981138267,0
"147.32.84.165",4743,"174.128.246.102",80,3,186,3,186,0,0,85189.947555,8.661931999988155,171.786155790883,0
"147.32.84.165",4744,"193.23.181.44",80,3,186,3,186,0,0,85190.043548,8.666394999992917,171.6976897546461,0
"147.32.84.165",4745,"174.128.246.102",80,3,186,3,186,0,0,85190.046797,8.663168999992195,171.76162672127725,0
"147.32.84.165",4746,"193.23.181.44",80,3,186,3,186,0,0,85190.049983,8.660005999990972,171.82436132279253,0
"147.32.84.165",4747,"195.113.232.83",80,8,1359,5,771,3,588,85190.053183,16.600812000004225,371.5480905390911,283.35963325160253
"147.32.84.165",4748,"72.20.15.61",80,3,186,3,186,0,0,85190.235581,8.775125999993179,169.5702147184162,0
"147.32.84.165",4749,"50.22.198.84",80,8,2186,5,1158,3,1028,85190.238803,0.8226929999946151,11260.579584438712,9996.438525736612
"147.32.84.165",4750,"67.214.158.5",80,10,1773,5,877,5,896,85190.248377,0.5629330000083428,12463.29492123578,12733.309292391401
"147.32.84.165",4751,"193.23.181.44",179,3,186,3,186,0,0,85190.343565,8.767573999997694,169.71627499241995,0
"147.32.84.165",4752,"193.23.181.44",179,3,186,3,186,0,0,85190.423549,8.787786000000779,169.3259257792427,0
"147.32.84.165",4753,"193.23.181.44",179,3,186,3,186,0,0,85190.426779,8.784576999998535,169.38778042474306,0
"147.32.84.165",4754,"193.23.181.44",179,3,186,3,186,0,0,85190.532768,8.678615999990143,171.45590955996786,0
"147.32.84.165",4755,"67.19.72.206",80,3,186,3,186,0,0,85190.606349,8.704993999999715,170.9363613576355,0
"147.32.84.165",4756,"193.23.181.44",179,3,186,3,186,0,0,85190.609549,8.701818000001367,170.99874991636992,0
"147.32.84.165",4757,"193.23.181.44",179,3,186,3,186,0,0,85190.612749,8.698637999987113,171.0612626944821,0
"147.32.84.165",4758,"67.19.72.206",80,3,186,3,186,0,0,85190.701593,8.710972000000766,170.819054406313,0
"147.32.84.165",4759,"72.20.15.61",80,3,186,3,186,0,0,85190.800349,8.813412000003154,168.8335913491242,0
"147.32.84.165",4760,"72.20.15.61",80,3,186,3,186,0,0,85190.873969,8.845364000007976,168.22371583562398,0
"147.32.84.165",4761,"174.128.246.102",80,3,186,3,186,0,0,85190.877168,8.845369999995455,168.2236017261872,0
"147.32.84.165",4762,"67.19.72.206",80,3,186,3,186,0,0,85190.88035,8.845415999996476,168.22272689046991,0
"147.32.84.165",4763,"193.23.181.44",80,3,186,3,186,0,0,85190.918351,8.810582000005525,168.8878214854668,0
"147.32.84.165",4765,"174.128.246.102",80,3,186,3,186,0,0,85190.92155,8.810567000007723,168.88810901712634,0
"147.32.84.165",4767,"184.82.148.43",80,10,1919,5,979,5,940,85190.924766,0.49031000000832137,15973.567742585463,15337.235626180118
"147.32.84.165",4766,"67.19.72.206",80,3,186,3,186,0,0,85190.928003,8.80733800001326,168.95002780610437,0
"147.32.84.165",4764,"72.20.15.61",80,3,186,3,186,0,0,85190.931172,8.807362000006833,168.94956741858067,0
"147.32.84.165",4768,"68.67.179.209",80,10,1586,6,644,4,942,85190.934354,15.569747000001371,330.8981192821917,484.0155719935164
"147.32.84.165",4769,"68.67.179.209",80,10,1614,6,644,4,970,85190.937553,15.566652000008617,330.96390925917456,498.5015403437878
"147.32.84.165",4770,"50.22.198.84",80,8,1730,5,1210,3,520,85190.943949,0.531743000014103,18204.28289557787,7823.328186529334
"147.32.84.165",4771,"174.128.246.102",80,3,186,3,186,0,0,85191.218749,8.795432999992045,169.17870899606032,0
"147.32.84.165",4772,"193.23.181.44",80,3,186,3,186,0,0,85191.221949,8.792291000005207,169.23916644696118,0
"147.32.84.165",4773,"217.163.21.41",80,10,1543,5,593,5,950,85191.225149,0.20259799998893868,23415.828390502422,37512.70990046763
"147.32.84.165",4774,"184.82.148.44",80,10,1514,5,596,5,918,85191.311968,0.32251800000085495,14783.670988866856,22770.822093590225
"147.32.84.165",4775,"94.245.121.179",80,8,1692,5,606,3,1086,85191.380745,0.12798799999291077,37878.55111626504,67881.36388162349
"147.32.84.165",4776,"217.163.21.41",80,10,1542,5,758,5,784,85191.40029,0.14615799998864532,41489.34714809383,42912.46459644534
"147.32.84.165",4777,"217.163.21.36",80,13,6078,6,750,7,5328,85191.541378,0.1867960000090534,32120.60215266494,228184.7576925317
"147.32.84.165",4778,"217.163.21.36",80,10,1449,5,700,5,749,85191.689209,0.13877199999114964,40353.96189690389,43178.73922968716
"147.32.84.165",4779,"217.163.21.35",80,13,4771,7,2009,6,2762,85191.782633,0.23344599999836646,68846.75685217336,94651.43973404821
"147.32.84.165",4780,"72.20.15.61",80,3,186,3,186,0,0,85192.089069,8.927588000005926,166.6743581803968,0
"147.32.84.165",4781,"174.37.196.55",80,3,186,3,186,0,0,85192.189863,8.92799599999853,166.6667413381732,0
"147.32.84.165",4782,"67.19.72.206",80,3,186,3,186,0,0,85192.7914,8.928113000001758,166.66455722499333,0
"147.32.84.165",4783,"67.19.72.206",80,3,186,3,186,0,0,85195.228509,8.797791000004509,169.13336540948035,0
"147.32.84.165",4784,"174.128.246.102",80,3,186,3,186,0,0,85195.33094,8.796025000003283,169.16732273946977,0
"147.32.84.165",4785,"174.128.246.102",80,3,186,3,186,0,0,85195.334142,8.792921000000206,169.22704070694655,0
"147.32.84.165",4786,"193.23.181.44",179,12,912,7,612,5,300,85195.71292,9.206108999991557,531.820772489712,260.6964571028
"147.32.84.165",4787,"174.37.196.55",80,3,186,3,186,0,0,85195.71612,9.012757000004058,165.0993142275255,0
"147.32.84.165",4788,"58.215.78.1",6667,10,1146,5,588,5,558,85196.197581,1.701625999994576,2764.4147421436874,2623.373173666969
"147.32.84.165",4789,"174.128.246.102",80,3,186,3,186,0,0,85196.202828,9.02811900000961,164.81838575659182,0
"147.32.84.165",4790,"67.19.72.206",80,3,186,3,186,0,0,85196.315608,9.014967999988585,165.05882217240085,0
"147.32.84.165",4791,"174.128.246.102",80,3,186,3,186,0,0,85196.402661,9.028565999993589,164.81022567715146,0
"147.32.84.165",4792,"174.128.246.102",80,3,186,3,186,0,0,85196.703701,9.029334999999264,164.7961893096359,0
"147.32.84.165",4793,"72.20.15.61",80,3,186,3,186,0,0,85196.703853,9.02924200000416,164.79788668852981,0
"147.32.84.165",4794,"212.117.171.138",65500,8,484,4,242,4,242,85197.639251,3.0229229999968084,640.4397333316277,640.4397333316277
"147.32.84.165",4795,"72.20.15.61",80,3,186,3,186,0,0,85198.208542,9.3219320000062,159.62356301236807,0
"147.32.84.165",4796,"184.82.148.43",80,10,1899,5,979,5,920,85199.215138,0.30405200000677723,25758.751791882398,24206.3857492664
"147.32.84.165",4797,"184.82.148.44",80,10,1308,5,581,5,727,85199.42384,0.3436799999908544,13524.208566467896,16922.718808643996
"147.32.84.165",4798,"217.163.21.35",80,15,6962,7,1891,8,5071,85199.663768,0.18692400000873022,80931.28757833906,217029.3809147316
"147.32.84.165",4799,"217.163.21.35",80,13,4502,7,1926,6,2576,85199.811576,0.24282400000083726,63453.36540023586,84868.05258100083
"147.32.84.165",4800,"174.37.196.55",80,3,186,3,186,0,0,85199.813758,9.073896000001696,163.98689162843854,0
"147.32.84.165",4801,"112.110.18.151",6667,6,366,3,186,3,180,85200.564496,4.052446999994572,367.18555480231896,355.3408594861151
"147.32.84.165",4803,"212.117.171.138",65500,8,484,4,242,4,242,85200.739885,0.8255059999937657,2345.2282600182443,2345.2282600182443
"147.32.84.165",4805,"212.117.171.138",65500,8,484,4,242,4,242,85201.607108,0.14978700000210665,12925.020195162273,12925.020195162273
"147.32.84.165",4807,"212.117.171.138",65500,8,484,4,242,4,242,85201.834608,0.47060099999362137,4113.888410832618,4113.888410832618
"147.32.84.165",4809,"212.117.171.138",65500,8,484,4,242,4,242,85202.381724,2.899361999996472,667.7331081811639,667.7331081811639
"147.32.84.165",4810,"67.19.72.206",80,3,186,3,186,0,0,85204.026678,9.02915600000415,164.79945633892206,0
"147.32.84.165",4811,"174.37.196.55",80,3,186,3,186,0,0,85204.026819,9.029039999993984,164.8015735893286,0
"147.32.84.165",4812,"193.23.181.44",179,10,781,5,481,5,300,85204.729542,0.21159500000067055,18185.68491688275,11342.423025082797
"147.32.84.165",4813,"193.23.181.44",179,10,793,5,493,5,300,85204.729898,0.18674900000041816,21119.256327965177,12851.474438924042
"147.32.84.165",4814,"67.19.72.206",80,3,186,3,186,0,0,85204.730164,9.027785000012955,164.82448352479204,0
"147.32.84.165",4815,"72.20.15.61",80,3,186,3,186,0,0,85204.730423,9.027572999999393,164.82835419886388,0
"147.32.84.165",4816,"193.23.181.44",80,8,855,5,471,3,384,85204.79314,0.13790000000153668,27324.147932980504,22277.012327525506
"147.32.84.165",4817,"193.23.181.44",179,10,812,5,512,5,300,85204.794403,0.19423499998811167,21087.857493503743,12356.16650009985
"147.32.84.165",4818,"67.19.72.206",80,3,186,3,186,0,0,85204.801535,8.956511999989743,166.1361029831372,0
"147.32.84.165",4819,"193.23.181.44",179,10,749,5,449,5,300,85204.829251,0.20331099999020807,17667.514301601976,11804.575257195083
"147.32.84.165",4820,"72.20.15.61",80,8,606,5,424,3,182,85204.829438,3.6208499999920605,936.7966085332001,402.1155253609491
"147.32.84.165",4821,"174.128.246.102",80,3,186,3,186,0,0,85204.85987,8.99867699999595,165.35764090662101,0
"147.32.84.165",4822,"193.23.181.44",179,10,754,5,454,5,300,85204.862199,0.21745799999916926,16702.0758032074,11036.613966877137
"147.32.84.165",4823,"174.37.196.55",80,3,186,3,186,0,0,85204.898817,8.95979300000181,166.0752653548692,0
"147.32.84.165",4824,"174.128.246.102",80,3,186,3,186,0,0,85204.929574,9.028902000005473,164.8040924576541,0
"147.32.84.165",4825,"72.20.15.61",80,3,186,3,186,0,0,85204.935873,9.022727000003215,164.9168815591417,0
"147.32.84.165",4826,"67.19.72.206",80,3,186,3,186,0,0,85205.23125,9.028224000008777,164.81646888674376,0
"147.32.84.165",4828,"174.128.246.102",80,3,186,3,186,0,0,85205.330962,9.029368999996223,164.79556877126436,0
"147.32.84.165",4829,"212.117.171.138",65500,34,10044,16,5312,18,4732,85205.359212,2.9477590000024065,14416.375287113127,12842.298166155746
"147.32.84.165",4830,"193.23.181.44",179,11,822,5,462,6,360,85205.431513,0.19913599999563303,18560.17997790983,14462.477904864802
"147.32.84.165",4832,"174.128.246.102",80,3,186,3,186,0,0,85205.49753,8.96221000001242,166.03047685759853,0
"147.32.84.165",4833,"212.117.171.138",65500,8,484,4,242,4,242,85205.53824,3.4901840000093216,554.6985488429348,554.6985488429348
"147.32.84.165",4834,"193.23.181.44",80,9,924,5,472,4,452,85205.733289,0.12809500000730623,29478.121704864563,28229.04875126861
"147.32.84.165",4835,"174.37.196.55",80,3,186,3,186,0,0,85205.733473,9.028766000003088,164.80657489622513,0
"147.32.84.165",4836,"193.23.181.44",179,10,728,5,428,5,300,85205.733653,0.1982739999948535,17269.031744398533,12104.461503083085
"147.32.84.165",4837,"174.128.246.102",80,3,186,3,186,0,0,85205.797417,8.964845000009518,165.98167620281447,0
"147.32.84.165",4838,"72.20.15.61",80,3,186,3,186,0,0,85205.798278,8.964007999995374,165.99717447828783,0
"147.32.84.165",4839,"174.37.196.55",80,3,186,3,186,0,0,85205.832483,9.028312999987975,164.81484414662873,0
"147.32.84.165",4840,"174.128.246.102",80,3,186,3,186,0,0,85205.832638,9.02828299999237,164.81539180830478,0
"147.32.84.165",4841,"65.55.16.187",443,23,9376,13,4428,10,4948,85205.861893,2.6837610000075074,13199.386979653145,14749.45049126553
"147.32.84.165",4842,"193.23.181.44",80,8,868,5,482,3,386,85205.933068,0.13441600000078324,28687.06106399187,22973.455540873158
"147.32.84.165",4843,"193.23.181.44",179,11,801,5,441,6,360,85206.000982,0.18742899999779183,18823.12769124076,15365.818523461845
"147.32.84.165",4844,"174.128.246.102",80,3,186,3,186,0,0,85206.063546,8.99839300000167,165.36285979060082,0
"147.32.84.165",4845,"193.23.181.44",179,10,812,5,512,5,300,85206.535651,0.18651100000715815,21961.171190132478,12867.87374421825
"147.32.84.165",4846,"174.128.246.102",80,10,785,6,543,4,242,85206.599269,9.291666000004625,467.5157286107613,208.35875934402253
"147.32.84.165",4847,"174.37.196.55",80,3,186,3,186,0,0,85206.936119,9.028228999988642,164.8163776087062,0
"147.32.84.165",4848,"174.128.246.102",80,3,186,3,186,0,0,85206.936841,9.027627000003122,164.82736825518882,0
"147.32.84.165",4849,"67.19.72.206",80,3,186,3,186,0,0,85206.93713,9.027386999994633,164.83175031721635,0
"147.32.84.165",4850,"174.128.246.102",80,3,186,3,186,0,0,85206.937353,9.027220000003581,164.8347996392477,0
"147.32.84.165",4851,"72.20.15.61",80,3,186,3,186,0,0,85206.937465,9.027156000011018,164.83596827153355,0
"147.32.84.165",4852,"193.23.181.44",179,10,788,5,488,5,300,85206.937575,0.2846770000032848,13713.787906838112,8430.607319777528
"147.32.84.165",4853,"67.19.72.206",80,3,186,3,186,0,0,85206.937685,9.026998000001186,164.83885340395605,0
"147.32.84.165",4854,"67.19.72.206",80,3,186,3,186,0,0,85206.937802,9.026929999992717,164.84009513768254,0
"147.32.84.165",4855,"67.19.72.206",80,3,186,3,186,0,0,85206.942621,9.022158000007039,164.9272823640241,0
"147.32.84.165",4856,"174.37.196.55",80,3,186,3,186,0,0,85206.942818,9.022009000007529,164.93000616589478,0
"147.32.84.165",4857,"174.37.196.55",80,3,186,3,186,0,0,85206.942998,9.021877000006498,164.93241927360884,0
"147.32.84.165",4859,"174.128.246.102",80,3,186,3,186,0,0,85206.943195,9.021726999999373,164.9351615272889,0
"147.32.84.165",4858,"67.19.72.206",80,3,186,3,186,0,0,85206.943371,9.021597999992082,164.93751993840849,0
"147.32.84.165",4860,"72.20.15.61",80,9,710,5,468,4,242,85207.011429,3.3295910000015283,1124.4624339741072,581.4527970549871
"147.32.84.165",4861,"193.23.181.44",80,10,1010,6,564,4,446,85207.037812,0.5694430000003194,7923.5322938335685,6265.7719912229995
"147.32.84.165",4862,"193.23.181.44",80,10,982,6,536,4,446,85207.040178,0.5735249999997905,7476.5703325950335,6221.176060330942
"147.32.84.165",4863,"193.23.181.44",179,10,828,5,528,5,300,85207.041998,0.5462310000002617,7732.992085762207,4393.745503273982
"147.32.84.165",4864,"193.23.181.44",179,10,745,5,445,5,300,85207.042109,0.6386820000043372,5573.978912785744,3757.738592889266
"147.32.84.165",4865,"174.128.246.102",80,3,186,3,186,0,0,85207.04249,9.023064999986673,164.91070384644217,0
"147.32.84.165",4866,"174.37.196.55",80,3,186,3,186,0,0,85207.0426,9.022975999992923,164.91233047734661,0
"147.32.84.165",4867,"72.20.15.61",80,3,186,3,186,0,0,85207.042708,9.022895000001881,164.91381092206987,0
"147.32.84.165",4868,"193.23.181.44",80,10,974,6,528,4,446,85207.042814,0.5804689999931725,7276.874389587873,6146.753745750362
"147.32.84.165",4869,"174.37.196.55",80,3,186,3,186,0,0,85207.04292,9.022712999998475,164.91713745081455,0
"147.32.84.165",4870,"193.23.181.44",179,3,186,3,186,0,0,85207.043033,9.022623000011663,164.9187824868751,0
"147.32.84.165",4871,"72.20.15.61",80,3,186,3,186,0,0,85207.04314,9.02253900001233,164.92031788368735,0
"147.32.84.165",4872,"72.20.15.61",80,3,186,3,186,0,0,85207.043247,9.02245600000606,164.92183503017367,0
"147.32.84.165",4873,"67.19.72.206",80,3,186,3,186,0,0,85207.043352,9.022377000001143,164.92327908707557,0
"147.32.84.165",4874,"72.20.15.61",80,3,186,3,186,0,0,85207.043459,9.022294000009424,164.92479628777843,0
"147.32.84.165",4875,"72.20.15.61",80,3,186,3,186,0,0,85207.043565,9.022209999995539,164.92633179683645,0
"147.32.84.165",4876,"193.23.181.44",80,3,186,3,186,0,0,85207.043671,9.022123999995529,164.92790389499606,0
"147.32.84.165",4877,"72.20.15.61",80,3,186,3,186,0,0,85207.043805,9.022010000000591,164.9299878851722,0
"147.32.84.165",4878,"174.37.196.55",80,3,186,3,186,0,0,85207.043913,9.021921999999904,164.93159661544578,0
"147.32.84.165",4879,"72.20.15.61",80,3,186,3,186,0,0,85207.044021,9.021840000001248,164.9330956877748,0
"147.32.84.165",4880,"174.37.196.55",80,3,186,3,186,0,0,85207.044128,9.021754000001238,164.93466791488615,0
"147.32.84.165",4882,"174.128.246.102",80,3,186,3,186,0,0,85207.045259,9.020645999989938,164.95492673159546,0
"147.32.84.165",4883,"174.128.246.102",80,3,186,3,186,0,0,85207.045392,9.020535000003292,164.95695654409155,0
"147.32.84.165",4884,"174.128.246.102",80,3,186,3,186,0,0,85207.045501,9.020449999996345,164.95851093909982,0
"147.32.84.165",4885,"72.20.15.61",80,3,186,3,186,0,0,85207.045609,9.020365000003949,164.9600653631365,0
"147.32.84.165",4886,"193.23.181.44",80,3,186,3,186,0,0,85207.045716,9.020279000003939,164.96163810446998,0
"147.32.84.165",4887,"174.37.196.55",80,3,186,3,186,0,0,85207.046452,9.021174000008614,164.94527208970575,0
"147.32.84.165",4888,"193.23.181.44",179,3,186,3,186,0,0,85207.049654,9.021171999993385,164.9453086584638,0
"147.32.84.165",4889,"193.23.181.44",80,3,186,3,186,0,0,85207.052853,9.021173000001,164.94529037408276,0
"147.32.84.165",4890,"72.20.15.61",80,3,186,3,186,0,0,85207.056053,9.021206000004895,164.94468699630545,0
"147.32.84.165",4891,"193.23.181.44",179,3,186,3,186,0,0,85207.059254,9.021201999988989,164.9447601330528,0
"147.32.84.165",4892,"193.23.181.44",179,3,186,3,186,0,0,85207.062453,9.021192000000156,164.94494297427372,0
"147.32.84.165",4893,"72.20.15.61",80,3,186,3,186,0,0,85207.065682,9.02115600000252,164.9456012067172,0
"147.32.84.165",4881,"174.128.246.102",80,10,822,6,580,4,242,85207.068854,9.396671000009519,493.79189715116127,206.03041225962247
"147.32.84.165",4895,"193.23.181.44",179,3,186,3,186,0,0,85207.129277,8.963967999996385,165.99791520904583,0
"147.32.84.165",4896,"72.20.15.61",80,3,186,3,186,0,0,85207.132476,8.963969999997062,165.99787817233747,0
"147.32.84.165",4897,"67.19.72.206",80,3,186,3,186,0,0,85207.135729,8.96391500000027,165.9988966874357,0
"147.32.84.165",4898,"193.23.181.44",179,3,186,3,186,0,0,85207.138859,8.963969000003999,165.99789669055482,0
"147.32.84.165",4899,"193.23.181.44",179,3,186,3,186,0,0,85207.142055,8.964036999997916,165.99663745256137,0
"147.32.84.165",4900,"72.20.15.61",80,3,186,3,186,0,0,85207.145257,8.963988000003155,165.99754484270574,0
"147.32.84.165",4894,"67.19.72.206",80,3,186,3,186,0,0,85207.148456,8.964019999999437,165.99695226026867,0
"147.32.84.165",4901,"193.23.181.44",179,3,186,3,186,0,0,85207.154875,8.960776000007172,166.05704684491712,0
"147.32.84.165",4902,"193.23.181.44",179,3,186,3,186,0,0,85207.216856,8.901972999999998,167.15395564556312,0
"147.32.84.165",4903,"193.23.181.44",179,3,186,3,186,0,0,85207.254883,8.867188000003807,167.80968216748772,0
"147.32.84.165",4904,"174.128.246.102",80,8,641,5,459,3,182,85207.258104,3.283073000013246,1118.4643168108612,443.4869404348077
"147.32.84.165",4905,"174.128.246.102",80,7,562,4,380,3,182,85207.261302,0.5367090000072494,5664.149473846979,2712.8294848425003
"147.32.84.165",4906,"174.37.196.55",80,3,186,3,186,0,0,85207.264452,8.860780999995768,167.93102097893072,0
"147.32.84.165",4907,"174.128.246.102",80,3,186,3,186,0,0,85207.267654,8.860823000009987,167.93022499132675,0
"147.32.84.165",4908,"193.23.181.44",80,3,186,3,186,0,0,85207.270853,8.860831000012695,167.93007337549582,0
"147.32.84.165",4909,"174.128.246.102",80,7,551,5,429,2,122,85207.274087,3.276809000002686,1047.360404587874,297.8507444282532
"147.32.84.165",4910,"72.20.15.61",80,3,186,3,186,0,0,85207.277285,8.857594000000972,167.9914432745322,0
"147.32.84.165",4911,"174.37.196.55",80,3,186,3,186,0,0,85207.280454,8.857625999997254,167.99083637088103,0
"147.32.84.165",4912,"174.128.246.102",80,7,590,5,468,2,122,85207.283653,3.286698999989312,1139.1368665071475,296.9544822945983
"147.32.84.165",4914,"67.19.72.206",80,3,186,3,186,0,0,85207.286853,8.85437400000228,168.05253539093974,0
"147.32.84.165",4915,"67.19.72.206",80,3,186,3,186,0,0,85207.290054,8.854373000009218,168.05255437041683,0
"147.32.84.165",4916,"67.19.72.206",80,3,186,3,186,0,0,85207.29328,8.854363000005833,168.05274416680453,0
"147.32.84.165",4917,"72.20.15.61",80,3,186,3,186,0,0,85207.296454,8.854378000003635,168.05245947252186,0
"147.32.84.165",4918,"193.23.181.44",179,3,186,3,186,0,0,85207.299654,8.85437699999602,168.052478452258,0
"147.32.84.165",4919,"193.23.181.44",179,3,186,3,186,0,0,85207.302853,8.854378000003635,168.05245947252186,0
"147.32.84.165",4920,"174.128.246.102",80,3,186,3,186,0,0,85207.306077,8.854372000001604,168.0525733501744,0
"147.32.84.165",4921,"67.19.72.206",80,3,186,3,186,0,0,85207.309256,8.854417000009562,168.05171927168024,0
"147.32.84.165",4913,"72.20.15.61",80,3,186,3,186,0,0,85207.312507,8.854321000006166,168.0535413160381,0
"147.32.84.165",4922,"174.37.196.55",80,3,186,3,186,0,0,85207.315708,8.870339000000968,167.75007133321935,0
"147.32.84.165",4923,"72.20.15.61",80,3,186,3,186,0,0,85207.318859,8.87038899998879,167.7491257713591,0
"147.32.84.165",4924,"174.128.246.102",80,3,186,3,186,0,0,85207.322053,8.870378000006895,167.74933379376205,0
"147.32.84.165",4925,"174.37.196.55",80,3,186,3,186,0,0,85207.325255,8.870372999997926,167.74942834989554,0
"147.32.84.165",4926,"193.23.181.44",179,3,186,3,186,0,0,85207.328502,8.870324999996228,167.75033609260458,0
"147.32.84.165",4927,"72.20.15.61",80,3,186,3,186,0,0,85207.331673,8.870354000013322,167.7497876632393,0
"147.32.84.165",4928,"174.37.196.55",80,3,186,3,186,0,0,85207.334877,8.870347999996739,167.74990113133634,0
"147.32.84.165",4929,"174.128.246.102",80,3,186,3,186,0,0,85207.33808,8.870345999996061,167.74993895397776,0
"147.32.84.165",4930,"72.20.15.61",80,3,186,3,186,0,0,85207.341253,8.870372999997926,167.74942834989554,0
"147.32.84.165",4931,"193.23.181.44",179,3,186,3,186,0,0,85207.34448,8.870345999996061,167.74993895397776,0
"147.32.84.165",4932,"193.23.181.44",179,3,186,3,186,0,0,85207.347674,8.870351999998093,167.74982548610473,0
"147.32.84.165",4933,"174.128.246.102",80,3,186,3,186,0,0,85207.350884,8.870341999994707,167.75001459931173,0
"147.32.84.165",4934,"174.37.196.55",80,3,186,3,186,0,0,85207.354082,8.870343999995384,167.7499767766362,0
"147.32.84.165",4935,"193.23.181.44",80,3,186,3,186,0,0,85207.357273,8.870383999994374,167.74922032698288,0
"147.32.84.165",4936,"72.20.15.61",80,3,186,3,186,0,0,85207.360474,8.870383000001311,167.74923923801035,0
"147.32.84.165",4937,"174.128.246.102",80,3,186,3,186,0,0,85207.363672,8.870383999994374,167.74922032698288,0
"147.32.84.165",4938,"72.20.15.61",80,3,186,3,186,0,0,85207.366891,8.870366999995895,167.74954181723132,0
"147.32.84.165",4939,"72.20.15.61",80,3,186,3,186,0,0,85207.485703,8.754721999997855,169.9654198043484,0
"147.32.84.165",4941,"67.19.72.206",80,3,186,3,186,0,0,85207.488903,8.754753000001074,169.96481796800177,0
"147.32.84.165",4940,"67.19.72.206",80,3,186,3,186,0,0,85207.492105,8.754750000007334,169.96487620991502,0
"147.32.84.165",4943,"67.19.72.206",80,3,186,3,186,0,0,85207.495303,8.754722999990918,169.96540039034286,0
"147.32.84.165",4944,"193.23.181.44",179,3,186,3,186,0,0,85207.498476,8.754750000007334,169.96487620991502,0
"147.32.84.165",4945,"67.19.72.206",80,3,186,3,186,0,0,85207.501706,8.754721000004793,169.96543921835834,0
"147.32.84.165",4946,"193.23.181.44",80,3,186,3,186,0,0,85207.504857,8.754767999998876,169.96452675846933,0
"147.32.84.165",4942,"193.23.181.44",80,3,186,3,186,0,0,85207.5081,8.75475799999549,169.96472089814094,0
"147.32.84.165",4947,"193.23.181.44",80,3,186,3,186,0,0,85207.511297,8.754759999996168,169.96468207017114,0
"147.32.84.165",4948,"174.37.196.55",80,3,186,3,186,0,0,85207.514503,8.754742999997688,169.96501210833864,0
"147.32.84.165",4949,"193.23.181.44",179,3,186,3,186,0,0,85207.517655,8.754789999991772,169.96409965303548,0
"147.32.84.165",4951,"67.19.72.206",80,3,186,3,186,0,0,85207.520871,8.75475799999549,169.96472089814094,0
"147.32.84.165",4950,"193.23.181.44",80,3,186,3,186,0,0,85207.524078,8.754766999991261,169.9645461725578,0
"147.32.84.165",4953,"67.19.72.206",80,3,186,3,186,0,0,85207.53366,8.781615999992937,169.44489488053188,0
"147.32.84.165",4952,"193.23.181.44",179,3,186,3,186,0,0,85207.536859,8.781623999995645,169.44474051732777,0
"147.32.84.165",4954,"67.19.72.206",80,3,186,3,186,0,0,85207.540053,8.781623000002583,169.4447598125725,0
"147.32.84.165",4955,"174.37.196.55",80,3,186,3,186,0,0,85207.543252,8.781627000003937,169.44468263105833,0
"147.32.84.165",4956,"72.20.15.61",80,3,186,3,186,0,0,85207.546486,8.78155999998853,169.44597543055488,0
"147.32.84.165",4957,"174.128.246.102",80,3,186,3,186,0,0,85207.549684,8.781589000005624,169.44541585800098,0
"147.32.84.165",4958,"72.20.15.61",80,3,186,3,186,0,0,85207.552855,8.781619999994291,169.44481769889467,0
"147.32.84.165",4959,"193.23.181.44",80,3,186,3,186,0,0,85207.556056,8.781621000001905,169.44479840335595,0
"147.32.84.165",4960,"174.37.196.55",80,3,186,3,186,0,0,85207.559253,8.781621000001905,169.44479840335595,0
"147.32.84.165",4961,"67.19.72.206",80,3,186,3,186,0,0,85207.562458,8.781617999993614,169.4448562897045,0
"147.32.84.165",4962,"193.23.181.44",80,3,186,3,186,0,0,85207.565676,8.78160200000275,169.44516501653504,0
"147.32.84.165",4963,"67.19.72.206",80,3,186,3,186,0,0,85207.568876,8.781600000002072,169.44520360750306,0
"147.32.84.165",4964,"193.23.181.44",179,3,186,3,186,0,0,85207.572099,8.781581000002916,169.44557022243555,0
"147.32.84.165",4965,"174.37.196.55",80,3,186,3,186,0,0,85207.575255,8.781623999995645,169.44474051732777,0
"147.32.84.165",4966,"72.20.15.61",80,3,186,3,186,0,0,85207.578456,8.781619999994291,169.44481769889467,0
"147.32.84.165",4967,"174.128.246.102",80,3,186,3,186,0,0,85207.581658,8.781621000001905,169.44479840335595,0
"147.32.84.165",4968,"67.19.72.206",80,3,186,3,186,0,0,85207.584859,8.781618000008166,169.44485628942368,0
"147.32.84.165",4969,"193.23.181.44",179,3,186,3,186,0,0,85207.58807,8.781560999996145,169.4459561347525,0
"147.32.84.165",4970,"193.23.181.44",179,3,186,3,186,0,0,85207.59127,8.78155999998853,169.44597543055488,0
"147.32.84.165",4971,"193.23.181.44",80,3,186,3,186,0,0,85207.59447,8.781560000003083,169.44597543027407,0
"147.32.84.165",4972,"193.23.181.44",179,3,186,3,186,0,0,85207.597673,8.781583000003593,169.44553163130055,0
"147.32.84.165",4973,"174.37.196.55",80,3,186,3,186,0,0,85207.600904,8.781573000000208,169.4457245871514,0
"147.32.84.165",4974,"184.82.148.43",80,10,1919,5,979,5,940,85207.629654,0.5752169999905163,13615.73110691987,13073.327109810703
"147.32.84.165",4975,"72.20.15.61",80,3,186,3,186,0,0,85207.649253,8.756773000000976,169.92561072438832,0
"147.32.84.165",4976,"174.37.196.55",80,8,659,4,417,4,242,85207.652503,0.42912599998817313,7773.940521180123,4511.495458334747
"147.32.84.165",4977,"193.23.181.44",179,3,186,3,186,0,0,85207.655684,8.811920000007376,168.8621775956607,0
"147.32.84.165",4978,"72.20.15.61",80,3,186,3,186,0,0,85207.658905,8.808760999992955,168.92273499090166,0
"147.32.84.165",4979,"193.23.181.44",179,3,186,3,186,0,0,85207.662104,8.805590000003576,168.98356612099764,0
"147.32.84.165",4981,"174.128.246.102",80,3,186,3,186,0,0,85207.665253,8.802464000007603,169.04357688923406,0
"147.32.84.165",4980,"193.23.181.44",80,3,186,3,186,0,0,85207.668452,8.799287999994704,169.1045911897526,0
"147.32.84.165",4982,"174.128.246.102",80,3,186,3,186,0,0,85207.671699,8.796063999994658,169.16657268534013,0
"147.32.84.165",4983,"193.23.181.44",80,3,186,3,186,0,0,85207.67491,8.792876999999862,169.22788752760027,0
"147.32.84.165",4984,"174.128.246.102",80,3,186,3,186,0,0,85207.678084,8.789728999996441,169.28849569771745,0
"147.32.84.165",4985,"193.23.181.44",179,3,186,3,186,0,0,85207.681292,8.786544000002323,169.34986042289285,0
"147.32.84.165",4986,"193.23.181.44",80,3,186,3,186,0,0,85207.684504,8.783353999999235,169.41136609091805,0
"147.32.84.165",4987,"193.23.181.44",179,3,186,3,186,0,0,85207.687708,8.881309999997029,167.5428512235805,0
"147.32.84.165",4988,"193.23.181.44",80,3,186,3,186,0,0,85207.690907,8.878171000003931,167.6020883129353,0
"147.32.84.165",4989,"174.37.196.55",80,3,186,3,186,0,0,85207.694103,8.877739999996265,167.61022512493338,0
"147.32.84.165",4990,"193.23.181.44",80,3,186,3,186,0,0,85207.697302,8.877743000004557,167.6101684853049,0
"147.32.84.165",4991,"174.128.246.102",80,3,186,3,186,0,0,85207.700504,8.877739000003203,167.61024400463486,0
"147.32.84.165",4992,"67.19.72.206",80,3,186,3,186,0,0,85207.703674,8.877798999994411,167.6091112223803,0
"147.32.84.165",4993,"67.19.72.206",80,3,186,3,186,0,0,85207.706905,8.877768999998807,167.60967761159364,0
"147.32.84.165",4994,"67.19.72.206",80,3,186,3,186,0,0,85207.710106,8.877766000005067,167.6097342506156,0
"147.32.84.165",4995,"193.23.181.44",179,3,186,3,186,0,0,85207.713276,8.877796000000671,167.6091678610195,0
"147.32.84.165",4996,"193.23.181.44",80,3,186,3,186,0,0,85207.716464,8.87778100000287,167.60945105533906,0
"147.32.84.165",4997,"193.23.181.44",80,3,186,3,186,0,0,85207.719672,8.877802999995765,167.60903570407112,0
"147.32.84.165",4998,"174.37.196.55",80,3,186,3,186,0,0,85207.722899,8.877777000001515,167.60952657402254,0
"147.32.84.165",4999,"174.128.246.102",80,3,186,3,186,0,0,85207.726077,8.877796000000671,167.6091678610195,0
"147.32.84.165",5000,"72.20.15.61",80,3,186,3,186,0,0,85207.729273,8.877770999999484,167.60963985217535,0
"147.32.84.165",1025,"67.19.72.206",80,3,186,3,186,0,0,85207.732474,8.877767999991192,167.60969649144653,0
"147.32.84.165",1026,"193.23.181.44",80,3,186,3,186,0,0,85207.735697,8.877745999998297,167.61011184598945,0
"147.32.84.165",1027,"67.19.72.206",80,3,186,3,186,0,0,85207.738855,8.87781599999289,167.6087902701736,0
"147.32.84.165",1028,"174.37.196.55",80,9,670,6,488,3,182,85207.742059,9.120042000009562,428.0682040714184,159.6483875840126
"147.32.84.165",1029,"174.37.196.55",80,9,669,6,487,3,182,85207.745257,9.123282999993535,427.0392576885712,159.59167330455844
"147.32.84.165",1030,"72.20.15.61",80,3,186,3,186,0,0,85207.748455,8.877788000012515,167.60931889766937,0
"147.32.84.165",1032,"72.20.15.61",80,3,186,3,186,0,0,85207.751699,8.87776699999813,167.60971537102893,0
"147.32.84.165",1031,"72.20.15.61",80,3,186,3,186,0,0,85207.754906,8.877777000001515,167.60952657402254,0
"147.32.84.165",1033,"193.23.181.44",80,3,186,3,186,0,0,85207.758103,8.87776400000439,167.60977201007643,0
"147.32.84.165",1034,"193.23.181.44",179,3,186,3,186,0,0,85207.761305,8.877741999996942,167.6101873652684,0
"147.32.84.165",1035,"193.23.181.44",179,3,186,3,186,0,0,85207.764504,8.877771999992547,167.60962097260995,0
"147.32.84.165",1036,"193.23.181.44",179,3,186,3,186,0,0,85207.767706,8.877791000006255,167.6092622589281,0
"147.32.84.165",1038,"67.19.72.206",80,3,186,3,186,0,0,85207.770903,8.877789000005578,167.60930001817627,0
"147.32.84.165",1040,"67.19.72.206",80,3,186,3,186,0,0,85207.774053,8.877838000000338,167.60837492190592,0
"147.32.84.165",1037,"193.23.181.44",80,3,186,3,186,0,0,85207.777274,8.877820000008796,167.60871475187892,0
"147.32.84.165",1041,"112.110.99.104",6667,2,124,2,124,0,0,85207.780483,2.80137200000172,354.1121993078359,0
"147.32.84.165",1042,"174.37.196.55",80,8,666,5,484,3,182,85207.78368,3.1111390000005485,1244.5602719773424,467.9958047518106
"147.32.84.165",1043,"193.23.181.44",179,3,186,3,186,0,0,85207.786885,8.882151000012527,167.52698755041445,0
"147.32.84.165",1044,"193.23.181.44",179,3,186,3,186,0,0,85207.790053,8.879105999993044,167.5844392443525,0
"147.32.84.165",1045,"174.37.196.55",80,8,679,5,497,3,182,85207.793272,3.1167120000027353,1275.7033694471966,467.1589803609452
"147.32.84.165",1046,"174.128.246.102",80,3,186,3,186,0,0,85207.796476,8.872728000002098,167.7049042864436,0
"147.32.84.165",1047,"193.23.181.44",179,3,186,3,186,0,0,85207.799685,8.87135999999009,167.73076506890285,0
"147.32.84.165",1048,"193.23.181.44",80,3,186,3,186,0,0,85207.802905,8.871377999996184,167.7304247435562,0
"147.32.84.165",1049,"72.20.15.61",80,3,186,3,186,0,0,85207.856054,9.008221999989473,165.18243000691356,0
"147.32.84.165",1050,"193.23.181.44",179,3,186,3,186,0,0,85207.859284,9.008189999993192,165.18301678818105,0
"147.32.84.165",1051,"193.23.181.44",179,3,186,3,186,0,0,85207.862505,9.008138000004692,165.1839703165321,0
"147.32.84.165",1052,"174.128.246.102",80,3,186,3,186,0,0,85207.865653,9.008189999993192,165.18301678818105,0
"147.32.84.165",1053,"174.128.246.102",80,3,186,3,186,0,0,85207.868918,9.008153000002494,165.1836952591267,0
"147.32.84.165",1054,"174.128.246.102",80,3,186,3,186,0,0,85207.872075,9.00820099998964,165.1828150816918,0
"147.32.84.165",1055,"174.37.196.55",80,3,186,3,186,0,0,85207.875257,9.00821799998812,165.18250335437736,0
"147.32.84.165",1056,"174.128.246.102",80,3,186,3,186,0,0,85207.878473,9.008216999995057,165.18252169112006,0
"147.32.84.165",1057,"67.19.72.206",80,3,186,3,186,0,0,85207.88169,9.008154000010109,165.1836769218566,0
"147.32.84.165",1058,"193.23.181.44",80,3,186,3,186,0,0,85207.884894,9.00814900000114,165.18376860771417,0
"147.32.84.165",1059,"193.23.181.44",80,3,186,3,186,0,0,85207.88807,9.008172999994713,165.18332851743338,0
"147.32.84.165",1060,"193.23.181.44",179,3,186,3,186,0,0,85207.891269,9.008174000002327,165.1833101802447,0
"147.32.84.165",1061,"193.23.181.44",80,3,186,3,186,0,0,85207.894473,9.008222000004025,165.1824300066467,0
"147.32.84.165",1062,"193.23.181.44",80,3,186,3,186,0,0,85207.89767,9.008201999997254,165.18279674461712,0
"147.32.84.165",1063,"72.20.15.61",80,3,186,3,186,0,0,85207.900871,9.008186999999452,165.1830717990302,0
"147.32.84.165",1064,"193.23.181.44",179,3,186,3,186,0,0,85207.904102,9.008193000001484,165.1829617771017,0
"147.32.84.165",1066,"193.23.181.44",179,3,186,3,186,0,0,85207.907254,9.00823799999489,165.18213661770972,0
"147.32.84.165",1067,"193.23.181.44",179,3,186,3,186,0,0,85207.910472,9.00817200000165,165.18334685435929,0
"147.32.84.165",1068,"193.23.181.44",179,3,186,3,186,0,0,85207.913703,9.008142000006046,165.18389696776552,0
"147.32.84.165",1069,"174.128.246.102",80,3,186,3,186,0,0,85207.916856,9.008186999999452,165.1830717990302,0
"147.32.84.165",1071,"193.23.181.44",179,3,186,3,186,0,0,85207.920092,9.00815199999488,165.18371359640088,0
"147.32.84.165",1072,"174.37.196.55",80,3,186,3,186,0,0,85207.923292,9.00815199999488,165.18371359640088,0
"147.32.84.165",1065,"72.20.15.61",80,7,634,4,452,3,182,85207.926487,0.42507599999953527,8506.714093489054,3425.269834104
"147.32.84.165",1073,"174.37.196.55",80,3,186,3,186,0,0,85207.929657,9.004985999999917,165.24178938201723,0
"147.32.84.165",1074,"174.128.246.102",80,3,186,3,186,0,0,85207.932855,9.004988000000594,165.24175268194713,0
"147.32.84.165",1075,"174.37.196.55",80,3,186,3,186,0,0,85207.936055,9.004989000008209,165.2417343317847,0
"147.32.84.165",1077,"67.19.72.206",80,3,186,3,186,0,0,85207.939254,9.004988000000594,165.24175268194713,0
"147.32.84.165",1076,"193.23.181.44",179,3,186,3,186,0,0,85207.942453,9.004991000008886,165.24169763173907,0
"147.32.84.165",1078,"193.23.181.44",179,3,186,3,186,0,0,85207.964056,8.986587999999756,165.5800844547497,0
"147.32.84.165",1079,"174.37.196.55",80,3,186,3,186,0,0,85207.976853,8.98338999999396,165.6390293643046,0
"147.32.84.165",1080,"72.20.15.61",80,3,186,3,186,0,0,85207.980054,8.983412000001408,165.63862372111697,0
"147.32.84.165",1081,"174.128.246.102",80,3,186,3,186,0,0,85207.983253,8.983412000001408,165.63862372111697,0
"147.32.84.165",1082,"174.128.246.102",80,3,186,3,186,0,0,85207.986454,8.983416999995825,165.63853152989464,0
"147.32.84.165",1083,"193.23.181.44",80,3,186,3,186,0,0,85207.989654,8.983393000002252,165.63897404907334,0
"147.32.84.165",1084,"174.128.246.102",80,3,186,3,186,0,0,85207.992854,8.983391000001575,165.63901092580065,0
"147.32.84.165",1085,"174.128.246.102",80,3,186,3,186,0,0,85207.996054,8.983448999992106,165.63794150791168,0
"147.32.84.165",1086,"174.37.196.55",80,3,186,3,186,0,0,85207.999254,8.983391000001575,165.63901092580065,0
"147.32.84.165",1088,"174.128.246.102",80,3,186,3,186,0,0,85208.002454,8.983408999993117,165.63867903611427,0
"147.32.84.165",1089,"174.37.196.55",80,3,186,3,186,0,0,85208.005653,8.983391000001575,165.63901092580065,0
"147.32.84.165",1087,"193.23.181.44",179,3,186,3,186,0,0,85208.008853,8.983394999988377,165.63893717263076,0
"147.32.84.165",1091,"174.37.196.55",80,3,186,3,186,0,0,85208.066472,8.928972999987309,166.64850481708422,0
"147.32.84.165",1092,"67.19.72.206",80,3,186,3,186,0,0,85208.069672,8.9289759999956,166.64844882556892,0
"147.32.84.165",1093,"193.23.181.44",80,3,186,3,186,0,0,85208.072872,8.9289759999956,166.64844882556892,0
"147.32.84.165",1094,"174.37.196.55",80,3,186,3,186,0,0,85208.076059,8.928985999998986,166.648262187909,0
"147.32.84.165",1095,"174.128.246.102",80,3,186,3,186,0,0,85208.07926,8.928985000005923,166.6482808515204,0
"147.32.84.165",1096,"72.20.15.61",80,3,186,3,186,0,0,85208.082475,8.928988999992725,166.64820619682837,0
"147.32.84.165",1090,"174.128.246.102",80,3,186,3,186,0,0,85208.085702,8.92896400000609,166.64867279104107,0
"147.32.84.165",1098,"67.19.72.206",80,3,186,3,186,0,0,85208.088901,8.928945000006934,166.64902740456398,0
"147.32.84.165",1097,"174.128.246.102",80,3,186,3,186,0,0,85208.092104,8.928995000009309,166.64809421423675,0
"147.32.84.165",1099,"184.82.148.44",80,10,1514,5,596,5,918,85208.101704,0.4832670000032522,9866.181634516557,15196.56835652047
"147.32.84.165",1100,"193.23.181.44",80,3,186,3,186,0,0,85208.114477,8.976167000000714,165.7723168474786,0
"147.32.84.165",1102,"193.23.181.44",80,3,186,3,186,0,0,85208.117703,8.97613999999885,165.7728154864107,0
"147.32.84.165",1103,"72.20.15.61",80,3,186,3,186,0,0,85208.120878,8.976165000000037,165.77235378360288,0
"147.32.84.165",1101,"72.20.15.61",80,3,186,3,186,0,0,85208.124105,8.976137999998173,165.77285242275718,0
"147.32.84.165",1104,"174.37.196.55",80,3,186,3,186,0,0,85208.127277,8.9761659999931,165.77233531567308,0
"147.32.84.165",1105,"193.23.181.44",179,3,186,3,186,0,0,85208.130477,8.976166000007652,165.77233531540432,0
"147.32.84.165",1110,"174.128.246.102",80,3,186,3,186,0,0,85208.133678,8.976165000000037,165.77235378360288,0
"147.32.84.165",1111,"174.128.246.102",80,10,763,6,521,4,242,85208.136903,9.289969999997993,448.65591600413137,208.39679783685182
"147.32.84.165",1112,"72.20.15.61",80,3,186,3,186,0,0,85208.140085,8.976157999990392,165.77248306030182,0
"147.32.84.165",1113,"193.23.181.44",80,3,186,3,186,0,0,85208.143254,8.976189000008162,165.77191055119795,0
"147.32.84.165",1114,"174.128.246.102",80,3,186,3,186,0,0,85208.146454,8.97618899999361,165.7719105514667,0
"147.32.84.165",1115,"193.23.181.44",179,3,186,3,186,0,0,85208.149656,8.976187000007485,165.77194748714118,0
"147.32.84.165",1116,"72.20.15.61",80,3,186,3,186,0,0,85208.152858,8.97618599999987,165.7719659552533,0
"147.32.84.165",1117,"174.128.246.102",80,3,186,3,186,0,0,85208.156057,8.97618599999987,165.7719659552533,0
"147.32.84.165",1118,"193.23.181.44",80,3,186,3,186,0,0,85208.159252,8.97619100000884,165.77187361527118,0
"147.32.84.165",1119,"72.20.15.61",80,3,186,3,186,0,0,85208.162507,8.976135999997496,165.77288935912014,0
"147.32.84.165",1120,"174.37.196.55",80,3,186,3,186,0,0,85208.185653,8.956190000011702,166.14207603881292,0
"147.32.84.165",1121,"72.20.15.61",80,3,186,3,186,0,0,85208.188854,8.985007999988738,165.60920146113003,0
"147.32.84.165",1122,"193.23.181.44",179,3,186,3,186,0,0,85208.192053,8.984998999992968,165.60936734674814,0
"147.32.84.165",1123,"174.37.196.55",80,3,186,3,186,0,0,85208.195253,8.984991999997874,165.6094963690955,0
"147.32.84.165",1124,"174.37.196.55",80,3,186,3,186,0,0,85208.198453,8.984992999990936,165.60947793743424,0
"147.32.84.165",1125,"67.19.72.206",80,3,186,3,186,0,0,85208.201653,8.984991999997874,165.6094963690955,0
"147.32.84.165",1126,"72.20.15.61",80,3,186,3,186,0,0,85208.204853,8.98499099999026,165.6095148010291,0
"147.32.84.165",1127,"193.23.181.44",179,3,186,3,186,0,0,85208.208053,8.985039000006509,165.60863007928202,0
"147.32.84.165",1128,"193.23.181.44",80,3,186,3,186,0,0,85208.211254,8.985037999998895,165.60864851102278,0
"147.32.84.165",1129,"72.20.15.61",80,3,186,3,186,0,0,85208.214453,8.984995000006165,165.60944107358756,0
"147.32.84.165",1130,"174.37.196.55",80,3,186,3,186,0,0,85208.217653,8.984995999999228,165.6094226419386,0
"147.32.84.165",1131,"67.19.72.206",80,3,186,3,186,0,0,85208.220852,8.984995999999228,165.6094226419386,0
"147.32.84.165",1132,"193.23.181.44",179,3,186,3,186,0,0,85208.224084,8.984960000001593,165.61008618844562,0
"147.32.84.165",1133,"193.23.181.44",179,3,186,3,186,0,0,85208.227253,8.98499099999026,165.6095148010291,0
"147.32.84.165",1134,"67.19.72.206",80,3,186,3,186,0,0,85208.23048,8.984964000002947,165.61001246076356,0
"147.32.84.165",1135,"67.19.72.206",80,3,186,3,186,0,0,85208.233673,8.984972000005655,165.6098650055964,0
"147.32.84.165",1136,"72.20.15.61",80,3,186,3,186,0,0,85208.236855,8.984993000005488,165.60947793716602,0
"147.32.84.165",1137,"67.19.72.206",80,3,186,3,186,0,0,85208.240055,8.985012000004645,165.6091277339675,0
"147.32.84.165",1138,"193.23.181.44",80,3,186,3,186,0,0,85208.243252,8.98501099999703,165.60914616581903,0
"147.32.84.165",1139,"174.37.196.55",80,3,186,3,186,0,0,85208.246452,8.985009999989416,165.60916459767466,0
"147.32.84.165",1140,"193.23.181.44",179,3,186,3,186,0,0,85208.249655,8.985092999995686,165.6076347791519,0
"147.32.84.165",1141,"174.37.196.55",80,3,186,3,186,0,0,85208.252854,8.985005999988061,165.6092383246018,0
"147.32.84.165",1142,"67.19.72.206",80,3,186,3,186,0,0,85208.256087,8.984983000002103,165.6096622553044,0
"147.32.84.165",1143,"72.20.15.61",80,3,186,3,186,0,0,85208.259271,8.98499099999026,165.6095148010291,0
"147.32.84.165",1144,"174.37.196.55",80,3,186,3,186,0,0,85208.278073,8.969421000001603,165.8969960268042,0
"147.32.84.165",1145,"67.19.72.206",80,3,186,3,186,0,0,85208.315253,8.95584300000337,166.14851332246894,0
"147.32.84.165",1146,"67.19.72.206",80,3,186,3,186,0,0,85208.318457,8.955795999994734,166.1493852697041,0
"147.32.84.165",1147,"193.23.181.44",80,3,186,3,186,0,0,85208.321654,8.955791000000318,166.14947803046624,0
"147.32.84.165",1148,"72.20.15.61",80,3,186,3,186,0,0,85208.324872,8.955780999996932,166.1496635525712,0
"147.32.84.165",1149,"193.23.181.44",179,3,186,3,186,0,0,85208.328071,8.95582899999863,166.14877305051579,0
"147.32.84.165",1150,"174.37.196.55",80,3,186,3,186,0,0,85208.331256,8.955786999998963,166.1495522392585,0
"147.32.84.165",1151,"174.37.196.55",80,3,186,3,186,0,0,85208.334474,8.955797000002349,166.14936671740213,0
"147.32.84.165",1152,"193.23.181.44",179,3,186,3,186,0,0,85208.337669,8.955824000004213,166.14886581059432,0
"147.32.84.165",1153,"193.23.181.44",179,3,186,3,186,0,0,85208.340852,8.955818000002182,166.14897712298725,0
"147.32.84.165",1154,"174.37.196.55",80,3,186,3,186,0,0,85208.344053,8.955790000007255,166.1494965825231,0
"147.32.84.165",1155,"72.20.15.61",80,3,186,3,186,0,0,85208.347254,8.955821000010474,166.14892146663715,0
"147.32.84.165",1156,"67.19.72.206",80,3,186,3,186,0,0,85208.350454,8.955841000002692,166.1485504264259,0
"147.32.84.165",1157,"193.23.181.44",179,3,186,3,186,0,0,85208.353684,8.95579199999338,166.14945947841352,0
"147.32.84.165",1158,"193.23.181.44",80,3,186,3,186,0,0,85208.356852,8.955847999997786,166.148420562784,0
"147.32.84.165",1159,"193.23.181.44",80,3,186,3,186,0,0,85208.360082,8.955813000007765,166.14906988329366,0
"147.32.84.165",1160,"174.37.196.55",80,3,186,3,186,0,0,85208.363284,8.955775999987964,166.14975631391405,0
"147.32.84.165",1161,"72.20.15.61",80,3,186,3,186,0,0,85208.366484,8.955807999998797,166.1491626439736,0
"147.32.84.165",1162,"193.23.181.44",179,3,186,3,186,0,0,85208.369652,8.955862000002526,166.14816083583918,0
"147.32.84.165",1163,"193.23.181.44",80,3,186,3,186,0,0,85208.37288,8.95590300000913,166.14740021173554,0
"147.32.84.165",1165,"193.23.181.44",179,3,186,3,186,0,0,85208.376082,8.95580899999186,166.1491440919913,0
"147.32.84.165",1164,"174.37.196.55",80,3,186,3,186,0,0,85208.379254,8.95584300000337,166.14851332246894,0
"147.32.84.165",1166,"193.23.181.44",80,3,186,3,186,0,0,85208.382454,8.955810999992536,166.1491069877692,0
"147.32.84.165",1167,"72.20.15.61",80,3,186,3,186,0,0,85208.388854,8.982571999993525,165.65411332089212,0
"147.32.84.165",1168,"72.20.15.61",80,3,186,3,186,0,0,85208.392053,8.979494999992312,165.71087795040523,0
"147.32.84.165",1169,"174.128.246.102",80,9,698,5,456,4,242,85208.395253,3.269627000001492,1115.7235978288456,592.1164707775891
"147.32.84.165",1170,"67.19.72.206",80,3,186,3,186,0,0,85208.398454,8.9731380000012,165.8282754594659,0
"147.32.84.165",1171,"174.37.196.55",80,3,186,3,186,0,0,85208.401654,8.969964999996591,165.88693489891716,0
"147.32.84.165",1172,"174.128.246.102",80,3,186,3,186,0,0,85208.404854,8.96779300000344,165.92711272432686,0
"147.32.84.165",1173,"193.23.181.44",179,3,186,3,186,0,0,85208.408054,8.967808999994304,165.92681668409142,0
"147.32.84.165",1174,"193.23.181.44",80,3,186,3,186,0,0,85208.411282,8.967837999996846,165.92628011350376,0
"147.32.84.165",1175,"72.20.15.61",80,3,186,3,186,0,0,85208.414454,8.967807000008179,165.9268536888275,0
"147.32.84.165",1176,"193.23.181.44",80,3,186,3,186,0,0,85208.417653,8.967809000008856,165.92681668382215,0
"147.32.84.165",1177,"174.37.196.55",80,3,186,3,186,0,0,85208.420873,8.968034999998054,165.9226352261474,0
"147.32.84.165",1178,"193.23.181.44",179,3,186,3,186,0,0,85208.424072,8.967787000001408,165.92722373978847,0
"147.32.84.165",1179,"193.23.181.44",80,3,186,3,186,0,0,85208.427276,8.967791999995825,165.9271312270281,0
"147.32.84.165",1180,"67.19.72.206",80,3,186,3,186,0,0,85208.430473,8.967785999993794,165.92724224251447,0
"147.32.84.165",1181,"174.128.246.102",80,3,186,3,186,0,0,85208.433655,8.967808999994304,165.92681668409142,0
"147.32.84.165",1182,"193.23.181.44",179,3,186,3,186,0,0,85208.43687,8.967791999995825,165.9271312270281,0
"147.32.84.165",1183,"193.23.181.44",179,3,186,3,186,0,0,85208.44009,8.967772999996669,165.92748277644324,0
"147.32.84.165",1184,"67.19.72.206",80,3,186,3,186,0,0,85208.443259,8.96778499998618,165.92726074524458,0
"147.32.84.165",1186,"67.19.72.206",80,3,186,3,186,0,0,85208.446454,8.967794999989565,165.92707571947525,0
"147.32.84.165",1187,"67.19.72.206",80,3,186,3,186,0,0,85208.449654,8.967841000005137,165.9262246062511,0
"147.32.84.165",1188,"67.19.72.206",80,3,186,3,186,0,0,85208.452854,8.967810000001919,165.92679818146033,0
"147.32.84.165",1185,"67.19.72.206",80,3,186,3,186,0,0,85208.456076,8.967787000001408,165.92722373978847,0
"147.32.84.165",1189,"217.163.21.36",80,14,6135,7,810,7,5325,85208.481676,0.2316430000064429,27974.080804599173,183903.67936356863
"147.32.84.165",1190,"193.23.181.44",80,3,186,3,186,0,0,85208.488069,8.98435199999949,165.6212935557383,0
"147.32.84.165",1191,"174.37.196.55",80,3,186,3,186,0,0,85208.491271,8.981174000000465,165.67989886399295,0
"147.32.84.165",1192,"174.128.246.102",80,3,186,3,186,0,0,85208.494505,8.977963000012096,165.73915486151984,0
"147.32.84.165",1193,"193.23.181.44",179,3,186,3,186,0,0,85208.497703,8.974786999999196,165.79780667776663,0
"147.32.84.165",1194,"174.128.246.102",80,3,186,3,186,0,0,85208.500872,8.971640999996453,165.85594541740898,0
"147.32.84.165",1195,"193.23.181.44",179,3,186,3,186,0,0,85208.5041,8.968434999987949,165.91523493251603,0
"147.32.84.165",1196,"72.20.15.61",80,3,186,3,186,0,0,85208.507255,8.965302999989945,165.97319689046415,0
"147.32.84.165",1197,"193.23.181.44",179,3,186,3,186,0,0,85208.510476,8.962104000005638,166.03244059643404,0
"147.32.84.165",1198,"193.23.181.44",80,3,186,3,186,0,0,85208.513705,8.958897999997134,166.09185638685426,0
"147.32.84.165",1199,"72.20.15.61",80,3,186,3,186,0,0,85208.516883,8.955746999999974,166.15029433055716,0
"147.32.84.165",1200,"72.20.15.61",80,3,186,3,186,0,0,85208.520083,8.952570000008564,166.2092561128901,0
"147.32.84.165",1201,"193.23.181.44",80,3,186,3,186,0,0,85208.523307,8.949367000008351,166.2687428059003,0
"147.32.84.165",1202,"193.23.181.44",179,3,186,3,186,0,0,85208.526482,8.9462130000029,166.3273610855809,0
"147.32.84.165",1203,"193.23.181.44",80,3,186,3,186,0,0,85208.529658,8.945386999999755,166.34271943740845,0
"147.32.84.165",1205,"67.19.72.206",80,3,186,3,186,0,0,85208.532854,8.945405999998911,166.34236612627544,0
"147.32.84.165",1206,"174.128.246.102",80,3,186,3,186,0,0,85208.536059,8.945417999988422,166.34214298336042,0
"147.32.84.165",1207,"193.23.181.44",80,3,186,3,186,0,0,85208.539255,8.94538800000737,166.3427008419058,0
"147.32.84.165",1204,"72.20.15.61",80,3,186,3,186,0,0,85208.542454,8.94538800000737,166.3427008419058,0
"147.32.84.165",1208,"174.128.246.102",80,3,186,3,186,0,0,85208.574453,8.997309000013047,165.38278278514633,0
"147.32.84.165",1209,"193.23.181.44",80,3,186,3,186,0,0,85208.577655,8.994212000005064,165.43972946147613,0
"147.32.84.165",1210,"174.128.246.102",80,3,186,3,186,0,0,85208.580883,8.991024999995716,165.49837198769984,0
"147.32.84.165",1211,"216.157.130.15",25,3,186,3,186,0,0,85208.584087,8.987850999998045,165.5568166406323,0
"147.32.84.165",1212,"174.128.246.102",80,3,186,3,186,0,0,85208.587305,8.984663000010187,165.61556065022282,0
"147.32.84.165",1213,"174.37.196.55",80,3,186,3,186,0,0,85208.59048,8.981515999999829,165.67359007098895,0
"147.32.84.165",1214,"72.20.15.61",80,3,186,3,186,0,0,85208.593705,8.978317999994033,165.73260158539594,0
"147.32.84.165",1215,"174.37.196.55",80,3,186,3,186,0,0,85208.596879,8.97517199999129,165.79069459632018,0
"147.32.84.165",1216,"174.37.196.55",80,3,186,3,186,0,0,85208.600052,8.97202900001139,165.8487728916292,0
"147.32.84.165",1218,"72.20.15.61",80,3,186,3,186,0,0,85208.603301,8.968808999998146,165.90831625473433,0
"147.32.84.165",1219,"193.23.181.44",179,3,186,3,186,0,0,85208.606507,8.965631999992183,165.96710639041368,0
"147.32.84.165",1220,"174.37.196.55",80,3,186,3,186,0,0,85208.609676,8.962492000006023,166.02525279788256,0
"147.32.84.165",1217,"67.19.72.206",80,3,186,3,186,0,0,85208.612902,8.95929199999955,166.08455221685762,0
"147.32.84.165",1221,"193.23.181.44",179,3,186,3,186,0,0,85208.616104,8.956116000001202,166.14344878960927,0
"147.32.84.165",1222,"193.23.181.44",80,3,186,3,186,0,0,85208.641202,9.031700999999885,164.753018285262,0
"147.32.84.165",1223,"67.19.72.206",80,3,186,3,186,0,0,85208.641948,9.031012999999803,164.76556948816622,0
"147.32.84.165",1224,"174.128.246.102",80,3,186,3,186,0,0,85208.642509,9.030473000006168,164.77542206249703,0
"147.32.84.165",1225,"67.19.72.206",80,4,246,3,186,1,60,85208.642732,9.19095400000515,161.89831871633416,52.225264102043276
"147.32.84.165",1226,"174.37.196.55",80,7,599,4,417,3,182,85208.642951,0.2422039999946719,13773.513237078605,6011.461412825674
"147.32.84.165",1227,"193.23.181.44",80,3,186,3,186,0,0,85208.643181,9.029850999999326,164.78677222914433,0
"147.32.84.165",1228,"217.163.21.36",80,10,1447,5,699,5,748,85208.676254,0.14220399998885114,39323.78836346668,42080.391553466485
"147.32.84.165",1229,"193.23.181.44",80,3,186,3,186,0,0,85208.742817,9.029626999996253,164.79086013194316,0
"147.32.84.165",1230,"72.20.15.61",80,3,186,3,186,0,0,85208.743762,9.028785000002244,164.8062280804815,0
"147.32.84.165",1231,"193.23.181.44",179,3,186,3,186,0,0,85208.74439,9.02819699999236,164.81696179217835,0
"147.32.84.165",1232,"193.23.181.44",80,3,186,3,186,0,0,85208.7445,9.028120000002673,164.81836750060472,0
"147.32.84.165",1233,"72.20.15.61",80,3,186,3,186,0,0,85208.744674,9.027994000003673,164.82066780276932,0
"147.32.84.165",1234,"193.23.181.44",179,3,186,3,186,0,0,85208.744783,9.027931999997236,164.8217997211826,0
"147.32.84.165",1235,"193.23.181.44",179,3,186,3,186,0,0,85208.74489,9.027871999991476,164.8228951408931,0
"147.32.84.165",1236,"72.20.15.61",80,3,186,3,186,0,0,85208.745004,9.027803999997559,164.82413663393692,0
"147.32.84.165",1237,"67.19.72.206",80,3,186,3,186,0,0,85208.745114,9.027744999999413,164.8252138269409,0
"147.32.84.165",1238,"67.19.72.206",80,3,186,3,186,0,0,85208.74522,9.027686000001268,164.8262910340248,0
"147.32.84.165",1239,"72.20.15.61",80,3,186,3,186,0,0,85208.745328,9.02762100000109,164.82747780393308,0
"147.32.84.165",1240,"72.20.15.61",80,3,186,3,186,0,0,85208.745435,9.027561999988393,164.8285550408752,0
"147.32.84.165",1241,"174.37.196.55",80,3,186,3,186,0,0,85208.745541,9.027501999997185,164.829650550115,0
"147.32.84.165",1242,"174.37.196.55",80,3,186,3,186,0,0,85208.745647,9.027442999999039,164.83072781519178,0
"147.32.84.165",1243,"193.23.181.44",80,3,186,3,186,0,0,85208.745753,9.02738600000157,164.83176857616826,0
"147.32.84.165",1244,"72.20.15.61",80,3,186,3,186,0,0,85208.74586,9.027322000009008,164.83293716547556,0
"147.32.84.165",1246,"67.19.72.206",80,3,186,3,186,0,0,85208.748085,9.025141999998596,164.8727521406568,0
"147.32.84.165",1245,"67.19.72.206",80,3,186,3,186,0,0,85208.748194,9.025066999995033,164.8741222642246,0
"147.32.84.165",1247,"72.20.15.61",80,3,186,3,186,0,0,85208.767026,9.006271000005654,165.21821295395907,0
"147.32.84.165",1248,"174.37.196.55",80,3,186,3,186,0,0,85208.793034,8.980297000001883,165.6960788712988,0
"147.32.84.165",1249,"72.20.15.61",80,3,186,3,186,0,0,85208.793158,8.980209999994258,165.6976841299871,0
"147.32.84.165",1252,"217.163.21.35",80,11,3577,6,1949,5,1628,85208.793277,0.2991780000011204,52116.1315335406,43532.61269194669
"147.32.84.165",1251,"174.37.196.55",80,3,186,3,186,0,0,85208.793406,8.9799980000098,165.70159592445077,0
"147.32.84.165",1250,"193.23.181.44",80,3,186,3,186,0,0,85208.793514,8.979932999995071,165.702795332751,0
"147.32.84.165",1253,"174.128.246.102",80,3,186,3,186,0,0,85208.890876,8.982649999990826,165.6526748789633,0
"147.32.84.165",1254,"193.23.181.44",80,3,186,3,186,0,0,85208.894088,8.979504000002635,165.71071186109648,0
"147.32.84.165",1255,"193.23.181.44",179,3,186,3,186,0,0,85208.897273,8.976342000009026,165.76908500127377,0
"147.32.84.165",1256,"67.19.72.206",80,3,186,3,186,0,0,85208.90047,8.973169000004418,165.82770256519936,0
"147.32.84.165",1257,"174.37.196.55",80,3,186,3,186,0,0,85208.903698,8.969964000003529,165.8869533923898,0
"147.32.84.165",1258,"72.20.15.61",80,7,597,4,415,3,182,85208.906857,0.4254849999997532,7802.860265348781,3421.9772729963324
"147.32.84.165",1259,"193.23.181.44",80,3,186,3,186,0,0,85208.910053,8.963636000000406,166.0040635295691,0
"147.32.84.165",1260,"72.20.15.61",80,3,186,3,186,0,0,85208.913253,8.960458999994444,166.06292155356357,0
"147.32.84.165",1261,"72.20.15.61",80,7,600,4,418,3,182,85208.916452,0.4355129999894416,7678.301221963686,3343.183785639691
"147.32.84.165",1262,"67.19.72.206",80,3,186,3,186,0,0,85208.919654,8.954079000002821,166.1812454412711,0
"147.32.84.165",1263,"174.128.246.102",80,3,186,3,186,0,0,85208.922906,8.95084799999313,166.2412321157886,0
"147.32.84.165",1264,"174.37.196.55",80,3,186,3,186,0,0,85208.926072,8.947704999998678,166.2996265523081,0
"147.32.84.165",1265,"72.20.15.61",80,3,186,3,186,0,0,85208.929254,8.944546999991871,166.35834100948347,0
"147.32.84.165",1267,"174.128.246.102",80,3,186,3,186,0,0,85208.932454,8.941371000008075,166.41743195743203,0
"147.32.84.165",1266,"67.19.72.206",80,3,186,3,186,0,0,85208.935654,8.938194000002113,166.47658352455184,0
"147.32.84.165",1268,"193.23.181.44",179,3,186,3,186,0,0,85208.938853,8.935016000003088,166.53579579482405,0
"147.32.84.165",1270,"67.19.72.206",80,3,186,3,186,0,0,85208.942054,8.931838999997126,166.5950315495475,0
"147.32.84.165",1271,"67.19.72.206",80,3,186,3,186,0,0,85208.945251,8.928664999999455,166.65425346343386,0
"147.32.84.165",1269,"174.37.196.55",80,3,186,3,186,0,0,85208.948454,8.925484999999753,166.7136295674735,0
"147.32.84.165",1273,"174.128.246.102",80,3,186,3,186,0,0,85208.954852,9.018063000010443,165.0021739699841,0
"147.32.84.165",1274,"193.23.181.44",80,3,186,3,186,0,0,85208.958052,9.014989999996033,165.05841936603977,0
"147.32.84.165",1275,"174.128.246.102",80,3,186,3,186,0,0,85208.961254,9.011837000012747,165.11616887854223,0
"147.32.84.165",1276,"72.20.15.61",80,3,186,3,186,0,0,85208.964453,9.008688000001712,165.17388547585588,0
"147.32.84.165",1277,"72.20.15.61",80,7,597,4,415,3,182,85208.967656,0.43817000000854023,7576.96784338337,3322.9111987849956
"147.32.84.165",1278,"193.23.181.44",80,3,186,3,186,0,0,85208.970854,9.002334999997402,165.29044964450105,0
"147.32.84.165",1279,"67.19.72.206",80,3,186,3,186,0,0,85208.974053,8.999183000007179,165.3483432883644,0
"147.32.84.165",1280,"67.19.72.206",80,3,186,3,186,0,0,85208.977283,8.995999000006123,165.4068658743723,0
"147.32.84.165",1281,"193.23.181.44",179,3,186,3,186,0,0,85208.98048,8.992849000002025,165.46480431281176,0
"147.32.84.165",1282,"174.128.246.102",80,3,186,3,186,0,0,85208.983655,8.989720999990823,165.52237828087425,0
"147.32.84.165",1283,"72.20.15.61",80,7,552,4,370,3,182,85208.986902,0.44034000000101514,6722.0783939528,3306.5358586470534
"147.32.84.165",1284,"174.37.196.55",80,3,186,3,186,0,0,85208.990077,8.983346000008169,165.63984065610376,0
"147.32.84.165",1285,"193.23.181.44",80,3,186,3,186,0,0,85208.993276,8.980194000003394,165.6979793531674,0
"147.32.84.165",1286,"193.23.181.44",179,3,186,3,186,0,0,85208.996481,8.977035000003525,165.75628812847623,0
"147.32.84.165",1287,"193.23.181.44",179,3,186,3,186,0,0,85208.999677,8.973887999993167,165.8144162264041,0
"147.32.84.165",1288,"72.20.15.61",80,3,186,3,186,0,0,85209.002903,8.970709999994142,165.87315831199223,0
"147.32.84.165",1289,"217.163.21.36",80,10,2273,5,1154,5,1119,85209.015549,0.24331199999141973,37943.05254293073,36792.26672057148
"147.32.84.165",1290,"212.117.171.138",65500,8,484,4,242,4,242,85209.031675,0.4497549999941839,4304.565819223879,4304.565819223879
"147.32.84.165",1291,"193.23.181.44",80,3,186,3,186,0,0,85209.044883,9.028239999999641,164.81617679636994,0
"147.32.84.165",1292,"174.37.196.55",80,3,186,3,186,0,0,85209.045924,9.027301999987685,164.83330235346395,0
"147.32.84.165",1293,"174.128.246.102",80,3,186,3,186,0,0,85209.046196,9.027054000005592,164.83783081380463,0
"147.32.84.165",1294,"193.23.181.44",179,3,186,3,186,0,0,85209.046787,9.026484000001801,164.8482399126507,0
"147.32.84.165",1295,"193.23.181.44",80,3,186,3,186,0,0,85209.047071,9.026222000000416,164.8530248868166,0
"147.32.84.165",1296,"193.23.181.44",80,3,186,3,186,0,0,85209.047289,9.026024000006146,164.8566411964988,0
"147.32.84.165",1298,"174.37.196.55",80,3,186,3,186,0,0,85209.047588,9.025750999993761,164.86162758102108,0
"147.32.84.165",1299,"174.128.246.102",80,3,186,3,186,0,0,85209.047823,9.025538999994751,164.8654999995973,0
"147.32.84.165",1297,"72.20.15.61",80,3,186,3,186,0,0,85209.048066,9.025318999993033,164.8695187395757,0
"147.32.84.165",1301,"72.20.15.61",80,3,186,3,186,0,0,85209.050854,9.022553000002517,164.9200619824106,0
"147.32.84.165",1302,"193.23.181.44",80,3,186,3,186,0,0,85209.054074,9.019356000004336,164.9785195305834,0
"147.32.84.165",1303,"174.128.246.102",80,3,186,3,186,0,0,85209.057255,9.01619799999753,165.0363046597255,0
"147.32.84.165",1304,"174.128.246.102",80,3,186,3,186,0,0,85209.060475,9.013001999992412,165.09482634101855,0
"147.32.84.165",1300,"193.23.181.44",80,3,186,3,186,0,0,85209.063671,9.009826000008616,165.15302293280436,0
"147.32.84.165",1306,"174.37.196.55",80,3,186,3,186,0,0,85209.066871,9.006653000004007,165.2112055387654,0
"147.32.84.165",1307,"193.23.181.44",179,3,186,3,186,0,0,85209.070074,9.003473000004306,165.2695576472866,0
"147.32.84.165",1308,"193.23.181.44",80,3,186,3,186,0,0,85209.073294,9.000274000005447,165.32830000498868,0
"147.32.84.165",1305,"67.19.72.206",80,3,186,3,186,0,0,85209.076474,8.99711899999238,165.38627531782785,0
"147.32.84.165",1309,"174.37.196.55",80,3,186,3,186,0,0,85209.079673,8.993946000002325,165.44462241596906,0
"147.32.84.165",1310,"174.37.196.55",80,3,186,3,186,0,0,85209.082875,8.990764000001946,165.50317637073758,0
"147.32.84.165",1311,"72.20.15.61",80,3,186,3,186,0,0,85209.086076,8.987584999995306,165.5617165234907,0
"147.32.84.165",1312,"174.128.246.102",80,7,606,4,424,3,182,85209.162903,0.383135999989463,8853.253153170901,3800.2171553705284
"147.32.84.165",1313,"174.37.196.55",80,3,186,3,186,0,0,85209.184504,8.889176999990013,167.3945743235478,0
"147.32.84.165",1314,"174.128.246.102",80,6,488,4,366,2,122,85209.187683,0.3738630000007106,7831.745853412706,2610.581951137569
"147.32.84.165",1315,"174.128.246.102",80,6,578,4,456,2,122,85209.190863,0.41067900000780355,8882.850109040593,2376.552002857352
"147.32.84.165",1316,"174.37.196.55",80,3,186,3,186,0,0,85209.194076,8.980219999997644,165.6974996158658,0
"147.32.84.165",1317,"72.20.15.61",80,3,186,3,186,0,0,85209.197306,8.97704800000065,165.75604809062983,0
"147.32.84.165",1318,"174.37.196.55",80,3,186,3,186,0,0,85209.200474,8.973901000004844,165.81417601990447,0
"147.32.84.165",1319,"193.23.181.44",80,3,186,3,186,0,0,85209.203674,8.970726999992621,165.87284397365164,0
"147.32.84.165",1320,"67.19.72.206",80,3,186,3,186,0,0,85209.206889,8.967536000011023,165.93186801794505,0
"147.32.84.165",1321,"217.163.21.35",80,13,5347,7,2464,6,2883,85209.216474,0.3547799999942072,55561.192852815424,65009.30154004337
"147.32.84.165",1322,"174.37.196.55",80,3,186,3,186,0,0,85209.238077,8.936367999995127,166.51060027975697,0
"147.32.84.165",1323,"193.23.181.44",80,3,186,3,186,0,0,85209.257273,8.917193000001134,166.86865474368568,0
"147.32.84.165",1324,"72.20.15.61",80,3,186,3,186,0,0,85209.260472,9.0135569999984,165.0846608059686,0
"147.32.84.165",1325,"174.37.196.55",80,3,186,3,186,0,0,85209.263683,9.010473000002094,165.1411640653775,0
"147.32.84.165",1326,"174.37.196.55",80,3,186,3,186,0,0,85209.397275,8.876941000009538,167.625311466912,0
"147.32.84.165",1327,"72.20.15.61",80,3,186,3,186,0,0,85209.416057,8.959490000008373,166.08088183575288,0
"147.32.84.165",1328,"67.19.72.206",80,3,186,3,186,0,0,85209.439655,8.935955000008107,166.51829602976403,0
"147.32.84.165",1329,"173.241.240.4",80,9,2193,5,1163,4,1030,85209.452456,0.14493199999560602,64195.62277676479,56854.248890857896
"147.32.84.165",1330,"92.240.244.181",80,10,1758,6,1364,4,394,85209.455656,5.100514999998268,2139.3918065143826,617.9768121456501
"147.32.84.165",1332,"174.37.196.55",80,3,186,3,186,0,0,85209.462056,9.012739999991027,165.09962564120138,0
"147.32.84.165",1333,"212.117.171.138",65500,8,484,4,242,4,242,85209.574476,0.8920380000054138,2170.311130230159,2170.311130230159
"147.32.84.165",1334,"173.192.170.88",80,14,2969,7,602,7,2367,85209.614304,40.58233499999915,118.6723238078859,466.6069608858238
"147.32.84.165",1335,"67.19.72.206",80,3,186,3,186,0,0,85209.845454,9.030563000007533,164.77377988490406,0
"147.32.84.165",1336,"72.20.15.61",80,3,186,3,186,0,0,85209.845736,9.03040200000396,164.7767175812713,0
"147.32.84.165",1337,"193.23.181.44",80,3,186,3,186,0,0,85210.15987,8.916950999991968,166.87318344592677,0
"147.32.84.165",1339,"174.128.246.102",80,10,763,6,521,4,242,85210.259051,9.232097000000067,451.4683933671808,209.7031692799573
"147.32.84.165",1338,"67.19.72.206",80,3,186,3,186,0,0,85210.262251,8.91502300000866,166.9092721351986,0
"147.32.84.165",1340,"67.19.72.206",80,3,186,3,186,0,0,85210.265452,8.911843999987468,166.9688113932529,0
"147.32.84.165",1341,"193.23.181.44",179,3,186,3,186,0,0,85210.268651,8.908668999996735,167.02831814725022,0
"147.32.84.165",1342,"174.128.246.102",80,8,627,5,445,3,182,85210.271852,3.200275999988662,1112.4040551541843,454.96075963609337
"147.32.84.165",1343,"67.19.72.206",80,3,186,3,186,0,0,85210.275051,8.902291999998852,167.1479659395796,0
"147.32.84.165",1345,"67.19.72.206",80,3,186,3,186,0,0,85210.351855,8.925275999994483,166.71753344108572,0
"147.32.84.165",1344,"193.23.181.44",80,3,186,3,186,0,0,85210.355053,8.922180999987177,166.77536579925228,0
"147.32.84.165",1346,"174.128.246.102",80,3,186,3,186,0,0,85210.358253,8.91900500000338,166.8347534281499,0
"147.32.84.165",1347,"67.19.72.206",80,3,186,3,186,0,0,85210.361454,8.915825999996741,166.8942395242509,0
"147.32.84.165",1348,"174.37.196.55",80,3,186,3,186,0,0,85210.381853,8.895449999996345,167.27652901209174,0
"147.32.84.165",1349,"174.37.196.55",80,3,186,3,186,0,0,85210.401055,8.876273000001675,167.63792641345296,0
"147.32.84.165",1350,"174.128.246.102",80,3,186,3,186,0,0,85210.421854,8.85549699999683,168.03122399573198,0
"147.32.84.165",1352,"193.23.181.44",80,3,186,3,186,0,0,85210.428255,8.94941299999482,166.26788818449447,0
"147.32.84.165",1351,"193.23.181.44",179,3,186,3,186,0,0,85210.431451,8.946315000008326,166.32546473029566,0
"147.32.84.165",1353,"193.23.181.44",179,3,186,3,186,0,0,85210.434651,8.943138999995426,166.38453232145457,0
"147.32.84.165",1354,"67.19.72.206",80,3,186,3,186,0,0,85210.437852,8.939958999995724,166.44371635269374,0
"147.32.84.165",1356,"212.117.171.138",65500,8,484,4,242,4,242,85210.50381,1.0143959999986691,1908.5248758892385,1908.5248758892385
"147.32.84.165",1357,"193.23.181.44",80,3,186,3,186,0,0,85210.649251,9.029252000007546,164.79770417292113,0
"147.32.84.165",1358,"72.20.15.61",80,3,186,3,186,0,0,85210.649524,9.02902700001141,164.80181087044258,0
"147.32.84.165",1359,"67.19.72.206",80,3,186,3,186,0,0,85210.649644,9.028955000001588,164.80312505707894,0
"147.32.84.165",1360,"67.19.72.206",80,4,246,3,186,1,60,85210.649761,9.184282000001986,162.0159311309995,52.263203590645
"147.32.84.165",1362,"67.19.72.206",80,3,186,3,186,0,0,85210.757471,9.021737000002759,164.93497870748672,0
"147.32.84.165",1361,"174.128.246.102",80,3,186,3,186,0,0,85210.760665,9.018565999998827,164.99297116639093,0
"147.32.84.165",1363,"67.19.72.206",80,3,186,3,186,0,0,85210.763855,9.015396999995573,165.05096780549215,0
"147.32.84.165",1364,"174.37.196.55",80,3,186,3,186,0,0,85210.804653,8.974625000002561,165.80079947625393,0
"147.32.84.165",1365,"193.23.181.44",179,3,186,3,186,0,0,85210.807855,8.971445999995922,165.8595504003119,0
"147.32.84.165",1366,"193.23.181.44",179,3,186,3,186,0,0,85211.049919,9.030373000001418,164.77724674271664,0
"147.32.84.165",1367,"174.37.196.55",80,3,186,3,186,0,0,85211.150966,9.028753999999026,164.80679393858338,0
"147.32.84.165",1368,"174.37.196.55",80,3,186,3,186,0,0,85211.250651,9.030244000008679,164.77960063964716,0
"147.32.84.165",1369,"193.23.181.44",80,3,186,3,186,0,0,85211.250828,9.030087999999523,164.78244730284783,0
"147.32.84.165",1370,"174.37.196.55",80,3,186,3,186,0,0,85211.251024,9.029919000007794,164.7855312986435,0
"147.32.84.165",1372,"193.23.181.44",80,3,186,3,186,0,0,85211.35184,9.02927099999215,164.7973573947768,0
"147.32.84.165",1371,"174.128.246.102",80,8,632,5,450,3,182,85211.352078,3.325129000004381,1082.6647627792056,437.877748501812
"147.32.84.165",1373,"174.128.246.102",80,10,785,6,543,4,242,85211.352331,9.356826000002911,464.2599958574252,206.90776979281196
"147.32.84.165",1374,"193.23.181.44",80,3,186,3,186,0,0,85211.451663,9.029794000001857,164.78781243511136,0
"147.32.84.165",1376,"72.20.15.61",80,3,186,3,186,0,0,85211.508658,8.972819999995409,165.83415247388908,0
"147.32.84.165",1377,"212.117.171.138",65500,8,484,4,242,4,242,85211.595097,0.1978650000091875,9784.448992545955,9784.448992545955
"147.32.84.165",1378,"72.20.15.61",80,3,186,3,186,0,0,85211.651991,9.029960999992909,164.78476485127328,0
"147.32.84.165",1380,"174.37.196.55",80,3,186,3,186,0,0,85211.753583,9.028455000006943,164.81225193002078,0
"147.32.84.165",1379,"174.37.196.55",80,3,186,3,186,0,0,85211.753803,9.028281999999308,164.8154100636327,0
"147.32.84.165",1381,"174.37.196.55",80,3,186,3,186,0,0,85211.754098,9.02803399998811,164.81993754143588,0
"147.32.84.165",1382,"174.37.196.55",80,3,186,3,186,0,0,85211.754786,9.027389999988372,164.8316955401192,0
"147.32.84.165",1383,"67.19.72.206",80,3,186,3,186,0,0,85211.757984,9.024243000007118,164.8891768538177,0
"147.32.84.165",1384,"174.128.246.102",80,3,186,3,186,0,0,85211.761203,9.021070999995572,164.94715538772837,0
"147.32.84.165",1385,"193.23.181.44",179,3,186,3,186,0,0,85211.764384,9.017938000004506,165.0044611084326,0
"147.32.84.165",1387,"212.117.171.138",65500,8,484,4,242,4,242,85211.862995,4.102079999996931,471.9556907718641,471.9556907718641
"147.32.84.165",1388,"174.128.246.102",80,9,728,6,546,3,182,85212.054994,9.353585999997449,466.9866722774764,155.66222409249212
"147.32.84.165",1389,"72.20.15.61",80,3,186,3,186,0,0,85212.055299,9.02763500000583,164.82722219042296,0
"147.32.84.165",1390,"193.23.181.44",80,3,186,3,186,0,0,85213.056092,9.03100099999574,164.76578842153842,0
"147.32.84.165",1391,"193.23.181.44",80,3,186,3,186,0,0,85213.156168,9.030297000004794,164.77863352658392,0
"147.32.84.165",1392,"174.37.196.55",80,3,186,3,186,0,0,85213.314769,8.97286599999643,165.83330231395323,0
"147.32.84.165",1393,"72.20.15.61",80,3,186,3,186,0,0,85213.758408,9.029967000009492,164.78465535903243,0
"147.32.84.165",1394,"72.20.15.61",80,3,186,3,186,0,0,85214.51943,8.97107600000163,165.8663910549559,0
"147.32.84.165",1395,"193.23.181.44",80,3,186,3,186,0,0,85215.729243,8.967537000004086,165.93184951445664,0
"147.32.84.165",1396,"184.82.148.43",80,10,1899,5,979,5,920,85215.921444,0.3669929999887245,21341.006504866935,20054.878431539917
"147.32.84.165",1398,"212.117.171.138",65500,29,20664,16,962,13,19702,85216.042768,0.7234750000061467,10637.547945588463,217859.63578376707
"147.32.84.165",1399,"193.23.181.44",179,3,186,3,186,0,0,85216.17005,8.92784400000528,166.6695789038339,0
"147.32.84.165",1400,"184.82.148.44",80,10,1476,5,581,5,895,85216.179646,0.4263409999985015,10902.071346683375,16794.068597730846
"147.32.84.165",1401,"193.23.181.44",80,3,186,3,186,0,0,85216.282028,8.914827000000514,166.91294177665077,0
"147.32.84.165",1402,"193.23.181.44",179,3,186,3,186,0,0,85216.285247,8.911719999989145,166.9711346408788,0
"147.32.84.165",1403,"193.23.181.44",179,3,186,3,186,0,0,85216.308851,8.888151000006474,167.4138974460398,0
"147.32.84.165",1404,"217.163.21.35",80,16,7417,8,2050,8,5367,85216.511441,0.2580030000099214,63565.152340745444,166416.66956721013
"147.32.84.165",1406,"217.163.21.35",80,13,4597,7,1993,6,2604,85216.711506,0.4431589999876451,35978.057537914174,47007.95877005946
"147.32.84.165",1407,"72.20.15.61",80,3,186,3,186,0,0,85216.742352,8.956734999999753,166.13196661507135,0
"147.32.84.165",1408,"174.128.246.102",80,3,186,3,186,0,0,85216.759844,8.939303000006475,166.45593062444826,0
"147.32.84.165",1409,"174.37.196.55",80,3,186,3,186,0,0,85216.953844,8.845304000002216,168.22485694099686,0
"147.32.84.165",1410,"212.117.171.138",65500,8,484,4,242,4,242,85216.957044,1.8797259999992093,1029.9373419321828,1029.9373419321828
"147.32.84.165",1412,"174.128.246.102",80,3,186,3,186,0,0,85217.27052,8.930438999988837,166.62114818788416,0
"147.32.84.165",1413,"193.23.181.44",80,3,186,3,186,0,0,85217.356668,8.94387300001108,166.37087758269337,0
"147.32.84.165",1414,"174.37.196.55",80,3,186,3,186,0,0,85217.427045,8.97447000000102,165.80366305752105,0
"147.32.84.165",1415,"174.128.246.102",80,3,186,3,186,0,0,85217.491072,9.010337999992771,165.14363834089175,0
"147.32.84.165",1416,"178.122.240.223",6667,2,124,2,124,0,0,85217.630595,2.9507339999981923,336.1875384228493,0
"147.32.84.165",1417,"193.23.181.44",80,3,186,3,186,0,0,85217.773742,9.028874999989057,164.80458528906465,0
"147.32.84.165",1418,"193.23.181.44",80,3,186,3,186,0,0,85217.774022,9.02865500000189,164.80860105959175,0
"147.32.84.165",1419,"193.23.181.44",80,3,186,3,186,0,0,85217.833982,8.968716000003042,165.91003662057037,0
"147.32.84.165",1421,"212.117.171.138",65500,8,484,4,242,4,242,85218.905234,2.2356789999903413,865.956159184017,865.956159184017
"147.32.84.165",1422,"72.20.15.61",80,3,186,3,186,0,0,85219.277585,8.998263999994379,165.36523044899877,0
"147.32.84.165",1423,"67.19.72.206",80,3,186,3,186,0,0,85219.335279,8.94377899999381,166.37262615735807,0
"147.32.84.165",1424,"193.23.181.44",179,3,186,3,186,0,0,85219.834565,8.873910000009346,167.682566083996,0
"147.32.84.165",1425,"174.128.246.102",80,8,610,5,428,3,182,85220.546176,3.2739290000026813,1045.8381962459162,444.7255881232634
"147.32.84.165",1426,"174.37.196.55",80,3,186,3,186,0,0,85220.882569,8.929691000012099,166.63510529065158,0
"147.32.84.165",1428,"212.117.171.138",65500,8,484,4,242,4,242,85221.218937,4.6886519999970915,412.9118561158305,412.9118561158305
"147.32.84.165",1429,"193.23.181.44",80,3,186,3,186,0,0,85221.24667,8.866543000011006,167.82188954569475,0
"147.32.84.165",1430,"72.20.15.61",80,3,186,3,186,0,0,85223.655982,8.879224000003887,167.58221213918566,0
"147.32.84.165",1431,"184.82.148.43",80,10,1919,5,979,5,940,85224.153982,0.3047109999897657,25703.043212299697,24679.122185456297
"147.32.84.165",1432,"184.82.148.44",80,10,1514,5,596,5,918,85224.361985,0.30327499999839347,15721.704723519108,24215.645866091512
"147.32.84.165",1433,"217.163.21.36",80,14,6141,7,810,7,5331,85224.576673,0.1871699999901466,34620.932843624156,227857.02838192642
"147.32.84.165",1434,"217.163.21.36",80,10,1451,5,701,5,750,85224.722025,0.13939500000560656,40230.99824078656,43043.15075690431
"147.32.84.165",1435,"217.163.21.35",80,13,4971,7,2036,6,2935,85224.815913,0.26995800000440795,60335.311417828125,86976.49263817561
"147.32.84.165",1436,"193.23.181.44",179,3,186,3,186,0,0,85225.098136,8.928272000004654,166.6615891629673,0
"147.32.84.165",1437,"72.20.15.61",80,8,662,5,480,3,182,85225.098316,3.341809999998077,1149.077894913897,435.6920351548526
"147.32.84.165",1438,"174.128.246.102",80,8,622,4,380,4,242,85225.799505,0.32591499999398366,9327.585413546838,5940.1991317850925
"147.32.84.165",1439,"67.19.72.206",80,3,186,3,186,0,0,85225.799642,8.929633000007016,166.63618762370535,0
"147.32.84.165",1440,"174.37.196.55",80,3,186,3,186,0,0,85225.799771,8.929533999995328,166.63803508680056,0
"147.32.84.165",1442,"174.37.196.55",80,3,186,3,186,0,0,85225.899851,8.928878999999142,166.650259231886,0
"147.32.84.165",1443,"174.128.246.102",80,3,186,3,186,0,0,85225.900031,8.928836000006413,166.65106179561718,0
"147.32.84.165",1444,"174.128.246.102",80,3,186,3,186,0,0,85225.9663,8.86262899999565,167.8960046731879,0
"147.32.84.165",1445,"212.117.171.138",65500,14,869,8,486,6,383,85225.985878,273.85525499998766,14.197280968737209,11.188392203757923
"147.32.84.165",1446,"174.128.246.102",80,3,186,3,186,0,0,85226.000619,8.929275000002235,166.64286854191718,0
"147.32.84.165",1447,"67.19.72.206",80,3,186,3,186,0,0,85226.000827,8.929157000005944,166.64507074956902,0
"147.32.84.165",1448,"72.20.15.61",80,3,186,3,186,0,0,85226.300931,8.929388999997173,166.64074104067717,0
"147.32.84.165",1449,"67.19.72.206",80,3,186,3,186,0,0,85226.401741,8.929284000012558,166.6427005791178,0
"147.32.84.165",1450,"72.20.15.61",80,3,186,3,186,0,0,85226.501816,8.928925000000163,166.64940068372988,0
"147.32.84.165",1452,"174.128.246.102",80,3,186,3,186,0,0,85226.80301,9.029722999999649,164.78910814872813,0
"147.32.84.165",1453,"67.19.72.206",80,3,186,3,186,0,0,85226.803229,9.02956300000369,164.79202814127237,0
"147.32.84.165",1454,"174.128.246.102",80,3,186,3,186,0,0,85226.803381,9.029431999995722,164.79441896242255,0
"147.32.84.165",1455,"193.23.181.44",80,3,186,3,186,0,0,85226.902854,9.029758999997284,164.78845116469304,0
"147.32.84.165",1456,"72.20.15.61",80,3,186,3,186,0,0,85226.903131,9.029607000004034,164.79122513298034,0
"147.32.84.165",1457,"98.126.71.122",80,12,4202,7,715,5,3487,85226.956739,16.1104090000008,355.04995559080567,1731.5513218813137
"147.32.84.165",1458,"174.37.196.55",80,3,186,3,186,0,0,85227.003414,9.029853999993065,164.78671748193744,0
"147.32.84.165",1459,"195.113.232.83",80,10,6556,7,686,3,5870,85227.561513,19.32353600001079,284.00599144985347,2430.1970405402913
"147.32.84.165",1460,"218.241.209.6",6667,2,124,2,124,0,0,85227.632116,2.982300000003306,332.62917882134604,0
"147.32.84.165",1461,"95.100.248.96",80,11,4527,6,1280,5,3247,85227.768569,19.116573999999673,535.660835461426,1358.8208849556643
"147.32.84.165",1462,"174.128.246.102",80,8,681,5,499,3,182,85227.906561,3.373399000003701,1183.3761734071838,431.612151423061
"147.32.84.165",1464,"193.23.181.44",80,3,186,3,186,0,0,85227.90712,9.028600999998162,164.8095867787604,0
"147.32.84.165",1463,"193.23.181.44",179,3,186,3,186,0,0,85227.907229,9.02856299999985,164.81028043997975,0
"147.32.84.165",1465,"72.20.15.61",80,7,573,4,391,3,182,85227.907347,0.37758499999472406,8284.227392623401,3856.0853848016854
"147.32.84.165",1466,"72.20.15.61",80,3,186,3,186,0,0,85227.907473,9.028344000005745,164.81427823297972,0
"147.32.84.165",1467,"67.19.72.206",80,3,186,3,186,0,0,85227.907607,9.028235000005225,164.81626807445076,0
"147.32.84.165",1468,"193.23.181.44",80,3,186,3,186,0,0,85227.907742,9.028124000004027,164.8182944761654,0
"147.32.84.165",1469,"193.23.181.44",80,3,186,3,186,0,0,85227.907919,9.02797099998861,164.8210877064046,0
"147.32.84.165",1470,"193.23.181.44",80,3,186,3,186,0,0,85227.908129,9.027784999998403,164.82448352505773,0
"147.32.84.165",1471,"193.23.181.44",80,3,186,3,186,0,0,85227.908308,9.027631000004476,164.82729522277353,0
"147.32.84.165",1472,"67.19.72.206",80,3,186,3,186,0,0,85227.908435,9.02752899999905,164.8291575690487,0
"147.32.84.165",1473,"193.23.181.44",80,3,186,3,186,0,0,85227.908557,9.027430000001914,164.8309651805314,0
"147.32.84.165",1474,"193.23.181.44",179,3,186,3,186,0,0,85228.007468,9.028699000002234,164.80779788977702,0
"147.32.84.165",1475,"174.37.196.55",80,3,186,3,186,0,0,85228.007647,9.028568999987328,164.81017091435956,0
"147.32.84.165",1477,"174.128.246.102",80,3,186,3,186,0,0,85228.009848,9.026415999993333,164.8494817877992,0
"147.32.84.165",1476,"67.19.72.206",80,3,186,3,186,0,0,85228.010181,9.026130999991437,164.85468690864465,0
"147.32.84.165",1478,"72.20.15.61",80,3,186,3,186,0,0,85228.01147,9.024889000007533,164.87737411493458,0
"147.32.84.165",1479,"193.23.181.44",179,3,186,3,186,0,0,85228.011735,9.024672000014107,164.88133862346177,0
"147.32.84.165",1480,"174.37.196.55",80,3,186,3,186,0,0,85228.011913,9.024541000006138,164.88373203678591,0
"147.32.84.165",1481,"72.20.15.61",80,8,623,5,441,3,182,85228.012089,3.454447000010987,1021.2922647210332,421.48569655153756
"147.32.84.165",1482,"72.20.15.61",80,3,186,3,186,0,0,85228.012265,9.024235999997472,164.8893047567037,0
"147.32.84.165",1483,"193.23.181.44",80,3,186,3,186,0,0,85228.01244,9.024107999997796,164.89164358409312,0
"147.32.84.165",1484,"174.128.246.102",80,3,186,3,186,0,0,85228.012615,9.023981999998796,164.893945932095,0
"147.32.84.165",1485,"174.128.246.102",80,3,186,3,186,0,0,85228.012787,9.023872999998275,164.89593769773626,0
"147.32.84.165",1486,"174.37.196.55",80,3,186,3,186,0,0,85228.012964,9.023744000005536,164.89829498699066,0
"147.32.84.165",1487,"174.37.196.55",80,3,186,3,186,0,0,85228.013137,9.023617999991984,164.90059752100785,0
"147.32.84.165",1488,"72.20.15.61",80,3,186,3,186,0,0,85228.013311,9.023489999992307,164.9029366687688,0
"147.32.84.165",1489,"193.23.181.44",179,3,186,3,186,0,0,85228.013486,9.023362000007182,164.9052758826273,0
"147.32.84.165",1490,"193.23.181.44",80,3,186,3,186,0,0,85228.013669,9.02322699999786,164.90774309461048,0
"147.32.84.165",1491,"72.20.15.61",80,8,652,5,470,3,182,85228.013844,3.4689780000044266,1083.89271998704,419.7201596545559
"147.32.84.165",1492,"193.23.181.44",80,3,186,3,186,0,0,85228.014111,9.022832000002381,164.91496239757177,0
"147.32.84.165",1493,"67.19.72.206",80,3,186,3,186,0,0,85228.014289,9.022699000008288,164.91739334301556,0
"147.32.84.165",1494,"174.128.246.102",80,6,509,4,387,2,122,85228.014463,0.3784670000022743,8180.369754777551,2578.8245738575224
"147.32.84.165",1495,"67.19.72.206",80,3,186,3,186,0,0,85228.014638,9.022397000007913,164.9229135005581,0
"147.32.84.165",1496,"174.37.196.55",80,3,186,3,186,0,0,85228.01481,9.022271000008914,164.92521672187965,0
"147.32.84.165",1497,"174.37.196.55",80,3,186,3,186,0,0,85228.015051,9.022077000001445,164.92876307747778,0
"147.32.84.165",1498,"67.19.72.206",80,3,186,3,186,0,0,85228.015231,9.021945000000414,164.9311761488162,0
"147.32.84.165",1499,"193.23.181.44",80,3,186,3,186,0,0,85228.015406,9.021817000000738,164.9335161641916,0
"147.32.84.165",1500,"72.20.15.61",80,3,186,3,186,0,0,85228.015848,9.021422999998322,164.94071944085505,0
"147.32.84.165",1501,"174.128.246.102",80,6,488,4,366,2,122,85228.019048,0.3897869999927934,7511.794903509184,2503.9316345030616
"147.32.84.165",1502,"174.128.246.102",80,9,701,5,459,4,242,85228.022248,3.388793000005535,1083.5716433532536,571.2948533583603
"147.32.84.165",1503,"174.128.246.102",80,3,186,3,186,0,0,85228.025448,9.01187000000209,165.11556425022275,0
"147.32.84.165",1504,"193.23.181.44",179,3,186,3,186,0,0,85228.028678,9.010588999997708,165.13903808068247,0
"147.32.84.165",1505,"174.128.246.102",80,3,186,3,186,0,0,85228.031876,9.010596000007354,165.13890979007223,0
"147.32.84.165",1506,"174.128.246.102",80,9,700,5,458,4,242,85228.035098,3.3956120000075316,1079.0396547049172,570.1475904772707
"147.32.84.165",1507,"67.19.72.206",80,3,186,3,186,0,0,85228.038249,9.0074159999931,165.19721083173465,0
"147.32.84.165",1508,"193.23.181.44",80,3,186,3,186,0,0,85228.041478,9.007372000007308,165.19801780128464,0
"147.32.84.165",1509,"72.20.15.61",80,3,186,3,186,0,0,85228.0447,9.007349000006798,165.19843962955994,0
"147.32.84.165",1510,"193.23.181.44",179,3,186,3,186,0,0,85228.047898,9.007350999992923,165.1984029490101,0
"147.32.84.165",1511,"67.19.72.206",80,3,186,3,186,0,0,85228.051094,9.007372000007308,165.19801780128464,0
"147.32.84.165",1512,"174.128.246.102",80,3,186,3,186,0,0,85228.054317,9.007352000000537,165.1983846084744,0
"147.32.84.165",1513,"174.128.246.102",80,3,186,3,186,0,0,85228.057498,9.007399000009173,165.19752261429574,0
"147.32.84.165",1514,"193.23.181.44",179,3,186,3,186,0,0,85228.060698,9.007368999999017,165.1980728223927,0
"147.32.84.165",1515,"174.128.246.102",80,3,186,3,186,0,0,85228.063898,9.007366000005277,165.19812784327053,0
"147.32.84.165",1516,"72.20.15.61",80,3,186,3,186,0,0,85228.067048,9.007404999996652,165.19741257338302,0
"147.32.84.165",1517,"174.128.246.102",80,3,186,3,186,0,0,85228.070248,9.007426999989548,165.197009090579,0
"147.32.84.165",1518,"193.23.181.44",80,3,186,3,186,0,0,85228.07348,9.00738999999885,165.19768767647344,0
"147.32.84.165",1519,"174.128.246.102",80,3,186,3,186,0,0,85228.07668,9.007385000004433,165.19777937761822,0
"147.32.84.165",1520,"174.37.196.55",80,3,186,3,186,0,0,85228.079877,9.007389000005787,165.1977060165875,0
"147.32.84.165",1521,"174.128.246.102",80,9,706,6,524,3,182,85228.083098,9.395386000003782,446.1764529949395,154.96968405549424
"147.32.84.165",1522,"174.128.246.102",80,3,186,3,186,0,0,85228.086296,9.007398000001558,165.19754095464003,0
"147.32.84.165",1524,"67.19.72.206",80,3,186,3,186,0,0,85228.089474,9.007420000009006,165.19713747094198,0
"147.32.84.165",1523,"193.23.181.44",80,3,186,3,186,0,0,85228.092648,9.007428999990225,165.19697241039756,0
"147.32.84.165",1525,"193.23.181.44",80,3,186,3,186,0,0,85228.11625,8.987026999995578,165.57199616744583,0
"147.32.84.165",1526,"72.20.15.61",80,3,186,3,186,0,0,85228.119452,9.017577000005986,165.0110667199196,0
"147.32.84.165",1527,"193.23.181.44",179,3,186,3,186,0,0,85228.122668,9.014383000001544,165.06953387711008,0
"147.32.84.165",1528,"193.23.181.44",179,3,186,3,186,0,0,85228.125849,9.011224999994738,165.12738279211416,0
"147.32.84.165",1529,"193.23.181.44",80,3,186,3,186,0,0,85228.129052,9.008042000001296,165.18573070593874,0
"147.32.84.165",1530,"174.37.196.55",80,3,186,3,186,0,0,85228.132296,9.00481800000125,165.2448722450352,0
"147.32.84.165",1532,"174.128.246.102",80,9,684,5,442,4,242,85228.135449,3.4571410000062315,1022.8104667971675,560.0003008255985
"147.32.84.165",1531,"193.23.181.44",80,3,186,3,186,0,0,85228.138666,8.99847000000591,165.36144477883715,0
"147.32.84.165",1533,"67.19.72.206",80,3,186,3,186,0,0,85228.141864,8.995295000000624,165.41981113458723,0
"147.32.84.165",1534,"174.128.246.102",80,3,186,3,186,0,0,85228.145096,8.992086000012932,165.47884439693524,0
"147.32.84.165",1535,"67.19.72.206",80,3,186,3,186,0,0,85228.148306,8.99014100000204,165.5146454321086,0
"147.32.84.165",1536,"174.37.196.55",80,3,186,3,186,0,0,85228.151499,8.990147999997134,165.514516557511,0
"147.32.84.165",1537,"67.19.72.206",80,3,186,3,186,0,0,85228.1547,8.990147000004072,165.5145349680407,0
"147.32.84.165",1538,"174.37.196.55",80,3,186,3,186,0,0,85228.157882,8.990164999995613,165.51420357698953,0
"147.32.84.165",1539,"72.20.15.61",80,3,186,3,186,0,0,85228.161096,8.990151000005426,165.51446132541065,0
"147.32.84.165",1540,"193.23.181.44",179,3,186,3,186,0,0,85228.164309,8.990137999993749,165.5147006643318,0
"147.32.84.165",1541,"193.23.181.44",179,3,186,3,186,0,0,85228.167506,8.99014100000204,165.5146454321086,0
"147.32.84.165",1542,"72.20.15.61",80,3,186,3,186,0,0,85228.170698,8.990149000004749,165.51449814671747,0
"147.32.84.165",1543,"193.23.181.44",80,3,186,3,186,0,0,85228.173895,8.990151999998488,165.51444291489733,0
"147.32.84.165",1544,"174.37.196.55",80,3,186,3,186,0,0,85228.177067,8.990180000007967,165.5139274184367,0
"147.32.84.165",1545,"174.128.246.102",80,3,186,3,186,0,0,85228.180267,8.990179999993416,165.5139274187046,0
"147.32.84.165",1546,"193.23.181.44",179,3,186,3,186,0,0,85228.183469,8.99017800000729,165.51396423950598,0
"147.32.84.165",1547,"72.20.15.61",80,3,186,3,186,0,0,85228.18665,8.99019799999951,165.5135960298184,0
"147.32.84.165",1548,"193.23.181.44",179,3,186,3,186,0,0,85228.18985,8.990200000000186,165.51355920891294,0
"147.32.84.165",1549,"193.23.181.44",179,3,186,3,186,0,0,85228.193069,8.990179999993416,165.5139274187046,0
"147.32.84.165",1550,"72.20.15.61",80,3,186,3,186,0,0,85228.196266,8.990181999994093,165.5138905976517,0
"147.32.84.165",1551,"174.128.246.102",80,3,186,3,186,0,0,85228.199468,8.990202000000863,165.5135223880239,0
"147.32.84.165",1552,"193.23.181.44",80,3,186,3,186,0,0,85228.202693,8.990180000007967,165.5139274184367,0
"147.32.84.165",1553,"193.23.181.44",179,3,186,3,186,0,0,85228.205867,8.990205000009155,165.51346715658707,0
"147.32.84.165",1554,"174.128.246.102",80,3,186,3,186,0,0,85228.20905,8.990212999997311,165.51331987356085,0
"147.32.84.165",1555,"174.128.246.102",80,3,186,3,186,0,0,85228.21225,8.990226000008988,165.513080538633,0
"147.32.84.165",1556,"174.37.196.55",80,3,186,3,186,0,0,85228.232256,8.97343600000022,165.82276844677597,0
"147.32.84.165",1557,"193.23.181.44",80,3,186,3,186,0,0,85228.251049,8.957848999998532,166.1113064085188,0
"147.32.84.165",1558,"193.23.181.44",80,3,186,3,186,0,0,85228.272646,8.939450000005309,166.4531934290271,0
"147.32.84.165",1559,"72.20.15.61",80,3,186,3,186,0,0,85228.28228,8.954370000006747,166.17584486668284,0
"147.32.84.165",1560,"193.23.181.44",179,3,186,3,186,0,0,85228.285481,8.951190000007045,166.23488050179125,0
"147.32.84.165",1561,"193.23.181.44",179,3,186,3,186,0,0,85228.288683,8.948014999987208,166.29386517592195,0
"147.32.84.165",1562,"72.20.15.61",80,3,186,3,186,0,0,85228.291848,8.94579800000065,166.33507709428403,0
"147.32.84.165",1563,"193.23.181.44",179,3,186,3,186,0,0,85228.295047,8.945819999993546,166.33466803502347,0
"147.32.84.165",1564,"193.23.181.44",179,3,186,3,186,0,0,85228.298248,8.945816999999806,166.33472381561486,0
"147.32.84.165",1565,"174.128.246.102",80,3,186,3,186,0,0,85228.301456,8.945842999994056,166.33424038416376,0
"147.32.84.165",1566,"67.19.72.206",80,3,186,3,186,0,0,85228.304666,8.945847000009962,166.33416601003157,0
"147.32.84.165",1567,"193.23.181.44",179,3,186,3,186,0,0,85228.307868,8.945829999996931,166.33448209953804,0
"147.32.84.165",1569,"193.23.181.44",80,3,186,3,186,0,0,85228.311099,8.945747000005213,166.33602537598404,0
"147.32.84.165",1570,"174.37.196.55",80,3,186,3,186,0,0,85228.314296,8.945768000005046,166.33563490570745,0
"147.32.84.165",1571,"72.20.15.61",80,3,186,3,186,0,0,85228.317513,8.945745999997598,166.33604396999417,0
"147.32.84.165",1568,"174.128.246.102",80,3,186,3,186,0,0,85228.3207,8.945764999996754,166.3356906872179,0
"147.32.84.165",1573,"193.23.181.44",179,3,186,3,186,0,0,85228.323902,8.945771999991848,166.33556053086932,0
"147.32.84.165",1574,"174.128.246.102",80,3,186,3,186,0,0,85228.327098,8.94574900000589,166.33598818824677,0
"147.32.84.165",1572,"67.19.72.206",80,3,186,3,186,0,0,85228.33027,8.94577500000014,166.33550474944616,0
"147.32.84.165",1575,"67.19.72.206",80,3,186,3,186,0,0,85228.33347,8.945781000002171,166.33539318698266,0
"147.32.84.165",1576,"193.23.181.44",80,3,186,3,186,0,0,85228.336696,8.945754000000306,166.33589521911165,0
"147.32.84.165",1577,"174.37.196.55",80,3,186,3,186,0,0,85228.33987,8.945780000009108,166.3354117805809,0
"147.32.84.165",1578,"174.37.196.55",80,3,186,3,186,0,0,85228.343067,8.945783000002848,166.33535599952808,0
"147.32.84.165",1580,"67.19.72.206",80,3,186,3,186,0,0,85228.346293,8.945754000000306,166.33589521911165,0
"147.32.84.165",1579,"193.23.181.44",179,3,186,3,186,0,0,85228.349448,8.945799000008265,166.33505850049005,0
"147.32.84.165",1581,"67.19.72.206",80,3,186,3,186,0,0,85228.352649,8.98493600000802,165.61052855564824,0
"147.32.84.165",1582,"174.128.246.102",80,3,186,3,186,0,0,85228.412967,9.024470999996993,164.88501098851066,0
"147.32.84.165",1583,"67.19.72.206",80,3,186,3,186,0,0,85228.414238,9.023321000000578,164.90602517630754,0
"147.32.84.165",1584,"67.19.72.206",80,3,186,3,186,0,0,85228.41463,9.0229779999936,164.91229392347574,0
"147.32.84.165",1585,"193.23.181.44",80,3,186,3,186,0,0,85228.415039,9.022618000002694,164.91887387890694,0
"147.32.84.165",1586,"193.23.181.44",179,3,186,3,186,0,0,85228.415258,9.022445000009611,164.922036099795,0
"147.32.84.165",1587,"67.19.72.206",80,3,186,3,186,0,0,85228.415524,9.022226000000956,164.92603931666557,0
"147.32.84.165",1588,"67.19.72.206",80,3,186,3,186,0,0,85228.417645,9.020155999998678,164.96388754254562,0
"147.32.84.165",1590,"174.37.196.55",80,3,186,3,186,0,0,85228.437755,9.000093999988167,165.33160653677132,0
"147.32.84.165",1591,"174.37.196.55",80,3,186,3,186,0,0,85228.437869,9.000027000001865,165.3328373347871,0
"147.32.84.165",1589,"174.128.246.102",80,3,186,3,186,0,0,85228.43798,8.999971999990521,165.3338477054781,0
"147.32.84.165",1592,"67.19.72.206",80,3,186,3,186,0,0,85228.510085,9.027999999991152,164.82055826334275,0
"147.32.84.165",1593,"174.37.196.55",80,3,186,3,186,0,0,85228.510552,9.027592999991612,164.82798903333176,0
"147.32.84.165",1594,"193.23.181.44",80,3,186,3,186,0,0,85228.511594,9.02657800000452,164.8465232338606,0
"147.32.84.165",1595,"174.128.246.102",80,3,186,3,186,0,0,85228.511813,9.026381999996374,164.85010273225726,0
"147.32.84.165",1596,"174.128.246.102",80,3,186,3,186,0,0,85228.512029,9.02618899999652,164.85362759416776,0
"147.32.84.165",1597,"174.37.196.55",80,3,186,3,186,0,0,85228.51231,9.025929999988875,164.85835808629514,0
"147.32.84.165",1598,"193.23.181.44",179,3,186,3,186,0,0,85228.512529,9.025735000002896,164.86191983251476,0
"147.32.84.165",1599,"193.23.181.44",80,3,186,3,186,0,0,85228.512934,9.025353000004543,164.8688976485741,0
"147.32.84.165",1600,"67.19.72.206",80,3,186,3,186,0,0,85228.513151,9.025159999990137,164.8724233145591,0
"147.32.84.165",1601,"174.128.246.102",80,3,186,3,186,0,0,85228.513366,9.024967999997898,164.87593086206473,0
"147.32.84.165",1602,"193.23.181.44",80,3,186,3,186,0,0,85228.513584,9.024774000004982,164.879475098122,0
"147.32.84.165",1603,"193.23.181.44",179,3,186,3,186,0,0,85228.513801,9.024580000012065,164.883019486559,0
"147.32.84.165",1604,"174.37.196.55",80,3,186,3,186,0,0,85228.514019,9.024386000004597,164.88656402765153,0
"147.32.84.165",1605,"174.37.196.55",80,3,186,3,186,0,0,85228.514233,9.024202000000514,164.88992600120378,0
"147.32.84.165",1606,"193.23.181.44",80,3,186,3,186,0,0,85228.5145,9.023963999992702,164.8942748443149,0
"147.32.84.165",1607,"174.128.246.102",80,3,186,3,186,0,0,85228.514717,9.023776000001817,164.8977102268164,0
"147.32.84.165",1608,"67.19.72.206",80,3,186,3,186,0,0,85228.514932,9.023592999990797,164.90105438061286,0
"147.32.84.165",1609,"72.20.15.61",80,3,186,3,186,0,0,85228.515151,9.023392000002787,164.90472762344143,0
"147.32.84.165",1610,"193.23.181.44",179,3,186,3,186,0,0,85228.515368,9.023203000004287,164.90818171765537,0
"147.32.84.165",1611,"174.37.196.55",80,3,186,3,186,0,0,85228.515583,9.023016999999527,164.91158112636583,0
"147.32.84.165",1612,"174.37.196.55",80,3,186,3,186,0,0,85228.515801,9.022828000001027,164.91503550769565,0
"147.32.84.165",1613,"193.23.181.44",80,3,186,3,186,0,0,85228.516017,9.02263999999559,164.91847175557567,0
"147.32.84.165",1614,"174.37.196.55",80,3,186,3,186,0,0,85228.516233,9.022452000004705,164.92190814639125,0
"147.32.84.165",1615,"72.20.15.61",80,3,186,3,186,0,0,85228.516499,9.022213999996893,164.92625867669648,0
"147.32.84.165",1616,"193.23.181.44",179,3,186,3,186,0,0,85228.516741,9.022012000001268,164.92995132347318,0
"147.32.84.165",1617,"67.19.72.206",80,3,186,3,186,0,0,85228.516957,9.021825999996508,164.93335162976717,0
"147.32.84.165",1618,"193.23.181.44",80,3,186,3,186,0,0,85228.517228,9.024061000003712,164.89250238882337,0
"147.32.84.165",1619,"193.23.181.44",179,3,186,3,186,0,0,85228.608635,9.02941699999792,164.79469272493924,0
"147.32.84.165",1620,"193.23.181.44",179,3,186,3,186,0,0,85228.609038,9.029141000006348,164.79973011817557,0
"147.32.84.165",1621,"174.128.246.102",80,3,186,3,186,0,0,85228.609398,9.028837999998359,164.80526065483403,0
"147.32.84.165",1622,"174.37.196.55",80,8,653,5,471,3,182,85228.609915,3.2630430000135675,1154.750335801377,446.20925926932193
"147.32.84.165",1623,"174.37.196.55",80,8,661,5,479,3,182,85228.610269,3.276983999996446,1169.3679310012365,444.3109883971295
"147.32.84.165",1624,"174.128.246.102",80,3,186,3,186,0,0,85228.708755,9.029796000002534,164.7877759364201,0
"147.32.84.165",1625,"72.20.15.61",80,3,186,3,186,0,0,85228.711202,9.027377999998862,164.83191464899195,0
"147.32.84.165",1626,"174.128.246.102",80,3,186,3,186,0,0,85228.712731,9.025878999993438,164.85928960504364,0
"147.32.84.165",1627,"72.20.15.61",80,3,186,3,186,0,0,85228.712978,9.025659999999334,164.8632897760507,0
"147.32.84.165",1628,"174.128.246.102",80,3,186,3,186,0,0,85228.713346,9.025318999993033,164.8695187395757,0
"147.32.84.165",1629,"174.37.196.55",80,3,186,3,186,0,0,85228.713579,9.025114000003668,164.8732636506747,0
"147.32.84.165",1630,"72.20.15.61",80,3,186,3,186,0,0,85228.713805,9.024914999987232,164.8768991178427,0
"147.32.84.165",1631,"67.19.72.206",80,3,186,3,186,0,0,85228.71403,9.024716999992961,164.88051647504963,0
"147.32.84.165",1632,"174.37.196.55",80,3,186,3,186,0,0,85228.714264,9.02451000000292,164.88429842722968,0
"147.32.84.165",1633,"174.37.196.55",80,3,186,3,186,0,0,85228.714489,9.024316999988514,164.88782475193346,0
"147.32.84.165",1634,"193.23.181.44",80,3,186,3,186,0,0,85228.714714,9.024113999999827,164.8915339500397,0
"147.32.84.165",1635,"174.37.196.55",80,3,186,3,186,0,0,85228.714946,9.023909000010462,164.89527986134112,0
"147.32.84.165",1636,"174.128.246.102",80,3,186,3,186,0,0,85228.71517,9.023714000009932,164.89884320340408,0
"147.32.84.165",1637,"193.23.181.44",80,3,186,3,186,0,0,85228.715395,9.023516999994172,164.9024432492299,0
"147.32.84.165",1638,"72.20.15.61",80,3,186,3,186,0,0,85228.715678,9.023262000002433,164.907103439931,0
"147.32.84.165",1639,"174.37.196.55",80,3,186,3,186,0,0,85228.715907,9.02314999999362,164.90915035226635,0
"147.32.84.165",1640,"72.20.15.61",80,3,186,3,186,0,0,85228.716133,9.022982000009506,164.9122208155167,0
"147.32.84.165",1641,"193.23.181.44",80,3,186,3,186,0,0,85228.716361,9.022809000001871,164.91538278153638,0
"147.32.84.165",1642,"193.23.181.44",179,3,186,3,186,0,0,85228.71659,9.022634000008111,164.9185814251872,0
"147.32.84.165",1643,"67.19.72.206",80,3,186,3,186,0,0,85228.716815,9.02247699999134,164.92145117149406,0
"147.32.84.165",1644,"174.37.196.55",80,3,186,3,186,0,0,85228.717043,9.022301000004518,164.92466833009172,0
"147.32.84.165",1645,"174.37.196.55",80,3,186,3,186,0,0,85228.717272,9.02211800000805,164.92801357715254,0
"147.32.84.165",1646,"174.37.196.55",80,3,186,3,186,0,0,85228.717498,9.021936999997706,164.9313223978818,0
"147.32.84.165",1647,"174.37.196.55",80,3,186,3,186,0,0,85228.717727,9.021753000008175,164.93468619664623,0
"147.32.84.165",1648,"193.23.181.44",80,3,186,3,186,0,0,85228.717977,9.021548000004259,164.9384340691085,0
"147.32.84.165",1649,"174.128.246.102",80,3,186,3,186,0,0,85228.71826,9.023419000004651,164.90423419318475,0
"147.32.84.165",1650,"174.128.246.102",80,3,186,3,186,0,0,85228.721155,9.023704999999609,164.89900766925166,0
"147.32.84.165",1651,"174.128.246.102",80,3,186,3,186,0,0,85228.724354,9.023702999998932,164.89904421723278,0
"147.32.84.165",1652,"174.37.196.55",80,3,186,3,186,0,0,85228.809532,9.029894000006607,164.78598752088467,0
"147.32.84.165",1654,"193.23.181.44",80,3,186,3,186,0,0,85228.810369,9.029177999997046,164.79905479773316,0
"147.32.84.165",1653,"174.128.246.102",80,3,186,3,186,0,0,85228.810485,9.02911300001142,164.80024117519827,0
"147.32.84.165",1655,"174.128.246.102",80,3,186,3,186,0,0,85228.810622,9.029023999988567,164.80186562821012,0
"147.32.84.165",1656,"193.23.181.44",179,3,186,3,186,0,0,85228.810764,9.028927999999723,164.80361788243803,0
"147.32.84.165",1657,"67.19.72.206",80,3,186,3,186,0,0,85228.810937,9.0288040000014,164.8058812661975,0
"147.32.84.165",1658,"67.19.72.206",80,3,186,3,186,0,0,85228.811109,9.028678999995464,164.80816296611582,0
"147.32.84.165",1659,"193.23.181.44",179,3,186,3,186,0,0,85228.811253,9.028581999999005,164.8099336086402,0
"147.32.84.165",1660,"193.23.181.44",179,3,186,3,186,0,0,85228.811398,9.028484999987995,164.81170428947698,0
"147.32.84.165",1661,"72.20.15.61",80,3,186,3,186,0,0,85228.811583,9.028349000000162,164.81418695710292,0
"147.32.84.165",1662,"67.19.72.206",80,3,186,3,186,0,0,85228.81179,9.028186999988975,164.8171443504457,0
"147.32.84.165",1663,"174.128.246.102",80,3,186,3,186,0,0,85228.811976,9.028049000000465,164.8196636947721,0
"147.32.84.165",1664,"72.20.15.61",80,3,186,3,186,0,0,85228.812161,9.027911000011954,164.8221831161195,0
"147.32.84.165",1665,"67.19.72.206",80,3,186,3,186,0,0,85228.812301,9.027816000001621,164.82391754547643,0
"147.32.84.165",1666,"174.37.196.55",80,3,186,3,186,0,0,85228.81244,9.02772399999958,164.82559723802692,0
"147.32.84.165",1667,"174.37.196.55",80,3,186,3,186,0,0,85228.812575,9.027635999998893,164.82720393247828,0
"147.32.84.165",1668,"193.23.181.44",179,3,186,3,186,0,0,85228.812702,9.027555000007851,164.8286828491996,0
"147.32.84.165",1669,"72.20.15.61",80,3,186,3,186,0,0,85228.81283,9.027477000010549,164.830107016419,0
"147.32.84.165",1670,"174.128.246.102",80,3,186,3,186,0,0,85228.812959,9.027392999996664,164.83164076279274,0
"147.32.84.165",1671,"193.23.181.44",80,3,186,3,186,0,0,85228.813093,9.02730899999733,164.8331745374441,0
"147.32.84.165",1672,"174.37.196.55",80,3,186,3,186,0,0,85229.01037,9.029106999994838,164.8003506881523,0
"147.32.84.165",1673,"174.37.196.55",80,3,186,3,186,0,0,85229.010566,9.028971000007004,164.80283301373387,0
"147.32.84.165",1674,"174.128.246.102",80,3,186,3,186,0,0,85229.011246,9.028313000002527,164.81484414636307,0
"147.32.84.165",1675,"174.128.246.102",80,3,186,3,186,0,0,85229.011388,9.028195999999298,164.81698004785406,0
"147.32.84.165",1676,"67.19.72.206",80,3,186,3,186,0,0,85229.011665,9.027943000008236,164.82159889563354,0
"147.32.84.165",1677,"67.19.72.206",80,3,186,3,186,0,0,85229.011865,9.027771000008215,164.824739129808,0
"147.32.84.165",1678,"193.23.181.44",179,3,186,3,186,0,0,85229.012013,9.027646000002278,164.82702135192545,0
"147.32.84.165",1679,"193.23.181.44",80,3,186,3,186,0,0,85229.012157,9.027522999997018,164.82926712017144,0
"147.32.84.165",1680,"174.37.196.55",80,3,186,3,186,0,0,85229.012301,9.027400999999372,164.8314946904545,0
"147.32.84.165",1681,"174.37.196.55",80,3,186,3,186,0,0,85229.012488,9.02723700000206,164.83448922407382,0
"147.32.84.165",1682,"174.128.246.102",80,3,186,3,186,0,0,85229.012671,9.02707699999155,164.83741082538597,0
"147.32.84.165",1683,"72.20.15.61",80,3,186,3,186,0,0,85229.012854,9.026920000003884,164.8402777469347,0
"147.32.84.165",1684,"193.23.181.44",80,3,186,3,186,0,0,85229.012988,9.026809000002686,164.84230473908966,0
"147.32.84.165",1685,"67.19.72.206",80,3,186,3,186,0,0,85229.013131,9.026693000007072,164.84442309036478,0
"147.32.84.165",1686,"72.20.15.61",80,3,186,3,186,0,0,85229.013259,9.026587999993353,164.84634061077074,0
"147.32.84.165",1687,"193.23.181.44",179,3,186,3,186,0,0,85229.013388,9.026480000000447,164.8483129636277,0
"147.32.84.165",1688,"193.23.181.44",179,3,186,3,186,0,0,85229.109856,9.029349000004004,164.79593379316051,0
"147.32.84.165",1689,"174.128.246.102",80,7,597,4,415,3,182,85229.110125,0.3302869999897666,10051.863985269976,4408.287338118399
"147.32.84.165",1690,"193.23.181.44",179,3,186,3,186,0,0,85229.110406,9.028920999990078,164.80374565262397,0
"147.32.84.165",1691,"174.37.196.55",80,3,186,3,186,0,0,85229.110671,9.028705999997328,164.80767011357335,0
"147.32.84.165",1692,"193.23.181.44",80,3,186,3,186,0,0,85229.111645,9.02777500000957,164.82466609972255,0
"147.32.84.165",1693,"174.37.196.55",80,3,186,3,186,0,0,85229.111951,9.027516999994987,164.8293766714398,0
"147.32.84.165",1694,"174.37.196.55",80,3,186,3,186,0,0,85229.112218,9.027295000007143,164.83343016915063,0
"147.32.84.165",1695,"193.23.181.44",80,3,186,3,186,0,0,85229.112495,9.027066000009654,164.83761168893733,0
"147.32.84.165",1696,"174.37.196.55",80,3,186,3,186,0,0,85229.112684,9.026921999990009,164.8402412252645,0
"147.32.84.165",1697,"193.23.181.44",179,3,186,3,186,0,0,85229.112867,9.026784999994561,164.84274301436187,0
"147.32.84.165",1698,"174.37.196.55",80,3,186,3,186,0,0,85229.113061,9.02663800001028,164.84542750006207,0
"147.32.84.165",1699,"174.128.246.102",80,7,607,5,485,2,122,85229.113305,3.3272539999888977,1166.1267820289484,293.3349843454262
"147.32.84.165",1700,"67.19.72.206",80,3,186,3,186,0,0,85229.11354,9.026204999987385,164.8533353720727,0
"147.32.84.165",1701,"67.19.72.206",80,3,186,3,186,0,0,85229.113779,9.026013999988209,164.85682384294373,0
"147.32.84.165",1702,"67.19.72.206",80,3,186,3,186,0,0,85229.11402,9.02581900000223,164.8603855228686,0
"147.32.84.165",1703,"67.19.72.206",80,3,186,3,186,0,0,85229.114253,9.025628999996115,164.86385602606094,0
"147.32.84.165",1704,"174.37.196.55",80,3,186,3,186,0,0,85229.114434,9.025498000002699,164.8662489315886,0
"147.32.84.165",1705,"67.19.72.206",80,3,186,3,186,0,0,85229.114676,9.025302000009106,164.8698292864326,0
"147.32.84.165",1706,"67.19.72.206",80,3,186,3,186,0,0,85229.114965,9.025055999998585,164.87432321752166,0
"147.32.84.165",1707,"67.19.72.206",80,3,186,3,186,0,0,85229.115255,9.024812999996357,164.87876258495336,0
"147.32.84.165",1708,"72.20.15.61",80,3,186,3,186,0,0,85229.115512,9.02460199999041,164.88261753832262,0
"147.32.84.165",1709,"67.19.72.206",80,3,186,3,186,0,0,85229.115801,9.024355999994441,164.8871121663326,0
"147.32.84.165",1710,"72.20.15.61",80,3,186,3,186,0,0,85229.116374,9.023829999990994,164.89672345350976,0
"147.32.84.165",1711,"72.20.15.61",80,3,186,3,186,0,0,85229.116637,9.023612000004505,164.90070716684818,0
"147.32.84.165",1712,"174.128.246.102",80,3,186,3,186,0,0,85229.211146,9.028882999991765,164.80443926467507,0
"147.32.84.165",1713,"174.37.196.55",80,3,186,3,186,0,0,85229.211739,9.028349000000162,164.81418695710292,0
"147.32.84.165",1714,"72.20.15.61",80,3,186,3,186,0,0,85229.212167,9.02794499999436,164.82156238223976,0
"147.32.84.165",1715,"174.128.246.102",80,7,569,4,387,3,182,85229.212328,0.32706799999868963,9465.921459795529,4451.673658095055
"147.32.84.165",1716,"174.37.196.55",80,3,186,3,186,0,0,85229.212446,9.027688000001945,164.82625451828636,0
"147.32.84.165",1717,"174.37.196.55",80,3,186,3,186,0,0,85229.212567,9.027593999999226,164.8279707749515,0
"147.32.84.165",1718,"174.37.196.55",80,3,186,3,186,0,0,85229.212683,9.02750099998957,164.82966880886738,0
"147.32.84.165",1719,"174.128.246.102",80,8,683,5,501,3,182,85229.212806,3.3286970000044676,1204.074747564774,437.40839133091595
"147.32.84.165",1720,"174.128.246.102",80,7,601,4,419,3,182,85229.212921,0.3327739999949699,10072.902330262183,4375.341823646103
"147.32.84.165",1721,"67.19.72.206",80,3,186,3,186,0,0,85229.213035,9.027170000001206,164.83571263195455,0
"147.32.84.165",1722,"67.19.72.206",80,3,186,3,186,0,0,85229.213151,9.02707699999155,164.83741082538597,0
"147.32.84.165",1723,"193.23.181.44",179,3,186,3,186,0,0,85229.213266,9.026985999997123,164.8390725321247,0
"147.32.84.165",1724,"72.20.15.61",80,3,186,3,186,0,0,85229.21338,9.026891999994405,164.84078905573728,0
"147.32.84.165",1725,"174.128.246.102",80,7,603,5,481,2,122,85229.213522,3.3267070000001695,1156.6994027426533,293.38321649605757
"147.32.84.165",1726,"193.23.181.44",80,3,186,3,186,0,0,85229.213688,9.026610999993864,164.84592057872123,0
"147.32.84.165",1727,"67.19.72.206",80,3,186,3,186,0,0,85229.213803,9.0265209999925,164.84756419458134,0
"147.32.84.165",1728,"72.20.15.61",80,3,186,3,186,0,0,85229.213916,9.02642900000501,164.84924436886106,0
"147.32.84.165",1729,"193.23.181.44",179,3,186,3,186,0,0,85229.21403,9.026335999995354,164.85094284112247,0
"147.32.84.165",1730,"67.19.72.206",80,3,186,3,186,0,0,85229.214145,9.02624300000025,164.8526413481178,0
"147.32.84.165",1731,"72.20.15.61",80,3,186,3,186,0,0,85229.214259,9.026152999998885,164.85428509800175,0
"147.32.84.165",1732,"193.23.181.44",179,3,186,3,186,0,0,85229.229138,9.0112999999983,165.12600845608077,0
"147.32.84.165",1733,"174.128.246.102",80,6,578,4,456,2,122,85229.249145,0.3275980000034906,11135.599118313085,2979.2611676188517
"147.32.84.165",1734,"193.23.181.44",179,3,186,3,186,0,0,85229.276651,8.963809000008041,166.00085967903433,0
"147.32.84.165",1735,"174.37.196.55",80,3,186,3,186,0,0,85229.310549,9.029825999998138,164.78722845825675,0
"147.32.84.165",1736,"193.23.181.44",179,3,186,3,186,0,0,85229.312138,9.028335000009974,164.81444252991898,0
"147.32.84.165",1737,"193.23.181.44",179,3,186,3,186,0,0,85229.313403,9.027098000005935,164.83702735907173,0
"147.32.84.165",1738,"174.128.246.102",80,3,186,3,186,0,0,85229.313632,9.026891000001342,164.84080731669172,0
"147.32.84.165",1739,"174.128.246.102",80,3,186,3,186,0,0,85229.313934,9.02661599998828,164.84582926779336,0
"147.32.84.165",1740,"193.23.181.44",179,3,186,3,186,0,0,85229.314155,9.026440000001458,164.84904347669288,0
"147.32.84.165",1741,"174.37.196.55",80,3,186,3,186,0,0,85229.314372,9.026246000008541,164.85258655686894,0
"147.32.84.165",1742,"72.20.15.61",80,3,186,3,186,0,0,85229.314639,9.026001999998698,164.85704301862714,0
"147.32.84.165",1743,"193.23.181.44",80,3,186,3,186,0,0,85229.314855,9.025810999999521,164.86053164641703,0
"147.32.84.165",1744,"174.128.246.102",80,8,667,6,545,2,122,85229.31507,9.351177999997162,466.25141773596044,104.37187699777463
"147.32.84.165",1745,"174.128.246.102",80,3,186,3,186,0,0,85229.315288,9.025424000006751,164.86760067991122,0
"147.32.84.165",1746,"174.37.196.55",80,3,186,3,186,0,0,85229.315503,9.025230999992345,164.87112629042537,0
"147.32.84.165",1748,"174.128.246.102",80,3,186,3,186,0,0,85229.315754,9.025001000001794,164.87532799162065,0
"147.32.84.165",1749,"174.37.196.55",80,3,186,3,186,0,0,85229.315974,9.0248050000082,164.87890874081467,0
"147.32.84.165",1750,"193.23.181.44",80,3,186,3,186,0,0,85229.31619,9.024612000008347,164.88243483471908,0
"147.32.84.165",1751,"193.23.181.44",80,3,186,3,186,0,0,85229.316405,9.02441899999394,164.8859610797104,0
"147.32.84.165",1752,"193.23.181.44",80,3,186,3,186,0,0,85229.316671,9.024173000012524,164.89045588974577,0
"147.32.84.165",1747,"193.23.181.44",80,3,186,3,186,0,0,85229.31689,9.023981999998796,164.893945932095,0
"147.32.84.165",1753,"193.23.181.44",179,3,186,3,186,0,0,85229.317126,9.023756000009598,164.8980757013396,0
"147.32.84.165",1755,"67.19.72.206",80,3,186,3,186,0,0,85229.317399,9.023503999997047,164.90268082116293,0
"147.32.84.165",1754,"174.37.196.55",80,3,186,3,186,0,0,85229.317613,9.02331299999787,164.90617138077238,0
"147.32.84.165",1756,"193.23.181.44",179,3,186,3,186,0,0,85229.376117,8.964830999990227,165.9819354097832,0
"147.32.84.165",1757,"193.23.181.44",80,3,186,3,186,0,0,85229.379643,8.961330000005546,166.04678100227076,0
"147.32.84.165",1758,"193.23.181.44",179,3,186,3,186,0,0,85229.410824,9.030515999998897,164.774637462597,0
"147.32.84.165",1759,"174.128.246.102",80,3,186,3,186,0,0,85229.411001,9.030360000004293,164.77748395404973,0
"147.32.84.165",1760,"174.37.196.55",80,3,186,3,186,0,0,85229.411206,9.030182000002242,164.7807319940651,0
"147.32.84.165",1761,"193.23.181.44",80,3,186,3,186,0,0,85229.411387,9.03002400000696,164.7836151929223,0
"147.32.84.165",1763,"193.23.181.44",179,3,186,3,186,0,0,85229.412184,9.029248999999254,164.79775892769408,0
"147.32.84.165",1762,"174.128.246.102",80,3,186,3,186,0,0,85229.412292,9.02916499999992,164.7992920718597,0
"147.32.84.165",1764,"174.128.246.102",80,3,186,3,186,0,0,85229.41241,9.029069999989588,164.80102601948107,0
"147.32.84.165",1765,"72.20.15.61",80,3,186,3,186,0,0,85229.412536,9.028964999990421,164.80294253013258,0
"147.32.84.165",1766,"193.23.181.44",80,3,186,3,186,0,0,85229.412683,9.028842999992776,164.80516938894502,0
"147.32.84.165",1767,"174.37.196.55",80,3,186,3,186,0,0,85229.412817,9.028733999992255,164.80715901047438,0
"147.32.84.165",1768,"174.128.246.102",80,3,186,3,186,0,0,85229.412951,9.02862099999038,164.80922169637927,0
"147.32.84.165",1769,"193.23.181.44",80,3,186,3,186,0,0,85229.413445,9.028149999998277,164.81781981915276,0
"147.32.84.165",1770,"67.19.72.206",80,3,186,3,186,0,0,85229.41357,9.028049000000465,164.8196636947721,0
"147.32.84.165",1771,"174.128.246.102",80,3,186,3,186,0,0,85229.413687,9.027954000004684,164.82139807083954,0
"147.32.84.165",1772,"72.20.15.61",80,3,186,3,186,0,0,85229.413807,9.027858000001288,164.82315074071698,0
"147.32.84.165",1773,"174.128.246.102",80,3,186,3,186,0,0,85229.416811,9.024877000003471,164.8775933455301,0
"147.32.84.165",1774,"67.19.72.206",80,3,186,3,186,0,0,85229.420011,9.021697000003769,164.9357099888611,0
"147.32.84.165",1775,"67.19.72.206",80,3,186,3,186,0,0,85229.423211,9.018519000004744,164.9938310269366,0
"147.32.84.165",1776,"193.23.181.44",179,3,186,3,186,0,0,85229.426415,9.015339000005042,165.0520296573615,0
"147.32.84.165",1777,"72.20.15.61",80,3,186,3,186,0,0,85229.510981,9.03009299999394,164.78235606222424,0
"147.32.84.165",1778,"174.37.196.55",80,3,186,3,186,0,0,85229.511337,9.029786999992211,164.7879401807909,0
"147.32.84.165",1779,"72.20.15.61",80,3,186,3,186,0,0,85229.512462,9.028707999998005,164.80763360608503,0
"147.32.84.165",1780,"72.20.15.61",80,3,186,3,186,0,0,85229.513153,9.02806499999133,164.81937159307438,0
"147.32.84.165",1781,"72.20.15.61",80,3,186,3,186,0,0,85229.513437,9.027828000005684,164.82369845759834,0
"147.32.84.165",1782,"174.37.196.55",80,3,186,3,186,0,0,85229.513712,9.027600000001257,164.82786122555194,0
"147.32.84.165",1783,"174.128.246.102",80,3,186,3,186,0,0,85229.513931,9.027428000001237,164.83100169835706,0
"147.32.84.165",1784,"72.20.15.61",80,3,186,3,186,0,0,85229.514145,9.02726000000257,164.83406925241727,0
"147.32.84.165",1785,"193.23.181.44",80,3,186,3,186,0,0,85229.51441,9.02704200000153,164.83804993925452,0
"147.32.84.165",1786,"174.37.196.55",80,3,186,3,186,0,0,85229.514634,9.026866999993217,164.84124558400143,0
"147.32.84.165",1787,"174.128.246.102",80,3,186,3,186,0,0,85229.514849,9.026700999995228,164.84427699563625,0
"147.32.84.165",1788,"193.23.181.44",80,3,186,3,186,0,0,85229.515088,9.026511999996728,164.8477285578903,0
"147.32.84.165",1789,"72.20.15.61",80,3,186,3,186,0,0,85229.515287,9.026362000004156,164.85046799577893,0
"147.32.84.165",1790,"72.20.15.61",80,3,186,3,186,0,0,85229.611976,9.029865999997128,164.78649849294257,0
"147.32.84.165",1792,"174.37.196.55",80,8,662,5,480,3,182,85229.612277,3.2531770000059623,1180.3845901999682,447.5624904508213
"147.32.84.165",1791,"72.20.15.61",80,3,186,3,186,0,0,85229.612384,9.02951700000267,164.79286765832103,0
"147.32.84.165",1793,"72.20.15.61",80,3,186,3,186,0,0,85229.612536,9.029385999994702,164.79525850383106,0
"147.32.84.165",1794,"174.37.196.55",80,3,186,3,186,0,0,85229.711693,9.029613999999128,164.79109738247323,0
"147.32.84.165",1795,"193.23.181.44",179,3,186,3,186,0,0,85229.712672,9.028694000007818,164.80788915857727,0
"147.32.84.165",1796,"174.37.196.55",80,3,186,3,186,0,0,85229.713386,9.028002999999444,164.82050349341839,0
"147.32.84.165",1797,"193.23.181.44",80,3,186,3,186,0,0,85229.713545,9.027867999990121,164.82296816940922,0
"147.32.84.165",1798,"174.128.246.102",80,3,186,3,186,0,0,85229.713655,9.027784999998403,164.82448352505773,0
"147.32.84.165",1799,"174.37.196.55",80,3,186,3,186,0,0,85229.713769,9.027694000003976,164.82614497116813,0
"147.32.84.165",1800,"174.128.246.102",80,3,186,3,186,0,0,85229.713877,9.027606999996351,164.82773341823602,0
"147.32.84.165",1801,"174.128.246.102",80,3,186,3,186,0,0,85229.713984,9.027522999997018,164.82926712017144,0
"147.32.84.165",1802,"72.20.15.61",80,3,186,3,186,0,0,85229.714092,9.027439000012237,164.83080085038327,0
"147.32.84.165",1803,"72.20.15.61",80,3,186,3,186,0,0,85229.714209,9.027342000001227,164.83257197963673,0
"147.32.84.165",1804,"193.23.181.44",179,3,186,3,186,0,0,85229.714322,9.027249999999185,164.8342518485845,0
"147.32.84.165",1805,"67.19.72.206",80,3,186,3,186,0,0,85229.71443,9.027164999992237,164.83580393194094,0
"147.32.84.165",1806,"193.23.181.44",80,3,186,3,186,0,0,85229.714544,9.02707399999781,164.83746560628182,0
"147.32.84.165",1807,"67.19.72.206",80,3,186,3,186,0,0,85229.714656,9.026983000003383,164.83912731412502,0
"147.32.84.165",1808,"72.20.15.61",80,3,186,3,186,0,0,85229.714764,9.026898999989498,164.8406612283721,0
"147.32.84.165",1809,"174.37.196.55",80,3,186,3,186,0,0,85229.714933,9.026750999997603,164.84336390805453,0
"147.32.84.165",1810,"67.19.72.206",80,3,186,3,186,0,0,85229.715068,9.026636999988114,164.84544576257574,0
"147.32.84.165",1812,"67.19.72.206",80,3,186,3,186,0,0,85229.715219,9.026508999988437,164.84778334590993,0
"147.32.84.165",1813,"193.23.181.44",80,3,186,3,186,0,0,85229.715328,9.026422999988426,164.84935394695196,0
"147.32.84.165",1811,"67.19.72.206",80,3,186,3,186,0,0,85229.71544,9.026333000001614,164.85099763101294,0
"147.32.84.165",1814,"174.37.196.55",80,3,186,3,186,0,0,85229.715581,9.026215000005323,164.85315273335752,0
"147.32.84.165",1816,"67.19.72.206",80,3,186,3,186,0,0,85229.715691,9.02612899999076,164.85472343698203,0
"147.32.84.165",1815,"174.37.196.55",80,3,186,3,186,0,0,85229.715802,9.026037999996333,164.8563854927937,0
"147.32.84.165",1817,"174.37.196.55",80,3,186,3,186,0,0,85229.812497,9.029225999998744,164.79817871434463,0
"147.32.84.165",1818,"193.23.181.44",80,3,186,3,186,0,0,85229.813261,9.028560999999172,164.8103169486407,0
"147.32.84.165",1819,"193.23.181.44",179,3,186,3,186,0,0,85229.813684,9.028164000003017,164.81756423559682,0
"147.32.84.165",1820,"174.37.196.55",80,3,186,3,186,0,0,85229.813848,9.0280219999986,164.82015661905018,0
"147.32.84.165",1821,"193.23.181.44",80,3,186,3,186,0,0,85229.813977,9.027918000007048,164.82205531760903,0
"147.32.84.165",1822,"174.128.246.102",80,3,186,3,186,0,0,85229.814086,9.027834000007715,164.82358891387773,0
"147.32.84.165",1823,"72.20.15.61",80,3,186,3,186,0,0,85229.814193,9.027753000002122,164.82506776599342,0
"147.32.84.165",1824,"193.23.181.44",80,3,186,3,186,0,0,85229.814301,9.027670999988914,164.8265649027116,0
"147.32.84.165",1825,"174.37.196.55",80,3,186,3,186,0,0,85229.814408,9.027589999997872,164.82804380796546,0
"147.32.84.165",1826,"72.20.15.61",80,3,186,3,186,0,0,85229.81452,9.027501999997185,164.829650550115,0
"147.32.84.165",1827,"72.20.15.61",80,3,186,3,186,0,0,85229.814626,9.027418999990914,164.83116602890567,0
"147.32.84.165",1828,"174.37.196.55",80,3,186,3,186,0,0,85229.814733,9.027336999992258,164.83266327614402,0
"147.32.84.165",1829,"193.23.181.44",80,3,186,3,186,0,0,85229.814841,9.02725400000054,164.83417881006906,0
"147.32.84.165",1830,"193.23.181.44",179,3,186,3,186,0,0,85229.814958,9.027161999998498,164.83585871176874,0
"147.32.84.165",1832,"72.20.15.61",80,3,186,3,186,0,0,85229.815086,9.027056999999331,164.83777603266606,0
"147.32.84.165",1831,"72.20.15.61",80,3,186,3,186,0,0,85229.815194,9.026972999999998,164.83930992149863,0
"147.32.84.165",1833,"193.23.181.44",80,3,186,3,186,0,0,85229.815302,9.02688799999305,164.84086210011085,0
"147.32.84.165",1834,"174.37.196.55",80,3,186,3,186,0,0,85229.912949,9.02973499998916,164.78888915364476,0
"147.32.84.165",1835,"174.37.196.55",80,3,186,3,186,0,0,85229.913142,9.02959199999168,164.7914988851513,0
"147.32.84.165",1837,"174.128.246.102",80,3,186,3,186,0,0,85229.913719,9.029046999989077,164.8014458227762,0
"147.32.84.165",1836,"67.19.72.206",80,3,186,3,186,0,0,85229.91386,9.02892700000666,164.80363613515783,0
"147.32.84.165",1838,"174.37.196.55",80,3,186,3,186,0,0,85229.914291,9.028518000006443,164.81110188836507,0
"147.32.84.165",1839,"193.23.181.44",179,3,186,3,186,0,0,85229.914431,9.028399000002537,164.81327420283284,0
"147.32.84.165",1840,"174.37.196.55",80,3,186,3,186,0,0,85229.914622,9.028239999999641,164.81617679636994,0
"147.32.84.165",1841,"193.23.181.44",80,3,186,3,186,0,0,85229.91475,9.028143000003183,164.81794761109515,0
"147.32.84.165",1842,"174.37.196.55",80,3,186,3,186,0,0,85229.914893,9.028028000000631,164.8200470800374,0
"147.32.84.165",1843,"193.23.181.44",80,3,186,3,186,0,0,85229.920398,9.02255399999558,164.92004370389236,0
"147.32.84.165",1844,"193.23.181.44",179,3,186,3,186,0,0,85229.940563,9.002428000007058,165.28874210366732,0
"147.32.84.165",1845,"174.37.196.55",80,3,186,3,186,0,0,85229.960792,8.982216999997036,165.66066039158162,0
"147.32.84.165",1847,"67.19.72.206",80,3,186,3,186,0,0,85229.981056,8.96198199999344,166.03470080626016,0
"147.32.84.165",1846,"193.23.181.44",179,3,186,3,186,0,0,85229.981181,8.961880000002566,166.03659053675946,0
"147.32.84.165",1848,"72.20.15.61",80,3,186,3,186,0,0,85230.014523,9.028226999987965,164.8164141200685,0
"147.32.84.165",1849,"174.128.246.102",80,3,186,3,186,0,0,85230.015716,9.027092000003904,164.83713692065578,0
"147.32.84.165",1850,"193.23.181.44",179,3,186,3,186,0,0,85230.015915,9.026914000001852,164.84038731283965,0
"147.32.84.165",1851,"72.20.15.61",80,3,186,3,186,0,0,85230.016273,9.026583999991999,164.84641366006443,0
"147.32.84.165",1852,"174.37.196.55",80,3,186,3,186,0,0,85230.016465,9.02641500000027,164.84950005067964,0
"147.32.84.165",1853,"174.128.246.102",80,3,186,3,186,0,0,85230.016651,9.026249999995343,164.85251350237004,0
"147.32.84.165",1854,"174.37.196.55",80,3,186,3,186,0,0,85230.01684,9.026085000004969,164.8555270639686,0
"147.32.84.165",1855,"67.19.72.206",80,3,186,3,186,0,0,85230.017029,9.025920000000042,164.85854073601286,0
"147.32.84.165",1856,"174.37.196.55",80,3,186,3,186,0,0,85230.017217,9.02575899999647,164.86148145552988,0
"147.32.84.165",1857,"193.23.181.44",80,3,186,3,186,0,0,85230.017404,9.025594999999157,164.86447707881186,0
"147.32.84.165",1858,"174.37.196.55",80,3,186,3,186,0,0,85230.017592,9.025433999995585,164.86741801011763,0
"147.32.84.165",1859,"67.19.72.206",80,3,186,3,186,0,0,85230.01778,9.025268000012147,164.87045038418773,0
"147.32.84.165",1860,"174.37.196.55",80,3,186,3,186,0,0,85230.017967,9.025102999992669,164.87346460214457,0
"147.32.84.165",1861,"193.23.181.44",80,3,186,3,186,0,0,85230.018203,9.024890999993659,164.87733757682454,0
"147.32.84.165",1862,"72.20.15.61",80,3,186,3,186,0,0,85230.018394,9.024722999994992,164.88040685579222,0
"147.32.84.165",1863,"174.128.246.102",80,3,186,3,186,0,0,85230.018583,9.024560000005295,164.8833848962306,0
"147.32.84.165",1864,"193.23.181.44",80,3,186,3,186,0,0,85230.018771,9.024384999996983,164.88658229901512,0
"147.32.84.165",1865,"174.128.246.102",80,3,186,3,186,0,0,85230.019065,9.02411499999289,164.89151567784458,0
"147.32.84.165",1866,"193.23.181.44",179,3,186,3,186,0,0,85230.019288,9.023916999998619,164.8951336764542,0
"147.32.84.165",1867,"193.23.181.44",179,3,186,3,186,0,0,85230.019505,9.023724999991828,164.8986421905973,0
"147.32.84.165",1868,"174.37.196.55",80,3,186,3,186,0,0,85230.01972,9.023532000006526,164.90216912833287,0
"147.32.84.165",1869,"174.128.246.102",80,3,186,3,186,0,0,85230.019937,9.023337999999058,164.90571449281356,0
"147.32.84.165",1870,"72.20.15.61",80,3,186,3,186,0,0,85230.113575,9.029777000003378,164.78812267450718,0
"147.32.84.165",1871,"72.20.15.61",80,3,186,3,186,0,0,85230.113752,9.029658999992535,164.79027613348745,0
"147.32.84.165",1872,"174.37.196.55",80,3,186,3,186,0,0,85230.113971,9.029469000000972,164.79374368524216,0
"147.32.84.165",1873,"174.128.246.102",80,7,565,4,383,3,182,85230.1141,0.3168829999922309,9669.18389460817,4594.7557932602795
"147.32.84.165",1874,"174.128.246.102",80,6,560,4,438,2,122,85230.114234,0.32933600000978913,10639.58996251806,2963.5387566831123
"147.32.84.165",1875,"72.20.15.61",80,3,186,3,186,0,0,85230.114409,9.029053999998723,164.8013180561563,0
"147.32.84.165",1876,"193.23.181.44",179,3,186,3,186,0,0,85230.11453,9.028954999987036,164.80312505734457,0
"147.32.84.165",1877,"174.37.196.55",80,3,186,3,186,0,0,85230.213259,9.02953100000741,164.792612152146,0
"147.32.84.165",1878,"174.37.196.55",80,3,186,3,186,0,0,85230.21359,9.029288999998244,164.79702886908254,0
"147.32.84.165",1879,"193.23.181.44",80,3,186,3,186,0,0,85230.213814,9.029089000003296,164.8006792268253,0
"147.32.84.165",1880,"193.23.181.44",80,3,186,3,186,0,0,85230.273615,8.969309000007343,165.89906758689904,0
"147.32.84.165",1881,"174.128.246.102",80,9,698,5,456,4,242,85230.28044,3.2570249999989755,1120.0405277826076,594.4074730776119
"147.32.84.165",1882,"193.23.181.44",80,3,186,3,186,0,0,85230.313823,9.029962999993586,164.784728353932,0
"147.32.84.165",1883,"67.19.72.206",80,3,186,3,186,0,0,85230.314031,9.029813999994076,164.78744744919177,0
"147.32.84.165",1884,"193.23.181.44",80,3,186,3,186,0,0,85230.413875,9.029590000005555,164.79153538522618,0
"147.32.84.165",1885,"72.20.15.61",80,3,186,3,186,0,0,85230.814978,9.029882000002544,164.78620650852145,0
"147.32.84.165",1886,"174.37.196.55",80,3,186,3,186,0,0,85230.815247,9.029735999996774,164.78887090392584,0
"147.32.84.165",1887,"174.128.246.102",80,3,186,3,186,0,0,85231.095714,8.950894000008702,166.24037777662804,0
"147.32.84.165",1888,"72.20.15.61",80,3,186,3,186,0,0,85231.118114,8.92854300000181,166.65653063435977,0
"147.32.84.165",1889,"193.23.181.44",80,3,186,3,186,0,0,85231.226918,8.919313999998849,166.82897361839622,0
"147.32.84.165",1890,"193.23.181.44",80,3,186,3,186,0,0,85231.230136,8.916119000001345,166.88875507379115,0
"147.32.84.165",1891,"193.23.181.44",80,3,186,3,186,0,0,85231.233368,8.912911999999778,166.94880416187627,0
"147.32.84.165",1892,"193.23.181.44",80,3,186,3,186,0,0,85231.236563,8.909740000002785,167.0082404199825,0
"147.32.84.165",1893,"72.20.15.61",80,3,186,3,186,0,0,85231.256946,8.889380000007804,167.39075166082378,0
"147.32.84.165",1894,"193.23.181.44",80,3,186,3,186,0,0,85231.277345,8.869002999999793,167.7753407006441,0
"147.32.84.165",1895,"193.23.181.44",179,3,186,3,186,0,0,85231.314941,8.831430999998702,168.48911575034882,0
"147.32.84.165",1896,"193.23.181.44",179,3,186,3,186,0,0,85231.318114,8.828280000001541,168.54925308211114,0
"147.32.84.165",1897,"174.128.246.102",80,8,638,5,456,3,182,85231.391769,3.1684690000111004,1151.344703068649,459.5279297335398
"147.32.84.165",1898,"67.19.72.206",80,3,186,3,186,0,0,85231.394937,8.85211100000015,168.09549722094252,0
"147.32.84.165",1899,"174.128.246.102",80,3,186,3,186,0,0,85231.39816,8.848910000000615,168.15630399675177,0
"147.32.84.165",1900,"193.23.181.44",80,3,186,3,186,0,0,85231.401362,8.845732999994652,168.21669837885673,0
"147.32.84.165",1901,"174.128.246.102",80,3,186,3,186,0,0,85231.404564,8.842554000002565,168.27717421907386,0
"147.32.84.165",1902,"72.20.15.61",80,3,186,3,186,0,0,85231.407766,8.839374999995925,168.33769355872852,0
"147.32.84.165",1903,"193.23.181.44",80,3,186,3,186,0,0,85231.410965,8.836198999997578,168.3981992710223,0
"147.32.84.165",1904,"193.23.181.44",179,3,186,3,186,0,0,85231.430542,8.816644999998971,168.771681291486,0
"147.32.84.165",1905,"174.37.196.55",80,3,186,3,186,0,0,85231.436914,8.909204999989015,167.01826930706326,0
"147.32.84.165",1906,"174.37.196.55",80,3,186,3,186,0,0,85231.440145,8.906073000005563,167.07700464605114,0
"147.32.84.165",1907,"193.23.181.44",80,3,186,3,186,0,0,85231.443363,8.902879000001121,167.1369452510601,0
"147.32.84.165",1908,"193.23.181.44",80,3,186,3,186,0,0,85231.446565,8.899697000000742,167.1967034383166,0
"147.32.84.165",1909,"174.128.246.102",80,3,186,3,186,0,0,85231.619547,9.028690000006463,164.8079621737965,0
"147.32.84.165",1910,"72.20.15.61",80,3,186,3,186,0,0,85231.619706,9.028554000004078,164.8104447289486,0
"147.32.84.165",1911,"193.23.181.44",80,3,186,3,186,0,0,85231.619847,9.028436000007787,164.8125987711179,0
"147.32.84.165",1912,"193.23.181.44",80,3,186,3,186,0,0,85231.728766,9.019058000005316,164.9839706096937,0
"147.32.84.165",1913,"193.23.181.44",80,3,186,3,186,0,0,85231.731957,9.015895000004093,165.0418510862565,0
"147.32.84.165",1914,"174.37.196.55",80,3,186,3,186,0,0,85231.735156,9.012719999998808,165.09999201131254,0
"147.32.84.165",1915,"67.19.72.206",80,3,186,3,186,0,0,85231.738387,9.009511999989627,165.15877885524912,0
"147.32.84.165",1916,"174.37.196.55",80,3,186,3,186,0,0,85231.741542,9.006380999999237,165.21619505105613,0
"147.32.84.165",1917,"193.23.181.44",179,3,186,3,186,0,0,85231.781185,8.96676799999841,165.94608001458985,0
"147.32.84.165",1918,"193.23.181.44",179,3,186,3,186,0,0,85231.784388,8.963592999993125,166.00485988165028,0
"147.32.84.165",1919,"67.19.72.206",80,3,186,3,186,0,0,85232.021406,9.027409999995143,164.83133035951624,0
"147.32.84.165",1920,"193.23.181.44",80,3,186,3,186,0,0,85232.121948,9.027321999994456,164.83293716574127,0
"147.32.84.165",1921,"174.128.246.102",80,7,576,4,394,3,182,85232.22209,0.3153420000016922,9995.496952461408,4617.2092521522245
"147.32.84.165",1922,"174.37.196.55",80,3,186,3,186,0,0,85232.222215,9.027220000003581,164.8347996392477,0
"147.32.84.165",1923,"67.19.72.206",80,3,186,3,186,0,0,85232.222356,9.027103000000352,164.83693605799579,0
"147.32.84.165",1924,"193.23.181.44",179,3,186,3,186,0,0,85232.2816,8.96787900000345,165.9255215195731,0
"147.32.84.165",1925,"174.128.246.102",80,3,186,3,186,0,0,85232.323077,9.026814000011655,164.84221343190177,0
"147.32.84.165",1926,"184.82.148.43",80,10,1919,5,979,5,940,85232.36477,0.3075340000068536,25467.102823835605,24452.580852303847
"147.32.84.165",1927,"174.37.196.55",80,3,186,3,186,0,0,85232.382195,8.967717999999877,165.92850042787032,0
"147.32.84.165",1928,"174.128.246.102",80,3,186,3,186,0,0,85232.382628,8.967314999987138,165.9359574189302,0
"147.32.84.165",1929,"174.37.196.55",80,3,186,3,186,0,0,85232.382973,8.967000999997254,165.94176804490775,0
"147.32.84.165",1930,"174.128.246.102",80,34,2170,18,1208,16,962,85232.446801,644.5571449999989,14.99324004856081,11.939980899598924
"147.32.84.165",1931,"72.20.15.61",80,3,186,3,186,0,0,85232.450001,9.000224999996135,165.32920010340175,0
"147.32.84.165",1932,"184.82.148.44",80,10,1514,5,596,5,918,85232.575026,0.30341399999451824,15714.50229747521,24204.552196446715
"147.32.84.165",1933,"193.23.181.44",80,3,186,3,186,0,0,85232.622839,9.028393000000506,164.81338373284333,0
"147.32.84.165",1934,"72.20.15.61",80,3,186,3,186,0,0,85232.72449,9.02644900001178,164.84887911049606,0
"147.32.84.165",1935,"174.128.246.102",80,3,186,3,186,0,0,85232.725372,9.025626000002376,164.86391082453542,0
"147.32.84.165",1936,"174.128.246.102",80,3,186,3,186,0,0,85232.725629,9.025391000002855,164.86820349384632,0
"147.32.84.165",1937,"67.19.72.206",80,3,186,3,186,0,0,85232.725912,9.025135000003502,164.87288001779726,0
"147.32.84.165",1938,"67.19.72.206",80,3,186,3,186,0,0,85232.72857,9.022499999991851,164.9210307565912,0
"147.32.84.165",1939,"67.19.72.206",80,3,186,3,186,0,0,85232.731767,9.019323999993503,164.97910486429714,0
"147.32.84.165",1940,"67.19.72.206",80,3,186,3,186,0,0,85232.734963,9.016152000011061,165.03714666724503,0
"147.32.84.165",1941,"193.23.181.44",80,3,186,3,186,0,0,85232.756551,8.994587000008323,165.43283199091,0
"147.32.84.165",1942,"217.163.21.36",80,14,6141,7,810,7,5331,85232.787475,0.1881020000000717,34449.39447745122,226728.05180159563
"147.32.84.165",1943,"217.163.21.36",80,10,1451,5,701,5,750,85232.94045,0.1389049999997951,40372.91674171752,43194.98938129549
"147.32.84.165",1944,"72.20.15.61",80,3,186,3,186,0,0,85233.024454,9.027727000007872,164.8255424647536,0
"147.32.84.165",1945,"217.163.21.35",80,11,3631,6,2001,5,1630,85233.03388,0.27486999999382533,58238.43999112163,47440.60828861982
"147.32.84.165",1946,"217.163.21.36",80,10,2277,5,1156,5,1121,85233.266417,0.1396939999976894,66201.84116821743,64197.4601639894
"147.32.84.165",1947,"217.163.21.35",80,13,5434,7,2516,6,2918,85233.360683,0.15139099999214523,132953.74230333586,154196.74882398016
"147.32.84.165",1948,"174.128.246.102",80,6,559,4,437,2,122,85233.38214,0.3285909999976866,10639.366263910493,2970.2578585745546
"147.32.84.165",1949,"173.241.240.4",80,9,2195,5,1165,4,1030,85233.470805,0.07837899999867659,118909.40175502833,105130.20069328685
"147.32.84.165",1950,"72.20.15.61",80,3,186,3,186,0,0,85233.55001,9.00332599999092,165.27225605309644,0
"147.32.84.165",1951,"72.20.15.61",80,3,186,3,186,0,0,85234.026784,9.029175999996369,164.7990913014209,0
"147.32.84.165",1952,"193.23.181.44",80,3,186,3,186,0,0,85234.127597,9.027616999999736,164.82755083651017,0
"147.32.84.165",1953,"72.20.15.61",80,3,186,3,186,0,0,85234.228042,9.028116999994381,164.8184222691095,0
"147.32.84.165",1954,"193.23.181.44",179,3,186,3,186,0,0,85234.394255,8.962577999991481,166.02365971056702,0
"147.32.84.165",1955,"174.37.196.55",80,3,186,3,186,0,0,85234.729514,9.027890999990632,164.82254825645813,0
"147.32.84.165",1956,"174.128.246.102",80,3,186,3,186,0,0,85235.430956,9.028507000009995,164.81130268806933,0
"147.32.84.165",1957,"67.19.72.206",80,3,186,3,186,0,0,85235.590479,8.969656000001123,165.8926496177572,0
"147.32.84.165",1958,"174.128.246.102",80,7,556,4,374,3,182,85236.634353,0.3267009999981383,9158.221125791013,4456.67445158814
"147.32.84.165",1959,"193.23.181.44",179,13,965,7,605,6,360,85236.798063,9.152912000005017,528.7934593927426,314.6539593080783
"147.32.84.165",1960,"174.37.196.55",80,3,186,3,186,0,0,85237.106475,8.958327000000281,166.1024430119545,0
"147.32.84.165",1961,"174.37.196.55",80,3,186,3,186,0,0,85237.215294,8.949992000008933,166.25713184978432,0
"147.32.84.165",1962,"193.23.181.44",80,11,1006,7,562,4,444,85237.218464,9.075630999999703,495.39255176859297,391.37774552536524
"147.32.84.165",1963,"174.128.246.102",80,3,186,3,186,0,0,85237.221697,8.94366999999329,166.3746538055537,0
"147.32.84.165",1964,"67.19.72.206",80,3,186,3,186,0,0,85237.316047,8.94934999999532,166.2690586468043,0
"147.32.84.165",1965,"186.110.109.63",6667,2,124,2,124,0,0,85237.634204,2.9127949999965494,340.56636323571524,0
"147.32.84.165",1966,"193.23.181.44",80,10,1022,7,638,3,384,85237.638777,9.15274999999383,557.6466089430435,335.63683046101676
"147.32.84.165",1967,"67.19.72.206",80,3,186,3,186,0,0,85237.639133,9.027268999998341,164.83390491634552,0
"147.32.84.165",1968,"31.192.109.161",80,10,1174,5,540,5,634,85237.712473,0.2371759999950882,18214.32185419041,21384.96306584578
"147.32.84.165",1969,"72.20.15.61",80,3,186,3,186,0,0,85237.751276,9.015260000000126,165.0534759951437,0
"147.32.84.165",1970,"67.19.72.206",80,3,186,3,186,0,0,85238.140842,9.027230000006966,164.83461704186686,0
"147.32.84.165",1971,"67.19.72.206",80,3,186,3,186,0,0,85238.240659,9.028481000001193,164.81177730781107,0
"147.32.84.165",1972,"174.128.246.102",80,3,186,3,186,0,0,85238.34114,9.02741499998956,164.8312390647512,0
"147.32.84.165",1973,"72.20.15.61",80,3,186,3,186,0,0,85238.441935,9.027146000007633,164.8361508719081,0
"147.32.84.165",1974,"67.19.72.206",80,3,186,3,186,0,0,85238.504949,8.964233000006061,165.99300799064392,0
"147.32.84.165",1975,"193.23.181.44",80,11,1056,7,604,4,452,85238.842495,9.161965999999666,527.3977222792768,394.67511667257133
"147.32.84.165",1976,"67.19.72.206",80,3,186,3,186,0,0,85238.842637,9.028211000011652,164.81670621101784,0
"147.32.84.165",1977,"67.19.72.206",80,3,186,3,186,0,0,85238.842855,9.028023000006215,164.82013836240512,0
"147.32.84.165",1978,"67.19.72.206",80,3,186,3,186,0,0,85240.247476,9.090442999993684,163.68839230398714,0
"147.32.84.165",1979,"72.20.15.61",80,3,186,3,186,0,0,85240.247616,9.093533000006573,163.63277067328227,0
"147.32.84.165",1980,"184.82.148.43",80,10,1919,5,979,5,940,85240.574965,0.3225839999940945,24278.947499390484,23311.757558148165
"147.32.84.165",1981,"72.20.15.61",80,3,186,3,186,0,0,85240.748169,9.028642000004766,164.8088383612081,0
"147.32.84.165",1982,"184.82.148.44",80,10,1513,5,596,5,917,85240.794576,0.33986300000105985,14029.182346960779,21585.168141213144
"147.32.84.165",1983,"217.163.21.36",80,13,6077,6,749,7,5328,85241.034111,0.1876499999925727,31931.787904274803,227146.28298261168
"147.32.84.165",1984,"217.163.21.36",80,10,1448,5,699,5,749,85241.178088,0.1388370000058785,40277.44765273831,43158.524022748206
"147.32.84.165",1985,"217.163.21.35",80,11,3627,6,1999,5,1628,85241.271693,0.2195519999950193,72839.23626458785,59320.79871873387
"147.32.84.165",1986,"217.163.21.36",80,10,2274,5,1154,5,1120,85241.447275,0.13990100000228267,65989.521160316,64045.28916772436
"147.32.84.165",1987,"217.163.21.35",80,13,5440,7,2514,6,2926,85241.54172,0.15161600000283215,132650.90755345288,154390.03798782942
"147.32.84.165",1988,"173.241.240.4",80,9,2194,5,1164,4,1030,85241.653653,0.06705399999918882,138873.147017518,122886.03215467658
"147.32.84.165",1989,"174.37.196.55",80,3,186,3,186,0,0,85241.851257,9.030220999993617,164.78002033405957,0
"147.32.84.165",1990,"193.23.181.44",179,3,186,3,186,0,0,85242.152822,9.029892999998992,164.78600576996493,0
"147.32.84.165",1991,"174.37.196.55",80,3,186,3,186,0,0,85244.560421,9.029991000003065,164.78421739285176,0
"147.32.84.165",1993,"46.4.36.120",443,6,366,3,186,3,180,85245.063145,1.0291000000142958,1445.9236225627533,1399.280925060729
"147.32.84.165",1996,"72.20.15.61",80,3,186,3,186,0,0,85245.826264,8.967525999993086,165.93205305467163,0
"147.32.84.165",1997,"174.37.196.55",80,3,186,3,186,0,0,85246.065188,9.029625000010128,164.79089663173508,0
"147.32.84.165",1998,"72.20.15.61",80,3,186,3,186,0,0,85246.230311,8.96542199999385,165.97099389197973,0
"147.32.84.165",1999,"193.23.181.44",80,8,829,5,445,3,384,85246.730191,0.12813199999800418,27783.847907278836,23975.275497517017
"147.32.84.165",2000,"193.23.181.44",179,10,742,5,442,5,300,85246.767242,0.1890690000000177,18702.166933763172,12693.778461830207
"147.32.84.165",2001,"72.20.15.61",80,3,186,3,186,0,0,85246.767515,9.030324000006658,164.7781408506387,0
"147.32.84.165",2002,"72.20.15.61",80,3,186,3,186,0,0,85246.796298,9.001564000005601,165.3046070659581,0
"147.32.84.165",2003,"174.37.196.55",80,3,186,3,186,0,0,85246.830683,8.967201000006753,165.938066961907,0
"147.32.84.165",2005,"193.23.181.44",80,8,829,5,445,3,384,85246.868455,0.12143600000126753,29315.853618060883,25297.27593109074
"147.32.84.165",2006,"67.19.72.206",80,3,186,3,186,0,0,85246.868875,9.028491999997641,164.8115765069503,0
"147.32.84.165",2007,"193.23.181.44",179,10,784,5,484,5,300,85246.869254,0.1977749999932712,19577.803059697813,12135.00189650691
"147.32.84.165",2008,"67.19.72.206",80,3,186,3,186,0,0,85246.930073,8.96741500000644,165.93410698611933,0
"147.32.84.165",2009,"193.23.181.44",80,9,899,5,455,4,444,85246.93639,0.12525800000003073,29060.020118468336,28357.470181538334
"147.32.84.165",2011,"174.37.196.55",80,3,186,3,186,0,0,85246.967796,9.03044800000498,164.77587822876333,0
"147.32.84.165",2010,"72.20.15.61",80,3,186,3,186,0,0,85246.967909,9.030396000001929,164.77682706269826,0
"147.32.84.165",2012,"174.37.196.55",80,3,186,3,186,0,0,85246.998695,8.999633999992511,165.3400571624622,0
"147.32.84.165",2013,"46.4.36.120",443,6,366,3,186,3,180,85247.093638,1.0050309999933233,1480.5513461872172,1432.7916253424683
"147.32.84.165",2014,"72.20.15.61",80,3,186,3,186,0,0,85247.269366,9.028932000001078,164.80354487106808,0
"147.32.84.165",2015,"174.37.196.55",80,3,186,3,186,0,0,85247.368969,9.029887999990024,164.78609701489586,0
"147.32.84.165",2016,"193.23.181.44",179,11,822,5,462,6,360,85247.469354,0.19595700000354555,18861.28079085272,14697.101914950172
"147.32.84.165",2017,"193.23.181.44",80,9,881,5,437,4,444,85247.535627,0.13092999999935273,26701.2907661902,27129.000229264184
"147.32.84.165",2018,"193.23.181.44",80,8,807,5,421,3,386,85247.601775,0.13406100000429433,25122.891817099036,23034.290359620496
"147.32.84.165",2019,"178.123.248.251",6667,2,124,2,124,0,0,85247.635495,2.9652290000085486,334.54414481887915,0
"147.32.84.165",2020,"67.19.72.206",80,3,186,3,186,0,0,85247.669241,8.930438000010327,166.62116684515132,0
"147.32.84.165",2022,"174.128.246.102",80,3,186,3,186,0,0,85247.871201,9.029471999994712,164.7936889334029,0
"147.32.84.165",2021,"67.19.72.206",80,3,186,3,186,0,0,85247.871312,9.02941999999166,164.79463797246936,0
"147.32.84.165",2023,"174.128.246.102",80,3,186,3,186,0,0,85247.871443,9.029309999998077,164.7966455908942,0
"147.32.84.165",2024,"67.19.72.206",80,3,186,3,186,0,0,85247.938147,8.962632000009762,166.02265941504453,0
"147.32.84.165",2025,"174.128.246.102",80,3,186,3,186,0,0,85247.971155,9.029150999995181,164.79954759874923,0
"147.32.84.165",2026,"193.23.181.44",179,10,751,5,451,5,300,85247.97129,0.19327600000542589,18667.604875404664,12417.475526876717
"147.32.84.165",2027,"174.128.246.102",80,3,186,3,186,0,0,85248.03654,8.963889999999083,165.99935965302478,0
"147.32.84.165",2028,"193.23.181.44",179,3,186,3,186,0,0,85248.071388,9.0299010000017,164.7858597784981,0
"147.32.84.165",2029,"184.82.148.43",80,10,1919,5,979,5,940,85248.795111,0.3404969999974128,23001.671086851016,22085.363454177685
"147.32.84.165",2030,"193.23.181.44",80,8,830,5,446,3,384,85248.974389,0.13965399999869987,25548.85645977356,21997.22170527589
"147.32.84.165",2031,"193.23.181.44",80,3,186,3,186,0,0,85248.974725,9.029762000005576,164.788396416105,0
"147.32.84.165",2032,"174.128.246.102",80,3,186,3,186,0,0,85248.974859,9.029692000010982,164.78967388900864,0
"147.32.84.165",2033,"72.20.15.61",80,7,628,4,446,3,182,85248.97497,0.3885790000058478,9182.174023676793,3746.9858123524136
"147.32.84.165",2034,"174.128.246.102",80,3,186,3,186,0,0,85248.975123,9.029450000001816,164.7940904484438,0
"147.32.84.165",2035,"174.37.196.55",80,3,186,3,186,0,0,85248.97524,9.029355000006035,164.7958242863422,0
"147.32.84.165",2036,"193.23.181.44",179,10,777,5,477,5,300,85248.975355,0.1909040000027744,19989.10447106683,12571.763818281024
"147.32.84.165",2037,"193.23.181.44",179,3,186,3,186,0,0,85248.975469,9.029150000002119,164.79956585056743,0
"147.32.84.165",2038,"193.23.181.44",80,3,186,3,186,0,0,85248.97561,9.02903000000515,164.80175611324265,0
"147.32.84.165",2039,"72.20.15.61",80,7,616,4,434,3,182,85248.975733,0.41074599999410566,8452.912505660004,3544.7697604380664
"147.32.84.165",2040,"184.82.148.44",80,10,1514,5,596,5,918,85249.027366,0.4102710000006482,11621.58670730436,17900.363418297653
"147.32.84.165",2041,"193.23.181.44",179,3,186,3,186,0,0,85249.038752,8.9659110000066,165.96194184828568,0
"147.32.84.165",2042,"193.23.181.44",179,3,186,3,186,0,0,85249.047799,8.956887999986066,166.12912877802145,0
"147.32.84.165",2043,"72.20.15.61",80,3,186,3,186,0,0,85249.075133,9.0290559999994,164.8012815514821,0
"147.32.84.165",2044,"174.128.246.102",80,3,186,3,186,0,0,85249.075327,9.028911000001244,164.80392818134933,0
"147.32.84.165",2045,"67.19.72.206",80,3,186,3,186,0,0,85249.077233,9.02704800000356,164.83794037645674,0
"147.32.84.165",2046,"174.128.246.102",80,3,186,3,186,0,0,85249.077779,9.026549000001978,164.84705284374726,0
"147.32.84.165",2047,"67.19.72.206",80,3,186,3,186,0,0,85249.078526,9.025848999997834,164.85983756213483,0
"147.32.84.165",2048,"193.23.181.44",80,3,186,3,186,0,0,85249.078637,9.025785000005271,164.86100654947253,0
"147.32.84.165",2049,"193.23.181.44",80,3,186,3,186,0,0,85249.078745,9.025727000000188,164.86206595878303,0
"147.32.84.165",2050,"174.37.196.55",80,3,186,3,186,0,0,85249.078853,9.02566499999375,164.86319844587965,0
"147.32.84.165",2052,"193.23.181.44",80,3,186,3,186,0,0,85249.079147,9.025464999998803,164.86685173563882,0
"147.32.84.165",2053,"72.20.15.61",80,3,186,3,186,0,0,85249.079258,9.025399999998626,164.86803908970532,0
"147.32.84.165",2054,"72.20.15.61",80,3,186,3,186,0,0,85249.079366,9.025339999992866,164.86913512412565,0
"147.32.84.165",2055,"174.37.196.55",80,3,186,3,186,0,0,85249.079473,9.02528099999472,164.87021290537885,0
"147.32.84.165",2056,"193.23.181.44",179,3,186,3,186,0,0,85249.079607,9.02519499999471,164.87178393385096,0
"147.32.84.165",2057,"72.20.15.61",80,3,186,3,186,0,0,85249.079717,9.025129999994533,164.8729713589612,0
"147.32.84.165",2058,"174.37.196.55",80,3,186,3,186,0,0,85249.079825,9.025068000002648,164.87410399562236,0
"147.32.84.165",2059,"174.128.246.102",80,3,186,3,186,0,0,85249.079935,9.02500300000247,164.8752914541516,0
"147.32.84.165",2060,"193.23.181.44",179,3,186,3,186,0,0,85249.080042,9.02494299999671,164.87638758500108,0
"147.32.84.165",2061,"193.23.181.44",80,3,186,3,186,0,0,85249.08015,9.024878000011086,164.87757507615862,0
"147.32.84.165",2062,"174.128.246.102",80,3,186,3,186,0,0,85249.080258,9.024816000004648,164.87870777633955,0
"147.32.84.165",2063,"67.19.72.206",80,3,186,3,186,0,0,85249.080376,9.02474500000244,164.88000491976203,0
"147.32.84.165",2064,"193.23.181.44",179,3,186,3,186,0,0,85249.080485,9.02468200000294,164.88115592322424,0
"147.32.84.165",2065,"193.23.181.44",80,3,186,3,186,0,0,85249.080593,9.024620999989565,164.88227040246016,0
"147.32.84.165",2066,"67.19.72.206",80,3,186,3,186,0,0,85249.080706,9.024554000003263,164.88349451944794,0
"147.32.84.165",2067,"174.37.196.55",80,3,186,3,186,0,0,85249.080821,9.02448700000241,164.88471865487787,0
"147.32.84.165",2068,"193.23.181.44",179,3,186,3,186,0,0,85249.080928,9.026343000005,164.85081499774336,0
"147.32.84.165",2069,"193.23.181.44",179,3,186,3,186,0,0,85249.082698,9.027772000001278,164.82472087241342,0
"147.32.84.165",2070,"193.23.181.44",80,3,186,3,186,0,0,85249.085897,9.027788999999757,164.82441049519878,0
"147.32.84.165",2051,"193.23.181.44",179,3,186,3,186,0,0,85249.089096,9.015469000005396,165.04964966316334,0
"147.32.84.165",2071,"67.19.72.206",80,3,186,3,186,0,0,85249.099129,9.017761000010069,165.00769980467862,0
"147.32.84.165",2073,"67.19.72.206",80,3,186,3,186,0,0,85249.118761,9.00130899999931,165.3092900154982,0
"147.32.84.165",2074,"193.23.181.44",179,3,186,3,186,0,0,85249.118874,9.004415999996127,165.25224956295224,0
"147.32.84.165",2075,"67.19.72.206",80,3,186,3,186,0,0,85249.119034,9.007451999990735,165.19655058961519,0
"147.32.84.165",2076,"193.23.181.44",80,3,186,3,186,0,0,85249.119171,9.010519000003114,165.14032099588113,0
"147.32.84.165",2077,"67.19.72.206",80,3,186,3,186,0,0,85249.119286,9.013588999994681,165.08407472327372,0
"147.32.84.165",2078,"72.20.15.61",80,3,186,3,186,0,0,85249.119396,9.016738000005716,165.02642086296137,0
"147.32.84.165",2079,"193.23.181.44",80,3,186,3,186,0,0,85249.121101,9.018169000002672,165.00023452649413,0
"147.32.84.165",2080,"193.23.181.44",179,3,186,3,186,0,0,85249.124298,9.018221999998786,164.99926482184628,0
"147.32.84.165",2081,"193.23.181.44",80,3,186,3,186,0,0,85249.127529,9.01819199998863,164.99981371009576,0
"147.32.84.165",2082,"193.23.181.44",80,3,186,3,186,0,0,85249.130727,9.018193000010797,164.9997954133626,0
"147.32.84.165",2072,"72.20.15.61",80,3,186,3,186,0,0,85249.133896,9.01818899999489,164.99986859898846,0
"147.32.84.165",2084,"174.37.196.55",80,3,186,3,186,0,0,85249.158296,8.996994000000996,165.38857311673604,0
"147.32.84.165",2085,"72.20.15.61",80,3,186,3,186,0,0,85249.161521,8.996962999997777,165.3891429808445,0
"147.32.84.165",2086,"193.23.181.44",80,3,186,3,186,0,0,85249.164696,8.996999999988475,165.3884628211522,0
"147.32.84.165",2083,"67.19.72.206",80,3,186,3,186,0,0,85249.167921,8.997013000000152,165.3882238471785,0
"147.32.84.165",2088,"46.4.36.120",443,6,366,3,186,3,180,85249.171118,1.0354179999994813,1437.1007651023504,1390.7426759055004
"147.32.84.165",2087,"174.37.196.55",80,3,186,3,186,0,0,85249.174372,8.99369800000568,165.44918452888462,0
"147.32.84.165",2089,"193.23.181.44",80,3,186,3,186,0,0,85249.19712,8.97417800000403,165.80905794372828,0
"147.32.84.165",2090,"193.23.181.44",179,3,186,3,186,0,0,85249.219521,8.954947999998694,166.16511899345667,0
"147.32.84.165",2091,"193.23.181.44",179,3,186,3,186,0,0,85249.225984,8.97943399999349,165.71200367429384,0
"147.32.84.165",2092,"174.128.246.102",80,9,684,6,500,3,184,85249.229101,6.31820599999628,633.0911021265142,232.97752558255723
"147.32.84.165",2093,"174.37.196.55",80,3,186,3,186,0,0,85249.232345,8.973096000001533,165.82905164502262,0
"147.32.84.165",2094,"193.23.181.44",80,3,186,3,186,0,0,85249.235544,8.969920000003185,165.88776711492093,0
"147.32.84.165",2095,"193.23.181.44",179,3,186,3,186,0,0,85249.238702,8.96678499999689,165.94576539980787,0
"147.32.84.165",2096,"193.23.181.44",80,3,186,3,186,0,0,85249.241901,8.963608999998542,166.0045635636541,0
"147.32.84.165",2097,"174.128.246.102",80,3,186,3,186,0,0,85249.245101,8.960432000007131,166.0634219420242,0
"147.32.84.165",2098,"193.23.181.44",80,3,186,3,186,0,0,85249.248301,8.958167000004323,166.10540973385312,0
"147.32.84.165",2099,"72.20.15.61",80,3,186,3,186,0,0,85249.251497,8.95817199999874,166.10531702229085,0
"147.32.84.165",2100,"193.23.181.44",179,3,186,3,186,0,0,85249.254729,8.958140000002459,166.1059103786714,0
"147.32.84.165",2101,"72.20.15.61",80,3,186,3,186,0,0,85249.257897,8.95817199999874,166.10531702229085,0
"147.32.84.165",2102,"193.23.181.44",179,3,186,3,186,0,0,85249.261148,8.958119999995688,166.1062812287306,0
"147.32.84.165",2103,"193.23.181.44",80,3,186,3,186,0,0,85249.264298,8.958170000012615,166.10535410668749,0
"147.32.84.165",2104,"67.19.72.206",80,3,186,3,186,0,0,85249.267498,8.958169999998063,166.10535410695732,0
"147.32.84.165",2105,"174.37.196.55",80,3,186,3,186,0,0,85249.270698,8.958189000011771,166.10500180315964,0
"147.32.84.165",2106,"193.23.181.44",80,3,186,3,186,0,0,85249.273897,8.958170999991125,166.10533556475693,0
"147.32.84.165",2107,"174.128.246.102",80,3,186,3,186,0,0,85249.277096,8.958189999990282,166.10498326130772,0
"147.32.84.165",2108,"72.20.15.61",80,3,186,3,186,0,0,85249.280298,8.958221000008052,166.1044084532702,0
"147.32.84.165",2110,"193.23.181.44",80,3,186,3,186,0,0,85249.283549,8.95817199999874,166.10531702229085,0
"147.32.84.165",2111,"174.37.196.55",80,3,186,3,186,0,0,85249.286733,8.958188000004156,166.10502034555532,0
"147.32.84.165",2112,"67.19.72.206",80,3,186,3,186,0,0,85249.289925,8.958164999989094,166.1054468188308,0
"147.32.84.165",2113,"174.37.196.55",80,3,186,3,186,0,0,85249.293143,8.958192999998573,166.10492763442772,0
"147.32.84.165",2114,"174.37.196.55",80,3,186,3,186,0,0,85249.296297,8.958172000013292,166.10531702202104,0
"147.32.84.165",2109,"174.128.246.102",80,3,186,3,186,0,0,85249.299529,8.958141000010073,166.105891836077,0
"147.32.84.165",2116,"67.19.72.206",80,3,186,3,186,0,0,85249.302752,8.958168999990448,166.10537264943167,0
"147.32.84.165",2117,"174.37.196.55",80,3,186,3,186,0,0,85249.305899,8.95819200000551,166.10494617653703,0
"147.32.84.165",2118,"174.37.196.55",80,3,186,3,186,0,0,85249.309097,8.958224999994854,166.10433428506815,0
"147.32.84.165",2119,"174.128.246.102",80,7,550,5,428,2,122,85249.312298,3.2661470000020927,1048.330035359035,298.8230474621548
"147.32.84.165",2120,"174.128.246.102",80,3,186,3,186,0,0,85249.315497,8.955025000002934,166.16369021856585,0
"147.32.84.165",2121,"174.128.246.102",80,3,186,3,186,0,0,85249.318725,8.954972999999882,166.1646551028149,0
"147.32.84.165",2122,"67.19.72.206",80,3,186,3,186,0,0,85249.321898,8.95499800000107,166.16419121476324,0
"147.32.84.165",2115,"72.20.15.61",80,3,186,3,186,0,0,85249.325149,8.9549410000036,166.16524888320333,0
"147.32.84.165",2123,"217.163.21.36",80,14,6138,7,810,7,5328,85249.334745,0.22759900000528432,28471.126849632685,187276.7454998061
"147.32.84.165",2124,"174.37.196.55",80,3,186,3,186,0,0,85249.344349,8.942167999994126,166.4025994592114,0
"147.32.84.165",2125,"72.20.15.61",80,3,186,3,186,0,0,85249.347521,8.942167999994126,166.4025994592114,0
"147.32.84.165",2126,"174.37.196.55",80,3,186,3,186,0,0,85249.350716,8.94220000000496,166.40200398103093,0
"147.32.84.165",2127,"67.19.72.206",80,3,186,3,186,0,0,85249.353919,8.942203999991762,166.40192954682882,0
"147.32.84.165",2128,"193.23.181.44",179,3,186,3,186,0,0,85249.357145,8.942142999992939,166.40306467936992,0
"147.32.84.165",2129,"193.23.181.44",80,3,186,3,186,0,0,85249.360301,8.942234000001918,166.4013712904047,0
"147.32.84.165",2130,"67.19.72.206",80,3,186,3,186,0,0,85249.363518,8.94217199999548,166.40252502420577,0
"147.32.84.165",2131,"193.23.181.44",179,3,186,3,186,0,0,85249.366716,8.942154999997001,166.4028413733042,0
"147.32.84.165",2132,"72.20.15.61",80,3,186,3,186,0,0,85249.369917,8.942161999992095,166.4027111118447,0
"147.32.84.165",2133,"193.23.181.44",80,3,186,3,186,0,0,85249.373117,8.942165000000386,166.40265528537392,0
"147.32.84.165",2134,"193.23.181.44",179,3,186,3,186,0,0,85249.376299,8.942170000009355,166.40256224142945,0
"147.32.84.165",2135,"174.37.196.55",80,3,186,3,186,0,0,85249.379515,8.942181000005803,166.40235754555118,0
"147.32.84.165",2136,"174.37.196.55",80,3,186,3,186,0,0,85249.38272,8.942204000006313,166.40192954655802,0
"147.32.84.165",2137,"174.128.246.102",80,16,2050,12,1802,4,248,85249.385916,93.0959440000006,154.85099973850532,21.311347355798738
"147.32.84.165",2138,"193.23.181.44",179,3,186,3,186,0,0,85249.389115,8.938984000007622,166.46187083439585,0
"147.32.84.165",2139,"193.23.181.44",80,3,186,3,186,0,0,85249.392299,8.938991000002716,166.46174048050256,0
"147.32.84.165",2140,"174.128.246.102",80,3,186,3,186,0,0,85249.395516,8.938968999995268,166.46215016528055,0
"147.32.84.165",2142,"174.128.246.102",80,3,186,3,186,0,0,85249.398751,8.938934000005247,166.4628019402679,0
"147.32.84.165",2141,"193.23.181.44",179,3,186,3,186,0,0,85249.401952,8.93894900000305,166.46252260746675,0
"147.32.84.165",2143,"193.23.181.44",80,3,186,3,186,0,0,85249.405149,8.938920000000508,166.46306265185453,0
"147.32.84.165",2145,"67.19.72.206",80,3,186,3,186,0,0,85249.408316,8.938951999996789,166.46246674112743,0
"147.32.84.165",2144,"193.23.181.44",80,3,186,3,186,0,0,85249.4115,8.938998999990872,166.4615915049906,0
"147.32.84.165",2146,"193.23.181.44",179,3,186,3,186,0,0,85249.414699,8.951797000001534,166.22360851120115,0
"147.32.84.165",2147,"193.23.181.44",80,3,186,3,186,0,0,85249.476705,8.928506000011112,166.65722126391,0
"147.32.84.165",2148,"193.23.181.44",80,3,186,3,186,0,0,85249.477184,8.92808499999228,166.6650799136978,0
"147.32.84.165",2149,"174.128.246.102",80,3,186,3,186,0,0,85249.477458,8.927832000001217,166.66980292637643,0
"147.32.84.165",2150,"174.128.246.102",80,3,186,3,186,0,0,85249.477635,8.927683000001707,166.67258458882506,0
"147.32.84.165",2151,"174.37.196.55",80,3,186,3,186,0,0,85249.477774,8.927567000006093,166.67475024258957,0
"147.32.84.165",2152,"174.128.246.102",80,3,186,3,186,0,0,85249.477902,8.92936799999734,166.64113294473287,0
"147.32.84.165",2153,"174.128.246.102",80,3,186,3,186,0,0,85249.478051,8.932436999995844,166.58387850938018,0
"147.32.84.165",2154,"174.37.196.55",80,3,186,3,186,0,0,85249.47817,8.935505999994348,166.52666340338658,0
"147.32.84.165",2155,"67.19.72.206",80,3,186,3,186,0,0,85249.47909,8.937829000002239,166.48338203825864,0
"147.32.84.165",2156,"193.23.181.44",80,3,186,3,186,0,0,85249.499044,8.921046000003116,166.79658416731405,0
"147.32.84.165",2157,"217.163.21.36",80,10,1449,5,700,5,749,85249.520564,0.15420499999891035,36315.294575659485,38857.36519595565
"147.32.84.165",2158,"67.19.72.206",80,3,186,3,186,0,0,85249.545956,8.877360999991652,167.6173808862115,0
"147.32.84.165",2159,"193.23.181.44",179,3,186,3,186,0,0,85249.578239,8.926872000010917,166.6877266749406,0
"147.32.84.165",2160,"193.23.181.44",179,3,186,3,186,0,0,85249.579451,8.925780999998096,166.70810094940907,0
"147.32.84.165",2161,"72.20.15.61",80,3,186,3,186,0,0,85249.580199,8.925082000001566,166.72115729578044,0
"147.32.84.165",2162,"193.23.181.44",80,3,186,3,186,0,0,85249.580591,8.924732999992557,166.727676895347,0
"147.32.84.165",2163,"193.23.181.44",80,3,186,3,186,0,0,85249.580814,8.924557000005734,166.73096490941163,0
"147.32.84.165",2164,"67.19.72.206",80,3,186,3,186,0,0,85249.581094,8.92432400000689,166.73531799146366,0
"147.32.84.165",2165,"193.23.181.44",179,3,186,3,186,0,0,85249.581319,8.924149999991641,166.73856893949494,0
"147.32.84.165",2166,"67.19.72.206",80,3,186,3,186,0,0,85249.581625,8.923889999990934,166.74342691376876,0
"147.32.84.165",2167,"67.19.72.206",80,3,186,3,186,0,0,85249.581845,8.923718000005465,166.74664080589378,0
"147.32.84.165",2169,"72.20.15.61",80,3,186,3,186,0,0,85249.582177,8.92344499999308,166.75174218041954,0
"147.32.84.165",2170,"174.37.196.55",80,3,186,3,186,0,0,85249.582445,8.92320400000608,166.75624585059202,0
"147.32.84.165",2171,"72.20.15.61",80,3,186,3,186,0,0,85249.582665,8.92303200000606,166.75946023716932,0
"147.32.84.165",2172,"174.128.246.102",80,3,186,3,186,0,0,85249.582881,8.922858999998425,166.76269343718897,0
"147.32.84.165",2173,"67.19.72.206",80,3,186,3,186,0,0,85249.583146,8.922638999996707,166.76680520197547,0
"147.32.84.165",2174,"72.20.15.61",80,3,186,3,186,0,0,85249.584301,8.921530000006896,166.7875353217273,0
"147.32.84.165",2175,"193.23.181.44",80,3,186,3,186,0,0,85249.587503,8.918374000000767,166.84655745541417,0
"147.32.84.165",2176,"174.37.196.55",80,3,186,3,186,0,0,85249.590703,8.915217000001576,166.9056400982429,0
"147.32.84.165",2177,"174.37.196.55",80,3,186,3,186,0,0,85249.593908,8.912059000009322,166.96478333440606,0
"147.32.84.165",2178,"174.37.196.55",80,3,186,3,186,0,0,85249.597119,8.908894000007422,167.02409973659584,0
"147.32.84.165",2179,"193.23.181.44",80,3,186,3,186,0,0,85249.600387,8.905671000000439,167.084546464823,0
"147.32.84.165",2168,"193.23.181.44",179,3,186,3,186,0,0,85249.60352,8.90258399999584,167.14248357563324,0
"147.32.84.165",2180,"193.23.181.44",179,3,186,3,186,0,0,85249.606715,8.899483000001055,167.2007239072004,0
"147.32.84.165",2181,"193.23.181.44",80,3,186,3,186,0,0,85249.609914,8.898958000005223,167.21058802605054,0
"147.32.84.165",2183,"174.128.246.102",80,3,186,3,186,0,0,85249.613119,8.898952999996254,167.21068197580394,0
"147.32.84.165",2184,"67.19.72.206",80,3,186,3,186,0,0,85249.616393,8.898877999992692,167.21209123231287,0
"147.32.84.165",2185,"67.19.72.206",80,3,186,3,186,0,0,85249.619519,8.898952999996254,167.21068197580394,0
"147.32.84.165",2182,"174.128.246.102",80,3,186,3,186,0,0,85249.622719,8.8989489999949,167.2107571355733,0
"147.32.84.165",2186,"217.163.21.35",80,11,3629,6,2000,5,1629,85249.632302,0.3261999999958789,49049.66278418804,39950.95033772116
"147.32.84.165",2188,"174.128.246.102",80,3,186,3,186,0,0,85249.677498,8.928161999996519,166.66364252805676,0
"147.32.84.165",2189,"193.23.181.44",179,3,186,3,186,0,0,85249.677629,8.928130000000237,166.66423988001523,0
"147.32.84.165",2187,"67.19.72.206",80,6,366,3,186,3,180,85249.677736,1.4620250000007218,1017.7664540615006,984.9352781240328
"147.32.84.165",2190,"174.37.196.55",80,3,186,3,186,0,0,85249.777073,8.92971199999738,166.63471341521839,0
"147.32.84.165",2191,"193.23.181.44",80,3,186,3,186,0,0,85249.778352,8.928455000001122,166.65817322255788,0
"147.32.84.165",2192,"193.23.181.44",80,3,186,3,186,0,0,85249.779203,8.927630000005593,166.67357406154466,0
"147.32.84.165",2193,"193.23.181.44",80,3,186,3,186,0,0,85249.779428,8.92742600000929,166.6773827078994,0
"147.32.84.165",2194,"193.23.181.44",80,3,186,3,186,0,0,85249.779687,8.927190000002156,166.68178900635482,0
"147.32.84.165",2195,"193.23.181.44",80,3,186,3,186,0,0,85249.779908,8.926990000007208,166.68552333975936,0
"147.32.84.165",2196,"174.37.196.55",80,3,186,3,186,0,0,85249.780125,8.926796999992803,166.68912713050378,0
"147.32.84.165",2197,"72.20.15.61",80,3,186,3,186,0,0,85249.780345,8.926598999998532,166.69282444526127,0
"147.32.84.165",2198,"193.23.181.44",80,3,186,3,186,0,0,85249.780563,8.926403000004939,166.6964845749376,0
"147.32.84.165",2199,"193.23.181.44",179,3,186,3,186,0,0,85249.781501,8.925489000001107,166.71355485394866,0
"147.32.84.165",2200,"174.37.196.55",80,3,186,3,186,0,0,85249.784701,8.922315000003437,166.7728610791512,0
"147.32.84.165",2202,"193.23.181.44",179,3,186,3,186,0,0,85249.787918,8.919123999992735,166.8325274994733,0
"147.32.84.165",2203,"72.20.15.61",80,3,186,3,186,0,0,85249.791115,8.915949999995064,166.89191841596508,0
"147.32.84.165",2204,"193.23.181.44",80,3,186,3,186,0,0,85249.794346,8.91274300000805,166.9519697806451,0
"147.32.84.165",2205,"72.20.15.61",80,3,186,3,186,0,0,85249.79752,8.909594000011566,167.01097715542014,0
"147.32.84.165",2206,"193.23.181.44",80,3,186,3,186,0,0,85249.800719,8.906418999991729,167.07051397440227,0
"147.32.84.165",2207,"72.20.15.61",80,3,186,3,186,0,0,85249.803899,8.903263000000152,167.1297365920758,0
"147.32.84.165",2208,"67.19.72.206",80,3,186,3,186,0,0,85249.807147,8.900038000007044,167.19029738960916,0
"147.32.84.165",2209,"72.20.15.61",80,3,186,3,186,0,0,85249.810316,8.896892999997362,167.24939818883303,0
"147.32.84.165",2210,"193.23.181.44",80,3,186,3,186,0,0,85249.813514,8.89371800000663,167.30910514577715,0
"147.32.84.165",2211,"72.20.15.61",80,3,186,3,186,0,0,85249.816744,8.890511999998125,167.36943834059431,0
"147.32.84.165",2213,"193.23.181.44",179,3,186,3,186,0,0,85249.819916,8.887363000001642,167.42874123626154,0
"147.32.84.165",2214,"174.37.196.55",80,3,186,3,186,0,0,85249.823102,8.884201000008034,167.48833125214688,0
"147.32.84.165",2215,"193.23.181.44",80,3,186,3,186,0,0,85249.826302,8.881024000002071,167.54824668863105,0
"147.32.84.165",2212,"67.19.72.206",80,3,186,3,186,0,0,85249.829498,8.877850999997463,167.6081294899436,0
"147.32.84.165",2217,"67.19.72.206",80,3,186,3,186,0,0,85249.832698,8.877233000006527,167.61979774541302,0
"147.32.84.165",2218,"174.128.246.102",80,3,186,3,186,0,0,85249.835897,8.877233000006527,167.61979774541302,0
"147.32.84.165",2216,"72.20.15.61",80,3,186,3,186,0,0,85249.839098,8.877231999998912,167.61981662754587,0
"147.32.84.165",2219,"193.23.181.44",80,3,186,3,186,0,0,85249.878027,8.928092999994988,166.66493057373341,0
"147.32.84.165",2220,"174.128.246.102",80,3,186,3,186,0,0,85249.878782,8.92746000000625,166.6767479214646,0
"147.32.84.165",2221,"72.20.15.61",80,3,186,3,186,0,0,85249.879537,8.926768000004813,166.68966864594194,0
"147.32.84.165",2222,"72.20.15.61",80,3,186,3,186,0,0,85249.87979,8.926565999994637,166.6934406804245,0
"147.32.84.165",2223,"174.37.196.55",80,3,186,3,186,0,0,85249.879901,8.926501000009011,166.6946544898721,0
"147.32.84.165",2224,"67.19.72.206",80,3,186,3,186,0,0,85249.880009,8.926441000003251,166.69577494540746,0
"147.32.84.165",2225,"174.128.246.102",80,3,186,3,186,0,0,85249.880118,8.926380999997491,166.69689541600545,0
"147.32.84.165",2226,"193.23.181.44",80,3,186,3,186,0,0,85249.880226,8.926319000005606,166.69805325118512,0
"147.32.84.165",2227,"72.20.15.61",80,3,186,3,186,0,0,85249.880334,8.926258999999845,166.69917375241138,0
"147.32.84.165",2228,"67.19.72.206",80,3,186,3,186,0,0,85249.880471,8.926168999998481,166.7008545323591,0
"147.32.84.165",2229,"72.20.15.61",80,3,186,3,186,0,0,85249.880696,8.925991000010981,166.70417884111347,0
"147.32.84.165",2230,"72.20.15.61",80,3,186,3,186,0,0,85249.883896,8.92283700000553,166.76310460440754,0
"147.32.84.165",2231,"193.23.181.44",80,3,186,3,186,0,0,85249.887098,8.919685000000754,166.82203463461704,0
"147.32.84.165",2232,"174.37.196.55",80,3,186,3,186,0,0,85249.890298,8.916534000003594,166.88098761238393,0
"147.32.84.165",2234,"72.20.15.61",80,3,186,3,186,0,0,85249.902098,8.904781999997795,167.10122718336828,0
"147.32.84.165",2233,"193.23.181.44",179,3,186,3,186,0,0,85249.902208,8.904718999998295,167.10240940789765,0
"147.32.84.165",2235,"67.19.72.206",80,3,186,3,186,0,0,85249.906385,8.900601000001188,167.1797219086443,0
"147.32.84.165",2237,"67.19.72.206",80,3,186,3,186,0,0,85249.906525,8.900508999999147,167.18144995978798,0
"147.32.84.165",2238,"67.19.72.206",80,3,186,3,186,0,0,85249.906633,8.900448999993387,167.182576968994,0
"147.32.84.165",2236,"72.20.15.61",80,3,186,3,186,0,0,85249.909522,8.897604999991017,167.2360146355679,0
"147.32.84.165",2239,"217.163.21.36",80,10,2275,5,1155,5,1120,85249.915945,0.13998999999603257,66004.71462434366,64004.57175693931
"147.32.84.165",2240,"173.192.170.88",80,7,860,4,423,3,437,85249.996122,23.149493999997503,146.1803009603737,151.01841966828204
"147.32.84.165",2241,"217.163.21.35",80,13,5433,7,2515,6,2918,85250.010377,0.3603399999992689,55836.15474285625,64783.2602543358
"147.32.84.165",2242,"174.37.196.55",80,3,186,3,186,0,0,85250.111556,8.895720000000438,167.2714518892149,0
"147.32.84.165",2243,"174.128.246.102",80,3,186,3,186,0,0,85250.1147,8.892691000000923,167.3284273567861,0
"147.32.84.165",2244,"174.37.196.55",80,3,186,3,186,0,0,85250.11793,8.889506000006804,167.3883790616555,0
"147.32.84.165",2245,"67.19.72.206",80,3,186,3,186,0,0,85250.1211,8.886380999989342,167.4472431467641,0
"147.32.84.165",2246,"193.23.181.44",80,3,186,3,186,0,0,85250.124316,8.88321200000064,167.5069783316995,0
"147.32.84.165",2247,"72.20.15.61",80,3,186,3,186,0,0,85250.127521,8.880051999993157,167.56658632192094,0
"147.32.84.165",2249,"174.37.196.55",80,3,186,3,186,0,0,85250.130699,8.876961000001756,167.6249338033259,0
"147.32.84.165",2250,"193.23.181.44",80,3,186,3,186,0,0,85250.133924,8.873780000008992,167.68502261702366,0
"147.32.84.165",2251,"67.19.72.206",80,3,186,3,186,0,0,85250.137098,8.870648999989498,167.74420902030522,0
"147.32.84.165",2248,"193.23.181.44",179,3,186,3,186,0,0,85250.140301,8.86731499999587,167.8072787535678,0
"147.32.84.165",2253,"193.23.181.44",179,3,186,3,186,0,0,85250.14355,8.864242000010563,167.86545313160752,0
"147.32.84.165",2254,"193.23.181.44",179,3,186,3,186,0,0,85250.146745,8.861091999991913,167.92512706124234,0
"147.32.84.165",2252,"193.23.181.44",179,3,186,3,186,0,0,85250.14992,8.857962000009138,167.98446414632,0
"147.32.84.165",2255,"193.23.181.44",80,3,186,3,186,0,0,85250.153111,8.85482099998626,168.04405193535916,0
"147.32.84.165",2256,"174.128.246.102",80,3,186,3,186,0,0,85250.156349,8.851634999999078,168.1045366195234,0
"147.32.84.165",2257,"193.23.181.44",179,3,186,3,186,0,0,85250.159519,8.848511000003782,168.16388655666066,0
"147.32.84.165",2258,"173.241.240.4",80,9,2194,5,1164,4,1030,85250.169119,0.34882400000060443,26695.410866178543,23622.2278283195
"147.32.84.165",2259,"92.240.244.181",80,10,1759,6,1365,4,394,85250.172315,5.140979999996489,2124.1086329858235,613.1126750156882
"147.32.84.165",2261,"72.20.15.61",80,3,186,3,186,0,0,85250.23515,8.872690000003786,167.7056225337936,0
"147.32.84.165",2260,"67.19.72.206",80,3,186,3,186,0,0,85250.238351,8.869547999987844,167.7650315441147,0
"147.32.84.165",2262,"174.128.246.102",80,10,787,7,603,3,184,85250.241545,12.23173100000713,394.38408186030154,120.342738080092
"147.32.84.165",2263,"193.23.181.44",179,3,186,3,186,0,0,85250.244729,8.863224000000628,167.88473359128628,0
"147.32.84.165",2264,"174.128.246.102",80,3,186,3,186,0,0,85250.247945,8.860032000011415,167.9452173534004,0
"147.32.84.165",2265,"174.37.196.55",80,3,186,3,186,0,0,85250.251098,8.856905000007828,168.00451173391664,0
"147.32.84.165",2266,"193.23.181.44",80,3,186,3,186,0,0,85250.254298,8.853728999994928,168.06477812917612,0
"147.32.84.165",2267,"193.23.181.44",179,3,186,3,186,0,0,85250.257498,8.850551999988966,168.1251067732109,0
"147.32.84.165",2268,"193.23.181.44",179,3,186,3,186,0,0,85250.260698,8.84737600000517,168.1854597339517,0
"147.32.84.165",2269,"174.128.246.102",80,7,547,5,425,2,122,85250.263898,3.2419949999894015,1048.7369659765407,301.0491996450305
"147.32.84.165",2270,"174.128.246.102",80,3,186,3,186,0,0,85250.267097,8.84100000000035,168.30675262978636,0
"147.32.84.165",2271,"72.20.15.61",80,3,186,3,186,0,0,85250.270298,8.837826000002678,168.3671979963793,0
"147.32.84.165",2272,"193.23.181.44",179,3,186,3,186,0,0,85250.273497,8.834648999996716,168.42774398853345,0
"147.32.84.165",2274,"67.19.72.206",80,3,186,3,186,0,0,85250.32632,8.781850000013947,169.44037987413094,0
"147.32.84.165",2275,"193.23.181.44",80,3,186,3,186,0,0,85250.329518,8.77867499999411,169.50166169735164,0
"147.32.84.165",2273,"174.37.196.55",80,3,186,3,186,0,0,85250.332721,8.775500000003376,169.56298786387416,0
"147.32.84.165",2276,"174.128.246.102",80,6,488,4,366,2,122,85250.335945,0.40767800000321586,7182.138844816015,2394.046281605338
"147.32.84.165",2277,"72.20.15.61",80,3,186,3,186,0,0,85250.339101,8.769141999990097,169.6859282244124,0
"147.32.84.165",2278,"72.20.15.61",80,3,186,3,186,0,0,85250.34232,8.76594599999953,169.747794476498,0
"147.32.84.165",2279,"174.128.246.102",80,3,186,3,186,0,0,85250.345551,8.762736999997287,169.8099577792259,0
"147.32.84.165",2280,"174.37.196.55",80,3,186,3,186,0,0,85250.348722,8.75959000000148,169.87096428026294,0
"147.32.84.165",2281,"193.23.181.44",80,3,186,3,186,0,0,85250.351948,8.756389000001946,169.9330625900322,0
"147.32.84.165",2282,"193.23.181.44",80,3,186,3,186,0,0,85250.380302,8.827661999996053,168.56105274541156,0
"147.32.84.165",2284,"72.20.15.61",80,3,186,3,186,0,0,85250.383498,8.824592999997549,168.61967458447242,0
"147.32.84.165",2283,"174.128.246.102",80,3,186,3,186,0,0,85250.386702,8.821438999992097,168.67996253234116,0
"147.32.84.165",2285,"67.19.72.206",80,3,186,3,186,0,0,85250.389915,8.818272999997134,168.7405232294899,0
"147.32.84.165",2286,"67.19.72.206",80,3,186,3,186,0,0,85250.393147,8.815088000003016,168.8014912612887,0
"147.32.84.165",2287,"193.23.181.44",80,3,186,3,186,0,0,85250.396347,8.81193899999198,168.8618135011323,0
"147.32.84.165",2288,"67.19.72.206",80,3,186,3,186,0,0,85250.399517,8.808806000000914,168.92187204484304,0
"147.32.84.165",2289,"174.128.246.102",80,3,186,3,186,0,0,85250.40272,8.805649000001722,168.98243388984832,0
"147.32.84.165",2290,"193.23.181.44",179,3,186,3,186,0,0,85250.405947,8.802470999988145,169.04344246087308,0
"147.32.84.165",2292,"174.128.246.102",80,3,186,3,186,0,0,85250.409095,8.799372000008589,169.10297689409512,0
"147.32.84.165",2293,"67.19.72.206",80,3,186,3,186,0,0,85250.412351,8.79616199999873,169.16468796279727,0
"147.32.84.165",2294,"174.37.196.55",80,3,186,3,186,0,0,85250.415527,8.793032999994466,169.2248852018338,0
"147.32.84.165",2295,"174.128.246.102",80,3,186,3,186,0,0,85250.418751,8.789854999995441,169.28606899667534,0
"147.32.84.165",2296,"174.128.246.102",80,3,186,3,186,0,0,85250.421948,8.786704999991343,169.34675740240124,0
"147.32.84.165",2297,"72.20.15.61",80,3,186,3,186,0,0,85250.425153,8.783547999992152,169.40762434511993,0
"147.32.84.165",2299,"67.19.72.206",80,3,186,3,186,0,0,85250.428325,8.780423000003793,169.46791743397296,0
"147.32.84.165",2300,"67.19.72.206",80,3,186,3,186,0,0,85250.431524,8.777316000006977,169.52790579703606,0
"147.32.84.165",2298,"72.20.15.61",80,3,186,3,186,0,0,85250.434749,8.774144000009983,169.58919297407326,0
"147.32.84.165",2301,"67.19.72.206",80,3,186,3,186,0,0,85250.447498,8.860899999999674,167.9287657010072,0
"147.32.84.165",2302,"193.23.181.44",80,3,186,3,186,0,0,85250.450698,8.857759000005899,167.98831397411118,0
"147.32.84.165",2303,"72.20.15.61",80,3,186,3,186,0,0,85250.453898,8.854582999993,168.04856874696148,0
"147.32.84.165",2304,"193.23.181.44",80,3,186,3,186,0,0,85250.457098,8.851406999994651,168.1088667599286,0
"147.32.84.165",2305,"193.23.181.44",80,3,186,3,186,0,0,85250.460296,8.848230999996304,168.1692080598508,0
"147.32.84.165",2306,"174.128.246.102",80,3,186,3,186,0,0,85250.463527,8.845023999994737,168.23018230373205,0
"147.32.84.165",2307,"174.128.246.102",80,3,186,3,186,0,0,85250.46673,8.841845999995712,168.29064880803415,0
"147.32.84.165",2308,"193.23.181.44",80,3,186,3,186,0,0,85250.469929,8.838669000004302,168.3511397473167,0
"147.32.84.165",2309,"193.23.181.44",80,3,186,3,186,0,0,85250.473128,8.835493000005954,168.41165512767623,0
"147.32.84.165",2310,"193.23.181.44",179,3,186,3,186,0,0,85250.476326,8.832318000000669,168.47219495492433,0
"147.32.84.165",2311,"174.37.196.55",80,3,186,3,186,0,0,85250.479515,8.829152000005706,168.532606528808,0
"147.32.84.165",2313,"72.20.15.61",80,3,186,3,186,0,0,85250.482697,8.825993000005838,168.59292773051325,0
"147.32.84.165",2314,"174.37.196.55",80,3,186,3,186,0,0,85250.485899,8.82281499999226,168.6536553244407,0
"147.32.84.165",2315,"72.20.15.61",80,3,186,3,186,0,0,85250.489116,8.819621000002371,168.71473275321014,0
"147.32.84.165",2316,"67.19.72.206",80,3,186,3,186,0,0,85250.492346,8.816414999993867,168.77608415677292,0
"147.32.84.165",2317,"67.19.72.206",80,3,186,3,186,0,0,85250.495497,8.813286999997217,168.83598593810345,0
"147.32.84.165",2318,"174.128.246.102",80,3,186,3,186,0,0,85250.498719,8.810087999998359,168.89729137782473,0
"147.32.84.165",2319,"72.20.15.61",80,3,186,3,186,0,0,85250.501897,8.806934000007459,168.95777804156813,0
"147.32.84.165",2321,"193.23.181.44",179,3,186,3,186,0,0,85250.505116,8.80373800000234,169.01911438068743,0
"147.32.84.165",2322,"193.23.181.44",179,3,186,3,186,0,0,85250.508317,8.800560000003316,169.08014944497162,0
"147.32.84.165",2320,"67.19.72.206",80,3,186,3,186,0,0,85250.51155,8.797351000001072,169.14182462423275,0
"147.32.84.165",2323,"193.23.181.44",80,3,186,3,186,0,0,85250.514738,8.794185999999172,169.20269823723766,0
"147.32.84.165",2324,"174.37.196.55",80,3,186,3,186,0,0,85250.521118,8.887017000000924,167.43525977275,0
"147.32.84.165",2325,"174.128.246.102",80,3,186,3,186,0,0,85250.524324,8.88386200000241,167.49472245286975,0
"147.32.84.165",2326,"174.128.246.102",80,3,186,3,186,0,0,85250.527501,8.880733999991207,167.55371796987424,0
"147.32.84.165",2327,"72.20.15.61",80,3,186,3,186,0,0,85250.530756,8.877528000011807,167.61422774425728,0
"147.32.84.165",2328,"72.20.15.61",80,3,186,3,186,0,0,85250.533903,8.87442700000247,167.6727973535177,0
"147.32.84.165",2329,"193.23.181.44",80,3,186,3,186,0,0,85250.537103,8.871274999997695,167.73237217878903,0
"147.32.84.165",2330,"67.19.72.206",80,3,186,3,186,0,0,85250.540303,8.868121999999858,167.79200827413334,0
"147.32.84.165",2331,"193.23.181.44",179,3,186,3,186,0,0,85250.543504,8.86496900000202,167.85168679097026,0
"147.32.84.165",2332,"193.23.181.44",179,3,186,3,186,0,0,85250.546703,8.861816000004183,167.91140777458003,0
"147.32.84.165",2333,"193.23.181.44",179,3,186,3,186,0,0,85250.549899,8.858666999993147,167.97109542566065,0
"147.32.84.165",2334,"72.20.15.61",80,3,186,3,186,0,0,85250.553135,8.855479000005289,168.03156554254278,0
"147.32.84.165",2338,"72.20.15.61",80,3,186,3,186,0,0,85250.556299,8.852375999995274,168.09046520400787,0
"147.32.84.165",2337,"174.128.246.102",80,3,186,3,186,0,0,85250.559498,8.849224999998114,168.15031824824402,0
"147.32.84.165",2336,"193.23.181.44",179,3,186,3,186,0,0,85250.5627,8.846071000007214,168.2102709777919,0
"147.32.84.165",2335,"193.23.181.44",179,3,186,3,186,0,0,85250.565899,8.84291900000244,168.27022841661102,0
"147.32.84.165",2340,"193.23.181.44",80,3,186,3,186,0,0,85250.569099,8.839766999997664,168.3302286135362,0
"147.32.84.165",2339,"67.19.72.206",80,3,186,3,186,0,0,85250.572299,8.836613999999827,168.3902906701627,0
"147.32.84.165",2342,"72.20.15.61",80,3,186,3,186,0,0,85250.575519,8.833505999995396,168.44953747705335,0
"147.32.84.165",2341,"174.37.196.55",80,3,186,3,186,0,0,85250.578703,8.830374999990454,168.50926489550088,0
"147.32.84.165",2343,"193.23.181.44",80,3,186,3,186,0,0,85250.597501,8.811624000009033,168.86785001249197,0
"147.32.84.165",2344,"174.128.246.102",80,3,186,3,186,0,0,85250.60713,8.901684999989811,167.15936364875898,0
"147.32.84.165",2345,"72.20.15.61",80,3,186,3,186,0,0,85250.610336,8.898503999997047,167.21911907894787,0
"147.32.84.165",2346,"72.20.15.61",80,3,186,3,186,0,0,85250.613498,8.895367999997688,167.27807101408135,0
"147.32.84.165",2347,"67.19.72.206",80,3,186,3,186,0,0,85250.616698,8.892193000006955,167.3377984484633,0
"147.32.84.165",2348,"72.20.15.61",80,3,186,3,186,0,0,85250.619898,8.889020000002347,167.39753088637522,0
"147.32.84.165",2349,"193.23.181.44",80,3,186,3,186,0,0,85250.623098,8.885844000003999,167.4573625194557,0
"147.32.84.165",2350,"174.128.246.102",80,3,186,3,186,0,0,85250.626332,8.882668000005651,167.51723693816467,0
"147.32.84.165",2351,"174.128.246.102",80,3,186,3,186,0,0,85250.62953,8.879497999994783,167.5770409544407,0
"147.32.84.165",2352,"67.19.72.206",80,3,186,3,186,0,0,85250.6327,8.87635500000033,167.63637776992297,0
"147.32.84.165",2353,"193.23.181.44",80,3,186,3,186,0,0,85250.635926,8.873154000000795,167.69685277634838,0
"147.32.84.165",2354,"174.37.196.55",80,7,567,4,385,3,182,85250.639097,0.24236099999689031,12708.315281912184,6007.567224176669
"147.32.84.165",2355,"174.128.246.102",80,3,186,3,186,0,0,85250.642346,8.86675900001137,167.8178012956134,0
"147.32.84.165",2356,"193.23.181.44",80,3,186,3,186,0,0,85250.645498,8.863633000000846,167.87698678407128,0
"147.32.84.165",2357,"193.23.181.44",80,3,186,3,186,0,0,85250.680728,8.928337999997893,166.66035716841714,0
"147.32.84.165",2358,"193.23.181.44",80,3,186,3,186,0,0,85250.681023,8.928167000005487,166.66354919202178,0
"147.32.84.165",2359,"67.19.72.206",80,3,186,3,186,0,0,85250.681147,8.928091000008862,166.6649679084278,0
"147.32.84.165",2360,"193.23.181.44",179,3,186,3,186,0,0,85250.761671,8.847613000005367,168.18095456922646,0
"147.32.84.165",2361,"67.19.72.206",80,3,186,3,186,0,0,85250.782713,8.926464000003762,166.69534543570364,0
"147.32.84.165",2362,"193.23.181.44",80,3,186,3,186,0,0,85250.783358,8.92587099999946,166.7064200233333,0
"147.32.84.165",2363,"193.23.181.44",179,3,186,3,186,0,0,85250.783828,8.925445000000764,166.71437670613315,0
"147.32.84.165",2364,"193.23.181.44",80,3,186,3,186,0,0,85250.80257,8.90675100000226,167.0642864047308,0
"147.32.84.165",2365,"174.37.196.55",80,3,186,3,186,0,0,85250.802684,8.906684000001405,167.06554313589268,0
"147.32.84.165",2366,"67.19.72.206",80,3,186,3,186,0,0,85250.802792,8.906619000001228,167.06676237074862,0
"147.32.84.165",2367,"193.23.181.44",179,3,186,3,186,0,0,85250.8029,8.906560000003083,167.06786907621853,0
"147.32.84.165",2368,"193.23.181.44",80,3,186,3,186,0,0,85250.803008,8.906501999998,167.06895703838995,0
"147.32.84.165",2369,"193.23.181.44",80,3,186,3,186,0,0,85250.803117,8.9064389999985,167.07013880634568,0
"147.32.84.165",2370,"67.19.72.206",80,3,186,3,186,0,0,85250.803226,8.906376999992062,167.07130183253258,0
"147.32.84.165",2371,"72.20.15.61",80,3,186,3,186,0,0,85250.803333,8.906317999993917,167.0724085981453,0
"147.32.84.165",2372,"72.20.15.61",80,3,186,3,186,0,0,85250.80344,8.906256999995094,167.07355289666802,0
"147.32.84.165",2373,"193.23.181.44",179,3,186,3,186,0,0,85250.803547,8.906195999996271,167.07469721086568,0
"147.32.84.165",2374,"174.37.196.55",80,3,186,3,186,0,0,85250.803665,8.906122999993386,167.07606665673774,0
"147.32.84.165",2375,"193.23.181.44",179,3,186,3,186,0,0,85250.803773,8.906060999986948,167.07722976545756,0
"147.32.84.165",2376,"174.128.246.102",80,3,186,3,186,0,0,85250.803907,8.90597200000775,167.07889941700975,0
"147.32.84.165",2377,"193.23.181.44",80,3,186,3,186,0,0,85250.804015,8.905908999993699,167.08008132589868,0
"147.32.84.165",2378,"193.23.181.44",80,3,186,3,186,0,0,85250.804123,8.905847000001813,167.081244490243,0
"147.32.84.165",2379,"193.23.181.44",80,3,186,3,186,0,0,85250.804231,8.905788000003668,167.08235138759053,0
"147.32.84.165",2380,"67.19.72.206",80,3,186,3,186,0,0,85250.804338,8.905729000005522,167.0834582996044,0
"147.32.84.165",2381,"174.128.246.102",80,3,186,3,186,0,0,85250.804445,8.905667999992147,167.08460274976701,0
"147.32.84.165",2383,"193.23.181.44",179,3,186,3,186,0,0,85250.822041,8.88812199998938,167.41444368132863,0
"147.32.84.165",2382,"193.23.181.44",80,3,186,3,186,0,0,85250.822152,8.88805800001137,167.41564917759274,0
"147.32.84.165",2384,"72.20.15.61",80,3,186,3,186,0,0,85250.882083,8.927711999989697,166.6720431843811,0
"147.32.84.165",2385,"193.23.181.44",179,3,186,3,186,0,0,85250.883559,8.926295000012033,166.69850144970496,0
"147.32.84.165",2387,"193.23.181.44",80,3,186,3,186,0,0,85250.8848,8.925075000006473,166.72128805628196,0
"147.32.84.165",2388,"174.128.246.102",80,3,186,3,186,0,0,85250.885022,8.924872999996296,166.72506152195302,0
"147.32.84.165",2389,"193.23.181.44",80,3,186,3,186,0,0,85250.885239,8.924683000004734,166.72861097690648,0
"147.32.84.165",2390,"174.37.196.55",80,3,186,3,186,0,0,85250.885457,8.924486000003526,166.73229136102765,0
"147.32.84.165",2391,"67.19.72.206",80,3,186,3,186,0,0,85250.885673,8.924291999996058,166.7359158576005,0
"147.32.84.165",2392,"174.128.246.102",80,3,186,3,186,0,0,85250.885895,8.924090000000433,166.73968998518927,0
"147.32.84.165",2393,"174.128.246.102",80,3,186,3,186,0,0,85250.886114,8.923894999999902,166.7433334883497,0
"147.32.84.165",2395,"72.20.15.61",80,3,186,3,186,0,0,85250.886406,8.923625999988872,166.74835991578487,0
"147.32.84.165",2396,"174.37.196.55",80,3,186,3,186,0,0,85250.886624,8.923429999995278,166.75202248471578,0
"147.32.84.165",2397,"174.128.246.102",80,3,186,3,186,0,0,85250.886842,8.923234999994747,166.75566652686788,0
"147.32.84.165",2398,"174.128.246.102",80,3,186,3,186,0,0,85250.887057,8.92304399999557,166.75923597381552,0
"147.32.84.165",2399,"72.20.15.61",80,3,186,3,186,0,0,85250.887272,8.92285199998878,166.76282426312474,0
"147.32.84.165",2400,"72.20.15.61",80,3,186,3,186,0,0,85250.887489,8.922661000004155,166.76639401623655,0
"147.32.84.165",2401,"67.19.72.206",80,3,186,3,186,0,0,85250.887704,8.922469000011915,166.76998261333415,0
"147.32.84.165",2394,"174.128.246.102",80,3,186,3,186,0,0,85250.887916,8.922279999998864,166.77351528983505,0
"147.32.84.165",2402,"193.23.181.44",179,3,186,3,186,0,0,85250.981821,8.927666000003228,166.67290196558227,0
"147.32.84.165",2403,"193.23.181.44",179,3,186,3,186,0,0,85250.982016,8.927537000010489,166.67531033455833,0
"147.32.84.165",2404,"67.19.72.206",80,3,186,3,186,0,0,85250.982977,8.926596999997855,166.69286179272544,0
"147.32.84.165",2405,"67.19.72.206",80,3,186,3,186,0,0,85250.983305,8.926290000003064,166.69859482489244,0
"147.32.84.165",2406,"67.19.72.206",80,3,186,3,186,0,0,85250.983457,8.926162000003387,166.70098526101535,0
"147.32.84.165",2407,"193.23.181.44",80,3,186,3,186,0,0,85250.983579,8.9260629999917,166.70283416119554,0
"147.32.84.165",2408,"174.37.196.55",80,3,186,3,186,0,0,85250.983696,8.925973000004888,166.70451501468636,0
"147.32.84.165",2409,"174.37.196.55",80,3,186,3,186,0,0,85250.983815,8.925877999994555,166.7062892861529,0
"147.32.84.165",2410,"193.23.181.44",80,3,186,3,186,0,0,85250.983936,8.925777999989805,166.70815698101606,0
"147.32.84.165",2411,"193.23.181.44",179,3,186,3,186,0,0,85250.984052,8.925682999994024,166.7099313297365,0
"147.32.84.165",2412,"67.19.72.206",80,3,186,3,186,0,0,85250.984168,8.92558999999892,166.71166836031904,0
"147.32.84.165",2414,"193.23.181.44",179,3,186,3,186,0,0,85250.993379,8.916401999988011,166.88345814847747,0
"147.32.84.165",2415,"72.20.15.61",80,3,186,3,186,0,0,85250.993491,8.916312999994261,166.8851239296958,0
"147.32.84.165",2413,"193.23.181.44",179,3,186,3,186,0,0,85250.993597,8.916230000002543,166.8866774409785,0
"147.32.84.165",2416,"193.23.181.44",179,3,186,3,186,0,0,85251.08614,8.924215999999433,166.7373358063156,0
"147.32.84.165",2417,"193.23.181.44",179,3,186,3,186,0,0,85251.086805,8.923611000005621,166.74864020843833,0
"147.32.84.165",2418,"72.20.15.61",80,3,186,3,186,0,0,85251.08693,8.923506999999518,166.7505835990357,0
"147.32.84.165",2419,"174.37.196.55",80,3,186,3,186,0,0,85251.087076,8.923388000010164,166.7528073415955,0
"147.32.84.165",2420,"174.128.246.102",80,3,186,3,186,0,0,85251.087186,8.923301000002539,166.7544331407824,0
"147.32.84.165",2421,"174.37.196.55",80,3,186,3,186,0,0,85251.087337,8.923171000002185,166.7568625547617,0
"147.32.84.165",2422,"193.23.181.44",179,3,186,3,186,0,0,85251.087447,8.923083000001498,166.75850712133354,0
"147.32.84.165",2423,"67.19.72.206",80,3,186,3,186,0,0,85251.087555,8.922998999987612,166.7600769653864,0
"147.32.84.165",2424,"67.19.72.206",80,3,186,3,186,0,0,85251.087672,8.922902999998769,166.76187110856247,0
"147.32.84.165",2425,"174.128.246.102",80,3,186,3,186,0,0,85251.087786,8.922809999989113,166.7636092219621,0
"147.32.84.165",2426,"67.19.72.206",80,3,186,3,186,0,0,85251.087906,8.92271400000027,166.76540344114528,0
"147.32.84.165",2427,"174.37.196.55",80,3,186,3,186,0,0,85251.088025,8.922617999996874,166.76719769920908,0
"147.32.84.165",2428,"67.19.72.206",80,3,186,3,186,0,0,85251.088135,8.922529999996186,166.76884246963988,0
"147.32.84.165",2429,"67.19.72.206",80,3,186,3,186,0,0,85251.088243,8.922449999998207,166.7703377435905,0
"147.32.84.165",2431,"174.37.196.55",80,3,186,3,186,0,0,85251.088381,8.922334000002593,166.7725059384201,0
"147.32.84.165",2432,"67.19.72.206",80,3,186,3,186,0,0,85251.08849,8.922246000001905,166.77415081355997,0
"147.32.84.165",2433,"193.23.181.44",179,3,186,3,186,0,0,85251.088599,8.922158000001218,166.77579572114692,0
"147.32.84.165",2434,"193.23.181.44",179,3,186,3,186,0,0,85251.088709,8.922074000001885,166.77736589045168,0
"147.32.84.165",2435,"67.19.72.206",80,3,186,3,186,0,0,85251.088817,8.921990000002552,166.77893608932249,0
"147.32.84.165",2430,"67.19.72.206",80,3,186,3,186,0,0,85251.088923,8.921904999995604,166.78052501127652,0
"147.32.84.165",2436,"174.128.246.102",80,3,186,3,186,0,0,85251.089143,8.92170599999372,166.7842450761152,0
"147.32.84.165",2437,"174.128.246.102",80,3,186,3,186,0,0,85251.089448,8.92142500000773,166.78949831430637,0
"147.32.84.165",2438,"72.20.15.61",80,3,186,3,186,0,0,85251.140269,8.870625000010477,167.74466286177608,0
"147.32.84.165",2439,"67.19.72.206",80,3,186,3,186,0,0,85251.183042,8.92702499999723,166.68486981950446,0
"147.32.84.165",2440,"174.128.246.102",80,3,186,3,186,0,0,85251.183315,8.926865000001271,166.68785738327935,0
"147.32.84.165",2441,"72.20.15.61",80,3,186,3,186,0,0,85251.183429,8.92679599999974,166.68914580326953,0
"147.32.84.165",2442,"174.128.246.102",80,3,186,3,186,0,0,85251.183561,8.926703999997699,166.69086372757332,0
"147.32.84.165",2443,"193.23.181.44",80,3,186,3,186,0,0,85251.192521,8.917786999998498,166.85753988071824,0
"147.32.84.165",2444,"46.4.36.120",443,6,366,3,186,3,180,85251.206469,1.0062760000000708,1478.719556066025,1431.0189252251855
"147.32.84.165",2445,"174.128.246.102",80,3,186,3,186,0,0,85251.28275,8.928211999998894,166.66270917404117,0
"147.32.84.165",2446,"72.20.15.61",80,3,186,3,186,0,0,85251.283126,8.92785800001002,166.6693175449621,0
"147.32.84.165",2447,"67.19.72.206",80,3,186,3,186,0,0,85251.283388,8.927621000009822,166.67374208631426,0
"147.32.84.165",2448,"174.128.246.102",80,3,186,3,186,0,0,85251.283664,8.927368000004208,166.67846559022757,0
"147.32.84.165",2449,"174.128.246.102",80,3,186,3,186,0,0,85251.382741,8.928596000012476,166.6555413637173,0
"147.32.84.165",2450,"67.19.72.206",80,3,186,3,186,0,0,85251.382952,8.928507000004174,166.65720259829604,0
"147.32.84.165",2451,"174.128.246.102",80,3,186,3,186,0,0,85251.483254,8.928901999999653,166.64982995670218,0
"147.32.84.165",2452,"72.20.15.61",80,3,186,3,186,0,0,85251.885007,8.928055999989738,166.6656212731764,0
"147.32.84.165",2453,"174.37.196.55",80,3,186,3,186,0,0,85251.885141,8.92804499999329,166.6658266172626,0
"147.32.84.165",2454,"174.37.196.55",80,3,186,3,186,0,0,85252.156372,8.85679400000663,168.00661729276825,0
"147.32.84.165",2455,"174.128.246.102",80,3,186,3,186,0,0,85252.159542,8.853749000001699,168.0643984824637,0
"147.32.84.165",2457,"193.23.181.44",80,3,186,3,186,0,0,85252.268351,8.845765999998548,168.21607082984607,0
"147.32.84.165",2456,"174.37.196.55",80,3,186,3,186,0,0,85252.271551,8.842625999997836,168.27580404286738,0
"147.32.84.165",2458,"67.19.72.206",80,3,186,3,186,0,0,85252.274721,8.839477000001352,168.33575108570025,0
"147.32.84.165",2459,"193.23.181.44",80,3,186,3,186,0,0,85252.277921,8.836299000002327,168.39629351605328,0
"147.32.84.165",2460,"72.20.15.61",80,3,186,3,186,0,0,85252.281121,8.83312599999772,168.45678415550557,0
"147.32.84.165",2461,"67.19.72.206",80,3,186,3,186,0,0,85252.28432,8.829948999991757,168.51739460798575,0
"147.32.84.165",2462,"193.23.181.44",179,3,186,3,186,0,0,85252.287521,8.826768999992055,168.5781059866118,0
"147.32.84.165",2463,"67.19.72.206",80,3,186,3,186,0,0,85252.290721,8.823589999999967,168.63884201328545,0
"147.32.84.165",2464,"193.23.181.44",179,3,186,3,186,0,0,85252.361173,8.853407000002335,168.07089067515,0
"147.32.84.165",2465,"193.23.181.44",179,3,186,3,186,0,0,85252.364374,8.850252999996883,168.1307867696578,0
"147.32.84.165",2466,"193.23.181.44",179,3,186,3,186,0,0,85252.367522,8.847150999994483,168.18973701261885,0
"147.32.84.165",2467,"193.23.181.44",179,3,186,3,186,0,0,85252.370721,8.844001000004937,168.2496417627236,0
"147.32.84.165",2468,"193.23.181.44",179,3,186,3,186,0,0,85252.37394,8.840826999992714,168.3100461078162,0
"147.32.84.165",2469,"72.20.15.61",80,3,186,3,186,0,0,85252.377139,8.837675000002491,168.3700747085156,0
"147.32.84.165",2470,"193.23.181.44",179,3,186,3,186,0,0,85252.380322,8.834537999995518,168.42986016934387,0
"147.32.84.165",2471,"193.23.181.44",80,3,186,3,186,0,0,85252.399922,8.81498000001011,168.80355939529,0
"147.32.84.165",2472,"72.20.15.61",80,3,186,3,186,0,0,85252.406339,8.909078000011505,167.02065017256314,0
"147.32.84.165",2473,"174.128.246.102",80,3,186,3,186,0,0,85252.409541,8.90589799999725,167.0802876925448,0
"147.32.84.165",2474,"67.19.72.206",80,3,186,3,186,0,0,85252.412725,8.902740000004997,167.13955478865662,0
"147.32.84.165",2475,"174.128.246.102",80,3,186,3,186,0,0,85252.415941,8.899548000001232,167.19950271629457,0
"147.32.84.165",2476,"174.128.246.102",80,3,186,3,186,0,0,85252.434725,8.880785000001197,167.552755752988,0
"147.32.84.165",2477,"193.23.181.44",179,3,186,3,186,0,0,85252.687254,8.928446999998414,166.65832255041266,0
"147.32.84.165",2478,"67.19.72.206",80,3,186,3,186,0,0,85252.687514,8.928235999992467,166.66226116796818,0
"147.32.84.165",2479,"174.37.196.55",80,7,563,4,381,3,182,85252.68766,0.2556530000001658,11922.410454788418,5695.219692313628
"147.32.84.165",2480,"193.23.181.44",179,3,186,3,186,0,0,85252.796713,8.919389999995474,166.82755210846875,0
"147.32.84.165",2481,"174.37.196.55",80,3,186,3,186,0,0,85252.799897,8.916226999994251,166.88673359269112,0
"147.32.84.165",2482,"67.19.72.206",80,3,186,3,186,0,0,85252.803095,8.91305000000284,166.9462193075912,0
"147.32.84.165",2483,"174.128.246.102",80,3,186,3,186,0,0,85252.806479,8.90969299999415,167.00912141428185,0
"147.32.84.165",2484,"193.23.181.44",179,3,186,3,186,0,0,85252.809493,8.906700999999885,167.06522426204936,0
"147.32.84.165",2485,"67.19.72.206",80,3,186,3,186,0,0,85252.812693,8.90352300000086,167.12485608223355,0
"147.32.84.165",2486,"193.23.181.44",179,3,186,3,186,0,0,85252.815893,8.90034399999422,167.18454927146257,0
"147.32.84.165",2487,"174.37.196.55",80,3,186,3,186,0,0,85252.835493,8.880767999988166,167.55307649090517,0
"147.32.84.165",2488,"72.20.15.61",80,3,186,3,186,0,0,85253.088722,8.928167000005487,166.66354919202178,0
"147.32.84.165",2489,"193.23.181.44",80,3,186,3,186,0,0,85253.189728,8.92743199999677,166.67727068663623,0
"147.32.84.165",2490,"46.4.36.120",443,6,366,3,186,3,180,85253.213429,1.0054700000036974,1479.9049200816814,1432.1660516919499
"147.32.84.165",2491,"174.37.196.55",80,3,186,3,186,0,0,85253.290515,8.927028999998583,166.68479513175504,0
"147.32.84.165",2492,"193.23.181.44",179,3,186,3,186,0,0,85253.290819,8.926748999991105,166.69002343422926,0
"147.32.84.165",2493,"67.19.72.206",80,3,186,3,186,0,0,85253.291132,8.926460000002407,166.69542013290808,0
"147.32.84.165",2494,"193.23.181.44",80,3,186,3,186,0,0,85253.348458,8.869157000008272,167.77242752593196,0
"147.32.84.165",2495,"174.37.196.55",80,3,186,3,186,0,0,85253.390474,8.927198000004864,166.68163963644463,0
"147.32.84.165",2496,"193.23.181.44",80,3,186,3,186,0,0,85253.390672,8.927050000012969,166.68440302203285,0
"147.32.84.165",2497,"67.19.72.206",80,3,186,3,186,0,0,85253.390796,8.926969999985886,166.68589678271044,0
"147.32.84.165",2498,"72.20.15.61",80,3,186,3,186,0,0,85253.407155,8.91065800000797,166.99103478089597,0
"147.32.84.165",2499,"67.19.72.206",80,3,186,3,186,0,0,85253.489893,8.928878999999142,166.650259231886,0
"147.32.84.165",2500,"174.37.196.55",80,7,602,4,420,3,182,85253.690593,0.24581499998748768,13668.815980192538,5923.153591416766
"147.32.84.165",2501,"174.37.196.55",80,3,186,3,186,0,0,85253.792444,8.926173999992898,166.70076115491182,0
"147.32.84.165",2502,"72.20.15.61",80,3,186,3,186,0,0,85253.792657,8.926084000006085,166.70244196659874,0
"147.32.84.165",2503,"193.23.181.44",179,3,186,3,186,0,0,85253.792776,8.926026999994065,166.70350649857875,0
"147.32.84.165",2504,"193.23.181.44",179,3,186,3,186,0,0,85253.79455,8.924300999991829,166.7357477074521,0
"147.32.84.165",2505,"174.37.196.55",80,3,186,3,186,0,0,85253.79775,8.921151999995345,166.79460231153737,0
"147.32.84.165",2506,"174.128.246.102",80,3,186,3,186,0,0,85253.800949,8.918021000004956,166.85316170472947,0
"147.32.84.165",2507,"193.23.181.44",80,3,186,3,186,0,0,85253.804171,8.91487400000915,166.91206179677613,0
"147.32.84.165",2509,"174.128.246.102",80,3,186,3,186,0,0,85253.80737,8.9117350000015,166.97085359918688,0
"147.32.84.165",2510,"174.128.246.102",80,3,186,3,186,0,0,85253.829001,8.890151999992668,167.37621583986723,0
"147.32.84.165",2511,"174.128.246.102",80,3,186,3,186,0,0,85254.093733,8.926240999993752,166.69950990579815,0
"147.32.84.165",2512,"174.128.246.102",80,3,186,3,186,0,0,85254.593101,8.928450999999768,166.65824788645182,0
"147.32.84.165",2513,"193.23.181.44",80,3,186,3,186,0,0,85255.095034,9.028195999999298,164.81698004785406,0
"147.32.84.165",2514,"174.128.246.102",80,3,186,3,186,0,0,85255.19608,9.028424000003724,164.81281782948898,0
"147.32.84.165",2515,"46.4.36.120",443,6,366,3,186,3,180,85255.219212,1.0063130000053206,1478.6651866686932,1430.9663096793804
"147.32.84.165",2516,"72.20.15.61",80,3,186,3,186,0,0,85255.295789,8.928741000010632,166.65283492916058,0
"147.32.84.165",2517,"174.128.246.102",80,3,186,3,186,0,0,85255.396106,8.927471000002697,166.6765425504659,0
"147.32.84.165",2518,"193.23.181.44",179,3,186,3,186,0,0,85255.798095,8.927170999988448,166.6821437611003,0
"147.32.84.165",2519,"72.20.15.61",80,3,186,3,186,0,0,85256.499383,8.928294999990612,166.66115982968356,0
"147.32.84.165",2520,"193.23.181.44",80,3,186,3,186,0,0,85256.600986,8.927029999991646,166.684776459964,0
"147.32.84.165",2521,"184.82.148.43",80,10,1919,5,979,5,940,85257.026798,0.3408659999986412,22976.770930603878,22061.455234696266
"147.32.84.165",2522,"46.4.36.120",443,6,366,3,186,3,180,85257.225754,1.0070470000064233,1477.5874412917262,1429.9233302823156
"147.32.84.165",2523,"184.82.148.44",80,10,1513,5,596,5,917,85257.258506,0.32179200000246055,14817.0246617801,22797.334924248913
"147.32.84.165",2524,"217.163.21.36",80,13,6077,6,749,7,5328,85257.485105,0.1963030000042636,30524.240586592445,217133.71674948538
"147.32.84.165",2525,"217.163.21.36",80,10,1448,5,699,5,749,85257.639037,0.13916099999914877,40183.67214977045,43058.04068695002
"147.32.84.165",2526,"93.177.158.45",6667,2,124,2,124,0,0,85257.639427,2.8725609999964945,345.33644368255733,0
"147.32.84.165",2527,"217.163.21.35",80,13,4883,7,2059,6,2824,85257.73293,0.23264299999573268,70803.76370792219,97110.16450275487
"147.32.84.165",2528,"174.128.246.102",80,6,541,4,419,2,122,85258.177698,0.37136699999973644,9026.11163620456,2628.1279704461967
"147.32.84.165",2529,"193.23.181.44",80,3,186,3,186,0,0,85258.353718,8.880401999995229,167.55998208198227,0
"147.32.84.165",2530,"193.23.181.44",80,3,186,3,186,0,0,85258.356897,8.877286999995704,167.61877812452386,0
"147.32.84.165",2531,"193.23.181.44",80,3,186,3,186,0,0,85258.360067,8.874138999992283,167.6782389819783,0
"147.32.84.165",2532,"193.23.181.44",80,3,186,3,186,0,0,85258.388096,8.94511300000886,166.34781472280184,0
"147.32.84.165",2533,"72.20.15.61",80,3,186,3,186,0,0,85258.605951,9.028628000000026,164.8090939177022,0
"147.32.84.165",2534,"193.23.181.44",179,3,186,3,186,0,0,85258.719531,9.016044000003603,165.03912358894937,0
"147.32.84.165",2535,"193.23.181.44",80,3,186,3,186,0,0,85259.108692,9.02793300000485,164.82178146417354,0
"147.32.84.165",2536,"174.37.196.55",80,3,186,3,186,0,0,85259.209254,9.027367999995477,164.83209724038565,0
"147.32.84.165",2537,"46.4.36.120",443,6,366,3,186,3,180,85259.232943,1.0056810000096448,1479.5944240626297,1431.8655716735127
"147.32.84.165",2538,"174.37.196.55",80,3,186,3,186,0,0,85259.268797,8.967848000000231,165.92609508992143,0
"147.32.84.165",2539,"67.19.72.206",80,3,186,3,186,0,0,85259.309214,9.028664000012213,164.8084367740329,0
"147.32.84.165",2541,"174.37.196.55",80,3,186,3,186,0,0,85259.409647,9.0271880000073,164.83538395331934,0
"147.32.84.165",2540,"67.19.72.206",80,3,186,3,186,0,0,85259.409871,9.02708500000881,164.83726474255508,0
"147.32.84.165",2542,"67.19.72.206",80,3,186,3,186,0,0,85259.810504,9.027922000008402,164.82198228990183,0
"147.32.84.165",2543,"193.23.181.44",179,3,186,3,186,0,0,85259.810638,9.027910999997403,164.8221831163852,0
"147.32.84.165",2544,"72.20.15.61",80,3,186,3,186,0,0,85261.215327,9.027373999997508,164.83198768550088,0
"147.32.84.165",2545,"193.23.181.44",80,3,186,3,186,0,0,85261.215685,9.0270509999973,164.83788559524535,0
"147.32.84.165",2546,"46.4.36.120",443,6,366,3,186,3,180,85261.237957,1.0070159999886528,1477.6329273981416,1429.9673490949758
"147.32.84.165",2547,"193.23.181.44",179,3,186,3,186,0,0,85261.716486,9.028553999989526,164.81044472921425,0
"147.32.84.165",2548,"174.37.196.55",80,3,186,3,186,0,0,85262.819872,9.02927900000941,164.79721138292982,0
"147.32.84.165",2549,"67.19.72.206",80,3,186,3,186,0,0,85263.120829,9.028323999998975,164.81464333802919,0
"147.32.84.165",2550,"46.4.36.120",443,6,366,3,186,3,180,85263.24448,1.007359000010183,1477.1298017737056,1429.4804533293925
"147.32.84.165",2551,"46.4.36.120",443,6,366,3,186,3,180,85265.251646,1.005896999995457,1479.2767052757094,1431.5581018797188
"147.32.84.165",2552,"184.82.148.43",80,10,1919,5,979,5,940,85265.256997,0.3049389999941923,25683.825290137254,24660.669839355487
"147.32.84.165",2553,"184.82.148.44",80,10,1513,5,596,5,917,85265.469871,0.34063700000115205,13997.305049022492,21536.12203012353
"147.32.84.165",2554,"193.23.181.44",179,3,186,3,186,0,0,85265.528243,9.03082300000824,164.76903600022305,0
"147.32.84.165",2555,"217.163.21.36",80,14,6134,7,809,7,5325,85265.709389,0.18864100000064354,34308.55434384848,225825.7748837987
"147.32.84.165",2556,"217.163.21.36",80,10,1446,5,698,5,748,85265.860028,0.1403580000041984,39783.980961776106,42633.836331530845
"147.32.84.165",2557,"217.163.21.35",80,11,3644,6,2017,5,1627,85265.954815,0.22747499999240972,70935.26761419242,57219.47466945516
"147.32.84.165",2558,"217.163.21.36",80,10,2272,5,1153,5,1119,85266.14066,0.13940899999579415,66165.02521557633,64213.931670624384
"147.32.84.165",2559,"217.163.21.35",80,13,5467,7,2532,6,2935,85266.234544,0.14773699999204837,137108.51040084905,158931.0734701785
"147.32.84.165",2560,"173.241.240.4",80,9,2193,5,1163,4,1030,85266.338773,0.06675100000575185,139383.67963323824,123443.84352728752
"147.32.84.165",2561,"193.23.181.44",80,3,186,3,186,0,0,85266.731704,9.030794999998761,164.76954686715888,0
"147.32.84.165",2562,"193.23.181.44",80,3,186,3,186,0,0,85267.033451,9.030947999999626,164.766755383827,0
"147.32.84.165",2563,"174.128.246.102",80,3,186,3,186,0,0,85267.133043,9.031341000008979,164.75958553646913,0
"147.32.84.165",2564,"46.4.36.120",443,6,366,3,186,3,180,85267.257788,1.0063010000012582,1478.6828195521414,1430.9833737601368
"147.32.84.165",2565,"61.89.186.155",6667,2,124,2,124,0,0,85267.640019,3.004482000003918,330.1733876251235,0
"147.32.84.165",2566,"67.19.72.206",80,3,186,3,186,0,0,85267.735886,9.03004399999918,164.78325022559528,0
"147.32.84.165",2567,"193.23.181.44",179,3,186,3,186,0,0,85267.736032,9.029945000002044,164.78505683031992,0
"147.32.84.165",2568,"193.23.181.44",179,3,186,3,186,0,0,85267.73617,9.029853999993065,164.78671748193744,0
"147.32.84.165",2569,"193.23.181.44",179,3,186,3,186,0,0,85267.835581,9.03115299998899,164.76301530954177,0
"147.32.84.165",2570,"174.128.246.102",80,3,186,3,186,0,0,85267.835874,9.030918000004021,164.7673027259618,0
"147.32.84.165",2571,"193.23.181.44",80,3,186,3,186,0,0,85267.936258,9.029991999996128,164.78419914443313,0
"147.32.84.165",2572,"193.23.181.44",80,3,186,3,186,0,0,85267.936517,9.029868000012357,164.7864619945678,0
"147.32.84.165",2573,"174.128.246.102",80,3,186,3,186,0,0,85267.936635,9.029807999992045,164.78755694487757,0
"147.32.84.165",2574,"174.37.196.55",80,3,186,3,186,0,0,85268.236817,9.03080300000147,164.76940090485397,0
"147.32.84.165",2575,"174.128.246.102",80,3,186,3,186,0,0,85268.338117,9.030316999997012,164.7782685813236,0
"147.32.84.165",2576,"67.19.72.206",80,3,186,3,186,0,0,85268.537844,9.031247999999323,164.76128216168038,0
"147.32.84.165",2577,"174.128.246.102",80,3,186,3,186,0,0,85268.838931,9.030259999999544,164.77930867993558,0
"147.32.84.165",2578,"174.128.246.102",80,3,186,3,186,0,0,85268.839331,9.029970000003232,164.7846006132321,0
"147.32.84.165",2579,"67.19.72.206",80,3,186,3,186,0,0,85268.839454,9.029876000000513,164.78631600255812,0
"147.32.84.165",2580,"174.128.246.102",80,3,186,3,186,0,0,85268.839646,9.029711000010138,164.78932714439358,0
"147.32.84.165",2581,"174.128.246.102",80,3,186,3,186,0,0,85268.938778,9.03117500001099,164.76261394538244,0
"147.32.84.165",2582,"174.128.246.102",80,3,186,3,186,0,0,85268.938929,9.031050999998115,164.76487620325813,0
"147.32.84.165",2583,"72.20.15.61",80,3,186,3,186,0,0,85269.039274,9.030286000008346,164.77883424717942,0
"147.32.84.165",2584,"46.4.36.120",443,6,366,3,186,3,180,85269.264807,1.0054410000011558,1479.9476050790545,1432.2073597539236
"147.32.84.165",2585,"174.37.196.55",80,3,186,3,186,0,0,85269.9429,9.030473000006168,164.77542206249703,0
"147.32.84.165",2586,"67.19.72.206",80,3,186,3,186,0,0,85269.943268,9.03016700000444,164.78100571110903,0
"147.32.84.165",2587,"193.23.181.44",179,3,186,3,186,0,0,85269.943491,9.029972999996971,164.78454586746815,0
"147.32.84.165",2588,"72.20.15.61",80,9,715,5,473,4,242,85269.943714,3.3790250000020023,1119.849660774264,572.9463380705537
"147.32.84.165",2589,"193.23.181.44",80,3,186,3,186,0,0,85269.944004,9.02948299999116,164.7934881766162,0
"147.32.84.165",2590,"174.37.196.55",80,3,186,3,186,0,0,85269.944221,9.029286999997566,164.79706537187278,0
"147.32.84.165",2591,"174.37.196.55",80,3,186,3,186,0,0,85269.94449,9.029041000001598,164.80155533680008,0
"147.32.84.165",2592,"174.128.246.102",80,3,186,3,186,0,0,85269.944764,9.028789999996661,164.806136813521,0
"147.32.84.165",2593,"193.23.181.44",80,3,186,3,186,0,0,85270.143648,9.030112000007648,164.78200934813873,0
"147.32.84.165",2594,"193.23.181.44",179,3,186,3,186,0,0,85270.143828,9.02998099999968,164.7843998785881,0
"147.32.84.165",2595,"174.37.196.55",80,3,186,3,186,0,0,85270.145351,9.028501000007964,164.8114122154594,0
"147.32.84.165",2596,"72.20.15.61",80,3,186,3,186,0,0,85270.147013,9.026886999999988,164.8408803610815,0
"147.32.84.165",2597,"67.19.72.206",80,3,186,3,186,0,0,85270.147123,9.026824000000488,164.84203081836088,0
"147.32.84.165",2598,"193.23.181.44",80,3,186,3,186,0,0,85270.147667,9.026328000007197,164.8510889476666,0
"147.32.84.165",2599,"193.23.181.44",179,3,186,3,186,0,0,85270.147776,9.026265000007697,164.85223954744637,0
"147.32.84.165",2600,"174.128.246.102",80,9,894,6,710,3,184,85270.147882,3.431219999998575,1655.3878795304174,429.0019293430941
"147.32.84.165",2601,"193.23.181.44",179,3,186,3,186,0,0,85270.147992,9.026098999995156,164.85527136371965,0
"147.32.84.165",2602,"72.20.15.61",80,3,186,3,186,0,0,85270.148111,9.026026999999885,164.85658640285686,0
"147.32.84.165",2603,"193.23.181.44",80,3,186,3,186,0,0,85270.148223,9.025957999998354,164.8578466684945,0
"147.32.84.165",2604,"174.37.196.55",80,3,186,3,186,0,0,85270.148331,9.025895999991917,164.85897909762448,0
"147.32.84.165",2605,"193.23.181.44",179,3,186,3,186,0,0,85270.148435,9.025835000007646,164.86009327654887,0
"147.32.84.165",2606,"174.37.196.55",80,3,186,3,186,0,0,85270.14854,9.02577900000324,164.86111614293523,0
"147.32.84.165",2607,"67.19.72.206",80,3,186,3,186,0,0,85270.148645,9.025721000012709,164.86217555338845,0
"147.32.84.165",2608,"67.19.72.206",80,3,186,3,186,0,0,85270.148749,9.025664000000688,164.86321671179942,0
"147.32.84.165",2609,"193.23.181.44",80,3,186,3,186,0,0,85270.148857,9.025623000008636,164.8639656230463,0
"147.32.84.165",2610,"72.20.15.61",80,3,186,3,186,0,0,85270.149023,9.02550699999847,164.8660845313457,0
"147.32.84.165",2611,"193.23.181.44",179,3,186,3,186,0,0,85270.149139,9.025437999996939,164.8673449422072,0
"147.32.84.165",2612,"174.37.196.55",80,3,186,3,186,0,0,85270.149245,9.02537800000573,164.86844096713236,0
"147.32.84.165",2613,"193.23.181.44",179,3,186,3,186,0,0,85270.149351,9.025322999994387,164.8694456698032,0
"147.32.84.165",2614,"72.20.15.61",80,3,186,3,186,0,0,85270.149457,9.025265999996918,164.870486919777,0
"147.32.84.165",2615,"174.37.196.55",80,3,186,3,186,0,0,85270.149564,9.025203999990481,164.87161952256918,0
"147.32.84.165",2616,"193.23.181.44",179,3,186,3,186,0,0,85270.149671,9.025143999999273,164.87271560432941,0
"147.32.84.165",2617,"174.37.196.55",80,3,186,3,186,0,0,85270.149785,9.025076000005356,164.87395784801336,0
"147.32.84.165",2618,"174.128.246.102",80,16,1900,12,1652,4,248,85270.149896,93.2108040000021,141.78613886861982,21.285086222407816
"147.32.84.165",2619,"193.23.181.44",80,3,186,3,186,0,0,85270.15,9.02490800000669,164.87702700115025,0
"147.32.84.165",2620,"193.23.181.44",80,3,186,3,186,0,0,85270.152893,9.02396599999338,164.8942382984479,0
"147.32.84.165",2621,"174.37.196.55",80,3,186,3,186,0,0,85270.156096,9.02396299999964,164.89429311712155,0
"147.32.84.165",2622,"193.23.181.44",80,3,186,3,186,0,0,85270.159299,9.023954999996931,164.89443930078397,0
"147.32.84.165",2623,"174.128.246.102",80,7,573,5,451,2,122,85270.162467,3.471638000002713,1039.2788649038812,281.13530270127166
"147.32.84.165",2624,"193.23.181.44",179,3,186,3,186,0,0,85270.165666,9.020791000002646,164.95227524942808,0
"147.32.84.165",2625,"193.23.181.44",179,3,186,3,186,0,0,85270.168867,9.020791999995708,164.95225696376858,0
"147.32.84.165",2626,"193.23.181.44",80,3,186,3,186,0,0,85270.172067,9.020771999988938,164.95262268038974,0
"147.32.84.165",2627,"193.23.181.44",80,3,186,3,186,0,0,85270.179552,9.016508000000613,165.03063048354184,0
"147.32.84.165",2628,"193.23.181.44",179,3,186,3,186,0,0,85270.199696,8.999560000011115,165.34141669127848,0
"147.32.84.165",2629,"193.23.181.44",179,3,186,3,186,0,0,85270.209536,8.992951000007452,165.46292757502704,0
"147.32.84.165",2630,"174.37.196.55",80,3,186,3,186,0,0,85270.209675,8.995962999993935,165.40752779896974,0
"147.32.84.165",2631,"72.20.15.61",80,3,186,3,186,0,0,85270.209784,8.999104999995325,165.34977645007731,0
"147.32.84.165",2632,"174.128.246.102",80,3,186,3,186,0,0,85270.209891,9.002201999988756,165.29289167271057,0
"147.32.84.165",2633,"72.20.15.61",80,3,186,3,186,0,0,85270.209997,9.005264999999781,165.2366698814567,0
"147.32.84.165",2634,"174.37.196.55",80,3,186,3,186,0,0,85270.210133,9.008329000003869,165.18046798683318,0
"147.32.84.165",2635,"193.23.181.44",179,3,186,3,186,0,0,85270.21024,9.011419999995269,165.12380956617062,0
"147.32.84.165",2636,"72.20.15.61",80,3,186,3,186,0,0,85270.210373,9.014510000008158,165.06720831178325,0
"147.32.84.165",2638,"67.19.72.206",80,3,186,3,186,0,0,85270.210482,9.01760700000159,165.01051775706546,0
"147.32.84.165",2639,"67.19.72.206",80,3,186,3,186,0,0,85270.210587,9.020699000000604,164.9539575591537,0
"147.32.84.165",2637,"174.37.196.55",80,3,186,3,186,0,0,85270.213671,9.020810999994865,164.95190953461358,0
"147.32.84.165",2640,"193.23.181.44",80,3,186,3,186,0,0,85270.24312,9.031002000003355,164.76577017693577,0
"147.32.84.165",2641,"174.37.196.55",80,3,186,3,186,0,0,85270.243315,9.030855999997584,164.76843391151382,0
"147.32.84.165",2642,"174.37.196.55",80,3,186,3,186,0,0,85270.2435,9.03071700000146,164.77097001265344,0
"147.32.84.165",2643,"174.128.246.102",80,3,186,3,186,0,0,85270.243683,9.030582000006689,164.7734332071729,0
"147.32.84.165",2644,"193.23.181.44",179,3,186,3,186,0,0,85270.245372,9.028938999996171,164.8034171014591,0
"147.32.84.165",2645,"174.128.246.102",80,3,186,3,186,0,0,85270.246422,9.027931999997236,164.8217997211826,0
"147.32.84.165",2646,"174.37.196.55",80,3,186,3,186,0,0,85270.246539,9.027860999995028,164.82309596933533,0
"147.32.84.165",2647,"193.23.181.44",179,3,186,3,186,0,0,85270.248866,9.025580000001355,164.86475107414444,0
"147.32.84.165",2648,"67.19.72.206",80,3,186,3,186,0,0,85270.252071,9.022421000001486,164.92247479914258,0
"147.32.84.165",2649,"193.23.181.44",80,3,186,3,186,0,0,85270.255285,9.020752999989782,164.95297011254888,0
"147.32.84.165",2650,"174.37.196.55",80,3,186,3,186,0,0,85270.258484,9.020751999996719,164.95298839836647,0
"147.32.84.165",2651,"67.19.72.206",80,3,186,3,186,0,0,85270.261683,9.020789000001969,164.95231182102532,0
"147.32.84.165",2652,"193.23.181.44",179,3,186,3,186,0,0,85270.26492,9.020770999995875,164.95264096613033,0
"147.32.84.165",2653,"174.128.246.102",80,3,186,3,186,0,0,85270.268085,9.02080699999351,164.95198267749996,0
"147.32.84.165",2654,"72.20.15.61",80,3,186,3,186,0,0,85270.271269,9.020795999997063,164.95218382063894,0
"147.32.84.165",2655,"72.20.15.61",80,3,186,3,186,0,0,85270.274491,9.020795999997063,164.95218382063894,0
"147.32.84.165",2656,"193.23.181.44",80,3,186,3,186,0,0,85270.277687,9.020803999999771,164.9520375345743,0
"147.32.84.165",2657,"193.23.181.44",80,3,186,3,186,0,0,85270.280918,9.020770000002813,164.95265925187496,0
"147.32.84.165",2658,"193.23.181.44",80,3,186,3,186,0,0,85270.284084,9.020785000000615,164.95238496426848,0
"147.32.84.165",2659,"72.20.15.61",80,3,186,3,186,0,0,85270.28729,9.020804000014323,164.95203753430818,0
"147.32.84.165",2660,"193.23.181.44",80,3,186,3,186,0,0,85270.290515,9.02073499999824,164.9532992600149,0
"147.32.84.165",2661,"193.23.181.44",179,3,186,3,186,0,0,85270.293717,9.020719000007375,164.9535918366134,0
"147.32.84.165",2662,"193.23.181.44",80,3,186,3,186,0,0,85270.296915,9.020722000001115,164.95353697850527,0
"147.32.84.165",2664,"193.23.181.44",80,3,186,3,186,0,0,85270.300089,9.020782999999938,164.95242153591437,0
"147.32.84.165",2665,"193.23.181.44",80,3,186,3,186,0,0,85270.303288,9.020805000007385,164.9520192487014,0
"147.32.84.165",2666,"174.37.196.55",80,3,186,3,186,0,0,85270.306487,9.020801999999094,164.95207410606614,0
"147.32.84.165",2667,"174.128.246.102",80,3,186,3,186,0,0,85270.30967,9.020818999997573,164.9517632490354,0
"147.32.84.165",2668,"174.37.196.55",80,3,186,3,186,0,0,85270.312884,9.020803000006708,164.95205582018514,0
"147.32.84.165",2669,"72.20.15.61",80,3,186,3,186,0,0,85270.316113,9.02072300000873,164.95351869229995,0
"147.32.84.165",2670,"193.23.181.44",80,3,186,3,186,0,0,85270.319287,9.02079799999774,164.95214724909846,0
"147.32.84.165",2671,"67.19.72.206",80,3,186,3,186,0,0,85270.322468,9.020824000006542,164.95167182054777,0
"147.32.84.165",2672,"174.37.196.55",80,3,186,3,186,0,0,85270.325702,9.020766000001458,164.9527323954262,0
"147.32.84.165",2663,"67.19.72.206",80,3,186,3,186,0,0,85270.328889,9.020768000002136,164.95269582364247,0
"147.32.84.165",2673,"193.23.181.44",80,3,186,3,186,0,0,85270.332113,9.02077499999723,164.95256782266014,0
"147.32.84.165",2674,"193.23.181.44",179,3,186,3,186,0,0,85270.335319,9.02074699998775,164.95307982831363,0
"147.32.84.165",2675,"174.37.196.55",80,3,186,3,186,0,0,85270.338496,9.020772999996552,164.95260439438712,0
"147.32.84.165",2676,"72.20.15.61",80,3,186,3,186,0,0,85270.341716,9.020771000010427,164.95264096586422,0
"147.32.84.165",2677,"72.20.15.61",80,3,186,3,186,0,0,85270.344867,9.020798999990802,164.95212896346735,0
"147.32.84.165",2678,"174.128.246.102",80,3,186,3,186,0,0,85270.348067,9.020827000000281,164.9516169637167,0
"147.32.84.165",2679,"174.37.196.55",80,3,186,3,186,0,0,85270.351267,9.020772999996552,164.95260439438712,0
"147.32.84.165",2681,"67.19.72.206",80,3,186,3,186,0,0,85270.354467,9.020793000003323,164.95223867784705,0
"147.32.84.165",2682,"67.19.72.206",80,3,186,3,186,0,0,85270.357667,9.020787999994354,164.95233010696307,0
"147.32.84.165",2680,"174.37.196.55",80,3,186,3,186,0,0,85270.360895,9.020795999997063,164.95218382063894,0
"147.32.84.165",2684,"67.19.72.206",80,3,186,3,186,0,0,85270.364072,9.020814999996219,164.95183639179206,0
"147.32.84.165",2685,"174.37.196.55",80,3,186,3,186,0,0,85270.367315,9.020768000002136,164.95269582364247,0
"147.32.84.165",2686,"193.23.181.44",80,3,186,3,186,0,0,85270.370516,9.020770000002813,164.95265925187496,0
"147.32.84.165",2687,"72.20.15.61",80,3,186,3,186,0,0,85270.373694,9.02079200001026,164.9522569635025,0
"147.32.84.165",2688,"174.128.246.102",80,3,186,3,186,0,0,85270.376894,9.020791999995708,164.95225696376858,0
"147.32.84.165",2689,"67.19.72.206",80,3,186,3,186,0,0,85270.380097,9.020789999995031,164.9522935353577,0
"147.32.84.165",2683,"72.20.15.61",80,3,186,3,186,0,0,85270.383319,9.020766000001458,164.9527323954262,0
"147.32.84.165",2690,"193.23.181.44",179,3,186,3,186,0,0,85270.386516,9.020768999995198,164.95267753788974,0
"147.32.84.165",2691,"67.19.72.206",80,3,186,3,186,0,0,85270.408119,9.002370000001974,165.28980701744914,0
"147.32.84.165",2692,"193.23.181.44",80,3,186,3,186,0,0,85270.428487,8.985203999996884,165.60558892157775,0
"147.32.84.165",2693,"193.23.181.44",80,3,186,3,186,0,0,85270.431693,9.008791999993264,165.17197866274554,0
"147.32.84.165",2694,"174.37.196.55",80,3,186,3,186,0,0,85270.446889,9.027885999996215,164.82263954159632,0
"147.32.84.165",2695,"193.23.181.44",80,3,186,3,186,0,0,85270.450068,9.024727999989409,164.8803155066553,0
"147.32.84.165",2696,"67.19.72.206",80,3,186,3,186,0,0,85270.453289,9.02153399999952,164.93869002766928,0
"147.32.84.165",2697,"174.128.246.102",80,3,186,3,186,0,0,85270.456485,9.018360999994911,164.9967216882136,0
"147.32.84.165",2698,"174.128.246.102",80,3,186,3,186,0,0,85270.459687,9.015180000002147,165.0549406667028,0
"147.32.84.165",2699,"174.37.196.55",80,3,186,3,186,0,0,85270.462866,9.012023000002955,165.11276103040484,0
"147.32.84.165",2700,"67.19.72.206",80,3,186,3,186,0,0,85270.466066,9.009571000002325,165.15769729764227,0
"147.32.84.165",2701,"67.19.72.206",80,3,186,3,186,0,0,85270.469268,9.009602999998606,165.15711069624604,0
"147.32.84.165",2702,"174.37.196.55",80,3,186,3,186,0,0,85270.47247,9.009566000007908,165.15778895439513,0
"147.32.84.165",2703,"193.23.181.44",80,3,186,3,186,0,0,85270.47569,9.0095469999942,165.15813725162408,0
"147.32.84.165",2704,"193.23.181.44",80,3,186,3,186,0,0,85270.478891,9.009546000001137,165.15815558295748,0
"147.32.84.165",2705,"174.37.196.55",80,3,186,3,186,0,0,85270.545379,9.029523999997764,164.79273990526727,0
"147.32.84.165",2706,"193.23.181.44",80,3,186,3,186,0,0,85270.545981,9.029024000003119,164.8018656279445,0
"147.32.84.165",2707,"174.128.246.102",80,3,186,3,186,0,0,85270.546368,9.028663999997661,164.80843677429854,0
"147.32.84.165",2708,"193.23.181.44",179,3,186,3,186,0,0,85270.546478,9.028576999990037,164.81002488007158,0
"147.32.84.165",2709,"72.20.15.61",80,3,186,3,186,0,0,85270.546584,9.028493999998318,164.81153999773133,0
"147.32.84.165",2710,"72.20.15.61",80,3,186,3,186,0,0,85270.546689,9.028411999999662,164.81303688844235,0
"147.32.84.165",2711,"174.128.246.102",80,3,186,3,186,0,0,85270.546794,9.028332000001683,164.8144972958153,0
"147.32.84.165",2712,"193.23.181.44",179,3,186,3,186,0,0,85270.546899,9.028250000003027,164.81599424024603,0
"147.32.84.165",2713,"193.23.181.44",80,3,186,3,186,0,0,85270.547004,9.028169000011985,164.8174729558147,0
"147.32.84.165",2714,"174.37.196.55",80,3,186,3,186,0,0,85270.54711,9.028086000005715,164.81898821068586,0
"147.32.84.165",2715,"72.20.15.61",80,3,186,3,186,0,0,85270.547217,9.028002999999444,164.82050349341839,0
"147.32.84.165",2716,"193.23.181.44",179,3,186,3,186,0,0,85270.547322,9.027922000008402,164.82198228990183,0
"147.32.84.165",2717,"174.37.196.55",80,8,663,5,481,3,182,85270.547428,3.312072000000626,1161.810492042224,439.6039699619226
"147.32.84.165",2718,"174.37.196.55",80,8,625,5,443,3,182,85270.547533,3.316460999994888,1068.6089780659152,439.0221986636491
"147.32.84.165",2719,"193.23.181.44",179,3,186,3,186,0,0,85270.547639,9.027629999996861,164.82731348100413,0
"147.32.84.165",2720,"174.128.246.102",80,3,186,3,186,0,0,85270.547744,9.027547999998205,164.8288106582536,0
"147.32.84.165",2721,"174.37.196.55",80,8,638,5,456,3,182,85270.547878,3.3351959999999963,1093.788790823689,436.5560524778758
"147.32.84.165",2722,"193.23.181.44",179,3,186,3,186,0,0,85270.547989,9.027327999996487,164.83282760974,0
"147.32.84.165",2723,"174.128.246.102",80,3,186,3,186,0,0,85270.5481,9.027241999996477,164.83439792580953,0
"147.32.84.165",2724,"67.19.72.206",80,3,186,3,186,0,0,85270.548205,9.02715999999782,164.83589523176272,0
"147.32.84.165",2725,"193.23.181.44",80,3,186,3,186,0,0,85270.54831,9.027079000006779,164.8373743044547,0
"147.32.84.165",2726,"174.128.246.102",80,3,186,3,186,0,0,85270.560473,9.014941000001272,165.05931652794953,0
"147.32.84.165",2727,"174.37.196.55",80,8,692,5,510,3,182,85270.578582,3.4404130000039004,1185.9041341825457,423.2050047474967
"147.32.84.165",2728,"72.20.15.61",80,3,186,3,186,0,0,85270.578725,8.996713999993517,165.39372041848526,0
"147.32.84.165",2730,"67.19.72.206",80,3,186,3,186,0,0,85270.578837,8.996627000000444,165.39531982374356,0
"147.32.84.165",2731,"67.19.72.206",80,3,186,3,186,0,0,85270.578951,8.996535999991465,165.39699279827386,0
"147.32.84.165",2729,"174.128.246.102",80,3,186,3,186,0,0,85270.579098,8.996413000000757,165.39925412493565,0
"147.32.84.165",2732,"174.128.246.102",80,3,186,3,186,0,0,85270.644934,9.030938000010792,164.76693783062422,0
"147.32.84.165",2733,"193.23.181.44",179,3,186,3,186,0,0,85270.645285,9.030650000000605,164.77219247782833,0
"147.32.84.165",2734,"174.37.196.55",80,3,186,3,186,0,0,85270.745306,9.030285000000731,164.77885249467536,0
"147.32.84.165",2735,"174.37.196.55",80,3,186,3,186,0,0,85270.746263,9.029377000013483,164.79542276258684,0
"147.32.84.165",2736,"193.23.181.44",179,3,186,3,186,0,0,85270.747196,9.028487000003224,164.81166777993573,0
"147.32.84.165",2737,"174.128.246.102",80,3,186,3,186,0,0,85270.74742,9.02831100000185,164.81488065704596,0
"147.32.84.165",2738,"193.23.181.44",179,3,186,3,186,0,0,85270.747538,9.028239999999641,164.81617679636994,0
"147.32.84.165",2739,"193.23.181.44",80,3,186,3,186,0,0,85270.747653,9.028172000005725,164.8174181882065,0
"147.32.84.165",2740,"193.23.181.44",80,3,186,3,186,0,0,85270.747767,9.02810500000487,164.81864134269563,0
"147.32.84.165",2741,"72.20.15.61",80,3,186,3,186,0,0,85270.747884,9.028031000008923,164.8199923104528,0
"147.32.84.165",2742,"193.23.181.44",179,3,186,3,186,0,0,85270.748017,9.027945999987423,164.8215441255489,0
"147.32.84.165",2743,"193.23.181.44",179,3,186,3,186,0,0,85270.74814,9.027866000003996,164.8230046834259,0
"147.32.84.165",2744,"72.20.15.61",80,3,186,3,186,0,0,85270.748284,9.0277700000006,164.82475738747232,0
"147.32.84.165",2745,"193.23.181.44",80,3,186,3,186,0,0,85270.748407,9.027696999997715,164.82609019779647,0
"147.32.84.165",2746,"174.128.246.102",80,3,186,3,186,0,0,85270.748522,9.027628000010736,164.82734999694608,0
"147.32.84.165",2747,"72.20.15.61",80,3,186,3,186,0,0,85270.748634,9.027562999996007,164.82853678236953,0
"147.32.84.165",2748,"174.128.246.102",80,3,186,3,186,0,0,85270.748745,9.02749799999583,164.82972358461748,0
"147.32.84.165",2749,"193.23.181.44",179,3,186,3,186,0,0,85270.748854,9.027435999989393,164.83085562741718,0
"147.32.84.165",2750,"72.20.15.61",80,3,186,3,186,0,0,85270.749007,9.02732899998955,164.83280935055348,0
"147.32.84.165",2752,"174.37.196.55",80,3,186,3,186,0,0,85270.76177,9.014613000006648,165.0653222716164,0
"147.32.84.165",2753,"67.19.72.206",80,3,186,3,186,0,0,85270.761885,9.014544000005117,165.06658573069868,0
"147.32.84.165",2754,"193.23.181.44",179,3,186,3,186,0,0,85270.762,9.014475999996648,165.0678308978307,0
"147.32.84.165",2755,"193.23.181.44",179,3,186,3,186,0,0,85270.762115,9.014406999995117,165.06909439531697,0
"147.32.84.165",2751,"67.19.72.206",80,3,186,3,186,0,0,85270.762224,9.01434499998868,165.07022972849038,0
"147.32.84.165",2756,"193.23.181.44",179,3,186,3,186,0,0,85270.763568,9.013049000001047,165.0939654272186,0
"147.32.84.165",2757,"193.23.181.44",80,3,186,3,186,0,0,85270.763731,9.012929000004078,165.09616352234957,0
"147.32.84.165",2758,"174.37.196.55",80,3,186,3,186,0,0,85270.763853,9.012853000007453,165.09755567951342,0
"147.32.84.165",2759,"174.128.246.102",80,3,186,3,186,0,0,85270.763988,9.014689999996335,165.06391234757987,0
"147.32.84.165",2760,"193.23.181.44",179,3,186,3,186,0,0,85270.764103,9.017791999998735,165.00713256639858,0
"147.32.84.165",2761,"174.37.196.55",80,3,186,3,186,0,0,85270.764218,9.02085500000976,164.95110496714446,0
"147.32.84.165",2762,"174.37.196.55",80,3,186,3,186,0,0,85270.844995,9.03073799998674,164.7705868559341,0
"147.32.84.165",2763,"193.23.181.44",80,3,186,3,186,0,0,85270.847153,9.028642000004766,164.8088383612081,0
"147.32.84.165",2764,"174.37.196.55",80,3,186,3,186,0,0,85270.847951,9.027865999989444,164.82300468369155,0
"147.32.84.165",2765,"174.128.246.102",80,3,186,3,186,0,0,85270.848219,9.027619000000414,164.82751432021354,0
"147.32.84.165",2766,"193.23.181.44",179,3,186,3,186,0,0,85270.848575,9.027287000004435,164.83357624491933,0
"147.32.84.165",2767,"193.23.181.44",80,3,186,3,186,0,0,85270.848856,9.027029999997467,164.838269065287,0
"147.32.84.165",2768,"193.23.181.44",80,3,186,3,186,0,0,85270.849148,9.026761000000988,164.8431812916989,0
"147.32.84.165",2769,"174.37.196.55",80,3,186,3,186,0,0,85270.849379,9.026551999995718,164.84699805647892,0
"147.32.84.165",2770,"174.128.246.102",80,3,186,3,186,0,0,85270.849596,9.026356000002124,164.85057757523077,0
"147.32.84.165",2771,"67.19.72.206",80,3,186,3,186,0,0,85270.849808,9.026167000003625,164.85402940133974,0
"147.32.84.165",2772,"193.23.181.44",80,3,186,3,186,0,0,85270.850021,9.02597699999751,164.8574996369269,0
"147.32.84.165",2773,"174.128.246.102",80,3,186,3,186,0,0,85270.850237,9.02578499999072,164.86100654973833,0
"147.32.84.165",2774,"174.128.246.102",80,3,186,3,186,0,0,85270.85045,9.025594999999157,164.86447707881186,0
"147.32.84.165",2775,"174.37.196.55",80,3,186,3,186,0,0,85270.850663,9.025404999993043,164.8679477542722,0
"147.32.84.165",2776,"174.37.196.55",80,3,186,3,186,0,0,85270.850879,9.02521199999319,164.87147337936472,0
"147.32.84.165",2777,"193.23.181.44",179,3,186,3,186,0,0,85270.851093,9.025022000001627,164.8749443491364,0
"147.32.84.165",2778,"193.23.181.44",179,3,186,3,186,0,0,85270.851306,9.024832000010065,164.87841546505692,0
"147.32.84.165",2779,"174.37.196.55",80,3,186,3,186,0,0,85270.851568,9.024592999994638,164.88278197153977,0
"147.32.84.165",2780,"72.20.15.61",80,9,714,5,472,4,242,85270.859331,3.495483000006061,1080.2512842984654,553.8576500004843
"147.32.84.165",2781,"193.23.181.44",80,3,186,3,186,0,0,85270.859469,9.016714999990654,165.02684181562157,0
"147.32.84.165",2782,"174.37.196.55",80,3,186,3,186,0,0,85271.046149,9.03083499999775,164.7688170584858,0
"147.32.84.165",2783,"174.128.246.102",80,3,186,3,186,0,0,85271.046561,9.030482000001939,164.7752578433444,0
"147.32.84.165",2785,"193.23.181.44",179,3,186,3,186,0,0,85271.048184,9.028879999998026,164.804494023658,0
"147.32.84.165",2784,"174.128.246.102",80,3,186,3,186,0,0,85271.048404,9.028686999998172,164.8080169353862,0
"147.32.84.165",2786,"174.37.196.55",80,3,186,3,186,0,0,85271.048752,9.028361999997287,164.8139496400839,0
"147.32.84.165",2787,"174.128.246.102",80,3,186,3,186,0,0,85271.04921,9.027925000002142,164.82192751929674,0
"147.32.84.165",2788,"67.19.72.206",80,3,186,3,186,0,0,85271.04937,9.027788000006694,164.8244287525246,0
"147.32.84.165",2789,"193.23.181.44",80,3,186,3,186,0,0,85271.049506,9.027675999997882,164.82647361295963,0
"147.32.84.165",2790,"174.37.196.55",80,3,186,3,186,0,0,85271.049639,9.02756399998907,164.82851852413359,0
"147.32.84.165",2791,"174.128.246.102",80,3,186,3,186,0,0,85271.049765,9.027459999997518,164.8304174153537,0
"147.32.84.165",2792,"193.23.181.44",179,3,186,3,186,0,0,85271.049883,9.0273659999948,164.83213375871293,0
"147.32.84.165",2793,"174.37.196.55",80,3,186,3,186,0,0,85271.050004,9.027268999998341,164.83390491634552,0
"147.32.84.165",2794,"67.19.72.206",80,3,186,3,186,0,0,85271.050127,9.027168000000529,164.83574915188382,0
"147.32.84.165",2795,"174.128.246.102",80,3,186,3,186,0,0,85271.050251,9.027066000009654,164.83761168893733,0
"147.32.84.165",2796,"72.20.15.61",80,3,186,3,186,0,0,85271.050374,9.026966999997967,164.839419486117,0
"147.32.84.165",2797,"174.37.196.55",80,3,186,3,186,0,0,85271.050499,9.02686499999254,164.8412821063824,0
"147.32.84.165",2798,"72.20.15.61",80,3,186,3,186,0,0,85271.145437,9.03088900000148,164.76783182693933,0
"147.32.84.165",2799,"193.23.181.44",179,3,186,3,186,0,0,85271.146328,9.03011300000071,164.78199110020915,0
"147.32.84.165",2800,"174.37.196.55",80,3,186,3,186,0,0,85271.146946,9.029521000004024,164.79279465647588,0
"147.32.84.165",2801,"67.19.72.206",80,3,186,3,186,0,0,85271.147089,9.029402000000118,164.7949664883655,0
"147.32.84.165",2802,"174.128.246.102",80,3,186,3,186,0,0,85271.147246,9.029268000012962,164.79741214878814,0
"147.32.84.165",2803,"193.23.181.44",80,3,186,3,186,0,0,85271.147417,9.029129000002285,164.79994914233959,0
"147.32.84.165",2804,"193.23.181.44",179,3,186,3,186,0,0,85271.147567,9.029002999988734,164.80224893068,0
"147.32.84.165",2805,"193.23.181.44",80,3,186,3,186,0,0,85271.147715,9.028877999997349,164.80453052975543,0
"147.32.84.165",2806,"174.37.196.55",80,3,186,3,186,0,0,85271.147859,9.028755999999703,164.80675743148325,0
"147.32.84.165",2807,"193.23.181.44",80,3,186,3,186,0,0,85271.148006,9.028632999994443,164.80900264756755,0
"147.32.84.165",2808,"72.20.15.61",80,3,186,3,186,0,0,85271.148149,9.028512000004412,164.8112114154883,0
"147.32.84.165",2809,"67.19.72.206",80,3,186,3,186,0,0,85271.148262,9.028422000003047,164.8128543392741,0
"147.32.84.165",2810,"193.23.181.44",179,3,186,3,186,0,0,85271.148376,9.028333000009297,164.81447904042392,0
"147.32.84.165",2811,"67.19.72.206",80,3,186,3,186,0,0,85271.148487,9.028246000001673,164.81606726264707,0
"147.32.84.165",2812,"193.23.181.44",179,3,186,3,186,0,0,85271.148599,9.028157000007923,164.81769202714287,0
"147.32.84.165",2813,"174.128.246.102",80,8,607,5,425,3,182,85271.148708,3.3284030000068014,1021.5109167949471,437.44702789807144
"147.32.84.165",2814,"67.19.72.206",80,3,186,3,186,0,0,85271.148845,9.027933999997913,164.82176320743417,0
"147.32.84.165",2816,"67.19.72.206",80,3,186,3,186,0,0,85271.149088,9.027714999989257,164.82576155779958,0
"147.32.84.165",2815,"67.19.72.206",80,3,186,3,186,0,0,85271.149252,9.02757500000007,164.8283176822113,0
"147.32.84.165",2817,"72.20.15.61",80,3,186,3,186,0,0,85271.246582,9.03026200000022,164.7792721850112,0
"147.32.84.165",2818,"193.23.181.44",179,3,186,3,186,0,0,85271.246761,9.030146999997669,164.78137066875922,0
"147.32.84.165",2819,"72.20.15.61",80,3,186,3,186,0,0,85271.24755,9.029381999993348,164.79533150785915,0
"147.32.84.165",2820,"72.20.15.61",80,3,186,3,186,0,0,85271.247935,9.029019999987213,164.80193863809222,0
"147.32.84.165",2821,"174.37.196.55",80,3,186,3,186,0,0,85271.248171,9.028808000002755,164.8058082528221,0
"147.32.84.165",2822,"174.37.196.55",80,3,186,3,186,0,0,85271.248279,9.028722999995807,164.80735980057102,0
"147.32.84.165",2823,"193.23.181.44",179,3,186,3,186,0,0,85271.248413,9.028611000001547,164.80940423723484,0
"147.32.84.165",2824,"67.19.72.206",80,3,186,3,186,0,0,85271.248521,9.028527000002214,164.81093759808607,0
"147.32.84.165",2825,"72.20.15.61",80,3,186,3,186,0,0,85271.248641,9.028428999998141,164.81272655522974,0
"147.32.84.165",2826,"174.128.246.102",80,3,186,3,186,0,0,85271.248755,9.028339000011329,164.8143695089576,0
"147.32.84.165",2827,"174.128.246.102",80,3,186,3,186,0,0,85271.248866,9.028251000010641,164.81597598452305,0
"147.32.84.165",2829,"67.19.72.206",80,3,186,3,186,0,0,85271.249047,9.028093999993871,164.81884216103757,0
"147.32.84.165",2830,"174.37.196.55",80,3,186,3,186,0,0,85271.249165,9.028000000005704,164.82055826307706,0
"147.32.84.165",2832,"193.23.181.44",179,3,186,3,186,0,0,85271.251278,9.025911000004271,164.85870512121113,0
"147.32.84.165",2833,"174.37.196.55",80,3,186,3,186,0,0,85271.251388,9.025823999996646,164.8602941959153,0
"147.32.84.165",2834,"174.37.196.55",80,3,186,3,186,0,0,85271.251494,9.025741000004928,164.86181023798352,0
"147.32.84.165",2835,"72.20.15.61",80,3,186,3,186,0,0,85271.251601,9.025657999998657,164.8633263082006,0
"147.32.84.165",2831,"174.37.196.55",80,3,186,3,186,0,0,85271.251704,9.025578000000678,164.86478760694197,0
"147.32.84.165",2836,"46.4.36.120",443,6,366,3,186,3,180,85271.270197,1.0068389999942156,1477.8926918887219,1430.2187340858598
"147.32.84.165",2837,"174.37.196.55",80,3,186,3,186,0,0,85271.347179,9.030045999999857,164.78321372892492,0
"147.32.84.165",2838,"72.20.15.61",80,3,186,3,186,0,0,85271.347658,9.029689999995753,164.78971038880624,0
"147.32.84.165",2839,"193.23.181.44",80,3,186,3,186,0,0,85271.348098,9.029299000001629,164.79684635537393,0
"147.32.84.165",2840,"174.128.246.102",80,3,186,3,186,0,0,85271.348262,9.0291819999984,164.79898179040623,0
"147.32.84.165",2841,"174.128.246.102",80,3,186,3,186,0,0,85271.348379,9.029112000003806,164.8002594274357,0
"147.32.84.165",2842,"193.23.181.44",179,3,186,3,186,0,0,85271.348496,9.02904199999466,164.8015370845412,0
"147.32.84.165",2843,"174.128.246.102",80,3,186,3,186,0,0,85271.348607,9.028977999987546,164.80270524549428,0
"147.32.84.165",2844,"67.19.72.206",80,3,186,3,186,0,0,85271.348725,9.028917999996338,164.803800411146,0
"147.32.84.165",2845,"72.20.15.61",80,3,186,3,186,0,0,85271.348836,9.028862999999546,164.8048043258686,0
"147.32.84.165",2846,"67.19.72.206",80,3,186,3,186,0,0,85271.348946,9.028808000002755,164.8058082528221,0
"147.32.84.165",2847,"193.23.181.44",80,3,186,3,186,0,0,85271.3493,9.028510000003735,164.81124792456168,0
"147.32.84.165",2849,"174.37.196.55",80,3,186,3,186,0,0,85271.349524,9.028341999990516,164.81431474367753,0
"147.32.84.165",2850,"174.128.246.102",80,3,186,3,186,0,0,85271.349738,9.028183000002173,164.8172173736002,0
"147.32.84.165",2851,"193.23.181.44",179,3,186,3,186,0,0,85271.349952,9.028025999999954,164.8200835930255,0
"147.32.84.165",2852,"193.23.181.44",179,3,186,3,186,0,0,85271.35017,9.027862999995705,164.82305945501255,0
"147.32.84.165",2853,"67.19.72.206",80,3,186,3,186,0,0,85271.350382,9.027705999993486,164.8259258776342,0
"147.32.84.165",2854,"193.23.181.44",179,3,186,3,186,0,0,85271.350635,9.027507000006153,164.829559256945,0
"147.32.84.165",2848,"67.19.72.206",80,3,186,3,186,0,0,85271.350857,9.02734000000055,164.83260849817438,0
"147.32.84.165",2855,"67.19.72.206",80,3,186,3,186,0,0,85271.351073,9.027178000003914,164.83556655239929,0
"147.32.84.165",2856,"193.23.181.44",80,3,186,3,186,0,0,85271.351288,9.027017000000342,164.83850645234673,0
"147.32.84.165",2858,"67.19.72.206",80,3,186,3,186,0,0,85271.351612,9.026756000006571,164.84327259969325,0
"147.32.84.165",2857,"174.128.246.102",80,3,186,3,186,0,0,85271.351863,9.026562999992166,164.84679716978562,0
"147.32.84.165",2859,"174.37.196.55",80,3,186,3,186,0,0,85271.447061,9.030564000000595,164.77376163879708,0
"147.32.84.165",2860,"72.20.15.61",80,3,186,3,186,0,0,85271.447248,9.0304049999977,164.77666284074513,0
"147.32.84.165",2862,"193.23.181.44",80,3,186,3,186,0,0,85271.448143,9.029536999994889,164.79250265000766,0
"147.32.84.165",2863,"174.37.196.55",80,3,186,3,186,0,0,85271.448335,9.029372000004514,164.79551401794677,0
"147.32.84.165",2861,"67.19.72.206",80,3,186,3,186,0,0,85271.448447,9.029287999990629,164.79704712060843,0
"147.32.84.165",2864,"67.19.72.206",80,3,186,3,186,0,0,85271.448587,9.029174999988754,164.79910955340364,0
"147.32.84.165",2865,"72.20.15.61",80,3,186,3,186,0,0,85271.448729,9.029061000008369,164.80119028973454,0
"147.32.84.165",2866,"193.23.181.44",179,3,186,3,186,0,0,85271.448863,9.028954000008525,164.80314330968957,0
"147.32.84.165",2867,"193.23.181.44",80,3,186,3,186,0,0,85271.449039,9.028804999994463,164.8058630129804,0
"147.32.84.165",2868,"174.37.196.55",80,3,186,3,186,0,0,85271.449182,9.028688999998849,164.80798042774424,0
"147.32.84.165",2869,"67.19.72.206",80,3,186,3,186,0,0,85271.449321,9.028577000004589,164.81002487980595,0
"147.32.84.165",2870,"174.128.246.102",80,3,186,3,186,0,0,85271.449468,9.028456999993068,164.81221542076818,0
"147.32.84.165",2871,"67.19.72.206",80,3,186,3,186,0,0,85271.449703,9.028252999996766,164.81593947362052,0
"147.32.84.165",2872,"193.23.181.44",179,3,186,3,186,0,0,85271.449836,9.028147000004537,164.8178745870279,0
"147.32.84.165",2873,"174.37.196.55",80,3,186,3,186,0,0,85271.449964,9.028046999999788,164.8197002075903,0
"147.32.84.165",2874,"193.23.181.44",80,3,186,3,186,0,0,85271.450101,9.027937999999267,164.8216901799858,0
"147.32.84.165",2875,"72.20.15.61",80,3,186,3,186,0,0,85271.450225,9.027846000011778,164.8233698268733,0
"147.32.84.165",2876,"72.20.15.61",80,3,186,3,186,0,0,85271.450373,9.027726000000257,164.8255607225959,0
"147.32.84.165",2877,"174.128.246.102",80,3,186,3,186,0,0,85271.450507,9.027617999992799,164.82753257849268,0
"147.32.84.165",2878,"67.19.72.206",80,3,186,3,186,0,0,85271.451858,9.026293999995687,164.85170990449802,0
"147.32.84.165",2880,"193.23.181.44",80,3,186,3,186,0,0,85271.547989,9.030245999994804,164.77956414485897,0
"147.32.84.165",2879,"67.19.72.206",80,3,186,3,186,0,0,85271.548244,9.030039999997825,164.78332321898446,0
"147.32.84.165",2881,"72.20.15.61",80,3,186,3,186,0,0,85271.548914,9.029422999999952,164.7945832197703,0
"147.32.84.165",2882,"174.128.246.102",80,3,186,3,186,0,0,85271.549544,9.028843000007328,164.80516938867942,0
"147.32.84.165",2883,"67.19.72.206",80,3,186,3,186,0,0,85271.549825,9.028611000001547,164.80940423723484,0
"147.32.84.165",2885,"193.23.181.44",179,3,186,3,186,0,0,85271.550102,9.028384000004735,164.81354802799922,0
"147.32.84.165",2886,"67.19.72.206",80,3,186,3,186,0,0,85271.550317,9.028214999998454,164.81663318831627,0
"147.32.84.165",2887,"72.20.15.61",80,3,186,3,186,0,0,85271.550532,9.028049000000465,164.8196636947721,0
"147.32.84.165",2888,"193.23.181.44",179,3,186,3,186,0,0,85271.550801,9.027828999998746,164.8236802004343,0
"147.32.84.165",2884,"193.23.181.44",80,3,186,3,186,0,0,85271.551013,9.027667000002111,164.826637934214,0
"147.32.84.165",2889,"72.20.15.61",80,3,186,3,186,0,0,85271.551261,9.027468000000226,164.8302713451837,0
"147.32.84.165",2890,"72.20.15.61",80,3,186,3,186,0,0,85271.551478,9.02730000000156,164.83333887205953,0
"147.32.84.165",2891,"193.23.181.44",80,3,186,3,186,0,0,85271.64761,9.030383000004804,164.77706427282303,0
"147.32.84.165",2893,"72.20.15.61",80,3,186,3,186,0,0,85271.648037,9.0300789999892,164.7826115365967,0
"147.32.84.165",2892,"174.37.196.55",80,7,602,4,420,3,182,85271.648197,0.24245199999131728,13858.413212183561,6005.31239194621
"147.32.84.165",2894,"174.128.246.102",80,3,186,3,186,0,0,85271.648382,9.029781999997795,164.78803142759853,0
"147.32.84.165",2895,"193.23.181.44",80,3,186,3,186,0,0,85271.748537,9.0305939999962,164.77321425374967,0
"147.32.84.165",2896,"67.19.72.206",80,3,186,3,186,0,0,85271.749337,9.029897999993409,164.78591452540064,0
"147.32.84.165",2897,"193.23.181.44",179,3,186,3,186,0,0,85271.749973,9.029292000006535,164.79697411479472,0
"147.32.84.165",2898,"174.37.196.55",80,3,186,3,186,0,0,85271.750193,9.029099000006681,164.80049670503104,0
"147.32.84.165",2899,"193.23.181.44",80,3,186,3,186,0,0,85271.750408,9.028911999994307,164.80390992856485,0
"147.32.84.165",2900,"174.37.196.55",80,3,186,3,186,0,0,85271.750626,9.028721000009682,164.8073963076724,0
"147.32.84.165",2901,"72.20.15.61",80,3,186,3,186,0,0,85271.750839,9.028535999997985,164.81077330813457,0
"147.32.84.165",2902,"174.37.196.55",80,3,186,3,186,0,0,85271.751052,9.028349999993225,164.81416870204598,0
"147.32.84.165",2903,"193.23.181.44",80,3,186,3,186,0,0,85271.75127,9.028160000001662,164.81763725938907,0
"147.32.84.165",2904,"67.19.72.206",80,3,186,3,186,0,0,85271.751482,9.027974999989965,164.82101467955482,0
"147.32.84.165",2905,"193.23.181.44",80,3,186,3,186,0,0,85271.751696,9.027788999999757,164.82441049519878,0
"147.32.84.165",2907,"174.37.196.55",80,3,186,3,186,0,0,85271.75201,9.027503000004799,164.8296322913666,0
"147.32.84.165",2908,"193.23.181.44",179,3,186,3,186,0,0,85271.752249,9.027291000005789,164.8335032070026,0
"147.32.84.165",2909,"67.19.72.206",80,3,186,3,186,0,0,85271.752463,9.027104000007967,164.8369177976333,0
"147.32.84.165",2910,"174.128.246.102",80,3,186,3,186,0,0,85271.752679,9.026918000003207,164.84031426888683,0
"147.32.84.165",2911,"174.37.196.55",80,3,186,3,186,0,0,85271.752892,9.026736999992863,164.8436195716322,0
"147.32.84.165",2912,"174.128.246.102",80,3,186,3,186,0,0,85271.753106,9.026553000003332,164.84697979388707,0
"147.32.84.165",2913,"174.37.196.55",80,3,186,3,186,0,0,85271.75337,9.026318999996874,164.85125331827018,0
"147.32.84.165",2906,"174.37.196.55",80,3,186,3,186,0,0,85271.753699,9.026018000004115,164.85675078415773,0
"147.32.84.165",2914,"174.128.246.102",80,3,186,3,186,0,0,85271.753919,9.025827000004938,164.86023939957923,0
"147.32.84.165",2916,"67.19.72.206",80,3,186,3,186,0,0,85271.754139,9.025634999998147,164.86374642895547,0
"147.32.84.165",2917,"67.19.72.206",80,3,186,3,186,0,0,85271.754353,9.025474000009126,164.86668733392787,0
"147.32.84.165",2915,"193.23.181.44",80,3,186,3,186,0,0,85271.754564,9.025293999991845,164.86997542698825,0
"147.32.84.165",2918,"193.23.181.44",80,3,186,3,186,0,0,85271.770534,9.009353000001283,165.16169363102856,0
"147.32.84.165",2919,"174.128.246.102",80,3,186,3,186,0,0,85271.849391,9.029263000003994,164.79750340635132,0
"147.32.84.165",2920,"193.23.181.44",80,3,186,3,186,0,0,85271.850115,9.028675000008661,164.80823598131204,0
"147.32.84.165",2921,"193.23.181.44",179,3,186,3,186,0,0,85271.850603,9.028246999994735,164.81604900717358,0
"147.32.84.165",2922,"174.37.196.55",80,3,186,3,186,0,0,85271.850846,9.028061000004527,164.81944461820248,0
"147.32.84.165",2923,"67.19.72.206",80,3,186,3,186,0,0,85271.851025,9.028015999996569,164.82026615820857,0
"147.32.84.165",2924,"193.23.181.44",80,3,186,3,186,0,0,85271.85114,9.027962000007392,164.82125201665465,0
"147.32.84.165",2925,"72.20.15.61",80,3,186,3,186,0,0,85271.851255,9.027906000002986,164.8222744011189,0
"147.32.84.165",2926,"67.19.72.206",80,3,186,3,186,0,0,85271.851395,9.027824999997392,164.8237532296461,0
"147.32.84.165",2928,"174.128.246.102",80,3,186,3,186,0,0,85271.86271,9.016566999998759,165.02955060392773,0
"147.32.84.165",2929,"174.128.246.102",80,3,186,3,186,0,0,85271.862825,9.01651000000129,165.03059387720828,0
"147.32.84.165",2930,"174.128.246.102",80,3,186,3,186,0,0,85271.862938,9.016466000000946,165.03139922003186,0
"147.32.84.165",2931,"193.23.181.44",179,3,186,3,186,0,0,85271.863052,9.016411000004155,165.0324059095481,0
"147.32.84.165",2927,"67.19.72.206",80,3,186,3,186,0,0,85271.863165,9.016354999999749,165.03343091526915,0
"147.32.84.165",2932,"174.37.196.55",80,3,186,3,186,0,0,85271.866225,9.013352999987546,165.08839718161,0
"147.32.84.165",2933,"193.23.181.44",179,3,186,3,186,0,0,85271.866362,9.013280999992276,165.08971594264898,0
"147.32.84.165",2935,"67.19.72.206",80,3,186,3,186,0,0,85271.866475,9.013227999996161,165.0906867107582,0
"147.32.84.165",2934,"174.37.196.55",80,3,186,3,186,0,0,85271.866588,9.013171999991755,165.091712440566,0
"147.32.84.165",2936,"174.37.196.55",80,3,186,3,186,0,0,85271.949255,9.029880000001867,164.7862430065175,0
"147.32.84.165",2937,"72.20.15.61",80,3,186,3,186,0,0,85271.949621,9.029584999996587,164.7916266362809,0
"147.32.84.165",2938,"72.20.15.61",80,3,186,3,186,0,0,85271.950878,9.028359000003547,164.814004405387,0
"147.32.84.165",2939,"174.37.196.55",80,3,186,3,186,0,0,85271.95161,9.027656999998726,164.8268205139174,0
"147.32.84.165",2940,"193.23.181.44",179,3,186,3,186,0,0,85271.951977,9.027319999993779,164.83297368444073,0
"147.32.84.165",2941,"174.128.246.102",80,3,186,3,186,0,0,85271.952233,9.027092999996967,164.83711866051453,0
"147.32.84.165",2942,"174.37.196.55",80,3,186,3,186,0,0,85271.952506,9.026847999994061,164.8415925471415,0
"147.32.84.165",2943,"67.19.72.206",80,3,186,3,186,0,0,85271.952723,9.02666100001079,164.84500747266583,0
"147.32.84.165",2945,"67.19.72.206",80,3,186,3,186,0,0,85271.952986,9.02642699998978,164.84928089505235,0
"147.32.84.165",2946,"193.23.181.44",80,3,186,3,186,0,0,85271.953207,9.026234999997541,164.8527874579385,0
"147.32.84.165",2947,"193.23.181.44",80,3,186,3,186,0,0,85271.953421,9.026049000007333,164.8561845829544,0
"147.32.84.165",2948,"193.23.181.44",80,3,186,3,186,0,0,85271.953636,9.025861999994959,164.8596001136325,0
"147.32.84.165",2944,"193.23.181.44",80,3,186,3,186,0,0,85271.953905,9.025622000001022,164.86398388940194,0
"147.32.84.165",2949,"72.20.15.61",80,8,654,4,412,4,242,85271.954121,0.36598799999046605,9005.759751920446,5289.790922244534
"147.32.84.165",2950,"72.20.15.61",80,3,186,3,186,0,0,85272.051006,9.02830800000811,164.81493542296778,0
"147.32.84.165",2951,"174.37.196.55",80,3,186,3,186,0,0,85272.051611,9.027837999994517,164.8235158850772,0
"147.32.84.165",2952,"193.23.181.44",179,3,186,3,186,0,0,85272.051857,9.027654000004986,164.82687528777444,0
"147.32.84.165",2953,"174.128.246.102",80,3,186,3,186,0,0,85272.051965,9.027604999995674,164.82776993462974,0
"147.32.84.165",2954,"174.37.196.55",80,3,186,3,186,0,0,85272.052148,9.027480999997351,164.8300339818424,0
"147.32.84.165",2955,"174.128.246.102",80,3,186,3,186,0,0,85272.052256,9.027432000002591,164.8309286627219,0
"147.32.84.165",2956,"67.19.72.206",80,3,186,3,186,0,0,85272.052365,9.027382000000216,164.83184161254772,0
"147.32.84.165",2957,"72.20.15.61",80,3,186,3,186,0,0,85272.052476,9.027327999996487,164.83282760974,0
"147.32.84.165",2958,"67.19.72.206",80,3,186,3,186,0,0,85272.052581,9.027282000010018,164.83366754227336,0
"147.32.84.165",2959,"193.23.181.44",80,3,186,3,186,0,0,85272.052689,9.027231999993091,164.83458052270495,0
"147.32.84.165",2960,"67.19.72.206",80,3,186,3,186,0,0,85272.052795,9.027205000005779,164.83507353594467,0
"147.32.84.165",2961,"174.128.246.102",80,3,186,3,186,0,0,85272.0529,9.027159000004758,164.83591349163294,0
"147.32.84.165",2962,"174.37.196.55",80,3,186,3,186,0,0,85272.053008,9.027109999995446,164.83680823660626,0
"147.32.84.165",2963,"174.128.246.102",80,3,186,3,186,0,0,85272.053113,9.02706500000204,164.83762994945354,0
"147.32.84.165",2964,"174.37.196.55",80,3,186,3,186,0,0,85272.05322,9.027014999999665,164.83854297351397,0
"147.32.84.165",2965,"193.23.181.44",179,3,186,3,186,0,0,85272.053325,9.026966999997967,164.839419486117,0
"147.32.84.165",2966,"67.19.72.206",80,3,186,3,186,0,0,85272.05368,9.026668999998947,164.84486137690146,0
"147.32.84.165",2968,"174.37.196.55",80,3,186,3,186,0,0,85272.053789,9.02661800000351,164.84579274313165,0
"147.32.84.165",2967,"67.19.72.206",80,3,186,3,186,0,0,85272.053894,9.026570000001811,164.84666933283643,0
"147.32.84.165",2969,"193.23.181.44",179,3,186,3,186,0,0,85272.053999,9.026522000000114,164.84754593186403,0
"147.32.84.165",2970,"72.20.15.61",80,3,186,3,186,0,0,85272.054135,9.026442999995197,164.84898868810137,0
"147.32.84.165",2971,"193.23.181.44",179,3,186,3,186,0,0,85272.054241,9.026396000001114,164.84984704856916,0
"147.32.84.165",2972,"193.23.181.44",179,3,186,3,186,0,0,85272.054365,9.026329999993322,164.8510524212056,0
"147.32.84.165",2973,"67.19.72.206",80,3,186,3,186,0,0,85272.137818,8.94293399999151,166.3883463750725,0
"147.32.84.165",2974,"174.37.196.55",80,3,186,3,186,0,0,85272.150162,9.030098999995971,164.78224657344995,0
"147.32.84.165",2975,"193.23.181.44",80,3,186,3,186,0,0,85272.150619,9.029708000001847,164.78938189360008,0
"147.32.84.165",2976,"72.20.15.61",80,3,186,3,186,0,0,85272.150878,9.02947999999742,164.793542928322,0
"147.32.84.165",2977,"67.19.72.206",80,3,186,3,186,0,0,85272.151099,9.029288999998244,164.79702886908254,0
"147.32.84.165",2978,"174.128.246.102",80,12,1034,8,788,4,246,85272.15135,12.48923300000024,504.75477557347824,157.57572943029905
"147.32.84.165",2979,"193.23.181.44",179,3,186,3,186,0,0,85272.249764,9.02982600001269,164.7872284579912,0
"147.32.84.165",2980,"174.128.246.102",80,3,186,3,186,0,0,85272.250045,9.029667000009795,164.79013013418833,0
"147.32.84.165",2981,"174.128.246.102",80,8,616,4,374,4,242,85272.250187,0.3285570000007283,9106.486850054534,5892.432667682346
"147.32.84.165",2982,"174.128.246.102",80,9,678,5,436,4,242,85272.250307,3.327567000000272,1048.2133041948412,581.8064670072283
"147.32.84.165",2983,"67.19.72.206",80,3,186,3,186,0,0,85272.35123,9.029850000006263,164.78679047813284,0
"147.32.84.165",2984,"193.23.181.44",179,3,186,3,186,0,0,85272.351456,9.029683999993722,164.78981988749933,0
"147.32.84.165",2985,"174.128.246.102",80,3,186,3,186,0,0,85272.415007,8.966153999994276,165.95744396102833,0
"147.32.84.165",2986,"72.20.15.61",80,3,186,3,186,0,0,85272.45104,9.029341999994358,164.79606155143196,0
"147.32.84.165",2987,"193.23.181.44",179,3,186,3,186,0,0,85272.852793,9.029720999998972,164.78914464800954,0
"147.32.84.165",2988,"174.37.196.55",80,3,186,3,186,0,0,85272.853079,9.029556000008597,164.79215589322257,0
"147.32.84.165",2989,"174.37.196.55",80,3,186,3,186,0,0,85273.053595,9.029667999988305,164.7901118847257,0
"147.32.84.165",2990,"72.20.15.61",80,3,186,3,186,0,0,85273.05382,9.029563999996753,164.79200989112377,0
"147.32.84.165",2991,"67.19.72.206",80,3,186,3,186,0,0,85273.138509,8.94492400001036,166.35132953597778,0
"147.32.84.165",2992,"174.128.246.102",80,6,543,4,421,2,122,85273.225774,0.4564929999905871,7377.98827160427,2138.0393566169146
"147.32.84.165",2993,"193.23.181.44",80,3,186,3,186,0,0,85273.228996,8.9542109999893,166.17879565288086,0
"147.32.84.165",2994,"193.23.181.44",179,3,186,3,186,0,0,85273.232172,8.951176000002306,166.2351404999317,0
"147.32.84.165",2995,"174.128.246.102",80,13,1381,9,1135,4,246,85273.235401,21.318287000001874,425.9254038562855,92.31510955827862
"147.32.84.165",2997,"72.20.15.61",80,3,186,3,186,0,0,85273.238555,8.944844999990892,166.35279873508318,0
"147.32.84.165",2996,"72.20.15.61",80,3,186,3,186,0,0,85273.241804,8.941645999992033,166.41231379561725,0
"147.32.84.165",2999,"72.20.15.61",80,3,186,3,186,0,0,85273.244956,8.938537000009092,166.47019529017854,0
"147.32.84.165",2998,"67.19.72.206",80,3,186,3,186,0,0,85273.248204,8.935347999999067,166.5296080242376,0
"147.32.84.165",3000,"174.128.246.102",80,8,638,6,516,2,122,85273.443775,9.164625999997952,450.42754608872445,106.49643531555112
"147.32.84.165",3001,"67.19.72.206",80,3,186,3,186,0,0,85273.446976,8.837055999989389,168.38186835092895,0
"147.32.84.165",3002,"174.128.246.102",80,3,186,3,186,0,0,85273.450176,8.833880000005593,168.44240582836284,0
"147.32.84.165",3003,"72.20.15.61",80,3,186,3,186,0,0,85273.453374,8.83070299999963,168.5030059328303,0
"147.32.84.165",3004,"193.23.181.44",179,3,186,3,186,0,0,85273.456608,8.827491000003647,168.56431799243808,0
"147.32.84.165",3005,"174.37.196.55",80,3,186,3,186,0,0,85273.459774,8.824349000002258,168.62433704736966,0
"147.32.84.165",3006,"193.23.181.44",179,3,186,3,186,0,0,85273.462958,8.821186999994097,168.68478131129015,0
"147.32.84.165",3007,"67.19.72.206",80,3,186,3,186,0,0,85273.466184,8.817983999993885,168.74605351983308,0
"147.32.84.165",3008,"46.4.36.120",443,6,366,3,186,3,180,85273.469357,1.0167070000024978,1463.5484952856077,1416.337253502201
"147.32.84.165",3009,"72.20.15.61",80,3,186,3,186,0,0,85273.48938,8.794810999999754,169.1906739098818,0
"147.32.84.165",3010,"174.37.196.55",80,3,186,3,186,0,0,85273.495802,8.887652999997954,167.42327811406932,0
"147.32.84.165",3012,"193.23.181.44",80,3,186,3,186,0,0,85273.499025,8.88445500000671,167.4835428846087,0
"147.32.84.165",3011,"193.23.181.44",80,3,186,3,186,0,0,85273.502203,8.881298000007519,167.54307759955137,0
"147.32.84.165",3013,"174.128.246.102",80,3,186,3,186,0,0,85273.505405,8.878117999993265,167.60308885296735,0
"147.32.84.165",3014,"174.37.196.55",80,3,186,3,186,0,0,85273.508589,8.874958000000333,167.66276527730543,0
"147.32.84.165",3015,"72.20.15.61",80,3,186,3,186,0,0,85273.536556,8.847023999987869,168.19215139486911,0
"147.32.84.165",3016,"184.82.148.43",80,10,1895,5,979,5,916,85273.574955,0.4584949999989476,17081.974721682847,15982.726093014799
"147.32.84.165",3017,"67.19.72.206",80,3,186,3,186,0,0,85273.670954,9.013705000004848,165.08195020795551,0
"147.32.84.165",3018,"193.23.181.44",179,3,186,3,186,0,0,85273.674154,9.01053200000024,165.14008273872847,0
"147.32.84.165",3019,"193.23.181.44",179,3,186,3,186,0,0,85273.738481,8.946228000000701,166.32708220714736,0
"147.32.84.165",3020,"193.23.181.44",179,3,186,3,186,0,0,85273.755754,8.9289759999956,166.64844882556892,0
"147.32.84.165",3021,"72.20.15.61",80,3,186,3,186,0,0,85273.776176,8.908576999994693,167.03004306982882,0
"147.32.84.165",3022,"174.37.196.55",80,3,186,3,186,0,0,85273.869022,8.91562499999418,166.89800210315838,0
"147.32.84.165",3023,"174.37.196.55",80,3,186,3,186,0,0,85273.872154,8.912523000006331,166.95609088458374,0
"147.32.84.165",3024,"193.23.181.44",179,3,186,3,186,0,0,85273.875354,8.909344999992754,167.01564480904153,0
"147.32.84.165",3025,"174.37.196.55",80,3,186,3,186,0,0,85273.878554,8.906166000000667,167.07525999401858,0
"147.32.84.165",3026,"193.23.181.44",80,3,186,3,186,0,0,85273.881754,8.902988000001642,167.13489897995208,0
"147.32.84.165",3028,"174.128.246.102",80,3,186,3,186,0,0,85273.884954,8.899813000010909,167.19452419934848,0
"147.32.84.165",3027,"67.19.72.206",80,3,186,3,186,0,0,85273.888154,8.89664300000004,167.2540979783041,0
"147.32.84.165",3029,"72.20.15.61",80,3,186,3,186,0,0,85273.891354,8.893455999990692,167.31403404948057,0
"147.32.84.165",3030,"174.37.196.55",80,3,186,3,186,0,0,85273.914604,8.870226999992155,167.75218943115163,0
"147.32.84.165",3031,"184.82.148.44",80,10,1479,5,578,5,901,85273.924206,0.3225150000071153,14337.317643824274,22349.34809184372
"147.32.84.165",3032,"67.19.72.206",80,3,186,3,186,0,0,85274.065754,9.020430999997188,164.95885839606376,0
"147.32.84.165",3033,"174.37.196.55",80,3,186,3,186,0,0,85274.162105,9.024128000004566,164.8912781378153,0
"147.32.84.165",3034,"67.19.72.206",80,3,186,3,186,0,0,85274.170826,9.015449999991688,165.04999750443648,0
"147.32.84.165",3035,"72.20.15.61",80,3,186,3,186,0,0,85274.259428,9.027313999991748,164.83308324063617,0
"147.32.84.165",3036,"72.20.15.61",80,3,186,3,186,0,0,85274.259635,9.02713400000357,164.83636999289158,0
"147.32.84.165",3037,"174.128.246.102",80,3,186,3,186,0,0,85274.259745,9.02704800000356,164.83794037645674,0
"147.32.84.165",3038,"174.128.246.102",80,3,186,3,186,0,0,85274.259852,9.026964000004227,164.83947426834794,0
"147.32.84.165",3039,"67.19.72.206",80,3,186,3,186,0,0,85274.318129,8.968709999986459,165.9101476134524,0
"147.32.84.165",3041,"193.23.181.44",179,3,186,3,186,0,0,85274.359409,9.028459000008297,164.81217891100047,0
"147.32.84.165",3040,"193.23.181.44",80,3,186,3,186,0,0,85274.35963,9.028286000000662,164.81533704181402,0
"147.32.84.165",3042,"193.23.181.44",179,3,186,3,186,0,0,85274.359882,9.028080999996746,164.8190794921464,0
"147.32.84.165",3043,"174.128.246.102",80,3,186,3,186,0,0,85274.360228,9.027780999997049,164.8245565549814,0
"147.32.84.165",3044,"70.32.97.26",80,8,2590,5,673,3,1917,85274.45515,0.36062099999981,14929.801647721115,42526.64154336015
"147.32.84.165",3045,"193.23.181.44",80,3,186,3,186,0,0,85274.459259,9.02817099999811,164.81743644424895,0
"147.32.84.165",3046,"195.113.232.96",80,8,2251,5,645,3,1606,85274.711099,62.78807900000538,82.18120512971193,204.62483013692614
"147.32.84.165",3047,"193.23.181.44",80,3,186,3,186,0,0,85274.760448,9.02763500000583,164.82722219042296,0
"147.32.84.165",3048,"193.23.181.44",179,3,186,3,186,0,0,85274.760751,9.027392000003601,164.83165902172038,0
"147.32.84.165",3049,"193.23.181.44",179,3,186,3,186,0,0,85274.762486,9.02568199999223,164.86288792373597,0
"147.32.84.165",3050,"174.128.246.102",80,3,186,3,186,0,0,85274.765686,9.02250500000082,164.9209393621688,0
"147.32.84.165",3051,"193.23.181.44",179,3,186,3,186,0,0,85274.768886,9.019327999994857,164.97903169735577,0
"147.32.84.165",3052,"193.23.181.44",179,3,186,3,186,0,0,85274.772085,9.01615199999651,165.0371466675114,0
"147.32.84.165",3054,"174.37.196.55",80,3,186,3,186,0,0,85274.778241,9.010018999993918,165.1494852564689,0
"147.32.84.165",3055,"67.19.72.206",80,3,186,3,186,0,0,85274.778485,9.009797999999137,165.15353618362394,0
"147.32.84.165",3053,"67.19.72.206",80,3,186,3,186,0,0,85274.781686,9.006620000000112,165.21181086800394,0
"147.32.84.165",3056,"70.32.97.26",80,8,1490,5,835,3,655,85274.904534,0.34495099999185186,19365.069242175814,15190.563297754681
"147.32.84.165",3057,"193.23.181.44",179,3,186,3,186,0,0,85275.06104,9.028070000000298,164.81928031129033,0
"147.32.84.165",3058,"173.201.33.10",80,11,4045,6,834,5,3211,85275.283857,0.5792269999947166,11518.800056041688,44348.76136684635
"147.32.84.165",3059,"193.23.181.44",179,3,186,3,186,0,0,85275.325545,8.964416999995592,165.98960088544874,0
"147.32.84.165",3060,"193.23.181.44",179,3,186,3,186,0,0,85275.420074,8.969714999999269,165.8915584274552,0
"147.32.84.165",3061,"46.4.36.120",443,6,366,3,186,3,180,85275.485781,1.007406999997329,1477.059420873535,1429.4123427808404
"147.32.84.165",3062,"174.128.246.102",80,3,186,3,186,0,0,85275.562318,9.028440000009141,164.81252575179028,0
"147.32.84.165",3063,"173.241.240.6",80,12,2825,6,691,6,2134,85275.712131,0.05191800001193769,106475.59610788025,328826.22589611646
"147.32.84.165",3064,"173.241.240.6",80,10,1603,5,889,5,714,85275.75801,0.05829200000152923,122006.4502815725,97989.43250960941
"147.32.84.165",3065,"173.241.240.6",80,9,1150,5,717,4,433,85275.759168,0.05823100000270642,98504.23313584526,59487.214711047425
"147.32.84.165",3066,"173.201.33.10",80,10,1631,5,920,5,711,85275.803775,0.6140850000083447,11985.311479518286,9262.561371671198
"147.32.84.165",3067,"204.2.197.201",80,10,1979,5,660,5,1319,85276.029553,0.36002900000312366,14665.485280225177,29308.750128207586
"147.32.84.165",3068,"217.163.21.36",80,14,6168,7,879,7,5289,85276.115496,0.18697500000416767,37609.306056121175,226297.63336840147
"147.32.84.165",3069,"72.20.15.61",80,3,186,3,186,0,0,85276.164739,9.027776999995694,164.82462958496978,0
"147.32.84.165",3070,"217.163.21.36",80,10,1624,5,774,5,850,85276.260956,0.1398230000049807,44284.55976326807,48632.91446870525
"147.32.84.165",3071,"193.23.181.44",80,3,186,3,186,0,0,85276.265022,9.028748999990057,164.80688520653732,0
"147.32.84.165",3072,"67.19.72.206",80,3,186,3,186,0,0,85276.265161,9.028632999994443,164.80900264756755,0
"147.32.84.165",3073,"174.37.196.55",80,3,186,3,186,0,0,85276.325624,8.968198000002303,165.9196195266449,0
"147.32.84.165",3074,"217.163.21.35",80,13,5063,7,2166,6,2897,85276.355075,0.4073309999948833,42540.341884653186,56897.21626954768
"147.32.84.165",3075,"193.23.181.44",80,3,186,3,186,0,0,85276.365288,9.02812200000335,164.81833098837697,0
"147.32.84.165",3076,"69.175.13.98",7691,9,544,5,302,4,242,85276.426925,0.3835629999957746,6298.834872046092,5047.410725281968
"147.32.84.165",3077,"173.236.31.226",7212,7,424,4,242,3,182,85276.440766,0.49227000000246335,3932.801105064928,2957.726450916599
"147.32.84.165",3078,"184.154.10.50",8339,8,486,5,304,3,182,85276.467121,3.4780940000055125,699.2335457282481,418.62008329783276
"147.32.84.165",3079,"193.23.181.44",179,3,186,3,186,0,0,85276.76637,9.029582000002847,164.7916813867498,0
"147.32.84.165",3080,"174.37.196.55",80,3,186,3,186,0,0,85277.468604,9.028244000000996,164.81610377387184,0
"147.32.84.165",3081,"46.4.36.120",443,6,366,3,186,3,180,85277.493037,1.0057720000040717,1479.4605536781457,1431.7360196885281
"147.32.84.165",3082,"67.19.72.206",80,3,186,3,186,0,0,85277.569384,9.027925999995205,164.82190926252503,0
"147.32.84.165",3083,"115.85.238.119",6667,10,1178,5,620,5,558,85277.64342,1.945848000003025,2549.017189416794,2294.1154704751143
"147.32.84.165",3084,"174.128.246.102",80,3,186,3,186,0,0,85279.427684,8.874806000007084,167.66563685998457,0
"147.32.84.165",3085,"174.37.196.55",80,3,186,3,186,0,0,85279.430858,8.871755999993184,167.72327823275836,0
"147.32.84.165",3086,"72.20.15.61",80,3,186,3,186,0,0,85279.434087,8.868575999993482,167.7834186684642,0
"147.32.84.165",3087,"174.128.246.102",80,3,186,3,186,0,0,85279.446857,8.956762000001618,166.13146581317346,0
"147.32.84.165",3088,"46.4.36.120",443,6,366,3,186,3,180,85279.49918,1.0060229999944568,1479.0914323113875,1431.378805462633
"147.32.84.165",3089,"193.23.181.44",179,3,186,3,186,0,0,85279.676128,9.027238999988185,164.83445270496853,0
"147.32.84.165",3090,"193.23.181.44",179,3,186,3,186,0,0,85279.788288,9.016449000002467,165.03171037728853,0
"147.32.84.165",3091,"174.128.246.102",80,3,186,3,186,0,0,85280.177041,9.028447999997297,164.8123797135948,0
"147.32.84.165",3092,"72.20.15.61",80,3,186,3,186,0,0,85280.277505,9.028227999995579,164.8163958642525,0
"147.32.84.165",3093,"193.23.181.44",80,3,186,3,186,0,0,85280.277645,9.028209000010975,164.81674272252573,0
"147.32.84.165",3094,"193.23.181.44",80,3,186,3,186,0,0,85280.37884,9.026770999989822,164.8429986760136,0
"147.32.84.165",3095,"72.20.15.61",80,3,186,3,186,0,0,85280.478324,9.027962000007392,164.82125201665465,0
"147.32.84.165",3096,"174.128.246.102",80,3,186,3,186,0,0,85280.478514,9.027894999991986,164.82247522831412,0
"147.32.84.165",3097,"174.37.196.55",80,3,186,3,186,0,0,85280.880352,8.92678700000397,166.6893138594366,0
"147.32.84.165",3098,"67.19.72.206",80,3,186,3,186,0,0,85280.880609,8.92662699999346,166.6923015827916,0
"147.32.84.165",3099,"46.4.36.120",443,6,366,3,186,3,180,85281.504804,1.007461000001058,1476.9802503505719,1429.3357261457147
"147.32.84.165",3100,"184.82.148.43",80,10,1919,5,979,5,940,85281.809739,0.34387799999967683,22775.51922486277,21868.22070620123
"147.32.84.165",3101,"184.82.148.44",80,10,1514,5,596,5,918,85282.050471,0.3043279999983497,15667.306327468572,24131.85773257743
"147.32.84.165",3102,"178.151.76.180",6667,6,366,3,186,3,180,85282.141414,1.0921380000072531,1362.4651829623342,1318.5146931893557
"147.32.84.165",3103,"217.163.21.36",80,14,6141,7,810,7,5331,85282.269499,0.18841600000450853,34391.98369482922,226350.2037989316
"147.32.84.165",3104,"174.37.196.55",80,3,186,3,186,0,0,85282.284458,8.928022000007331,166.6662559745908,0
"147.32.84.165",3105,"174.128.246.102",80,3,186,3,186,0,0,85282.28465,8.927888999998686,166.66873882507042,0
"147.32.84.165",3106,"217.163.21.36",80,10,1451,5,701,5,750,85282.420408,0.13901400000031572,40341.26059236669,43161.120462589184
"147.32.84.165",3107,"193.23.181.44",80,3,186,3,186,0,0,85282.447139,8.963194000010844,166.01224965098376,0
"147.32.84.165",3108,"217.163.21.35",80,11,3680,6,2040,5,1640,85282.514005,0.24367199999687728,66975.27824374218,53842.87074496921
"147.32.84.165",3109,"217.163.21.36",80,10,2277,5,1156,5,1121,85282.711868,0.13941600000543986,66333.84977075194,64325.47196627416
"147.32.84.165",3110,"174.37.196.55",80,3,186,3,186,0,0,85282.78503,8.928635000003851,166.65481341765658,0
"147.32.84.165",3111,"217.163.21.35",80,13,5512,7,2555,6,2957,85282.806192,0.1550909999932628,131793.59215485048,152529.8050888035
"147.32.84.165",3112,"173.241.240.4",80,9,2195,5,1165,4,1030,85282.920411,0.06564200000138953,141982.267447712,125529.38667050932
"147.32.84.165",3113,"46.4.36.120",443,6,366,3,186,3,180,85283.512438,1.0052099999884376,1480.2877010944137,1432.536484930078
"147.32.84.165",3114,"67.19.72.206",80,3,186,3,186,0,0,85283.889365,8.927628000004916,166.67361140038324,0
"147.32.84.165",3115,"67.19.72.206",80,3,186,3,186,0,0,85284.19012,8.927895000000717,166.66862681515414,0
"147.32.84.165",3116,"46.4.36.120",443,6,366,3,186,3,180,85285.517964,1.0062730000063311,1478.7239645609473,1431.023191510594
"147.32.84.165",3117,"58.143.125.236",6667,6,366,3,186,3,180,85286.243054,1.87654699999257,792.9457668824131,767.3668711765288
"147.32.84.165",3118,"193.23.181.44",80,3,186,3,186,0,0,85286.597542,9.028028000000631,164.8200470800374,0
"147.32.84.165",3119,"46.4.36.120",443,6,366,3,186,3,180,85287.524283,1.0058809999900404,1479.3002353307531,1431.5808729007288
"147.32.84.165",3120,"67.19.72.206",80,3,186,3,186,0,0,85287.801261,8.928289999996196,166.6612531627707,0
"147.32.84.165",3121,"174.37.196.55",80,3,186,3,186,0,0,85288.102233,8.928945000006934,166.64902740456398,0
"147.32.84.165",3122,"193.23.181.44",179,3,186,3,186,0,0,85288.202463,8.928596000012476,166.6555413637173,0
"147.32.84.165",3123,"174.37.196.55",80,3,186,3,186,0,0,85288.805069,8.928208000012091,166.6627838417278,0
"147.32.84.165",3124,"72.20.15.61",80,3,186,3,186,0,0,85288.805208,8.928092999994988,166.66493057373341,0
"147.32.84.165",3125,"174.37.196.55",80,3,186,3,186,0,0,85288.805344,8.927980000007665,166.66704002458815,0
"147.32.84.165",3126,"174.128.246.102",80,3,186,3,186,0,0,85288.904599,8.928373999995529,166.65968517904213,0
"147.32.84.165",3127,"174.128.246.102",80,3,186,3,186,0,0,85288.904824,8.92824500000279,166.66209316607407,0
"147.32.84.165",3129,"193.23.181.44",80,3,186,3,186,0,0,85289.005731,8.927819999997155,166.67002694952117,0
"147.32.84.165",3130,"193.23.181.44",80,3,186,3,186,0,0,85289.005994,8.927647999997134,166.67323801302175,0
"147.32.84.165",3131,"193.23.181.44",80,3,186,3,186,0,0,85289.006106,8.92754099999729,166.67523565564713,0
"147.32.84.165",3132,"174.128.246.102",80,3,186,3,186,0,0,85289.306186,8.928598999991664,166.65548536801677,0
"147.32.84.165",3133,"174.128.246.102",80,3,186,3,186,0,0,85289.40602,8.928678000011132,166.6540108175191,0
"147.32.84.165",3134,"46.4.36.120",443,6,366,3,186,3,180,85289.530843,1.006085000000894,1479.0002832749497,1431.2905967176932
"147.32.84.165",3135,"174.37.196.55",80,34,2191,18,1229,16,962,85289.60737,613.8836120000051,16.016065273297958,12.536578350620534
"147.32.84.165",3136,"193.23.181.44",80,3,186,3,186,0,0,85289.807439,9.028734000006807,164.80715901020875,0
"147.32.84.165",3137,"174.128.246.102",80,3,186,3,186,0,0,85289.807765,9.028465999988839,164.81205112826913,0
"147.32.84.165",3138,"72.20.15.61",80,3,186,3,186,0,0,85289.807889,9.028363999997964,164.8139131298135,0
"147.32.84.165",3139,"67.19.72.206",80,3,186,3,186,0,0,85289.808032,9.02824800000235,164.81603075143846,0
"147.32.84.165",3140,"193.23.181.44",80,3,186,3,186,0,0,85289.908197,9.028063999998267,164.81938984928394,0
"147.32.84.165",3141,"174.128.246.102",80,3,186,3,186,0,0,85289.90833,9.03005000000121,164.78314073563274,0
"147.32.84.165",3142,"67.19.72.206",80,3,186,3,186,0,0,85290.008621,9.02873799999361,164.8070859959668,0
"147.32.84.165",3143,"184.82.148.43",80,10,1919,5,979,5,940,85290.048079,0.3224740000005113,24287.229357987257,23319.70949592239
"147.32.84.165",3144,"184.82.148.44",80,10,1513,5,596,5,917,85290.26841,0.3575249999994412,13336.13034055647,20518.844836057524
"147.32.84.165",3145,"217.163.21.36",80,14,6137,7,809,7,5328,85290.520034,0.18726299999980256,34561.01846070406,227615.7062529434
"147.32.84.165",3146,"217.163.21.36",80,10,1448,5,699,5,749,85290.665365,0.13959900000190828,40057.59353522274,42922.943573507626
"147.32.84.165",3147,"217.163.21.35",80,13,4939,7,2103,6,2836,85290.7596,0.23112499999115244,72791.77934297039,98163.3315343148
"147.32.84.165",3149,"174.128.246.102",80,10,962,7,778,3,184,85290.911593,9.29459200000565,669.6367091741323,158.37166386637574
"147.32.84.165",3148,"72.20.15.61",80,7,561,4,379,3,182,85290.911814,0.36942599999019876,8207.327042710696,3941.2493978188572
"147.32.84.165",3150,"72.20.15.61",80,7,544,4,362,3,182,85290.912052,0.36946699999680277,7838.318442580964,3940.8120346677774
"147.32.84.165",3151,"193.23.181.44",80,3,186,3,186,0,0,85290.912312,9.027501000004122,164.8296688086017,0
"147.32.84.165",3152,"193.23.181.44",80,3,186,3,186,0,0,85290.912568,9.027310000004945,164.833156277915,0
"147.32.84.165",3153,"193.23.181.44",179,3,186,3,186,0,0,85290.912836,9.027063999994425,164.8376482099738,0
"147.32.84.165",3154,"174.37.196.55",80,3,186,3,186,0,0,85290.913186,9.026734999992186,164.84365609506517,0
"147.32.84.165",3155,"193.23.181.44",80,3,186,3,186,0,0,85291.097191,8.942695000005187,166.3927932238701,0
"147.32.84.165",3156,"174.128.246.102",80,9,723,5,481,4,242,85291.097301,3.2739549999969313,1175.3368632139436,591.3337232801962
"147.32.84.165",3157,"174.128.246.102",80,7,567,5,445,2,122,85291.111976,3.4807889999938197,1022.7566221354758,280.39619752927655
"147.32.84.165",3158,"67.19.72.206",80,3,186,3,186,0,0,85291.114012,9.027105000001029,164.8368995375406,0
"147.32.84.165",3159,"174.128.246.102",80,3,186,3,186,0,0,85291.114527,9.026611000008415,164.8459205784555,0
"147.32.84.165",3160,"67.19.72.206",80,3,186,3,186,0,0,85291.115275,9.025891999990563,164.85905215811974,0
"147.32.84.165",3161,"174.37.196.55",80,3,186,3,186,0,0,85291.115391,9.025798000002396,164.86076909760277,0
"147.32.84.165",3162,"193.23.181.44",179,3,186,3,186,0,0,85291.115507,9.025703000006615,164.86250433887636,0
"147.32.84.165",3163,"174.128.246.102",80,3,186,3,186,0,0,85291.115617,9.02561599999899,164.86409348682312,0
"147.32.84.165",3164,"193.23.181.44",80,3,186,3,186,0,0,85291.115728,9.025528999991366,164.8656826654065,0
"147.32.84.165",3165,"174.128.246.102",80,8,626,6,504,2,122,85291.115835,9.46417599999404,426.0275802143302,103.12572378204025
"147.32.84.165",3166,"193.23.181.44",80,3,186,3,186,0,0,85291.115943,9.025359999999637,164.86876977761108,0
"147.32.84.165",3167,"174.128.246.102",80,3,186,3,186,0,0,85291.116051,9.02527499999269,164.87032251108198,0
"147.32.84.165",3168,"72.20.15.61",80,3,186,3,186,0,0,85291.116157,9.02519200000097,164.87183873759582,0
"147.32.84.165",3169,"193.23.181.44",80,3,186,3,186,0,0,85291.116269,9.025102999992669,164.87346460214457,0
"147.32.84.165",3170,"174.37.196.55",80,3,186,3,186,0,0,85291.116406,9.024988999997731,164.8755472167749,0
"147.32.84.165",3171,"174.37.196.55",80,3,186,3,186,0,0,85291.116513,9.024904999998398,164.87708180864664,0
"147.32.84.165",3172,"72.20.15.61",80,3,186,3,186,0,0,85291.116619,9.024821000013617,164.87861642881947,0
"147.32.84.165",3173,"174.128.246.102",80,8,658,4,416,4,242,85291.116726,0.4453840000060154,7472.2037611478,4346.810841821556
"147.32.84.165",3174,"174.128.246.102",80,3,186,3,186,0,0,85291.116832,9.024632000000565,164.8820694295243,0
"147.32.84.165",3175,"67.19.72.206",80,3,186,3,186,0,0,85291.116942,9.024543999999878,164.88367722513405,0
"147.32.84.165",3176,"174.37.196.55",80,3,186,3,186,0,0,85291.118732,9.022776999991038,164.91596766732437,0
"147.32.84.165",3177,"72.20.15.61",80,3,186,3,186,0,0,85291.121935,9.01959799999895,164.97409308044251,0
"147.32.84.165",3178,"193.23.181.44",179,3,186,3,186,0,0,85291.125152,9.016403000001446,165.03255233819533,0
"147.32.84.165",3179,"174.37.196.55",80,3,186,3,186,0,0,85291.128355,9.013223000001744,165.09077829314907,0
"147.32.84.165",3180,"67.19.72.206",80,3,186,3,186,0,0,85291.131554,9.010046999988845,165.148972031094,0
"147.32.84.165",3181,"72.20.15.61",80,3,186,3,186,0,0,85291.134781,9.006842000002507,165.20773873901484,0
"147.32.84.165",3182,"174.37.196.55",80,3,186,3,186,0,0,85291.138024,9.003622999996878,165.2668042631856,0
"147.32.84.165",3183,"67.19.72.206",80,3,186,3,186,0,0,85291.141183,9.00048699999752,165.32438744708037,0
"147.32.84.165",3184,"174.37.196.55",80,3,186,3,186,0,0,85291.144336,8.999924000003375,165.33472949320927,0
"147.32.84.165",3185,"193.23.181.44",179,3,186,3,186,0,0,85291.147561,8.999931999991531,165.33458252811246,0
"147.32.84.165",3186,"72.20.15.61",80,3,186,3,186,0,0,85291.150781,8.999908999991021,165.33500505410493,0
"147.32.84.165",3188,"67.19.72.206",80,3,186,3,186,0,0,85291.153979,8.999881000010646,165.33551943611698,0
"147.32.84.165",3189,"174.37.196.55",80,3,186,3,186,0,0,85291.157156,8.999905999997281,165.3350601662339,0
"147.32.84.165",3190,"67.19.72.206",80,3,186,3,186,0,0,85291.160353,8.999909000005573,165.33500505383762,0
"147.32.84.165",3191,"174.128.246.102",80,3,186,3,186,0,0,85291.163587,8.999874000001,165.3356480323874,0
"147.32.84.165",3192,"193.23.181.44",80,3,186,3,186,0,0,85291.166782,8.99989999999525,165.33517039086937,0
"147.32.84.165",3193,"67.19.72.206",80,3,186,3,186,0,0,85291.169953,8.999926999997115,165.33467438130077,0
"147.32.84.165",3194,"67.19.72.206",80,3,186,3,186,0,0,85291.173182,8.999918999994406,165.33482134682822,0
"147.32.84.165",3195,"72.20.15.61",80,3,186,3,186,0,0,85291.176351,8.999929999990854,165.334619269429,0
"147.32.84.165",3196,"174.128.246.102",80,3,186,3,186,0,0,85291.179551,8.99992800000473,165.33465601049454,0
"147.32.84.165",3187,"67.19.72.206",80,3,186,3,186,0,0,85291.182783,8.99992800000473,165.33465601049454,0
"147.32.84.165",3197,"72.20.15.61",80,3,186,3,186,0,0,85291.185981,8.999932999999146,165.33456415732664,0
"147.32.84.165",3199,"174.128.246.102",80,3,186,3,186,0,0,85291.18916,8.999905000004219,165.3350785368626,0
"147.32.84.165",3200,"67.19.72.206",80,3,186,3,186,0,0,85291.192331,8.999947000003885,165.3343069686252,0
"147.32.84.165",3198,"193.23.181.44",179,3,186,3,186,0,0,85291.195566,8.999917000008281,165.33485808798358,0
"147.32.84.165",3201,"184.106.213.57",6667,10,1147,5,589,5,558,85291.198762,0.522633999993559,9015.869614410987,8541.350161020935
"147.32.84.165",3203,"193.23.181.44",80,3,186,3,186,0,0,85291.219132,9.02147999999579,164.93967730357926,0
"147.32.84.165",3202,"67.19.72.206",80,3,186,3,186,0,0,85291.222334,9.018324999997276,164.99738033398103,0
"147.32.84.165",3204,"174.128.246.102",80,3,186,3,186,0,0,85291.225533,9.015168999991147,165.05514206128151,0
"147.32.84.165",3205,"72.20.15.61",80,3,186,3,186,0,0,85291.228733,9.012017000000924,165.11287095883722,0
"147.32.84.165",3206,"174.37.196.55",80,3,186,3,186,0,0,85291.231932,9.011533000011696,165.12173899802272,0
"147.32.84.165",3207,"174.37.196.55",80,3,186,3,186,0,0,85291.235134,9.011549999995623,165.12142750145344,0
"147.32.84.165",3208,"193.23.181.44",80,3,186,3,186,0,0,85291.238334,9.011548000009498,165.12146414782808,0
"147.32.84.165",3209,"174.128.246.102",80,3,186,3,186,0,0,85291.241534,9.011547000001883,165.12148247128812,0
"147.32.84.165",3210,"72.20.15.61",80,3,186,3,186,0,0,85291.244734,9.011545999994269,165.12150079475225,0
"147.32.84.165",3211,"174.37.196.55",80,3,186,3,186,0,0,85291.247933,9.011550999988685,165.12140917827222,0
"147.32.84.165",3212,"193.23.181.44",80,3,186,3,186,0,0,85291.251134,9.011546999987331,165.12148247155477,0
"147.32.84.165",3213,"72.20.15.61",80,3,186,3,186,0,0,85291.254333,9.01154900000256,165.12144582463873,0
"147.32.84.165",3214,"174.37.196.55",80,3,186,3,186,0,0,85291.257534,9.011530999996467,165.1217756450689,0
"147.32.84.165",3215,"174.37.196.55",80,3,186,3,186,0,0,85291.260733,9.01152899999579,165.1218122918647,0
"147.32.84.165",3216,"193.23.181.44",179,3,186,3,186,0,0,85291.263933,9.011529000010341,165.12181229159808,0
"147.32.84.165",3217,"67.19.72.206",80,3,186,3,186,0,0,85291.267133,9.011578000005102,165.1209144501837,0
"147.32.84.165",3218,"193.23.181.44",80,3,186,3,186,0,0,85291.270334,9.011528000002727,165.1218306151354,0
"147.32.84.165",3219,"67.19.72.206",80,3,186,3,186,0,0,85291.273555,9.011556999990717,165.12129923847044,0
"147.32.84.165",3220,"72.20.15.61",80,3,186,3,186,0,0,85291.276737,9.011575000011362,165.12096941967678,0
"147.32.84.165",3221,"72.20.15.61",80,3,186,3,186,0,0,85291.279936,9.011576999997487,165.12093277352176,0
"147.32.84.165",3222,"174.37.196.55",80,3,186,3,186,0,0,85291.283154,9.011539999992237,165.12161073482244,0
"147.32.84.165",3223,"67.19.72.206",80,3,186,3,186,0,0,85291.286385,9.01147700000729,165.1227651137318,0
"147.32.84.165",3224,"67.19.72.206",80,3,186,3,186,0,0,85291.289553,9.011508000010508,165.12219708380272,0
"147.32.84.165",3225,"193.23.181.44",179,3,186,3,186,0,0,85291.292755,9.011507000002894,165.12221540742544,0
"147.32.84.165",3226,"193.23.181.44",179,3,186,3,186,0,0,85291.295954,9.011507000002894,165.12221540742544,0
"147.32.84.165",3227,"72.20.15.61",80,3,186,3,186,0,0,85291.299156,9.011506000009831,165.12223373078558,0
"147.32.84.165",3228,"174.128.246.102",80,3,186,3,186,0,0,85291.302334,9.011527999988175,165.12183061540202,0
"147.32.84.165",3229,"193.23.181.44",80,3,186,3,186,0,0,85291.305554,9.011507999995956,165.12219708406937,0
"147.32.84.165",3230,"193.23.181.44",179,3,186,3,186,0,0,85291.308736,9.011556999990717,165.12129923847044,0
"147.32.84.165",3231,"72.20.15.61",80,3,186,3,186,0,0,85291.311936,9.011526999995112,165.12184893867678,0
"147.32.84.165",3233,"67.19.72.206",80,3,186,3,186,0,0,85291.315154,9.011536000005435,165.12168402801726,0
"147.32.84.165",3234,"193.23.181.44",80,3,186,3,186,0,0,85291.318352,9.011509999996633,165.12216043710276,0
"147.32.84.165",3235,"72.20.15.61",80,3,186,3,186,0,0,85291.321553,9.01150900000357,165.1221787604507,0
"147.32.84.165",3236,"174.128.246.102",80,3,186,3,186,0,0,85291.324735,9.011526999995112,165.12184893867678,0
"147.32.84.165",3237,"72.20.15.61",80,3,186,3,186,0,0,85291.327938,9.011524000001373,165.12190390879204,0
"147.32.84.165",3238,"193.23.181.44",80,3,186,3,186,0,0,85291.331135,9.011526999995112,165.12184893867678,0
"147.32.84.165",3239,"174.37.196.55",80,3,186,3,186,0,0,85291.334334,9.011545999994269,165.12150079475225,0
"147.32.84.165",3240,"193.23.181.44",80,3,186,3,186,0,0,85291.337535,9.011530000003404,165.12179396833145,0
"147.32.84.165",3241,"174.37.196.55",80,3,186,3,186,0,0,85291.340756,9.011557999998331,165.12128091505105,0
"147.32.84.165",3242,"174.128.246.102",80,3,186,3,186,0,0,85291.343953,9.011530999996467,165.1217756450689,0
"147.32.84.165",3243,"193.23.181.44",80,3,186,3,186,0,0,85291.347182,9.011530999996467,165.1217756450689,0
"147.32.84.165",3244,"174.37.196.55",80,3,186,3,186,0,0,85291.350354,9.011561000006623,165.12122594508392,0
"147.32.84.165",3232,"67.19.72.206",80,3,186,3,186,0,0,85291.353591,9.011543999993592,165.12153744142603,0
"147.32.84.165",3245,"67.19.72.206",80,3,186,3,186,0,0,85291.35678,9.011503999994602,165.12227037805135,0
"147.32.84.165",3246,"174.128.246.102",80,3,186,3,186,0,0,85291.359955,9.011552999989362,165.12137253165537,0
"147.32.84.165",3247,"193.23.181.44",179,3,186,3,186,0,0,85291.363184,9.011530999996467,165.1217756450689,0
"147.32.84.165",3248,"174.37.196.55",80,3,186,3,186,0,0,85291.366353,9.01152600000205,165.12186726195557,0
"147.32.84.165",3249,"193.23.181.44",179,3,186,3,186,0,0,85291.369556,9.01152600000205,165.12186726195557,0
"147.32.84.165",3250,"72.20.15.61",80,3,186,3,186,0,0,85291.372784,9.011503999994602,165.12227037805135,0
"147.32.84.165",3251,"72.20.15.61",80,3,186,3,186,0,0,85291.375935,9.011581999991904,165.12084115767206,0
"147.32.84.165",3253,"67.19.72.206",80,3,186,3,186,0,0,85291.379153,9.01152600000205,165.12186726195557,0
"147.32.84.165",3254,"67.19.72.206",80,3,186,3,186,0,0,85291.382386,9.011494000005769,165.12245361302436,0
"147.32.84.165",3252,"174.37.196.55",80,3,186,3,186,0,0,85291.385591,9.011492999998154,165.12247193670402,0
"147.32.84.165",3255,"193.23.181.44",179,3,186,3,186,0,0,85291.407133,8.993149999994785,165.45926621938509,0
"147.32.84.165",3256,"193.23.181.44",179,3,186,3,186,0,0,85291.413533,9.025531999999657,164.8656278654883,0
"147.32.84.165",3257,"72.20.15.61",80,3,186,3,186,0,0,85291.437567,9.01114200000302,165.1289037504349,0
"147.32.84.165",3258,"174.37.196.55",80,3,186,3,186,0,0,85291.440765,9.011140999995405,165.12892207554611,0
"147.32.84.165",3259,"72.20.15.61",80,3,186,3,186,0,0,85291.443933,9.011151999991853,165.1287205011463,0
"147.32.84.165",3260,"193.23.181.44",80,3,186,3,186,0,0,85291.447155,9.011161000002176,165.12855557676096,0
"147.32.84.165",3261,"67.19.72.206",80,3,186,3,186,0,0,85291.450354,9.011155000000144,165.1286655262257,0
"147.32.84.165",3262,"193.23.181.44",179,3,186,3,186,0,0,85291.453588,9.011124999989988,165.12921527574562,0
"147.32.84.165",3263,"193.23.181.44",80,3,186,3,186,0,0,85291.456764,9.011148999998113,165.12877547583682,0
"147.32.84.165",3264,"67.19.72.206",80,3,186,3,186,0,0,85291.459988,9.011084999990999,165.12994828053297,0
"147.32.84.165",3265,"67.19.72.206",80,3,186,3,186,0,0,85291.463151,9.011163000002853,165.1285189269719,0
"147.32.84.165",3266,"174.37.196.55",80,3,186,3,186,0,0,85291.466354,9.011140000002342,165.12894040039475,0
"147.32.84.165",3267,"72.20.15.61",80,3,186,3,186,0,0,85291.469555,9.011159999994561,165.1285739017949,0
"147.32.84.165",3268,"193.23.181.44",80,3,186,3,186,0,0,85291.519077,9.02229599999555,164.92475972864713,0
"147.32.84.165",3269,"193.23.181.44",80,3,186,3,186,0,0,85291.519669,9.021727999992436,164.93514324542346,0
"147.32.84.165",3270,"72.20.15.61",80,3,186,3,186,0,0,85291.520428,9.020991999990656,164.94859988807676,0
"147.32.84.165",3271,"72.20.15.61",80,3,186,3,186,0,0,85291.520692,9.020752999989782,164.95297011254888,0
"147.32.84.165",3272,"72.20.15.61",80,3,186,3,186,0,0,85291.520908,9.020559999989928,164.95649937494585,0
"147.32.84.165",3273,"174.37.196.55",80,3,186,3,186,0,0,85291.521139,9.020351999992272,164.96030310139503,0
"147.32.84.165",3274,"193.23.181.44",80,3,186,3,186,0,0,85291.521355,9.020158999992418,164.96383267758924,0
"147.32.84.165",3275,"193.23.181.44",179,3,186,3,186,0,0,85291.521571,9.019965999992564,164.96736240482798,0
"147.32.84.165",3276,"193.23.181.44",80,3,186,3,186,0,0,85291.521789,9.019769999998971,164.97094715277328,0
"147.32.84.165",3277,"193.23.181.44",80,3,186,3,186,0,0,85291.522004,9.019578999999794,164.97444060305187,0
"147.32.84.165",3278,"67.19.72.206",80,3,186,3,186,0,0,85291.522217,9.019390999994357,164.97787932698904,0
"147.32.84.165",3279,"72.20.15.61",80,3,186,3,186,0,0,85291.522434,9.019197999994503,164.98140965537144,0
"147.32.84.165",3280,"67.19.72.206",80,3,186,3,186,0,0,85291.522648,9.019010000003618,164.98484866957716,0
"147.32.84.165",3281,"174.128.246.102",80,3,186,3,186,0,0,85291.522861,9.01881899998989,164.98834270891433,0
"147.32.84.165",3282,"193.23.181.44",179,3,186,3,186,0,0,85291.52313,9.018572999993921,164.99284310289477,0
"147.32.84.165",3283,"174.37.196.55",80,3,186,3,186,0,0,85291.523345,9.021323000008124,164.94254778358564,0
"147.32.84.165",3284,"67.19.72.206",80,3,186,3,186,0,0,85291.523936,9.023931999996421,164.8948595801243,0
"147.32.84.165",3285,"72.20.15.61",80,3,186,3,186,0,0,85291.527156,9.023914999997942,164.89517022271812,0
"147.32.84.165",3286,"72.20.15.61",80,3,186,3,186,0,0,85291.53035,9.023916999998619,164.8951336764542,0
"147.32.84.165",3287,"72.20.15.61",80,3,186,3,186,0,0,85291.533539,9.023929000002681,164.89491439921102,0
"147.32.84.165",3288,"72.20.15.61",80,3,186,3,186,0,0,85291.536738,9.023926000008942,164.89496921833418,0
"147.32.84.165",3290,"67.19.72.206",80,3,186,3,186,0,0,85291.539951,9.023912000004202,164.8952250420114,0
"147.32.84.165",3289,"174.37.196.55",80,3,186,3,186,0,0,85291.543151,9.023912999997265,164.8952067689982,0
"147.32.84.165",3291,"46.4.36.120",443,6,366,3,186,3,180,85291.546368,0.9973000000027241,1492.028476883521,1443.8985260163106
"147.32.84.165",3292,"72.20.15.61",80,3,186,3,186,0,0,85291.613972,9.028528999988339,164.81090108941578,0
"147.32.84.165",3293,"193.23.181.44",80,3,186,3,186,0,0,85291.614319,9.028302999999141,164.81502669993924,0
"147.32.84.165",3294,"193.23.181.44",179,3,186,3,186,0,0,85291.714182,9.028025000006892,164.82010184939276,0
"147.32.84.165",3295,"72.20.15.61",80,3,186,3,186,0,0,85291.716615,9.025630999996793,164.86381949367626,0
"147.32.84.165",3296,"193.23.181.44",80,3,186,3,186,0,0,85291.724647,9.017634000003454,165.01002369351318,0
"147.32.84.165",3297,"72.20.15.61",80,3,186,3,186,0,0,85291.725079,9.017241000008653,165.0172153542943,0
"147.32.84.165",3298,"67.19.72.206",80,3,186,3,186,0,0,85291.725346,9.017010999988997,165.02142450550585,0
"147.32.84.165",3299,"174.37.196.55",80,3,186,3,186,0,0,85291.725665,9.016726999994717,165.02662218794822,0
"147.32.84.165",3300,"174.37.196.55",80,3,186,3,186,0,0,85291.725884,9.016545999998925,165.0299349662473,0
"147.32.84.165",3301,"72.20.15.61",80,3,186,3,186,0,0,85291.726105,9.016360000008717,165.03333939622658,0
"147.32.84.165",3302,"72.20.15.61",80,3,186,3,186,0,0,85291.726328,9.016176999997697,165.03668905350685,0
"147.32.84.165",3303,"174.128.246.102",80,3,186,3,186,0,0,85291.726544,9.015998000002583,165.03996562549966,0
"147.32.84.165",3304,"174.37.196.55",80,3,186,3,186,0,0,85291.72681,9.015769000005093,165.04415763083097,0
"147.32.84.165",3305,"193.23.181.44",80,3,186,3,186,0,0,85291.727066,9.0155509999895,165.04814847165002,0
"147.32.84.165",3306,"72.20.15.61",80,3,186,3,186,0,0,85291.727281,9.015373999995063,165.05138888312507,0
"147.32.84.165",3307,"174.37.196.55",80,3,186,3,186,0,0,85291.7275,9.015209000004688,165.05440972019906,0
"147.32.84.165",3308,"193.23.181.44",80,3,186,3,186,0,0,85291.727724,9.015025000000605,165.05777854192308,0
"147.32.84.165",3309,"174.37.196.55",80,3,186,3,186,0,0,85291.727939,9.014844999997877,165.0610742614377,0
"147.32.84.165",3310,"67.19.72.206",80,3,186,3,186,0,0,85291.728203,9.014618999994127,165.065212406755,0
"147.32.84.165",3311,"193.23.181.44",80,3,186,3,186,0,0,85291.72842,9.014439999999013,165.0684901114393,0
"147.32.84.165",3312,"174.37.196.55",80,3,186,3,186,0,0,85291.728634,9.014263999997638,165.07171300955795,0
"147.32.84.165",3313,"174.37.196.55",80,3,186,3,186,0,0,85291.728852,9.014085999995586,165.07497265953847,0
"147.32.84.165",3314,"193.23.181.44",80,3,186,3,186,0,0,85291.729146,9.013831000003847,165.07964260694092,0
"147.32.84.165",3315,"193.23.181.44",179,3,186,3,186,0,0,85291.729264,9.013750000012806,165.08112605717776,0
"147.32.84.165",3316,"174.37.196.55",80,3,186,3,186,0,0,85291.729371,9.013681000011275,165.08238975820632,0
"147.32.84.165",3317,"193.23.181.44",80,3,186,3,186,0,0,85291.72948,9.013610000009066,165.08369010845857,0
"147.32.84.165",3318,"193.23.181.44",179,3,186,3,186,0,0,85291.729586,9.013540999992983,165.08495384900988,0
"147.32.84.165",3319,"193.23.181.44",179,3,186,3,186,0,0,85291.742727,9.00261799999862,165.2852536895632,0
"147.32.84.165",3320,"72.20.15.61",80,3,186,3,186,0,0,85291.763585,8.984909000006155,165.61102622174366,0
"147.32.84.165",3321,"174.37.196.55",80,3,186,3,186,0,0,85291.783084,8.96861200001149,165.91196051274085,0
"147.32.84.165",3322,"67.19.72.206",80,3,186,3,186,0,0,85291.814819,9.02823399999761,164.81628633023843,0
"147.32.84.165",3323,"67.19.72.206",80,3,186,3,186,0,0,85291.815347,9.02782699999807,164.8237167150321,0
"147.32.84.165",3324,"193.23.181.44",80,3,186,3,186,0,0,85291.815558,9.02766399999382,164.8266927082154,0
"147.32.84.165",3325,"193.23.181.44",179,3,186,3,186,0,0,85291.81572,9.027545000004466,164.82886543343332,0
"147.32.84.165",3326,"193.23.181.44",179,3,186,3,186,0,0,85291.815858,9.027455999996164,164.83049045053582,0
"147.32.84.165",3327,"72.20.15.61",80,3,186,3,186,0,0,85291.815966,9.027394000004278,164.83162250360346,0
"147.32.84.165",3328,"72.20.15.61",80,3,186,3,186,0,0,85291.816071,9.027335999999195,164.83268153529818,0
"147.32.84.165",3329,"174.37.196.55",80,3,186,3,186,0,0,85291.816177,9.027277999994112,164.83374058060144,0
"147.32.84.165",3330,"72.20.15.61",80,3,186,3,186,0,0,85291.816283,9.027219000010518,164.8348178988752,0
"147.32.84.165",3331,"174.37.196.55",80,3,186,3,186,0,0,85291.816389,9.02715999999782,164.83589523176272,0
"147.32.84.165",3332,"67.19.72.206",80,3,186,3,186,0,0,85291.816525,9.027069999996456,164.83753864771006,0
"147.32.84.165",3334,"72.20.15.61",80,3,186,3,186,0,0,85291.816652,9.02699000001303,164.83899948907137,0
"147.32.84.165",3335,"174.128.246.102",80,3,186,3,186,0,0,85291.816759,9.026932000007946,164.84005861556176,0
"147.32.84.165",3336,"174.37.196.55",80,3,186,3,186,0,0,85291.816865,9.026874000002863,164.84111775566248,0
"147.32.84.165",3337,"67.19.72.206",80,3,186,3,186,0,0,85291.816971,9.026816000012332,164.84217690910808,0
"147.32.84.165",3333,"67.19.72.206",80,3,186,3,186,0,0,85291.817075,9.026761000000988,164.8431812916989,0
"147.32.84.165",3338,"174.37.196.55",80,3,186,3,186,0,0,85291.81721,9.026674000007915,164.84477006688124,0
"147.32.84.165",3339,"193.23.181.44",80,3,186,3,186,0,0,85291.817348,9.026582000005874,164.8464501844698,0
"147.32.84.165",3340,"193.23.181.44",80,3,186,3,186,0,0,85291.817457,9.026519999999437,164.8475824570369,0
"147.32.84.165",3341,"174.128.246.102",80,3,186,3,186,0,0,85292.015078,9.02856600000814,164.81022567688584,0
"147.32.84.165",3342,"174.37.196.55",80,3,186,3,186,0,0,85292.015438,9.028267000001506,164.81568389589629,0
"147.32.84.165",3343,"174.128.246.102",80,3,186,3,186,0,0,85292.016807,9.026919999989332,164.84027774720045,0
"147.32.84.165",3344,"174.37.196.55",80,3,186,3,186,0,0,85292.017795,9.025958999991417,164.85782840376464,0
"147.32.84.165",3345,"67.19.72.206",80,3,186,3,186,0,0,85292.018034,9.025743000005605,164.8617737065055,0
"147.32.84.165",3346,"174.128.246.102",80,3,186,3,186,0,0,85292.018253,9.02554699999746,164.8653538672414,0
"147.32.84.165",3347,"193.23.181.44",179,3,186,3,186,0,0,85292.018527,9.025296000007074,164.86993889162568,0
"147.32.84.165",3348,"193.23.181.44",80,3,186,3,186,0,0,85292.018747,9.025099999998929,164.87351940700674,0
"147.32.84.165",3349,"193.23.181.44",80,3,186,3,186,0,0,85292.018998,9.024875000002794,164.87762988401937,0
"147.32.84.165",3350,"67.19.72.206",80,3,186,3,186,0,0,85292.019222,9.024674000000232,164.88130208359456,0
"147.32.84.165",3352,"193.23.181.44",179,3,186,3,186,0,0,85292.019523,9.024395000000368,164.8863995868908,0
"147.32.84.165",3353,"174.37.196.55",80,3,186,3,186,0,0,85292.01974,9.0242009999929,164.8899442733125,0
"147.32.84.165",3354,"174.128.246.102",80,3,186,3,186,0,0,85292.020009,9.023952000003192,164.89449411959126,0
"147.32.84.165",3355,"72.20.15.61",80,3,186,3,186,0,0,85292.020253,9.023732000001473,164.89851427322498,0
"147.32.84.165",3356,"67.19.72.206",80,3,186,3,186,0,0,85292.020469,9.02353900000162,164.90204120575453,0
"147.32.84.165",3351,"174.37.196.55",80,3,186,3,186,0,0,85292.020684,9.023350999996183,164.90547691213936,0
"147.32.84.165",3357,"174.37.196.55",80,3,186,3,186,0,0,85292.115403,9.028164000003017,164.81756423559682,0
"147.32.84.165",3358,"72.20.15.61",80,3,186,3,186,0,0,85292.116185,9.027496999988216,164.82974184338607,0
"147.32.84.165",3359,"67.19.72.206",80,3,186,3,186,0,0,85292.116308,9.027413999996497,164.83125732358982,0
"147.32.84.165",3360,"174.37.196.55",80,3,186,3,186,0,0,85292.116443,9.027313999991748,164.83308324063617,0
"147.32.84.165",3361,"72.20.15.61",80,3,186,3,186,0,0,85292.116652,9.027146000007633,164.8361508719081,0
"147.32.84.165",3362,"67.19.72.206",80,3,186,3,186,0,0,85292.116814,9.027023000002373,164.8383968889421,0
"147.32.84.165",3363,"193.23.181.44",179,3,186,3,186,0,0,85292.116952,9.026922999997623,164.84022296416973,0
"147.32.84.165",3364,"193.23.181.44",80,3,186,3,186,0,0,85292.117089,9.02682499999355,164.84201255713532,0
"147.32.84.165",3365,"193.23.181.44",80,3,186,3,186,0,0,85292.117223,9.026725000003353,164.84383871220706,0
"147.32.84.165",3366,"174.128.246.102",80,8,631,4,389,4,242,85292.117361,0.31527900000219233,9870.622527914515,6140.592935103631
"147.32.84.165",3367,"174.128.246.102",80,8,641,5,459,3,182,85292.117487,3.323426000002655,1104.8839360337995,438.10212714194233
"147.32.84.165",3368,"193.23.181.44",179,3,186,3,186,0,0,85292.117616,9.026370999999926,164.85030362700715,0
"147.32.84.165",3369,"193.23.181.44",80,3,186,3,186,0,0,85292.117753,9.026270999995177,164.85212996605077,0
"147.32.84.165",3370,"174.128.246.102",80,3,186,3,186,0,0,85292.117885,9.026178999993135,164.85381023366938,0
"147.32.84.165",3371,"193.23.181.44",179,3,186,3,186,0,0,85292.118062,9.026039000003948,164.8563672281218,0
"147.32.84.165",3372,"193.23.181.44",80,3,186,3,186,0,0,85292.118192,9.025944000008167,164.8581023767324,0
"147.32.84.165",3373,"72.20.15.61",80,3,186,3,186,0,0,85292.118373,9.025800999996136,164.8607143012168,0
"147.32.84.165",3374,"193.23.181.44",179,3,186,3,186,0,0,85292.118495,9.025716999996803,164.8622486169827,0
"147.32.84.165",3375,"174.128.246.102",80,7,580,5,458,2,122,85292.215209,3.333050999994157,1099.2931101283548,292.82480226126484
"147.32.84.165",3376,"72.20.15.61",80,3,186,3,186,0,0,85292.215395,9.028727999990224,164.80726853235706,0
"147.32.84.165",3378,"174.128.246.102",80,3,186,3,186,0,0,85292.216082,9.028103999997256,164.81865959900907,0
"147.32.84.165",3377,"72.20.15.61",80,3,186,3,186,0,0,85292.21622,9.027988000001642,164.82077734260716,0
"147.32.84.165",3379,"193.23.181.44",80,3,186,3,186,0,0,85292.216345,9.027883000002475,164.82269431267463,0
"147.32.84.165",3380,"67.19.72.206",80,3,186,3,186,0,0,85292.216484,9.027768999992986,164.82477564514068,0
"147.32.84.165",3381,"174.37.196.55",80,3,186,3,186,0,0,85292.21662,9.027652999997372,164.82689354591201,0
"147.32.84.165",3382,"174.37.196.55",80,3,186,3,186,0,0,85292.216752,9.027543000003789,164.82890195032863,0
"147.32.84.165",3383,"193.23.181.44",179,3,186,3,186,0,0,85292.21692,9.027405000000726,164.83142165438244,0
"147.32.84.165",3384,"174.37.196.55",80,3,186,3,186,0,0,85292.217057,9.027289000005112,164.83353972595287,0
"147.32.84.165",3385,"193.23.181.44",179,3,186,3,186,0,0,85292.217191,9.02717999999004,164.83553003281665,0
"147.32.84.165",3386,"193.23.181.44",80,3,186,3,186,0,0,85292.217331,9.02706299998681,164.8376664704981,0
"147.32.84.165",3387,"72.20.15.61",80,3,186,3,186,0,0,85292.21751,9.026905999999144,164.84053340093948,0
"147.32.84.165",3388,"67.19.72.206",80,3,186,3,186,0,0,85292.217724,9.02671299999929,164.84405785363032,0
"147.32.84.165",3390,"174.37.196.55",80,3,186,3,186,0,0,85292.217907,9.026553999996395,164.846961531565,0
"147.32.84.165",3391,"174.128.246.102",80,3,186,3,186,0,0,85292.218064,9.026419999994687,164.84940873578626,0
"147.32.84.165",3392,"193.23.181.44",179,3,186,3,186,0,0,85292.218191,9.026313999987906,164.85134463547288,0
"147.32.84.165",3393,"174.128.246.102",80,3,186,3,186,0,0,85292.218325,9.026201000000583,164.85340842730002,0
"147.32.84.165",3394,"72.20.15.61",80,3,186,3,186,0,0,85292.275959,8.968588999996427,165.9123859952321,0
"147.32.84.165",3395,"174.37.196.55",80,3,186,3,186,0,0,85292.316161,9.027656000005663,164.82683877177715,0
"147.32.84.165",3396,"174.37.196.55",80,3,186,3,186,0,0,85292.316605,9.027333999998518,164.83271805388438,0
"147.32.84.165",3397,"67.19.72.206",80,3,186,3,186,0,0,85292.317025,9.026962999996613,164.83949252927684,0
"147.32.84.165",3398,"193.23.181.44",80,3,186,3,186,0,0,85292.317145,9.026886000006925,164.84089862205622,0
"147.32.84.165",3399,"193.23.181.44",179,3,186,3,186,0,0,85292.317262,9.026819000006071,164.84212212508075,0
"147.32.84.165",3400,"193.23.181.44",80,3,186,3,186,0,0,85292.317378,9.026747999989311,164.843418693173,0
"147.32.84.165",3401,"193.23.181.44",179,3,186,3,186,0,0,85292.317493,9.026679000002332,164.84467875722794,0
"147.32.84.165",3402,"174.37.196.55",80,3,186,3,186,0,0,85292.317608,9.026611000008415,164.8459205784555,0
"147.32.84.165",3403,"193.23.181.44",80,3,186,3,186,0,0,85292.317722,9.026539999991655,164.84721720630225,0
"147.32.84.165",3404,"174.128.246.102",80,3,186,3,186,0,0,85292.31784,9.026469999997062,164.84849559135347,0
"147.32.84.165",3405,"193.23.181.44",80,3,186,3,186,0,0,85292.317952,9.026406999997562,164.84964615493206,0
"147.32.84.165",3406,"174.128.246.102",80,3,186,3,186,0,0,85292.318099,9.026308000000427,164.85145421582442,0
"147.32.84.165",3407,"72.20.15.61",80,3,186,3,186,0,0,85292.318215,9.026240999999573,164.8526778755487,0
"147.32.84.165",3408,"193.23.181.44",179,3,186,3,186,0,0,85292.318332,9.026170000011916,164.85397460916818,0
"147.32.84.165",3409,"67.19.72.206",80,3,186,3,186,0,0,85292.318445,9.026104999997187,164.8551617780276,0
"147.32.84.165",3410,"174.128.246.102",80,3,186,3,186,0,0,85292.318574,9.026029000000563,164.85654987369387,0
"147.32.84.165",3411,"193.23.181.44",179,3,186,3,186,0,0,85292.318687,9.025962999992771,164.85775534435402,0
"147.32.84.165",3412,"174.128.246.102",80,3,186,3,186,0,0,85292.318802,9.025894999998854,164.85899736260933,0
"147.32.84.165",3413,"174.37.196.55",80,3,186,3,186,0,0,85292.318913,9.025831000006292,164.86016633803166,0
"147.32.84.165",3414,"193.23.181.44",80,3,186,3,186,0,0,85292.33397,9.010819999995874,165.1348046016546,0
"147.32.84.165",3415,"72.20.15.61",80,3,186,3,186,0,0,85292.354113,8.990724000002956,165.50391269930105,0
"147.32.84.165",3416,"193.23.181.44",179,3,186,3,186,0,0,85292.367058,8.977824999994482,165.7417024725827,0
"147.32.84.165",3417,"174.37.196.55",80,3,186,3,186,0,0,85292.41562,9.029123000000254,164.80005865463988,0
"147.32.84.165",3418,"174.128.246.102",80,3,186,3,186,0,0,85292.415825,9.028940999996848,164.80338059585497,0
"147.32.84.165",3419,"72.20.15.61",80,3,186,3,186,0,0,85292.416005,9.028784999987693,164.8062280807471,0
"147.32.84.165",3420,"72.20.15.61",80,3,186,3,186,0,0,85292.416787,9.028025999999954,164.8200835930255,0
"147.32.84.165",3421,"174.37.196.55",80,3,186,3,186,0,0,85292.417097,9.027738999997382,164.82532337282143,0
"147.32.84.165",3422,"193.23.181.44",179,3,186,3,186,0,0,85292.417328,9.027530999999726,164.82912105204016,0
"147.32.84.165",3423,"72.20.15.61",80,3,186,3,186,0,0,85292.417448,9.027435000010883,164.83087388590516,0
"147.32.84.165",3424,"174.37.196.55",80,3,186,3,186,0,0,85292.417557,9.027349000010872,164.83244416474957,0
"147.32.84.165",3425,"72.20.15.61",80,3,186,3,186,0,0,85292.417663,9.027264999996987,164.8339779546182,0
"147.32.84.165",3426,"72.20.15.61",80,3,186,3,186,0,0,85292.41777,9.027182000005268,164.83549351271876,0
"147.32.84.165",3428,"174.128.246.102",80,3,186,3,186,0,0,85292.417909,9.02706500000204,164.83762994945354,0
"147.32.84.165",3429,"174.128.246.102",80,3,186,3,186,0,0,85292.418052,9.026945000005071,164.8398212240314,0
"147.32.84.165",3430,"193.23.181.44",179,3,186,3,186,0,0,85292.418171,9.026849000001675,164.8415742857473,0
"147.32.84.165",3431,"193.23.181.44",80,3,186,3,186,0,0,85292.418279,9.026763999994728,164.84312650700397,0
"147.32.84.165",3432,"193.23.181.44",80,3,186,3,186,0,0,85292.418387,9.026679999995395,164.84466049541572,0
"147.32.84.165",3433,"193.23.181.44",80,3,186,3,186,0,0,85292.418494,9.026595999996061,164.84619451237756,0
"147.32.84.165",3434,"174.37.196.55",80,3,186,3,186,0,0,85292.4186,9.026511999996728,164.8477285578903,0
"147.32.84.165",3435,"72.20.15.61",80,3,186,3,186,0,0,85292.418706,9.026429999998072,164.84922610603724,0
"147.32.84.165",3436,"193.23.181.44",179,3,186,3,186,0,0,85292.418838,9.026320999997552,164.8512167914706,0
"147.32.84.165",3427,"193.23.181.44",179,3,186,3,186,0,0,85292.418975,9.026208000010229,164.85328058009674,0
"147.32.84.165",3437,"174.37.196.55",80,3,186,3,186,0,0,85292.516532,9.027968000009423,164.82114247618588,0
"147.32.84.165",3439,"72.20.15.61",80,3,186,3,186,0,0,85292.517048,9.027502000011737,164.82965054984928,0
"147.32.84.165",3438,"193.23.181.44",80,3,186,3,186,0,0,85292.517158,9.027438000004622,164.83081910939052,0
"147.32.84.165",3440,"193.23.181.44",179,3,186,3,186,0,0,85292.517287,9.027356999999029,164.83229809125308,0
"147.32.84.165",3441,"193.23.181.44",179,3,186,3,186,0,0,85292.517424,9.027266999997664,164.83394143547378,0
"147.32.84.165",3442,"193.23.181.44",179,3,186,3,186,0,0,85292.517561,9.0271769999963,164.8355848124624,0
"147.32.84.165",3443,"72.20.15.61",80,3,186,3,186,0,0,85292.51775,9.027035000006435,164.83817776256979,0
"147.32.84.165",3444,"72.20.15.61",80,3,186,3,186,0,0,85292.517929,9.026903000005404,164.84058818391082,0
"147.32.84.165",3445,"174.37.196.55",80,3,186,3,186,0,0,85292.518143,9.0267359999998,164.8436378332138,0
"147.32.84.165",3446,"174.37.196.55",80,3,186,3,186,0,0,85292.51827,9.026668999998947,164.84486137690146,0
"147.32.84.165",3447,"174.128.246.102",80,3,186,3,186,0,0,85292.518398,9.02658999999403,164.84630408614817,0
"147.32.84.165",3448,"72.20.15.61",80,3,186,3,186,0,0,85292.518523,9.026511999996728,164.8477285578903,0
"147.32.84.165",3449,"67.19.72.206",80,3,186,3,186,0,0,85292.616309,9.02894999999262,164.80321632096937,0
"147.32.84.165",3450,"174.37.196.55",80,33,2120,17,1158,16,962,85292.616467,610.8756120000035,15.165116789766273,12.598309457474228
"147.32.84.165",3451,"67.19.72.206",80,3,186,3,186,0,0,85292.616584,9.028781999993953,164.8062828409188,0
"147.32.84.165",3452,"174.128.246.102",80,3,186,3,186,0,0,85292.71862,9.027633999998216,164.82724044863738,0
"147.32.84.165",3453,"67.19.72.206",80,3,186,3,186,0,0,85292.71948,9.026895000002696,164.8407342723667,0
"147.32.84.165",3454,"72.20.15.61",80,3,186,3,186,0,0,85292.719591,9.026832999996259,164.8418664664137,0
"147.32.84.165",3455,"174.128.246.102",80,3,186,3,186,0,0,85292.71978,9.02668700000504,164.84453266178048,0
"147.32.84.165",3456,"193.23.181.44",179,3,186,3,186,0,0,85292.71989,9.026628000006895,164.84561012139454,0
"147.32.84.165",3457,"174.128.246.102",80,3,186,3,186,0,0,85292.719996,9.026568000001134,164.84670585762086,0
"147.32.84.165",3458,"193.23.181.44",80,3,186,3,186,0,0,85292.720103,9.026503000000957,164.847892921527,0
"147.32.84.165",3459,"193.23.181.44",179,3,186,3,186,0,0,85292.720211,9.02644099999452,164.8490252139136,0
"147.32.84.165",3460,"193.23.181.44",179,3,186,3,186,0,0,85292.720325,9.026373000000603,164.8502671006284,0
"147.32.84.165",3461,"174.37.196.55",80,3,186,3,186,0,0,85292.720434,9.026310000001104,164.85141768893578,0
"147.32.84.165",3462,"174.37.196.55",80,3,186,3,186,0,0,85292.720541,9.026249999995343,164.85251350237004,0
"147.32.84.165",3463,"193.23.181.44",179,3,186,3,186,0,0,85292.720649,9.026184000002104,164.8537189137351,0
"147.32.84.165",3464,"174.37.196.55",80,3,186,3,186,0,0,85292.720755,9.026127999997698,164.8547417010239,0
"147.32.84.165",3465,"174.128.246.102",80,3,186,3,186,0,0,85292.720862,9.026067999991938,164.85583755865002,0
"147.32.84.165",3466,"174.128.246.102",80,3,186,3,186,0,0,85292.720967,9.026008999993792,164.85691516605218,0
"147.32.84.165",3467,"67.19.72.206",80,3,186,3,186,0,0,85292.721102,9.025921000007656,164.8585224708634,0
"147.32.84.165",3468,"67.19.72.206",80,3,186,3,186,0,0,85292.72464,9.022429999997257,164.92231028674672,0
"147.32.84.165",3470,"193.23.181.44",179,3,186,3,186,0,0,85292.745482,9.001634000000195,165.30332159694206,0
"147.32.84.165",3469,"67.19.72.206",80,3,186,3,186,0,0,85292.745598,9.00156699999934,165.3045519741295,0
"147.32.84.165",3471,"174.37.196.55",80,3,186,3,186,0,0,85292.751899,8.99531399999978,165.41946173307974,0
"147.32.84.165",3472,"174.37.196.55",80,3,186,3,186,0,0,85292.752049,8.995213000001968,165.42131909490908,0
"147.32.84.165",3473,"193.23.181.44",179,3,186,3,186,0,0,85292.752166,8.995140999992145,165.4226431805015,0
"147.32.84.165",3475,"67.19.72.206",80,3,186,3,186,0,0,85292.752281,8.99507300001278,165.42389372469637,0
"147.32.84.165",3476,"193.23.181.44",80,3,186,3,186,0,0,85292.752407,8.994991999992635,165.4253833690145,0
"147.32.84.165",3477,"174.128.246.102",80,3,186,3,186,0,0,85292.752518,8.994929000007687,165.42654199924516,0
"147.32.84.165",3474,"193.23.181.44",80,3,186,3,186,0,0,85292.752634,8.994861999992281,165.42777421168628,0
"147.32.84.165",3478,"67.19.72.206",80,3,186,3,186,0,0,85292.818842,9.027001000009477,164.83879862187206,0
"147.32.84.165",3479,"72.20.15.61",80,3,186,3,186,0,0,85292.819492,9.026456000006874,164.8487512705836,0
"147.32.84.165",3480,"72.20.15.61",80,3,186,3,186,0,0,85292.820143,9.025828999991063,164.86020286906316,0
"147.32.84.165",3481,"193.23.181.44",80,3,186,3,186,0,0,85292.820432,9.025560000009136,164.86511640258263,0
"147.32.84.165",3482,"72.20.15.61",80,3,186,3,186,0,0,85292.820708,9.025305000002845,164.86977448402362,0
"147.32.84.165",3483,"72.20.15.61",80,3,186,3,186,0,0,85292.820928,9.025112999996054,164.87328191909072,0
"147.32.84.165",3484,"72.20.15.61",80,3,186,3,186,0,0,85292.821141,9.024923000004492,164.87675296501249,0
"147.32.84.165",3485,"174.37.196.55",80,3,186,3,186,0,0,85292.821409,9.024676000000909,164.8812655434777,0
"147.32.84.165",3486,"193.23.181.44",179,3,186,3,186,0,0,85292.821627,9.024480000007316,164.88484655058173,0
"147.32.84.165",3487,"67.19.72.206",80,3,186,3,186,0,0,85292.821841,9.024290000001201,164.88831808372757,0
"147.32.84.165",3488,"193.23.181.44",179,3,186,3,186,0,0,85292.822075,9.024078000002191,164.89219175628122,0
"147.32.84.165",3489,"174.37.196.55",80,3,186,3,186,0,0,85292.822297,9.023879000000306,164.89582805797258,0
"147.32.84.165",3490,"72.20.15.61",80,3,186,3,186,0,0,85292.822511,9.023692999995546,164.89922695738147,0
"147.32.84.165",3491,"67.19.72.206",80,3,186,3,186,0,0,85292.822727,9.023498999988078,164.9027721953497,0
"147.32.84.165",3492,"174.128.246.102",80,3,186,3,186,0,0,85292.82294,9.023320000007516,164.90604345171852,0
"147.32.84.165",3493,"174.128.246.102",80,3,186,3,186,0,0,85292.823235,9.023061999992933,164.91075867606423,0
"147.32.84.165",3494,"72.20.15.61",80,3,186,3,186,0,0,85292.823506,9.022815000003902,164.91527311591298,0
"147.32.84.165",3495,"193.23.181.44",80,3,186,3,186,0,0,85292.91833,9.028447999997297,164.8123797135948,0
"147.32.84.165",3496,"193.23.181.44",80,3,186,3,186,0,0,85292.918515,9.028330000001006,164.81453380634449,0
"147.32.84.165",3497,"193.23.181.44",80,3,186,3,186,0,0,85292.919256,9.027618000007351,164.827532578227,0
"147.32.84.165",3498,"174.128.246.102",80,3,186,3,186,0,0,85292.919672,9.027226999998675,164.8346718211715,0
"147.32.84.165",3499,"67.19.72.206",80,3,186,3,186,0,0,85292.919851,9.027073000004748,164.83748386649995,0
"147.32.84.165",3500,"174.128.246.102",80,3,186,3,186,0,0,85292.919995,9.026952999993227,164.8396751374596,0
"147.32.84.165",3501,"174.128.246.102",80,3,186,3,186,0,0,85292.920104,9.026868000000832,164.84122732268412,0
"147.32.84.165",3502,"67.19.72.206",80,3,186,3,186,0,0,85292.920239,9.026756999999634,164.8432543381926,0
"147.32.84.165",3503,"193.23.181.44",80,3,186,3,186,0,0,85292.920351,9.026668000005884,164.8448796387582,0
"147.32.84.165",3504,"174.37.196.55",80,3,186,3,186,0,0,85292.920467,9.02657599998929,164.84655975884604,0
"147.32.84.165",3505,"67.19.72.206",80,3,186,3,186,0,0,85292.92453,9.022535999989486,164.92037272023452,0
"147.32.84.165",3506,"174.37.196.55",80,3,186,3,186,0,0,85292.937549,9.00954100000672,165.15824724021903,0
"147.32.84.165",3507,"174.128.246.102",80,3,186,3,186,0,0,85292.94427,9.002843999987817,165.28110450453363,0
"147.32.84.165",3508,"174.128.246.102",80,3,186,3,186,0,0,85293.020144,9.02636899999925,164.85034015340207,0
"147.32.84.165",3509,"193.23.181.44",179,3,186,3,186,0,0,85293.021431,9.02510600000096,164.873409797053,0
"147.32.84.165",3510,"174.37.196.55",80,3,186,3,186,0,0,85293.021744,9.024814000003971,164.87874431532276,0
"147.32.84.165",3511,"193.23.181.44",80,3,186,3,186,0,0,85293.022015,9.024564999999711,164.88329354379383,0
"147.32.84.165",3512,"174.128.246.102",80,3,186,3,186,0,0,85293.022231,9.024373000007472,164.88680155383292,0
"147.32.84.165",3513,"174.37.196.55",80,3,186,3,186,0,0,85293.022445,9.024182000008295,164.89029144122227,0
"147.32.84.165",3514,"72.20.15.61",80,7,544,4,362,3,182,85293.022671,0.3693000000057509,7841.862983901711,3942.594096878761
"147.32.84.165",3515,"193.23.181.44",80,3,186,3,186,0,0,85293.022887,9.023763000004692,164.89794778511208,0
"147.32.84.165",3516,"193.23.181.44",179,3,186,3,186,0,0,85293.023101,9.023572000005515,164.9014381443502,0
"147.32.84.165",3517,"193.23.181.44",179,3,186,3,186,0,0,85293.023369,9.02332700000261,164.90591552312907,0
"147.32.84.165",3518,"174.37.196.55",80,3,186,3,186,0,0,85293.023585,9.023134000002756,164.90944277227243,0
"147.32.84.165",3519,"174.128.246.102",80,3,186,3,186,0,0,85293.023799,9.022941999995965,164.91295189536467,0
"147.32.84.165",3520,"174.37.196.55",80,3,186,3,186,0,0,85293.024039,9.022725000002538,164.91691811504634,0
"147.32.84.165",3521,"193.23.181.44",80,3,186,3,186,0,0,85293.024258,9.022530000002007,164.9204823923743,0
"147.32.84.165",3522,"67.19.72.206",80,3,186,3,186,0,0,85293.024472,9.022339999995893,164.92395542627273,0
"147.32.84.165",3523,"193.23.181.44",179,3,186,3,186,0,0,85293.024741,9.022098000001279,164.92837918628118,0
"147.32.84.165",3524,"193.23.181.44",80,3,186,3,186,0,0,85293.024959,9.02190399999381,164.93192567788583,0
"147.32.84.165",3525,"193.23.181.44",179,3,186,3,186,0,0,85293.025176,9.021710000000894,164.9354723217497,0
"147.32.84.165",3527,"193.23.181.44",80,3,186,3,186,0,0,85293.025471,9.021437999996124,164.94044519295474,0
"147.32.84.165",3528,"72.20.15.61",80,3,186,3,186,0,0,85293.025688,9.021245000010822,164.94397391914475,0
"147.32.84.165",3526,"193.23.181.44",179,3,186,3,186,0,0,85293.025929,9.021029000010458,164.9479233464691,0
"147.32.84.165",3529,"174.37.196.55",80,3,186,3,186,0,0,85293.026199,9.020782000006875,164.95243982161037,0
"147.32.84.165",3530,"193.23.181.44",80,3,186,3,186,0,0,85293.02645,9.02055799998925,164.9565359484162,0
"147.32.84.165",3531,"174.128.246.102",80,3,186,3,186,0,0,85293.026666,9.020368999990751,164.95999221334802,0
"147.32.84.165",3532,"193.23.181.44",80,3,186,3,186,0,0,85293.118378,9.028250000003027,164.81599424024603,0
"147.32.84.165",3533,"67.19.72.206",80,3,186,3,186,0,0,85293.118501,9.028185999995912,164.81716260616182,0
"147.32.84.165",3534,"174.37.196.55",80,3,186,3,186,0,0,85293.118637,9.028076999995392,164.8191525172813,0
"147.32.84.165",3535,"67.19.72.206",80,3,186,3,186,0,0,85293.1188,9.02793599999859,164.82172669370192,0
"147.32.84.165",3536,"174.37.196.55",80,3,186,3,186,0,0,85293.208309,8.938452000002144,166.47177833473214,0
"147.32.84.165",3537,"174.37.196.55",80,3,186,3,186,0,0,85293.218107,9.028476999999839,164.8118503264755,0
"147.32.84.165",3538,"193.23.181.44",179,3,186,3,186,0,0,85293.218477,9.02823100000387,164.81634109709444,0
"147.32.84.165",3539,"193.23.181.44",80,3,186,3,186,0,0,85293.318648,9.029240999996546,164.79790494024573,0
"147.32.84.165",3540,"67.19.72.206",80,3,186,3,186,0,0,85293.318846,9.029104000001098,164.8004054444183,0
"147.32.84.165",3541,"193.23.181.44",80,3,186,3,186,0,0,85293.319041,9.028939000010723,164.80341710119347,0
"147.32.84.165",3542,"67.19.72.206",80,3,186,3,186,0,0,85293.419389,9.02871199999936,164.8075605911569,0
"147.32.84.165",3543,"46.4.36.120",443,6,366,3,186,3,180,85293.543543,1.0059569999866653,1479.1884742784478,1431.4727170436593
"147.32.84.165",3544,"72.20.15.61",80,3,186,3,186,0,0,85293.820844,9.028231999996933,164.8163228415603,0
"147.32.84.165",3545,"174.37.196.55",80,3,186,3,186,0,0,85293.820978,9.028198999993037,164.8169252805734,0
"147.32.84.165",3547,"193.23.181.44",80,3,186,3,186,0,0,85294.021571,9.028367999999318,164.81384010932123,0
"147.32.84.165",3546,"193.23.181.44",179,3,186,3,186,0,0,85294.021688,9.028310000008787,164.81489891226062,0
"147.32.84.165",3548,"174.128.246.102",80,3,186,3,186,0,0,85294.02191,9.028111000006902,164.81853180569695,0
"147.32.84.165",3549,"193.23.181.44",80,3,186,3,186,0,0,85294.087484,8.962564000001294,166.02391904814127,0
"147.32.84.165",3550,"193.23.181.44",80,3,186,3,186,0,0,85294.178776,8.971005999992485,165.867685296526,0
"147.32.84.165",3551,"72.20.15.61",80,3,186,3,186,0,0,85294.181977,8.967929000005824,165.92459641451595,0
"147.32.84.165",3552,"67.19.72.206",80,3,186,3,186,0,0,85294.185176,8.964779000001727,165.98289818407272,0
"147.32.84.165",3553,"193.23.181.44",80,3,186,3,186,0,0,85294.188363,8.961640000008629,166.04103713143658,0
"147.32.84.165",3554,"67.19.72.206",80,3,186,3,186,0,0,85294.191578,8.95846999999776,166.0997915939186,0
"147.32.84.165",3555,"72.20.15.61",80,3,186,3,186,0,0,85294.194767,8.955332000012277,166.15799391892563,0
"147.32.84.165",3556,"174.128.246.102",80,7,640,5,518,2,122,85294.216348,3.2425550000043586,1278.0045365443084,300.9972074486595
"147.32.84.165",3557,"174.37.196.55",80,3,186,3,186,0,0,85294.405579,8.845470000000205,168.2216999209726,0
"147.32.84.165",3558,"72.20.15.61",80,3,186,3,186,0,0,85294.408782,8.842287999999826,168.28223645283092,0
"147.32.84.165",3559,"174.37.196.55",80,3,186,3,186,0,0,85294.41198,8.839112000001478,168.34270229857378,0
"147.32.84.165",3560,"72.20.15.61",80,3,186,3,186,0,0,85294.415178,8.835938000003807,168.4031734943544,0
"147.32.84.165",3561,"174.37.196.55",80,3,186,3,186,0,0,85294.418377,8.832761000012397,168.46374536771816,0
"147.32.84.165",3562,"174.37.196.55",80,3,186,3,186,0,0,85294.421549,8.829610000000685,168.52386458743757,0
"147.32.84.165",3563,"193.23.181.44",80,3,186,3,186,0,0,85294.424748,8.826434000002337,168.58450422895658,0
"147.32.84.165",3564,"67.19.72.206",80,3,186,3,186,0,0,85294.428017,8.823187999994843,168.6465254963251,0
"147.32.84.165",3565,"67.19.72.206",80,3,186,3,186,0,0,85294.447999,8.80322800000431,169.02890621477388,0
"147.32.84.165",3566,"193.23.181.44",179,3,186,3,186,0,0,85294.454402,8.895903999989969,167.2679921008228,0
"147.32.84.165",3567,"72.20.15.61",80,3,186,3,186,0,0,85294.457603,8.892751999999746,167.32727956430614,0
"147.32.84.165",3568,"193.23.181.44",80,3,186,3,186,0,0,85294.460799,8.889599000001908,167.38662790072763,0
"147.32.84.165",3569,"193.23.181.44",179,3,186,3,186,0,0,85294.463996,8.88644899999781,167.44596182348727,0
"147.32.84.165",3570,"193.23.181.44",179,3,186,3,186,0,0,85294.467167,8.883324000009452,167.50486642144503,0
"147.32.84.165",3571,"193.23.181.44",179,3,186,3,186,0,0,85294.470393,8.880145000002813,167.56483143006434,0
"147.32.84.165",3572,"221.208.241.38",6667,2,124,2,124,0,0,85294.597812,2.9346149999910267,338.0341203200533,0
"147.32.84.165",3574,"174.37.196.55",80,7,586,4,404,3,182,85294.623118,0.2626099999906728,12307.223640054803,5544.343322994986
"147.32.84.165",3573,"174.37.196.55",80,7,626,4,444,3,182,85294.623228,0.27997200000390876,12686.98298383556,5200.5200519325945
"147.32.84.165",3575,"193.23.181.44",80,3,186,3,186,0,0,85294.623366,9.028667000005953,164.80838201242983,0
"147.32.84.165",3576,"193.23.181.44",179,3,186,3,186,0,0,85294.623519,9.028573000003234,164.8100978969176,0
"147.32.84.165",3577,"72.20.15.61",80,3,186,3,186,0,0,85294.623699,9.02842299999611,164.81283608451233,0
"147.32.84.165",3578,"174.128.246.102",80,3,186,3,186,0,0,85294.732653,9.019555000006221,164.97487958097418,0
"147.32.84.165",3579,"174.128.246.102",80,3,186,3,186,0,0,85294.735855,9.016375999999582,165.03304653666495,0
"147.32.84.165",3580,"67.19.72.206",80,3,186,3,186,0,0,85294.739054,9.013200000001234,165.0911995739356,0
"147.32.84.165",3581,"193.23.181.44",80,3,186,3,186,0,0,85294.742251,9.01003399999172,165.14921031389753,0
"147.32.84.165",3582,"193.23.181.44",179,3,186,3,186,0,0,85294.74545,9.006859999994049,165.20740857535068,0
"147.32.84.165",3583,"72.20.15.61",80,3,186,3,186,0,0,85294.748651,9.003685999996378,165.26564786917254,0
"147.32.84.165",3584,"193.23.181.44",179,3,186,3,186,0,0,85294.751851,9.000509000004968,165.32398334351743,0
"147.32.84.165",3585,"193.23.181.44",80,3,186,3,186,0,0,85294.755086,8.997296999994433,165.38300336211205,0
"147.32.84.165",3586,"174.37.196.55",80,3,186,3,186,0,0,85294.758286,8.994120000003022,165.44142172880726,0
"147.32.84.165",3587,"67.19.72.206",80,3,186,3,186,0,0,85294.798651,8.953778999988572,166.18681341162198,0
"147.32.84.165",3588,"67.19.72.206",80,3,186,3,186,0,0,85294.801884,8.95057000000088,166.24639548094186,0
"147.32.84.165",3589,"193.23.181.44",179,3,186,3,186,0,0,85295.024613,9.029202999998233,164.7985985031338,0
"147.32.84.165",3590,"174.128.246.102",80,3,186,3,186,0,0,85295.124833,9.030043000006117,164.78326847380373,0
"147.32.84.165",3591,"67.19.72.206",80,3,186,3,186,0,0,85295.124962,9.029945000002044,164.78505683031992,0
"147.32.84.165",3592,"193.23.181.44",179,3,186,3,186,0,0,85295.225628,9.028525000001537,164.81097410703816,0
"147.32.84.165",3593,"174.37.196.55",80,3,186,3,186,0,0,85295.225946,9.028227999995579,164.8163958642525,0
"147.32.84.165",3594,"67.19.72.206",80,3,186,3,186,0,0,85295.226061,9.028132999999798,164.81813017154636,0
"147.32.84.165",3595,"174.37.196.55",80,3,186,3,186,0,0,85295.226199,9.028023000006215,164.82013836240512,0
"147.32.84.165",3597,"193.23.181.44",179,3,186,3,186,0,0,85295.226337,9.027908000003663,164.82223788716016,0
"147.32.84.165",3598,"72.20.15.61",80,3,186,3,186,0,0,85295.283102,8.971164000002318,165.864764037266,0
"147.32.84.165",3599,"174.37.196.55",80,3,186,3,186,0,0,85295.325674,9.029756999996607,164.78848766368344,0
"147.32.84.165",3600,"72.20.15.61",80,3,186,3,186,0,0,85295.325831,9.029621000008774,164.79096963189863,0
"147.32.84.165",3601,"193.23.181.44",80,3,186,3,186,0,0,85295.325946,9.029532000000472,164.79259390186803,0
"147.32.84.165",3602,"174.37.196.55",80,3,186,3,186,0,0,85295.328169,9.027331999997841,164.83275457248675,0
"147.32.84.165",3603,"174.128.246.102",80,3,186,3,186,0,0,85295.391816,8.963707999995677,166.00273012024908,0
"147.32.84.165",3604,"67.19.72.206",80,3,186,3,186,0,0,85295.426436,9.028847000008682,164.80509637593474,0
"147.32.84.165",3605,"46.4.36.120",443,6,366,3,186,3,180,85295.550374,1.0063200000004144,1478.6549010249098,1430.9563558305579
"147.32.84.165",3606,"174.37.196.55",80,3,186,3,186,0,0,85295.731086,9.025404999993043,164.8679477542722,0
"147.32.84.165",3607,"174.37.196.55",80,3,186,3,186,0,0,85295.734334,9.022216000012122,164.9262221163848,0
"147.32.84.165",3608,"174.128.246.102",80,10,788,6,546,4,242,85295.737515,9.345482000004267,467.3916230321781,207.15892449411555
"147.32.84.165",3609,"174.128.246.102",80,9,719,6,537,3,182,85295.740732,9.34829899999022,459.54884412709674,155.75026002072926
"147.32.84.165",3610,"67.19.72.206",80,3,186,3,186,0,0,85295.74394,9.012680999992881,165.10070643809266,0
"147.32.84.165",3611,"193.23.181.44",179,3,186,3,186,0,0,85295.747139,9.00950400000147,165.15892550796994,0
"147.32.84.165",3612,"193.23.181.44",80,3,186,3,186,0,0,85295.750284,9.006382000006852,165.21617670656963,0
"147.32.84.165",3614,"67.19.72.206",80,3,186,3,186,0,0,85295.753502,9.003187999987858,165.27478933040237,0
"147.32.84.165",3613,"193.23.181.44",179,3,186,3,186,0,0,85295.756684,9.000027999994927,165.3328189646564,0
"147.32.84.165",3615,"193.23.181.44",80,3,186,3,186,0,0,85296.028782,9.027822000003653,164.82380800146458,0
"147.32.84.165",3616,"72.20.15.61",80,3,186,3,186,0,0,85296.227999,9.030619000011939,164.77275810196764,0
"147.32.84.165",3617,"67.19.72.206",80,3,186,3,186,0,0,85296.328142,9.0297750000027,164.78815917335203,0
"147.32.84.165",3618,"72.20.15.61",80,3,186,3,186,0,0,85296.529506,9.028999999994994,164.80230368820745,0
"147.32.84.165",3619,"67.19.72.206",80,3,186,3,186,0,0,85297.13147,9.029653000005055,164.79038563266684,0
"147.32.84.165",3620,"193.23.181.44",179,3,186,3,186,0,0,85297.235821,9.025051000004169,164.87441456001886,0
"147.32.84.165",3621,"174.37.196.55",80,3,186,3,186,0,0,85297.23615,9.02474799999618,164.8799501105881,0
"147.32.84.165",3622,"174.37.196.55",80,3,186,3,186,0,0,85297.236399,9.02452199999243,164.88407917906878,0
"147.32.84.165",3623,"72.20.15.61",80,3,186,3,186,0,0,85297.295838,8.96510399998806,165.97688102692192,0
"147.32.84.165",3624,"72.20.15.61",80,3,186,3,186,0,0,85297.332197,9.029829999999492,164.78715546140776,0
"147.32.84.165",3625,"46.4.36.120",443,6,366,3,186,3,180,85297.557576,1.0051239999884274,1480.4143568526194,1432.659055018664
"147.32.84.165",3626,"67.19.72.206",80,3,186,3,186,0,0,85297.73355,9.029956999991555,164.7848378460043,0
"147.32.84.165",3627,"31.192.109.161",80,10,1174,5,540,5,634,85297.820862,0.2394510000012815,18041.269403664548,21181.78667022838
"147.32.84.165",3628,"60.190.223.75",88,56,59488,30,1981,26,57507,85298.225334,133.10596699999587,119.06303193755762,3456.313870587141
"147.32.84.165",3629,"184.82.148.43",80,10,1899,5,979,5,920,85298.282564,0.3404980000050273,23001.603533308167,21615.398621699198
"147.32.84.165",3630,"174.128.246.102",80,9,672,6,490,3,182,85298.436075,9.370632999998634,418.3281961848865,155.37904429724355
"147.32.84.165",3631,"184.82.148.44",80,10,1474,5,580,5,894,85298.514799,0.3235620000050403,14340.373714860583,22103.9553466989
"147.32.84.165",3632,"193.23.181.44",179,3,186,3,186,0,0,85298.535635,9.030839000013657,164.76874407768202,0
"147.32.84.165",3633,"217.163.21.35",80,15,7441,7,2074,8,5367,85298.745298,0.18726200000673998,88603.13357436542,229283.03659287328
"147.32.84.165",3634,"217.163.21.35",80,13,4784,7,2077,6,2707,85298.889979,0.2501110000011977,66434.50308031407,86585.55601271555
"147.32.84.165",3635,"46.4.36.120",443,6,366,3,186,3,180,85299.563168,1.0055019999999786,1479.8578222619465,1432.1204731567225
"147.32.84.165",3636,"174.128.246.102",80,8,627,5,445,3,182,85300.403476,3.166925999990781,1124.1184669330332,459.75182243103836
"147.32.84.165",3637,"193.23.181.44",80,3,186,3,186,0,0,85300.406664,8.86449900000298,167.8605863681072,0
"147.32.84.165",3638,"67.19.72.206",80,3,186,3,186,0,0,85300.409863,8.861402000009548,167.91925250636373,0
"147.32.84.165",3639,"174.37.196.55",80,3,186,3,186,0,0,85300.432716,8.838573000000906,168.35296829022596,0
"147.32.84.165",3640,"193.23.181.44",80,3,186,3,186,0,0,85300.442265,8.929866999998922,166.6318210562576,0
"147.32.84.165",3641,"174.37.196.55",80,33,2132,17,1170,16,962,85300.642964,615.9228960000037,15.196707348901581,12.495070486874633
"147.32.84.165",3642,"193.23.181.44",179,3,186,3,186,0,0,85300.758152,9.015097000010428,165.05646029080762,0
"147.32.84.165",3643,"72.20.15.61",80,3,186,3,186,0,0,85300.781317,8.9919910000026,165.48059267403292,0
"147.32.84.165",3644,"174.128.246.102",80,10,780,6,538,4,242,85301.144566,9.344138000000385,460.6096356881526,207.18872088574895
"147.32.84.165",3645,"72.20.15.61",80,3,186,3,186,0,0,85301.244813,9.029714000003878,164.78927239548904,0
"147.32.84.165",3646,"193.23.181.44",179,3,186,3,186,0,0,85301.244956,9.029697000005399,164.7895826403821,0
"147.32.84.165",3647,"193.23.181.44",80,3,186,3,186,0,0,85301.345265,9.030135000008158,164.78158964385977,0
"147.32.84.165",3648,"72.20.15.61",80,3,186,3,186,0,0,85301.545389,9.030864999993355,164.76826970629003,0
"147.32.84.165",3649,"67.19.72.206",80,3,186,3,186,0,0,85301.545856,9.030421000003116,164.77637089117843,0
"147.32.84.165",3650,"46.4.36.120",443,6,366,3,186,3,180,85301.568762,1.0068730000057258,1477.8427865197878,1430.1704385675364
"147.32.84.165",3651,"174.37.196.55",80,3,186,3,186,0,0,85301.846605,9.029974999997648,164.7845093702239,0
"147.32.84.165",3652,"67.19.72.206",80,3,186,3,186,0,0,85301.846752,9.029886999996961,164.78611526373484,0
"147.32.84.165",3653,"60.190.223.75",888,8,2535,5,611,3,1924,85302.923204,0.7731490000005579,6322.19662703628,19908.193634071693
"147.32.84.165",3654,"193.23.181.44",179,3,186,3,186,0,0,85303.251441,9.029680999999982,164.78987463676768,0
"147.32.84.165",3655,"174.37.196.55",80,3,186,3,186,0,0,85303.251647,9.02953400000115,164.79255740105864,0
"147.32.84.165",3656,"174.128.246.102",80,7,650,5,528,2,122,85303.350853,3.324222000010195,1270.673258280297,293.6025331632504
"147.32.84.165",3657,"174.128.246.102",80,8,684,5,502,3,182,85303.411878,3.2744459999958053,1226.4670115204663,444.65537071060726
"147.32.84.165",3658,"46.4.36.120",443,6,366,3,186,3,180,85303.575693,1.0072379999910481,1477.3072501367349,1429.652177551679
"147.32.84.165",3663,"72.20.15.61",80,3,186,3,186,0,0,85303.752667,9.030619000011939,164.77275810196764,0
"147.32.84.165",3664,"122.224.6.164",82,115,135552,60,3781,55,131771,85304.029584,8.160196999990148,3706.773255601123,129184.1361184384
"147.32.84.165",3665,"178.121.31.113",6667,2,124,2,124,0,0,85304.599785,2.966629999995348,334.3861553350285,0
"147.32.84.165",3666,"193.23.181.44",80,3,186,3,186,0,0,85304.856926,9.029013999999734,164.80204815277105,0
"147.32.84.165",3667,"72.20.15.61",80,3,186,3,186,0,0,85304.920279,8.96570800000336,165.96569952974627,0
"147.32.84.165",3668,"174.37.196.55",80,3,186,3,186,0,0,85304.923714,8.96231999999145,166.02843906504336,0
"147.32.84.165",3669,"193.23.181.44",80,3,186,3,186,0,0,85305.157475,9.03032499999972,164.7781226035659,0
"147.32.84.165",3670,"46.4.36.120",443,6,366,3,186,3,180,85305.58256,1.0071719999978086,1477.4040580985547,1429.7458626760208
"147.32.84.165",3671,"184.82.148.43",80,10,1919,5,979,5,940,85306.514981,0.32153800000378396,24357.92970009091,23387.593379045407
"147.32.84.165",3672,"174.37.196.55",80,9,726,6,544,3,182,85306.518622,9.411235999999917,462.42597677924965,154.70869076070485
"147.32.84.165",3673,"193.23.181.44",179,3,186,3,186,0,0,85306.524786,9.125618000005488,163.05744991726644,0
"147.32.84.165",3674,"184.82.148.44",80,10,1513,5,596,5,917,85306.738699,0.3033760000107577,15716.470649724852,24181.21407013035
"147.32.84.165",3675,"217.163.21.36",80,13,6077,6,749,7,5328,85306.950631,0.18783399999665562,31900.507895837214,226923.77312285805
"147.32.84.165",3676,"217.163.21.36",80,10,1448,5,699,5,749,85307.099229,0.1390209999954095,40224.138800502435,43101.40194789173
"147.32.84.165",3677,"217.163.21.35",80,11,3687,6,2059,5,1628,85307.192412,0.23144399999000598,71170.56394078603,56272.79169286044
"147.32.84.165",3678,"217.163.21.36",80,10,2274,5,1154,5,1120,85307.379947,0.13963400000648107,66115.7024762701,64167.75283658796
"147.32.84.165",3679,"217.163.21.35",80,13,5545,7,2574,6,2971,85307.474348,0.15589799999725074,132086.36416351167,152458.6588693835
"147.32.84.165",3680,"173.241.240.4",80,9,2194,5,1164,4,1030,85307.587079,0.07765999999537598,119907.28818638236,106103.52820616307
"147.32.84.165",3681,"46.4.36.120",443,6,366,3,186,3,180,85307.591163,1.0052699999941979,1480.199349437055,1432.4509833261823
"147.32.84.165",3682,"174.128.246.102",80,3,186,3,186,0,0,85307.645156,9.009298000004492,165.16270191076575,0
"147.32.84.165",3683,"193.23.181.44",179,3,186,3,186,0,0,85307.666205,9.028697000001557,164.8078343973381,0
"147.32.84.165",3684,"174.37.196.55",80,3,186,3,186,0,0,85308.76999,9.028126999997767,164.81823970801122,0
"147.32.84.165",3685,"174.37.196.55",80,3,186,3,186,0,0,85309.07086,9.029225999998744,164.79817871434463,0
"147.32.84.165",3686,"67.19.72.206",80,3,186,3,186,0,0,85309.171108,9.029367000010097,164.79560527314217,0
"147.32.84.165",3687,"46.4.36.120",443,6,366,3,186,3,180,85309.596527,1.0072019999934128,1477.3600529086834,1429.7032770084033
"147.32.84.165",3688,"174.128.246.102",80,8,662,4,420,4,242,85309.773631,0.32490099999995437,10341.611752504523,5958.738200252606
"147.32.84.165",3689,"67.19.72.206",80,3,186,3,186,0,0,85309.773774,9.028556000004755,164.81040822023104,0
"147.32.84.165",3690,"193.23.181.44",80,3,186,3,186,0,0,85309.77392,9.02843199999188,164.81267179077588,0
"147.32.84.165",3691,"193.23.181.44",179,3,186,3,186,0,0,85309.873277,9.0291709999874,164.79918256084378,0
"147.32.84.165",3692,"174.128.246.102",80,3,186,3,186,0,0,85309.873488,9.029019000008702,164.80195689017444,0
"147.32.84.165",3693,"174.128.246.102",80,3,186,3,186,0,0,85309.937067,8.965467999994871,165.9701423284151,0
"147.32.84.165",3694,"174.37.196.55",80,3,186,3,186,0,0,85309.974631,9.027581000002101,164.8282081323506,0
"147.32.84.165",3695,"174.37.196.55",80,3,186,3,186,0,0,85309.974901,9.027373000004445,164.83200594450537,0
"147.32.84.165",3696,"193.23.181.44",80,3,186,3,186,0,0,85309.975014,9.027281000002404,164.83368580191575,0
"147.32.84.165",3697,"72.20.15.61",80,3,186,3,186,0,0,85310.274976,9.0299010000017,164.7858597784981,0
"147.32.84.165",3698,"193.23.181.44",179,3,186,3,186,0,0,85310.333276,8.971623999997973,165.85625969170533,0
"147.32.84.165",3699,"72.20.15.61",80,3,186,3,186,0,0,85310.375624,9.029484000013326,164.793469925613,0
"147.32.84.165",3700,"174.37.196.55",80,3,186,3,186,0,0,85310.876842,9.029131999996025,164.7998943863768,0
"147.32.84.165",3701,"193.23.181.44",179,3,186,3,186,0,0,85310.877087,9.029009000005317,164.80213941520313,0
"147.32.84.165",3702,"67.19.72.206",80,3,186,3,186,0,0,85310.877316,9.028827999994974,164.8054431871809,0
"147.32.84.165",3703,"72.20.15.61",80,3,186,3,186,0,0,85310.877438,9.02874900000461,164.8068852062717,0
"147.32.84.165",3704,"174.37.196.55",80,3,186,3,186,0,0,85310.977069,9.030543000000762,164.7741448105473,0
"147.32.84.165",3705,"193.23.181.44",179,3,186,3,186,0,0,85310.977216,9.030457999993814,164.77569576216612,0
"147.32.84.165",3706,"193.23.181.44",80,3,186,3,186,0,0,85311.077253,9.029553000000305,164.7922106443087,0
"147.32.84.165",3707,"46.4.36.120",443,6,366,3,186,3,180,85311.604395,1.005697999993572,1479.5694134914365,1431.8413678949385
"147.32.84.165",3708,"174.128.246.102",80,3,186,3,186,0,0,85311.980107,8.92999800000689,166.62937662459186,0
"147.32.84.165",3709,"72.20.15.61",80,3,186,3,186,0,0,85311.980244,8.929920999988099,166.63081341951212,0
"147.32.84.165",3710,"174.37.196.55",80,3,186,3,186,0,0,85311.980377,8.92981200000213,166.63284736561587,0
"147.32.84.165",3711,"193.23.181.44",179,3,186,3,186,0,0,85311.980515,8.92969799999264,166.63497466557394,0
"147.32.84.165",3712,"193.23.181.44",179,3,186,3,186,0,0,85312.080819,8.928920000005746,166.64949400364685,0
"147.32.84.165",3713,"174.128.246.102",80,3,186,3,186,0,0,85312.184342,8.92640600001323,166.69642855117664,0
"147.32.84.165",3714,"67.19.72.206",80,3,186,3,186,0,0,85312.186335,8.924434000000474,166.73326286013443,0
"147.32.84.165",3715,"174.37.196.55",80,3,186,3,186,0,0,85312.186928,8.923869000005652,166.7438193006932,0
"147.32.84.165",3716,"72.20.15.61",80,3,186,3,186,0,0,85312.187154,8.923666000002413,166.74761247222807,0
"147.32.84.165",3717,"193.23.181.44",179,3,186,3,186,0,0,85312.187598,8.923242999997456,166.7555170245195,0
"147.32.84.165",3718,"72.20.15.61",80,3,186,3,186,0,0,85312.187876,8.922988999998779,166.76026385331235,0
"147.32.84.165",3719,"174.128.246.102",80,7,620,4,438,3,182,85312.188094,0.4049220000015339,8653.518455373445,3595.7542440136235
"147.32.84.165",3720,"174.37.196.55",80,3,186,3,186,0,0,85312.18831,8.922579000005499,166.76792662738913,0
"147.32.84.165",3721,"193.23.181.44",80,3,186,3,186,0,0,85312.188583,8.922332000001916,166.77254332159805,0
"147.32.84.165",3722,"193.23.181.44",80,3,186,3,186,0,0,85312.1888,8.922141999995802,166.7760947988387,0
"147.32.84.165",3723,"174.37.196.55",80,3,186,3,186,0,0,85312.189057,8.921908000003896,166.7804689310123,0
"147.32.84.165",3724,"72.20.15.61",80,3,186,3,186,0,0,85312.18921,8.921778000003542,166.78289910367747,0
"147.32.84.165",3725,"174.37.196.55",80,3,186,3,186,0,0,85312.189326,8.921683999986271,166.7846563498875,0
"147.32.84.165",3726,"174.37.196.55",80,3,186,3,186,0,0,85312.189445,8.921589000005042,166.7864323271515,0
"147.32.84.165",3727,"72.20.15.61",80,3,186,3,186,0,0,85312.189562,8.921495999995386,166.78817095258123,0
"147.32.84.165",3728,"72.20.15.61",80,3,186,3,186,0,0,85312.189678,8.921407000001636,166.78983483207605,0
"147.32.84.165",3729,"193.23.181.44",179,3,186,3,186,0,0,85312.189792,8.921317000000272,166.79151744074946,0
"147.32.84.165",3730,"193.23.181.44",179,3,186,3,186,0,0,85312.189923,8.92121300000872,166.79346183064405,0
"147.32.84.165",3731,"174.37.196.55",80,3,186,3,186,0,0,85312.190043,8.92111599999771,166.79527538935508,0
"147.32.84.165",3732,"174.128.246.102",80,7,640,5,518,2,122,85312.190151,3.5092189999995753,1180.8895369597913,278.12456275886973
"147.32.84.165",3733,"193.23.181.44",179,3,186,3,186,0,0,85312.190259,8.920922999997856,166.7988839271853,0
"147.32.84.165",3734,"174.37.196.55",80,3,186,3,186,0,0,85312.190367,8.920836999997846,166.80049192697493,0
"147.32.84.165",3735,"67.19.72.206",80,3,186,3,186,0,0,85312.190475,8.920752999998513,166.8020625613385,0
"147.32.84.165",3736,"174.37.196.55",80,3,186,3,186,0,0,85312.190618,8.920634000009159,166.80428767713957,0
"147.32.84.165",3737,"72.20.15.61",80,3,186,3,186,0,0,85312.190728,8.920547000001534,166.80591448032774,0
"147.32.84.165",3738,"174.37.196.55",80,3,186,3,186,0,0,85312.190835,8.9204630000022,166.80748521681363,0
"147.32.84.165",3740,"193.23.181.44",80,3,186,3,186,0,0,85312.194929,8.916393999999855,166.88360788004928,0
"147.32.84.165",3741,"67.19.72.206",80,3,186,3,186,0,0,85312.195041,8.918850999994902,166.83763413032133,0
"147.32.84.165",3742,"67.19.72.206",80,3,186,3,186,0,0,85312.195148,8.921942999993917,166.77981466604467,0
"147.32.84.165",3743,"193.23.181.44",179,3,186,3,186,0,0,85312.197144,8.923178999990341,166.7567130505407,0
"147.32.84.165",3744,"174.128.246.102",80,3,186,3,186,0,0,85312.200343,8.923199999990175,166.75632060265806,0
"147.32.84.165",3739,"67.19.72.206",80,3,186,3,186,0,0,85312.203544,8.923194999995758,166.75641404235898,0
"147.32.84.165",3745,"193.23.181.44",80,3,186,3,186,0,0,85312.214993,8.91492599999765,166.91108821322715,0
"147.32.84.165",3746,"72.20.15.61",80,3,186,3,186,0,0,85312.23449,8.89862799999537,167.2167889253011,0
"147.32.84.165",3747,"72.20.15.61",80,3,186,3,186,0,0,85312.254699,8.88159099999757,167.5375504231626,0
"147.32.84.165",3748,"174.128.246.102",80,10,956,7,772,3,184,85312.268028,9.239092999996501,668.4638849292176,159.3229984805389
"147.32.84.165",3749,"72.20.15.61",80,3,186,3,186,0,0,85312.268189,8.871331000002101,167.73131337334246,0
"147.32.84.165",3750,"174.128.246.102",80,7,608,5,486,2,122,85312.268309,3.49200299999211,1113.4011053280267,279.4957507202042
"147.32.84.165",3752,"67.19.72.206",80,3,186,3,186,0,0,85312.268464,8.874228000000585,167.6765573298209,0
"147.32.84.165",3753,"67.19.72.206",80,3,186,3,186,0,0,85312.268586,8.87730599999486,167.61841937192,0
"147.32.84.165",3751,"193.23.181.44",179,3,186,3,186,0,0,85312.268696,8.880395000000135,167.56011416158597,0
"147.32.84.165",3754,"174.37.196.55",80,3,186,3,186,0,0,85312.281908,8.928529999990133,166.65677328761222,0
"147.32.84.165",3755,"193.23.181.44",179,3,186,3,186,0,0,85312.283994,8.926468999998178,166.69525206442813,0
"147.32.84.165",3756,"72.20.15.61",80,3,186,3,186,0,0,85312.285653,8.924834000004921,166.72579008183004,0
"147.32.84.165",3757,"174.128.246.102",80,10,732,6,490,4,242,85312.285764,9.261278000005404,423.26771747891735,209.0424237344857
"147.32.84.165",3758,"174.37.196.55",80,3,186,3,186,0,0,85312.286994,8.923537000009674,166.75002300078847,0
"147.32.84.165",3759,"193.23.181.44",80,3,186,3,186,0,0,85312.287107,8.92344700000831,166.75170480629453,0
"147.32.84.165",3760,"193.23.181.44",179,3,186,3,186,0,0,85312.287214,8.923364000002039,166.753255834869,0
"147.32.84.165",3761,"193.23.181.44",80,3,186,3,186,0,0,85312.287322,8.923284999997122,166.7547321418603,0
"147.32.84.165",3762,"174.37.196.55",80,3,186,3,186,0,0,85312.28746,8.92316999999457,166.75688124297815,0
"147.32.84.165",3763,"174.37.196.55",80,3,186,3,186,0,0,85312.287569,8.92308100000082,166.7585444982359,0
"147.32.84.165",3764,"174.128.246.102",80,3,186,3,186,0,0,85312.287687,8.922988999998779,166.76026385331235,0
"147.32.84.165",3765,"193.23.181.44",80,3,186,3,186,0,0,85312.287795,8.922904000006383,166.76185241922758,0
"147.32.84.165",3766,"72.20.15.61",80,3,186,3,186,0,0,85312.287903,8.922816999998759,166.76347839479473,0
"147.32.84.165",3767,"174.37.196.55",80,3,186,3,186,0,0,85312.288016,8.922726999997394,166.76516047172962,0
"147.32.84.165",3768,"193.23.181.44",80,3,186,3,186,0,0,85312.288136,8.922632000001613,166.76693603409072,0
"147.32.84.165",3769,"193.23.181.44",179,3,186,3,186,0,0,85312.289943,8.923150000002352,166.75725500519525,0
"147.32.84.165",3770,"174.128.246.102",80,3,186,3,186,0,0,85312.293143,8.923152000003029,166.75721762887093,0
"147.32.84.165",3771,"193.23.181.44",80,3,186,3,186,0,0,85312.296343,8.923149000009289,166.7572736932277,0
"147.32.84.165",3772,"193.23.181.44",80,3,186,3,186,0,0,85312.299563,8.923151000009966,166.75723631689502,0
"147.32.84.165",3773,"193.23.181.44",80,3,186,3,186,0,0,85312.302744,8.923154000003706,166.7571802525634,0
"147.32.84.165",3774,"72.20.15.61",80,3,186,3,186,0,0,85312.305942,8.923151999988477,166.75721762914287,0
"147.32.84.165",3775,"174.37.196.55",80,3,186,3,186,0,0,85312.309145,8.923194999995758,166.75641404235898,0
"147.32.84.165",3776,"174.128.246.102",80,3,186,3,186,0,0,85312.312361,8.923153999989154,166.75718025283535,0
"147.32.84.165",3777,"72.20.15.61",80,3,186,3,186,0,0,85312.315565,8.923148000001675,166.75729238153627,0
"147.32.84.165",3778,"67.19.72.206",80,3,186,3,186,0,0,85312.318832,8.92307499999879,166.75865662904346,0
"147.32.84.165",3779,"174.37.196.55",80,3,186,3,186,0,0,85312.321962,8.923148000001675,166.75729238153627,0
"147.32.84.165",3780,"72.20.15.61",80,3,186,3,186,0,0,85312.325173,8.923169000001508,166.75689993092683,0
"147.32.84.165",3781,"174.37.196.55",80,3,186,3,186,0,0,85312.328367,8.923177000004216,166.75675042636686,0
"147.32.84.165",3782,"193.23.181.44",179,3,186,3,186,0,0,85312.331561,8.923166000007768,166.75695599506997,0
"147.32.84.165",3783,"67.19.72.206",80,3,186,3,186,0,0,85312.334797,8.923119999992196,166.7578156520703,0
"147.32.84.165",3784,"174.128.246.102",80,3,186,3,186,0,0,85312.33801,8.923110999996425,166.75798384673195,0
"147.32.84.165",3785,"72.20.15.61",80,3,186,3,186,0,0,85312.341187,8.923156000004383,166.7571428762726,0
"147.32.84.165",3787,"193.23.181.44",80,3,186,3,186,0,0,85312.344367,8.923143000007258,166.75738582232626,0
"147.32.84.165",3788,"174.37.196.55",80,3,186,3,186,0,0,85312.347566,8.923156999997445,166.75712418826947,0
"147.32.84.165",3789,"67.19.72.206",80,3,186,3,186,0,0,85312.350761,8.923177000004216,166.75675042636686,0
"147.32.84.165",3790,"67.19.72.206",80,3,186,3,186,0,0,85312.353962,8.923157000011997,166.7571241879975,0
"147.32.84.165",3791,"193.23.181.44",179,3,186,3,186,0,0,85312.357192,8.923116999998456,166.75787171682916,0
"147.32.84.165",3792,"67.19.72.206",80,3,186,3,186,0,0,85312.36036,8.923180999991018,166.75667567445933,0
"147.32.84.165",3786,"67.19.72.206",80,3,186,3,186,0,0,85312.363594,8.923101000007591,166.75817072996642,0
"147.32.84.165",3794,"193.23.181.44",80,3,186,3,186,0,0,85312.366784,8.923141999999643,166.75740451065997,0
"147.32.84.165",3795,"174.128.246.102",80,3,186,3,186,0,0,85312.369962,8.923181999998633,166.75665698628896,0
"147.32.84.165",3796,"193.23.181.44",80,3,186,3,186,0,0,85312.373194,8.92314699999406,166.75731106984907,0
"147.32.84.165",3797,"174.128.246.102",80,3,186,3,186,0,0,85312.376391,8.923129000002518,166.75764745747597,0
"147.32.84.165",3798,"193.23.181.44",179,3,186,3,186,0,0,85312.37956,8.92318100000557,166.7566756741874,0
"147.32.84.165",3799,"72.20.15.61",80,3,186,3,186,0,0,85312.382749,8.923193000009633,166.7564514180511,0
"147.32.84.165",3793,"67.19.72.206",80,3,186,3,186,0,0,85312.385947,8.92314699999406,166.75731106984907,0
"147.32.84.165",3800,"72.20.15.61",80,3,186,3,186,0,0,85312.389165,8.923127000001841,166.75768483399295,0
"147.32.84.165",3801,"174.37.196.55",80,3,186,3,186,0,0,85312.392392,8.923099999999977,166.75818941847606,0
"147.32.84.165",3802,"72.20.15.61",80,3,186,3,186,0,0,85312.395591,8.923099999999977,166.75818941847606,0
"147.32.84.165",3803,"174.37.196.55",80,3,186,3,186,0,0,85312.398796,8.923123000000487,166.75775958707717,0
"147.32.84.165",3804,"174.37.196.55",80,3,186,3,186,0,0,85312.401994,8.923099000006914,166.75820810671797,0
"147.32.84.165",3806,"174.37.196.55",80,3,186,3,186,0,0,85312.405172,8.923148000001675,166.75729238153627,0
"147.32.84.165",3807,"67.19.72.206",80,3,186,3,186,0,0,85312.408373,8.923169000001508,166.75689993092683,0
"147.32.84.165",3805,"72.20.15.61",80,3,186,3,186,0,0,85312.411591,8.923148000001675,166.75729238153627,0
"147.32.84.165",3808,"174.128.246.102",80,3,186,3,186,0,0,85312.438372,8.899550999994972,167.19944635418582,0
"147.32.84.165",3809,"193.23.181.44",80,3,186,3,186,0,0,85312.44157,8.924369000000297,166.7344772498706,0
"147.32.84.165",3810,"60.190.223.75",888,11,1323,6,836,5,487,85312.444774,0.9705539999995381,6890.909727849437,4014.2021979218616
"147.32.84.165",3811,"193.23.181.44",80,3,186,3,186,0,0,85312.48194,8.928859999999986,166.65061385216055,0
"147.32.84.165",3812,"72.20.15.61",80,3,186,3,186,0,0,85312.482295,8.928627000001143,166.65496273949057,0
"147.32.84.165",3813,"193.23.181.44",80,3,186,3,186,0,0,85312.482662,8.92830800000229,166.66091716365727,0
"147.32.84.165",3814,"193.23.181.44",80,3,186,3,186,0,0,85312.483561,8.927452000003541,166.6768972826076,0
"147.32.84.165",3815,"193.23.181.44",80,3,186,3,186,0,0,85312.484112,8.926949000000604,166.68628889891713,0
"147.32.84.165",3816,"193.23.181.44",179,3,186,3,186,0,0,85312.484426,8.926682999997865,166.69125586742084,0
"147.32.84.165",3817,"174.37.196.55",80,8,661,5,479,3,182,85312.484646,3.402304000002914,1126.295592632733,427.9452982445875
"147.32.84.165",3818,"193.23.181.44",80,3,186,3,186,0,0,85312.484863,8.92629199998919,166.69855747513103,0
"147.32.84.165",3819,"67.19.72.206",80,3,186,3,186,0,0,85312.485104,8.92840599999181,166.65908785973275,0
"147.32.84.165",3820,"72.20.15.61",80,3,186,3,186,0,0,85312.485322,8.931388000011793,166.60344394376722,0
"147.32.84.165",3821,"174.37.196.55",80,8,661,5,479,3,182,85312.485572,3.4229209999903105,1119.5116685459136,425.3676903452115
"147.32.84.165",3822,"174.128.246.102",80,3,186,3,186,0,0,85312.583747,8.928028000009363,166.6661439680117,0
"147.32.84.165",3823,"174.128.246.102",80,3,186,3,186,0,0,85312.584224,8.927608999991207,166.6739661203202,0
"147.32.84.165",3824,"67.19.72.206",80,3,186,3,186,0,0,85312.584614,8.92726299999049,166.68042601652772,0
"147.32.84.165",3825,"174.128.246.102",80,3,186,3,186,0,0,85312.584799,8.927081000001635,166.6838241973751,0
"147.32.84.165",3826,"193.23.181.44",80,3,186,3,186,0,0,85312.584916,8.926977999988594,166.6857474054379,0
"147.32.84.165",3827,"174.128.246.102",80,3,186,3,186,0,0,85312.585031,8.926892000003136,166.68735322433355,0
"147.32.84.165",3828,"72.20.15.61",80,3,186,3,186,0,0,85312.585145,8.926800999994157,166.6890524389391,0
"147.32.84.165",3829,"193.23.181.44",80,3,186,3,186,0,0,85312.585258,8.92670999999973,166.69075168791693,0
"147.32.84.165",3830,"193.23.181.44",80,3,186,3,186,0,0,85312.585376,8.926613000003272,166.69256301348054,0
"147.32.84.165",3831,"72.20.15.61",80,3,186,3,186,0,0,85312.585492,8.92652100000123,166.69428100822202,0
"147.32.84.165",3833,"174.128.246.102",80,3,186,3,186,0,0,85312.595256,8.91678200000024,166.8763461975363,0
"147.32.84.165",3834,"174.37.196.55",80,8,682,5,500,3,182,85312.595385,3.5104190000129165,1139.46511797745,414.7653029437918
"147.32.84.165",3835,"174.128.246.102",80,3,186,3,186,0,0,85312.5955,8.916563999999198,166.880426137258,0
"147.32.84.165",3836,"67.19.72.206",80,3,186,3,186,0,0,85312.595608,8.91647899999225,166.8820169936242,0
"147.32.84.165",3837,"174.37.196.55",80,3,186,3,186,0,0,85312.595718,8.916391999999178,166.8836453130523,0
"147.32.84.165",3838,"193.23.181.44",80,3,186,3,186,0,0,85312.595827,8.916303000005428,166.88531109800712,0
"147.32.84.165",3839,"193.23.181.44",80,3,186,3,186,0,0,85312.595939,8.916210999988834,166.88703306840355,0
"147.32.84.165",3840,"174.37.196.55",80,3,186,3,186,0,0,85312.596048,8.91612099998747,166.88871763876816,0
"147.32.84.165",3841,"174.37.196.55",80,3,186,3,186,0,0,85312.596156,8.916041000004043,166.89021506286537,0
"147.32.84.165",3842,"72.20.15.61",80,3,186,3,186,0,0,85312.596265,8.915953999996418,166.8918435425528,0
"147.32.84.165",3832,"67.19.72.206",80,3,186,3,186,0,0,85312.59637,8.915869999997085,166.89341589777402,0
"147.32.84.165",3843,"174.128.246.102",80,3,186,3,186,0,0,85312.615416,8.896844999995665,167.25030052796527,0
"147.32.84.165",3844,"72.20.15.61",80,3,186,3,186,0,0,85312.635673,8.876613000000361,167.63150539512532,0
"147.32.84.165",3845,"72.20.15.61",80,3,186,3,186,0,0,85312.683069,8.928336999990279,166.66037583500938,0
"147.32.84.165",3846,"193.23.181.44",80,3,186,3,186,0,0,85312.683435,8.928092000001925,166.66494924107852,0
"147.32.84.165",3847,"193.23.181.44",179,3,186,3,186,0,0,85312.783613,8.928781999988132,166.65206967781023,0
"147.32.84.165",3848,"174.37.196.55",80,3,186,3,186,0,0,85312.784844,8.92757200000051,166.6746568943846,0
"147.32.84.165",3849,"193.23.181.44",179,3,186,3,186,0,0,85312.785598,8.926846999995178,166.6881934910281,0
"147.32.84.165",3850,"72.20.15.61",80,3,186,3,186,0,0,85312.785709,8.92675899999449,166.68983670343496,0
"147.32.84.165",3851,"174.37.196.55",80,3,186,3,186,0,0,85312.785861,8.926636000003782,166.69213352032833,0
"147.32.84.165",3852,"193.23.181.44",80,3,186,3,186,0,0,85312.785989,8.926550000003772,166.6937394625439,0
"147.32.84.165",3853,"72.20.15.61",80,3,186,3,186,0,0,85312.786105,8.926457999987178,166.69545748180715,0
"147.32.84.165",3854,"72.20.15.61",80,3,186,3,186,0,0,85312.786217,8.926372999994783,166.6970448132595,0
"147.32.84.165",3855,"72.20.15.61",80,3,186,3,186,0,0,85312.786324,8.92628899999545,166.6986135000512,0
"147.32.84.165",3856,"193.23.181.44",179,3,186,3,186,0,0,85312.786438,8.92619700000796,166.70033161924087,0
"147.32.84.165",3857,"174.128.246.102",80,3,186,3,186,0,0,85312.786545,8.926113000008627,166.70190036789384,0
"147.32.84.165",3859,"67.19.72.206",80,3,186,3,186,0,0,85312.786708,8.926000000006752,166.70401075497136,0
"147.32.84.165",3860,"193.23.181.44",179,3,186,3,186,0,0,85312.78683,8.925901000009617,166.70585972199297,0
"147.32.84.165",3861,"193.23.181.44",179,3,186,3,186,0,0,85312.786939,8.925814000001992,166.7074846058486,0
"147.32.84.165",3862,"72.20.15.61",80,3,186,3,186,0,0,85312.787047,8.925729999988107,166.70905348940454,0
"147.32.84.165",3863,"174.128.246.102",80,3,186,3,186,0,0,85312.787153,8.925646999996388,166.7106037243689,0
"147.32.84.165",3864,"193.23.181.44",179,3,186,3,186,0,0,85312.787261,8.925560999996378,166.7122100224965,0
"147.32.84.165",3865,"72.20.15.61",80,3,186,3,186,0,0,85312.787397,8.925448000009055,166.7143206703451,0
"147.32.84.165",3866,"72.20.15.61",80,3,186,3,186,0,0,85312.787506,8.925363000002108,166.71590836133484,0
"147.32.84.165",3867,"174.37.196.55",80,3,186,3,186,0,0,85312.787626,8.925265999991097,166.7177202339386,0
"147.32.84.165",3858,"174.37.196.55",80,3,186,3,186,0,0,85312.796493,8.91619200000423,166.8873886967995,0
"147.32.84.165",3869,"174.128.246.102",80,3,186,3,186,0,0,85312.79661,8.916304999991553,166.88527366452917,0
"147.32.84.165",3870,"174.128.246.102",80,3,186,3,186,0,0,85312.796718,8.916219999999157,166.88686461304687,0
"147.32.84.165",3871,"174.37.196.55",80,3,186,3,186,0,0,85312.798957,8.91400399999111,166.9283522871971,0
"147.32.84.165",3872,"67.19.72.206",80,3,186,3,186,0,0,85312.802156,8.910831000001053,166.98779272099586,0
"147.32.84.165",3868,"193.23.181.44",80,3,186,3,186,0,0,85312.805356,8.91018299999996,166.99993703833093,0
"147.32.84.165",3873,"193.23.181.44",179,3,186,3,186,0,0,85312.814575,8.904164000006858,167.11282496580856,0
"147.32.84.165",3874,"193.23.181.44",80,3,186,3,186,0,0,85312.834862,8.887103000000934,167.43363951108068,0
"147.32.84.165",3875,"193.23.181.44",80,3,186,3,186,0,0,85312.884959,8.927368000004208,166.67846559022757,0
"147.32.84.165",3876,"193.23.181.44",80,3,186,3,186,0,0,85312.88587,8.926577999998699,166.69321659433402,0
"147.32.84.165",3877,"193.23.181.44",179,3,186,3,186,0,0,85312.886302,8.926195000007283,166.7003689700691,0
"147.32.84.165",3878,"193.23.181.44",179,3,186,3,186,0,0,85312.886543,8.92599699999846,166.70406678382892,0
"147.32.84.165",3879,"72.20.15.61",80,3,186,3,186,0,0,85312.88676,8.925843000004534,166.70694297437723,0
"147.32.84.165",3880,"72.20.15.61",80,8,688,5,506,3,182,85312.886994,3.5924450000020443,1126.8091787063397,405.29500103666766
"147.32.84.165",3881,"174.128.246.102",80,3,186,3,186,0,0,85312.88721,8.925440000006347,166.71447009883454,0
"147.32.84.165",3882,"193.23.181.44",80,3,186,3,186,0,0,85312.887426,8.925273999993806,166.71757079962282,0
"147.32.84.165",3883,"72.20.15.61",80,3,186,3,186,0,0,85312.887644,8.9251030000014,166.72076501523475,0
"147.32.84.165",3884,"193.23.181.44",179,3,186,3,186,0,0,85312.887861,8.92493100000138,166.72397803409012,0
"147.32.84.165",3885,"67.19.72.206",80,3,186,3,186,0,0,85312.888125,8.924714000007953,166.7280318449055,0
"147.32.84.165",3886,"72.20.15.61",80,3,186,3,186,0,0,85312.888356,8.924529000010807,166.7314880144597,0
"147.32.84.165",3887,"67.19.72.206",80,3,186,3,186,0,0,85312.888625,8.924310999995214,166.7355608742006,0
"147.32.84.165",3888,"174.128.246.102",80,3,186,3,186,0,0,85312.888841,8.924141999988933,166.73871841145572,0
"147.32.84.165",3889,"193.23.181.44",80,3,186,3,186,0,0,85312.889136,8.923890000005485,166.74342691349685,0
"147.32.84.165",3890,"174.37.196.55",80,3,186,3,186,0,0,85312.889354,8.923718999998528,166.74662212024444,0
"147.32.84.165",3891,"193.23.181.44",80,3,186,3,186,0,0,85312.889571,8.92354799999157,166.74981744945012,0
"147.32.84.165",3892,"193.23.181.44",80,3,186,3,186,0,0,85312.88979,8.923376000006101,166.75303158793068,0
"147.32.84.165",3893,"67.19.72.206",80,3,186,3,186,0,0,85312.898442,8.914769999988494,166.91400899876504,0
"147.32.84.165",3894,"174.128.246.102",80,9,723,6,539,3,184,85313.083634,6.380181000000448,675.8428953660872,230.7144577873099
"147.32.84.165",3895,"174.37.196.55",80,3,186,3,186,0,0,85313.083998,8.929166000001715,166.6449027826019,0
"147.32.84.165",3896,"193.23.181.44",179,3,186,3,186,0,0,85313.085614,8.927674999998999,166.6727339425065,0
"147.32.84.165",3897,"67.19.72.206",80,3,186,3,186,0,0,85313.086475,8.926863999993657,166.68787605603237,0
"147.32.84.165",3898,"67.19.72.206",80,3,186,3,186,0,0,85313.086812,8.926570000010543,166.6933659847223,0
"147.32.84.165",3899,"67.19.72.206",80,3,186,3,186,0,0,85313.087045,8.92638600000646,166.6968020427218,0
"147.32.84.165",3900,"67.19.72.206",80,3,186,3,186,0,0,85313.087334,8.926143000004231,166.701340097206,0
"147.32.84.165",3901,"67.19.72.206",80,3,186,3,186,0,0,85313.087612,8.925914999999804,166.70559824959486,0
"147.32.84.165",3902,"67.19.72.206",80,3,186,3,186,0,0,85313.087828,8.9257479999942,166.708717297527,0
"147.32.84.165",3903,"174.128.246.102",80,8,649,4,407,4,242,85313.088089,0.3235980000026757,10061.866884137347,5982.7316608384235
"147.32.84.165",3905,"67.19.72.206",80,3,186,3,186,0,0,85313.088409,8.925208999993629,166.71878496078492,0
"147.32.84.165",3906,"72.20.15.61",80,3,186,3,186,0,0,85313.088627,8.925038999994285,166.7219605428002,0
"147.32.84.165",3907,"72.20.15.61",80,3,186,3,186,0,0,85313.088898,8.924813000005088,166.72618238602328,0
"147.32.84.165",3904,"67.19.72.206",80,3,186,3,186,0,0,85313.089187,8.924569999988307,166.73072204060807,0
"147.32.84.165",3908,"193.23.181.44",179,3,186,3,186,0,0,85313.089406,8.924396999995224,166.73395412606547,0
"147.32.84.165",3909,"193.23.181.44",80,3,186,3,186,0,0,85313.089679,8.92417500000738,166.7381018412088,0
"147.32.84.165",3910,"193.23.181.44",179,3,186,3,186,0,0,85313.184493,8.928976000010152,166.64844882529735,0
"147.32.84.165",3911,"174.128.246.102",80,10,785,6,543,4,242,85313.185062,9.243628999989596,469.9452996225713,209.44155158133012
"147.32.84.165",3912,"193.23.181.44",179,3,186,3,186,0,0,85313.185479,8.928106999999727,166.66466922943974,0
"147.32.84.165",3913,"193.23.181.44",80,3,186,3,186,0,0,85313.185792,8.927815000002738,166.67012029254008,0
"147.32.84.165",3914,"193.23.181.44",80,3,186,3,186,0,0,85313.185925,8.927705000009155,166.67217386758122,0
"147.32.84.165",3915,"193.23.181.44",80,3,186,3,186,0,0,85313.186036,8.92761500000779,166.6738541031061,0
"147.32.84.165",3916,"193.23.181.44",179,3,186,3,186,0,0,85313.205989,8.907686999998987,167.04673165998864,0
"147.32.84.165",3918,"174.37.196.55",80,3,186,3,186,0,0,85313.211703,8.901996000000509,167.15352377151316,0
"147.32.84.165",3919,"72.20.15.61",80,3,186,3,186,0,0,85313.211817,8.901903999998467,167.15525128110303,0
"147.32.84.165",3920,"72.20.15.61",80,3,186,3,186,0,0,85313.211927,8.90181599999778,167.15690371496908,0
"147.32.84.165",3921,"193.23.181.44",179,3,186,3,186,0,0,85313.212037,8.901731999998447,167.15848106865715,0
"147.32.84.165",3922,"72.20.15.61",80,3,186,3,186,0,0,85313.212181,8.90161500000977,167.16067814642253,0
"147.32.84.165",3923,"72.20.15.61",80,3,186,3,186,0,0,85313.212291,8.901524999993853,167.16236824600588,0
"147.32.84.165",3917,"72.20.15.61",80,3,186,3,186,0,0,85313.212397,8.901439000008395,167.1639832614251,0
"147.32.84.165",3925,"67.19.72.206",80,3,186,3,186,0,0,85313.212589,8.901268000001437,167.16719460640437,0
"147.32.84.165",3924,"193.23.181.44",80,3,186,3,186,0,0,85313.212698,8.901186000002781,167.16873459329298,0
"147.32.84.165",3926,"193.23.181.44",179,3,186,3,186,0,0,85313.25103,8.86287500000617,167.89134451280924,0
"147.32.84.165",3927,"174.37.196.55",80,3,186,3,186,0,0,85313.284406,8.929403999994975,166.64046111037618,0
"147.32.84.165",3928,"193.23.181.44",80,3,186,3,186,0,0,85313.285221,8.92864900000859,166.65455210509097,0
"147.32.84.165",3929,"174.128.246.102",80,3,186,3,186,0,0,85313.285673,8.928251999997883,166.66196249840985,0
"147.32.84.165",3930,"174.128.246.102",80,9,728,6,546,3,182,85313.285877,9.243415999997524,472.55257147370304,157.5175238245677
"147.32.84.165",3931,"174.128.246.102",80,3,186,3,186,0,0,85313.28599,8.92804499999329,166.6658266172626,0
"147.32.84.165",3932,"67.19.72.206",80,3,186,3,186,0,0,85313.286131,8.92795899999328,166.6674320526248,0
"147.32.84.165",3933,"174.37.196.55",80,3,186,3,186,0,0,85313.286239,8.927906000011717,166.66842146389615,0
"147.32.84.165",3934,"174.128.246.102",80,3,186,3,186,0,0,85313.286345,8.927855000001728,166.66937355050143,0
"147.32.84.165",3935,"193.23.181.44",179,3,186,3,186,0,0,85313.286452,8.927802000005613,166.67036298509584,0
"147.32.84.165",3936,"193.23.181.44",179,3,186,3,186,0,0,85313.28656,8.927749000009499,166.67135243143787,0
"147.32.84.165",3938,"193.23.181.44",179,3,186,3,186,0,0,85313.286712,8.927651000005426,166.67318200488523,0
"147.32.84.165",3939,"193.23.181.44",179,3,186,3,186,0,0,85313.286849,8.927569999999832,166.67469423370838,0
"147.32.84.165",3940,"193.23.181.44",80,3,186,3,186,0,0,85313.286958,8.927515999996103,166.6757024015022,0
"147.32.84.165",3937,"67.19.72.206",80,3,186,3,186,0,0,85313.287073,8.92746000000625,166.6767479214646,0
"147.32.84.165",3942,"174.128.246.102",80,3,186,3,186,0,0,85313.287182,8.927379999993718,166.678241544669,0
"147.32.84.165",3941,"67.19.72.206",80,3,186,3,186,0,0,85313.287287,8.92730300000403,166.67967918186804,0
"147.32.84.165",3943,"193.23.181.44",80,3,186,3,186,0,0,85313.287396,8.927221999998437,166.68119152859205,0
"147.32.84.165",3944,"72.20.15.61",80,3,186,3,186,0,0,85313.287503,8.92714299999352,166.68266655984786,0
"147.32.84.165",3945,"72.20.15.61",80,3,186,3,186,0,0,85313.386123,8.927971999990405,166.66718936860457,0
"147.32.84.165",3946,"67.19.72.206",80,3,186,3,186,0,0,85313.386617,8.927580000003218,166.67450753725686,0
"147.32.84.165",3947,"193.23.181.44",80,3,186,3,186,0,0,85313.386808,8.927410000003874,166.67768143272843,0
"147.32.84.165",3948,"193.23.181.44",80,3,186,3,186,0,0,85313.387009,8.92724000000453,166.68085544907998,0
"147.32.84.165",3949,"193.23.181.44",80,3,186,3,186,0,0,85313.387141,8.927146000001812,166.6826105453745,0
"147.32.84.165",3950,"174.37.196.55",80,3,186,3,186,0,0,85313.387249,8.927066999996896,166.6840856017455,0
"147.32.84.165",3951,"174.128.246.102",80,3,186,3,186,0,0,85313.387356,8.926988999999594,166.68554201198944,0
"147.32.84.165",3952,"72.20.15.61",80,3,186,3,186,0,0,85313.387463,8.92691099998774,166.68699844795626,0
"147.32.84.165",3953,"67.19.72.206",80,3,186,3,186,0,0,85313.387569,8.92683300000499,166.6884549088314,0
"147.32.84.165",3954,"193.23.181.44",179,3,186,3,186,0,0,85313.387678,8.926751999999397,166.68996741481118,0
"147.32.84.165",3955,"174.37.196.55",80,3,186,3,186,0,0,85313.387785,8.926674000002095,166.69142392784266,0
"147.32.84.165",3956,"174.37.196.55",80,3,186,3,186,0,0,85313.387892,8.926594999997178,166.69289914020635,0
"147.32.84.165",3957,"67.19.72.206",80,3,186,3,186,0,0,85313.388003,8.926512999998522,166.6944304007899,0
"147.32.84.165",3958,"193.23.181.44",179,3,186,3,186,0,0,85313.38816,8.92638399999123,166.6968393922401,0
"147.32.84.165",3959,"193.23.181.44",179,3,186,3,186,0,0,85313.388281,8.926290999996127,166.69857615000964,0
"147.32.84.165",3960,"174.37.196.55",80,3,186,3,186,0,0,85313.388398,8.926202000002377,166.70023824237944,0
"147.32.84.165",3961,"174.128.246.102",80,3,186,3,186,0,0,85313.388506,8.926121999989846,166.70173228661815,0
"147.32.84.165",3962,"67.19.72.206",80,3,186,3,186,0,0,85313.388613,8.926043999992544,166.70318900525731,0
"147.32.84.165",3963,"174.128.246.102",80,3,186,3,186,0,0,85313.38872,8.925967000002856,166.7046270728453,0
"147.32.84.165",3964,"193.23.181.44",179,3,186,3,186,0,0,85313.399712,8.915007000003243,166.90957169180672,0
"147.32.84.165",3965,"193.23.181.44",179,3,186,3,186,0,0,85313.418485,8.896263000002364,167.2612421642216,0
"147.32.84.165",3966,"193.23.181.44",80,3,186,3,186,0,0,85313.425975,8.888800999993691,167.40165518398445,0
"147.32.84.165",3967,"174.128.246.102",80,3,186,3,186,0,0,85313.485403,8.929881999996724,166.6315411559241,0
"147.32.84.165",3969,"193.23.181.44",80,3,186,3,186,0,0,85313.486249,8.929096000007121,166.64620920178407,0
"147.32.84.165",3968,"67.19.72.206",80,3,186,3,186,0,0,85313.48638,8.92899000000034,166.6481875329621,0
"147.32.84.165",3970,"193.23.181.44",80,3,186,3,186,0,0,85313.486929,8.928463999996893,166.65800522917692,0
"147.32.84.165",3971,"193.23.181.44",80,3,186,3,186,0,0,85313.489224,8.926191999998991,166.7004249964787,0
"147.32.84.165",3972,"193.23.181.44",179,3,186,3,186,0,0,85313.489411,8.926026999994065,166.70350649857875,0
"147.32.84.165",3973,"174.37.196.55",80,3,186,3,186,0,0,85313.489522,8.925938999993377,166.70515001291227,0
"147.32.84.165",3974,"72.20.15.61",80,3,186,3,186,0,0,85313.489638,8.925845999998273,166.70688694385808,0
"147.32.84.165",3975,"67.19.72.206",80,3,186,3,186,0,0,85313.489753,8.925753999996232,166.70860523386912,0
"147.32.84.165",3976,"174.37.196.55",80,3,186,3,186,0,0,85313.489867,8.925662000008742,166.71032355903043,0
"147.32.84.165",3977,"72.20.15.61",80,3,186,3,186,0,0,85313.489983,8.925569999992149,166.71204192015847,0
"147.32.84.165",3978,"193.23.181.44",80,3,186,3,186,0,0,85313.490098,8.925479000012274,166.7137416376145,0
"147.32.84.165",3979,"67.19.72.206",80,3,186,3,186,0,0,85313.490213,8.925394000005326,166.71532931757545,0
"147.32.84.165",3980,"193.23.181.44",179,3,186,3,186,0,0,85313.490328,8.925310999999056,166.7168796695328,0
"147.32.84.165",3981,"193.23.181.44",179,3,186,3,186,0,0,85313.49044,8.9252290000004,166.718411370726,0
"147.32.84.165",3982,"174.128.246.102",80,3,186,3,186,0,0,85313.490945,8.924752000006265,166.7273219467561,0
"147.32.84.165",3983,"174.37.196.55",80,3,186,3,186,0,0,85313.492327,8.923397999998997,166.75262047038217,0
"147.32.84.165",3985,"67.19.72.206",80,3,186,3,186,0,0,85313.49314,8.92261399999552,166.76727246082226,0
"147.32.84.165",3986,"67.19.72.206",80,3,186,3,186,0,0,85313.493262,8.92251399999077,166.76914152239374,0
"147.32.84.165",3984,"193.23.181.44",179,3,186,3,186,0,0,85313.493376,8.922428999998374,166.77073025745244,0
"147.32.84.165",3987,"193.23.181.44",80,3,186,3,186,0,0,85313.585633,8.928808000011486,166.65158439940538,0
"147.32.84.165",3988,"72.20.15.61",80,3,186,3,186,0,0,85313.586134,8.928330000009737,166.66050649991402,0
"147.32.84.165",3989,"193.23.181.44",179,3,186,3,186,0,0,85313.58654,8.927947999996832,166.66763740117304,0
"147.32.84.165",3990,"67.19.72.206",80,3,186,3,186,0,0,85313.586712,8.927798999997322,166.67041899133778,0
"147.32.84.165",3991,"193.23.181.44",179,3,186,3,186,0,0,85313.586834,8.927700000000186,166.67226721327654,0
"147.32.84.165",3992,"174.37.196.55",80,8,690,5,508,3,182,85313.586952,3.2907580000028247,1234.9738266978343,442.4512528720587
"147.32.84.165",3993,"72.20.15.61",80,3,186,3,186,0,0,85313.587083,8.927473999996437,166.67648654038018,0
"147.32.84.165",3994,"174.128.246.102",80,3,186,3,186,0,0,85313.587201,8.927379000000656,166.678260214996,0
"147.32.84.165",3995,"193.23.181.44",179,3,186,3,186,0,0,85313.587318,8.927284999997937,166.6800152566367,0
"147.32.84.165",3996,"174.37.196.55",80,8,621,5,439,3,182,85313.592762,3.2975299999961862,1065.0395902399862,441.5426091655524
"147.32.84.165",3997,"174.37.196.55",80,8,653,5,471,3,182,85313.60825,3.285491999995429,1146.8601962827006,443.1604155487293
"147.32.84.165",3999,"46.4.36.120",443,6,366,3,186,3,180,85313.627431,0.9890969999978552,1504.4025004658054,1455.8733875475536
"147.32.84.165",3998,"174.37.196.55",80,7,577,4,395,3,182,85313.627554,0.24312999998801388,12997.162012733046,5988.565788145353
"147.32.84.165",4001,"193.23.181.44",80,3,186,3,186,0,0,85313.685557,8.930286999995587,166.62398420126198,0
"147.32.84.165",4000,"174.37.196.55",80,9,686,6,504,3,182,85313.685679,9.1726459999918,439.5678193624396,158.73282365865876
"147.32.84.165",4002,"72.20.15.61",80,3,186,3,186,0,0,85313.749874,8.866060999993351,167.83101311857834,0
"147.32.84.165",4003,"193.23.181.44",80,3,186,3,186,0,0,85313.789497,8.925975999998627,166.7044589857993,0
"147.32.84.165",4004,"174.37.196.55",80,3,186,3,186,0,0,85313.79025,8.925252999993972,166.71796306513718,0
"147.32.84.165",4005,"193.23.181.44",80,3,186,3,186,0,0,85313.790383,8.925147999994806,166.71992442039794,0
"147.32.84.165",4006,"174.37.196.55",80,3,186,3,186,0,0,85313.790493,8.925067000003764,166.72143749726163,0
"147.32.84.165",4007,"174.128.246.102",80,3,186,3,186,0,0,85313.790601,8.924987999998848,166.72291324091327,0
"147.32.84.165",4008,"174.128.246.102",80,3,186,3,186,0,0,85313.790708,8.924908000000869,166.72440769135716,0
"147.32.84.165",4009,"193.23.181.44",179,3,186,3,186,0,0,85313.790817,8.924826999995275,166.72592084987056,0
"147.32.84.165",4010,"72.20.15.61",80,3,186,3,186,0,0,85313.790925,8.924747000011848,166.72741535396182,0
"147.32.84.165",4011,"174.128.246.102",80,3,186,3,186,0,0,85313.791032,8.924666000006255,166.72892856706986,0
"147.32.84.165",4012,"193.23.181.44",80,3,186,3,186,0,0,85313.79114,8.924585000000661,166.73044180764592,0
"147.32.84.165",4013,"174.128.246.102",80,3,186,3,186,0,0,85313.791255,8.924496999999974,166.73208585313037,0
"147.32.84.165",4014,"67.19.72.206",80,3,186,3,186,0,0,85313.791369,8.924408999999287,166.73372993103735,0
"147.32.84.165",4015,"193.23.181.44",179,3,186,3,186,0,0,85313.791485,8.924319000012474,166.735411407629,0
"147.32.84.165",4016,"193.23.181.44",80,3,186,3,186,0,0,85313.791604,8.92422699999588,166.73713028598297,0
"147.32.84.165",4017,"174.128.246.102",80,3,186,3,186,0,0,85313.79172,8.924137000009068,166.73881183115947,0
"147.32.84.165",4018,"193.23.181.44",179,3,186,3,186,0,0,85313.791838,8.924044999992475,166.74053077962458,0
"147.32.84.165",4019,"174.37.196.55",80,3,186,3,186,0,0,85313.791954,8.923955999998725,166.74219370873328,0
"147.32.84.165",4021,"174.37.196.55",80,3,186,3,186,0,0,85313.807157,8.908779999997932,167.0262370381068,0
"147.32.84.165",4022,"72.20.15.61",80,3,186,3,186,0,0,85313.807269,8.908695000005537,167.02783067543285,0
"147.32.84.165",4023,"174.128.246.102",80,3,186,3,186,0,0,85313.807378,8.90861300000688,167.02936809566773,0
"147.32.84.165",4024,"193.23.181.44",80,3,186,3,186,0,0,85313.807487,8.908531000008225,167.03090554420547,0
"147.32.84.165",4025,"174.37.196.55",80,3,186,3,186,0,0,85313.807596,8.908448999995016,167.0324430213197,0
"147.32.84.165",4026,"72.20.15.61",80,3,186,3,186,0,0,85313.807705,8.908368999997037,167.0339430259899,0
"147.32.84.165",4020,"67.19.72.206",80,3,186,3,186,0,0,85313.80781,8.90829200000735,167.0353868057729,0
"147.32.84.165",4027,"67.19.72.206",80,3,186,3,186,0,0,85313.827105,8.88902399998915,167.39745555887984,0
"147.32.84.165",4028,"174.128.246.102",80,3,186,3,186,0,0,85313.829576,8.88900699999067,167.39777570223106,0
"147.32.84.165",4029,"60.190.223.75",888,11,1331,6,844,5,487,85313.843074,1.019629000002169,6622.0164392986435,3820.997637367819
"147.32.84.165",4030,"174.128.246.102",80,3,186,3,186,0,0,85313.88764,8.928063999992446,166.66547193224187,0
"147.32.84.165",4031,"193.23.181.44",179,3,186,3,186,0,0,85313.888363,8.927398999992874,166.6778868068054,0
"147.32.84.165",4032,"174.37.196.55",80,3,186,3,186,0,0,85313.889232,8.926552999997512,166.69368344089983,0
"147.32.84.165",4033,"193.23.181.44",179,3,186,3,186,0,0,85313.889492,8.926322999992408,166.6979785518926,0
"147.32.84.165",4034,"72.20.15.61",80,3,186,3,186,0,0,85313.889716,8.926127999991877,166.70162023235093,0
"147.32.84.165",4035,"72.20.15.61",80,3,186,3,186,0,0,85313.889935,8.925937000007252,166.70518736562795,0
"147.32.84.165",4036,"193.23.181.44",80,3,186,3,186,0,0,85313.890155,8.925743999992847,166.70879200671592,0
"147.32.84.165",4038,"174.37.196.55",80,3,186,3,186,0,0,85313.89049,8.925435999990441,166.71454481345154,0
"147.32.84.165",4039,"193.23.181.44",80,3,186,3,186,0,0,85313.890714,8.9252400000114,166.71820589677134,0
"147.32.84.165",4037,"67.19.72.206",80,3,186,3,186,0,0,85313.890926,8.925055000014254,166.7216616589616,0
"147.32.84.165",4041,"72.20.15.61",80,3,186,3,186,0,0,85313.891199,8.924809999996796,166.72623842978552,0
"147.32.84.165",4042,"67.19.72.206",80,3,186,3,186,0,0,85313.891415,8.924620999998297,166.72976925297826,0
"147.32.84.165",4043,"72.20.15.61",80,3,186,3,186,0,0,85313.891629,8.924434000000474,166.73326286013443,0
"147.32.84.165",4044,"72.20.15.61",80,3,186,3,186,0,0,85313.8919,8.924190999998245,166.73780290003796,0
"147.32.84.165",4045,"174.37.196.55",80,3,186,3,186,0,0,85313.892116,8.924006999994162,166.74124079026086,0
"147.32.84.165",4040,"72.20.15.61",80,3,186,3,186,0,0,85313.892328,8.923823999997694,166.74466013677372,0
"147.32.84.165",4046,"174.37.196.55",80,3,186,3,186,0,0,85313.892598,8.923581999988528,166.74918211116488,0
"147.32.84.165",4047,"193.23.181.44",80,3,186,3,186,0,0,85313.986883,8.928791999991518,166.6518830320399,0
"147.32.84.165",4048,"193.23.181.44",179,3,186,3,186,0,0,85313.987067,8.928698000003351,166.653637517972,0
"147.32.84.165",4049,"193.23.181.44",80,3,186,3,186,0,0,85313.987752,8.928037000005133,166.66597595856115,0
"147.32.84.165",4050,"174.37.196.55",80,3,186,3,186,0,0,85313.988078,8.927748000001884,166.6713711004932,0
"147.32.84.165",4051,"193.23.181.44",179,3,186,3,186,0,0,85313.988226,8.927630999998655,166.67355539226747,0
"147.32.84.165",4052,"72.20.15.61",80,3,186,3,186,0,0,85313.988336,8.92755200000829,166.67503028810341,0
"147.32.84.165",4053,"193.23.181.44",80,3,186,3,186,0,0,85313.988447,8.92748900000879,166.67620648970106,0
"147.32.84.165",4054,"72.20.15.61",80,3,186,3,186,0,0,85313.988562,8.92740899999626,166.67770010320166,0
"147.32.84.165",4055,"174.128.246.102",80,3,186,3,186,0,0,85313.988683,8.927320999995572,166.67934310872636,0
"147.32.84.165",4056,"67.19.72.206",80,3,186,3,186,0,0,85313.988823,8.927210999987437,166.6813969113191,0
"147.32.84.165",4057,"67.19.72.206",80,3,186,3,186,0,0,85313.988936,8.927127000002656,166.68296530334533,0
"147.32.84.165",4059,"174.37.196.55",80,3,186,3,186,0,0,85314.007637,8.908456000004662,167.03231177200868,0
"147.32.84.165",4058,"174.37.196.55",80,3,186,3,186,0,0,85314.007753,8.908370999997715,167.0339055255312,0
"147.32.84.165",4060,"174.37.196.55",80,3,186,3,186,0,0,85314.087583,8.928677000003518,166.65402948268974,0
"147.32.84.165",4061,"193.23.181.44",179,3,186,3,186,0,0,85314.088342,8.927983999994467,166.6669653530878,0
"147.32.84.165",4062,"193.23.181.44",179,3,186,3,186,0,0,85314.088464,8.927891999992426,166.6686828202293,0
"147.32.84.165",4063,"193.23.181.44",179,3,186,3,186,0,0,85314.088653,8.927733000004082,166.67165113465194,0
"147.32.84.165",4064,"174.37.196.55",80,3,186,3,186,0,0,85314.088772,8.927643000002718,166.67333135963736,0
"147.32.84.165",4065,"193.23.181.44",80,3,186,3,186,0,0,85314.089245,8.927198000004864,166.68163963644463,0
"147.32.84.165",4066,"174.128.246.102",80,7,603,5,481,2,122,85314.08947,3.3258509999868693,1156.9971114205634,293.4587268052157
"147.32.84.165",4067,"72.20.15.61",80,3,186,3,186,0,0,85314.089737,8.92673599999398,166.69026618475147,0
"147.32.84.165",4068,"193.23.181.44",80,3,186,3,186,0,0,85314.089958,8.926543000008678,166.69387018004096,0
"147.32.84.165",4069,"174.128.246.102",80,3,186,3,186,0,0,85314.090175,8.926354999988689,166.6973809580602,0
"147.32.84.165",4070,"174.128.246.102",80,3,186,3,186,0,0,85314.090396,8.926166000004741,166.7009105588233,0
"147.32.84.165",4072,"193.23.181.44",179,3,186,3,186,0,0,85314.09069,8.925902999995742,166.705822368976,0
"147.32.84.165",4073,"174.128.246.102",80,7,621,4,439,3,182,85314.09091,0.32753300000331365,10722.583678482684,4445.353597913095
"147.32.84.165",4074,"72.20.15.61",80,3,186,3,186,0,0,85314.091131,8.925491000001784,166.71351749721137,0
"147.32.84.165",4071,"67.19.72.206",80,3,186,3,186,0,0,85314.091345,8.925306000004639,166.7169730650385,0
"147.32.84.165",4076,"67.19.72.206",80,3,186,3,186,0,0,85314.091564,8.925115999998525,166.72052217587378,0
"147.32.84.165",4077,"174.37.196.55",80,3,186,3,186,0,0,85314.091785,8.924922999998671,166.72412747989216,0
"147.32.84.165",4078,"72.20.15.61",80,3,186,3,186,0,0,85314.092004,8.924731999999494,166.72769557675056,0
"147.32.84.165",4075,"67.19.72.206",80,3,186,3,186,0,0,85314.092218,8.924546999987797,166.73115173263525,0
"147.32.84.165",4079,"72.20.15.61",80,3,186,3,186,0,0,85314.092439,8.924354000002495,166.7347574961262,0
"147.32.84.165",4080,"174.37.196.55",80,3,186,3,186,0,0,85314.092657,8.924165000003995,166.73828868015482,0
"147.32.84.165",4081,"72.20.15.61",80,3,186,3,186,0,0,85314.092875,8.923974999997881,166.7418386986016,0
"147.32.84.165",4082,"174.128.246.102",80,8,688,4,446,4,242,85314.093151,0.32042899999942165,11135.072044061055,6041.900077719228
"147.32.84.165",4083,"193.23.181.44",80,3,186,3,186,0,0,85314.188146,8.928409000000102,166.65903186110572,0
"147.32.84.165",4084,"174.37.196.55",80,3,186,3,186,0,0,85314.188312,8.92833999999857,166.66031983551682,0
"147.32.84.165",4085,"193.23.181.44",179,3,186,3,186,0,0,85314.188434,8.92824200000905,166.66214916648673,0
"147.32.84.165",4086,"193.23.181.44",80,3,186,3,186,0,0,85314.188598,8.928098000003956,166.66483723625578,0
"147.32.84.165",4087,"174.128.246.102",80,9,700,6,518,3,182,85314.188791,9.258045000009588,447.6106996666908,157.26862420721568
"147.32.84.165",4088,"174.128.246.102",80,3,186,3,186,0,0,85314.253968,8.86277799999516,167.8931820249602,0
"147.32.84.165",4089,"72.20.15.61",80,3,186,3,186,0,0,85314.254939,8.861834999988787,167.91104776853584,0
"147.32.84.165",4090,"193.23.181.44",80,3,186,3,186,0,0,85314.287087,8.930228999990504,166.62506638985207,0
"147.32.84.165",4091,"72.20.15.61",80,3,186,3,186,0,0,85314.287269,8.930105000006733,166.6273800810716,0
"147.32.84.165",4092,"193.23.181.44",80,3,186,3,186,0,0,85314.388553,8.929252000001725,166.64329778123772,0
"147.32.84.165",4093,"193.23.181.44",179,3,186,3,186,0,0,85314.388738,8.929148000010173,166.64523871687476,0
"147.32.84.165",4094,"174.37.196.55",80,3,186,3,186,0,0,85314.388849,8.929077000007965,166.64656380482245,0
"147.32.84.165",4095,"67.19.72.206",80,3,186,3,186,0,0,85314.487821,8.92969199999061,166.6350866302628,0
"147.32.84.165",4096,"89.200.164.105",6667,2,124,2,124,0,0,85314.602119,2.9958630000037374,331.123285677203,0
"147.32.84.165",4097,"184.82.148.43",80,10,1919,5,979,5,940,85314.74831,0.3446960000001127,22721.47051314039,21816.325109654714
"147.32.84.165",4098,"67.19.72.206",80,3,186,3,186,0,0,85314.889249,8.929021999996621,166.64759029606637,0
"147.32.84.165",4099,"193.23.181.44",179,3,186,3,186,0,0,85314.889383,8.929008999999496,166.6478329230135,0
"147.32.84.165",4100,"61.147.99.179",81,41,37045,21,1439,20,35606,85314.947276,3.1563769999920623,3647.219581193549,90245.24003334086
"147.32.84.165",4101,"184.82.148.44",80,10,1514,5,596,5,918,85314.98734,0.3532439999980852,13497.752261965796,20790.162041081545
"147.32.84.165",4102,"193.23.181.44",80,3,186,3,186,0,0,85315.090538,8.928799999994226,166.65173371572465,0
"147.32.84.165",4103,"72.20.15.61",80,3,186,3,186,0,0,85315.09079,8.928671000001486,166.65414147298654,0
"147.32.84.165",4104,"174.128.246.102",80,9,703,6,521,3,182,85315.091003,9.255261000012979,450.3384615511281,157.3159309065361
"147.32.84.165",4105,"174.37.196.55",80,3,186,3,186,0,0,85315.091114,8.92844000000332,166.65845321236932,0
"147.32.84.165",4106,"67.19.72.206",80,3,186,3,186,0,0,85315.243631,8.876385999988997,167.63579231478266,0
"147.32.84.165",4107,"174.37.196.55",80,3,186,3,186,0,0,85315.246837,8.873246000002837,167.69511405403662,0
"147.32.84.165",4108,"67.19.72.206",80,3,186,3,186,0,0,85315.250033,8.870079999993322,167.75496951562107,0
"147.32.84.165",4109,"193.23.181.44",80,3,186,3,186,0,0,85315.253254,8.866888999997173,167.81534087101738,0
"147.32.84.165",4110,"174.37.196.55",80,3,186,3,186,0,0,85315.256456,8.863714999999502,167.87543372052053,0
"147.32.84.165",4111,"174.37.196.55",80,3,186,3,186,0,0,85315.259632,8.860566999996081,167.9350768410936,0
"147.32.84.165",4112,"217.163.21.36",80,14,6141,7,810,7,5331,85315.262826,0.6891819999873405,9402.451021818664,61882.05728063617
"147.32.84.165",4113,"67.19.72.206",80,3,186,3,186,0,0,85315.468004,8.75181300000986,170.0219143163049,0
"147.32.84.165",4114,"193.23.181.44",179,3,186,3,186,0,0,85315.471204,8.748659999997471,170.08318988284265,0
"147.32.84.165",4115,"72.20.15.61",80,3,186,3,186,0,0,85315.474404,8.745506999999634,170.14450963221026,0
"147.32.84.165",4116,"174.128.246.102",80,19,2216,14,1908,5,308,85315.477635,309.150158000004,49.374065013415915,7.970236909922485
"147.32.84.165",4117,"193.23.181.44",179,3,186,3,186,0,0,85315.48085,8.739154999988386,170.2681781021137,0
"147.32.84.165",4118,"72.20.15.61",80,3,186,3,186,0,0,85315.484051,8.735999999989872,170.3296703298678,0
"147.32.84.165",4119,"174.37.196.55",80,3,186,3,186,0,0,85315.487236,8.732862999997451,170.3908557823974,0
"147.32.84.165",4120,"193.23.181.44",80,3,186,3,186,0,0,85315.490455,8.729689999992843,170.45278812892784,0
"147.32.84.165",4121,"174.128.246.102",80,3,186,3,186,0,0,85315.493605,8.726588999998057,170.51335865598017,0
"147.32.84.165",4122,"193.23.181.44",179,3,186,3,186,0,0,85315.54281,8.677433000004385,171.47928425367826,0
"147.32.84.165",4123,"193.23.181.44",179,3,186,3,186,0,0,85315.564406,8.655899999997928,171.90586767411318,0
"147.32.84.165",4124,"174.128.246.102",80,3,186,3,186,0,0,85315.570824,8.750530999997864,170.04682344424165,0
"147.32.84.165",4125,"193.23.181.44",80,3,186,3,186,0,0,85315.574022,8.747355999992578,170.10854479928136,0
"147.32.84.165",4126,"72.20.15.61",80,3,186,3,186,0,0,85315.577222,8.744178999986616,170.1703498981754,0
"147.32.84.165",4127,"193.23.181.44",80,3,186,3,186,0,0,85315.580422,8.741001999995206,170.23219992408377,0
"147.32.84.165",4128,"193.23.181.44",179,3,186,3,186,0,0,85315.583611,8.737836000000243,170.29388054433142,0
"147.32.84.165",4129,"174.128.246.102",80,3,186,3,186,0,0,85315.586831,8.734639000002062,170.35621048559062,0
"147.32.84.165",4130,"72.20.15.61",80,3,186,3,186,0,0,85315.608808,8.712684999991325,170.7854696917749,0
"147.32.84.165",4131,"46.4.36.120",443,6,366,3,186,3,180,85315.733656,0.9883970000082627,1505.467944548153,1456.9044624659546
"147.32.84.165",4132,"174.128.246.102",80,3,186,3,186,0,0,85315.743243,8.878232999995816,167.60091788542846,0
"147.32.84.165",4133,"174.128.246.102",80,3,186,3,186,0,0,85315.746427,8.875115999995614,167.65978044689615,0
"147.32.84.165",4134,"72.20.15.61",80,3,186,3,186,0,0,85315.749622,8.871952000001329,167.71957287412928,0
"147.32.84.165",4135,"217.163.21.36",80,10,1451,5,701,5,750,85315.759207,0.35448200000973884,15820.267319203596,16926.106261630095
"147.32.84.165",4136,"193.23.181.44",179,3,186,3,186,0,0,85315.780828,8.840775999997277,168.31101704199477,0
"147.32.84.165",4137,"193.23.181.44",80,3,186,3,186,0,0,85315.802408,8.81922599999234,168.7222892350522,0
"147.32.84.165",4138,"67.19.72.206",80,3,186,3,186,0,0,85315.824031,8.797632000001613,169.13642216447872,0
"147.32.84.165",4139,"174.37.196.55",80,3,186,3,186,0,0,85315.916809,8.80481200000213,168.99849763965886,0
"147.32.84.165",4140,"174.128.246.102",80,3,186,3,186,0,0,85315.920026,8.801627999986522,169.0596330590521,0
"147.32.84.165",4141,"67.19.72.206",80,3,186,3,186,0,0,85315.923251,8.798431999995955,169.12104338599013,0
"147.32.84.165",4142,"174.37.196.55",80,3,186,3,186,0,0,85315.926408,8.79530500000692,169.1811710905795,0
"147.32.84.165",4143,"174.37.196.55",80,3,186,3,186,0,0,85315.929624,8.792117999997572,169.24249651795063,0
"147.32.84.165",4144,"174.37.196.55",80,3,186,3,186,0,0,85315.932807,8.788965999992797,169.30319220727665,0
"147.32.84.165",4145,"174.128.246.102",80,3,186,3,186,0,0,85315.936006,8.785795000003418,169.36429771004458,0
"147.32.84.165",4146,"174.128.246.102",80,3,186,3,186,0,0,85315.939219,8.78261099998781,169.42569812121536,0
"147.32.84.165",4147,"67.19.72.206",80,3,186,3,186,0,0,85315.942405,8.77945400000317,169.48662183314164,0
"147.32.84.165",4148,"67.19.72.206",80,3,186,3,186,0,0,85315.945623,8.776264000000083,169.54822689928037,0
"147.32.84.165",4149,"72.20.15.61",80,3,186,3,186,0,0,85315.948809,8.773106000007829,169.60925811208392,0
"147.32.84.165",4150,"174.37.196.55",80,3,186,3,186,0,0,85316.000826,8.721118000001297,170.62032643059968,0
"147.32.84.165",4151,"217.163.21.35",80,13,5006,7,2126,6,2880,85316.071236,0.544767999992473,31220.629699679488,42293.233083291125
"147.32.84.165",4152,"193.23.181.44",179,3,186,3,186,0,0,85316.125653,8.897576000003028,167.23655971013832,0
"147.32.84.165",4153,"72.20.15.61",80,3,186,3,186,0,0,85316.284421,8.838435999990907,168.3555778422258,0
"147.32.84.165",4154,"67.19.72.206",80,3,186,3,186,0,0,85316.287655,8.83532300000661,168.41489552774547,0
"147.32.84.165",4155,"174.37.196.55",80,3,186,3,186,0,0,85316.310404,8.812622999990708,168.84870713311676,0
"147.32.84.165",4156,"193.23.181.44",179,3,186,3,186,0,0,85316.332022,8.79105499999423,169.26296104403585,0
"147.32.84.165",4157,"72.20.15.61",80,3,186,3,186,0,0,85316.392804,8.83107800000289,168.4958506763855,0
"147.32.84.165",4158,"174.128.246.102",80,3,186,3,186,0,0,85316.396004,8.82790100001148,168.55648924903724,0
"147.32.84.165",4159,"174.37.196.55",80,3,186,3,186,0,0,85316.399205,8.824730000007548,168.61705683898853,0
"147.32.84.165",4160,"67.19.72.206",80,3,186,3,186,0,0,85316.402404,8.821560000011232,168.67764885100883,0
"147.32.84.165",4161,"67.19.72.206",80,3,186,3,186,0,0,85316.405604,8.818387000006624,168.73834183041438,0
"147.32.84.165",4162,"193.23.181.44",80,3,186,3,186,0,0,85316.408805,8.815214999995078,168.79905935372318,0
"147.32.84.165",4164,"193.23.181.44",80,3,186,3,186,0,0,85316.482456,8.841484999997192,168.29752015645252,0
"147.32.84.165",4163,"193.23.181.44",179,3,186,3,186,0,0,85316.485626,8.838343000010354,168.35734933553232,0
"147.32.84.165",4165,"72.20.15.61",80,3,186,3,186,0,0,85316.488822,8.8351740000071,168.41773574564624,0
"147.32.84.165",4166,"174.128.246.102",80,3,186,3,186,0,0,85316.492055,8.831971000006888,168.47881407206154,0
"147.32.84.165",4167,"174.37.196.55",80,3,186,3,186,0,0,85316.495229,8.828825000004144,168.53884860095218,0
"147.32.84.165",4168,"174.128.246.102",80,3,186,3,186,0,0,85316.593654,8.830750000008265,168.50210910722274,0
"147.32.84.165",4169,"174.37.196.55",80,9,714,6,532,3,182,85316.757172,9.111294999995152,467.11252352187745,159.80165278380017
"147.32.84.165",4170,"193.23.181.44",80,3,186,3,186,0,0,85316.770501,8.854543999987072,168.0493089200497,0
"147.32.84.165",4171,"174.37.196.55",80,9,720,6,538,3,182,85316.774118,9.09436000000278,473.2603503708545,160.0992263336348
"147.32.84.165",4173,"174.128.246.102",80,3,186,3,186,0,0,85316.836404,8.888601999991806,167.40540300953646,0
"147.32.84.165",4172,"193.23.181.44",80,3,186,3,186,0,0,85316.839608,8.885447000007844,167.4648444809458,0
"147.32.84.165",4174,"174.37.196.55",80,3,186,3,186,0,0,85316.842818,8.88228099999833,167.52453564577385,0
"147.32.84.165",4175,"174.37.196.55",80,3,186,3,186,0,0,85316.846027,8.879144999998971,167.5837031606278,0
"147.32.84.165",4176,"67.19.72.206",80,3,186,3,186,0,0,85316.849206,8.876023999997415,167.642629177257,0
"147.32.84.165",4177,"193.23.181.44",179,3,186,3,186,0,0,85316.852411,8.872877000001608,167.7020880600205,0
"147.32.84.165",4178,"174.37.196.55",80,3,186,3,186,0,0,85316.855608,8.869737000000896,167.76145673765183,0
"147.32.84.165",4179,"193.23.181.44",80,3,186,3,186,0,0,85317.097274,8.929615000000922,166.63652352311342,0
"147.32.84.165",4180,"174.37.196.55",80,3,186,3,186,0,0,85317.260407,8.86731200000213,167.80733552621612,0
"147.32.84.165",4181,"193.23.181.44",80,3,186,3,186,0,0,85317.297381,8.930066000000807,166.62810778776614,0
"147.32.84.165",4182,"67.19.72.206",80,3,186,3,186,0,0,85317.397592,8.9299580000079,166.63012300826986,0
"147.32.84.165",4183,"193.23.181.44",80,3,186,3,186,0,0,85317.598233,8.930566000010003,166.61877869760252,0
"147.32.84.165",4184,"46.4.36.120",443,6,366,3,186,3,180,85317.72258,1.0067909999925178,1477.9631522441684,1430.2869215266146
"147.32.84.165",4185,"193.23.181.44",80,3,186,3,186,0,0,85318.200685,8.929842999990797,166.63226889896424,0
"147.32.84.165",4186,"193.23.181.44",80,3,186,3,186,0,0,85318.301055,8.92987799999537,166.6316157959573,0
"147.32.84.165",4187,"67.19.72.206",80,3,186,3,186,0,0,85318.301284,8.929692000005161,166.63508662999126,0
"147.32.84.165",4188,"174.37.196.55",80,3,186,3,186,0,0,85318.301471,8.929566000006162,166.63743792239995,0
"147.32.84.165",4189,"174.37.196.55",80,3,186,3,186,0,0,85318.301614,8.929482000006828,166.6390054875369,0
"147.32.84.165",4190,"60.190.223.75",888,11,1324,6,837,5,487,85318.357104,0.9711270000116201,6895.081693660951,4011.833673611569
"147.32.84.165",4191,"174.37.196.55",80,3,186,3,186,0,0,85318.400884,8.92992399999639,166.63075743988432,0
"147.32.84.165",4192,"174.37.196.55",80,3,186,3,186,0,0,85318.802559,8.9293650000036,166.64118893106064,0
"147.32.84.165",4193,"60.190.223.75",888,11,1331,6,844,5,487,85319.487023,0.9705590000085067,6956.815608263712,4014.181518038422
"147.32.84.165",4194,"72.20.15.61",80,3,186,3,186,0,0,85319.605928,8.92877800000133,166.6521443359638,0
"147.32.84.165",4195,"46.4.36.120",443,6,366,3,186,3,180,85319.730896,1.0055370000045514,1479.8063124412774,1432.0706249431719
"147.32.84.165",4196,"193.23.181.44",80,3,186,3,186,0,0,85321.353092,8.88747699999658,167.4265936216288,0
"147.32.84.165",4197,"174.37.196.55",80,3,186,3,186,0,0,85321.35634,8.884277999997721,167.4868796316799,0
"147.32.84.165",4198,"193.23.181.44",179,3,186,3,186,0,0,85321.35951,8.881152000001748,167.5458318920459,0
"147.32.84.165",4199,"174.128.246.102",80,3,186,3,186,0,0,85321.369095,8.971598000003723,165.85674034875197,0
"147.32.84.165",4200,"67.19.72.206",80,3,186,3,186,0,0,85321.387913,8.952879000004032,166.2035195605045,0
"147.32.84.165",4201,"193.23.181.44",80,3,186,3,186,0,0,85321.725138,9.017038000005414,165.02093037637266,0
"147.32.84.165",4202,"193.23.181.44",179,3,186,3,186,0,0,85321.728369,9.013855999990483,165.0791847575079,0
"147.32.84.165",4203,"46.4.36.120",443,6,366,3,186,3,180,85321.735202,1.0078760000033071,1476.3720933875968,1428.7471871492871
"147.32.84.165",4204,"174.128.246.102",80,8,631,5,449,3,182,85322.214936,3.3376719999941997,1076.1992190982944,436.2322001690191
"147.32.84.165",4205,"193.23.181.44",80,3,186,3,186,0,0,85322.215097,9.028674000001047,164.80825423532045,0
"147.32.84.165",4206,"174.37.196.55",80,3,186,3,186,0,0,85322.272622,8.971208000002662,165.86395054039082,0
"147.32.84.165",4207,"174.37.196.55",80,3,186,3,186,0,0,85322.314947,9.028821999992942,164.80555270678315,0
"147.32.84.165",4209,"67.19.72.206",80,3,186,3,186,0,0,85322.372604,8.971255999989808,165.86306309859964,0
"147.32.84.165",4210,"193.23.181.44",80,3,186,3,186,0,0,85322.514777,9.029238999995869,164.79794144342407,0
"147.32.84.165",4211,"174.128.246.102",80,3,186,3,186,0,0,85322.514977,9.029068999996525,164.80104427162675,0
"147.32.84.165",4212,"67.19.72.206",80,3,186,3,186,0,0,85322.73816,9.007761000000755,165.1908837279181,0
"147.32.84.165",4214,"72.20.15.61",80,3,186,3,186,0,0,85322.816446,9.028489999996964,164.81161301618548,0
"147.32.84.165",4215,"67.19.72.206",80,3,186,3,186,0,0,85322.816584,9.028472000005422,164.8119415997642,0
"147.32.84.165",4216,"184.82.148.43",80,10,1919,5,979,5,940,85322.984662,0.34300700000312645,22833.35325497326,21923.75082704276
"147.32.84.165",4217,"184.82.148.44",80,10,1514,5,596,5,918,85323.218438,0.30329599999822676,15720.616163839537,24213.969191954187
"147.32.84.165",4218,"174.37.196.55",80,3,186,3,186,0,0,85323.282372,8.9641730000003,165.9941190336186,0
"147.32.84.165",4220,"217.163.21.36",80,14,6141,7,810,7,5331,85323.435075,0.18718700000317767,34617.788627896145,227836.33478433872
"147.32.84.165",4221,"217.163.21.36",80,10,1451,5,701,5,750,85323.583145,0.13938300000154413,40234.4618779756,43046.85650282696
"147.32.84.165",4222,"217.163.21.35",80,13,5017,7,2145,6,2872,85323.677363,0.24627699999837205,69677.63940649526,93293.32418436102
"147.32.84.165",4223,"46.4.36.120",443,6,366,3,186,3,180,85323.744051,1.004784999997355,1480.9138273400947,1433.1424135549303
"147.32.84.165",4224,"72.20.15.61",80,3,186,3,186,0,0,85324.183853,8.965925000011339,165.96168270402868,0
"147.32.84.165",4225,"67.19.72.206",80,3,186,3,186,0,0,85324.220824,9.028716000000713,164.8074875762935,0
"147.32.84.165",4226,"193.23.181.44",179,3,186,3,186,0,0,85324.221112,9.02854899999511,164.81053600094612,0
"147.32.84.165",4227,"174.128.246.102",80,3,186,3,186,0,0,85324.385902,9.00123700000404,165.31061230798971,0
"147.32.84.165",4228,"143.107.171.10",6667,2,124,2,124,0,0,85324.603563,2.9277969999966444,338.8213048927699,0
"147.32.84.165",4229,"193.23.181.44",80,3,186,3,186,0,0,85324.722144,9.029236999995192,164.79797794661857,0
"147.32.84.165",4230,"72.20.15.61",80,3,186,3,186,0,0,85325.388941,8.964370000001509,165.9904711652631,0
"147.32.84.165",4231,"174.128.246.102",80,3,186,3,186,0,0,85325.747426,9.007138999993913,165.20229120489932,0
"147.32.84.165",4232,"193.23.181.44",179,3,186,3,186,0,0,85325.747651,9.006938999998965,165.20595953854811,0
"147.32.84.165",4233,"46.4.36.120",443,6,366,3,186,3,180,85325.749745,1.0071500000049127,1477.436330231586,1429.7770937725024
"147.32.84.165",4234,"174.37.196.55",80,3,186,3,186,0,0,85325.825821,9.030434000000241,164.77613368305003,0
"147.32.84.165",4235,"174.37.196.55",80,3,186,3,186,0,0,85325.825961,9.030315000010887,164.7783050755379,0
"147.32.84.165",4236,"193.23.181.44",80,3,186,3,186,0,0,85325.826177,9.030121000003419,164.78184511585576,0
"147.32.84.165",4237,"67.19.72.206",80,3,186,3,186,0,0,85326.128205,9.028798999992432,164.8059725331406,0
"147.32.84.165",4238,"67.19.72.206",80,3,186,3,186,0,0,85327.432327,9.102343999998993,163.47437539167544,0
"147.32.84.165",4239,"46.4.36.120",443,6,366,3,186,3,180,85327.757284,1.0063569999911124,1478.600536403226,1430.9037449063476
"147.32.84.165",4240,"193.23.181.44",179,3,186,3,186,0,0,85328.535146,9.030197000000044,164.78045827793045,0
"147.32.84.165",4241,"67.19.72.206",80,4,246,3,186,1,60,85328.635213,9.203530999991926,161.67707806941763,52.153896151425045
"147.32.84.165",4242,"67.19.72.206",80,3,186,3,186,0,0,85329.739211,9.030745000010938,164.77045913689267,0
"147.32.84.165",4243,"46.4.36.120",443,6,366,3,186,3,180,85329.762887,1.00669100000232,1478.1099662126421,1430.4289995606214
"147.32.84.165",4244,"67.19.72.206",80,3,186,3,186,0,0,85330.039618,9.030610000001616,164.7729223164032,0
"147.32.84.165",4245,"174.128.246.102",80,9,770,5,528,4,242,85330.139875,3.3911060000100406,1245.6113138272567,570.9051855041594
"147.32.84.165",4246,"193.23.181.44",80,3,186,3,186,0,0,85330.742709,9.03016999999818,164.78095096773373,0
"147.32.84.165",4247,"193.23.181.44",80,3,186,3,186,0,0,85330.742986,9.029915999999503,164.78558604532776,0
"147.32.84.165",4248,"174.128.246.102",80,3,186,3,186,0,0,85330.843021,9.03063100000145,164.7725391503386,0
"147.32.84.165",4249,"193.23.181.44",80,3,186,3,186,0,0,85330.843331,9.030379999996512,164.77711901388145,0
"147.32.84.165",4250,"193.23.181.44",179,3,186,3,186,0,0,85330.84355,9.03018199998769,164.7807319943306,0
"147.32.84.165",4251,"174.128.246.102",80,8,631,4,389,4,242,85330.942727,0.32738099999551196,9505.744072022086,5913.599139921194
"147.32.84.165",4252,"72.20.15.61",80,3,186,3,186,0,0,85330.943238,9.030056999996305,164.78301299765982,0
"147.32.84.165",4253,"193.23.181.44",80,3,186,3,186,0,0,85330.943466,9.029949999996461,164.7849655868065,0
"147.32.84.165",4254,"193.23.181.44",80,3,186,3,186,0,0,85331.107691,8.966599000006681,165.94920772066322,0
"147.32.84.165",4255,"184.82.148.43",80,10,1919,5,979,5,940,85331.21837,0.34067799999320414,22989.450449269494,22073.629644855286
"147.32.84.165",4256,"193.23.181.44",179,3,186,3,186,0,0,85331.244042,9.030945999998949,164.7667918732072,0
"147.32.84.165",4257,"67.19.72.206",80,3,186,3,186,0,0,85331.24421,9.030799999993178,164.76945564082075,0
"147.32.84.165",4258,"174.128.246.102",80,8,661,4,419,4,242,85331.344099,0.3169480000069598,10575.867334472514,6108.257505828994
"147.32.84.165",4259,"184.82.148.44",80,10,1513,5,596,5,917,85331.451433,0.3426350000081584,13915.682869194537,21410.538911160053
"147.32.84.165",4260,"72.20.15.61",80,3,186,3,186,0,0,85331.503104,8.972979999991367,165.8311954335607,0
"147.32.84.165",4261,"217.163.21.36",80,14,6137,7,809,7,5328,85331.694103,0.1978030000027502,32719.42285966348,215487.1260769926
"147.32.84.165",4262,"46.4.36.120",443,6,366,3,186,3,180,85331.771157,1.0054070000041975,1479.997652685716,1432.2557929216607
"147.32.84.165",4263,"217.163.21.36",80,10,1448,5,699,5,749,85331.854666,0.13940899999579415,40112.18788004151,42981.44309320613
"147.32.84.165",4264,"193.23.181.44",80,3,186,3,186,0,0,85331.85556,9.020226000007824,164.9626073669007,0
"147.32.84.165",4265,"67.19.72.206",80,3,186,3,186,0,0,85331.856233,9.019668000008096,164.97281274639647,0
"147.32.84.165",4266,"72.20.15.61",80,3,186,3,186,0,0,85331.856455,9.019470999992336,164.97641602276502,0
"147.32.84.165",4267,"174.37.196.55",80,3,186,3,186,0,0,85331.856676,9.019278000007034,164.97994628825495,0
"147.32.84.165",4268,"72.20.15.61",80,3,186,3,186,0,0,85331.946509,9.030211999997846,164.78018456270516,0
"147.32.84.165",4269,"72.20.15.61",80,3,186,3,186,0,0,85331.94666,9.03012700000545,164.7817356277605,0
"147.32.84.165",4270,"217.163.21.35",80,11,3707,6,2079,5,1628,85331.948712,0.22681600000942126,73328.16026783452,57420.993225605875
"147.32.84.165",4271,"67.19.72.206",80,3,186,3,186,0,0,85332.045844,9.031212000001688,164.76193892909635,0
"147.32.84.165",4272,"217.163.21.36",80,10,2274,5,1154,5,1120,85332.132932,0.13969200001156423,66088.25129023666,64141.1104376647
"147.32.84.165",4273,"217.163.21.35",80,13,5595,7,2594,6,3001,85332.227167,0.26206599999568425,79186.15921310565,91610.51033096765
"147.32.84.165",4274,"173.241.240.4",80,9,2194,5,1164,4,1030,85332.446083,0.06945799999812152,134066.63019741199,118632.84287228037
"147.32.84.165",4275,"174.37.196.55",80,3,186,3,186,0,0,85332.949432,9.030396000001929,164.77682706269826,0
"147.32.84.165",4276,"67.19.72.206",80,3,186,3,186,0,0,85332.949652,9.030271000010544,164.7791079579187,0
"147.32.84.165",4277,"174.128.246.102",80,8,656,4,414,4,242,85332.949799,0.3262749999994412,10150.946287658178,5933.644931433042
"147.32.84.165",4278,"72.20.15.61",80,8,648,4,406,4,242,85332.949942,0.3690999999962514,8799.783256659406,5245.191005200926
"147.32.84.165",4279,"193.23.181.44",80,3,186,3,186,0,0,85333.049268,9.031246999991708,164.76130040528912,0
"147.32.84.165",4280,"67.19.72.206",80,3,186,3,186,0,0,85333.113616,8.96701999999641,165.94141643495786,0
"147.32.84.165",4281,"72.20.15.61",80,3,186,3,186,0,0,85333.135873,8.944811999986996,166.3534124587709,0
"147.32.84.165",4282,"193.23.181.44",80,3,186,3,186,0,0,85333.151447,9.0288040000014,164.8058812661975,0
"147.32.84.165",4283,"193.23.181.44",179,3,186,3,186,0,0,85333.152253,9.028046000006725,164.81971846387265,0
"147.32.84.165",4284,"193.23.181.44",179,3,186,3,186,0,0,85333.152617,9.027730000001611,164.82548769178237,0
"147.32.84.165",4285,"193.23.181.44",80,3,186,3,186,0,0,85333.152735,9.027658999999403,164.82678399794437,0
"147.32.84.165",4286,"174.128.246.102",80,3,186,3,186,0,0,85333.152852,9.02759500000684,164.8279525165753,0
"147.32.84.165",4287,"193.23.181.44",80,3,186,3,186,0,0,85333.152968,9.02752600000531,164.82921234445902,0
"147.32.84.165",4288,"174.128.246.102",80,3,186,3,186,0,0,85333.153084,9.027456999989226,164.83047219186707,0
"147.32.84.165",4289,"193.23.181.44",179,3,186,3,186,0,0,85333.153235,9.02735199999006,164.83238938745697,0
"147.32.84.165",4290,"193.23.181.44",179,3,186,3,186,0,0,85333.15335,9.027285000003758,164.83361276390195,0
"147.32.84.165",4291,"193.23.181.44",80,3,186,3,186,0,0,85333.153467,9.027215000009164,164.834890937957,0
"147.32.84.165",4292,"174.37.196.55",80,3,186,3,186,0,0,85333.15358,9.027163999999175,164.83582219179092,0
"147.32.84.165",4293,"174.37.196.55",80,3,186,3,186,0,0,85333.153692,9.02709999999206,164.83699083884179,0
"147.32.84.165",4294,"72.20.15.61",80,3,186,3,186,0,0,85333.153812,9.027029999997467,164.838269065287,0
"147.32.84.165",4295,"193.23.181.44",80,3,186,3,186,0,0,85333.153931,9.026958000002196,164.83958383318478,0
"147.32.84.165",4296,"174.37.196.55",80,3,186,3,186,0,0,85333.154047,9.026889000000665,164.84084383887853,0
"147.32.84.165",4297,"193.23.181.44",179,3,186,3,186,0,0,85333.154163,9.026819000006071,164.84212212508075,0
"147.32.84.165",4298,"67.19.72.206",80,3,186,3,186,0,0,85333.154278,9.02675000000454,164.84338216957948,0
"147.32.84.165",4299,"193.23.181.44",179,3,186,3,186,0,0,85333.154392,9.026683000003686,164.84460570947184,0
"147.32.84.165",4300,"174.128.246.102",80,3,186,3,186,0,0,85333.154511,9.026612000001478,164.84590231636813,0
"147.32.84.165",4301,"193.23.181.44",80,3,186,3,186,0,0,85333.154627,9.026544000007561,164.84714415603065,0
"147.32.84.165",4302,"174.128.246.102",80,7,640,5,518,2,122,85333.154746,3.4245240000018384,1210.0951840307662,285.0031128412229
"147.32.84.165",4303,"174.37.196.55",80,3,186,3,186,0,0,85333.15486,9.026359000010416,164.85052278535375,0
"147.32.84.165",4304,"193.23.181.44",179,3,186,3,186,0,0,85333.154977,9.026287000000593,164.85183774899937,0
"147.32.84.165",4305,"174.37.196.55",80,3,186,3,186,0,0,85333.155096,9.026218999992125,164.85307967835683,0
"147.32.84.165",4306,"193.23.181.44",80,3,186,3,186,0,0,85333.158289,9.023073000003933,164.91055763367442,0
"147.32.84.165",4307,"193.23.181.44",179,3,186,3,186,0,0,85333.161517,9.019895000004908,164.96866094330258,0
"147.32.84.165",4308,"174.37.196.55",80,3,186,3,186,0,0,85333.164713,9.01868100000138,164.99086728977025,0
"147.32.84.165",4309,"174.128.246.102",80,3,186,3,186,0,0,85333.167937,9.018596999987494,164.9924040293699,0
"147.32.84.165",4310,"193.23.181.44",80,3,186,3,186,0,0,85333.171108,9.018642000010004,164.99158077217717,0
"147.32.84.165",4311,"174.128.246.102",80,3,186,3,186,0,0,85333.174298,9.018634000007296,164.9917271283873,0
"147.32.84.165",4312,"193.23.181.44",179,3,186,3,186,0,0,85333.17751,9.01864100000239,164.99159906682235,0
"147.32.84.165",4313,"193.23.181.44",80,3,186,3,186,0,0,85333.180691,9.018660000001546,164.99125147191987,0
"147.32.84.165",4314,"193.23.181.44",179,3,186,3,186,0,0,85333.183909,9.018637999994098,164.991653950516,0
"147.32.84.165",4315,"174.37.196.55",80,3,186,3,186,0,0,85333.187137,9.018610999992234,164.99214790407098,0
"147.32.84.165",4316,"193.23.181.44",80,3,186,3,186,0,0,85333.19029,9.018659000008483,164.9912697662258,0
"147.32.84.165",4317,"193.23.181.44",179,3,186,3,186,0,0,85333.19351,9.018641999995452,164.99158077244337,0
"147.32.84.165",4318,"72.20.15.61",80,3,186,3,186,0,0,85333.196743,9.018637000001036,164.9916722449112,0
"147.32.84.165",4319,"193.23.181.44",179,3,186,3,186,0,0,85333.250365,9.030819000006886,164.7691089810199,0
"147.32.84.165",4320,"193.23.181.44",80,3,186,3,186,0,0,85333.253067,9.028141000002506,164.81798412315302,0
"147.32.84.165",4321,"72.20.15.61",80,3,186,3,186,0,0,85333.253416,9.027814999994007,164.82393580295872,0
"147.32.84.165",4322,"193.23.181.44",80,3,186,3,186,0,0,85333.25377,9.027482000004966,164.8300157230091,0
"147.32.84.165",4323,"72.20.15.61",80,3,186,3,186,0,0,85333.254118,9.027155000003404,164.83598653168568,0
"147.32.84.165",4324,"174.128.246.102",80,3,186,3,186,0,0,85333.254475,9.026819999999134,164.84210386383498,0
"147.32.84.165",4326,"193.23.181.44",179,3,186,3,186,0,0,85333.257412,9.023905999987619,164.8953346812391,0
"147.32.84.165",4325,"174.37.196.55",80,3,186,3,186,0,0,85333.257732,9.02360800000315,164.90078026433335,0
"147.32.84.165",4327,"67.19.72.206",80,3,186,3,186,0,0,85333.258744,9.02261699999508,164.91889215743186,0
"147.32.84.165",4328,"174.37.196.55",80,3,186,3,186,0,0,85333.259103,9.022279999990133,164.92505220427955,0
"147.32.84.165",4329,"193.23.181.44",179,3,186,3,186,0,0,85333.259323,9.022080999988248,164.928689955448,0
"147.32.84.165",4330,"193.23.181.44",80,3,186,3,186,0,0,85333.259541,9.021884999994654,164.93227302286402,0
"147.32.84.165",4331,"67.19.72.206",80,3,186,3,186,0,0,85333.259809,9.021638000005623,164.9367886407183,0
"147.32.84.165",4332,"67.19.72.206",80,3,186,3,186,0,0,85333.260025,9.021443999998155,164.94033549399677,0
"147.32.84.165",4333,"193.23.181.44",80,3,186,3,186,0,0,85333.260241,9.021248000004562,164.94391906743363,0
"147.32.84.165",4334,"193.23.181.44",80,3,186,3,186,0,0,85333.260508,9.022021999990102,164.92976851548715,0
"147.32.84.165",4335,"67.19.72.206",80,3,186,3,186,0,0,85333.260723,9.025007999996888,164.8752001106828,0
"147.32.84.165",4336,"67.19.72.206",80,3,186,3,186,0,0,85333.260936,9.028025999999954,164.8200835930255,0
"147.32.84.165",4337,"67.19.72.206",80,3,186,3,186,0,0,85333.263891,9.028269000002183,164.81564738485753,0
"147.32.84.165",4338,"174.128.246.102",80,3,186,3,186,0,0,85333.267094,9.028264000007766,164.81573866235192,0
"147.32.84.165",4339,"193.23.181.44",179,3,186,3,186,0,0,85333.270294,9.028235999998287,164.81624981893276,0
"147.32.84.165",4340,"193.23.181.44",80,3,186,3,186,0,0,85333.273493,9.028267999994569,164.8156656405077,0
"147.32.84.165",4341,"193.23.181.44",179,3,186,3,186,0,0,85333.276693,9.028267999994569,164.8156656405077,0
"147.32.84.165",4342,"72.20.15.61",80,3,186,3,186,0,0,85333.279951,9.028206999995746,164.81677923431542,0
"147.32.84.165",4343,"72.20.15.61",80,3,186,3,186,0,0,85333.283121,9.028239000006579,164.81619505187177,0
"147.32.84.165",4344,"174.128.246.102",80,3,186,3,186,0,0,85333.286299,9.028279999998631,164.81544657456632,0
"147.32.84.165",4345,"72.20.15.61",80,3,186,3,186,0,0,85333.28949,9.028241000007256,164.81615854060655,0
"147.32.84.165",4346,"193.23.181.44",179,3,186,3,186,0,0,85333.29269,9.028269999995246,164.81562912947703,0
"147.32.84.165",4347,"193.23.181.44",179,3,186,3,186,0,0,85333.29589,9.028292000002693,164.8152275092073,0
"147.32.84.165",4348,"193.23.181.44",80,3,186,3,186,0,0,85333.299093,9.028323999998975,164.81464333802919,0
"147.32.84.165",4349,"193.23.181.44",80,3,186,3,186,0,0,85333.30229,9.028240999992704,164.81615854087218,0
"147.32.84.165",4350,"193.23.181.44",80,3,186,3,186,0,0,85333.30549,9.028241000007256,164.81615854060655,0
"147.32.84.165",4351,"174.37.196.55",80,3,186,3,186,0,0,85333.30869,9.028240999992704,164.81615854087218,0
"147.32.84.165",4352,"193.23.181.44",80,3,186,3,186,0,0,85333.31189,9.028241000007256,164.81615854060655,0
"147.32.84.165",4353,"193.23.181.44",80,3,186,3,186,0,0,85333.31509,9.028260999999475,164.81579342910962,0
"147.32.84.165",4354,"174.128.246.102",80,3,186,3,186,0,0,85333.318289,9.028242999993381,164.81612202962313,0
"147.32.84.165",4355,"193.23.181.44",179,3,186,3,186,0,0,85333.321522,9.02823100000387,164.81634109709444,0
"147.32.84.165",4356,"174.37.196.55",80,3,186,3,186,0,0,85333.324739,9.028242000000319,164.81614028511282,0
"147.32.84.165",4357,"174.128.246.102",80,3,186,3,186,0,0,85333.32792,9.02823399999761,164.81628633023843,0
"147.32.84.165",4358,"67.19.72.206",80,3,186,3,186,0,0,85333.331118,9.02823699999135,164.81623156341882,0
"147.32.84.165",4359,"193.23.181.44",179,3,186,3,186,0,0,85333.334341,9.028212000004714,164.81668795540278,0
"147.32.84.165",4360,"193.23.181.44",179,3,186,3,186,0,0,85333.337542,9.028239999999641,164.81617679636994,0
"147.32.84.165",4361,"72.20.15.61",80,3,186,3,186,0,0,85333.34069,9.028242000000319,164.81614028511282,0
"147.32.84.165",4362,"193.23.181.44",179,3,186,3,186,0,0,85333.34389,9.028260999999475,164.81579342910962,0
"147.32.84.165",4363,"174.128.246.102",80,3,186,3,186,0,0,85333.34709,9.028279000005568,164.81546482990638,0
"147.32.84.165",4364,"174.128.246.102",80,3,186,3,186,0,0,85333.350289,9.028275000004214,164.8155378518383,0
"147.32.84.165",4365,"72.20.15.61",80,3,186,3,186,0,0,85333.353513,9.028221000000485,164.81652365398676,0
"147.32.84.165",4366,"193.23.181.44",179,3,186,3,186,0,0,85333.377511,9.007421000002068,165.19711913095418,0
"147.32.84.165",4367,"72.20.15.61",80,3,186,3,186,0,0,85333.380711,9.007420999987517,165.19711913122106,0
"147.32.84.165",4368,"193.23.181.44",80,3,186,3,186,0,0,85333.383942,9.00738999999885,165.19768767647344,0
"147.32.84.165",4369,"193.23.181.44",179,3,186,3,186,0,0,85333.390312,9.017040999999153,165.02087547346628,0
"147.32.84.165",4370,"193.23.181.44",80,3,186,3,186,0,0,85333.393492,9.017056999990018,165.0205826581386,0
"147.32.84.165",4371,"193.23.181.44",80,3,186,3,186,0,0,85333.396692,9.017063999999664,165.02045455150983,0
"147.32.84.165",4373,"72.20.15.61",80,3,186,3,186,0,0,85333.39991,9.017043000014382,165.02083887119386,0
"147.32.84.165",4374,"193.23.181.44",179,3,186,3,186,0,0,85333.403097,9.017051999995601,165.02067416276694,0
"147.32.84.165",4372,"193.23.181.44",179,3,186,3,186,0,0,85333.406342,9.016988999996101,165.02182713105708,0
"147.32.84.165",4375,"174.37.196.55",80,3,186,3,186,0,0,85333.450851,9.030794000005699,164.76956511233243,0
"147.32.84.165",4376,"67.19.72.206",80,3,186,3,186,0,0,85333.452118,9.029548000005889,164.79230189584567,0
"147.32.84.165",4377,"67.19.72.206",80,3,186,3,186,0,0,85333.452462,9.029232000000775,164.7980692045428,0
"147.32.84.165",4378,"67.19.72.206",80,3,186,3,186,0,0,85333.452845,9.028871999995317,164.80464004814462,0
"147.32.84.165",4379,"193.23.181.44",179,3,186,3,186,0,0,85333.453067,9.02867200000037,164.80829074308372,0
"147.32.84.165",4380,"193.23.181.44",80,3,186,3,186,0,0,85333.453283,9.028478000007453,164.8118320716705,0
"147.32.84.165",4381,"193.23.181.44",179,3,186,3,186,0,0,85333.453501,9.028283999999985,164.81537355271527,0
"147.32.84.165",4382,"67.19.72.206",80,3,186,3,186,0,0,85333.453714,9.028093999993871,164.81884216103757,0
"147.32.84.165",4383,"174.128.246.102",80,3,186,3,186,0,0,85333.453928,9.027906000002986,164.8222744011189,0
"147.32.84.165",4384,"193.23.181.44",179,3,186,3,186,0,0,85333.551863,9.029739000005065,164.7888161550589,0
"147.32.84.165",4385,"174.37.196.55",80,3,186,3,186,0,0,85333.552293,9.02943100000266,164.79443721310474,0
"147.32.84.165",4386,"67.19.72.206",80,3,186,3,186,0,0,85333.55264,9.029132000010577,164.7998943861112,0
"147.32.84.165",4387,"174.128.246.102",80,3,186,3,186,0,0,85333.5528,9.029022999995505,164.80188388054177,0
"147.32.84.165",4388,"174.37.196.55",80,3,186,3,186,0,0,85333.552937,9.028934000001755,164.80350836540734,0
"147.32.84.165",4389,"174.37.196.55",80,3,186,3,186,0,0,85333.553046,9.028875000003609,164.80458528879902,0
"147.32.84.165",4390,"67.19.72.206",80,3,186,3,186,0,0,85333.553159,9.028810999996495,164.80575349296578,0
"147.32.84.165",4391,"174.37.196.55",80,3,186,3,186,0,0,85333.553269,9.028749999997672,164.8068669528322,0
"147.32.84.165",4392,"174.37.196.55",80,3,186,3,186,0,0,85333.553375,9.028693000000203,164.80790741250883,0
"147.32.84.165",4393,"174.37.196.55",80,3,186,3,186,0,0,85333.553481,9.028636000002734,164.8089478853228,0
"147.32.84.165",4394,"193.23.181.44",80,3,186,3,186,0,0,85333.553599,9.028566999986651,164.81020742297198,0
"147.32.84.165",4395,"193.23.181.44",179,3,186,3,186,0,0,85333.553707,9.028508000003058,164.81128443365128,0
"147.32.84.165",4396,"72.20.15.61",80,3,186,3,186,0,0,85333.553814,9.028447000004235,164.81239796825545,0
"147.32.84.165",4397,"67.19.72.206",80,3,186,3,186,0,0,85333.55392,9.028387999991537,164.8134750080961,0
"147.32.84.165",4399,"193.23.181.44",80,3,186,3,186,0,0,85333.557101,9.02525500000047,164.8706878642124,0
"147.32.84.165",4400,"67.19.72.206",80,3,186,3,186,0,0,85333.557212,9.025192999994033,164.87182046976545,0
"147.32.84.165",4401,"72.20.15.61",80,3,186,3,186,0,0,85333.557322,9.02512900000147,164.87298962704662,0
"147.32.84.165",4402,"67.19.72.206",80,3,186,3,186,0,0,85333.557431,9.025068000002648,164.87410399562236,0
"147.32.84.165",4398,"193.23.181.44",179,3,186,3,186,0,0,85333.557545,9.025003999995533,164.8752731855561,0
"147.32.84.165",4403,"193.23.181.44",80,3,186,3,186,0,0,85333.5584,9.02419200001168,164.8901087208776,0
"147.32.84.165",4404,"193.23.181.44",80,3,186,3,186,0,0,85333.558534,9.024101000002702,164.89177149054012,0
"147.32.84.165",4405,"193.23.181.44",80,3,186,3,186,0,0,85333.558643,9.024034000001848,164.89299574887409,0
"147.32.84.165",4406,"174.37.196.55",80,7,599,4,417,3,182,85333.651933,0.24280399999406654,13739.477109444337,5996.606316352204
"147.32.84.165",4407,"72.20.15.61",80,3,186,3,186,0,0,85333.65213,9.030018999997992,164.78370643520583,0
"147.32.84.165",4408,"174.37.196.55",80,3,186,3,186,0,0,85333.751814,9.030153999992763,164.78124293353054,0
"147.32.84.165",4409,"174.37.196.55",80,3,186,3,186,0,0,85333.753614,9.02839700000186,164.81331071282017,0
"147.32.84.165",4410,"174.128.246.102",80,3,186,3,186,0,0,85333.754823,9.027236000008998,164.8345074836325,0
"147.32.84.165",4411,"72.20.15.61",80,3,186,3,186,0,0,85333.755301,9.02680400000827,164.84239604611298,0
"147.32.84.165",4412,"193.23.181.44",80,3,186,3,186,0,0,85333.755492,9.026660000003176,164.8450257348207,0
"147.32.84.165",4413,"193.23.181.44",179,3,186,3,186,0,0,85333.755815,9.026383999997051,164.85006620596752,0
"147.32.84.165",4414,"193.23.181.44",179,3,186,3,186,0,0,85333.756004,9.026240999999573,164.8526778755487,0
"147.32.84.165",4415,"193.23.181.44",80,3,186,3,186,0,0,85333.75619,9.02610299999651,164.8551983065754,0
"147.32.84.165",4416,"193.23.181.44",80,3,186,3,186,0,0,85333.756425,9.025913000004948,164.8586685911092,0
"147.32.84.165",4417,"72.20.15.61",80,3,186,3,186,0,0,85333.756613,9.025775999994949,164.86117093985413,0
"147.32.84.165",4418,"174.128.246.102",80,3,186,3,186,0,0,85333.756798,9.0256389999995,164.86367336429944,0
"147.32.84.165",4419,"193.23.181.44",179,3,186,3,186,0,0,85333.756989,9.025490999993053,164.86637679890714,0
"147.32.84.165",4420,"193.23.181.44",179,3,186,3,186,0,0,85333.757175,9.025352999989991,164.8688976488399,0
"147.32.84.165",4421,"174.128.246.102",80,3,186,3,186,0,0,85333.75736,9.025213999993866,164.87143684360407,0
"147.32.84.165",4422,"193.23.181.44",80,3,186,3,186,0,0,85333.757547,9.025078999999096,164.8739030428597,0
"147.32.84.165",4423,"72.20.15.61",80,3,186,3,186,0,0,85333.757734,9.024938999995356,164.87646066092697,0
"147.32.84.165",4424,"174.128.246.102",80,3,186,3,186,0,0,85333.757919,9.024797000005492,164.87905489720094,0
"147.32.84.165",4425,"174.37.196.55",80,3,186,3,186,0,0,85333.758148,9.0246160000097,164.88236175349738,0
"147.32.84.165",4426,"193.23.181.44",179,3,186,3,186,0,0,85333.758375,9.02443599999242,164.8856504718134,0
"147.32.84.165",4427,"174.37.196.55",80,3,186,3,186,0,0,85333.758562,9.024294999995618,164.8882267258243,0
"147.32.84.165",4428,"193.23.181.44",80,3,186,3,186,0,0,85333.758749,9.02415500000643,164.8907847880427,0
"147.32.84.165",4429,"193.23.181.44",179,3,186,3,186,0,0,85333.758936,9.024015000002692,164.8933429298994,0
"147.32.84.165",4430,"193.23.181.44",179,3,186,3,186,0,0,85333.759275,9.023721999998088,164.8986970121991,0
"147.32.84.165",4431,"174.128.246.102",80,3,186,3,186,0,0,85333.759587,9.023457000002963,164.90353974086776,0
"147.32.84.165",4432,"174.37.196.55",80,3,186,3,186,0,0,85333.759808,9.025194000001648,164.87180220167326,0
"147.32.84.165",4433,"193.23.181.44",179,3,186,3,186,0,0,85333.76083,9.02737199999683,164.8320242037796,0
"147.32.84.165",4435,"67.19.72.206",80,3,186,3,186,0,0,85333.76403,9.027386999994633,164.83175031721635,0
"147.32.84.165",4434,"72.20.15.61",80,3,186,3,186,0,0,85333.76723,9.027371000003768,164.8320424627922,0
"147.32.84.165",4436,"193.23.181.44",179,3,186,3,186,0,0,85333.788846,9.008977000004961,165.1685868438981,0
"147.32.84.165",4459,"46.4.36.120",443,6,366,3,186,3,180,85333.792044,0.9899230000009993,1503.1472144788008,1454.658594656904
"147.32.84.165",4498,"72.20.15.61",80,3,186,3,186,0,0,85333.853417,9.029775999995763,164.78814092406037,0
"147.32.84.165",4510,"67.19.72.206",80,3,186,3,186,0,0,85333.853885,9.029366999995545,164.79560527340777,0
"147.32.84.165",4516,"193.23.181.44",179,3,186,3,186,0,0,85333.853997,9.029277000008733,164.7972478858009,0
"147.32.84.165",4517,"67.19.72.206",80,3,186,3,186,0,0,85333.854173,9.029125999993994,164.80000389860433,0
"147.32.84.165",4532,"174.37.196.55",80,3,186,3,186,0,0,85333.854305,9.029016999993473,164.80199339541343,0
"147.32.84.165",4544,"193.23.181.44",179,3,186,3,186,0,0,85333.854501,9.028849000009359,164.80505986958664,0
"147.32.84.165",4594,"193.23.181.44",80,3,186,3,186,0,0,85333.854615,9.02876099999412,164.80666616393646,0
"147.32.84.165",4598,"193.23.181.44",80,3,186,3,186,0,0,85333.854722,9.02867499999411,164.80823598157767,0
"147.32.84.165",4601,"193.23.181.44",80,3,186,3,186,0,0,85333.85483,9.028589000008651,164.80980582885923,0
"147.32.84.165",4603,"67.19.72.206",80,3,186,3,186,0,0,85333.854936,9.028506999995443,164.81130268833496,0
"147.32.84.165",4666,"193.23.181.44",179,3,186,3,186,0,0,85333.855042,9.028422000003047,164.8128543392741,0
"147.32.84.165",4703,"72.20.15.61",80,3,186,3,186,0,0,85333.855151,9.028338999996777,164.81436950922327,0
"147.32.84.165",4704,"174.37.196.55",80,3,186,3,186,0,0,85333.855262,9.028252000003704,164.81595772906977,0
"147.32.84.165",4716,"193.23.181.44",179,3,186,3,186,0,0,85333.858141,9.025399999998626,164.86803908970532,0
"147.32.84.165",4717,"72.20.15.61",80,3,186,3,186,0,0,85333.858261,9.025301999994554,164.86982928669843,0
"147.32.84.165",4718,"72.20.15.61",80,3,186,3,186,0,0,85333.858395,9.025188999992679,164.87189354164295,0
"147.32.84.165",4714,"67.19.72.206",80,3,186,3,186,0,0,85333.858499,9.025107000008575,164.8733915286086,0
"147.32.84.165",4719,"72.20.15.61",80,8,661,5,479,3,182,85333.87885,3.398964000007254,1127.4023496547247,428.3658197017952
"147.32.84.165",4720,"174.128.246.102",80,3,186,3,186,0,0,85334.053218,9.030541999993147,164.77416305700467,0
"147.32.84.165",4724,"72.20.15.61",80,3,186,3,186,0,0,85334.0539,9.029922000001534,164.78547655226117,0
"147.32.84.165",4723,"193.23.181.44",80,3,186,3,186,0,0,85334.054015,9.029829999999492,164.78715546140776,0
"147.32.84.165",4731,"193.23.181.44",179,3,186,3,186,0,0,85334.054147,9.029725000000326,164.7890716494629,0
"147.32.84.165",4747,"174.37.196.55",80,3,186,3,186,0,0,85334.054351,9.029544000004535,164.79237489725426,0
"147.32.84.165",4749,"174.37.196.55",80,3,186,3,186,0,0,85334.054556,9.029362000001129,164.79569652870424,0
"147.32.84.165",4750,"174.128.246.102",80,3,186,3,186,0,0,85334.054695,9.029244000004837,164.79785018537575,0
"147.32.84.165",4767,"174.128.246.102",80,3,186,3,186,0,0,85334.054832,9.029131000002963,164.79991263827182,0
"147.32.84.165",4768,"72.20.15.61",80,3,186,3,186,0,0,85334.05497,9.029017000008025,164.80199339514783,0
"147.32.84.165",4769,"72.20.15.61",80,3,186,3,186,0,0,85334.05519,9.02882399999362,164.8055162002329,0
"147.32.84.165",4770,"174.128.246.102",80,3,186,3,186,0,0,85334.05532,9.028716000000713,164.8074875762935,0
"147.32.84.165",4773,"67.19.72.206",80,3,186,3,186,0,0,85334.055454,9.028605999992578,164.8094955080799,0
"147.32.84.165",4774,"174.37.196.55",80,3,186,3,186,0,0,85334.055588,9.028493999998318,164.81153999773133,0
"147.32.84.165",4775,"193.23.181.44",80,3,186,3,186,0,0,85334.055749,9.02835999999661,164.81398615037048,0
"147.32.84.165",4776,"193.23.181.44",179,3,186,3,186,0,0,85334.152883,9.030512999990606,164.774692202043,0
"147.32.84.165",4777,"174.37.196.55",80,3,186,3,186,0,0,85334.153511,9.029986000008648,164.78430863553663,0
"147.32.84.165",4779,"72.20.15.61",80,3,186,3,186,0,0,85334.15479,9.028730999998515,164.8072137712647,0
"147.32.84.165",4778,"174.128.246.102",80,39,2879,21,1793,18,1086,85334.155046,653.5124039999937,21.949086065090416,13.29431537461695
"147.32.84.165",4786,"193.23.181.44",80,3,186,3,186,0,0,85334.155762,9.027780000003986,164.8245748123396,0
"147.32.84.165",4788,"67.19.72.206",80,3,186,3,186,0,0,85334.156072,9.027491000000737,164.82985139501977,0
"147.32.84.165",4794,"174.128.246.102",80,37,2564,20,1540,17,1024,85334.156296,653.5112930000032,18.85200781067442,12.535361037747148
"147.32.84.165",4796,"174.37.196.55",80,3,186,3,186,0,0,85334.156512,9.02707699999155,164.83741082538597,0
"147.32.84.165",4797,"67.19.72.206",80,3,186,3,186,0,0,85334.156806,9.026805999994394,164.84235952350411,0
"147.32.84.165",4798,"67.19.72.206",80,3,186,3,186,0,0,85334.157023,9.026609999986249,164.8459388410784,0
"147.32.84.165",4799,"72.20.15.61",80,3,186,3,186,0,0,85334.157237,9.026418999987072,164.8494269989163,0
"147.32.84.165",4801,"67.19.72.206",80,3,186,3,186,0,0,85334.157454,9.02622600000177,164.85295183166343,0
"147.32.84.165",4802,"193.23.181.44",80,3,186,3,186,0,0,85334.157667,9.02603399999498,164.85645855099014,0
"147.32.84.165",4803,"193.23.181.44",80,3,186,3,186,0,0,85334.157881,9.025840999995125,164.8599836847119,0
"147.32.84.165",4804,"72.20.15.61",80,3,186,3,186,0,0,85334.158209,9.025536999994074,164.86553653272674,0
"147.32.84.165",4805,"174.128.246.102",80,7,565,4,383,3,182,85334.158447,0.31538900001032744,9714.986888888545,4616.521184798212
"147.32.84.165",4806,"174.37.196.55",80,3,186,3,186,0,0,85334.253786,9.030415000001085,164.7764803721447,0
"147.32.84.165",4808,"174.37.196.55",80,3,186,3,186,0,0,85334.254604,9.029657999999472,164.79029438325205,0
"147.32.84.165",4807,"193.23.181.44",179,3,186,3,186,0,0,85334.254719,9.029563999996753,164.79200989112377,0
"147.32.84.165",4809,"174.128.246.102",80,3,186,3,186,0,0,85334.254879,9.029427999994368,164.7944919657068,0
"147.32.84.165",4812,"193.23.181.44",179,3,186,3,186,0,0,85334.255027,9.029303999996046,164.79675509880403,0
"147.32.84.165",4813,"67.19.72.206",80,3,186,3,186,0,0,85334.255177,9.029183000006014,164.7989635384518,0
"147.32.84.165",4816,"174.128.246.102",80,3,186,3,186,0,0,85334.255324,9.029058000000077,164.80124504682408,0
"147.32.84.165",4817,"67.19.72.206",80,3,186,3,186,0,0,85334.255494,9.028911000001244,164.80392818134933,0
"147.32.84.165",4819,"193.23.181.44",179,3,186,3,186,0,0,85334.255692,9.02873499999987,164.8071407567086,0
"147.32.84.165",4822,"193.23.181.44",80,3,186,3,186,0,0,85334.255883,9.028567999994266,164.81018916853094,0
"147.32.84.165",4827,"174.128.246.102",80,3,186,3,186,0,0,85334.256014,9.02846000000136,164.81216065638833,0
"147.32.84.165",4830,"67.19.72.206",80,3,186,3,186,0,0,85334.256152,9.02834299999813,164.8142964883266,0
"147.32.84.165",4834,"72.20.15.61",80,3,186,3,186,0,0,85334.256287,9.028228000010131,164.81639586398686,0
"147.32.84.165",4836,"174.37.196.55",80,3,186,3,186,0,0,85334.256423,9.028115000008256,164.81845878111204,0
"147.32.84.165",4842,"193.23.181.44",80,3,186,3,186,0,0,85334.256555,9.028005999993184,164.8204487237961,0
"147.32.84.165",4843,"193.23.181.44",80,3,186,3,186,0,0,85334.256692,9.0278959999996,164.8224569711554,0
"147.32.84.165",4845,"72.20.15.61",80,3,186,3,186,0,0,85334.256826,9.027784999998403,164.82448352505773,0
"147.32.84.165",4852,"193.23.181.44",179,3,186,3,186,0,0,85334.314489,8.97014200000558,165.8836615963353,0
"147.32.84.165",4861,"193.23.181.44",179,3,186,3,186,0,0,85334.316814,8.967839999997523,165.92624310875428,0
"147.32.84.165",4862,"72.20.15.61",80,3,186,3,186,0,0,85334.355216,9.028716000000713,164.8074875762935,0
"147.32.84.165",4868,"193.23.181.44",179,3,186,3,186,0,0,85334.356485,9.027566999997362,164.82846374891872,0
"147.32.84.165",1025,"174.128.246.102",80,3,186,3,186,0,0,85334.356983,9.02711699999054,164.83668041541495,0
"147.32.84.165",1026,"193.23.181.44",80,3,186,3,186,0,0,85334.357358,9.026785000009113,164.84274301409613,0
"147.32.84.165",1027,"193.23.181.44",179,3,186,3,186,0,0,85334.357579,9.026610999993864,164.84592057872123,0
"147.32.84.165",1028,"174.37.196.55",80,3,186,3,186,0,0,85334.357794,9.026445000010426,164.84895216203958,0
"147.32.84.165",1029,"72.20.15.61",80,3,186,3,186,0,0,85334.358057,9.02622899999551,164.85289704047395,0
"147.32.84.165",1030,"174.37.196.55",80,3,186,3,186,0,0,85334.35828,9.026052999994135,164.85611152526656,0
"147.32.84.165",1031,"174.128.246.102",80,3,186,3,186,0,0,85334.358495,9.025884000002407,164.85919827903874,0
"147.32.84.165",1032,"193.23.181.44",179,3,186,3,186,0,0,85334.358714,9.025710999994772,164.86235821209675,0
"147.32.84.165",1033,"174.37.196.55",80,3,186,3,186,0,0,85334.358929,9.025543000010657,164.86542693312114,0
"147.32.84.165",1035,"67.19.72.206",80,3,186,3,186,0,0,85334.359291,9.025227999998606,164.87118109373301,0
"147.32.84.165",1036,"193.23.181.44",179,3,186,3,186,0,0,85334.35951,9.02507100001094,164.8740491901057,0
"147.32.84.165",1037,"67.19.72.206",80,3,186,3,186,0,0,85334.359723,9.024907999992138,164.8770270014161,0
"147.32.84.165",1038,"72.20.15.61",80,3,186,3,186,0,0,85334.35994,9.024740000008023,164.88009626855478,0
"147.32.84.165",1040,"174.37.196.55",80,3,186,3,186,0,0,85334.360158,9.024568000008003,164.88323873216763,0
"147.32.84.165",1034,"67.19.72.206",80,3,186,3,186,0,0,85334.360369,9.024403999996139,164.88623514645806,0
"147.32.84.165",1041,"193.23.181.44",80,3,186,3,186,0,0,85334.360615,9.024205000008806,164.8898711851679,0
"147.32.84.165",1042,"193.23.181.44",179,3,186,3,186,0,0,85334.360833,9.024032999994233,164.89301402166313,0
"147.32.84.165",1043,"174.128.246.102",80,3,186,3,186,0,0,85334.361048,9.023864999995567,164.89608388431463,0
"147.32.84.165",1044,"174.128.246.102",80,3,186,3,186,0,0,85334.361265,9.023696000003838,164.89917213516136,0
"147.32.84.165",1045,"193.23.181.44",179,3,186,3,186,0,0,85334.361535,9.023474999994505,164.90321079195166,0
"147.32.84.165",1046,"67.19.72.206",80,3,186,3,186,0,0,85334.455561,9.029020000001765,164.8019386378266,0
"147.32.84.165",1047,"67.19.72.206",80,3,186,3,186,0,0,85334.455914,9.028767999989213,164.80653838948766,0
"147.32.84.165",1048,"193.23.181.44",179,3,186,3,186,0,0,85334.456299,9.02840599999763,164.81314641813742,0
"147.32.84.165",1049,"193.23.181.44",80,3,186,3,186,0,0,85334.456409,9.028316999989329,164.81477112531147,0
"147.32.84.165",1050,"174.37.196.55",80,3,186,3,186,0,0,85334.456517,9.028235000005225,164.81626807445076,0
"147.32.84.165",1051,"193.23.181.44",80,3,186,3,186,0,0,85334.456624,9.028151000005892,164.81780156302537,0
"147.32.84.165",1052,"72.20.15.61",80,3,186,3,186,0,0,85334.45673,9.028065999998944,164.81935333660323,0
"147.32.84.165",1053,"174.128.246.102",80,3,186,3,186,0,0,85334.456838,9.02798199999961,164.8208868825906,0
"147.32.84.165",1054,"174.37.196.55",80,3,186,3,186,0,0,85334.456945,9.027899000007892,164.82240219996913,0
"147.32.84.165",1055,"67.19.72.206",80,3,186,3,186,0,0,85334.457052,9.027813000007882,164.8239723174041,0
"147.32.84.165",1056,"193.23.181.44",80,3,186,3,186,0,0,85334.457157,9.027729000008549,164.82550594934685,0
"147.32.84.165",1057,"72.20.15.61",80,3,186,3,186,0,0,85334.457263,9.027648999996018,164.82696657797135,0
"147.32.84.165",1058,"67.19.72.206",80,3,186,3,186,0,0,85334.457368,9.027568999998039,164.8284272322176,0
"147.32.84.165",1059,"174.37.196.55",80,3,186,3,186,0,0,85334.457476,9.027484000005643,164.8299792056203,0
"147.32.84.165",1060,"67.19.72.206",80,3,186,3,186,0,0,85334.457583,9.02740000000631,164.83151294934976,0
"147.32.84.165",1061,"72.20.15.61",80,3,186,3,186,0,0,85334.457689,9.027315999992425,164.83304672188817,0
"147.32.84.165",1062,"67.19.72.206",80,3,186,3,186,0,0,85334.457822,9.027203999998164,164.83509179589856,0
"147.32.84.165",1063,"174.37.196.55",80,3,186,3,186,0,0,85334.45793,9.027119999998831,164.8366256347753,0
"147.32.84.165",1065,"67.19.72.206",80,3,186,3,186,0,0,85334.469309,9.015763000003062,165.04426746793305,0
"147.32.84.165",1064,"174.128.246.102",80,3,186,3,186,0,0,85334.46942,9.015672000008635,165.04593334790516,0
"147.32.84.165",1066,"174.128.246.102",80,3,186,3,186,0,0,85334.554497,9.030806999988272,164.769327924064,0
"147.32.84.165",1068,"174.37.196.55",80,3,186,3,186,0,0,85334.555253,9.030098999995971,164.78224657344995,0
"147.32.84.165",1067,"72.20.15.61",80,3,186,3,186,0,0,85334.555474,9.029921000008471,164.7854948009627,0
"147.32.84.165",1069,"174.37.196.55",80,3,186,3,186,0,0,85334.555742,9.029701000006753,164.78950964144738,0
"147.32.84.165",1071,"193.23.181.44",179,3,186,3,186,0,0,85334.556098,9.029391999996733,164.7951489979102,0
"147.32.84.165",1072,"193.23.181.44",80,3,186,3,186,0,0,85334.556353,9.029183999999077,164.798945286767,0
"147.32.84.165",1073,"72.20.15.61",80,3,186,3,186,0,0,85334.556722,9.02886099999887,164.80484083210345,0
"147.32.84.165",1074,"72.20.15.61",80,3,186,3,186,0,0,85334.557068,9.028560999999172,164.8103169486407,0
"147.32.84.165",1075,"77.123.72.98",6667,2,124,2,124,0,0,85334.605577,2.9597190000058617,335.16695334862374,0
"147.32.84.165",1076,"174.128.246.102",80,3,186,3,186,0,0,85334.654989,9.030107999991742,164.78208234069413,0
"147.32.84.165",1077,"193.23.181.44",80,3,186,3,186,0,0,85334.655172,9.030047000007471,164.78319548046304,0
"147.32.84.165",1078,"72.20.15.61",80,3,186,3,186,0,0,85334.755755,9.029939999993076,164.78514807419995,0
"147.32.84.165",1079,"193.23.181.44",80,3,186,3,186,0,0,85334.756555,9.02919899999688,164.79867151012115,0
"147.32.84.165",1080,"174.128.246.102",80,3,186,3,186,0,0,85334.756666,9.029108999995515,164.80031418390664,0
"147.32.84.165",1081,"174.128.246.102",80,3,186,3,186,0,0,85334.756847,9.028955000001588,164.80312505707894,0
"147.32.84.165",1082,"174.37.196.55",80,3,186,3,186,0,0,85334.756957,9.0288670000009,164.80473131344738,0
"147.32.84.165",1083,"193.23.181.44",80,3,186,3,186,0,0,85334.757065,9.02878100000089,164.80630109422893,0
"147.32.84.165",1084,"193.23.181.44",179,3,186,3,186,0,0,85334.757173,9.02869500000088,164.80787090491538,0
"147.32.84.165",1085,"174.37.196.55",80,3,186,3,186,0,0,85334.757284,9.028607999993255,164.80945899978286,0
"147.32.84.165",1086,"72.20.15.61",80,3,186,3,186,0,0,85334.757392,9.028523999993922,164.8109923616531,0
"147.32.84.165",1087,"67.19.72.206",80,3,186,3,186,0,0,85334.757499,9.028441000002204,164.8125074971013,0
"147.32.84.165",1088,"193.23.181.44",80,3,186,3,186,0,0,85334.757606,9.028359000003547,164.814004405387,0
"147.32.84.165",1089,"193.23.181.44",179,3,186,3,186,0,0,85334.757712,9.0282739999966,164.81555610746423,0
"147.32.84.165",1090,"72.20.15.61",80,3,186,3,186,0,0,85334.757825,9.02818200000911,164.81723562933252,0
"147.32.84.165",1091,"193.23.181.44",179,3,186,3,186,0,0,85334.757935,9.028095000001485,164.81882390468368,0
"147.32.84.165",1092,"72.20.15.61",80,3,186,3,186,0,0,85334.75808,9.02797300000384,164.82105119270594,0
"147.32.84.165",1093,"193.23.181.44",179,3,186,3,186,0,0,85334.758194,9.027882000009413,164.82271256962028,0
"147.32.84.165",1095,"193.23.181.44",80,3,186,3,186,0,0,85334.75833,9.027767999999924,164.8247939025474,0
"147.32.84.165",1096,"174.37.196.55",80,3,186,3,186,0,0,85334.758438,9.027682999992976,164.8263458077956,0
"147.32.84.165",1097,"174.37.196.55",80,3,186,3,186,0,0,85334.758544,9.027599000008195,164.82787948364225,0
"147.32.84.165",1094,"67.19.72.206",80,3,186,3,186,0,0,85334.758658,9.027507999999216,164.82954099848254,0
"147.32.84.165",1099,"193.23.181.44",179,3,186,3,186,0,0,85334.758766,9.027421999999206,164.83111125193116,0
"147.32.84.165",1098,"67.19.72.206",80,3,186,3,186,0,0,85334.758871,9.027342000001227,164.83257197963673,0
"147.32.84.165",1100,"193.23.181.44",80,3,186,3,186,0,0,85334.759069,9.027167999985977,164.83574915214953,0
"147.32.84.165",1101,"72.20.15.61",80,3,186,3,186,0,0,85334.75929,9.026969999991707,164.83936470392248,0
"147.32.84.165",1102,"72.20.15.61",80,3,186,3,186,0,0,85334.760864,9.025418999997783,164.86769201522563,0
"147.32.84.165",1103,"174.128.246.102",80,3,186,3,186,0,0,85334.764082,9.022224000000278,164.9260758766302,0
"147.32.84.165",1104,"193.23.181.44",179,3,186,3,186,0,0,85334.856928,9.02885500001139,164.80495035063947,0
"147.32.84.165",1105,"193.23.181.44",80,3,186,3,186,0,0,85334.857108,9.028732999999193,164.8071772639786,0
"147.32.84.165",1110,"67.19.72.206",80,3,186,3,186,0,0,85334.857786,9.02807600000233,164.81917077344232,0
"147.32.84.165",1111,"67.19.72.206",80,3,186,3,186,0,0,85334.858031,9.027858000001288,164.82315074071698,0
"147.32.84.165",1112,"67.19.72.206",80,3,186,3,186,0,0,85334.858174,9.02773800000432,164.8253416303495,0
"147.32.84.165",1113,"67.19.72.206",80,3,186,3,186,0,0,85334.858282,9.02765200000431,164.82691180378794,0
"147.32.84.165",1114,"174.128.246.102",80,3,186,3,186,0,0,85334.858389,9.027568999998039,164.8284272322176,0
"147.32.84.165",1115,"174.37.196.55",80,3,186,3,186,0,0,85334.858494,9.027488000006997,164.82990617089123,0
"147.32.84.165",1116,"193.23.181.44",179,3,186,3,186,0,0,85334.8586,9.027405999993789,164.83140339550738,0
"147.32.84.165",1117,"67.19.72.206",80,3,186,3,186,0,0,85334.858706,9.027319999993779,164.83297368444073,0
"147.32.84.165",1118,"72.20.15.61",80,3,186,3,186,0,0,85334.858812,9.027235000001383,164.83452574346097,0
"147.32.84.165",1119,"67.19.72.206",80,3,186,3,186,0,0,85334.858931,9.027138999997987,164.83627869254386,0
"147.32.84.165",1120,"174.128.246.102",80,3,186,3,186,0,0,85334.859139,9.02695300000778,164.83967513719386,0
"147.32.84.165",1121,"193.23.181.44",179,3,186,3,186,0,0,85334.859288,9.026829999987967,164.84192125053684,0
"147.32.84.165",1122,"174.128.246.102",80,3,186,3,186,0,0,85334.859403,9.026737000007415,164.84361957136645,0
"147.32.84.165",1123,"174.128.246.102",80,3,186,3,186,0,0,85334.859516,9.02664700000605,164.8452631413417,0
"147.32.84.165",1124,"174.37.196.55",80,3,186,3,186,0,0,85334.860371,9.025813999993261,164.86047685018892,0
"147.32.84.165",1125,"174.128.246.102",80,3,186,3,186,0,0,85334.956766,9.03019599999243,164.7804765257861,0
"147.32.84.165",1126,"193.23.181.44",179,3,186,3,186,0,0,85334.957182,9.029842000003555,164.7869364712488,0
"147.32.84.165",1127,"193.23.181.44",179,3,186,3,186,0,0,85334.958409,9.028638999996474,164.80889312338007,0
"147.32.84.165",1128,"193.23.181.44",80,3,186,3,186,0,0,85334.959006,9.02806499999133,164.81937159307438,0
"147.32.84.165",1129,"67.19.72.206",80,3,186,3,186,0,0,85334.959364,9.02773500001058,164.82539640322364,0
"147.32.84.165",1130,"193.23.181.44",80,3,186,3,186,0,0,85334.959586,9.027536000008695,164.82902975945672,0
"147.32.84.165",1131,"193.23.181.44",179,3,186,3,186,0,0,85334.95981,9.027335000006133,164.8326997944564,0
"147.32.84.165",1132,"174.37.196.55",80,3,186,3,186,0,0,85334.960079,9.02708800000255,164.83720996179272,0
"147.32.84.165",1133,"193.23.181.44",179,3,186,3,186,0,0,85334.960297,9.026893999995082,164.84075253357474,0
"147.32.84.165",1134,"193.23.181.44",80,3,186,3,186,0,0,85334.960514,9.026699999987613,164.84429525762923,0
"147.32.84.165",1135,"193.23.181.44",80,3,186,3,186,0,0,85334.961143,9.026095000008354,164.85534442066285,0
"147.32.84.165",1136,"193.23.181.44",80,3,186,3,186,0,0,85334.961369,9.025892000005115,164.85905215785397,0
"147.32.84.165",1137,"174.128.246.102",80,3,186,3,186,0,0,85334.961586,9.025700999991386,164.862540870944,0
"147.32.84.165",1138,"193.23.181.44",179,3,186,3,186,0,0,85335.05764,9.028965000004973,164.80294252986698,0
"147.32.84.165",1139,"174.37.196.55",80,3,186,3,186,0,0,85335.058356,9.028369999999995,164.81380359909937,0
"147.32.84.165",1140,"193.23.181.44",179,3,186,3,186,0,0,85335.058467,9.028307000000495,164.81495367846023,0
"147.32.84.165",1141,"72.20.15.61",80,3,186,3,186,0,0,85335.058606,9.028216999999131,164.81659667685693,0
"147.32.84.165",1142,"72.20.15.61",80,3,186,3,186,0,0,85335.058713,9.02815699999337,164.81769202740853,0
"147.32.84.165",1143,"193.23.181.44",80,3,186,3,186,0,0,85335.058821,9.028095999994548,164.8188056485995,0
"147.32.84.165",1144,"193.23.181.44",80,3,186,3,186,0,0,85335.058935,9.028029000008246,164.8200288234166,0
"147.32.84.165",1145,"193.23.181.44",80,3,186,3,186,0,0,85335.059207,9.027803999997559,164.82413663393692,0
"147.32.84.165",1146,"193.23.181.44",179,3,186,3,186,0,0,85335.059326,9.027732000002288,164.82545117639987,0
"147.32.84.165",1147,"174.37.196.55",80,3,186,3,186,0,0,85335.059456,9.02764699999534,164.8270030940253,0
"147.32.84.165",1148,"72.20.15.61",80,3,186,3,186,0,0,85335.059574,9.02757500000007,164.8283176822113,0
"147.32.84.165",1149,"67.19.72.206",80,3,186,3,186,0,0,85335.059693,9.027516999994987,164.8293766714398,0
"147.32.84.165",1150,"174.128.246.102",80,8,656,6,534,2,122,85335.059811,9.352127000005567,456.7944810840846,104.36128594055866
"147.32.84.165",1151,"174.37.196.55",80,3,186,3,186,0,0,85335.059929,9.027381000007153,164.83185987151987,0
"147.32.84.165",1152,"193.23.181.44",179,3,186,3,186,0,0,85335.060048,9.027310000004945,164.833156277915,0
"147.32.84.165",1153,"174.37.196.55",80,3,186,3,186,0,0,85335.060169,9.027235999994446,164.83450748389822,0
"147.32.84.165",1154,"67.19.72.206",80,3,186,3,186,0,0,85335.060288,9.027163000006112,164.83584045164494,0
"147.32.84.165",1156,"67.19.72.206",80,3,186,3,186,0,0,85335.060462,9.027035999999498,164.83815950219793,0
"147.32.84.165",1157,"67.19.72.206",80,3,186,3,186,0,0,85335.060582,9.026963999989675,164.83947426861366,0
"147.32.84.165",1155,"72.20.15.61",80,3,186,3,186,0,0,85335.060698,9.026895000002696,164.8407342723667,0
"147.32.84.165",1159,"72.20.15.61",80,3,186,3,186,0,0,85335.158095,9.028714999993099,164.8075058301361,0
"147.32.84.165",1158,"174.37.196.55",80,3,186,3,186,0,0,85335.158319,9.028554000004078,164.8104447289486,0
"147.32.84.165",1160,"174.37.196.55",80,3,186,3,186,0,0,85335.158536,9.028359000003547,164.814004405387,0
"147.32.84.165",1161,"72.20.15.61",80,3,186,3,186,0,0,85335.158751,9.028165000010631,164.81754597952605,0
"147.32.84.165",1162,"67.19.72.206",80,3,186,3,186,0,0,85335.159042,9.027898000000278,164.82242045711573,0
"147.32.84.165",1163,"174.37.196.55",80,3,186,3,186,0,0,85335.159264,9.027698999998393,164.826053682147,0
"147.32.84.165",1164,"174.37.196.55",80,3,186,3,186,0,0,85335.257851,9.02940800000215,164.79485698283273,0
"147.32.84.165",1165,"174.128.246.102",80,8,692,4,450,4,242,85335.25805,0.3202939999900991,11239.673550273445,6044.4466648137195
"147.32.84.165",1166,"193.23.181.44",179,3,186,3,186,0,0,85335.358647,9.028718999994453,164.80743281532122,0
"147.32.84.165",1167,"193.23.181.44",80,3,186,3,186,0,0,85335.359114,9.028310999987298,164.8148806573116,0
"147.32.84.165",1168,"174.128.246.102",80,16,2020,12,1772,4,248,85335.359354,93.11895000000368,152.23539354770904,21.30608216694799
"147.32.84.165",1169,"174.37.196.55",80,3,186,3,186,0,0,85335.418888,8.968557999993209,165.91295947477028,0
"147.32.84.165",1170,"174.128.246.102",80,3,186,3,186,0,0,85335.458273,9.029395000005024,164.79509424487156,0
"147.32.84.165",1171,"72.20.15.61",80,3,186,3,186,0,0,85335.523421,8.964368000000832,165.9905081986663,0
"147.32.84.165",1172,"46.4.36.120",443,6,366,3,186,3,180,85335.781287,1.0081680000002962,1475.9444854424687,1428.3333730088407
"147.32.84.165",1173,"193.23.181.44",80,3,186,3,186,0,0,85335.859165,9.029616999992868,164.79104263239242,0
"147.32.84.165",1174,"67.19.72.206",80,3,186,3,186,0,0,85335.859498,9.029343999995035,164.7960250490864,0
"147.32.84.165",1175,"174.37.196.55",80,3,186,3,186,0,0,85336.059671,9.029774000009638,164.78817742264775,0
"147.32.84.165",1176,"174.37.196.55",80,3,186,3,186,0,0,85336.059927,9.029579000009107,164.79173613725504,0
"147.32.84.165",1177,"193.23.181.44",179,3,186,3,186,0,0,85336.060038,9.029490000000806,164.79336042233473,0
"147.32.84.165",1178,"174.37.196.55",80,3,186,3,186,0,0,85336.19827,8.991684000007808,165.4862426213719,0
"147.32.84.165",1179,"174.128.246.102",80,12,896,8,650,4,246,85336.201471,18.315755000003264,283.9085803451222,107.44847809984624
"147.32.84.165",1180,"72.20.15.61",80,3,186,3,186,0,0,85336.20467,8.985435999988113,165.6013130583723,0
"147.32.84.165",1181,"174.128.246.102",80,3,186,3,186,0,0,85336.207895,8.982250999993994,165.66003332583279,0
"147.32.84.165",1183,"174.128.246.102",80,3,186,3,186,0,0,85336.21112,8.979065999999875,165.71879525108966,0
"147.32.84.165",1182,"193.23.181.44",179,3,186,3,186,0,0,85336.214325,8.975900000004913,165.77724796390174,0
"147.32.84.165",1184,"174.128.246.102",80,12,901,8,655,4,246,85336.380671,18.238088999991305,287.3108032317694,107.90604212979432
"147.32.84.165",1185,"72.20.15.61",80,3,186,3,186,0,0,85336.383903,8.90679700000328,167.06342358531938,0
"147.32.84.165",1186,"174.37.196.55",80,3,186,3,186,0,0,85336.387071,8.903649999992922,167.1224722446618,0
"147.32.84.165",1187,"72.20.15.61",80,3,186,3,186,0,0,85336.39027,8.900473000001512,167.18212616337888,0
"147.32.84.165",1188,"72.20.15.61",80,3,186,3,186,0,0,85336.393491,8.897275000010268,167.24221742030934,0
"147.32.84.165",1189,"72.20.15.61",80,3,186,3,186,0,0,85336.396672,8.894115000002785,167.3016370936888,0
"147.32.84.165",1190,"193.23.181.44",80,3,186,3,186,0,0,85336.399896,8.890912000002572,167.361908429593,0
"147.32.84.165",1191,"72.20.15.61",80,3,186,3,186,0,0,85336.403088,8.887742999999318,167.42158273479714,0
"147.32.84.165",1192,"174.128.246.102",80,3,186,3,186,0,0,85336.406323,8.884531999996398,167.48209134714168,0
"147.32.84.165",1193,"193.23.181.44",179,3,186,3,186,0,0,85336.409493,8.881382000006852,167.54149297922913,0
"147.32.84.165",1194,"174.128.246.102",80,3,186,3,186,0,0,85336.433093,8.85780500000692,167.98744158387294,0
"147.32.84.165",1195,"193.23.181.44",80,3,186,3,186,0,0,85336.467491,8.923429000002216,166.75204117157548,0
"147.32.84.165",1196,"174.37.196.55",80,3,186,3,186,0,0,85336.470688,8.920278000005055,166.81094468122595,0
"147.32.84.165",1197,"193.23.181.44",179,3,186,3,186,0,0,85336.473895,8.917117999997572,166.8700582408358,0
"147.32.84.165",1198,"67.19.72.206",80,3,186,3,186,0,0,85336.477094,8.91396399999212,166.92910135168992,0
"147.32.84.165",1199,"174.128.246.102",80,3,186,3,186,0,0,85336.480289,8.910816000003251,166.98807381944113,0
"147.32.84.165",1200,"174.128.246.102",80,10,856,7,672,3,184,85336.483487,9.174419999995735,585.9770971900675,160.44610994489943
"147.32.84.165",1201,"174.128.246.102",80,3,186,3,186,0,0,85336.496274,8.894877999991877,167.28728600902215,0
"147.32.84.165",1202,"174.37.196.55",80,7,602,4,420,3,182,85336.662546,0.2784079999983078,12068.61871792629,5229.734777768059
"147.32.84.165",1203,"193.23.181.44",179,3,186,3,186,0,0,85336.662915,9.028410000013537,164.8130733980589,0
"147.32.84.165",1204,"72.20.15.61",80,3,186,3,186,0,0,85336.663185,9.028237999998964,164.81621330764327,0
"147.32.84.165",1205,"174.37.196.55",80,7,569,4,387,3,182,85336.663505,0.2990529999951832,10352.679959906327,4868.7022033668
"147.32.84.165",1206,"193.23.181.44",80,3,186,3,186,0,0,85336.663858,9.02758900000481,164.8280620660962,0
"147.32.84.165",1207,"193.23.181.44",80,3,186,3,186,0,0,85336.664148,9.02732000000833,164.83297368417502,0
"147.32.84.165",1208,"193.23.181.44",80,3,186,3,186,0,0,85336.778018,9.01416400000744,165.07354425754534,0
"147.32.84.165",1209,"174.37.196.55",80,3,186,3,186,0,0,85336.781199,9.011025999992853,165.1310294744661,0
"147.32.84.165",1210,"174.128.246.102",80,3,186,3,186,0,0,85336.784395,9.007880000004661,165.18870144797998,0
"147.32.84.165",1211,"193.23.181.44",179,3,186,3,186,0,0,85336.787612,9.00471199999447,165.24681744412413,0
"147.32.84.165",1212,"72.20.15.61",80,3,186,3,186,0,0,85336.790816,9.001553000009153,165.30480907000015,0
"147.32.84.165",1213,"72.20.15.61",80,3,186,3,186,0,0,85336.793999,8.998416999995243,165.36241874551786,0
"147.32.84.165",1214,"72.20.15.61",80,3,186,3,186,0,0,85336.797244,8.995221999997739,165.42115358580077,0
"147.32.84.165",1215,"67.19.72.206",80,3,186,3,186,0,0,85336.800395,8.992117999994662,165.4782555123146,0
"147.32.84.165",1216,"72.20.15.61",80,3,186,3,186,0,0,85336.803615,8.988941000003251,165.53674120226864,0
"147.32.84.165",1217,"67.19.72.206",80,3,186,3,186,0,0,85336.806796,8.985806999990018,165.59447582188812,0
"147.32.84.165",1218,"193.23.181.44",80,3,186,3,186,0,0,85336.809996,8.98265600000741,165.65256423030922,0
"147.32.84.165",1219,"174.128.246.102",80,3,186,3,186,0,0,85336.813213,8.979485999996541,165.71104403977836,0
"147.32.84.165",1220,"67.19.72.206",80,3,186,3,186,0,0,85336.834816,8.957928999996511,166.10982292900283,0
"147.32.84.165",1221,"67.19.72.206",80,3,186,3,186,0,0,85336.854844,8.937946000005468,166.48120272813125,0
"147.32.84.165",1222,"174.37.196.55",80,3,186,3,186,0,0,85337.065869,9.028042000005371,164.8197914895738,0
"147.32.84.165",1223,"174.37.196.55",80,3,186,3,186,0,0,85337.095463,8.998544000001857,165.36008492037078,0
"147.32.84.165",1224,"67.19.72.206",80,3,186,3,186,0,0,85337.164147,9.031057999993209,164.76474849360054,0
"147.32.84.165",1225,"67.19.72.206",80,3,186,3,186,0,0,85337.164294,9.031030999991344,164.76524108946433,0
"147.32.84.165",1226,"193.23.181.44",179,3,186,3,186,0,0,85337.164439,9.030933999994886,164.76701080982792,0
"147.32.84.165",1227,"193.23.181.44",80,3,186,3,186,0,0,85337.164658,9.030758000008063,164.77022194578478,0
"147.32.84.165",1229,"72.20.15.61",80,3,186,3,186,0,0,85337.265255,9.02925399999367,164.7976676701135,0
"147.32.84.165",1228,"174.37.196.55",80,3,186,3,186,0,0,85337.265364,9.029169999994338,164.79920081258112,0
"147.32.84.165",1230,"72.20.15.61",80,3,186,3,186,0,0,85337.265503,9.029053999998723,164.8013180561563,0
"147.32.84.165",1231,"193.23.181.44",80,3,186,3,186,0,0,85337.266729,9.027855000007548,164.82320551213505,0
"147.32.84.165",1232,"174.128.246.102",80,3,186,3,186,0,0,85337.269929,9.024676999993972,164.88124727355827,0
"147.32.84.165",1233,"174.128.246.102",80,3,186,3,186,0,0,85337.273128,9.021500000002561,164.9393116443582,0
"147.32.84.165",1234,"193.23.181.44",80,3,186,3,186,0,0,85337.325041,8.969610000000102,165.89350038630252,0
"147.32.84.165",1235,"72.20.15.61",80,3,186,3,186,0,0,85337.371148,9.024042999997619,164.89283129528445,0
"147.32.84.165",1236,"193.23.181.44",179,3,186,3,186,0,0,85337.37433,9.020885999998427,164.95053811790322,0
"147.32.84.165",1237,"174.37.196.55",80,3,186,3,186,0,0,85337.377548,9.017691999993986,165.0089623820588,0
"147.32.84.165",1238,"72.20.15.61",80,3,186,3,186,0,0,85337.380746,9.014521000004606,165.06700688802428,0
"147.32.84.165",1239,"193.23.181.44",179,3,186,3,186,0,0,85337.383978,9.011312000002363,165.1257885643744,0
"147.32.84.165",1240,"193.23.181.44",179,3,186,3,186,0,0,85337.465582,9.029169000001275,164.79921906432253,0
"147.32.84.165",1241,"67.19.72.206",80,3,186,3,186,0,0,85337.66586,9.030058000003919,164.7829947492424,0
"147.32.84.165",1242,"174.37.196.55",80,3,186,3,186,0,0,85337.768036,9.028183000002173,164.8172173736002,0
"147.32.84.165",1243,"72.20.15.61",80,3,186,3,186,0,0,85337.771218,9.025021000008564,164.87496261765907,0
"147.32.84.165",1244,"67.19.72.206",80,3,186,3,186,0,0,85337.774431,9.021835999999894,164.9331688139773,0
"147.32.84.165",1245,"174.128.246.102",80,3,186,3,186,0,0,85337.777616,9.018672999998671,164.99101364471463,0
"147.32.84.165",1246,"174.128.246.102",80,3,186,3,186,0,0,85337.780817,9.015492999998969,165.0492102872433,0
"147.32.84.165",1247,"174.37.196.55",80,3,186,3,186,0,0,85337.784045,9.012286000011954,165.10794264607517,0
"147.32.84.165",1248,"72.20.15.61",80,3,186,3,186,0,0,85337.787222,9.009130000005825,165.16578182344333,0
"147.32.84.165",1249,"46.4.36.120",443,6,366,3,186,3,180,85337.790402,1.006915999998455,1477.7796757646947,1430.109363643253
"147.32.84.165",1250,"67.19.72.206",80,3,186,3,186,0,0,85337.839171,8.957204999998794,166.12324938417737,0
"147.32.84.165",1251,"174.37.196.55",80,3,186,3,186,0,0,85338.068116,9.028788000010536,164.80617332008057,0
"147.32.84.165",1252,"72.20.15.61",80,3,186,3,186,0,0,85338.168453,9.029157999990275,164.7994198353382,0
"147.32.84.165",1253,"72.20.15.61",80,3,186,3,186,0,0,85338.267683,9.030706999998074,164.77115246905004,0
"147.32.84.165",1254,"72.20.15.61",80,3,186,3,186,0,0,85338.369056,9.028504000001703,164.811357451879,0
"147.32.84.165",1255,"174.128.246.102",80,12,856,8,610,4,246,85338.56946,18.35782499999914,265.82669787952705,107.20224209567813
"147.32.84.165",1256,"174.37.196.55",80,3,186,3,186,0,0,85339.171171,9.029501000011805,164.79315966608283,0
"147.32.84.165",1257,"174.37.196.55",80,3,186,3,186,0,0,85339.272338,9.0288040000014,164.8058812661975,0
"147.32.84.165",1258,"193.23.181.44",179,3,186,3,186,0,0,85339.272714,9.02844899999036,164.81236145893817,0
"147.32.84.165",1259,"193.23.181.44",80,3,186,3,186,0,0,85339.272989,9.028195999999298,164.81698004785406,0
"147.32.84.165",1260,"193.23.181.44",80,3,186,3,186,0,0,85339.27334,9.027868999997736,164.8229499121413,0
"147.32.84.165",1261,"174.128.246.102",80,3,186,3,186,0,0,85339.372004,9.029440999991493,164.79425470540224,0
"147.32.84.165",1262,"184.82.148.43",80,10,1919,5,979,5,940,85339.453413,0.30442800000309944,25726.93707517134,24702.06419883663
"147.32.84.165",1263,"67.19.72.206",80,3,186,3,186,0,0,85339.540238,8.961813000001712,166.03783185385768,0
"147.32.84.165",1264,"184.82.148.44",80,10,1513,5,596,5,917,85339.663505,0.3222279999899911,14796.976054682094,22766.488325744096
"147.32.84.165",1265,"193.23.181.44",179,3,186,3,186,0,0,85339.77309,9.029081000000588,164.80082524455182,0
"147.32.84.165",1266,"46.4.36.120",443,6,366,3,186,3,180,85339.797843,1.0067010000057053,1478.0952834968546,1430.4147904808272
"147.32.84.165",1267,"217.163.21.36",80,14,6137,7,809,7,5328,85339.891286,0.18783700000494719,34455.405483634975,226920.14884648597
"147.32.84.165",1268,"217.163.21.36",80,10,1448,5,699,5,749,85340.04212,0.13921799999661744,40167.21975704197,43040.411442095035
"147.32.84.165",1269,"217.163.21.35",80,11,3722,6,2094,5,1628,85340.135853,0.2671779999946011,62699.773186184895,48746.528532525794
"147.32.84.165",1270,"217.163.21.36",80,10,2274,5,1154,5,1120,85340.36158,0.13930900000559632,66269.94666266453,64317.452566884116
"147.32.84.165",1271,"217.163.21.35",80,13,5610,7,2609,6,3001,85340.455486,0.20759599999291822,100541.43625460997,115647.70034499216
"147.32.84.165",1272,"173.241.240.4",80,9,2194,5,1164,4,1030,85340.580398,0.10224799999559764,91072.68602222962,80588.373370186
"147.32.84.165",1273,"92.240.244.181",80,10,1758,6,1364,4,394,85340.581942,5.066588999994565,2153.7172247466106,622.1147995235812
"147.32.84.165",1274,"193.23.181.44",179,3,186,3,186,0,0,85340.582632,9.023400999998557,164.90456314644976,0
"147.32.84.165",1275,"46.4.36.120",443,6,366,3,186,3,180,85341.804447,1.0047950000007404,1480.8990888677824,1433.128150517209
"147.32.84.165",1276,"67.19.72.206",80,3,186,3,186,0,0,85342.394532,8.916224000000511,166.88678974416914,0
"147.32.84.165",1277,"174.37.196.55",80,3,186,3,186,0,0,85342.397759,8.913056000004872,166.94610692440244,0
"147.32.84.165",1278,"174.37.196.55",80,3,186,3,186,0,0,85342.400932,8.90990499999316,167.0051476419942,0
"147.32.84.165",1279,"67.19.72.206",80,3,186,3,186,0,0,85342.426532,8.984106999996584,165.62581011118476,0
"147.32.84.165",1280,"67.19.72.206",80,3,186,3,186,0,0,85342.429751,8.980994999990799,165.68320102633666,0
"147.32.84.165",1281,"174.37.196.55",80,3,186,3,186,0,0,85342.801019,9.01075299999502,165.13603247151735,0
"147.32.84.165",1282,"174.37.196.55",80,3,186,3,186,0,0,85342.804222,9.007671999992453,165.19251589103672,0
"147.32.84.165",1283,"193.23.181.44",80,3,186,3,186,0,0,85343.288625,9.024764000001596,164.87965779490042,0
"147.32.84.165",1284,"67.19.72.206",80,3,186,3,186,0,0,85343.291826,9.021586999995634,164.93772104627712,0
"147.32.84.165",1285,"72.20.15.61",80,3,186,3,186,0,0,85343.385394,8.928048000001581,166.66577061410698,0
"147.32.84.165",1286,"174.128.246.102",80,3,186,3,186,0,0,85343.385748,8.927714999997988,166.67198717704758,0
"147.32.84.165",1287,"67.19.72.206",80,3,186,3,186,0,0,85343.586187,8.927845000012894,166.66956023518003,0
"147.32.84.165",1288,"193.23.181.44",179,3,186,3,186,0,0,85343.586409,8.92765500000678,166.67310732760953,0
"147.32.84.165",1289,"174.128.246.102",80,3,186,3,186,0,0,85343.78893,8.92608299999847,166.70246064261949,0
"147.32.84.165",1290,"46.4.36.120",443,6,366,3,186,3,180,85343.810555,1.0056209999893326,1479.6827035391905,1431.9510034250231
"147.32.84.165",1291,"72.20.15.61",80,3,186,3,186,0,0,85343.886408,8.92928799999936,166.64262592942535,0
"147.32.84.165",1292,"67.19.72.206",80,3,186,3,186,0,0,85343.886582,8.929135999991558,166.64546267426172,0
"147.32.84.165",1293,"67.19.72.206",80,3,186,3,186,0,0,85344.252826,8.862978999997722,167.88937444175176,0
"147.32.84.165",1294,"67.19.72.206",80,3,186,3,186,0,0,85344.287612,8.929130999997142,166.64555598976835,0
"147.32.84.165",1295,"201.65.242.60",6667,2,124,2,124,0,0,85344.608211,2.9900760000018636,331.76414244968413,0
"147.32.84.165",1296,"72.20.15.61",80,3,186,3,186,0,0,85345.19059,8.930747000005795,166.61540182462167,0
"147.32.84.165",1297,"72.20.15.61",80,3,186,3,186,0,0,85345.291184,8.929829999993672,166.6325114812997,0
"147.32.84.165",1298,"67.19.72.206",80,3,186,3,186,0,0,85345.29131,8.929824000006192,166.63262344240695,0
"147.32.84.165",1299,"72.20.15.61",80,3,186,3,186,0,0,85345.350112,8.871069999993779,167.7362482768193,0
"147.32.84.165",1300,"193.23.181.44",179,3,186,3,186,0,0,85345.391464,8.941130000006524,166.42191758747657,0
"147.32.84.165",1301,"174.128.246.102",80,3,186,3,186,0,0,85345.457093,8.87867799999367,167.59251771503156,0
"147.32.84.165",1302,"193.23.181.44",80,3,186,3,186,0,0,85345.793181,8.929285999998683,166.642663254399,0
"147.32.84.165",1303,"46.4.36.120",443,6,366,3,186,3,180,85345.817943,1.0057359999918845,1479.5135105156892,1431.7872682409893
"147.32.84.165",1304,"193.23.181.44",179,3,186,3,186,0,0,85346.395507,8.928697000010288,166.65365618278742,0
"147.32.84.165",1305,"193.23.181.44",179,3,186,3,186,0,0,85346.796655,8.928639000005205,166.65473875683992,0
"147.32.84.165",1306,"174.128.246.102",80,3,186,3,186,0,0,85346.796859,8.928559000007226,166.65623198534004,0
"147.32.84.165",1307,"67.19.72.206",80,3,186,3,186,0,0,85346.897126,8.929101000001538,166.6461158855459,0
"147.32.84.165",1308,"193.23.181.44",80,3,186,3,186,0,0,85346.897489,8.92876600001182,166.65236831136914,0
"147.32.84.165",1309,"67.19.72.206",80,3,186,3,186,0,0,85346.897759,8.928522999995039,166.65690394713963,0
"147.32.84.165",1310,"72.20.15.61",80,3,186,3,186,0,0,85347.197824,8.929137999992236,166.64542534803402,0
"147.32.84.165",1311,"184.82.148.43",80,10,1919,5,979,5,940,85347.661512,0.3063819999952102,25562.859437311723,24544.52285094282
"147.32.84.165",1312,"67.19.72.206",80,3,186,3,186,0,0,85347.76397,8.875222000002395,167.6577780251129,0
"147.32.84.165",1313,"46.4.36.120",443,6,366,3,186,3,180,85347.823046,1.0064849999907892,1478.4124949836485,1430.7217693390146
"147.32.84.165",1314,"184.82.148.44",80,10,1514,5,596,5,918,85347.872858,0.3436399999918649,13874.985450217886,21371.202421644328
"147.32.84.165",1315,"217.163.21.36",80,14,6141,7,810,7,5331,85348.114732,0.18785499999648891,34494.69005414343,227026.16380078843
"147.32.84.165",1316,"217.163.21.36",80,10,1451,5,701,5,750,85348.262027,0.13861999999789987,40455.92266689484,43283.79743248378
"147.32.84.165",1317,"217.163.21.35",80,13,5214,7,2156,6,3058,85348.355297,0.2516360000008717,68543.45165214934,97219.79366988527
"147.32.84.165",1318,"193.23.181.44",179,3,186,3,186,0,0,85348.503253,8.984058999994886,165.6266950162334,0
"147.32.84.165",1319,"67.19.72.206",80,3,186,3,186,0,0,85349.60631,8.929516000003787,166.6383709933852,0
"147.32.84.165",1320,"46.4.36.120",443,6,366,3,186,3,180,85349.830352,1.0059329999930924,1479.2237654100402,1431.5068697516517
"147.32.84.165",1321,"94.100.176.20",25,3,186,3,186,0,0,85350.026651,8.910794000010355,166.98848609880002,0
"147.32.84.165",1322,"193.23.181.44",80,3,186,3,186,0,0,85350.808871,8.932979000004707,166.57377119091134,0
"147.32.84.165",1323,"67.19.72.206",80,3,186,3,186,0,0,85351.110398,8.931622999996762,166.59906043957963,0
"147.32.84.165",1324,"174.37.196.55",80,3,186,3,186,0,0,85351.812812,8.932149000000209,166.58924968671764,0
"147.32.84.165",1325,"174.128.246.102",80,3,186,3,186,0,0,85351.813088,8.931896000009147,166.59396840250673,0
"147.32.84.165",1326,"46.4.36.120",443,6,366,3,186,3,180,85351.837385,1.00568299999577,1479.5914816162338,1431.8627241447423
"147.32.84.165",1328,"193.23.181.44",179,3,186,3,186,0,0,85351.912354,8.932849000004353,166.576195343644,0
"147.32.84.165",1327,"72.20.15.61",80,3,186,3,186,0,0,85351.912467,8.932784999997239,166.57738879872963,0
"147.32.84.165",1329,"193.23.181.44",80,3,186,3,186,0,0,85351.912605,8.932690000001458,166.5791603648797,0
"147.32.84.165",1330,"193.23.181.44",179,3,186,3,186,0,0,85352.013153,8.932702999998583,166.57891793785555,0
"147.32.84.165",1331,"72.20.15.61",80,3,186,3,186,0,0,85352.013384,8.932541000001947,166.58193900253866,0
"147.32.84.165",1332,"174.128.246.102",80,3,186,3,186,0,0,85352.113293,8.932203000003938,166.5882425644988,0
"147.32.84.165",1333,"72.20.15.61",80,3,186,3,186,0,0,85352.313688,9.033244000005652,164.72487624590556,0
"147.32.84.165",1334,"193.23.181.44",80,3,186,3,186,0,0,85352.313829,9.03314099999261,164.72675451442828,0
"147.32.84.165",1335,"174.37.196.55",80,3,186,3,186,0,0,85352.413936,9.033462999999756,164.7208827888087,0
"147.32.84.165",1336,"193.23.181.44",80,3,186,3,186,0,0,85352.815937,9.032193999999436,164.7440256487065,0
"147.32.84.165",1337,"72.20.15.61",80,3,186,3,186,0,0,85352.816243,9.031947000010405,164.74853096439625,0
"147.32.84.165",1338,"72.20.15.61",80,3,186,3,186,0,0,85352.816386,9.031827999991947,164.75070162998307,0
"147.32.84.165",1339,"174.37.196.55",80,3,186,3,186,0,0,85352.816494,9.031742999999551,164.75225214004362,0
"147.32.84.165",1340,"67.19.72.206",80,3,186,3,186,0,0,85352.915964,9.032575999997789,164.73705839844183,0
"147.32.84.165",1341,"72.20.15.61",80,3,186,3,186,0,0,85352.916257,9.032412000000477,164.74004950171908,0
"147.32.84.165",1342,"174.37.196.55",80,3,186,3,186,0,0,85353.016351,9.032632000002195,164.73603707088236,0
"147.32.84.165",1343,"46.4.36.120",443,6,366,3,186,3,180,85353.842732,1.0073599999886937,1477.1283354676589,1429.4790343235409
"147.32.84.165",1344,"72.20.15.61",80,8,659,5,477,3,182,85353.921702,3.449079999991227,1106.3819917223452,422.1415565900772
"147.32.84.165",1345,"193.23.181.44",80,3,186,3,186,0,0,85353.921858,9.029714000003878,164.78927239548904,0
"147.32.84.165",1346,"193.23.181.44",80,3,186,3,186,0,0,85354.027156,9.024304999999003,164.88804401005555,0
"147.32.84.165",1347,"67.19.72.206",80,3,186,3,186,0,0,85354.02745,9.024134000006597,164.89116850424784,0
"147.32.84.165",1348,"174.37.196.55",80,3,186,3,186,0,0,85354.027718,9.02391400000488,164.8951884957232,0
"147.32.84.165",1349,"193.23.181.44",179,3,186,3,186,0,0,85354.122997,9.029727000001003,164.7890351502138,0
"147.32.84.165",1350,"193.23.181.44",179,3,186,3,186,0,0,85354.124065,9.028680000003078,164.80814471212764,0
"147.32.84.165",1351,"174.128.246.102",80,7,640,5,518,2,122,85354.124178,3.436371000003419,1205.9233418032795,284.02055540540556
"147.32.84.165",1352,"174.37.196.55",80,3,186,3,186,0,0,85354.124339,9.028429999991204,164.8127083004963,0
"147.32.84.165",1353,"72.20.15.61",80,3,186,3,186,0,0,85354.124449,9.02834299999813,164.8142964883266,0
"147.32.84.165",1354,"193.23.181.44",80,3,186,3,186,0,0,85354.124556,9.02826200000709,164.81577517343112,0
"147.32.84.165",1355,"174.37.196.55",80,3,186,3,186,0,0,85354.124663,9.028178000007756,164.81730865283356,0
"147.32.84.165",1356,"174.37.196.55",80,3,186,3,186,0,0,85354.124769,9.028095000001485,164.81882390468368,0
"147.32.84.165",1357,"193.23.181.44",80,3,186,3,186,0,0,85354.124878,9.028009000001475,164.82039395394455,0
"147.32.84.165",1358,"193.23.181.44",80,3,186,3,186,0,0,85354.124985,9.027925999995205,164.82190926252503,0
"147.32.84.165",1359,"174.37.196.55",80,3,186,3,186,0,0,85354.125101,9.027832000007038,164.8236254284351,0
"147.32.84.165",1360,"72.20.15.61",80,3,186,3,186,0,0,85354.125214,9.027742999998736,164.82525034221823,0
"147.32.84.165",1361,"193.23.181.44",179,3,186,3,186,0,0,85354.125352,9.027627999996184,164.82734999721177,0
"147.32.84.165",1362,"193.23.181.44",179,3,186,3,186,0,0,85354.125466,9.027536000008695,164.82902975945672,0
"147.32.84.165",1363,"174.37.196.55",80,3,186,3,186,0,0,85354.125584,9.027442000005976,164.83074607391717,0
"147.32.84.165",1364,"174.37.196.55",80,3,186,3,186,0,0,85354.125698,9.027350999996997,164.83240764655045,0
"147.32.84.165",1365,"174.37.196.55",80,3,186,3,186,0,0,85354.12581,9.027262000003248,164.83403273323236,0
"147.32.84.165",1366,"193.23.181.44",80,3,186,3,186,0,0,85354.125926,9.027169000008143,164.8357308917843,0
"147.32.84.165",1367,"67.19.72.206",80,3,186,3,186,0,0,85354.126038,9.027079999999842,164.83735604426084,0
"147.32.84.165",1368,"67.19.72.206",80,3,186,3,186,0,0,85354.126144,9.026998000001186,164.83885340395605,0
"147.32.84.165",1369,"193.23.181.44",179,3,186,3,186,0,0,85354.126254,9.026910000000498,164.8404603568572,0
"147.32.84.165",1370,"193.23.181.44",179,3,186,3,186,0,0,85354.126361,9.026826000001165,164.8419942956481,0
"147.32.84.165",1371,"193.23.181.44",80,3,186,3,186,0,0,85354.126471,9.026739000008092,164.84358304794966,0
"147.32.84.165",1373,"72.20.15.61",80,3,186,3,186,0,0,85354.131168,9.0220699999918,164.92889104178448,0
"147.32.84.165",1374,"67.19.72.206",80,3,186,3,186,0,0,85354.131279,9.021982000005664,164.93049975039474,0
"147.32.84.165",1372,"67.19.72.206",80,3,186,3,186,0,0,85354.131385,9.021899999992456,164.93199880305082,0
"147.32.84.165",1376,"67.19.72.206",80,3,186,3,186,0,0,85354.150616,9.005252000002656,165.23690841739477,0
"147.32.84.165",1377,"72.20.15.61",80,3,186,3,186,0,0,85354.150728,9.008343000008608,165.18021127732126,0
"147.32.84.165",1375,"67.19.72.206",80,3,186,3,186,0,0,85354.150834,9.011434000000008,165.1235530327358,0
"147.32.84.165",1379,"174.37.196.55",80,3,186,3,186,0,0,85354.166973,8.998493999999482,165.36100374130223,0
"147.32.84.165",1380,"67.19.72.206",80,3,186,3,186,0,0,85354.167084,9.001615000001038,165.30367050799532,0
"147.32.84.165",1378,"67.19.72.206",80,3,186,3,186,0,0,85354.16719,9.004707000000053,165.24690919982086,0
"147.32.84.165",1381,"193.23.181.44",179,3,186,3,186,0,0,85354.16733,9.007738000000245,165.19130551976085,0
"147.32.84.165",1383,"67.19.72.206",80,3,186,3,186,0,0,85354.16744,9.010826999990968,165.13467631788865,0
"147.32.84.165",1384,"67.19.72.206",80,3,186,3,186,0,0,85354.167547,9.01397200000065,165.07706036804782,0
"147.32.84.165",1382,"72.20.15.61",80,3,186,3,186,0,0,85354.167652,9.017045000000508,165.02080226947035,0
"147.32.84.165",1385,"72.20.15.61",80,3,186,3,186,0,0,85354.221872,9.031163000006927,164.7628328709003,0
"147.32.84.165",1387,"193.23.181.44",80,3,186,3,186,0,0,85354.225734,9.027347999988706,164.83246242438662,0
"147.32.84.165",1386,"67.19.72.206",80,3,186,3,186,0,0,85354.22602,9.02711100000306,164.8367899762721,0
"147.32.84.165",1388,"174.37.196.55",80,3,186,3,186,0,0,85354.234473,9.018702999994275,164.99046481527827,0
"147.32.84.165",1389,"174.128.246.102",80,3,186,3,186,0,0,85354.235612,9.017611999996006,165.0104262637003,0
"147.32.84.165",1390,"174.37.196.55",80,3,186,3,186,0,0,85354.235868,9.017401999997674,165.0142690766569,0
"147.32.84.165",1391,"67.19.72.206",80,3,186,3,186,0,0,85354.236085,9.017227999996976,165.0174532573091,0
"147.32.84.165",1392,"193.23.181.44",80,3,186,3,186,0,0,85354.236304,9.017058999990695,165.02054605626242,0
"147.32.84.165",1393,"174.128.246.102",80,3,186,3,186,0,0,85354.236518,9.016890999992029,165.02362066939872,0
"147.32.84.165",1394,"72.20.15.61",80,3,186,3,186,0,0,85354.236733,9.0167220000003,165.02671369927458,0
"147.32.84.165",1395,"72.20.15.61",80,3,186,3,186,0,0,85354.237001,9.016499000004842,165.0307952121107,0
"147.32.84.165",1396,"193.23.181.44",179,3,186,3,186,0,0,85354.237219,9.016327000004821,165.0339434227712,0
"147.32.84.165",1397,"174.128.246.102",80,3,186,3,186,0,0,85354.237433,9.016159999999218,165.03700023071121,0
"147.32.84.165",1398,"174.128.246.102",80,3,186,3,186,0,0,85354.237701,9.015938999989885,165.0410456416874,0
"147.32.84.165",1399,"67.19.72.206",80,3,186,3,186,0,0,85354.237916,9.015769000005093,165.04415763083097,0
"147.32.84.165",1400,"193.23.181.44",179,3,186,3,186,0,0,85354.238131,9.015598999991198,165.04726973786796,0
"147.32.84.165",1401,"72.20.15.61",80,3,186,3,186,0,0,85354.238405,9.015368000007584,165.05149872958577,0
"147.32.84.165",1403,"193.23.181.44",80,3,186,3,186,0,0,85354.238724,9.016345000010915,165.0336139531261,0
"147.32.84.165",1404,"174.37.196.55",80,3,186,3,186,0,0,85354.238942,9.01934600000095,164.97870244692277,0
"147.32.84.165",1405,"174.37.196.55",80,3,186,3,186,0,0,85354.239213,9.022279000011622,164.92507048364203,0
"147.32.84.165",1402,"67.19.72.206",80,3,186,3,186,0,0,85354.23932,9.02535200001148,164.8689159157568,0
"147.32.84.165",1406,"193.23.181.44",80,3,186,3,186,0,0,85354.239445,9.028424000003724,164.81281782948898,0
"147.32.84.165",1408,"193.23.181.44",80,3,186,3,186,0,0,85354.23974,9.031348999997135,164.75943959207777,0
"147.32.84.165",1407,"67.19.72.206",80,3,186,3,186,0,0,85354.242961,9.0313240000105,164.75989566959063,0
"147.32.84.165",1409,"67.19.72.206",80,3,186,3,186,0,0,85354.246146,9.031330999991042,164.75976796791923,0
"147.32.84.165",1412,"67.19.72.206",80,3,186,3,186,0,0,85354.249363,9.031323000002885,164.75991391289236,0
"147.32.84.165",1413,"67.19.72.206",80,3,186,3,186,0,0,85354.252561,9.031325999996625,164.75985918353032,0
"147.32.84.165",1414,"67.19.72.206",80,3,186,3,186,0,0,85354.25576,9.031329000004916,164.75980445393915,0
"147.32.84.165",1415,"67.19.72.206",80,3,186,3,186,0,0,85354.258963,9.031321000002208,164.7599503992424,0
"147.32.84.165",1416,"174.128.246.102",80,3,186,3,186,0,0,85354.262158,9.031314000007114,164.76007810146208,0
"147.32.84.165",1417,"193.23.181.44",80,3,186,3,186,0,0,85354.26539,9.031281999996281,164.7606618861655,0
"147.32.84.165",1418,"67.19.72.206",80,3,186,3,186,0,0,85354.268571,9.031300000002375,164.7603335067608,0
"147.32.84.165",1419,"72.20.15.61",80,3,186,3,186,0,0,85354.27179,9.031281000003219,164.76068012937142,0
"147.32.84.165",1420,"193.23.181.44",179,3,186,3,186,0,0,85354.274991,9.031277999994927,164.76073485954433,0
"147.32.84.165",1410,"193.23.181.44",80,3,186,3,186,0,0,85354.278165,9.031304999996792,164.76024229062452,0
"147.32.84.165",1422,"193.23.181.44",179,3,186,3,186,0,0,85354.281391,9.031281000003219,164.76068012937142,0
"147.32.84.165",1423,"174.128.246.102",80,3,186,3,186,0,0,85354.284542,9.031330000012531,164.7597862106617,0
"147.32.84.165",1424,"174.128.246.102",80,3,186,3,186,0,0,85354.287793,9.031277000001865,164.7607531027664,0
"147.32.84.165",1425,"67.19.72.206",80,3,186,3,186,0,0,85354.290993,9.031277999994927,164.76073485954433,0
"147.32.84.165",1426,"193.23.181.44",179,3,186,3,186,0,0,85354.294193,9.031278000009479,164.76073485927887,0
"147.32.84.165",1427,"174.128.246.102",80,3,186,3,186,0,0,85354.29739,9.031299999987823,164.76033350702627,0
"147.32.84.165",1428,"174.37.196.55",80,3,186,3,186,0,0,85354.300541,9.031328999990365,164.75980445420464,0
"147.32.84.165",1429,"72.20.15.61",80,3,186,3,186,0,0,85354.303788,9.031308999998146,164.76016931768203,0
"147.32.84.165",1430,"174.37.196.55",80,3,186,3,186,0,0,85354.306994,9.031306000004406,164.7602240472501,0
"147.32.84.165",1432,"193.23.181.44",80,3,186,3,186,0,0,85354.310191,9.031325000003562,164.75987742655846,0
"147.32.84.165",1421,"67.19.72.206",80,3,186,3,186,0,0,85354.313391,9.031325999996625,164.75985918353032,0
"147.32.84.165",1431,"193.23.181.44",179,3,186,3,186,0,0,85354.316592,9.031304000003729,164.7602605337375,0
"147.32.84.165",1434,"67.19.72.206",80,3,186,3,186,0,0,85354.319768,9.031350999997812,164.75940310595396,0
"147.32.84.165",1435,"67.19.72.206",80,3,186,3,186,0,0,85354.32294,9.031329000004916,164.75980445393915,0
"147.32.84.165",1433,"174.128.246.102",80,3,186,3,186,0,0,85354.326145,9.031323000002885,164.75991391289236,0
"147.32.84.165",1436,"193.23.181.44",179,3,186,3,186,0,0,85354.339054,9.04521399999794,164.5068872887185,0
"147.32.84.165",1437,"174.128.246.102",80,3,186,3,186,0,0,85354.34219,9.045280999998795,164.5056687570235,0
"147.32.84.165",1438,"67.19.72.206",80,3,186,3,186,0,0,85354.345389,9.045299000004889,164.50534139326913,0
"147.32.84.165",1439,"193.23.181.44",80,3,186,3,186,0,0,85354.34854,9.045331999994232,164.50474123016699,0
"147.32.84.165",1440,"193.23.181.44",80,3,186,3,186,0,0,85354.351741,9.04536599999119,164.50412288474,0
"147.32.84.165",1441,"193.23.181.44",179,3,186,3,186,0,0,85354.354958,9.04533100000117,164.504759416743,0
"147.32.84.165",1442,"72.20.15.61",80,3,186,3,186,0,0,85354.421813,9.031563000011374,164.75553566953207,0
"147.32.84.165",1443,"193.23.181.44",80,3,186,3,186,0,0,85354.422739,9.030686999991303,164.77151738305545,0
"147.32.84.165",1444,"67.19.72.206",80,3,186,3,186,0,0,85354.423228,9.030255000005127,164.77939991718452,0
"147.32.84.165",1446,"174.37.196.55",80,3,186,3,186,0,0,85354.423551,9.02998099999968,164.7843998785881,0
"147.32.84.165",1447,"193.23.181.44",179,3,186,3,186,0,0,85354.423771,9.029802999997628,164.78764819126076,0
"147.32.84.165",1448,"193.23.181.44",179,3,186,3,186,0,0,85354.423987,9.029634999998962,164.79071413187478,0
"147.32.84.165",1450,"174.37.196.55",80,3,186,3,186,0,0,85354.424319,9.029349000004004,164.79593379316051,0
"147.32.84.165",1451,"193.23.181.44",179,3,186,3,186,0,0,85354.424538,9.029177999997046,164.79905479773316,0
"147.32.84.165",1449,"174.128.246.102",80,3,186,3,186,0,0,85354.42475,9.029011999999057,164.80208465778486,0
"147.32.84.165",1452,"174.37.196.55",80,3,186,3,186,0,0,85354.523515,9.03165699999954,164.75382092124133,0
"147.32.84.165",1453,"67.19.72.206",80,3,186,3,186,0,0,85354.523994,9.03123599999526,164.76150108365908,0
"147.32.84.165",1454,"193.23.181.44",179,3,186,3,186,0,0,85354.524206,9.031044999996084,164.7649856689503,0
"147.32.84.165",1455,"174.128.246.102",80,3,186,3,186,0,0,85354.524314,9.030957000009948,164.76659118168328,0
"147.32.84.165",1456,"174.128.246.102",80,3,186,3,186,0,0,85354.524427,9.030864000000292,164.76828795118072,0
"147.32.84.165",1457,"174.37.196.55",80,3,186,3,186,0,0,85354.524564,9.03075199999148,164.77033141884573,0
"147.32.84.165",1458,"174.37.196.55",80,3,186,3,186,0,0,85354.524672,9.030666999999085,164.77188229841173,0
"147.32.84.165",1459,"193.23.181.44",179,3,186,3,186,0,0,85354.524779,9.030582999999751,164.7734149611427,0
"147.32.84.165",1460,"174.128.246.102",80,3,186,3,186,0,0,85354.524886,9.030499000000418,164.77494765238677,0
"147.32.84.165",1461,"174.128.246.102",80,3,186,3,186,0,0,85354.524992,9.030415999994148,164.77646212543965,0
"147.32.84.165",1462,"193.23.181.44",80,3,186,3,186,0,0,85354.5251,9.030331999994814,164.77799487337282,0
"147.32.84.165",1463,"193.23.181.44",80,3,186,3,186,0,0,85354.525245,9.030213999998523,164.7801480673928,0
"147.32.84.165",1464,"174.128.246.102",80,3,186,3,186,0,0,85354.52536,9.030121999996481,164.78182686796256,0
"147.32.84.165",1465,"193.23.181.44",179,3,186,3,186,0,0,85354.525476,9.030028000008315,164.78354219927445,0
"147.32.84.165",1466,"174.37.196.55",80,3,186,3,186,0,0,85354.525589,9.02993800000695,164.78518457146157,0
"147.32.84.165",1467,"193.23.181.44",179,3,186,3,186,0,0,85354.525702,9.029848999998649,164.786808727391,0
"147.32.84.165",1469,"193.23.181.44",80,3,186,3,186,0,0,85354.531563,9.024012000008952,164.89339774797773,0
"147.32.84.165",1470,"193.23.181.44",80,3,186,3,186,0,0,85354.531682,9.023916999998619,164.8951336764542,0
"147.32.84.165",1471,"67.19.72.206",80,3,186,3,186,0,0,85354.531796,9.023826000004192,164.89679654719725,0
"147.32.84.165",1472,"67.19.72.206",80,3,186,3,186,0,0,85354.531909,9.02373699999589,164.89842290402277,0
"147.32.84.165",1473,"193.23.181.44",80,3,186,3,186,0,0,85354.532023,9.023646999994526,164.90006756701615,0
"147.32.84.165",1468,"174.37.196.55",80,3,186,3,186,0,0,85354.532134,9.023560000001453,164.9016574389443,0
"147.32.84.165",1474,"113.193.156.31",6667,6,366,3,186,3,180,85354.611447,1.6627409999928204,894.9078659914112,866.0398703142689
"147.32.84.165",1475,"193.23.181.44",179,3,186,3,186,0,0,85354.621856,9.032139999995707,164.74501059557394,0
"147.32.84.165",1476,"174.128.246.102",80,3,186,3,186,0,0,85354.72274,9.03202300000703,164.7471446871694,0
"147.32.84.165",1477,"193.23.181.44",80,3,186,3,186,0,0,85354.7237,9.03108699999575,164.76421941242512,0
"147.32.84.165",1479,"174.37.196.55",80,3,186,3,186,0,0,85354.724724,9.030083000005106,164.78253854357249,0
"147.32.84.165",1478,"67.19.72.206",80,3,186,3,186,0,0,85354.724878,9.029949000003398,164.78498383539485,0
"147.32.84.165",1480,"67.19.72.206",80,3,186,3,186,0,0,85354.725209,9.029644000009284,164.7905498819743,0
"147.32.84.165",1481,"72.20.15.61",80,3,186,3,186,0,0,85354.725326,9.029550000006566,164.79226539516566,0
"147.32.84.165",1482,"72.20.15.61",80,3,186,3,186,0,0,85354.725442,9.029455000010785,164.79399919466044,0
"147.32.84.165",1483,"67.19.72.206",80,3,186,3,186,0,0,85354.725556,9.029362999994191,164.7956782777431,0
"147.32.84.165",1484,"193.23.181.44",80,3,186,3,186,0,0,85354.72567,9.029271999999764,164.79733914318217,0
"147.32.84.165",1485,"174.37.196.55",80,3,186,3,186,0,0,85354.725818,9.02914499999315,164.79965711051588,0
"147.32.84.165",1486,"67.19.72.206",80,3,186,3,186,0,0,85354.725932,9.029062000001431,164.8011720375565,0
"147.32.84.165",1487,"72.20.15.61",80,3,186,3,186,0,0,85354.726059,9.028959000002942,164.80305204614564,0
"147.32.84.165",1488,"174.128.246.102",80,3,186,3,186,0,0,85354.726166,9.028875000003609,164.80458528879902,0
"147.32.84.165",1489,"174.37.196.55",80,3,186,3,186,0,0,85354.726272,9.028791000004276,164.80611855998166,0
"147.32.84.165",1490,"193.23.181.44",179,3,186,3,186,0,0,85354.72638,9.02870600001188,164.80767011330772,0
"147.32.84.165",1491,"174.37.196.55",80,3,186,3,186,0,0,85354.726488,9.028619999997318,164.80923995034036,0
"147.32.84.165",1492,"193.23.181.44",80,3,186,3,186,0,0,85354.72662,9.028510999996797,164.8112296701558,0
"147.32.84.165",1493,"193.23.181.44",80,3,186,3,186,0,0,85354.726729,9.028424000003724,164.81281782948898,0
"147.32.84.165",1494,"193.23.181.44",179,3,186,3,186,0,0,85354.726835,9.028341000012006,164.8143329985012,0
"147.32.84.165",1495,"193.23.181.44",179,3,186,3,186,0,0,85354.726943,9.028256000005058,164.8158847067658,0
"147.32.84.165",1496,"174.128.246.102",80,3,186,3,186,0,0,85354.727051,9.028170000005048,164.8174547000298,0
"147.32.84.165",1497,"193.23.181.44",179,3,186,3,186,0,0,85354.727184,9.028059999996913,164.81946287469387,0
"147.32.84.165",1498,"174.37.196.55",80,3,186,3,186,0,0,85354.727303,9.027963999993517,164.82121550341455,0
"147.32.84.165",1499,"174.37.196.55",80,3,186,3,186,0,0,85354.727415,9.027874999999767,164.82284036941564,0
"147.32.84.165",1500,"193.23.181.44",80,3,186,3,186,0,0,85354.728768,9.026545000000624,164.84712589367217,0
"147.32.84.165",1501,"193.23.181.44",179,3,186,3,186,0,0,85354.731967,9.025901000000886,164.8588877719636,0
"147.32.84.165",1502,"193.23.181.44",179,3,186,3,186,0,0,85354.735169,9.025928999995813,164.8583763511424,0
"147.32.84.165",1503,"193.23.181.44",179,3,186,3,186,0,0,85354.738361,9.025911999997334,164.85868685629103,0
"147.32.84.165",1504,"174.37.196.55",80,3,186,3,186,0,0,85354.741562,9.02630300000601,164.85154553298392,0
"147.32.84.165",1505,"174.128.246.102",80,3,186,3,186,0,0,85354.823512,9.031109000003198,164.76381804266487,0
"147.32.84.165",1506,"174.37.196.55",80,3,186,3,186,0,0,85354.824087,9.030593000003137,164.77323249973543,0
"147.32.84.165",1507,"174.128.246.102",80,3,186,3,186,0,0,85354.824197,9.030504000009387,164.77485641980263,0
"147.32.84.165",1508,"174.128.246.102",80,3,186,3,186,0,0,85354.824326,9.030400000003283,164.77675407506413,0
"147.32.84.165",1509,"72.20.15.61",80,3,186,3,186,0,0,85354.824434,9.030314000003273,164.77832332291666,0
"147.32.84.165",1510,"174.37.196.55",80,3,186,3,186,0,0,85354.824541,9.0302270000102,164.77991084812368,0
"147.32.84.165",1511,"174.37.196.55",80,3,186,3,186,0,0,85354.824668,9.030123999997159,164.7817903719227,0
"147.32.84.165",1512,"174.128.246.102",80,3,186,3,186,0,0,85354.824782,9.030032000009669,164.78346920569126,0
"147.32.84.165",1513,"174.128.246.102",80,3,186,3,186,0,0,85354.824895,9.029940000007628,164.78514807393438,0
"147.32.84.165",1514,"72.20.15.61",80,3,186,3,186,0,0,85354.825007,9.029850999999326,164.78677222914433,0
"147.32.84.165",1515,"72.20.15.61",80,3,186,3,186,0,0,85354.82512,9.029761000012513,164.78841466545327,0
"147.32.84.165",1517,"193.23.181.44",179,3,186,3,186,0,0,85354.83252,9.022384000010788,164.92315113147708,0
"147.32.84.165",1518,"72.20.15.61",80,3,186,3,186,0,0,85354.832742,9.022184999994352,164.9267887990472,0
"147.32.84.165",1516,"174.128.246.102",80,3,186,3,186,0,0,85354.832956,9.021993999995175,164.93028037934806,0
"147.32.84.165",1520,"174.128.246.102",80,3,186,3,186,0,0,85354.852122,9.0028500000044,165.28099435170782,0
"147.32.84.165",1519,"67.19.72.206",80,3,186,3,186,0,0,85354.852231,9.00276400000439,165.28257321854426,0
"147.32.84.165",1521,"174.128.246.102",80,3,186,3,186,0,0,85354.872758,8.982260000004317,165.65986733842985,0
"147.32.84.165",1522,"72.20.15.61",80,3,186,3,186,0,0,85355.024137,9.03126400000474,164.76099026661373,0
"147.32.84.165",1523,"72.20.15.61",80,3,186,3,186,0,0,85355.024808,9.030715999993845,164.77098825840767,0
"147.32.84.165",1524,"193.23.181.44",179,3,186,3,186,0,0,85355.024949,9.03062299999874,164.77268511820364,0
"147.32.84.165",1525,"67.19.72.206",80,3,186,3,186,0,0,85355.025072,9.030543000000762,164.7741448105473,0
"147.32.84.165",1526,"193.23.181.44",80,3,186,3,186,0,0,85355.025242,9.030421000003116,164.77637089117843,0
"147.32.84.165",1527,"67.19.72.206",80,3,186,3,186,0,0,85355.025455,9.03025300000445,164.7794364121655,0
"147.32.84.165",1528,"193.23.181.44",179,3,186,3,186,0,0,85355.025649,9.030105999991065,164.7821188368633,0
"147.32.84.165",1529,"174.37.196.55",80,3,186,3,186,0,0,85355.025794,9.030008999994607,164.78388891981047,0
"147.32.84.165",1530,"193.23.181.44",80,3,186,3,186,0,0,85355.025945,9.029914999991888,164.7856042943191,0
"147.32.84.165",1531,"67.19.72.206",80,3,186,3,186,0,0,85355.026096,9.029819000003044,164.78735620276535,0
"147.32.84.165",1532,"67.19.72.206",80,3,186,3,186,0,0,85355.026314,9.02964599999541,164.79051338233597,0
"147.32.84.165",1533,"174.128.246.102",80,3,186,3,186,0,0,85355.026436,9.0295710000064,164.79188213913434,0
"147.32.84.165",1534,"193.23.181.44",80,3,186,3,186,0,0,85355.026568,9.029485999999451,164.79343342468113,0
"147.32.84.165",1535,"67.19.72.206",80,3,186,3,186,0,0,85355.026766,9.029334000006202,164.79620756071023,0
"147.32.84.165",1536,"174.128.246.102",80,3,186,3,186,0,0,85355.123563,9.031386000002385,164.75876460153592,0
"147.32.84.165",1537,"72.20.15.61",80,3,186,3,186,0,0,85355.12375,9.031258000002708,164.76109972714252,0
"147.32.84.165",1538,"174.128.246.102",80,10,772,6,530,4,242,85355.123931,9.354527000003145,453.25648212876763,206.95862014181466
"147.32.84.165",1539,"174.128.246.102",80,3,186,3,186,0,0,85355.124334,9.030722000010428,164.7708787844739,0
"147.32.84.165",1540,"174.37.196.55",80,3,186,3,186,0,0,85355.12452,9.030559000006178,164.7738528699034,0
"147.32.84.165",1541,"174.37.196.55",80,3,186,3,186,0,0,85355.124641,9.030459000001429,164.77567751536932,0
"147.32.84.165",1542,"174.37.196.55",80,3,186,3,186,0,0,85355.124851,9.030272000003606,164.77908971063172,0
"147.32.84.165",1543,"193.23.181.44",179,3,186,3,186,0,0,85355.125034,9.03011300000071,164.78199110020915,0
"147.32.84.165",1544,"67.19.72.206",80,3,186,3,186,0,0,85355.125206,9.029962000000523,164.78474660246783,0
"147.32.84.165",1545,"193.23.181.44",80,3,186,3,186,0,0,85355.125347,9.029842000003555,164.7869364712488,0
"147.32.84.165",1546,"193.23.181.44",80,3,186,3,186,0,0,85355.125506,9.029710000002524,164.78934539421357,0
"147.32.84.165",1547,"193.23.181.44",179,3,186,3,186,0,0,85355.125656,9.029584999996587,164.7916266362809,0
"147.32.84.165",1548,"72.20.15.61",80,3,186,3,186,0,0,85355.125845,9.02941699999792,164.79469272493924,0
"147.32.84.165",1549,"174.128.246.102",80,3,186,3,186,0,0,85355.223883,9.032540000000154,164.73771497275126,0
"147.32.84.165",1550,"174.128.246.102",80,7,560,4,378,3,182,85355.224633,0.3344929999875603,9040.547934074739,4352.856412702652
"147.32.84.165",1551,"72.20.15.61",80,3,186,3,186,0,0,85355.225096,9.031386000002385,164.75876460153592,0
"147.32.84.165",1552,"193.23.181.44",179,3,186,3,186,0,0,85355.225425,9.03107799999998,164.7643836095761,0
"147.32.84.165",1553,"193.23.181.44",179,3,186,3,186,0,0,85355.225543,9.030987000005553,164.76604384427583,0
"147.32.84.165",1554,"193.23.181.44",80,3,186,3,186,0,0,85355.225661,9.03089199999522,164.76777709231686,0
"147.32.84.165",1555,"72.20.15.61",80,3,186,3,186,0,0,85355.225786,9.030790000004345,164.76963809359802,0
"147.32.84.165",1556,"193.23.181.44",80,3,186,3,186,0,0,85355.225902,9.030696000001626,164.77135317142023,0
"147.32.84.165",1557,"193.23.181.44",179,3,186,3,186,0,0,85355.226015,9.030607000007876,164.77297705444408,0
"147.32.84.165",1558,"193.23.181.44",80,3,186,3,186,0,0,85355.226131,9.03051699999196,164.7746192163001,0
"147.32.84.165",1559,"174.37.196.55",80,3,186,3,186,0,0,85355.226245,9.030425999997533,164.77627965728377,0
"147.32.84.165",1560,"193.23.181.44",179,3,186,3,186,0,0,85355.226364,9.030329000001075,164.778049614784,0
"147.32.84.165",1561,"174.37.196.55",80,3,186,3,186,0,0,85355.232814,9.02390299999388,164.89538950064173,0
"147.32.84.165",1562,"174.128.246.102",80,3,186,3,186,0,0,85355.262219,8.994522000008146,165.43402751126212,0
"147.32.84.165",1564,"67.19.72.206",80,3,186,3,186,0,0,85355.282234,8.974534000008134,165.8024806634697,0
"147.32.84.165",1565,"193.23.181.44",80,3,186,3,186,0,0,85355.282347,8.974442999999155,165.80416188504847,0
"147.32.84.165",1566,"193.23.181.44",80,3,186,3,186,0,0,85355.282457,8.974356000006082,165.80576923837114,0
"147.32.84.165",1567,"67.19.72.206",80,3,186,3,186,0,0,85355.282565,8.97426999999152,165.80735814739316,0
"147.32.84.165",1563,"72.20.15.61",80,3,186,3,186,0,0,85355.28267,8.974187999992864,165.80887318175004,0
"147.32.84.165",1569,"174.128.246.102",80,3,186,3,186,0,0,85355.326261,9.029578000001493,164.7917543876086,0
"147.32.84.165",1568,"174.37.196.55",80,3,186,3,186,0,0,85355.326483,9.029401000007056,164.794984739169,0
"147.32.84.165",1570,"193.23.181.44",80,3,186,3,186,0,0,85355.326725,9.029199999989942,164.79865325850105,0
"147.32.84.165",1571,"72.20.15.61",80,3,186,3,186,0,0,85355.327002,9.028965999998036,164.80292427730083,0
"147.32.84.165",1572,"174.128.246.102",80,3,186,3,186,0,0,85355.32727,9.028739000001224,164.80706774221719,0
"147.32.84.165",1573,"193.23.181.44",80,3,186,3,186,0,0,85355.327631,9.028419000009308,164.8129091038493,0
"147.32.84.165",1574,"72.20.15.61",80,3,186,3,186,0,0,85355.327888,9.028204000002006,164.81683400149902,0
"147.32.84.165",1575,"72.20.15.61",80,3,186,3,186,0,0,85355.32822,9.027910999997403,164.8221831163852,0
"147.32.84.165",1576,"67.19.72.206",80,3,186,3,186,0,0,85355.328478,9.027694000003976,164.82614497116813,0
"147.32.84.165",1577,"174.37.196.55",80,3,186,3,186,0,0,85355.328733,9.027482000004966,164.8300157230091,0
"147.32.84.165",1578,"174.128.246.102",80,3,186,3,186,0,0,85355.329049,9.027205999998841,164.83505527626056,0
"147.32.84.165",1579,"67.19.72.206",80,3,186,3,186,0,0,85355.329441,9.026854000010644,164.8414829793686,0
"147.32.84.165",1580,"72.20.15.61",80,3,186,3,186,0,0,85355.329794,9.026541999992332,164.84718068129123,0
"147.32.84.165",1581,"174.37.196.55",80,3,186,3,186,0,0,85355.33014,9.026235999990604,164.85276919432962,0
"147.32.84.165",1582,"193.23.181.44",179,3,186,3,186,0,0,85355.330398,9.026017999989563,164.8567507844235,0
"147.32.84.165",1583,"174.128.246.102",80,3,186,3,186,0,0,85355.330637,9.025818999987678,164.8603855231344,0
"147.32.84.165",1584,"72.20.15.61",80,3,186,3,186,0,0,85355.330874,9.02562199998647,164.86398388966774,0
"147.32.84.165",1585,"174.128.246.102",80,3,186,3,186,0,0,85355.331178,9.025357000005897,164.86882457935212,0
"147.32.84.165",1586,"193.23.181.44",179,3,186,3,186,0,0,85355.331426,9.025150000001304,164.8726059954444,0
"147.32.84.165",1587,"174.37.196.55",80,3,186,3,186,0,0,85355.331734,9.024881999997888,164.8775019995107,0
"147.32.84.165",1588,"174.37.196.55",80,3,186,3,186,0,0,85355.331982,9.024676000000909,164.8812655434777,0
"147.32.84.165",1589,"72.20.15.61",80,3,186,3,186,0,0,85355.33223,9.02447000000393,164.8850292592642,0
"147.32.84.165",1590,"174.128.246.102",80,3,186,3,186,0,0,85355.393141,8.963599000009708,166.00474876200826,0
"147.32.84.165",1591,"72.20.15.61",80,3,186,3,186,0,0,85355.425929,9.030792999998084,164.76958335777553,0
"147.32.84.165",1592,"67.19.72.206",80,3,186,3,186,0,0,85355.426455,9.030387000006158,164.77699128497875,0
"147.32.84.165",1593,"72.20.15.61",80,3,186,3,186,0,0,85355.426697,9.03019299999869,164.78053126884618,0
"147.32.84.165",1594,"67.19.72.206",80,3,186,3,186,0,0,85355.426848,9.030085999998846,164.78248379917866,0
"147.32.84.165",1595,"193.23.181.44",179,3,186,3,186,0,0,85355.426958,9.030029000001377,164.78352395100538,0
"147.32.84.165",1596,"193.23.181.44",179,3,186,3,186,0,0,85355.42708,9.029954000012367,164.78489259169672,0
"147.32.84.165",1597,"72.20.15.61",80,3,186,3,186,0,0,85355.427188,9.029893999992055,164.78598752115022,0
"147.32.84.165",1598,"193.23.181.44",179,3,186,3,186,0,0,85355.427297,9.029829999999492,164.78715546140776,0
"147.32.84.165",1599,"174.37.196.55",80,3,186,3,186,0,0,85355.427403,9.029771000001347,164.78823217109027,0
"147.32.84.165",1600,"193.23.181.44",80,3,186,3,186,0,0,85355.42751,9.029711000010138,164.78932714439358,0
"147.32.84.165",1602,"67.19.72.206",80,3,186,3,186,0,0,85355.443247,9.014022999996087,165.0761263867028,0
"147.32.84.165",1601,"67.19.72.206",80,3,186,3,186,0,0,85355.443356,9.013961999997264,165.0772435029626,0
"147.32.84.165",1604,"72.20.15.61",80,3,186,3,186,0,0,85355.462593,8.994775999992271,165.42935588404632,0
"147.32.84.165",1605,"193.23.181.44",179,3,186,3,186,0,0,85355.462708,8.99470699999074,165.43062492213832,0
"147.32.84.165",1606,"193.23.181.44",179,3,186,3,186,0,0,85355.462818,8.994644000005792,165.4317836257935,0
"147.32.84.165",1607,"174.128.246.102",80,3,186,3,186,0,0,85355.462926,8.994584000000032,165.4328871685444,0
"147.32.84.165",1608,"67.19.72.206",80,3,186,3,186,0,0,85355.463035,8.994524000008823,165.4339907257505,0
"147.32.84.165",1603,"67.19.72.206",80,3,186,3,186,0,0,85355.463142,8.994453999999678,165.43527822812294,0
"147.32.84.165",1609,"72.20.15.61",80,3,186,3,186,0,0,85355.483484,8.974163000006229,165.80933508773657,0
"147.32.84.165",1610,"193.23.181.44",80,3,186,3,186,0,0,85355.489462,8.968233999999939,165.91895349742327,0
"147.32.84.165",1611,"193.23.181.44",80,3,186,3,186,0,0,85355.52474,9.03226100000029,164.7428036014407,0
"147.32.84.165",1612,"174.37.196.55",80,3,186,3,186,0,0,85355.525173,9.031875999993645,164.74982606061542,0
"147.32.84.165",1613,"193.23.181.44",80,3,186,3,186,0,0,85355.525445,9.03165399999125,164.75387564685735,0
"147.32.84.165",1614,"67.19.72.206",80,3,186,3,186,0,0,85355.525585,9.0315649999975,164.75549918540275,0
"147.32.84.165",1615,"72.20.15.61",80,3,186,3,186,0,0,85355.525704,9.031497999996645,164.7567214210259,0
"147.32.84.165",1617,"174.37.196.55",80,3,186,3,186,0,0,85355.525867,9.03138499999477,164.75878284458713,0
"147.32.84.165",1616,"193.23.181.44",80,3,186,3,186,0,0,85355.525987,9.03131599999324,164.76004161532094,0
"147.32.84.165",1618,"174.128.246.102",80,3,186,3,186,0,0,85355.526095,9.031257000009646,164.76111797044538,0
"147.32.84.165",1619,"193.23.181.44",179,3,186,3,186,0,0,85355.625662,9.031578999987687,164.75524379535722,0
"147.32.84.165",1620,"67.19.72.206",80,3,186,3,186,0,0,85355.625907,9.031400000007125,164.75850920110128,0
"147.32.84.165",1621,"174.128.246.102",80,3,186,3,186,0,0,85355.727612,9.029314999992494,164.79655433454664,0
"147.32.84.165",1622,"174.128.246.102",80,3,186,3,186,0,0,85355.729156,9.027841999995871,164.82344285607573,0
"147.32.84.165",1623,"193.23.181.44",179,3,186,3,186,0,0,85355.729396,9.02762600001006,164.8273865131699,0
"147.32.84.165",1624,"174.37.196.55",80,3,186,3,186,0,0,85355.729762,9.027291999998852,164.8334849476664,0
"147.32.84.165",1625,"72.20.15.61",80,3,186,3,186,0,0,85355.73005,9.027031000005081,164.83825080462915,0
"147.32.84.165",1626,"72.20.15.61",80,3,186,3,186,0,0,85355.730281,9.026826000001165,164.8419942956481,0
"147.32.84.165",1627,"72.20.15.61",80,3,186,3,186,0,0,85355.730511,9.02662400000554,164.84568317004084,0
"147.32.84.165",1628,"174.37.196.55",80,3,186,3,186,0,0,85355.730745,9.026418000008562,164.84944526151887,0
"147.32.84.165",1629,"67.19.72.206",80,3,186,3,186,0,0,85355.730974,9.026218999992125,164.85307967835683,0
"147.32.84.165",1630,"193.23.181.44",80,3,186,3,186,0,0,85355.731205,9.02601400000276,164.85682384267795,0
"147.32.84.165",1631,"72.20.15.61",80,3,186,3,186,0,0,85355.731438,9.025806999998167,164.86060470828838,0
"147.32.84.165",1632,"72.20.15.61",80,3,186,3,186,0,0,85355.731667,9.025605000002543,164.86429441567415,0
"147.32.84.165",1633,"193.23.181.44",179,3,186,3,186,0,0,85355.731895,9.025408000001335,164.86789295284822,0
"147.32.84.165",1634,"72.20.15.61",80,3,186,3,186,0,0,85355.732125,9.025204999998095,164.87160125452152,0
"147.32.84.165",1635,"193.23.181.44",80,3,186,3,186,0,0,85355.732352,9.025004999988596,164.87525491696462,0
"147.32.84.165",1636,"193.23.181.44",80,3,186,3,186,0,0,85355.732579,9.024804999993648,164.87890874108052,0
"147.32.84.165",1637,"193.23.181.44",80,3,186,3,186,0,0,85355.73281,9.024602000004961,164.88261753805673,0
"147.32.84.165",1638,"72.20.15.61",80,3,186,3,186,0,0,85355.733044,9.024397000001045,164.88636304451452,0
"147.32.84.165",1639,"67.19.72.206",80,3,186,3,186,0,0,85355.733272,9.026268000001437,164.85218475673037,0
"147.32.84.165",1640,"193.23.181.44",80,3,186,3,186,0,0,85355.733503,9.029235000009066,164.79801444956365,0
"147.32.84.165",1641,"67.19.72.206",80,3,186,3,186,0,0,85355.73373,9.032207999989623,164.74377029423033,0
"147.32.84.165",1642,"72.20.15.61",80,3,186,3,186,0,0,85355.734097,9.035038000001805,164.69216842250168,0
"147.32.84.165",1643,"193.23.181.44",179,3,186,3,186,0,0,85355.734331,9.038021000000299,164.6378117510405,0
"147.32.84.165",1644,"193.23.181.44",179,3,186,3,186,0,0,85355.734557,9.04098299999896,164.58387323592703,0
"147.32.84.165",1646,"67.19.72.206",80,3,186,3,186,0,0,85355.734785,9.043977000008454,164.52938790076635,0
"147.32.84.165",1645,"174.37.196.55",80,3,186,3,186,0,0,85355.735012,9.046976999990875,164.47482954820165,0
"147.32.84.165",1648,"193.23.181.44",80,3,186,3,186,0,0,85355.827198,9.071137999999337,164.03675040552892,0
"147.32.84.165",1647,"67.19.72.206",80,3,186,3,186,0,0,85355.82734,9.074196999994456,163.98145202279707,0
"147.32.84.165",1649,"174.128.246.102",80,3,186,3,186,0,0,85355.827723,9.077014000009513,163.93056130556155,0
"147.32.84.165",1650,"72.20.15.61",80,9,718,6,536,3,182,85355.827961,9.477012999996077,452.463239208575,153.63490585067285
"147.32.84.165",1651,"67.19.72.206",80,3,186,3,186,0,0,85355.828084,9.083104000004823,163.82064985705435,0
"147.32.84.165",1652,"193.23.181.44",80,3,186,3,186,0,0,85355.828221,9.08611399999063,163.76638021507705,0
"147.32.84.165",1653,"72.20.15.61",80,3,186,3,186,0,0,85355.828346,9.089193000007072,163.71090370716544,0
"147.32.84.165",1654,"174.37.196.55",80,3,186,3,186,0,0,85355.82847,9.092270000008284,163.6555007713854,0
"147.32.84.165",1655,"174.37.196.55",80,3,186,3,186,0,0,85355.828591,9.095346000001882,163.60015330914206,0
"147.32.84.165",1656,"193.23.181.44",80,3,186,3,186,0,0,85355.828706,9.098450999998022,163.54432199506525,0
"147.32.84.165",1657,"174.128.246.102",80,3,186,3,186,0,0,85355.828822,9.101536000001943,163.4888880294142,0
"147.32.84.165",1658,"72.20.15.61",80,3,186,3,186,0,0,85355.828935,9.104602000006707,163.43383269240147,0
"147.32.84.165",1659,"174.128.246.102",80,3,186,3,186,0,0,85355.829099,9.107657000000472,163.37901174801848,0
"147.32.84.165",1660,"174.128.246.102",80,3,186,3,186,0,0,85355.829232,9.110741999989841,163.3236897721019,0
"147.32.84.165",1661,"174.37.196.55",80,3,186,3,186,0,0,85355.829353,9.11378300000797,163.26919348405582,0
"147.32.84.165",1663,"67.19.72.206",80,3,186,3,186,0,0,85355.843543,9.102794999998878,163.46627601744117,0
"147.32.84.165",1662,"174.128.246.102",80,3,186,3,186,0,0,85355.84366,9.1058950000006,163.4106257539651,0
"147.32.84.165",1664,"46.4.36.120",443,6,366,3,186,3,180,85355.850519,1.0072030000010272,1477.358586102784,1429.7018575188233
"147.32.84.165",1665,"184.82.148.43",80,10,1919,5,979,5,940,85355.871679,0.32274499999766704,24266.83604720945,23300.12858465463
"147.32.84.165",1666,"174.128.246.102",80,3,186,3,186,0,0,85355.926724,9.03252199999406,164.7380432620013,0
"147.32.84.165",1667,"174.37.196.55",80,3,186,3,186,0,0,85355.927105,9.03525700001046,164.68817655084712,0
"147.32.84.165",1668,"72.20.15.61",80,8,657,4,415,4,242,85355.928218,0.36983900000632275,8976.87912833217,5234.710238690085
"147.32.84.165",1669,"193.23.181.44",80,3,186,3,186,0,0,85355.928959,9.036577999999281,164.6641018314807,0
"147.32.84.165",1670,"174.37.196.55",80,3,186,3,186,0,0,85355.929261,9.039478999999119,164.6112569098446,0
"147.32.84.165",1671,"174.37.196.55",80,3,186,3,186,0,0,85355.929514,9.042442999998457,164.55729939356587,0
"147.32.84.165",1672,"193.23.181.44",80,3,186,3,186,0,0,85355.929732,9.04542899999069,164.50297713923038,0
"147.32.84.165",1673,"193.23.181.44",80,3,186,3,186,0,0,85355.930002,9.04835599999933,164.44976302878777,0
"147.32.84.165",1674,"193.23.181.44",179,3,186,3,186,0,0,85355.93022,9.0513370000117,164.3956025499964,0
"147.32.84.165",1675,"174.128.246.102",80,3,186,3,186,0,0,85355.930435,9.0543539999926,164.34082431515446,0
"147.32.84.165",1676,"193.23.181.44",179,3,186,3,186,0,0,85355.930675,9.057310000003781,164.2871890218375,0
"147.32.84.165",1678,"67.19.72.206",80,3,186,3,186,0,0,85355.930973,9.060215999998036,164.2344950716763,0
"147.32.84.165",1677,"193.23.181.44",80,3,186,3,186,0,0,85355.931192,9.063146000000415,164.18140014515177,0
"147.32.84.165",1679,"174.128.246.102",80,3,186,3,186,0,0,85356.02762,9.032122000004165,164.74533891363666,0
"147.32.84.165",1680,"72.20.15.61",80,3,186,3,186,0,0,85356.028194,9.031606000004103,164.75475125900354,0
"147.32.84.165",1681,"67.19.72.206",80,3,186,3,186,0,0,85356.028334,9.03148799999326,164.75690384586798,0
"147.32.84.165",1682,"193.23.181.44",179,3,186,3,186,0,0,85356.028451,9.031397999991896,164.75854568709465,0
"147.32.84.165",1683,"174.128.246.102",80,3,186,3,186,0,0,85356.028567,9.031304999996792,164.76024229062452,0
"147.32.84.165",1684,"193.23.181.44",80,3,186,3,186,0,0,85356.028692,9.031200999990688,164.7621396092872,0
"147.32.84.165",1685,"174.37.196.55",80,3,186,3,186,0,0,85356.02881,9.031105999994907,164.7638727749225,0
"147.32.84.165",1686,"174.128.246.102",80,3,186,3,186,0,0,85356.028923,9.031015999993542,164.76551475504684,0
"147.32.84.165",1687,"72.20.15.61",80,3,186,3,186,0,0,85356.029075,9.03088600000774,164.76788656159812,0
"147.32.84.165",1688,"174.128.246.102",80,3,186,3,186,0,0,85356.029189,9.030792000005022,164.76960160295715,0
"147.32.84.165",1689,"72.20.15.61",80,3,186,3,186,0,0,85356.0293,9.030706999998074,164.77115246905004,0
"147.32.84.165",1690,"174.128.246.102",80,3,186,3,186,0,0,85356.029415,9.03061400000297,164.7728493322282,0
"147.32.84.165",1691,"72.20.15.61",80,3,186,3,186,0,0,85356.029532,9.030518999992637,164.7745827234529,0
"147.32.84.165",1692,"193.23.181.44",179,3,186,3,186,0,0,85356.029643,9.030431999999564,164.77617017658423,0
"147.32.84.165",1693,"72.20.15.61",80,3,186,3,186,0,0,85356.029761,9.03033900000446,164.77786714311225,0
"147.32.84.165",1694,"174.128.246.102",80,3,186,3,186,0,0,85356.02988,9.030241000000387,164.7796553823908,0
"147.32.84.165",1695,"72.20.15.61",80,3,186,3,186,0,0,85356.029994,9.030146999997669,164.78137066875922,0
"147.32.84.165",1696,"174.37.196.55",80,3,186,3,186,0,0,85356.030136,9.030027999993763,164.78354219954,0
"147.32.84.165",1697,"72.20.15.61",80,3,186,3,186,0,0,85356.033666,9.027870999998413,164.82291339788324,0
"147.32.84.165",1698,"184.82.148.44",80,10,1513,5,596,5,917,85356.09491,0.3406140000006417,13998.250218696288,21537.576259302845
"147.32.84.165",1699,"174.128.246.102",80,7,621,4,439,3,182,85356.113934,0.325010000000475,10805.821359326997,4479.862158080897
"147.32.84.165",1700,"72.20.15.61",80,3,186,3,186,0,0,85356.12741,9.032502999994904,164.7383897908298,0
"147.32.84.165",1701,"193.23.181.44",179,3,186,3,186,0,0,85356.128146,9.031900999994832,164.7493700385834,0
"147.32.84.165",1702,"174.37.196.55",80,3,186,3,186,0,0,85356.128491,9.031606000004103,164.75475125900354,0
"147.32.84.165",1703,"193.23.181.44",179,3,186,3,186,0,0,85356.128746,9.031394999998156,164.75860041558406,0
"147.32.84.165",1704,"193.23.181.44",80,3,186,3,186,0,0,85356.129026,9.031712000010884,164.75281762729003,0
"147.32.84.165",1705,"174.37.196.55",80,3,186,3,186,0,0,85356.129255,9.034700999996858,164.6983115435162,0
"147.32.84.165",1706,"72.20.15.61",80,3,186,3,186,0,0,85356.227361,9.062976000001072,164.18447979999328,0
"147.32.84.165",1707,"174.37.196.55",80,3,186,3,186,0,0,85356.277368,9.016190000009374,165.03645109502494,0
"147.32.84.165",1708,"174.128.246.102",80,8,652,4,410,4,242,85356.328297,0.320028000001912,10249.103203408464,6049.470671280117
"147.32.84.165",1709,"72.20.15.61",80,3,186,3,186,0,0,85356.328656,9.111681000009412,163.30685852571693,0
"147.32.84.165",1710,"193.23.181.44",179,3,186,3,186,0,0,85356.328941,9.114595999999437,163.25463026557532,0
"147.32.84.165",1711,"217.163.21.36",80,13,6077,6,749,7,5328,85356.335586,0.1862600000022212,32170.084827276623,228841.40448562062
"147.32.84.165",1712,"174.37.196.55",80,3,186,3,186,0,0,85356.427988,9.032867000001715,164.73175128115108,0
"147.32.84.165",1713,"193.23.181.44",80,3,186,3,186,0,0,85356.428137,9.032781000001705,164.7333196719503,0
"147.32.84.165",1714,"217.163.21.36",80,10,1448,5,699,5,749,85356.482705,0.13866699999198318,40326.82613976861,43211.43459039583
"147.32.84.165",1715,"193.23.181.44",80,3,186,3,186,0,0,85356.48919,8.971750000011525,165.85393039240822,0
"147.32.84.165",1716,"217.163.21.35",80,11,3742,6,2114,5,1628,85356.576001,0.22783300001174212,74229.80867182711,57164.677633743864
"147.32.84.165",1717,"217.163.21.36",80,10,2274,5,1154,5,1120,85356.759933,0.1497010000020964,61669.59472462252,59852.63959408771
"147.32.84.165",1718,"174.37.196.55",80,3,186,3,186,0,0,85356.830565,9.03120399999898,164.76208487818104,0
"147.32.84.165",1719,"193.23.181.44",179,3,186,3,186,0,0,85356.830711,9.031117999998969,164.76365384664112,0
"147.32.84.165",1720,"217.163.21.35",80,13,5645,7,2629,6,3016,85356.864152,0.15665699999954086,134255.09233587803,154018.01387790343
"147.32.84.165",1721,"173.241.240.4",80,9,2194,5,1164,4,1030,85356.977935,0.06710899999598041,138759.33184159733,122785.3194130973
"147.32.84.165",1722,"174.37.196.55",80,3,186,3,186,0,0,85357.033356,9.029374999998254,164.79545926493117,0
"147.32.84.165",1723,"174.128.246.102",80,3,186,3,186,0,0,85357.034914,9.027877000000444,164.82280385520613,0
"147.32.84.165",1724,"67.19.72.206",80,3,186,3,186,0,0,85357.038096,9.024715999999898,164.8805347448071,0
"147.32.84.165",1725,"174.37.196.55",80,3,186,3,186,0,0,85357.16694,8.996561000007205,165.39653318627066,0
"147.32.84.165",1726,"174.37.196.55",80,3,186,3,186,0,0,85357.170111,8.99344900000142,165.45376529068716,0
"147.32.84.165",1727,"174.37.196.55",80,3,186,3,186,0,0,85357.173312,8.990269000001717,165.51228889810926,0
"147.32.84.165",1728,"193.23.181.44",80,3,186,3,186,0,0,85357.176564,8.987045000001672,165.57166454599073,0
"147.32.84.165",1729,"193.23.181.44",179,3,186,3,186,0,0,85357.179712,8.983919999998761,165.62925760694722,0
"147.32.84.165",1730,"193.23.181.44",179,3,186,3,186,0,0,85357.201334,8.962318999998388,166.02845759007994,0
"147.32.84.165",1731,"174.37.196.55",80,3,186,3,186,0,0,85357.364512,8.89836199999263,167.22178756059063,0
"147.32.84.165",1732,"67.19.72.206",80,3,186,3,186,0,0,85357.367712,8.895185999994283,167.28149360799836,0
"147.32.84.165",1733,"193.23.181.44",179,3,186,3,186,0,0,85357.370912,8.892009000002872,167.3412611255251,0
"147.32.84.165",1734,"193.23.181.44",179,3,186,3,186,0,0,85357.374112,8.88883199999691,167.40107136691495,0
"147.32.84.165",1735,"174.37.196.55",80,3,186,3,186,0,0,85357.377345,8.885622000001604,167.46154630477545,0
"147.32.84.165",1736,"193.23.181.44",179,3,186,3,186,0,0,85357.380541,8.882448999996996,167.52136713652996,0
"147.32.84.165",1737,"67.19.72.206",80,3,186,3,186,0,0,85357.383759,8.879254999992554,167.58162706232085,0
"147.32.84.165",1738,"193.23.181.44",80,3,186,3,186,0,0,85357.38693,8.8761080000113,167.64104267299425,0
"147.32.84.165",1739,"193.23.181.44",80,3,186,3,186,0,0,85357.390111,8.872948000003817,167.70074613300562,0
"147.32.84.165",1740,"193.23.181.44",179,3,186,3,186,0,0,85357.393329,8.86975500000699,167.76111628774723,0
"147.32.84.165",1741,"67.19.72.206",80,3,186,3,186,0,0,85357.416929,8.84617900000012,168.2082173557623,0
"147.32.84.165",1742,"67.19.72.206",80,3,186,3,186,0,0,85357.439331,8.925527999992482,166.71282640099872,0
"147.32.84.165",1743,"67.19.72.206",80,3,186,3,186,0,0,85357.442514,8.922367999999551,166.7718704272313,0
"147.32.84.165",1744,"193.23.181.44",80,3,186,3,186,0,0,85357.445741,8.919161999991047,166.83181671119928,0
"147.32.84.165",1745,"174.37.196.55",80,3,186,3,186,0,0,85357.448933,8.91599199999473,166.89113224875925,0
"147.32.84.165",1746,"72.20.15.61",80,3,186,3,186,0,0,85357.452133,8.912815999996383,166.9506023686121,0
"147.32.84.165",1747,"193.23.181.44",80,3,186,3,186,0,0,85357.455313,8.909660999997868,167.0097212453264,0
"147.32.84.165",1748,"174.128.246.102",80,3,186,3,186,0,0,85357.632853,9.031221999990521,164.76175649336955,0
"147.32.84.165",1749,"72.20.15.61",80,3,186,3,186,0,0,85357.633048,9.03116399999999,164.76281462721767,0
"147.32.84.165",1750,"67.19.72.206",80,3,186,3,186,0,0,85357.633185,9.03107799999998,164.7643836095761,0
"147.32.84.165",1751,"193.23.181.44",80,3,186,3,186,0,0,85357.633368,9.030943999998271,164.7668283626036,0
"147.32.84.165",1752,"193.23.181.44",179,3,186,3,186,0,0,85357.746285,9.018968000003952,164.98561697960875,0
"147.32.84.165",1753,"174.37.196.55",80,3,186,3,186,0,0,85357.74948,9.01579700000002,165.0436450598873,0
"147.32.84.165",1754,"67.19.72.206",80,3,186,3,186,0,0,85357.7527,9.012601000009454,165.10217194774728,0
"147.32.84.165",1755,"193.23.181.44",179,3,186,3,186,0,0,85357.755852,9.009473999991314,165.1594754589929,0
"147.32.84.165",1756,"193.23.181.44",179,3,186,3,186,0,0,85357.759056,9.00629299999855,165.2178093695419,0
"147.32.84.165",1757,"72.20.15.61",80,3,186,3,186,0,0,85357.762255,9.003117000000202,165.27609271321995,0
"147.32.84.165",1758,"72.20.15.61",80,3,186,3,186,0,0,85357.765485,8.999909000005573,165.33500505383762,0
"147.32.84.165",1759,"193.23.181.44",80,3,186,3,186,0,0,85357.768702,8.996715999994194,165.39368365089663,0
"147.32.84.165",1760,"174.128.246.102",80,3,186,3,186,0,0,85357.771906,8.993536000009044,165.45216475460862,0
"147.32.84.165",1761,"193.23.181.44",80,3,186,3,186,0,0,85357.775086,8.990383000011207,165.51019016633055,0
"147.32.84.165",1762,"193.23.181.44",80,3,186,3,186,0,0,85357.778305,8.98718799999915,165.56903004589876,0
"147.32.84.165",1763,"193.23.181.44",179,3,186,3,186,0,0,85357.7815,8.984020000003511,165.62741400836356,0
"147.32.84.165",1764,"67.19.72.206",80,3,186,3,186,0,0,85357.784706,8.980836999995518,165.68611589328953,0
"147.32.84.165",1765,"174.37.196.55",80,3,186,3,186,0,0,85357.787904,8.97766099999717,165.7447301697479,0
"147.32.84.165",1766,"46.4.36.120",443,6,366,3,186,3,180,85357.857181,1.0076510000071721,1476.7017548629524,1429.0662143835025
"147.32.84.165",1767,"31.192.109.161",80,10,1174,5,540,5,634,85357.936634,0.24170100000628736,17873.322824016548,20984.604945234245
"147.32.84.165",1768,"174.128.246.102",80,3,186,3,186,0,0,85358.034944,9.03181100000802,164.751011729395,0
"147.32.84.165",1769,"174.37.196.55",80,3,186,3,186,0,0,85358.035207,9.03167100000428,164.75356553613332,0
"147.32.84.165",1770,"72.20.15.61",80,3,186,3,186,0,0,85358.135225,9.030919999990147,164.7672662366208,0
"147.32.84.165",1771,"174.37.196.55",80,3,186,3,186,0,0,85358.135355,9.030898999990313,164.76764937816225,0
"147.32.84.165",1772,"174.37.196.55",80,3,186,3,186,0,0,85358.135494,9.030801999993855,164.7694191502607,0
"147.32.84.165",1773,"193.23.181.44",179,3,186,3,186,0,0,85358.135644,9.030689999999595,164.77146264571886,0
"147.32.84.165",1774,"193.23.181.44",179,3,186,3,186,0,0,85358.23648,9.030946999992011,164.76677362864783,0
"147.32.84.165",1775,"67.19.72.206",80,3,186,3,186,0,0,85358.236979,9.030496999999741,164.77498414539562,0
"147.32.84.165",1776,"193.23.181.44",179,3,186,3,186,0,0,85358.237203,9.030320000005304,164.77821383950138,0
"147.32.84.165",1777,"193.23.181.44",80,3,186,3,186,0,0,85358.237422,9.030146999997669,164.78137066875922,0
"147.32.84.165",1779,"67.19.72.206",80,3,186,3,186,0,0,85358.237709,9.029907000003732,164.78575028506773,0
"147.32.84.165",1780,"174.37.196.55",80,3,186,3,186,0,0,85358.237926,9.029737999997451,164.78883440476568,0
"147.32.84.165",1778,"72.20.15.61",80,3,186,3,186,0,0,85358.238201,9.029508999999962,164.79301366220537,0
"147.32.84.165",1781,"193.23.181.44",179,3,186,3,186,0,0,85358.336,9.031027999997605,164.7652958224019,0
"147.32.84.165",1782,"174.37.196.55",80,3,186,3,186,0,0,85358.33623,9.030824000001303,164.7690177551667,0
"147.32.84.165",1783,"193.23.181.44",80,3,186,3,186,0,0,85358.33829,9.028785000002244,164.8062280804815,0
"147.32.84.165",1784,"193.23.181.44",179,3,186,3,186,0,0,85358.341491,9.025605000002543,164.86429441567415,0
"147.32.84.165",1785,"72.20.15.61",80,3,186,3,186,0,0,85358.344691,9.022429999997257,164.92231028674672,0
"147.32.84.165",1786,"193.23.181.44",179,3,186,3,186,0,0,85358.436121,9.030997999987449,164.76584315510513,0
"147.32.84.165",1787,"174.128.246.102",80,3,186,3,186,0,0,85358.636458,9.031276000008802,164.7607713459925,0
"147.32.84.165",1789,"193.23.181.44",80,3,186,3,186,0,0,85358.739022,9.028757000007317,164.80673917780643,0
"147.32.84.165",1788,"72.20.15.61",80,3,186,3,186,0,0,85358.742199,9.025628999996115,164.86385602606094,0
"147.32.84.165",1790,"72.20.15.61",80,3,186,3,186,0,0,85358.745417,9.022460000007413,164.92176191402095,0
"147.32.84.165",1791,"174.128.246.102",80,3,186,3,186,0,0,85358.748598,9.019327999994857,164.97903169735577,0
"147.32.84.165",1792,"174.128.246.102",80,3,186,3,186,0,0,85358.751819,9.016155000004801,165.03709175354768,0
"147.32.84.165",1793,"174.128.246.102",80,3,186,3,186,0,0,85358.755035,9.012982000000193,165.09519268982987,0
"147.32.84.165",1794,"174.128.246.102",80,3,186,3,186,0,0,85358.758202,9.009862999999314,165.15234471380012,0
"147.32.84.165",1795,"193.23.181.44",179,3,186,3,186,0,0,85358.761417,9.006695000003674,165.21043512624698,0
"147.32.84.165",1796,"174.128.246.102",80,3,186,3,186,0,0,85359.038445,9.031048000004375,164.7649309359533,0
"147.32.84.165",1797,"174.128.246.102",80,3,186,3,186,0,0,85359.138097,9.031132999996771,164.7633801872403,0
"147.32.84.165",1798,"174.128.246.102",80,3,186,3,186,0,0,85359.239265,9.030551999996533,164.7739805939406,0
"147.32.84.165",1799,"60.243.38.64",6667,2,124,2,124,0,0,85359.285949,2.9635879999987083,334.72938883557106,0
"147.32.84.165",1800,"72.20.15.61",80,3,186,3,186,0,0,85359.339394,9.031667000002926,164.75363850322626,0
"147.32.84.165",1801,"46.4.36.120",443,6,366,3,186,3,180,85359.865053,1.0074440000025788,1477.0051734847705,1429.3598453078423
"147.32.84.165",1802,"193.23.181.44",80,3,186,3,186,0,0,85360.14329,9.030655999988085,164.7720830028254,0
"147.32.84.165",1803,"174.128.246.102",80,3,186,3,186,0,0,85360.243409,9.030786999996053,164.7696928297224,0
"147.32.84.165",1804,"72.20.15.61",80,3,186,3,186,0,0,85360.243977,9.0302679999877,164.77916270060055,0
"147.32.84.165",1805,"67.19.72.206",80,3,186,3,186,0,0,85360.244299,9.029993999996805,164.78416264734247,0
"147.32.84.165",1806,"67.19.72.206",80,3,186,3,186,0,0,85360.244639,9.029701000006753,164.78950964144738,0
"147.32.84.165",1807,"72.20.15.61",80,3,186,3,186,0,0,85360.343856,9.030726999990293,164.77078755692642,0
"147.32.84.165",1808,"193.23.181.44",179,3,186,3,186,0,0,85360.443936,9.0300270000007,164.78356044781313,0
"147.32.84.165",1809,"174.37.196.55",80,3,186,3,186,0,0,85360.745178,9.030293999996502,164.778688268685,0
"147.32.84.165",1810,"193.23.181.44",80,3,186,3,186,0,0,85361.547137,9.030455999993137,164.77573225550634,0
"147.32.84.165",1811,"46.4.36.120",443,6,366,3,186,3,180,85361.872808,1.0059219999966444,1479.239941073924,1431.5225236199265
"147.32.84.165",1812,"72.20.15.61",80,3,186,3,186,0,0,85363.371469,8.912862999990466,166.94972199186634,0
"147.32.84.165",1813,"193.23.181.44",179,3,186,3,186,0,0,85363.374668,8.90971300000092,167.00874652189654,0
"147.32.84.165",1814,"193.23.181.44",179,3,186,3,186,0,0,85363.377868,8.906557000009343,167.0679253496541,0
"147.32.84.165",1815,"67.19.72.206",80,3,186,3,186,0,0,85363.403488,8.980420000007143,165.69380942080844,0
"147.32.84.165",1816,"67.19.72.206",80,3,186,3,186,0,0,85363.406718,8.977310000002035,165.75121055189837,0
"147.32.84.165",1817,"72.20.15.61",80,3,186,3,186,0,0,85363.770668,9.014410000003409,165.06903946009083,0
"147.32.84.165",1818,"193.23.181.44",179,3,186,3,186,0,0,85363.773868,9.011331000001519,165.12544040383705,0
"147.32.84.165",1819,"46.4.36.120",443,6,366,3,186,3,180,85363.87922,1.0433289999928093,1426.20400660794,1380.1974257496195
"147.32.84.165",1820,"184.82.148.43",80,10,1919,5,979,5,940,85364.093368,0.3471279999939725,22562.282501371235,21663.47860192948
"147.32.84.165",1821,"174.128.246.102",80,7,573,5,451,2,122,85364.3178,3.2700610000028973,1103.3433321264658,298.46538030915485
"147.32.84.165",1822,"184.82.148.44",80,10,1514,5,596,5,918,85364.333775,0.32356699999945704,14735.742520121028,22696.999385018633
"147.32.84.165",1823,"193.23.181.44",80,3,186,3,186,0,0,85364.357195,9.049038999990444,164.43735075089978,0
"147.32.84.165",1824,"174.37.196.55",80,3,186,3,186,0,0,85364.357552,9.05190199999197,164.38534133503876,0
"147.32.84.165",1825,"193.23.181.44",80,3,186,3,186,0,0,85364.358935,9.053698000003351,164.35273188916278,0
"147.32.84.165",1826,"72.20.15.61",80,3,186,3,186,0,0,85364.362155,9.053681999997934,164.35302233945697,0
"147.32.84.165",1827,"193.23.181.44",179,3,186,3,186,0,0,85364.557845,9.029782999990857,164.78801317833515,0
"147.32.84.165",1828,"174.128.246.102",80,3,186,3,186,0,0,85364.558126,9.029550999999628,164.79224714496448,0
"147.32.84.165",1829,"217.163.21.36",80,14,6141,7,810,7,5331,85364.562366,0.18733699999575038,34590.07030189976,227653.9071350958
"147.32.84.165",1830,"217.163.21.36",80,10,1451,5,701,5,750,85364.709513,0.13882000000739936,40397.63722591185,43221.43783086147
"147.32.84.165",1831,"67.19.72.206",80,3,186,3,186,0,0,85364.785188,9.002745000005234,165.2829220420144,0
"147.32.84.165",1832,"217.163.21.35",80,11,3746,6,2116,5,1630,85364.802968,0.2617689999897266,64667.70320650787,49814.91315057081
"147.32.84.165",1833,"174.128.246.102",80,3,186,3,186,0,0,85364.95274,8.9362880000117,166.51209092612635,0
"147.32.84.165",1834,"174.128.246.102",80,3,186,3,186,0,0,85364.955936,8.933224000007613,166.56920278711604,0
"147.32.84.165",1835,"217.163.21.36",80,10,2277,5,1156,5,1121,85365.022814,0.16443200000503566,56242.093994580035,54539.262429000184
"147.32.84.165",1836,"174.128.246.102",80,8,661,4,419,4,242,85365.135156,0.33979899999394547,9864.655281680421,5697.48586674621
"147.32.84.165",1837,"217.163.21.35",80,13,5649,7,2631,6,3018,85365.144757,0.301978000003146,69700.44175330893,79952.84424609895
"147.32.84.165",1838,"174.37.196.55",80,3,186,3,186,0,0,85365.167157,9.022096999993664,164.92839746691317,0
"147.32.84.165",1839,"193.23.181.44",179,3,186,3,186,0,0,85365.296773,8.992893000002368,165.4639947344651,0
"147.32.84.165",1840,"193.23.181.44",80,3,186,3,186,0,0,85365.31834,8.971384000004036,165.86069663268572,0
"147.32.84.165",1841,"173.241.240.4",80,9,2195,5,1165,4,1030,85365.327959,0.13818399999581743,67446.30348146021,59630.637412793156
"147.32.84.165",1842,"92.240.244.181",80,10,1760,6,1366,4,394,85365.331155,5.095651999989059,2144.5734520378282,618.5665740138393
"147.32.84.165",1843,"46.4.36.120",443,6,366,3,186,3,180,85365.922582,0.969637000001967,1534.5949051005496,1485.091843645693
"147.32.84.165",1844,"174.128.246.102",80,8,661,4,419,4,242,85366.163866,0.33099799999035895,10126.94940784426,5848.9779396141075
"147.32.84.165",1845,"193.23.181.44",179,3,186,3,186,0,0,85366.263375,9.030382000011741,164.77708251966143,0
"147.32.84.165",1846,"193.23.181.44",179,3,186,3,186,0,0,85366.263564,9.030314000003273,164.77832332291666,0
"147.32.84.165",1847,"193.23.181.44",179,3,186,3,186,0,0,85366.263687,9.03023899999971,164.77969187748494,0
"147.32.84.165",1848,"67.19.72.206",80,3,186,3,186,0,0,85366.330891,8.963078000000678,166.01439817882735,0
"147.32.84.165",1849,"67.19.72.206",80,3,186,3,186,0,0,85366.365217,9.075066999997944,163.96573160290026,0
"147.32.84.165",1850,"67.19.72.206",80,3,186,3,186,0,0,85366.365378,9.07810499999323,163.91086025124295,0
"147.32.84.165",1851,"67.19.72.206",80,3,186,3,186,0,0,85366.765783,9.028728999997838,164.80725027856704,0
"147.32.84.165",1852,"193.23.181.44",179,3,186,3,186,0,0,85367.367331,9.028925999999046,164.8036543881473,0
"147.32.84.165",1853,"72.20.15.61",80,3,186,3,186,0,0,85367.428735,8.967564999999013,165.93133141495645,0
"147.32.84.165",1854,"72.20.15.61",80,3,186,3,186,0,0,85367.768587,9.029299000001629,164.79684635537393,0
"147.32.84.165",1855,"193.23.181.44",179,3,186,3,186,0,0,85367.768816,9.029194000002462,164.7987627688135,0
"147.32.84.165",1856,"67.19.72.206",80,3,186,3,186,0,0,85367.868623,9.02977199999441,164.78821392178244,0
"147.32.84.165",1857,"193.23.181.44",179,3,186,3,186,0,0,85367.868833,9.029592999999295,164.79148063485434,0
"147.32.84.165",1858,"67.19.72.206",80,3,186,3,186,0,0,85367.868952,9.029507999992347,164.79303191284188,0
"147.32.84.165",1859,"46.4.36.120",443,6,366,3,186,3,180,85367.891984,1.1098539999948116,1340.7168870923167,1297.467955250629
"147.32.84.165",1860,"72.20.15.61",80,3,186,3,186,0,0,85368.169728,9.03072800001246,164.77076931095112,0
"147.32.84.165",1861,"193.23.181.44",179,3,186,3,186,0,0,85368.671239,9.029932999997982,164.7852758154831,0
"147.32.84.165",1862,"222.85.179.42",6667,2,124,2,124,0,0,85369.289988,2.994223999994574,331.3045383384134,0
"147.32.84.165",1863,"174.37.196.55",80,3,186,3,186,0,0,85369.474384,9.105410000003758,163.41932982692552,0
"147.32.84.165",1864,"46.4.36.120",443,6,366,3,186,3,180,85370.002,1.0051600000006147,1480.3613355078694,1432.6077440398738
"147.32.84.165",1865,"193.23.181.44",179,3,186,3,186,0,0,85370.57788,9.030299999998533,164.77857878478474,0
"147.32.84.165",1866,"74.125.93.27",25,3,186,3,186,0,0,85370.980053,9.0300159999897,164.78376118067754,0
"147.32.84.165",1867,"193.23.181.44",179,3,186,3,186,0,0,85371.785747,9.025817000001553,164.86042205373144,0
"147.32.84.165",1868,"46.4.36.120",443,6,366,3,186,3,180,85372.006747,1.023775999987265,1453.4429406613453,1406.5576845109792
"147.32.84.165",1869,"193.23.181.44",80,3,186,3,186,0,0,85372.082528,9.030345999999554,164.77773941331523,0
"147.32.84.165",1870,"184.82.148.43",80,10,1919,5,979,5,940,85372.33171,0.3038539999979548,25775.53693567541,24748.72800769651
"147.32.84.165",1871,"184.82.148.44",80,10,1514,5,596,5,918,85372.53964,0.34017799999855924,14016.191523320715,21588.697681893314
"147.32.84.165",1872,"217.163.21.36",80,13,6078,6,750,7,5328,85372.781378,0.1861030000000028,32240.211065914627,229034.4594122575
"147.32.84.165",1873,"72.20.15.61",80,3,186,3,186,0,0,85372.785644,9.031279999995604,164.76069837284683,0
"147.32.84.165",1874,"174.37.196.55",80,3,186,3,186,0,0,85372.785917,9.031052999998792,164.7648397147264,0
"147.32.84.165",1875,"193.23.181.44",179,3,186,3,186,0,0,85372.885945,9.029645000002347,164.79053163215312,0
"147.32.84.165",1876,"67.19.72.206",80,3,186,3,186,0,0,85372.886079,9.02956899999117,164.79191863991016,0
"147.32.84.165",1877,"67.19.72.206",80,3,186,3,186,0,0,85372.886199,9.029471999994712,164.7936889334029,0
"147.32.84.165",1878,"217.163.21.36",80,10,1449,5,700,5,749,85372.925405,0.13882700000249315,40337.974600758,43161.632822811065
"147.32.84.165",1879,"193.23.181.44",80,3,186,3,186,0,0,85372.986233,9.0304679999972,164.77551329570753,0
"147.32.84.165",1880,"174.128.246.102",80,3,186,3,186,0,0,85372.986348,9.030413000000408,164.77651686583246,0
"147.32.84.165",1881,"217.163.21.35",80,12,3813,6,2115,6,1698,85373.018899,0.2488630000007106,67989.2149493966,54584.249165047484
"147.32.84.165",1882,"193.23.181.44",179,3,186,3,186,0,0,85373.086352,9.03078600000299,164.76971107492827,0
"147.32.84.165",1883,"217.163.21.36",80,10,2275,5,1155,5,1120,85373.226105,0.13926700000592973,66347.37590101444,64336.849358559455
"147.32.84.165",1884,"217.163.21.35",80,13,5726,7,2630,6,3096,85373.320124,0.15625400000135414,134652.55289347895,158511.14211338817
"147.32.84.165",1885,"193.23.181.44",179,3,186,3,186,0,0,85373.419035,8.998957999996492,165.35247747578998,0
"147.32.84.165",1886,"174.128.246.102",80,3,186,3,186,0,0,85373.422234,8.995783000005758,165.41083750008727,0
"147.32.84.165",1887,"174.128.246.102",80,3,186,3,186,0,0,85373.487424,9.030495999992127,164.77500239203886,0
"147.32.84.165",1888,"109.169.13.223",80,12,7452,7,1595,5,5857,85373.55532,0.10358500000438653,123183.8586615789,452343.48600681353
"147.32.84.165",1889,"109.169.13.223",80,13,8496,7,1121,6,7375,85373.632189,0.08204000000841916,109312.5304617221,719161.3846165928
"147.32.84.165",1890,"109.169.13.223",80,10,2353,5,1607,5,746,85373.703528,0.10059499999624677,127799.59242983907,59327.0043264841
"147.32.84.165",1891,"109.169.13.214",80,26,22648,15,1581,11,21067,85373.73547,0.10681500000646338,118410.33561985366,1577830.8289079426
"147.32.84.165",1892,"193.23.181.44",80,3,186,3,186,0,0,85373.889439,9.031232999986969,164.7615558143774,0
"147.32.84.165",1893,"174.128.246.102",80,3,186,3,186,0,0,85373.889919,9.03087700001197,164.76805076605825,0
"147.32.84.165",1894,"67.19.72.206",80,3,186,3,186,0,0,85373.890155,9.03068899999198,164.77148089158217,0
"147.32.84.165",1895,"193.23.181.44",179,3,186,3,186,0,0,85373.890341,9.030545999994501,164.77409007173054,0
"147.32.84.165",1896,"67.19.72.206",80,3,186,3,186,0,0,85373.989357,9.030326000007335,164.77810435623158,0
"147.32.84.165",1897,"174.128.246.102",80,3,186,3,186,0,0,85373.989499,9.030243999994127,164.7796006399127,0
"147.32.84.165",1898,"46.4.36.120",443,6,366,3,186,3,180,85374.031254,1.0643739999941317,1398.0048366534731,1352.907906438845
"147.32.84.165",1899,"174.128.246.102",80,8,607,4,365,4,242,85374.089561,0.32404700000188313,9011.038522137316,5974.441979060905
"147.32.84.165",1900,"72.20.15.61",80,3,186,3,186,0,0,85374.25178,8.968806999997469,165.9083532514882,0
"147.32.84.165",1901,"174.128.246.102",80,3,186,3,186,0,0,85374.992318,8.931767000001855,166.5963744911495,0
"147.32.84.165",1902,"193.23.181.44",80,3,186,3,186,0,0,85375.092486,8.930940000005648,166.61180122126663,0
"147.32.84.165",1903,"72.20.15.61",80,3,186,3,186,0,0,85375.092747,8.930802000002586,166.61437573014933,0
"147.32.84.165",1904,"67.19.72.206",80,3,186,3,186,0,0,85375.093004,8.93059400000493,166.61825629954498,0
"147.32.84.165",1905,"174.37.196.55",80,3,186,3,186,0,0,85375.193477,8.930612000011024,166.61792047377753,0
"147.32.84.165",1906,"193.23.181.44",179,3,186,3,186,0,0,85375.193662,8.93045699999493,166.62081235045918,0
"147.32.84.165",1907,"193.23.181.44",179,3,186,3,186,0,0,85375.193842,8.93029300001217,166.6238722512209,0
"147.32.84.165",1908,"193.23.181.44",80,3,186,3,186,0,0,85375.194869,8.929292000000714,166.6425512795282,0
"147.32.84.165",1909,"193.23.181.44",179,3,186,3,186,0,0,85375.195187,8.928996000002371,166.64807555066716,0
"147.32.84.165",1910,"67.19.72.206",80,3,186,3,186,0,0,85375.195403,8.928804999988643,166.6516403932993,0
"147.32.84.165",1911,"174.37.196.55",80,3,186,3,186,0,0,85375.195525,8.928706999999122,166.653469533735,0
"147.32.84.165",1912,"193.23.181.44",80,3,186,3,186,0,0,85375.195635,8.928620000006049,166.655093396179,0
"147.32.84.165",1913,"193.23.181.44",179,3,186,3,186,0,0,85375.195743,8.928532999998424,166.65671729054063,0
"147.32.84.165",1914,"174.128.246.102",80,8,636,4,394,4,242,85375.195852,0.3452019999967888,9130.8856844089,5608.3104965151115
"147.32.84.165",1915,"174.37.196.55",80,3,186,3,186,0,0,85375.195959,8.928341999999247,166.66028250263324,0
"147.32.84.165",1916,"72.20.15.61",80,3,186,3,186,0,0,85375.196067,8.928259000007529,166.6618318306789,0
"147.32.84.165",1917,"174.37.196.55",80,3,186,3,186,0,0,85375.196177,8.92817099999229,166.66347452364937,0
"147.32.84.165",1918,"174.128.246.102",80,7,605,5,483,2,122,85375.196285,3.4620600000052946,1116.0985078231142,281.913080650973
"147.32.84.165",1919,"174.128.246.102",80,7,603,4,421,3,182,85375.196394,0.3639899999980116,9253.001456134505,4000.1098931507836
"147.32.84.165",1920,"193.23.181.44",80,3,186,3,186,0,0,85375.196502,8.92787299999327,166.66903751891653,0
"147.32.84.165",1921,"174.128.246.102",80,3,186,3,186,0,0,85375.19661,8.927788000000874,166.67062434724642,0
"147.32.84.165",1922,"174.128.246.102",80,7,584,5,462,2,122,85375.196719,3.437565000000177,1075.1796693298336,283.92190402216386
"147.32.84.165",1923,"67.19.72.206",80,3,186,3,186,0,0,85375.196827,8.927591999992728,166.67428350233882,0
"147.32.84.165",1924,"67.19.72.206",80,3,186,3,186,0,0,85375.196938,8.927507000000332,166.67587043056304,0
"147.32.84.165",1925,"174.37.196.55",80,3,186,3,186,0,0,85375.197046,8.927421999993385,166.67745738927795,0
"147.32.84.165",1926,"193.23.181.44",80,3,186,3,186,0,0,85375.197155,8.927335999993375,166.6790630487196,0
"147.32.84.165",1927,"72.20.15.61",80,3,186,3,186,0,0,85375.197263,8.927252000008593,166.68063139682488,0
"147.32.84.165",1928,"67.19.72.206",80,3,186,3,186,0,0,85375.197416,8.927123000001302,166.68303998945495,0
"147.32.84.165",1929,"174.128.246.102",80,3,186,3,186,0,0,85375.197565,8.926997000002302,166.68539263535277,0
"147.32.84.165",1930,"174.37.196.55",80,3,186,3,186,0,0,85375.197683,8.926902999999584,166.68714782719934,0
"147.32.84.165",1931,"193.23.181.44",80,3,186,3,186,0,0,85375.197797,8.926814000005834,166.68880969168032,0
"147.32.84.165",1932,"193.23.181.44",80,3,186,3,186,0,0,85375.199902,8.924733000007109,166.72767689507515,0
"147.32.84.165",1933,"174.37.196.55",80,3,186,3,186,0,0,85375.203104,8.921556999994209,166.78703055990852,0
"147.32.84.165",1934,"67.19.72.206",80,3,186,3,186,0,0,85375.206336,8.920872999995481,166.79981880705552,0
"147.32.84.165",1935,"193.23.181.44",179,3,186,3,186,0,0,85375.209501,8.920889000000898,166.7995196442698,0
"147.32.84.165",1936,"174.128.246.102",80,3,186,3,186,0,0,85375.212704,8.920902999991085,166.79925787798464,0
"147.32.84.165",1937,"174.37.196.55",80,3,186,3,186,0,0,85375.215907,8.920902999991085,166.79925787798464,0
"147.32.84.165",1939,"67.19.72.206",80,3,186,3,186,0,0,85375.219083,8.920908000000054,166.79916438999157,0
"147.32.84.165",1938,"193.23.181.44",80,3,186,3,186,0,0,85375.222302,8.920916000002762,166.7990148096383,0
"147.32.84.165",1940,"174.37.196.55",80,3,186,3,186,0,0,85375.294645,8.930569999996806,166.61870406934074,0
"147.32.84.165",1941,"72.20.15.61",80,3,186,3,186,0,0,85375.294992,8.93027000001166,166.62430139268545,0
"147.32.84.165",1942,"193.23.181.44",179,3,186,3,186,0,0,85375.298663,8.926642000005813,166.692021478965,0
"147.32.84.165",1943,"174.128.246.102",80,3,186,3,186,0,0,85375.30008,8.925271999993129,166.71760815817663,0
"147.32.84.165",1944,"193.23.181.44",80,3,186,3,186,0,0,85375.300371,8.925027999997837,166.722166025738,0
"147.32.84.165",1945,"72.20.15.61",80,3,186,3,186,0,0,85375.300706,8.924735000007786,166.72763953200874,0
"147.32.84.165",1946,"72.20.15.61",80,3,186,3,186,0,0,85375.300816,8.924671999993734,166.7288164765097,0
"147.32.84.165",1947,"174.128.246.102",80,3,186,3,186,0,0,85375.300922,8.92461300001014,166.72991870889072,0
"147.32.84.165",1948,"193.23.181.44",80,3,186,3,186,0,0,85375.30103,8.924564000000828,166.73083413373044,0
"147.32.84.165",1949,"67.19.72.206",80,3,186,3,186,0,0,85375.301136,8.924506000010297,166.73191771043497,0
"147.32.84.165",1950,"72.20.15.61",80,3,186,3,186,0,0,85375.301242,8.924442999996245,166.733094715337,0
"147.32.84.165",1951,"67.19.72.206",80,3,186,3,186,0,0,85375.301359,8.924371999994037,166.73442120084127,0
"147.32.84.165",1952,"174.37.196.55",80,3,186,3,186,0,0,85375.301466,8.924308000001474,166.73561692399613,0
"147.32.84.165",1953,"174.128.246.102",80,3,186,3,186,0,0,85375.301572,8.924247000002651,166.73675661370174,0
"147.32.84.165",1954,"174.128.246.102",80,3,186,3,186,0,0,85375.301679,8.924184999996214,166.73791500295334,0
"147.32.84.165",1955,"174.128.246.102",80,3,186,3,186,0,0,85375.301796,8.924113000000943,166.73926024915224,0
"147.32.84.165",1956,"174.37.196.55",80,3,186,3,186,0,0,85375.301902,8.924050999994506,166.7404186731918,0
"147.32.84.165",1957,"193.23.181.44",179,3,186,3,186,0,0,85375.302014,8.923985000001267,166.74165185169952,0
"147.32.84.165",1958,"193.23.181.44",179,3,186,3,186,0,0,85375.302128,8.923907999997027,166.7430905832395,0
"147.32.84.165",1959,"193.23.181.44",80,3,186,3,186,0,0,85375.302235,8.923846999998204,166.7442303751173,0
"147.32.84.165",1960,"174.37.196.55",80,3,186,3,186,0,0,85375.302342,8.923781999998027,166.74544492462152,0
"147.32.84.165",1961,"72.20.15.61",80,3,186,3,186,0,0,85375.305481,8.92090699999244,166.79918308769064,0
"147.32.84.165",1962,"193.23.181.44",80,3,186,3,186,0,0,85375.308681,8.920909000007669,166.7991456922967,0
"147.32.84.165",1963,"72.20.15.61",80,3,186,3,186,0,0,85375.311881,8.920933999994304,166.7986782550964,0
"147.32.84.165",1964,"174.128.246.102",80,3,186,3,186,0,0,85375.315081,8.920935000001919,166.79865955751052,0
"147.32.84.165",1965,"193.23.181.44",179,3,186,3,186,0,0,85375.31828,8.920908999993117,166.7991456925688,0
"147.32.84.165",1966,"174.128.246.102",80,3,186,3,186,0,0,85375.321481,8.92090699999244,166.79918308769064,0
"147.32.84.165",1967,"174.128.246.102",80,3,186,3,186,0,0,85375.32468,8.92093899998872,166.79858476802514,0
"147.32.84.165",1968,"193.23.181.44",80,3,186,3,186,0,0,85375.32788,8.920939999996335,166.7985660704602,0
"147.32.84.165",1969,"67.19.72.206",80,3,186,3,186,0,0,85375.331109,8.920910999993794,166.7991082974637,0
"147.32.84.165",1970,"174.128.246.102",80,3,186,3,186,0,0,85375.334333,8.920910000000731,166.7991269948781,0
"147.32.84.165",1971,"193.23.181.44",179,3,186,3,186,0,0,85375.337535,8.92088099999819,166.7996692255285,0
"147.32.84.165",1972,"72.20.15.61",80,3,186,3,186,0,0,85375.340681,8.920908000000054,166.79916438999157,0
"147.32.84.165",1973,"174.37.196.55",80,3,186,3,186,0,0,85375.34388,8.920908999993117,166.7991456925688,0
"147.32.84.165",1974,"174.128.246.102",80,3,186,3,186,0,0,85375.347081,8.920908000000054,166.79916438999157,0
"147.32.84.165",1975,"67.19.72.206",80,3,186,3,186,0,0,85375.350281,8.920908000000054,166.79916438999157,0
"147.32.84.165",1976,"67.19.72.206",80,3,186,3,186,0,0,85375.353479,8.920910000000731,166.7991269948781,0
"147.32.84.165",1977,"174.37.196.55",80,3,186,3,186,0,0,85375.356681,8.920908000000054,166.79916438999157,0
"147.32.84.165",1978,"67.19.72.206",80,3,186,3,186,0,0,85375.359881,8.920908000000054,166.79916438999157,0
"147.32.84.165",1979,"174.128.246.102",80,3,186,3,186,0,0,85375.363081,8.920908000000054,166.79916438999157,0
"147.32.84.165",1980,"174.37.196.55",80,3,186,3,186,0,0,85375.366281,8.920908000000054,166.79916438999157,0
"147.32.84.165",1981,"72.20.15.61",80,3,186,3,186,0,0,85375.405085,8.885303999995813,167.46753965882328,0
"147.32.84.165",1982,"174.37.196.55",80,3,186,3,186,0,0,85375.408283,8.88530599999649,167.46750196342003,0
"147.32.84.165",1983,"193.23.181.44",80,3,186,3,186,0,0,85375.411501,8.885288000004948,167.46784122238597,0
"147.32.84.165",1984,"174.128.246.102",80,3,186,3,186,0,0,85375.414699,8.885322000001906,167.46720040080493,0
"147.32.84.165",1985,"174.128.246.102",80,3,186,3,186,0,0,85375.417928,8.885309000004781,167.46744542020983,0
"147.32.84.165",1986,"193.23.181.44",80,3,186,3,186,0,0,85375.421081,8.885362000000896,167.46644649929289,0
"147.32.84.165",1987,"174.37.196.55",80,3,186,3,186,0,0,85375.424298,8.885313999999198,167.4673511819767,0
"147.32.84.165",1989,"67.19.72.206",80,3,186,3,186,0,0,85375.427508,8.885302000009688,167.46757735396923,0
"147.32.84.165",1990,"67.19.72.206",80,3,186,3,186,0,0,85375.430738,8.885298000008333,167.4676527448606,0
"147.32.84.165",1991,"174.37.196.55",80,3,186,3,186,0,0,85375.43393,8.885276999993948,167.468048548291,0
"147.32.84.165",1988,"174.37.196.55",80,3,186,3,186,0,0,85375.437125,8.885309000004781,167.46744542020983,0
"147.32.84.165",1992,"193.23.181.44",179,3,186,3,186,0,0,85375.446699,8.891732000003685,167.34647423014812,0
"147.32.84.165",1993,"193.23.181.44",179,3,186,3,186,0,0,85375.4499,8.891736999998102,167.34638012801295,0
"147.32.84.165",1994,"72.20.15.61",80,3,186,3,186,0,0,85375.453081,8.891734000004362,167.34643658922658,0
"147.32.84.165",1995,"72.20.15.61",80,3,186,3,186,0,0,85375.456301,8.89170500000182,167.34698238410917,0
"147.32.84.165",1997,"193.23.181.44",80,3,186,3,186,0,0,85375.459498,8.891692000004696,167.34722705186078,0
"147.32.84.165",1996,"174.128.246.102",80,3,186,3,186,0,0,85375.4627,8.891689999989467,167.3472646934118,0
"147.32.84.165",1998,"72.20.15.61",80,3,186,3,186,0,0,85375.494432,8.93179199998849,166.59590818974706,0
"147.32.84.165",2000,"174.37.196.55",80,3,186,3,186,0,0,85375.494903,8.931347999998252,166.60419009541351,0
"147.32.84.165",1999,"193.23.181.44",80,3,186,3,186,0,0,85375.495022,8.93125300000247,166.60596223168108,0
"147.32.84.165",2001,"193.23.181.44",179,3,186,3,186,0,0,85375.495152,8.931144999995013,166.60797691682654,0
"147.32.84.165",2002,"174.37.196.55",80,3,186,3,186,0,0,85375.49529,8.931029999992461,166.61012223688152,0
"147.32.84.165",2003,"67.19.72.206",80,3,186,3,186,0,0,85375.495458,8.930884999994305,166.61282728430035,0
"147.32.84.165",2004,"174.37.196.55",80,3,186,3,186,0,0,85375.495608,8.930758000002243,166.61519660477043,0
"147.32.84.165",2005,"72.20.15.61",80,3,186,3,186,0,0,85375.495797,8.93059100001119,166.6183122705021,0
"147.32.84.165",2006,"67.19.72.206",80,3,186,3,186,0,0,85375.497881,8.928529999990133,166.65677328761222,0
"147.32.84.165",2007,"72.20.15.61",80,3,186,3,186,0,0,85375.59588,8.929792000009911,166.63322057202996,0
"147.32.84.165",2008,"72.20.15.61",80,3,186,3,186,0,0,85375.596932,8.928864999994403,166.6505205309894,0
"147.32.84.165",2009,"174.37.196.55",80,3,186,3,186,0,0,85375.597452,8.928394999995362,166.65929318771995,0
"147.32.84.165",2010,"193.23.181.44",179,3,186,3,186,0,0,85375.597796,8.928094000002602,166.66491190612086,0
"147.32.84.165",2011,"174.37.196.55",80,3,186,3,186,0,0,85375.59807,8.927870000014082,166.66909352372437,0
"147.32.84.165",2012,"174.37.196.55",80,3,186,3,186,0,0,85375.59829,8.92769799999951,166.6723045515296,0
"147.32.84.165",2013,"193.23.181.44",179,3,186,3,186,0,0,85375.598508,8.927523000005749,166.6755717122254,0
"147.32.84.165",2014,"174.128.246.102",80,3,186,3,186,0,0,85375.598741,8.927336000007926,166.67906304844792,0
"147.32.84.165",2015,"193.23.181.44",179,3,186,3,186,0,0,85375.598995,8.927129000003333,166.68292796031562,0
"147.32.84.165",2016,"72.20.15.61",80,3,186,3,186,0,0,85375.59922,8.92694799999299,166.6863075713187,0
"147.32.84.165",2017,"193.23.181.44",179,3,186,3,186,0,0,85375.599522,8.926695000001928,166.6910317872044,0
"147.32.84.165",2018,"174.128.246.102",80,3,186,3,186,0,0,85375.599741,8.926508000004105,166.69452377114496,0
"147.32.84.165",2019,"193.23.181.44",80,3,186,3,186,0,0,85375.599959,8.926336000004085,166.69773577863515,0
"147.32.84.165",2020,"174.37.196.55",80,8,698,5,516,3,182,85375.60018,3.2667190000065602,1263.6532251447738,445.7071453030016
"147.32.84.165",2021,"67.19.72.206",80,3,186,3,186,0,0,85375.600396,8.925946000003023,166.70501927745207,0
"147.32.84.165",2022,"174.128.246.102",80,3,186,3,186,0,0,85375.600612,8.925777000011294,166.70817565777378,0
"147.32.84.165",2023,"67.19.72.206",80,3,186,3,186,0,0,85375.600882,8.925556999995024,166.71228473481594,0
"147.32.84.165",2024,"193.23.181.44",80,3,186,3,186,0,0,85375.601101,8.92538400000194,166.7155161054893,0
"147.32.84.165",2025,"174.37.196.55",80,8,631,5,449,3,182,85375.601316,3.2822980000055395,1094.355235263202,443.591654382857
"147.32.84.165",2027,"67.19.72.206",80,3,186,3,186,0,0,85375.601622,8.924910000001546,166.72437032975597,0
"147.32.84.165",2028,"193.23.181.44",179,3,186,3,186,0,0,85375.601842,8.924732999992557,166.727676895347,0
"147.32.84.165",2026,"72.20.15.61",80,3,186,3,186,0,0,85375.602057,8.924565000008442,166.73081545135167,0
"147.32.84.165",2029,"72.20.15.61",80,3,186,3,186,0,0,85375.69495,8.931077000001096,166.60924544708521,0
"147.32.84.165",2030,"174.37.196.55",80,3,186,3,186,0,0,85375.794796,8.931448000003002,166.602324729372,0
"147.32.84.165",2031,"193.23.181.44",80,3,186,3,186,0,0,85375.794985,8.931310999993002,166.604880291501,0
"147.32.84.165",2032,"72.20.15.61",80,3,186,3,186,0,0,85375.795178,8.931165000001783,166.60760382320817,0
"147.32.84.165",2033,"72.20.15.61",80,3,186,3,186,0,0,85375.796219,8.93017000000691,166.62616725088643,0
"147.32.84.165",2034,"193.23.181.44",179,3,186,3,186,0,0,85375.796762,8.929673000006005,166.6354411856962,0
"147.32.84.165",2035,"193.23.181.44",179,3,186,3,186,0,0,85375.797163,8.929319000002579,166.6420473946076,0
"147.32.84.165",2036,"72.20.15.61",80,3,186,3,186,0,0,85375.797275,8.929252999994787,166.64327911874247,0
"147.32.84.165",2037,"193.23.181.44",80,3,186,3,186,0,0,85375.797384,8.929191999995965,166.64441754647817,0
"147.32.84.165",2038,"72.20.15.61",80,3,186,3,186,0,0,85375.797492,8.929128999996465,166.64559331605457,0
"147.32.84.165",2039,"174.37.196.55",80,3,186,3,186,0,0,85375.7976,8.929067999997642,166.6467317754096,0
"147.32.84.165",2040,"174.128.246.102",80,3,186,3,186,0,0,85375.797709,8.92900199998985,166.6479635687943,0
"147.32.84.165",2041,"174.37.196.55",80,3,186,3,186,0,0,85375.797817,8.92894100000558,166.64910206026337,0
"147.32.84.165",2042,"67.19.72.206",80,3,186,3,186,0,0,85375.797969,8.928839999993215,166.65098713843352,0
"147.32.84.165",2043,"174.37.196.55",80,3,186,3,186,0,0,85375.798085,8.928770999991684,166.65227498850467,0
"147.32.84.165",2044,"174.37.196.55",80,3,186,3,186,0,0,85375.798192,8.928711000000476,166.65339487412245,0
"147.32.84.165",2045,"193.23.181.44",80,3,186,3,186,0,0,85375.7983,8.928653000009945,166.65447744450844,0
"147.32.84.165",2046,"174.128.246.102",80,3,186,3,186,0,0,85375.798407,8.928592000011122,166.6556160252531,0
"147.32.84.165",2048,"174.128.246.102",80,3,186,3,186,0,0,85375.798549,8.928497999993851,166.65737059033052,0
"147.32.84.165",2049,"174.128.246.102",80,3,186,3,186,0,0,85375.798659,8.928435000008903,166.65854654242497,0
"147.32.84.165",2050,"174.128.246.102",80,3,186,3,186,0,0,85375.798776,8.928364000006695,166.65987184201765,0
"147.32.84.165",2051,"174.128.246.102",80,3,186,3,186,0,0,85375.798882,8.928304999993998,166.66097316355123,0
"147.32.84.165",2052,"72.20.15.61",80,3,186,3,186,0,0,85375.799085,8.92814799999178,166.66390386913054,0
"147.32.84.165",2047,"174.37.196.55",80,3,186,3,186,0,0,85375.799328,8.927952000012738,166.66756272859408,0
"147.32.84.165",2053,"193.23.181.44",80,3,186,3,186,0,0,85375.799591,8.927735999997822,166.67159512785358,0
"147.32.84.165",2055,"67.19.72.206",80,3,186,3,186,0,0,85375.800778,8.926594999997178,166.69289914020635,0
"147.32.84.165",2056,"174.128.246.102",80,3,186,3,186,0,0,85375.803994,8.925351999991108,166.71611382962627,0
"147.32.84.165",2057,"67.19.72.206",80,3,186,3,186,0,0,85375.807192,8.925354000006337,166.71607647147033,0
"147.32.84.165",2058,"193.23.181.44",80,3,186,3,186,0,0,85375.810396,8.925342999995337,166.71628194017612,0
"147.32.84.165",2054,"174.37.196.55",80,3,186,3,186,0,0,85375.813598,8.925325000003795,166.71661816229295,0
"147.32.84.165",2059,"174.128.246.102",80,3,186,3,186,0,0,85375.896334,8.930248999997275,166.62469321969118,0
"147.32.84.165",2060,"67.19.72.206",80,3,186,3,186,0,0,85375.896853,8.92978900000162,166.63327655331275,0
"147.32.84.165",2061,"174.37.196.55",80,3,186,3,186,0,0,85375.896964,8.929701999993995,166.6349000225316,0
"147.32.84.165",2062,"174.37.196.55",80,3,186,3,186,0,0,85375.897094,8.929747000001953,166.63406029304912,0
"147.32.84.165",2063,"193.23.181.44",179,3,186,3,186,0,0,85375.897203,8.92966300000262,166.63562779463945,0
"147.32.84.165",2064,"193.23.181.44",80,3,186,3,186,0,0,85375.89731,8.929579000003287,166.63719532572054,0
"147.32.84.165",2065,"193.23.181.44",80,3,186,3,186,0,0,85375.897417,8.929493999996339,166.63878154804854,0
"147.32.84.165",2066,"174.37.196.55",80,3,186,3,186,0,0,85375.897526,8.929407999996329,166.64038646241855,0
"147.32.84.165",2067,"174.37.196.55",80,3,186,3,186,0,0,85375.897632,8.92932500000461,166.64193542056447,0
"147.32.84.165",2068,"174.128.246.102",80,3,186,3,186,0,0,85375.897738,8.929243000005954,166.6434657449694,0
"147.32.84.165",2069,"67.19.72.206",80,3,186,3,186,0,0,85375.897844,8.92916200000036,166.64497743460583,0
"147.32.84.165",2070,"193.23.181.44",80,3,186,3,186,0,0,85375.897951,8.92907899999409,166.64652647837306,0
"147.32.84.165",2071,"174.37.196.55",80,3,186,3,186,0,0,85375.898093,8.928960000004736,166.64874744642273,0
"147.32.84.165",2072,"72.20.15.61",80,3,186,3,186,0,0,85375.898203,8.928873999990174,166.6503525530361,0
"147.32.84.165",2073,"67.19.72.206",80,3,186,3,186,0,0,85375.91705,8.910049999991315,167.00242984062382,0
"147.32.84.165",2075,"193.23.181.44",179,3,186,3,186,0,0,85375.931337,8.895785999993677,167.27021086175608,0
"147.32.84.165",2074,"193.23.181.44",179,3,186,3,186,0,0,85375.931462,8.895684000002802,167.27212882107,0
"147.32.84.165",2076,"193.23.181.44",80,3,186,3,186,0,0,85376.096224,8.931616000001668,166.59919100862845,0
"147.32.84.165",2077,"193.23.181.44",179,3,186,3,186,0,0,85376.096591,8.931315000008908,166.6048056751459,0
"147.32.84.165",2078,"193.23.181.44",80,3,186,3,186,0,0,85376.096922,8.931005999998888,166.6105699626879,0
"147.32.84.165",2079,"193.23.181.44",80,3,186,3,186,0,0,85376.097195,8.930754000000888,166.61527123016174,0
"147.32.84.165",2080,"46.4.36.120",443,4,246,3,186,1,60,85376.097389,8.95806299999822,166.10733816007945,53.58301230970305
"147.32.84.165",2081,"174.37.196.55",80,3,186,3,186,0,0,85376.097523,8.930473000000347,166.62051382944017,0
"147.32.84.165",2082,"174.37.196.55",80,3,186,3,186,0,0,85376.097653,8.930366999993566,166.62249155057927,0
"147.32.84.165",2083,"193.23.181.44",179,3,186,3,186,0,0,85376.09781,8.930233999999473,166.6249730970194,0
"147.32.84.165",2084,"193.23.181.44",179,3,186,3,186,0,0,85376.09794,8.93012699999963,166.62696958285832,0
"147.32.84.165",2085,"193.23.181.44",179,3,186,3,186,0,0,85376.098138,8.92995200000587,166.63023496643902,0
"147.32.84.165",2086,"67.19.72.206",80,3,186,3,186,0,0,85376.098275,8.92983799999638,166.63236219969536,0
"147.32.84.165",2087,"174.37.196.55",80,3,186,3,186,0,0,85376.098404,8.929731999989599,166.63434020211727,0
"147.32.84.165",2088,"174.37.196.55",80,3,186,3,186,0,0,85376.098539,8.929621000002953,166.63641155649358,0
"147.32.84.165",2089,"193.23.181.44",179,3,186,3,186,0,0,85376.098659,8.929524000006495,166.6382217012819,0
"147.32.84.165",2090,"72.20.15.61",80,3,186,3,186,0,0,85376.09879,8.9294169999921,166.64021850489416,0
"147.32.84.165",2092,"193.23.181.44",179,3,186,3,186,0,0,85376.196425,8.930597999991733,166.61818167175116,0
"147.32.84.165",2091,"67.19.72.206",80,3,186,3,186,0,0,85376.196558,8.930587000009837,166.61838689868438,0
"147.32.84.165",2093,"174.128.246.102",80,3,186,3,186,0,0,85376.196959,8.93023600000015,166.62493577996986,0
"147.32.84.165",2094,"67.19.72.206",80,3,186,3,186,0,0,85376.19715,8.930087999993702,166.62769728596732,0
"147.32.84.165",2095,"67.19.72.206",80,3,186,3,186,0,0,85376.19726,8.930026000001817,166.62885416007717,0
"147.32.84.165",2096,"193.23.181.44",80,3,186,3,186,0,0,85376.197368,8.929965000002994,166.6299923907318,0
"147.32.84.165",2097,"72.20.15.61",80,3,186,3,186,0,0,85376.197494,8.929899000009755,166.6312239363933,0
"147.32.84.165",2098,"174.128.246.102",80,9,940,6,756,3,184,85376.197612,3.376833999995142,1791.0267428036736,435.91127073528565
"147.32.84.165",2099,"174.37.196.55",80,3,186,3,186,0,0,85376.197722,8.929722000000766,166.63452680832307,0
"147.32.84.165",2101,"67.19.72.206",80,3,186,3,186,0,0,85376.197832,8.929659999994328,166.6356837775397,0
"147.32.84.165",2102,"72.20.15.61",80,3,186,3,186,0,0,85376.19794,8.929598000002443,166.6368407625509,0
"147.32.84.165",2100,"193.23.181.44",179,3,186,3,186,0,0,85376.198084,8.929500999991433,166.63865091693563,0
"147.32.84.165",2103,"174.128.246.102",80,7,547,4,365,3,182,85376.296866,0.3354959999996936,8703.531487715702,4339.843097984267
"147.32.84.165",2105,"174.37.196.55",80,3,186,3,186,0,0,85376.297818,8.929829000000609,166.63253014138328,0
"147.32.84.165",2104,"67.19.72.206",80,3,186,3,186,0,0,85376.297951,8.929793999996036,166.6331832515577,0
"147.32.84.165",2106,"193.23.181.44",179,3,186,3,186,0,0,85376.29832,8.929449000002933,166.63962132484448,0
"147.32.84.165",2107,"193.23.181.44",80,3,186,3,186,0,0,85376.298431,8.929357999993954,166.64131956642433,0
"147.32.84.165",2108,"174.128.246.102",80,3,186,3,186,0,0,85376.298539,8.929277000002912,166.64283121685156,0
"147.32.84.165",2109,"72.20.15.61",80,3,186,3,186,0,0,85376.298647,8.929191999995965,166.64441754647817,0
"147.32.84.165",2110,"193.23.181.44",80,3,186,3,186,0,0,85376.298753,8.929108000011183,166.64598524266214,0
"147.32.84.165",2111,"72.20.15.61",80,3,186,3,186,0,0,85376.298859,8.929026999991038,166.64749697828145,0
"147.32.84.165",2112,"174.37.196.55",80,3,186,3,186,0,0,85376.299166,8.928742999996757,166.65279759990185,0
"147.32.84.165",2113,"72.20.15.61",80,3,186,3,186,0,0,85376.299295,8.928638999990653,166.65473875711155,0
"147.32.84.165",2114,"67.19.72.206",80,3,186,3,186,0,0,85376.299458,8.928499000001466,166.65735192441144,0
"147.32.84.165",2115,"193.23.181.44",80,3,186,3,186,0,0,85376.299567,8.92841400000907,166.65893853023488,0
"147.32.84.165",2116,"174.128.246.102",80,3,186,3,186,0,0,85376.299673,8.928331999995862,166.66046916721842,0
"147.32.84.165",2117,"72.20.15.61",80,3,186,3,186,0,0,85376.316741,8.911288000002969,166.9792290406846,0
"147.32.84.165",2118,"193.23.181.44",179,3,186,3,186,0,0,85376.322222,8.905830000003334,167.08156342524424,0
"147.32.84.165",2119,"174.128.246.102",80,8,692,4,450,4,242,85376.322362,0.3228149999922607,11151.898146264293,5997.243003102131
"147.32.84.165",2120,"193.23.181.44",80,3,186,3,186,0,0,85376.322471,8.905604999992647,167.08578473907482,0
"147.32.84.165",2121,"174.128.246.102",80,9,684,6,500,3,184,85376.363656,6.313830999992206,633.5297856412276,233.13896111597177
"147.32.84.165",2122,"193.23.181.44",80,3,186,3,186,0,0,85376.398531,8.930523999995785,166.61956230123812,0
"147.32.84.165",2123,"174.128.246.102",80,3,186,3,186,0,0,85376.399654,8.929523000013432,166.6382403626444,0
"147.32.84.165",2124,"72.20.15.61",80,3,186,3,186,0,0,85376.40029,8.928935999996611,166.6491953801175,0
"147.32.84.165",2125,"174.37.196.55",80,3,186,3,186,0,0,85376.400509,8.92876100000285,166.65246163488135,0
"147.32.84.165",2126,"174.37.196.55",80,3,186,3,186,0,0,85376.400732,8.92858900000283,166.65567202158462,0
"147.32.84.165",2127,"193.23.181.44",179,3,186,3,186,0,0,85376.401001,8.928367000000435,166.65981584313542,0
"147.32.84.165",2128,"72.20.15.61",80,3,186,3,186,0,0,85376.401219,8.928192999999737,166.663063847303,0
"147.32.84.165",2129,"67.19.72.206",80,3,186,3,186,0,0,85376.401434,8.928025000001071,166.66619997141825,0
"147.32.84.165",2130,"67.19.72.206",80,3,186,3,186,0,0,85376.401667,8.927838000003248,166.6696909150299,0
"147.32.84.165",2131,"67.19.72.206",80,3,186,3,186,0,0,85376.401883,8.927668999996968,166.67284595794328,0
"147.32.84.165",2132,"174.37.196.55",80,3,186,3,186,0,0,85376.402098,8.927499999990687,166.67600112030829,0
"147.32.84.165",2133,"72.20.15.61",80,3,186,3,186,0,0,85376.402315,8.92732899999828,166.67919374319985,0
"147.32.84.165",2134,"174.37.196.55",80,3,186,3,186,0,0,85376.402531,8.927162000007229,166.682311802877,0
"147.32.84.165",2135,"193.23.181.44",80,3,186,3,186,0,0,85376.402747,8.926993000000948,166.68546732363765,0
"147.32.84.165",2136,"193.23.181.44",80,3,186,3,186,0,0,85376.402963,8.926823000001605,166.68864163652987,0
"147.32.84.165",2138,"193.23.181.44",179,3,186,3,186,0,0,85376.403182,8.92664700000023,166.69192811141312,0
"147.32.84.165",2139,"193.23.181.44",80,3,186,3,186,0,0,85376.403398,8.926480000009178,166.69504664755536,0
"147.32.84.165",2140,"67.19.72.206",80,3,186,3,186,0,0,85376.403613,8.926311000002897,166.69820265051453,0
"147.32.84.165",2142,"67.19.72.206",80,3,186,3,186,0,0,85376.403976,8.92599699999846,166.70406678382892,0
"147.32.84.165",2143,"193.23.181.44",80,3,186,3,186,0,0,85376.404195,8.925828999999794,166.70720445126545,0
"147.32.84.165",2144,"67.19.72.206",80,3,186,3,186,0,0,85376.404412,8.92565599999216,166.71043562527024,0
"147.32.84.165",2145,"67.19.72.206",80,3,186,3,186,0,0,85376.404625,8.925491000001784,166.71351749721137,0
"147.32.84.165",2141,"72.20.15.61",80,3,186,3,186,0,0,85376.404837,8.92532600001141,166.71659948309986,0
"147.32.84.165",2146,"72.20.15.61",80,3,186,3,186,0,0,85376.465806,8.864403000014136,167.8624042699353,0
"147.32.84.165",2147,"193.23.181.44",80,3,186,3,186,0,0,85376.485016,8.845239999995101,168.22607413714314,0
"147.32.84.165",2148,"193.23.181.44",179,3,186,3,186,0,0,85376.498122,8.932293999998365,166.58654540482797,0
"147.32.84.165",2149,"193.23.181.44",179,3,186,3,186,0,0,85376.49861,8.931895000001532,166.59398705423035,0
"147.32.84.165",2150,"67.19.72.206",80,3,186,3,186,0,0,85376.498775,8.931758000006084,166.59654236030426,0
"147.32.84.165",2151,"193.23.181.44",80,3,186,3,186,0,0,85376.498907,8.931649000005564,166.59857547011455,0
"147.32.84.165",2152,"174.37.196.55",80,3,186,3,186,0,0,85376.499052,8.931526000000304,166.600869772976,0
"147.32.84.165",2153,"174.128.246.102",80,6,522,4,400,2,122,85376.499187,0.3203910000011092,9987.79616153051,3046.2778292668054
"147.32.84.165",2154,"174.37.196.55",80,3,186,3,186,0,0,85376.499295,8.931305999998585,166.60497356156375,0
"147.32.84.165",2155,"193.23.181.44",80,3,186,3,186,0,0,85376.499404,8.931220999991638,166.6065591705091,0
"147.32.84.165",2156,"67.19.72.206",80,3,186,3,186,0,0,85376.499511,8.931134999991627,166.60816346426236,0
"147.32.84.165",2157,"193.23.181.44",179,3,186,3,186,0,0,85376.499618,8.931049999999232,166.60974913365484,0
"147.32.84.165",2158,"193.23.181.44",80,3,186,3,186,0,0,85376.499725,8.930966999992961,166.61129752256085,0
"147.32.84.165",2159,"174.37.196.55",80,3,186,3,186,0,0,85376.499841,8.930873999997857,166.61303249831505,0
"147.32.84.165",2160,"193.23.181.44",80,3,186,3,186,0,0,85376.49995,8.93078599999717,166.6146742291744,0
"147.32.84.165",2161,"174.128.246.102",80,3,186,3,186,0,0,85376.500056,8.930703999998514,166.61620405292211,0
"147.32.84.165",2162,"193.23.181.44",80,3,186,3,186,0,0,85376.500163,8.930617999998503,166.61780853242735,0
"147.32.84.165",2163,"67.19.72.206",80,3,186,3,186,0,0,85376.50027,8.930530999990879,166.6194317002561,0
"147.32.84.165",2164,"193.23.181.44",179,3,186,3,186,0,0,85376.500388,8.930437000002712,166.62118550296566,0
"147.32.84.165",2165,"72.20.15.61",80,3,186,3,186,0,0,85376.50209,8.928756000008434,166.6525549582265,0
"147.32.84.165",2166,"174.37.196.55",80,3,186,3,186,0,0,85376.50529,8.925581000003149,166.71183646190372,0
"147.32.84.165",2167,"193.23.181.44",80,3,186,3,186,0,0,85376.516922,8.91397200000938,166.92895153792654,0
"147.32.84.165",2168,"72.20.15.61",80,3,186,3,186,0,0,85376.59742,8.934056999991299,166.55367208888964,0
"147.32.84.165",2169,"174.128.246.102",80,3,186,3,186,0,0,85376.598197,8.933332000000519,166.56718903986928,0
"147.32.84.165",2170,"193.23.181.44",80,3,186,3,186,0,0,85376.598495,8.933080999995582,166.5718692129553,0
"147.32.84.165",2171,"72.20.15.61",80,3,186,3,186,0,0,85376.598648,8.932975000003353,166.57384577919916,0
"147.32.84.165",2172,"67.19.72.206",80,3,186,3,186,0,0,85376.598826,8.932843000002322,166.57630722935724,0
"147.32.84.165",2173,"67.19.72.206",80,3,186,3,186,0,0,85376.599097,8.932618000006187,166.580503050614,0
"147.32.84.165",2174,"67.19.72.206",80,3,186,3,186,0,0,85376.59932,8.932442000004812,166.58378526266372,0
"147.32.84.165",2175,"67.19.72.206",80,3,186,3,186,0,0,85376.599609,8.932199000002583,166.58831716574716,0
"147.32.84.165",2176,"193.23.181.44",179,3,186,3,186,0,0,85376.660797,8.871056999996654,167.73649408413917,0
"147.32.84.165",2177,"72.20.15.61",80,3,186,3,186,0,0,85376.697724,8.933038000002853,166.5726710218321,0
"147.32.84.165",2178,"72.20.15.61",80,3,186,3,186,0,0,85376.697916,8.932971999995061,166.57390172059453,0
"147.32.84.165",2179,"72.20.15.61",80,3,186,3,186,0,0,85376.800783,8.931085000003804,166.60909620716475,0
"147.32.84.165",2180,"174.128.246.102",80,3,186,3,186,0,0,85376.802218,8.929707999996026,166.63478805809353,0
"147.32.84.165",2181,"72.20.15.61",80,3,186,3,186,0,0,85376.802439,8.929507999986527,166.63852028602753,0
"147.32.84.165",2182,"174.37.196.55",80,3,186,3,186,0,0,85376.802727,8.929246999992756,166.6433910945914,0
"147.32.84.165",2183,"174.37.196.55",80,3,186,3,186,0,0,85376.802946,8.929050999999163,166.64704905371684,0
"147.32.84.165",2184,"174.128.246.102",80,3,186,3,186,0,0,85376.803161,8.928856999991694,166.6506698451307,0
"147.32.84.165",2185,"72.20.15.61",80,3,186,3,186,0,0,85376.803376,8.928664000006393,166.65427212838725,0
"147.32.84.165",2186,"193.23.181.44",179,3,186,3,186,0,0,85376.803594,8.928469999998924,166.65789323368722,0
"147.32.84.165",2187,"67.19.72.206",80,3,186,3,186,0,0,85376.803809,8.928275999991456,166.66151449635115,0
"147.32.84.165",2188,"67.19.72.206",80,3,186,3,186,0,0,85376.804024,8.928083000006154,166.66511724845907,0
"147.32.84.165",2189,"72.20.15.61",80,3,186,3,186,0,0,85376.804299,8.927831000008155,166.669821594813,0
"147.32.84.165",2190,"174.128.246.102",80,3,186,3,186,0,0,85376.804518,8.92763500000001,166.6734807146572,0
"147.32.84.165",2191,"72.20.15.61",80,3,186,3,186,0,0,85376.804733,8.927442000000156,166.67708398441277,0
"147.32.84.165",2192,"174.128.246.102",80,3,186,3,186,0,0,85376.804951,8.927244999998948,166.68076209403634,0
"147.32.84.165",2193,"72.20.15.61",80,3,186,3,186,0,0,85376.805166,8.927052999992156,166.6843470069358,0
"147.32.84.165",2194,"174.37.196.55",80,3,186,3,186,0,0,85376.805381,8.926863000000594,166.68789472851785,0
"147.32.84.165",2195,"174.128.246.102",80,3,186,3,186,0,0,85376.805598,8.926668000000063,166.69153596840272,0
"147.32.84.165",2196,"174.37.196.55",80,3,186,3,186,0,0,85376.805813,8.92647500000021,166.6951400188725,0
"147.32.84.165",2197,"67.19.72.206",80,3,186,3,186,0,0,85376.806029,8.926282000000356,166.6987442251926,0
"147.32.84.165",2198,"72.20.15.61",80,3,186,3,186,0,0,85376.806304,8.926029000009294,166.70346914607276,0
"147.32.84.165",2199,"193.23.181.44",80,3,186,3,186,0,0,85376.806523,8.925832999986596,166.7071297437712,0
"147.32.84.165",2200,"67.19.72.206",80,3,186,3,186,0,0,85376.806738,8.92563899999368,166.71075314619532,0
"147.32.84.165",2201,"67.19.72.206",80,3,186,3,186,0,0,85376.807005,8.925396000006003,166.71529196004292,0
"147.32.84.165",2202,"67.19.72.206",80,3,186,3,186,0,0,85376.807223,8.925199999997858,166.71895307672176,0
"147.32.84.165",2203,"72.20.15.61",80,3,186,3,186,0,0,85376.817418,8.915027999988524,166.90917852438776,0
"147.32.84.165",2204,"174.37.196.55",80,3,186,3,186,0,0,85376.837619,8.89484999999695,167.28781261072533,0
"147.32.84.165",2205,"193.23.181.44",80,3,186,3,186,0,0,85376.898776,8.932566999996197,166.5814541330206,0
"147.32.84.165",2207,"174.128.246.102",80,3,186,3,186,0,0,85376.900047,8.931402000001981,166.60318279254142,0
"147.32.84.165",2206,"174.128.246.102",80,3,186,3,186,0,0,85376.900327,8.931146000002627,166.60795826197023,0
"147.32.84.165",2208,"193.23.181.44",179,3,186,3,186,0,0,85376.900584,8.930909999995492,166.61236089051968,0
"147.32.84.165",2209,"174.128.246.102",80,3,186,3,186,0,0,85376.900856,8.930658000012045,166.6170622587936,0
"147.32.84.165",2210,"67.19.72.206",80,3,186,3,186,0,0,85376.90117,8.930371000009472,166.6224169184485,0
"147.32.84.165",2211,"193.23.181.44",179,3,186,3,186,0,0,85376.901439,8.93012400000589,166.62702555966956,0
"147.32.84.165",2212,"174.37.196.55",80,3,186,3,186,0,0,85376.901771,8.929814000002807,166.63281004503926,0
"147.32.84.165",2213,"193.23.181.44",80,3,186,3,186,0,0,85376.902027,8.92957999999635,166.6371766645921,0
"147.32.84.165",2214,"174.128.246.102",80,3,186,3,186,0,0,85376.902293,8.929337999987183,166.64169281106123,0
"147.32.84.165",2215,"193.23.181.44",179,3,186,3,186,0,0,85376.90265,8.92900199998985,166.6479635687943,0
"147.32.84.165",2216,"193.23.181.44",179,3,186,3,186,0,0,85376.903064,8.92861499999708,166.65518672274328,0
"147.32.84.165",2217,"174.37.196.55",80,3,186,3,186,0,0,85376.903557,8.928146999998717,166.66392253624565,0
"147.32.84.165",2218,"72.20.15.61",80,3,186,3,186,0,0,85376.90386,8.927865999998176,166.66916819767502,0
"147.32.84.165",2219,"174.37.196.55",80,3,186,3,186,0,0,85376.904097,8.927648999990197,166.67321934381985,0
"147.32.84.165",2220,"193.23.181.44",80,3,186,3,186,0,0,85376.904341,8.927425999994739,166.67738270817108,0
"147.32.84.165",2221,"72.20.15.61",80,8,662,5,480,3,182,85377.00047,3.3748800000030315,1137.8182335361705,431.4227468824646
"147.32.84.165",2222,"67.19.72.206",80,3,186,3,186,0,0,85377.001874,8.930569000003743,166.61872272633204,0
"147.32.84.165",2223,"174.128.246.102",80,3,186,3,186,0,0,85377.002608,8.929903000011109,166.63114929671116,0
"147.32.84.165",2224,"174.128.246.102",80,3,186,3,186,0,0,85377.002893,8.929642999995849,166.6360010137798,0
"147.32.84.165",2225,"174.128.246.102",80,3,186,3,186,0,0,85377.00315,8.929409999997006,166.64034913846479,0
"147.32.84.165",2226,"67.19.72.206",80,3,186,3,186,0,0,85377.003372,8.929211999988183,166.64404428990701,0
"147.32.84.165",2227,"72.20.15.61",80,3,186,3,186,0,0,85377.003586,8.929020999989007,166.64760895979884,0
"147.32.84.165",2228,"174.37.196.55",80,3,186,3,186,0,0,85377.003801,8.928828999996767,166.65119244646064,0
"147.32.84.165",2229,"193.23.181.44",179,3,186,3,186,0,0,85377.004087,8.928565000009257,166.6561199922336,0
"147.32.84.165",2230,"193.23.181.44",80,3,186,3,186,0,0,85377.004306,8.928369999994175,166.65975984429082,0
"147.32.84.165",2231,"67.19.72.206",80,3,186,3,186,0,0,85377.018692,8.914006000006339,166.9283148338628,0
"147.32.84.165",2232,"193.23.181.44",80,3,186,3,186,0,0,85377.038867,8.893855000002077,167.30652793413572,0
"147.32.84.165",2233,"193.23.181.44",179,3,186,3,186,0,0,85377.100947,8.930993000001763,166.61081248184902,0
"147.32.84.165",2234,"174.128.246.102",80,3,186,3,186,0,0,85377.102083,8.929992999997921,166.62946992235564,0
"147.32.84.165",2235,"193.23.181.44",179,3,186,3,186,0,0,85377.102279,8.929847000006703,166.63219425807443,0
"147.32.84.165",2236,"193.23.181.44",80,3,186,3,186,0,0,85377.102628,8.929545000006328,166.6378298109193,0
"147.32.84.165",2237,"193.23.181.44",179,3,186,3,186,0,0,85377.102817,8.929403999994975,166.64046111037618,0
"147.32.84.165",2238,"193.23.181.44",80,3,186,3,186,0,0,85377.103049,8.929218999997829,166.6439136502713,0
"147.32.84.165",2239,"193.23.181.44",179,3,186,3,186,0,0,85377.103237,8.929078000001027,166.64654514159568,0
"147.32.84.165",2240,"174.37.196.55",80,3,186,3,186,0,0,85377.103424,8.928937999997288,166.64915805221762,0
"147.32.84.165",2241,"193.23.181.44",80,3,186,3,186,0,0,85377.103631,8.92877800000133,166.6521443359638,0
"147.32.84.165",2242,"193.23.181.44",179,3,186,3,186,0,0,85377.103818,8.928638999990653,166.65473875711155,0
"147.32.84.165",2243,"67.19.72.206",80,3,186,3,186,0,0,85377.104002,8.928504000010435,166.65725859542215,0
"147.32.84.165",2244,"72.20.15.61",80,3,186,3,186,0,0,85377.104187,8.928367999993498,166.65979717694026,0
"147.32.84.165",2245,"67.19.72.206",80,3,186,3,186,0,0,85377.104374,8.928226999996696,166.66242916992934,0
"147.32.84.165",2246,"174.128.246.102",80,3,186,3,186,0,0,85377.104625,8.928023999993457,166.66621863931937,0
"147.32.84.165",2247,"72.20.15.61",80,3,186,3,186,0,0,85377.104812,8.927886999998009,166.6687761617426,0
"147.32.84.165",2248,"174.37.196.55",80,3,186,3,186,0,0,85377.105052,8.92769500000577,166.67236055880474,0
"147.32.84.165",2249,"72.20.15.61",80,3,186,3,186,0,0,85377.10524,8.927553000001353,166.67501161849998,0
"147.32.84.165",2250,"174.128.246.102",80,3,186,3,186,0,0,85377.105457,8.92738300000201,166.67818553316968,0
"147.32.84.165",2251,"174.37.196.55",80,3,186,3,186,0,0,85377.105646,8.927242000005208,166.68081810699564,0
"147.32.84.165",2252,"67.19.72.206",80,3,186,3,186,0,0,85377.200947,8.932036999991396,166.59133857164198,0
"147.32.84.165",2253,"174.37.196.55",80,3,186,3,186,0,0,85377.201126,8.931916000001365,166.59359537189698,0
"147.32.84.165",2254,"67.19.72.206",80,3,186,3,186,0,0,85377.201291,8.931774999990012,166.59622527455787,0
"147.32.84.165",2255,"67.19.72.206",80,3,186,3,186,0,0,85377.2014,8.931689999997616,166.59781071671736,0
"147.32.84.165",2256,"193.23.181.44",80,3,186,3,186,0,0,85377.201507,8.931604999990668,166.59939618932484,0
"147.32.84.165",2257,"174.128.246.102",80,3,186,3,186,0,0,85377.201613,8.93152199999895,166.60094438553418,0
"147.32.84.165",2258,"174.37.196.55",80,3,186,3,186,0,0,85377.302979,8.929459000006318,166.63943470695673,0
"147.32.84.165",2259,"193.23.181.44",80,3,186,3,186,0,0,85377.303332,8.929231000001892,166.6436896973194,0
"147.32.84.165",2260,"174.128.246.102",80,3,186,3,186,0,0,85377.401117,8.932514999993145,166.5824238751507,0
"147.32.84.165",2261,"67.19.72.206",80,3,186,3,186,0,0,85377.401297,8.9323929999955,166.58469908352103,0
"147.32.84.165",2262,"193.23.181.44",179,3,186,3,186,0,0,85377.501045,8.932058000005782,166.59094690149087,0
"147.32.84.165",2263,"72.20.15.61",80,3,186,3,186,0,0,85377.50136,8.931865000005928,166.59454660353828,0
"147.32.84.165",2264,"174.128.246.102",80,3,186,3,186,0,0,85377.501572,8.931704000002355,166.59754958288,0
"147.32.84.165",2265,"67.19.72.206",80,3,186,3,186,0,0,85377.902669,8.933007999992697,166.57323042822938,0
"147.32.84.165",2266,"72.20.15.61",80,3,186,3,186,0,0,85377.902869,8.932929999995395,166.57468490190422,0
"147.32.84.165",2267,"72.20.15.61",80,3,186,3,186,0,0,85378.104183,8.932176000002073,166.58874612408607,0
"147.32.84.165",2269,"174.128.246.102",80,7,588,4,406,3,182,85378.104688,0.32006499999260996,10147.93870018588,4549.075969048843
"147.32.84.165",2268,"174.128.246.102",80,3,186,3,186,0,0,85378.104907,8.931500999999116,166.60133610242525,0
"147.32.84.165",2270,"72.20.15.61",80,3,186,3,186,0,0,85378.228599,8.907090000007884,167.05792801001033,0
"147.32.84.165",2271,"174.128.246.102",80,8,712,6,590,2,122,85378.231777,9.233657000004314,511.1734169893678,105.70026588593707
"147.32.84.165",2272,"174.128.246.102",80,3,186,3,186,0,0,85378.234997,8.900864999988698,167.17476335186404,0
"147.32.84.165",2273,"67.19.72.206",80,3,186,3,186,0,0,85378.238179,8.897726999988663,167.23372160124669,0
"147.32.84.165",2274,"174.128.246.102",80,3,186,3,186,0,0,85378.241397,8.894556999992346,167.29332332136164,0
"147.32.84.165",2275,"67.19.72.206",80,3,186,3,186,0,0,85378.244597,8.891403000001446,167.35266639019264,0
"147.32.84.165",2276,"193.23.181.44",179,3,186,3,186,0,0,85378.265703,8.870345000002999,167.74995786516723,0
"147.32.84.165",2277,"174.37.196.55",80,3,186,3,186,0,0,85378.434998,8.802005999998073,169.05237283413868,0
"147.32.84.165",2278,"67.19.72.206",80,3,186,3,186,0,0,85378.438204,8.798846999998204,169.11306674616614,0
"147.32.84.165",2279,"72.20.15.61",80,3,186,3,186,0,0,85378.4414,8.795698000001721,169.173611917975,0
"147.32.84.165",2280,"67.19.72.206",80,3,186,3,186,0,0,85378.444617,8.79252699999779,169.23462390281816,0
"147.32.84.165",2281,"193.23.181.44",179,3,186,3,186,0,0,85378.447797,8.789393999992171,169.29494797949954,0
"147.32.84.165",2282,"174.128.246.102",80,3,186,3,186,0,0,85378.450997,8.78624599998875,169.3556042025121,0
"147.32.84.165",2283,"174.37.196.55",80,3,186,3,186,0,0,85378.454177,8.783097999999882,169.4163039055263,0
"147.32.84.165",2284,"174.128.246.102",80,3,186,3,186,0,0,85378.457399,8.779923999987659,169.4775490086351,0
"147.32.84.165",2285,"67.19.72.206",80,3,186,3,186,0,0,85378.460626,8.776744000002509,169.53895430920335,0
"147.32.84.165",2286,"174.37.196.55",80,3,186,3,186,0,0,85378.463778,8.773651999988942,169.59870302604608,0
"147.32.84.165",2287,"193.23.181.44",179,3,186,3,186,0,0,85378.466997,8.770480999999563,169.6600220672132,0
"147.32.84.165",2288,"72.20.15.61",80,3,186,3,186,0,0,85378.487799,8.749727000002167,170.06244880550346,0
"147.32.84.165",2289,"72.20.15.61",80,3,186,3,186,0,0,85378.509377,8.72819600001094,170.4819644286328,0
"147.32.84.165",2290,"174.128.246.102",80,3,186,3,186,0,0,85378.531807,8.804731999989599,169.00003316418463,0
"147.32.84.165",2291,"193.23.181.44",80,3,186,3,186,0,0,85378.534979,8.801607999994303,169.0600172151456,0
"147.32.84.165",2292,"67.19.72.206",80,3,186,3,186,0,0,85378.538179,8.798457000011695,169.12056284391937,0
"147.32.84.165",2294,"67.19.72.206",80,3,186,3,186,0,0,85378.541379,8.795303999999305,169.18119032612375,0
"147.32.84.165",2295,"174.128.246.102",80,3,186,3,186,0,0,85378.544579,8.792151000001468,169.24186129193546,0
"147.32.84.165",2293,"193.23.181.44",179,3,186,3,186,0,0,85378.547786,8.788991000008537,169.30271062953128,0
"147.32.84.165",2296,"67.19.72.206",80,3,186,3,186,0,0,85378.705662,8.932193000000552,166.58842906774495,0
"147.32.84.165",2297,"67.19.72.206",80,3,186,3,186,0,0,85378.705815,8.932099000012386,166.5901822178568,0
"147.32.84.165",2298,"174.37.196.55",80,9,725,6,543,3,182,85378.706012,9.174626000007265,473.47979089246365,158.69856711312778
"147.32.84.165",2299,"67.19.72.206",80,3,186,3,186,0,0,85378.706151,8.931810999987647,166.5955538022533,0
"147.32.84.165",2300,"72.20.15.61",80,3,186,3,186,0,0,85378.746126,8.891858999995748,167.3440840661904,0
"147.32.84.165",2301,"72.20.15.61",80,3,186,3,186,0,0,85378.763071,8.8749370000005,167.6631620032814,0
"147.32.84.165",2302,"193.23.181.44",80,3,186,3,186,0,0,85378.817611,8.919962999993004,166.81683545112992,0
"147.32.84.165",2303,"174.37.196.55",80,3,186,3,186,0,0,85378.820807,8.916810000009718,166.8758221828634,0
"147.32.84.165",2304,"72.20.15.61",80,3,186,3,186,0,0,85378.824009,8.913650999995298,166.93496301356032,0
"147.32.84.165",2305,"193.23.181.44",179,3,186,3,186,0,0,85378.827212,8.910491999995429,166.99414577789457,0
"147.32.84.165",2306,"67.19.72.206",80,3,186,3,186,0,0,85378.830393,8.907354000009946,167.0529766750416,0
"147.32.84.165",2307,"193.23.181.44",179,3,186,3,186,0,0,85378.833615,8.904175000003306,167.11261851877882,0
"147.32.84.165",2308,"193.23.181.44",179,3,186,3,186,0,0,85378.836793,8.901040000011562,167.17147659128227,0
"147.32.84.165",2309,"72.20.15.61",80,3,186,3,186,0,0,85378.839993,8.897882999997819,167.230789615953,0
"147.32.84.165",2310,"193.23.181.44",80,3,186,3,186,0,0,85378.843193,8.894727000006242,167.29012593629415,0
"147.32.84.165",2313,"72.20.15.61",80,3,186,3,186,0,0,85378.846394,8.891569000013988,167.34954202094806,0
"147.32.84.165",2314,"72.20.15.61",80,3,186,3,186,0,0,85378.849595,8.88841099999263,167.40900032651888,0
"147.32.84.165",2315,"174.37.196.55",80,3,186,3,186,0,0,85378.85281,8.885238000002573,167.46878361610223,0
"147.32.84.165",2311,"72.20.15.61",80,3,186,3,186,0,0,85378.856007,8.882087000005413,167.52819466856081,0
"147.32.84.165",2316,"193.23.181.44",80,3,186,3,186,0,0,85378.859208,8.878930000006221,167.58776113776744,0
"147.32.84.165",2317,"193.23.181.44",80,3,186,3,186,0,0,85379.107234,8.931433999998262,166.60258587817918,0
"147.32.84.165",2318,"174.128.246.102",80,3,186,3,186,0,0,85379.107369,8.931403999988106,166.60314548552293,0
"147.32.84.165",2319,"174.37.196.55",80,3,186,3,186,0,0,85379.20729,8.932000000000698,166.59202866098116,0
"147.32.84.165",2320,"174.37.196.55",80,3,186,3,186,0,0,85379.207493,8.931918000002042,166.59355806890073,0
"147.32.84.165",2321,"72.20.15.61",80,3,186,3,186,0,0,85379.207626,8.931832999995095,166.59514346056596,0
"147.32.84.165",2322,"72.20.15.61",80,3,186,3,186,0,0,85379.207766,8.931735999998637,166.59695270888292,0
"147.32.84.165",2323,"59.99.153.96",6667,2,124,2,124,0,0,85379.292628,2.925451000002795,339.0930150595762,0
"147.32.84.165",2324,"174.37.196.55",80,3,186,3,186,0,0,85379.30731,8.931513999996241,166.601093610851,0
"147.32.84.165",2325,"193.23.181.44",179,3,186,3,186,0,0,85379.307505,8.93138199999521,166.60355586635953,0
"147.32.84.165",2326,"67.19.72.206",80,3,186,3,186,0,0,85379.307629,8.931280000004335,166.60545856800792,0
"147.32.84.165",2327,"72.20.15.61",80,3,186,3,186,0,0,85379.30785,8.931083000003127,166.6091335171198,0
"147.32.84.165",2328,"67.19.72.206",80,3,186,3,186,0,0,85379.308018,8.931005000005825,166.61058861785762,0
"147.32.84.165",2329,"174.128.246.102",80,3,186,3,186,0,0,85379.310096,8.928983999998309,166.64829951540756,0
"147.32.84.165",2330,"193.23.181.44",179,3,186,3,186,0,0,85379.31332,8.92580799999996,166.70759666799987,0
"147.32.84.165",2331,"193.23.181.44",80,3,186,3,186,0,0,85379.410757,8.929351999991923,166.64143153963983,0
"147.32.84.165",2332,"174.37.196.55",80,3,186,3,186,0,0,85379.413956,8.926198000001023,166.70031294396892,0
"147.32.84.165",2333,"72.20.15.61",80,3,186,3,186,0,0,85379.417155,8.92304399999557,166.75923597381552,0
"147.32.84.165",2334,"174.37.196.55",80,3,186,3,186,0,0,85379.420385,8.919861000002129,166.81874302745803,0
"147.32.84.165",2335,"67.19.72.206",80,3,186,3,186,0,0,85379.423586,8.916705999989063,166.87776853939394,0
"147.32.84.165",2336,"174.37.196.55",80,3,186,3,186,0,0,85379.476402,8.86393500000122,167.87126710651592,0
"147.32.84.165",2337,"174.128.246.102",80,3,186,3,186,0,0,85379.508427,8.931363000010606,166.6039102876272,0
"147.32.84.165",2338,"193.23.181.44",179,3,186,3,186,0,0,85379.708245,8.932065999993938,166.5907976946218,0
"147.32.84.165",2339,"174.37.196.55",80,3,186,3,186,0,0,85379.811685,8.929991000011796,166.62950724116456,0
"147.32.84.165",2340,"193.23.181.44",80,3,186,3,186,0,0,85379.814884,8.926813999991282,166.68880969195206,0
"147.32.84.165",2341,"193.23.181.44",80,3,186,3,186,0,0,85379.818084,8.923639000000549,166.74811699575795,0
"147.32.84.165",2342,"67.19.72.206",80,3,186,3,186,0,0,85379.821285,8.920461999994586,166.8075039163782,0
"147.32.84.165",2343,"193.23.181.44",179,3,186,3,186,0,0,85379.824511,8.917262999995728,166.8673448344759,0
"147.32.84.165",2344,"174.128.246.102",80,3,186,3,186,0,0,85379.827716,8.914080999995349,166.9269103568586,0
"147.32.84.165",2345,"174.37.196.55",80,3,186,3,186,0,0,85379.830914,8.910904999997001,166.98640598238907,0
"147.32.84.165",2346,"174.128.246.102",80,3,186,3,186,0,0,85379.834118,8.9077249999973,167.04601904531754,0
"147.32.84.165",2347,"193.23.181.44",179,3,186,3,186,0,0,85380.110805,8.931077999994159,166.60922679221625,0
"147.32.84.165",2348,"193.23.181.44",80,3,186,3,186,0,0,85380.192974,8.848956999994698,168.15541085812617,0
"147.32.84.165",2349,"193.23.181.44",179,3,186,3,186,0,0,85380.209919,9.032619999998133,164.73625592577875,0
"147.32.84.165",2350,"193.23.181.44",80,3,186,3,186,0,0,85380.310362,9.033595000000787,164.71847586701313,0
"147.32.84.165",2351,"193.23.181.44",80,3,186,3,186,0,0,85380.410175,8.933841000005486,166.55769897842217,0
"147.32.84.165",2352,"184.82.148.43",80,10,1919,5,979,5,940,85380.538655,0.30496799999673385,25681.382965045115,24658.32480811278
"147.32.84.165",2353,"184.82.148.44",80,10,1513,5,596,5,917,85380.746527,0.341922000006889,13944.70083792191,21455.18568519193
"147.32.84.165",2354,"217.163.21.36",80,14,6137,7,809,7,5328,85380.987187,0.1875959999888437,34499.66950459972,227211.66763968766
"147.32.84.165",2355,"217.163.21.36",80,10,1448,5,699,5,749,85381.132903,0.13934599999629427,40130.32308174409,43000.87551963709
"147.32.84.165",2356,"193.23.181.44",80,3,186,3,186,0,0,85381.213663,8.933468999995966,166.56463463416864,0
"147.32.84.165",2357,"217.163.21.35",80,12,3822,6,2134,6,1688,85381.22706,0.22630100000242237,75439.34847754653,59672.7367526235
"147.32.84.165",2358,"193.23.181.44",80,3,186,3,186,0,0,85381.334634,8.912054000000353,166.96487700814438,0
"147.32.84.165",2359,"174.37.196.55",80,3,186,3,186,0,0,85381.337835,8.908899999994901,167.02398724880194,0
"147.32.84.165",2360,"193.23.181.44",179,3,186,3,186,0,0,85381.341002,8.90578000000096,167.08250147655116,0
"147.32.84.165",2361,"193.23.181.44",179,3,186,3,186,0,0,85381.344201,8.902629999996861,167.1416199483214,0
"147.32.84.165",2362,"217.163.21.36",80,10,2274,5,1154,5,1120,85381.410978,0.13966699999582488,66100.0809087041,64152.59152317902
"147.32.84.165",2363,"174.128.246.102",80,3,186,3,186,0,0,85381.414283,8.933511999988696,166.5638329026572,0
"147.32.84.165",2364,"217.163.21.35",80,13,5690,7,2649,6,3041,85381.505165,0.1562770000018645,135605.3673908967,155672.29982473268
"147.32.84.165",2365,"174.37.196.55",80,3,186,3,186,0,0,85381.514023,8.933492000011029,166.5642057997212,0
"147.32.84.165",2366,"173.241.240.4",80,9,2194,5,1164,4,1030,85381.621397,0.066145000004326,140781.6161371378,124574.7977845807
"147.32.84.165",2367,"72.20.15.61",80,3,186,3,186,0,0,85381.817308,8.931580999997095,166.59984385748547,0
"147.32.84.165",2368,"193.23.181.44",179,3,186,3,186,0,0,85382.619216,8.93110999999044,166.60862983454385,0
"147.32.84.165",2369,"72.20.15.61",80,3,186,3,186,0,0,85384.325624,8.930838999993284,166.61368545565753,0
"147.32.84.165",2370,"193.23.181.44",179,3,186,3,186,0,0,85384.328812,8.927756999997655,166.67120308050397,0
"147.32.84.165",2371,"193.23.181.44",179,3,186,3,186,0,0,85384.332013,8.924583999993047,166.73046048994098,0
"147.32.84.165",2372,"174.37.196.55",80,3,186,3,186,0,0,85384.35759,8.999844000005396,165.33619916068633,0
"147.32.84.165",2373,"193.23.181.44",80,3,186,3,186,0,0,85384.360807,8.99668599999859,165.39423516617487,0
"147.32.84.165",2374,"174.128.246.102",80,3,186,3,186,0,0,85384.74214,9.01588300000003,165.04207075446686,0
"147.32.84.165",2375,"72.20.15.61",80,3,186,3,186,0,0,85384.745339,9.012742999999318,165.0995706856517,0
"147.32.84.165",2376,"72.20.15.61",80,3,186,3,186,0,0,85385.330681,9.028890999994474,164.80429324054424,0
"147.32.84.165",2377,"193.23.181.44",179,3,186,3,186,0,0,85385.332261,9.027369999996154,164.83206072207454,0
"147.32.84.165",2378,"193.23.181.44",179,3,186,3,186,0,0,85385.335461,9.024193000004743,164.89009044899836,0
"147.32.84.165",2379,"174.37.196.55",80,3,186,3,186,0,0,85385.33866,9.021017999999458,164.94812447997435,0
"147.32.84.165",2380,"193.23.181.44",179,3,186,3,186,0,0,85385.53236,9.028158000000985,164.81767377130944,0
"147.32.84.165",2381,"67.19.72.206",80,3,186,3,186,0,0,85385.532601,9.027962000007392,164.82125201665465,0
"147.32.84.165",2382,"193.23.181.44",179,3,186,3,186,0,0,85385.735071,9.026251000002958,164.85249523855612,0
"147.32.84.165",2383,"174.37.196.55",80,3,186,3,186,0,0,85385.831953,9.029844999997295,164.7868817239328,0
"147.32.84.165",2384,"72.20.15.61",80,3,186,3,186,0,0,85385.832167,9.029695000004722,164.7896191398737,0
"147.32.84.165",2385,"46.4.36.120",443,6,366,3,186,3,180,85386.060122,1.005276000010781,1480.1905148278106,1432.4424337043329
"147.32.84.165",2386,"67.19.72.206",80,3,186,3,186,0,0,85386.133359,9.028470999997808,164.81195985459345,0
"147.32.84.165",2387,"193.23.181.44",80,3,186,3,186,0,0,85386.233022,9.029483000005712,164.7934881763506,0
"147.32.84.165",2388,"174.37.196.55",80,3,186,3,186,0,0,85386.233263,9.029343999995035,164.7960250490864,0
"147.32.84.165",2389,"174.37.196.55",80,3,186,3,186,0,0,85387.238289,9.027629999996861,164.82731348100413,0
"147.32.84.165",2390,"67.19.72.206",80,3,186,3,186,0,0,85387.238533,9.027492000008351,164.82983313622694,0
"147.32.84.165",2391,"193.23.181.44",80,3,186,3,186,0,0,85387.238773,9.027281000002404,164.83368580191575,0
"147.32.84.165",2392,"174.37.196.55",80,3,186,3,186,0,0,85387.239212,9.026868000000832,164.84122732268412,0
"147.32.84.165",2393,"174.128.246.102",80,3,186,3,186,0,0,85387.301603,8.96450200000254,165.9880269979948,0
"147.32.84.165",2394,"193.23.181.44",179,3,186,3,186,0,0,85387.33712,9.052838000003248,164.3683450426779,0
"147.32.84.165",2395,"174.128.246.102",80,3,186,3,186,0,0,85387.337477,9.055662000013399,164.31708692283328,0
"147.32.84.165",2396,"193.23.181.44",179,3,186,3,186,0,0,85387.738465,9.028990999999223,164.80246796127363,0
"147.32.84.165",2397,"193.23.181.44",179,3,186,3,186,0,0,85387.760149,9.007329000000027,165.198806438623,0
"147.32.84.165",2398,"46.4.36.120",443,6,366,3,186,3,180,85388.064828,1.0077409999939846,1476.569872624893,1428.9385864111866
"147.32.84.165",2399,"193.23.181.44",179,3,186,3,186,0,0,85388.340838,9.029870999991545,164.78640724783259,0
"147.32.84.165",2400,"174.37.196.55",80,3,186,3,186,0,0,85388.341109,9.029643999994732,164.79054988223987,0
"147.32.84.165",2401,"193.23.181.44",179,3,186,3,186,0,0,85388.74214,9.029521000004024,164.79279465647588,0
"147.32.84.165",2402,"193.23.181.44",179,3,186,3,186,0,0,85388.742252,9.02953100000741,164.792612152146,0
"147.32.84.165",2403,"184.82.148.43",80,10,1895,5,979,5,916,85388.750036,0.3453670000017155,22677.325859045875,21218.008668933628
"147.32.84.165",2404,"193.23.181.44",80,3,186,3,186,0,0,85388.842085,9.03016999999818,164.78095096773373,0
"147.32.84.165",2405,"67.19.72.206",80,3,186,3,186,0,0,85388.842329,9.029986999987159,164.78429038736334,0
"147.32.84.165",2406,"174.37.196.55",80,3,186,3,186,0,0,85388.842653,9.029704999993555,164.78943664284293,0
"147.32.84.165",2407,"184.82.148.44",80,10,1307,5,580,5,727,85388.982001,0.3409000000101514,13611.029627051419,17060.72161873514
"147.32.84.165",2408,"193.23.181.44",179,3,186,3,186,0,0,85389.14235,9.054347000012058,164.34095136822327,0
"147.32.84.165",2409,"178.123.195.112",6667,6,366,3,186,3,180,85389.298179,1.107490999987931,1343.577509899598,1300.2362999028367
"147.32.84.165",2410,"93.184.220.20",80,14,6630,8,757,6,5873,85389.437472,6.256811999992351,967.9050609171896,7509.255512241288
"147.32.84.165",2412,"195.113.232.97",80,15,3639,9,1690,6,1949,85389.504908,67.81826800000272,199.35631502708767,229.90855502236323
"147.32.84.165",2413,"74.125.232.207",80,30,18699,15,3857,15,14842,85389.505942,67.81694999999308,454.9894974634387,1750.8307288961257
"147.32.84.165",2414,"70.42.33.241",80,9,1312,5,555,4,757,85389.521411,0.4289590000116732,10350.6395713324,14117.899379276805
"147.32.84.165",2415,"195.113.232.97",80,10,2885,6,643,4,2242,85389.521846,67.80123599999934,75.86882339431173,264.5379503111149
"147.32.84.165",2416,"74.125.232.207",80,10,2553,6,1663,4,890,85389.589312,67.73347400000785,196.41691492154175,105.11789193035005
"147.32.84.165",2417,"195.113.232.89",80,8,3239,5,541,3,2698,85389.727312,67.59567500000412,64.02776508999631,319.3103700791313
"147.32.84.165",2418,"67.19.72.206",80,4,246,3,186,1,60,85389.736942,9.109784000000218,163.3408651621119,52.690601665197384
"147.32.84.165",2419,"68.67.185.210",80,10,1603,6,777,4,826,85389.838513,14.212026000008336,437.3760644679621,464.95833880377955
"147.32.84.165",2420,"68.67.185.209",80,17,6924,10,2871,7,4053,85389.889793,22.739759000003687,1010.0370896629237,1425.872631279634
"147.32.84.165",2421,"94.245.121.179",80,8,1737,5,650,3,1087,85389.977043,0.16141799998877104,32214.499004830534,53872.5544896166
"147.32.84.165",2422,"46.4.36.120",443,6,366,3,186,3,180,85390.074427,1.002399000004516,1484.4388312371584,1436.5537076488629
"147.32.84.165",2423,"195.113.232.91",80,8,1052,5,657,3,395,85390.137771,67.1848800000007,78.23188788905993,47.034392262067996
"147.32.84.165",2424,"217.163.21.35",80,14,5892,7,789,7,5103,85390.23526,0.1912609999999404,33002.023413042734,213446.54686534486
"147.32.84.165",2425,"217.163.21.35",80,10,1525,5,703,5,822,85390.390299,0.15729299999657087,35754.92870072163,41807.32772687508
"147.32.84.165",2426,"46.137.48.58",80,8,1445,5,618,3,827,85390.437364,0.14129200000024866,34991.365399253315,46825.01486275483
"147.32.84.165",2427,"174.37.196.55",80,3,186,3,186,0,0,85390.447936,9.069597000008798,164.0646216142301,0
"147.32.84.165",2428,"217.163.21.35",80,13,4429,7,2203,6,2226,85390.502191,0.23511599999619648,74958.74377024578,75741.33619272224
"147.32.84.165",2429,"95.172.94.12",80,8,1340,5,764,3,576,85390.526695,0.10240100001101382,59686.917113530326,44999.56054632653
"147.32.84.165",2430,"174.37.196.55",80,3,186,3,186,0,0,85391.550572,9.031596000000718,164.75493367948275,0
"147.32.84.165",2431,"74.125.39.27",25,3,186,3,186,0,0,85391.951987,9.032013000003644,164.74732709080465,0
"147.32.84.165",2432,"46.4.36.120",443,6,366,3,186,3,180,85392.076721,1.0094839999946998,1474.0203906231427,1426.4713457643315
"147.32.84.165",2433,"174.128.246.102",80,3,186,3,186,0,0,85392.75606,9.029532999993535,164.7925756515941,0
"147.32.84.165",2434,"72.20.15.61",80,3,186,3,186,0,0,85393.055453,9.03164500001003,164.7540398231272,0
"147.32.84.165",2435,"182.2.117.2",6667,3,184,2,124,1,60,85393.416537,2.549337000004016,389.1207792451282,188.28424802183622
"147.32.84.165",2436,"193.23.181.44",80,3,186,3,186,0,0,85393.758316,9.031124999994063,164.7635261388784,0
"147.32.84.165",2437,"174.128.246.102",80,3,186,3,186,0,0,85393.758456,9.031041000009282,164.76505864589373,0
"147.32.84.165",2438,"193.23.181.44",80,3,186,3,186,0,0,85393.859281,9.029806999998982,164.78757519403987,0
"147.32.84.165",2439,"67.19.72.206",80,3,186,3,186,0,0,85393.859625,9.029592999999295,164.79148063485434,0
"147.32.84.165",2440,"193.23.181.44",80,3,186,3,186,0,0,85393.859885,9.02939100000367,164.79516724875413,0
"147.32.84.165",2441,"174.128.246.102",80,3,186,3,186,0,0,85393.958895,9.031076999992365,164.76440185387168,0
"147.32.84.165",2442,"193.23.181.44",80,3,186,3,186,0,0,85393.959246,9.030847999994876,164.7685798721055,0
"147.32.84.165",2443,"174.128.246.102",80,3,186,3,186,0,0,85394.058946,9.032635999988997,164.73596411964488,0
"147.32.84.165",2444,"46.4.36.120",443,6,366,3,186,3,180,85394.087314,1.0252429999964079,1451.3632377935899,1404.5450688325063
"147.32.84.165",2445,"67.19.72.206",80,3,186,3,186,0,0,85394.359925,9.03205500000331,164.74656099851634,0
"147.32.84.165",2446,"174.128.246.102",80,3,186,3,186,0,0,85394.360067,9.031956999999238,164.74834855836068,0
"147.32.84.165",2447,"174.37.196.55",80,3,186,3,186,0,0,85394.460613,9.031489999993937,164.75686736086723,0
"147.32.84.165",2448,"174.128.246.102",80,3,186,3,186,0,0,85394.86396,9.029494999995222,164.79326916962546,0
"147.32.84.165",2450,"193.23.181.44",80,3,186,3,186,0,0,85394.864295,9.029209000000264,164.79848899277405,0
"147.32.84.165",2449,"72.20.15.61",80,3,186,3,186,0,0,85394.864412,9.029139999998733,164.7997483702998,0
"147.32.84.165",2451,"72.20.15.61",80,3,186,3,186,0,0,85394.864549,9.029047999996692,164.801427570276,0
"147.32.84.165",2452,"174.128.246.102",80,3,186,3,186,0,0,85394.962502,9.031992000003811,164.7477101396206,0
"147.32.84.165",2453,"67.19.72.206",80,3,186,3,186,0,0,85394.962915,9.031640000001062,164.7541310326613,0
"147.32.84.165",2454,"193.23.181.44",80,3,186,3,186,0,0,85395.262782,9.031846999991103,164.75035504935656,0
"147.32.84.165",2455,"174.37.196.55",80,3,186,3,186,0,0,85395.966351,9.030529000010574,164.77440025919387,0
"147.32.84.165",2456,"72.20.15.61",80,3,186,3,186,0,0,85396.06574,9.031281999996281,164.7606618861655,0
"147.32.84.165",2457,"67.19.72.206",80,3,186,3,186,0,0,85396.066082,9.030998000002,164.76584315483964,0
"147.32.84.165",2458,"174.128.246.102",80,3,186,3,186,0,0,85396.066361,9.030740999995032,164.77053211921574,0
"147.32.84.165",2459,"46.4.36.120",443,6,366,3,186,3,180,85396.113693,1.082446999993408,1374.6631474881094,1330.3191749884932
"147.32.84.165",2460,"193.23.181.44",179,3,186,3,186,0,0,85396.165949,9.03114099999948,164.76323423586075,0
"147.32.84.165",2461,"193.23.181.44",179,3,186,3,186,0,0,85396.166142,9.030973000000813,164.76629926807067,0
"147.32.84.165",2462,"193.23.181.44",80,3,186,3,186,0,0,85396.166332,9.030806000009761,164.76934616892353,0
"147.32.84.165",2463,"72.20.15.61",80,3,186,3,186,0,0,85396.167599,9.029562000010628,164.79204639142503,0
"147.32.84.165",2464,"67.19.72.206",80,3,186,3,186,0,0,85396.168113,9.029071999990265,164.80098951493625,0
"147.32.84.165",2465,"174.37.196.55",80,3,186,3,186,0,0,85396.16852,9.028688999998849,164.80798042774424,0
"147.32.84.165",2466,"193.23.181.44",179,3,186,3,186,0,0,85396.16864,9.028594000003068,164.80971455793608,0
"147.32.84.165",2467,"174.128.246.102",80,3,186,3,186,0,0,85396.168758,9.02850000000035,164.8114304701714,0
"147.32.84.165",2468,"72.20.15.61",80,3,186,3,186,0,0,85396.168874,9.028407999998308,164.8131099082229,0
"147.32.84.165",2469,"174.128.246.102",80,7,601,4,419,3,182,85396.169039,0.3635070000018459,9221.280470480564,4005.424929898479
"147.32.84.165",2470,"174.128.246.102",80,3,186,3,186,0,0,85396.169167,9.02813900000183,164.8180206352271,0
"147.32.84.165",2471,"193.23.181.44",179,3,186,3,186,0,0,85396.169285,9.028044000006048,164.81975497671513,0
"147.32.84.165",2472,"193.23.181.44",80,3,186,3,186,0,0,85396.169402,9.027950999996392,164.82145284135842,0
"147.32.84.165",2473,"193.23.181.44",179,3,186,3,186,0,0,85396.169519,9.027858000001288,164.82315074071698,0
"147.32.84.165",2474,"174.37.196.55",80,3,186,3,186,0,0,85396.169635,9.027765000006184,164.82484867505752,0
"147.32.84.165",2475,"67.19.72.206",80,3,186,3,186,0,0,85396.169752,9.027671999996528,164.82654664464684,0
"147.32.84.165",2476,"67.19.72.206",80,3,186,3,186,0,0,85396.169893,9.027555000007851,164.8286828491996,0
"147.32.84.165",2477,"174.128.246.102",80,3,186,3,186,0,0,85396.170011,9.02746000001207,164.83041741508802,0
"147.32.84.165",2478,"174.128.246.102",80,3,186,3,186,0,0,85396.170128,9.0273659999948,164.83213375871293,0
"147.32.84.165",2480,"193.23.181.44",179,3,186,3,186,0,0,85396.171387,9.02613100000599,164.85468690837885,0
"147.32.84.165",2481,"174.128.246.102",80,3,186,3,186,0,0,85396.171506,9.026035000002594,164.85644028630205,0
"147.32.84.165",2482,"193.23.181.44",179,3,186,3,186,0,0,85396.171623,9.025940999999875,164.85815717164786,0
"147.32.84.165",2483,"193.23.181.44",179,3,186,3,186,0,0,85396.17174,9.02584799999022,164.8598558275757,0
"147.32.84.165",2484,"72.20.15.61",80,3,186,3,186,0,0,85396.171855,9.02575600000273,164.86153625242582,0
"147.32.84.165",2485,"174.37.196.55",80,3,186,3,186,0,0,85396.172002,9.02563299999747,164.86378296130778,0
"147.32.84.165",2486,"174.37.196.55",80,3,186,3,186,0,0,85396.172119,9.025539000009303,164.8654999993315,0
"147.32.84.165",2487,"72.20.15.61",80,3,186,3,186,0,0,85396.172235,9.027945999987423,164.8215441255489,0
"147.32.84.165",2488,"193.23.181.44",179,3,186,3,186,0,0,85396.172352,9.031031999998959,164.7652228449829,0
"147.32.84.165",2489,"174.37.196.55",80,3,186,3,186,0,0,85396.175553,9.031048000004375,164.7649309359533,0
"147.32.84.165",2490,"193.23.181.44",80,3,186,3,186,0,0,85396.178777,9.031020000009448,164.76544177716838,0
"147.32.84.165",2479,"67.19.72.206",80,3,186,3,186,0,0,85396.181996,9.031033000006573,164.76520460050548,0
"147.32.84.165",2492,"174.128.246.102",80,3,186,3,186,0,0,85396.269352,9.028206999995746,164.81677923431542,0
"147.32.84.165",2491,"67.19.72.206",80,3,186,3,186,0,0,85396.269669,9.027948000002652,164.82150761164806,0
"147.32.84.165",2493,"174.37.196.55",80,3,186,3,186,0,0,85396.272004,9.025636999998824,164.86370989661935,0
"147.32.84.165",2494,"67.19.72.206",80,3,186,3,186,0,0,85396.272622,9.025041999993846,164.874578977141,0
"147.32.84.165",2495,"174.128.246.102",80,3,186,3,186,0,0,85396.273037,9.024649999992107,164.88174056626033,0
"147.32.84.165",2496,"174.37.196.55",80,3,186,3,186,0,0,85396.273267,9.024443000002066,164.8855225745965,0
"147.32.84.165",2497,"174.37.196.55",80,3,186,3,186,0,0,85396.273497,9.024235999997472,164.8893047567037,0
"147.32.84.165",2498,"174.128.246.102",80,3,186,3,186,0,0,85396.273774,9.023981000005733,164.89396420482873,0
"147.32.84.165",2499,"174.37.196.55",80,3,186,3,186,0,0,85396.274013,9.023764999990817,164.89791123788288,0
"147.32.84.165",2500,"72.20.15.61",80,3,186,3,186,0,0,85396.274241,9.023562999995193,164.9016026153741,0
"147.32.84.165",2501,"174.128.246.102",80,3,186,3,186,0,0,85396.274483,9.023342999993474,164.90562311563198,0
"147.32.84.165",2502,"193.23.181.44",80,3,186,3,186,0,0,85396.27471,9.023138999997173,164.909351390959,0
"147.32.84.165",2503,"72.20.15.61",80,3,186,3,186,0,0,85396.274936,9.022935999993933,164.91306155790093,0
"147.32.84.165",2504,"174.128.246.102",80,3,186,3,186,0,0,85396.275166,9.022729999996955,164.9168267254481,0
"147.32.84.165",2505,"193.23.181.44",80,3,186,3,186,0,0,85396.275396,9.022526000000653,164.92055550739252,0
"147.32.84.165",2506,"72.20.15.61",80,3,186,3,186,0,0,85396.275625,9.022326000005705,164.92421133963228,0
"147.32.84.165",2507,"174.37.196.55",80,3,186,3,186,0,0,85396.275857,9.022121999994852,164.92794045578736,0
"147.32.84.165",2509,"72.20.15.61",80,3,186,3,186,0,0,85396.276087,9.02191799999855,164.931669740319,0
"147.32.84.165",2510,"174.128.246.102",80,3,186,3,186,0,0,85396.276315,9.021712000001571,164.93543575761905,0
"147.32.84.165",2511,"174.37.196.55",80,3,186,3,186,0,0,85396.276548,9.021502000003238,164.93927507852527,0
"147.32.84.165",2512,"67.19.72.206",80,3,186,3,186,0,0,85396.276776,9.021298000006936,164.9430048756682,0
"147.32.84.165",2513,"193.23.181.44",80,3,186,3,186,0,0,85396.277005,9.021091000002343,164.94678969534988,0
"147.32.84.165",2514,"72.20.15.61",80,3,186,3,186,0,0,85396.277237,9.02088100000401,164.950629544868,0
"147.32.84.165",2515,"193.23.181.44",80,3,186,3,186,0,0,85396.277468,9.02067199999874,164.9544512870225,0
"147.32.84.165",2516,"174.37.196.55",80,3,186,3,186,0,0,85396.278722,9.019440999996732,164.9769647587405,0
"147.32.84.165",2517,"193.23.181.44",179,3,186,3,186,0,0,85396.281926,9.016262999997707,165.0351148807858,0
"147.32.84.165",2518,"67.19.72.206",80,3,186,3,186,0,0,85396.28512,9.01564199999848,165.04648254669507,0
"147.32.84.165",2519,"174.128.246.102",80,8,700,5,518,3,182,85396.288347,3.341736000002129,1240.0740214060477,435.70168319671944
"147.32.84.165",2520,"67.19.72.206",80,3,186,3,186,0,0,85396.291547,9.01241399999708,165.10559767898837,0
"147.32.84.165",2521,"72.20.15.61",80,3,186,3,186,0,0,85396.294719,9.012442000006558,165.1050847260839,0
"147.32.84.165",2522,"174.37.196.55",80,3,186,3,186,0,0,85396.297971,9.012390999996569,165.10601903541098,0
"147.32.84.165",2523,"174.37.196.55",80,3,186,3,186,0,0,85396.301121,9.012440000005881,165.10512136547138,0
"147.32.84.165",2524,"72.20.15.61",80,3,186,3,186,0,0,85396.304321,9.012438999998267,165.10513968530452,0
"147.32.84.165",2525,"193.23.181.44",80,3,186,3,186,0,0,85396.307521,9.0124710000091,165.10455345692625,0
"147.32.84.165",2526,"67.19.72.206",80,3,186,3,186,0,0,85396.310721,9.012461999998777,165.10471833337016,0
"147.32.84.165",2527,"67.19.72.206",80,3,186,3,186,0,0,85396.313921,9.012441000013496,165.10510304564232,0
"147.32.84.165",2528,"174.128.246.102",80,3,186,3,186,0,0,85396.317121,9.012442000006558,165.1050847260839,0
"147.32.84.165",2530,"174.37.196.55",80,3,186,3,186,0,0,85396.320321,9.012460999991163,165.10473665311386,0
"147.32.84.165",2529,"67.19.72.206",80,3,186,3,186,0,0,85396.323521,9.012457999997423,165.10479161183613,0
"147.32.84.165",2532,"174.128.246.102",80,3,186,3,186,0,0,85396.326721,9.012443999992684,165.10504808697928,0
"147.32.84.165",2533,"67.19.72.206",80,3,186,3,186,0,0,85396.329951,9.0124599999981,165.104754972595,0
"147.32.84.165",2534,"67.19.72.206",80,3,186,3,186,0,0,85396.333121,9.012483999991673,165.10431530323658,0
"147.32.84.165",2535,"67.19.72.206",80,3,186,3,186,0,0,85396.336321,9.012489000000642,165.1042237055595,0
"147.32.84.165",2536,"193.23.181.44",179,3,186,3,186,0,0,85396.339521,9.012472000002163,165.1045351374898,0
"147.32.84.165",2531,"67.19.72.206",80,3,186,3,186,0,0,85396.342721,9.012486999999965,165.1042603445648,0
"147.32.84.165",2538,"174.37.196.55",80,3,186,3,186,0,0,85396.345921,9.01245700000436,165.1048099313295,0
"147.32.84.165",2537,"67.19.72.206",80,3,186,3,186,0,0,85396.349124,9.012491000001319,165.1041870665704,0
"147.32.84.165",2539,"193.23.181.44",179,3,186,3,186,0,0,85396.370725,8.9940590000042,165.44254379466548,0
"147.32.84.165",2540,"174.128.246.102",80,3,186,3,186,0,0,85396.373973,8.994011000002502,165.44342674248298,0
"147.32.84.165",2541,"193.23.181.44",80,3,186,3,186,0,0,85396.377142,8.99406799999997,165.44237824308254,0
"147.32.84.165",2542,"174.128.246.102",80,12,1090,8,844,4,246,85396.380322,12.443444999997155,542.6150073393296,158.1555590112264
"147.32.84.165",2544,"67.19.72.206",80,3,186,3,186,0,0,85396.383539,8.990823999993154,165.50207189031096,0
"147.32.84.165",2543,"72.20.15.61",80,3,186,3,186,0,0,85396.386744,8.990835999997216,165.50185099588745,0
"147.32.84.165",2545,"193.23.181.44",179,3,186,3,186,0,0,85396.396323,9.00124599999981,165.31044702033822,0
"147.32.84.165",2546,"174.37.196.55",80,3,186,3,186,0,0,85396.39954,8.998149999999441,165.36732550580868,0
"147.32.84.165",2547,"72.20.15.61",80,3,186,3,186,0,0,85396.402722,8.99501600000076,165.42494199008365,0
"147.32.84.165",2548,"193.23.181.44",179,3,186,3,186,0,0,85396.405938,8.99184800000512,165.4832243604599,0
"147.32.84.165",2549,"174.37.196.55",80,3,186,3,186,0,0,85396.409122,8.988717000000179,165.54086639950623,0
"147.32.84.165",2550,"193.23.181.44",80,3,186,3,186,0,0,85396.41234,8.985545000003185,165.59930421576794,0
"147.32.84.165",2551,"193.23.181.44",80,3,186,3,186,0,0,85396.467376,9.031436999997823,164.75783421844815,0
"147.32.84.165",2552,"72.20.15.61",80,3,186,3,186,0,0,85396.468268,9.030608000000939,164.77295880851491,0
"147.32.84.165",2553,"72.20.15.61",80,3,186,3,186,0,0,85396.468885,9.030012000002898,164.78383417425385,0
"147.32.84.165",2554,"67.19.72.206",80,3,186,3,186,0,0,85396.469218,9.029704000000493,164.7894548924216,0
"147.32.84.165",2555,"193.23.181.44",80,3,186,3,186,0,0,85396.469497,9.029449000008754,164.79410869905323,0
"147.32.84.165",2556,"174.128.246.102",80,3,186,3,186,0,0,85396.469751,9.029246999998577,164.79779543080775,0
"147.32.84.165",2557,"174.37.196.55",80,3,186,3,186,0,0,85396.469969,9.02905300000566,164.80133630836667,0
"147.32.84.165",2558,"174.37.196.55",80,3,186,3,186,0,0,85396.472171,9.026874999995925,164.84109949463925,0
"147.32.84.165",2559,"72.20.15.61",80,3,186,3,186,0,0,85396.492278,9.006792000000132,165.20865586770276,0
"147.32.84.165",2560,"174.37.196.55",80,3,186,3,186,0,0,85396.567876,9.030918000004021,164.7673027259618,0
"147.32.84.165",2561,"72.20.15.61",80,3,186,3,186,0,0,85396.568496,9.0303939999867,164.77686355680513,0
"147.32.84.165",2562,"72.20.15.61",80,3,186,3,186,0,0,85396.568651,9.030263000007835,164.7792539374223,0
"147.32.84.165",2563,"174.37.196.55",80,3,186,3,186,0,0,85396.568763,9.030174999992596,164.78085972876715,0
"147.32.84.165",2564,"72.20.15.61",80,3,186,3,186,0,0,85396.568881,9.030119999995804,164.78186336401856,0
"147.32.84.165",2565,"193.23.181.44",179,3,186,3,186,0,0,85396.569157,9.029897000000346,164.78593277419918,0
"147.32.84.165",2566,"174.128.246.102",80,3,186,3,186,0,0,85396.569387,9.02971499999694,164.7892541459508,0
"147.32.84.165",2567,"193.23.181.44",80,3,186,3,186,0,0,85396.569606,9.029543999989983,164.79237489751984,0
"147.32.84.165",2568,"67.19.72.206",80,3,186,3,186,0,0,85396.569822,9.029374999998254,164.79545926493117,0
"147.32.84.165",2569,"67.19.72.206",80,3,186,3,186,0,0,85396.570036,9.02920799999265,164.79850724462338,0
"147.32.84.165",2570,"72.20.15.61",80,3,186,3,186,0,0,85396.570256,9.029034999999567,164.80166485123507,0
"147.32.84.165",2571,"72.20.15.61",80,3,186,3,186,0,0,85396.570476,9.028862000006484,164.80482257885117,0
"147.32.84.165",2572,"193.23.181.44",80,3,186,3,186,0,0,85396.570691,9.028693999993266,164.8078891588429,0
"147.32.84.165",2573,"67.19.72.206",80,3,186,3,186,0,0,85396.570913,9.028518999999505,164.81108363399153,0
"147.32.84.165",2574,"174.128.246.102",80,3,186,3,186,0,0,85396.571136,9.02834299999813,164.8142964883266,0
"147.32.84.165",2575,"72.20.15.61",80,3,186,3,186,0,0,85396.571353,9.028172999998787,164.81739993243372,0
"147.32.84.165",2576,"174.128.246.102",80,3,186,3,186,0,0,85396.571569,9.028005000000121,164.82046698024425,0
"147.32.84.165",2577,"72.20.15.61",80,3,186,3,186,0,0,85396.571886,9.027736999996705,164.8253598881473,0
"147.32.84.165",2579,"67.19.72.206",80,3,186,3,186,0,0,85396.572182,9.027487999992445,164.82990617115695,0
"147.32.84.165",2578,"193.23.181.44",80,3,186,3,186,0,0,85396.5724,9.02731700000004,164.8330284623874,0
"147.32.84.165",2580,"72.20.15.61",80,3,186,3,186,0,0,85396.668324,9.030589000001783,164.77330548424985,0
"147.32.84.165",2581,"69.175.13.98",7691,7,424,4,242,3,182,85396.707857,0.37359899999864865,5182.026718505678,3897.2267056530304
"147.32.84.165",2582,"193.23.181.44",179,3,186,3,186,0,0,85396.767749,9.031900999994832,164.7493700385834,0
"147.32.84.165",2583,"174.37.196.55",80,3,186,3,186,0,0,85396.767936,9.031772000002093,164.7517231391199,0
"147.32.84.165",2584,"193.23.181.44",80,3,186,3,186,0,0,85396.76814,9.031589000005624,164.75506137392583,0
"147.32.84.165",2585,"193.23.181.44",179,3,186,3,186,0,0,85396.769642,9.030115000001388,164.78195460409654,0
"147.32.84.165",2586,"174.128.246.102",80,3,186,3,186,0,0,85396.770974,9.028806000002078,164.8058447595017,0
"147.32.84.165",2587,"193.23.181.44",80,3,186,3,186,0,0,85396.771195,9.028604999999516,164.80951376210166,0
"147.32.84.165",2588,"193.23.181.44",179,3,186,3,186,0,0,85396.771623,9.028201000008266,164.816888768719,0
"147.32.84.165",2589,"174.37.196.55",80,3,186,3,186,0,0,85396.771995,9.027851999999257,164.82326028385518,0
"147.32.84.165",2590,"174.128.246.102",80,3,186,3,186,0,0,85396.772213,9.027654999998049,164.82685702990662,0
"147.32.84.165",2591,"67.19.72.206",80,3,186,3,186,0,0,85396.77243,9.027465000006487,164.83032612133425,0
"147.32.84.165",2592,"193.23.181.44",80,3,186,3,186,0,0,85396.772644,9.027276000007987,164.83377709939117,0
"147.32.84.165",2593,"193.23.181.44",80,3,186,3,186,0,0,85396.772857,9.027084000001196,164.8372830029944,0
"147.32.84.165",2594,"67.19.72.206",80,3,186,3,186,0,0,85396.773074,9.026888000007602,164.84086209984514,0
"147.32.84.165",2595,"174.128.246.102",80,3,186,3,186,0,0,85396.773289,9.026696000000811,164.84436830484447,0
"147.32.84.165",2596,"174.128.246.102",80,3,186,3,186,0,0,85396.773505,9.026501999993343,164.84791118432116,0
"147.32.84.165",2597,"193.23.181.44",179,3,186,3,186,0,0,85396.77377,9.026257999998052,164.852367393035,0
"147.32.84.165",2598,"174.128.246.102",80,3,186,3,186,0,0,85396.773995,9.026057000010042,164.8560384671119,0
"147.32.84.165",2599,"174.128.246.102",80,3,186,3,186,0,0,85396.774226,9.025849000012386,164.85983756186903,0
"147.32.84.165",2600,"174.128.246.102",80,3,186,3,186,0,0,85396.774497,9.025599000000511,164.86440401350822,0
"147.32.84.165",2601,"193.23.181.44",80,3,186,3,186,0,0,85396.774713,9.025406000000658,164.86792948703823,0
"147.32.84.165",2602,"72.20.15.61",80,3,186,3,186,0,0,85396.774945,9.025198000003002,164.8717291298767,0
"147.32.84.165",2603,"72.20.15.61",80,3,186,3,186,0,0,85396.775165,9.024998000008054,164.8753827977216,0
"147.32.84.165",2604,"67.19.72.206",80,3,186,3,186,0,0,85396.77538,9.024807999987388,164.8788539326354,0
"147.32.84.165",2605,"72.20.15.61",80,3,186,3,186,0,0,85396.775677,9.024533999996493,164.88385993122506,0
"147.32.84.165",2606,"174.128.246.102",80,3,186,3,186,0,0,85396.776934,9.023297000007005,164.9064637902138,0
"147.32.84.165",2607,"174.128.246.102",80,3,186,3,186,0,0,85396.780154,9.020100000008824,164.9649116970482,0
"147.32.84.165",2608,"193.23.181.44",80,3,186,3,186,0,0,85396.783352,9.019501000002492,164.97586729017368,0
"147.32.84.165",2610,"67.19.72.206",80,3,186,3,186,0,0,85396.786556,9.019496999986586,164.97594045457447,0
"147.32.84.165",2609,"72.20.15.61",80,3,186,3,186,0,0,85396.78975,9.019504000010784,164.97581241698222,0
"147.32.84.165",2611,"173.236.31.226",7212,23683,1468592,11823,709382,11860,759210,85396.80782,9514.198852999994,596.4828029856192,638.3806029117062
"147.32.84.165",2612,"193.23.181.44",80,3,186,3,186,0,0,85396.869172,9.030207999996492,164.7802575533784,0
"147.32.84.165",2613,"193.23.181.44",179,3,186,3,186,0,0,85396.869639,9.029800000003888,164.78770293908605,0
"147.32.84.165",2614,"174.37.196.55",80,3,186,3,186,0,0,85396.86975,9.029710999995586,164.78932714465915,0
"147.32.84.165",2615,"72.20.15.61",80,3,186,3,186,0,0,85396.869882,9.029603999995743,164.791279883448,0
"147.32.84.165",2616,"193.23.181.44",80,3,186,3,186,0,0,85396.86999,9.029518999988795,164.79283115765597,0
"147.32.84.165",2617,"193.23.181.44",80,3,186,3,186,0,0,85396.870097,9.029431999995722,164.79441896242255,0
"147.32.84.165",2619,"193.23.181.44",80,3,186,3,186,0,0,85396.870204,9.029351999997743,164.79587903986598,0
"147.32.84.165",2620,"174.37.196.55",80,3,186,3,186,0,0,85396.870311,9.029266999990796,164.79743040066452,0
"147.32.84.165",2621,"193.23.181.44",80,3,186,3,186,0,0,85396.870417,9.029189000008046,164.79885402760692,0
"147.32.84.165",2622,"193.23.181.44",179,3,186,3,186,0,0,85396.870554,9.029096000012942,164.80055146139406,0
"147.32.84.165",2623,"72.20.15.61",80,3,186,3,186,0,0,85396.870662,9.02900999999838,164.80212116281487,0
"147.32.84.165",2624,"174.128.246.102",80,3,186,3,186,0,0,85396.870769,9.028925999999046,164.8036543881473,0
"147.32.84.165",2625,"72.20.15.61",80,3,186,3,186,0,0,85396.870876,9.028839999999036,164.80522414841317,0
"147.32.84.165",2626,"72.20.15.61",80,8,659,5,477,3,182,85396.870984,3.405021000013221,1120.6979340172009,427.6038238807768
"147.32.84.165",2627,"67.19.72.206",80,3,186,3,186,0,0,85396.871089,9.028650000007474,164.8086923292816,0
"147.32.84.165",2628,"72.20.15.61",80,3,186,3,186,0,0,85396.871223,9.028539000006276,164.81071854471313,0
"147.32.84.165",2629,"193.23.181.44",80,3,186,3,186,0,0,85396.871997,9.027786000006017,164.8244652674541,0
"147.32.84.165",2630,"184.82.148.43",80,10,1895,5,979,5,916,85396.983445,0.32140899999649264,24367.705945027883,22799.610465419344
"147.32.84.165",2631,"193.23.181.44",80,3,186,3,186,0,0,85397.068569,9.031759000004968,164.7519602769717,0
"147.32.84.165",2632,"174.37.196.55",80,3,186,3,186,0,0,85397.068759,9.031703000000562,164.75298180198214,0
"147.32.84.165",2633,"193.23.181.44",179,3,186,3,186,0,0,85397.068942,9.031570000006468,164.75540797435377,0
"147.32.84.165",2634,"72.20.15.61",80,3,186,3,186,0,0,85397.069639,9.030916000003344,164.76733921558443,0
"147.32.84.165",2635,"174.37.196.55",80,3,186,3,186,0,0,85397.069799,9.03080300000147,164.76940090485397,0
"147.32.84.165",2636,"174.128.246.102",80,3,186,3,186,0,0,85397.069931,9.03071700000146,164.77097001265344,0
"147.32.84.165",2637,"193.23.181.44",80,3,186,3,186,0,0,85397.070061,9.030633999995189,164.77248441258862,0
"147.32.84.165",2638,"193.23.181.44",179,3,186,3,186,0,0,85397.070184,9.03055399999721,164.77394410137626,0
"147.32.84.165",2639,"193.23.181.44",80,3,186,3,186,0,0,85397.070313,9.030471999998554,164.77544030923724,0
"147.32.84.165",2640,"174.37.196.55",80,3,186,3,186,0,0,85397.070522,9.030309000008856,164.7784145590744,0
"147.32.84.165",2641,"174.128.246.102",80,3,186,3,186,0,0,85397.070665,9.030208999989554,164.7802393058368,0
"147.32.84.165",2642,"193.23.181.44",80,3,186,3,186,0,0,85397.070794,9.030125999997836,164.78175387589903,0
"147.32.84.165",2643,"174.37.196.55",80,3,186,3,186,0,0,85397.070929,9.030033000002732,164.78345095743836,0
"147.32.84.165",2644,"174.128.246.102",80,3,186,3,186,0,0,85397.071079,9.029930000004242,164.78533056173202,0
"147.32.84.165",2645,"193.23.181.44",179,3,186,3,186,0,0,85397.168878,9.031942000001436,164.74862216783094,0
"147.32.84.165",2646,"174.128.246.102",80,7,596,4,414,3,182,85397.169868,0.3302130000083707,10029.889798148597,4409.275225273054
"147.32.84.165",2647,"72.20.15.61",80,3,186,3,186,0,0,85397.170592,9.030249000003096,164.77950940217593,0
"147.32.84.165",2648,"72.20.15.61",80,3,186,3,186,0,0,85397.170835,9.030033000002732,164.78345095743836,0
"147.32.84.165",2649,"67.19.72.206",80,3,186,3,186,0,0,85397.17109,9.029799999989336,164.78770293935162,0
"147.32.84.165",2650,"193.23.181.44",80,3,186,3,186,0,0,85397.171309,9.02960300000268,164.7912981334349,0
"147.32.84.165",2651,"67.19.72.206",80,3,186,3,186,0,0,85397.171529,9.029404999993858,164.79491173571373,0
"147.32.84.165",2652,"174.37.196.55",80,3,186,3,186,0,0,85397.171748,9.029209000000264,164.79848899277405,0
"147.32.84.165",2653,"174.128.246.102",80,3,186,3,186,0,0,85397.171965,9.02901299999212,164.80206640540874,0
"147.32.84.165",2654,"174.37.196.55",80,3,186,3,186,0,0,85397.172223,9.028775999991922,164.806392361637,0
"147.32.84.165",2655,"193.23.181.44",80,3,186,3,186,0,0,85397.17244,9.02858600000036,164.80986059167412,0
"147.32.84.165",2656,"184.82.148.44",80,10,1480,5,578,5,902,85397.20712,0.3441339999990305,13436.626430439965,20968.576194216002
"147.32.84.165",2657,"67.19.72.206",80,3,186,3,186,0,0,85397.270982,9.02970600000117,164.78941839300273,0
"147.32.84.165",2658,"193.23.181.44",80,3,186,3,186,0,0,85397.271262,9.029548000005889,164.79230189584567,0
"147.32.84.165",2659,"72.20.15.61",80,3,186,3,186,0,0,85397.271572,9.029286000004504,164.79708362314116,0
"147.32.84.165",2660,"174.128.246.102",80,3,186,3,186,0,0,85397.271684,9.02922199999739,164.79825172096002,0
"147.32.84.165",2661,"72.20.15.61",80,3,186,3,186,0,0,85397.2718,9.029152999995858,164.79951109485935,0
"147.32.84.165",2662,"193.23.181.44",179,3,186,3,186,0,0,85397.271911,9.029092999990098,164.80060621832467,0
"147.32.84.165",2663,"72.20.15.61",80,3,186,3,186,0,0,85397.272023,9.02903000000515,164.80175611324265,0
"147.32.84.165",2664,"174.37.196.55",80,3,186,3,186,0,0,85397.272118,9.028982000003452,164.80263223466733,0
"147.32.84.165",2665,"72.20.15.61",80,3,186,3,186,0,0,85397.272225,9.028922000012244,164.80372739934867,0
"147.32.84.165",2666,"174.128.246.102",80,3,186,3,186,0,0,85397.272335,9.028859999991255,164.80485908535974,0
"147.32.84.165",2668,"193.23.181.44",80,3,186,3,186,0,0,85397.274481,9.026763000001665,164.84314476847632,0
"147.32.84.165",2669,"174.37.196.55",80,3,186,3,186,0,0,85397.274592,9.026700000002165,164.84429525736348,0
"147.32.84.165",2667,"67.19.72.206",80,3,186,3,186,0,0,85397.274698,9.026637000002665,164.84544576231,0
"147.32.84.165",2671,"193.23.181.44",80,3,186,3,186,0,0,85397.29465,9.006735000002664,165.20970140673174,0
"147.32.84.165",2672,"174.37.196.55",80,3,186,3,186,0,0,85397.294761,9.006672000003164,165.2108570179393,0
"147.32.84.165",2670,"174.37.196.55",80,3,186,3,186,0,0,85397.294868,9.006611000004341,165.21197595846905,0
"147.32.84.165",2673,"72.20.15.61",80,3,186,3,186,0,0,85397.334481,8.967044000004535,165.9409722980335,0
"147.32.84.165",2674,"193.23.181.44",179,3,186,3,186,0,0,85397.373192,9.02882399999362,164.8055162002329,0
"147.32.84.165",2675,"72.20.15.61",80,3,186,3,186,0,0,85397.374395,9.027682999992976,164.8263458077956,0
"147.32.84.165",2676,"72.20.15.61",80,3,186,3,186,0,0,85397.374618,9.027482000004966,164.8300157230091,0
"147.32.84.165",2677,"67.19.72.206",80,3,186,3,186,0,0,85397.374989,9.027132999995956,164.8363882531327,0
"147.32.84.165",2678,"174.37.196.55",80,3,186,3,186,0,0,85397.375416,9.026729000004707,164.84376566519546,0
"147.32.84.165",2679,"67.19.72.206",80,3,186,3,186,0,0,85397.375637,9.026528999995207,164.8474180940193,0
"147.32.84.165",2680,"193.23.181.44",80,3,186,3,186,0,0,85397.375853,9.026335999995354,164.85094284112247,0
"147.32.84.165",2681,"67.19.72.206",80,3,186,3,186,0,0,85397.376118,9.02609400000074,164.8553626851081,0
"147.32.84.165",2682,"174.37.196.55",80,3,186,3,186,0,0,85397.376338,9.025896999999532,164.8589608323779,0
"147.32.84.165",2683,"67.19.72.206",80,3,186,3,186,0,0,85397.376553,9.025703999999678,164.8624860731144,0
"147.32.84.165",2684,"193.23.181.44",80,3,186,3,186,0,0,85397.376772,9.02550699999847,164.8660845313457,0
"147.32.84.165",2685,"193.23.181.44",179,3,186,3,186,0,0,85397.376987,9.025315999999293,164.86957354181467,0
"147.32.84.165",2686,"72.20.15.61",80,3,186,3,186,0,0,85397.377209,9.025116999997408,164.87320884598253,0
"147.32.84.165",2687,"193.23.181.44",80,3,186,3,186,0,0,85397.377423,9.024925000005169,164.87671642691188,0
"147.32.84.165",2688,"193.23.181.44",179,3,186,3,186,0,0,85397.377641,9.024730000004638,164.88027896670985,0
"147.32.84.165",2689,"67.19.72.206",80,3,186,3,186,0,0,85397.377853,9.024539999998524,164.88375030752186,0
"147.32.84.165",2690,"72.20.15.61",80,3,186,3,186,0,0,85397.378115,9.02430099999765,164.88811709631446,0
"147.32.84.165",2691,"67.19.72.206",80,3,186,3,186,0,0,85397.378333,9.024105999997118,164.89168012881,0
"147.32.84.165",2692,"193.23.181.44",80,3,186,3,186,0,0,85397.378548,9.023913000011817,164.89520676873232,0
"147.32.84.165",2693,"174.37.196.55",80,3,186,3,186,0,0,85397.378761,9.023721999998088,164.8986970121991,0
"147.32.84.165",2694,"174.37.196.55",80,3,186,3,186,0,0,85397.379205,9.023300999993808,164.90639068795568,0
"147.32.84.165",2695,"193.23.181.44",80,3,186,3,186,0,0,85397.379457,9.023071999996318,164.91057591035593,0
"147.32.84.165",2696,"193.23.181.44",179,3,186,3,186,0,0,85397.379676,9.022876000002725,164.91415819075323,0
"147.32.84.165",2697,"193.23.181.44",179,3,186,3,186,0,0,85397.379891,9.022683999995934,164.9176675145301,0
"147.32.84.165",2698,"193.23.181.44",179,3,186,3,186,0,0,85397.380141,9.022456999999122,164.9218167512624,0
"147.32.84.165",2699,"70.32.97.26",80,8,2604,5,800,3,1804,85397.450833,0.34904800000367686,18335.587082385755,41346.74887077988
"147.32.84.165",2700,"174.37.196.55",80,3,186,3,186,0,0,85397.472406,9.029074999998556,164.8009347580165,0
"147.32.84.165",2701,"174.128.246.102",80,3,186,3,186,0,0,85397.472949,9.028666999991401,164.80838201269546,0
"147.32.84.165",2702,"67.19.72.206",80,3,186,3,186,0,0,85397.473191,9.028474999999162,164.81188683583198,0
"147.32.84.165",2703,"193.23.181.44",80,3,186,3,186,0,0,85397.473326,9.028383999990183,164.81354802826485,0
"147.32.84.165",2704,"174.37.196.55",80,3,186,3,186,0,0,85397.473435,9.028321999998298,164.8146798486231,0
"147.32.84.165",2705,"193.23.181.44",179,3,186,3,186,0,0,85397.473545,9.028258999998798,164.81582994021306,0
"147.32.84.165",2706,"174.37.196.55",80,3,186,3,186,0,0,85397.473653,9.028197000006912,164.8169617919127,0
"147.32.84.165",2707,"72.20.15.61",80,3,186,3,186,0,0,85397.47376,9.02813600000809,164.8180754032357,0
"147.32.84.165",2708,"174.37.196.55",80,3,186,3,186,0,0,85397.473867,9.02807600000233,164.81917077344232,0
"147.32.84.165",2710,"174.37.196.55",80,3,186,3,186,0,0,85397.474501,9.027487999992445,164.82990617115695,0
"147.32.84.165",2711,"193.23.181.44",80,3,186,3,186,0,0,85397.474613,9.027419000005466,164.83116602863998,0
"147.32.84.165",2712,"72.20.15.61",80,3,186,3,186,0,0,85397.474721,9.027357999992091,164.83227983218387,0
"147.32.84.165",2713,"193.23.181.44",179,3,186,3,186,0,0,85397.474828,9.027293999999529,164.8334484287404,0
"147.32.84.165",2714,"67.19.72.206",80,3,186,3,186,0,0,85397.474936,9.027232000007643,164.83458052243924,0
"147.32.84.165",2715,"72.20.15.61",80,3,186,3,186,0,0,85397.475043,9.027172000001883,164.83567611204145,0
"147.32.84.165",2716,"174.37.196.55",80,3,186,3,186,0,0,85397.475151,9.027118999991217,164.83664389507302,0
"147.32.84.165",2709,"174.37.196.55",80,3,186,3,186,0,0,85397.475256,9.027059000000008,164.83773951183863,0
"147.32.84.165",2718,"67.19.72.206",80,3,186,3,186,0,0,85397.494509,9.007855000003474,165.1891599053744,0
"147.32.84.165",2717,"72.20.15.61",80,3,186,3,186,0,0,85397.494618,9.007792000003974,165.19031522923083,0
"147.32.84.165",2719,"72.20.15.61",80,3,186,3,186,0,0,85397.571194,9.030541999993147,164.77416305700467,0
"147.32.84.165",2720,"72.20.15.61",80,3,186,3,186,0,0,85397.571872,9.029962999993586,164.784728353932,0
"147.32.84.165",2721,"193.23.181.44",179,3,186,3,186,0,0,85397.571986,9.02987500000745,164.7863342514456,0
"147.32.84.165",2722,"67.19.72.206",80,3,186,3,186,0,0,85397.572094,9.02979200000118,164.7878489338188,0
"147.32.84.165",2723,"174.128.246.102",80,3,186,3,186,0,0,85397.572227,9.029674999997951,164.78998413567905,0
"147.32.84.165",2724,"72.20.15.61",80,3,186,3,186,0,0,85397.572415,9.029508999999962,164.79301366220537,0
"147.32.84.165",2725,"193.23.181.44",80,3,186,3,186,0,0,85397.572609,9.029339000000618,164.7961163048478,0
"147.32.84.165",2726,"67.19.72.206",80,3,186,3,186,0,0,85397.572796,9.029175000003306,164.79910955313804,0
"147.32.84.165",2727,"193.23.181.44",179,3,186,3,186,0,0,85397.572983,9.029010999991442,164.80210291043065,0
"147.32.84.165",2728,"209.191.88.254",25,2,124,2,124,0,0,85397.665216,2.9169050000054995,340.08649578856006,0
"147.32.84.165",2729,"212.11.70.8",25,2,124,2,124,0,0,85397.665352,2.9167920000036247,340.0996711451373,0
"147.32.84.165",2730,"174.37.196.55",80,7,602,4,420,3,182,85397.672175,0.2744959999981802,12240.615528176279,5304.266728876387
"147.32.84.165",2731,"174.37.196.55",80,7,630,4,448,3,182,85397.672358,0.25722300000779796,13933.43519005434,5660.458045959575
"147.32.84.165",2732,"205.188.190.1",25,2,124,2,124,0,0,85397.684662,2.997378000000026,330.95592214261643,0
"147.32.84.165",2733,"195.113.232.96",80,17,6169,9,2513,8,3656,85397.690616,64.633920999986,311.0441032968486,452.51780408009495
"147.32.84.165",2734,"195.113.232.89",80,8,1801,5,917,3,884,85397.695231,64.62920899999153,113.509048207614,109.42420786862681
"147.32.84.165",2735,"174.128.246.102",80,3,186,3,186,0,0,85397.773878,9.0289819999889,164.80263223493293,0
"147.32.84.165",2736,"67.19.72.206",80,3,186,3,186,0,0,85397.775555,9.027363999994122,164.83217027705638,0
"147.32.84.165",2737,"193.23.181.44",80,3,186,3,186,0,0,85397.775781,9.027158999990206,164.83591349189865,0
"147.32.84.165",2739,"72.20.15.61",80,3,186,3,186,0,0,85397.776232,9.026734999992186,164.84365609506517,0
"147.32.84.165",2740,"193.23.181.44",179,3,186,3,186,0,0,85397.77649,9.026499999992666,164.8479477096559,0
"147.32.84.165",2741,"174.37.196.55",80,3,186,3,186,0,0,85397.776708,9.026302999991458,164.8515455332497,0
"147.32.84.165",2742,"193.23.181.44",80,3,186,3,186,0,0,85397.776923,9.026110000006156,164.85507045659594,0
"147.32.84.165",2743,"193.23.181.44",179,3,186,3,186,0,0,85397.777138,9.025918999992427,164.85855900116636,0
"147.32.84.165",2744,"193.23.181.44",179,3,186,3,186,0,0,85397.77741,9.025674000004074,164.8630340514546,0
"147.32.84.165",2745,"174.37.196.55",80,3,186,3,186,0,0,85397.777628,9.025479000003543,164.86659599999246,0
"147.32.84.165",2746,"174.128.246.102",80,3,186,3,186,0,0,85397.777844,9.025286000003689,164.8701215672713,0
"147.32.84.165",2747,"72.20.15.61",80,3,186,3,186,0,0,85397.778109,9.025042999986908,164.87456070870337,0
"147.32.84.165",2748,"72.20.15.61",80,3,186,3,186,0,0,85397.778473,9.024701000002096,164.8808087935162,0
"147.32.84.165",2749,"193.23.181.44",80,3,186,3,186,0,0,85397.7787,9.024499999999534,164.8844811346974,0
"147.32.84.165",2750,"193.23.181.44",80,3,186,3,186,0,0,85397.778914,9.024310000007972,164.88795265219008,0
"147.32.84.165",2751,"174.37.196.55",80,3,186,3,186,0,0,85397.779256,9.02398300000641,164.89392765909943,0
"147.32.84.165",2752,"193.23.181.44",179,3,186,3,186,0,0,85397.779475,9.023786999998265,164.8975092165059,0
"147.32.84.165",2753,"72.20.15.61",80,3,186,3,186,0,0,85397.779691,9.023593999998411,164.90103610604177,0
"147.32.84.165",2754,"174.128.246.102",80,3,186,3,186,0,0,85397.779908,9.023402000006172,164.90454487110097,0
"147.32.84.165",2738,"174.128.246.102",80,3,186,3,186,0,0,85397.780125,9.023210999992443,164.9080355098918,0
"147.32.84.165",2755,"174.37.196.55",80,3,186,3,186,0,0,85397.783084,9.020277000003261,164.96167468021903,0
"147.32.84.165",2756,"193.23.181.44",80,3,186,3,186,0,0,85397.786267,9.017116000002716,165.01950290974983,0
"147.32.84.165",2757,"193.23.181.44",179,3,186,3,186,0,0,85397.789487,9.013919000004535,165.07803098732654,0
"147.32.84.165",2759,"67.19.72.206",80,3,186,3,186,0,0,85397.792686,9.010741999998572,165.1362340637692,0
"147.32.84.165",2760,"67.19.72.206",80,3,186,3,186,0,0,85397.795887,9.007563999999547,165.19449653647476,0
"147.32.84.165",2758,"193.23.181.44",179,3,186,3,186,0,0,85397.799068,9.004406000007293,165.25243308651284,0
"147.32.84.165",2761,"193.23.181.44",179,3,186,3,186,0,0,85397.840666,8.965414999998757,165.97112347841193,0
"147.32.84.165",2762,"174.37.196.55",80,3,186,3,186,0,0,85397.843867,8.96541599999182,165.97110496616753,0
"147.32.84.165",2763,"72.20.15.61",80,3,186,3,186,0,0,85397.872664,9.030747000011615,164.77042264588812,0
"147.32.84.165",2764,"72.20.15.61",80,3,186,3,186,0,0,85397.875865,9.027604000002611,164.8277881926998,0
"147.32.84.165",2765,"174.128.246.102",80,3,186,3,186,0,0,85397.879066,9.024425000010524,164.88585145294738,0
"147.32.84.165",2766,"174.128.246.102",80,3,186,3,186,0,0,85397.882267,9.021251000012853,164.94386421549294,0
"147.32.84.165",2767,"67.19.72.206",80,3,186,3,186,0,0,85397.885467,9.018072999999276,165.00199100186032,0
"147.32.84.165",2768,"193.23.181.44",179,3,186,3,186,0,0,85397.888666,9.014895000000251,165.06015877056345,0
"147.32.84.165",2769,"193.23.181.44",179,3,186,3,186,0,0,85397.891866,9.011717000001227,165.11836756522618,0
"147.32.84.165",2770,"67.19.72.206",80,3,186,3,186,0,0,85397.895066,9.008540000009816,165.17659909356883,0
"147.32.84.165",2771,"72.20.15.61",80,3,186,3,186,0,0,85397.898266,9.005365999997593,165.23481666379774,0
"147.32.84.165",2772,"193.23.181.44",80,3,186,3,186,0,0,85397.901467,9.002187999998569,165.29314873231226,0
"147.32.84.165",2774,"193.23.181.44",179,3,186,3,186,0,0,85397.904667,8.999009999999544,165.3515220007618,0
"147.32.84.165",2775,"72.20.15.61",80,3,186,3,186,0,0,85397.907882,8.995819999996456,165.410157161947,0
"147.32.84.165",2773,"193.23.181.44",80,3,186,3,186,0,0,85397.911068,8.992656000002171,165.4683555113907,0
"147.32.84.165",2776,"193.23.181.44",179,3,186,3,186,0,0,85397.914267,8.989478999996209,165.5268342025859,0
"147.32.84.165",2777,"174.37.196.55",80,3,186,3,186,0,0,85397.917467,8.986300999997184,165.58537266896204,0
"147.32.84.165",2778,"174.128.246.102",80,3,186,3,186,0,0,85397.920672,8.98312000000442,165.64400787246169,0
"147.32.84.165",2779,"193.23.181.44",80,3,186,3,186,0,0,85397.973417,9.029626999996253,164.79086013194316,0
"147.32.84.165",2780,"174.37.196.55",80,3,186,3,186,0,0,85397.974061,9.029106000001775,164.8003689401484,0
"147.32.84.165",2781,"67.19.72.206",80,3,186,3,186,0,0,85397.974208,9.02900700000464,164.80217592025738,0
"147.32.84.165",2782,"67.19.72.206",80,3,186,3,186,0,0,85397.974368,9.028896000003442,164.8042019754611,0
"147.32.84.165",2783,"193.23.181.44",80,3,186,3,186,0,0,85397.974505,9.028805999987526,164.80584475976733,0
"147.32.84.165",2784,"67.19.72.206",80,3,186,3,186,0,0,85397.974637,9.028719999987516,164.80741456176042,0
"147.32.84.165",2785,"67.19.72.206",80,3,186,3,186,0,0,85397.974757,9.02864899999986,164.80871058339108,0
"147.32.84.165",2786,"193.23.181.44",179,3,186,3,186,0,0,85397.974887,9.028565000000526,164.81024393133495,0
"147.32.84.165",2787,"193.23.181.44",80,3,186,3,186,0,0,85397.975085,9.028414000000339,164.81300037857636,0
"147.32.84.165",2788,"193.23.181.44",179,3,186,3,186,0,0,85397.975311,9.02823399999761,164.81628633023843,0
"147.32.84.165",2789,"67.19.72.206",80,3,186,3,186,0,0,85397.975431,9.028158999994048,164.81765551548006,0
"147.32.84.165",2790,"46.137.16.7",80,8,1568,5,869,3,699,85398.069089,0.2308820000034757,30110.619276926504,24220.164412625574
"147.32.84.165",2791,"74.125.232.217",80,8,1880,5,871,3,1009,85398.070288,64.25405299999693,108.4445210016609,125.62631652201591
"147.32.84.165",2792,"72.20.15.61",80,3,186,3,186,0,0,85398.07369,9.029574999993201,164.79180913842794,0
"147.32.84.165",2793,"174.128.246.102",80,3,186,3,186,0,0,85398.073914,9.029411000010441,164.79480222998814,0
"147.32.84.165",2794,"174.37.196.55",80,3,186,3,186,0,0,85398.074892,9.028456000000006,164.81223367539246,0
"147.32.84.165",2796,"68.67.185.212",80,10,1905,6,982,4,923,85398.075142,14.554200999991735,539.775422917717,507.3449239847789
"147.32.84.165",2804,"68.67.185.218",80,10,1728,6,702,4,1026,85398.078341,14.55109999999695,385.95020307751145,564.0810660363629
"147.32.84.165",2795,"174.37.196.55",80,3,186,3,186,0,0,85398.102029,9.001340000002529,165.308720701538,0
"147.32.84.165",2797,"67.19.72.206",80,3,186,3,186,0,0,85398.102066,9.001322999989497,165.3090329056891,0
"147.32.84.165",2798,"72.20.15.61",80,3,186,3,186,0,0,85398.102104,9.001306999998633,165.3093267455744,0
"147.32.84.165",2799,"72.20.15.61",80,3,186,3,186,0,0,85398.102157,9.001281000004383,165.309804237783,0
"147.32.84.165",2800,"193.23.181.44",80,3,186,3,186,0,0,85398.102193,9.001268000007258,165.3100429849217,0
"147.32.84.165",2801,"72.20.15.61",80,3,186,3,186,0,0,85398.10224,9.001256000003195,165.31026336763134,0
"147.32.84.165",2802,"67.19.72.206",80,3,186,3,186,0,0,85398.102276,9.001255999988643,165.31026336789859,0
"147.32.84.165",2803,"193.23.181.44",80,3,186,3,186,0,0,85398.102312,9.001244999992196,165.31046538576499,0
"147.32.84.165",2805,"193.23.181.44",179,3,186,3,186,0,0,85398.102368,9.001212999995914,165.31105307703254,0
"147.32.84.165",2806,"193.23.181.44",80,3,186,3,186,0,0,85398.102407,9.00119700000505,165.31134692409967,0
"147.32.84.165",2807,"174.128.246.102",80,3,186,3,186,0,0,85398.102443,9.001188000009279,165.3115122135507,0
"147.32.84.165",2808,"174.128.246.102",80,9,906,6,722,3,184,85398.102478,3.381703999999445,1708.0146576994757,435.2835138735506
"147.32.84.165",2809,"174.37.196.55",80,3,186,3,186,0,0,85398.102518,9.001136000006227,165.31246722624462,0
"147.32.84.165",2810,"72.20.15.61",80,3,186,3,186,0,0,85398.102572,9.001105000003008,165.3130365660108,0
"147.32.84.165",2811,"193.23.181.44",179,3,186,3,186,0,0,85398.102608,9.001092000005883,165.31327532248613,0
"147.32.84.165",2812,"193.23.181.44",80,3,186,3,186,0,0,85398.102677,9.001048999998602,165.31406506066472,0
"147.32.84.165",2813,"72.20.15.61",80,3,186,3,186,0,0,85398.199897,9.00403599999845,165.25922375257676,0
"147.32.84.165",2814,"67.19.72.206",80,3,186,3,186,0,0,85398.203096,9.000937000004342,165.3161220880984,0
"147.32.84.165",2815,"193.23.181.44",80,3,186,3,186,0,0,85398.206296,8.997760999991442,165.37447482783944,0
"147.32.84.165",2816,"72.20.15.61",80,3,186,3,186,0,0,85398.209496,8.994581000006292,165.43294234594796,0
"147.32.84.165",2817,"193.23.181.44",80,3,186,3,186,0,0,85398.212697,8.991406000001007,165.49135919341575,0
"147.32.84.165",2818,"72.20.15.61",80,3,186,3,186,0,0,85398.215896,8.988230000002659,165.54983572956633,0
"147.32.84.165",2819,"46.4.36.120",443,6,366,3,186,3,180,85398.219101,0.9862750000029337,1508.707003620262,1460.039035761544
"147.32.84.165",2820,"65.55.92.168",25,2,124,2,124,0,0,85398.222294,2.9621559999941383,334.89120762105813,0
"147.32.84.165",2821,"193.23.181.44",179,3,186,3,186,0,0,85398.322715,8.881431999994675,167.54054976730015,0
"147.32.84.165",2822,"174.37.196.55",80,3,186,3,186,0,0,85398.335497,8.96902200000477,165.90437619611242,0
"147.32.84.165",2823,"193.23.181.44",80,3,186,3,186,0,0,85398.338697,8.96588000000338,165.9625156704572,0
"147.32.84.165",2824,"195.113.232.96",80,8,1350,5,819,3,531,85398.369514,63.95511799999804,102.44684405085768,66.42158020879783
"147.32.84.165",2825,"217.163.21.35",80,15,7282,7,2189,8,5093,85398.372714,0.27377500000875443,63964.93470711359,148822.9385396663
"147.32.84.165",2829,"64.4.62.124",81,7,1080,5,619,2,461,85398.418874,63.90531300001021,77.48964471857308,57.7103816078549
"147.32.84.165",2826,"174.37.196.55",80,3,186,3,186,0,0,85398.583362,9.022042999989935,164.92938461961,0
"147.32.84.165",2827,"193.23.181.44",80,3,186,3,186,0,0,85398.583394,9.022131000005174,164.92777593222118,0
"147.32.84.165",2830,"174.37.196.55",80,3,186,3,186,0,0,85398.58342,9.02215299999807,164.92737376547686,0
"147.32.84.165",2831,"193.23.181.44",80,3,186,3,186,0,0,85398.58345,9.022165999995195,164.92713612238927,0
"147.32.84.165",2832,"72.20.15.61",80,3,186,3,186,0,0,85398.583477,9.022188000002643,164.9267339584992,0
"147.32.84.165",2833,"217.163.21.35",80,13,5121,7,2193,6,2928,85398.607192,0.2351280000002589,74614.67796255946,99622.33336724766
"147.32.84.165",2834,"68.67.185.200",80,10,1660,6,865,4,795,85398.784655,13.844364999997197,499.8423546331956,459.3926843160584
"147.32.84.165",2835,"70.32.97.26",80,8,1491,5,836,3,655,85398.814173,0.34845299999869894,19193.40628441991,15037.896072123256
"147.32.84.165",2836,"193.23.181.44",179,3,186,3,186,0,0,85398.926408,8.979344000006677,165.71366460611083,0
"147.32.84.165",2837,"174.37.196.55",80,3,186,3,186,0,0,85398.926471,8.979405999998562,165.7125204050511,0
"147.32.84.165",2838,"193.23.181.44",179,3,186,3,186,0,0,85398.926522,8.979399000003468,165.71264958817682,0
"147.32.84.165",2839,"174.37.196.55",80,3,186,3,186,0,0,85399.077776,9.028463999988162,164.81208763771457,0
"147.32.84.165",2840,"193.23.181.44",179,3,186,3,186,0,0,85399.077984,9.02831700000388,164.81477112504584,0
"147.32.84.165",2841,"193.23.181.44",179,3,186,3,186,0,0,85399.196317,9.010707000008551,165.13687549696022,0
"147.32.84.165",2842,"193.23.181.44",179,3,186,3,186,0,0,85399.199514,9.007568999993964,165.19440483897455,0
"147.32.84.165",2843,"67.19.72.206",80,3,186,3,186,0,0,85399.202714,9.004390000001877,165.252726725485,0
"147.32.84.165",2844,"72.20.15.61",80,3,186,3,186,0,0,85399.205914,9.001216999997268,165.31097961536219,0
"147.32.84.165",2845,"193.23.181.44",179,3,186,3,186,0,0,85399.209114,8.998040000005858,165.36934710215016,0
"147.32.84.165",2846,"72.20.15.61",80,3,186,3,186,0,0,85399.212314,8.994862999999896,165.42775582018507,0
"147.32.84.165",2847,"174.37.196.55",80,3,186,3,186,0,0,85399.38514,8.921822000003885,166.78207657576579,0
"147.32.84.165",2848,"174.37.196.55",80,3,186,3,186,0,0,85399.388315,8.918766000002506,166.83922417065116,0
"147.32.84.165",2849,"193.23.181.44",80,3,186,3,186,0,0,85399.391514,8.91562200000044,166.89805826221956,0
"147.32.84.165",2850,"174.37.196.55",80,3,186,3,186,0,0,85399.394714,8.912465000001248,166.9571773914166,0
"147.32.84.165",2851,"174.128.246.102",80,17,2104,12,1796,5,308,85399.397914,93.2634790000011,154.05816032232542,26.419773596478972
"147.32.84.165",2852,"193.23.181.44",80,3,186,3,186,0,0,85399.401142,8.906088000003365,167.07672324812395,0
"147.32.84.165",2853,"193.23.181.44",80,3,186,3,186,0,0,85399.404347,8.902936999991653,167.13585640349865,0
"147.32.84.165",2854,"174.37.196.55",80,3,186,3,186,0,0,85399.407552,8.899779999992461,167.1951441497723,0
"147.32.84.165",2855,"193.23.181.44",179,3,186,3,186,0,0,85399.410743,8.896634999997332,167.25424837598106,0
"147.32.84.165",2856,"193.23.181.44",179,3,186,3,186,0,0,85399.413942,8.893479000005755,167.3136013475758,0
"147.32.84.165",2857,"174.37.196.55",80,3,186,3,186,0,0,85399.417142,8.890325999993365,167.37293998005364,0
"147.32.84.165",2858,"174.128.246.102",80,3,186,3,186,0,0,85399.42034,8.887180000005173,167.43218883820668,0
"147.32.84.165",2859,"174.37.196.55",80,3,186,3,186,0,0,85399.423514,8.884041000012076,167.4913476871592,0
"147.32.84.165",2861,"174.37.196.55",80,3,186,3,186,0,0,85399.445913,8.962142999997013,166.0317180835539,0
"147.32.84.165",2860,"174.37.196.55",80,3,186,3,186,0,0,85399.449113,8.959002000003238,166.089928320081,0
"147.32.84.165",2862,"193.23.181.44",80,3,186,3,186,0,0,85399.45234,8.955795999994734,166.1493852697041,0
"147.32.84.165",2863,"174.37.196.55",80,3,186,3,186,0,0,85399.455534,8.952628000013647,166.2081793187131,0
"147.32.84.165",2864,"193.23.181.44",80,3,186,3,186,0,0,85399.458715,8.949469999992289,166.2668292090238,0
"147.32.84.165",2865,"72.20.15.61",80,3,186,3,186,0,0,85399.461914,8.946293000000878,166.32587374456145,0
"147.32.84.165",2866,"174.128.246.102",80,3,186,3,186,0,0,85399.485533,8.92269700000179,166.76572117149126,0
"147.32.84.165",2867,"193.23.181.44",80,3,186,3,186,0,0,85399.544281,8.96353700000327,166.0058970024285,0
"147.32.84.165",2868,"72.20.15.61",80,3,186,3,186,0,0,85399.564655,8.943295000004582,166.38163003671886,0
"147.32.84.165",2869,"72.20.15.61",80,3,186,3,186,0,0,85399.679157,9.029960999992909,164.78476485127328,0
"147.32.84.165",2871,"174.37.196.55",80,7,599,4,417,3,182,85399.679924,0.28144500000053085,11853.115173457363,5173.302066113286
"147.32.84.165",2870,"174.128.246.102",80,12,879,8,633,4,246,85399.680198,18.437401999995927,274.65908700158076,106.73955039871858
"147.32.84.165",2872,"193.23.181.44",179,3,186,3,186,0,0,85399.680419,9.02882099999988,164.80557095993152,0
"147.32.84.165",2873,"193.23.181.44",179,3,186,3,186,0,0,85399.680643,9.028617000003578,164.80929471251358,0
"147.32.84.165",2874,"193.23.181.44",179,3,186,3,186,0,0,85399.791979,9.01708000000508,165.02016173740964,0
"147.32.84.165",2875,"193.23.181.44",80,3,186,3,186,0,0,85399.79518,9.013999000002514,165.07656590594087,0
"147.32.84.165",2877,"193.23.181.44",179,3,186,3,186,0,0,85399.798379,9.010848999998416,165.13427314121694,0
"147.32.84.165",2876,"174.37.196.55",80,3,186,3,186,0,0,85399.80153,9.007741000008537,165.19125050316055,0
"147.32.84.165",2878,"193.23.181.44",179,3,186,3,186,0,0,85399.80473,9.004590999989887,165.2490379631536,0
"147.32.84.165",2879,"67.19.72.206",80,3,186,3,186,0,0,85399.80793,9.00144900000305,165.30671895152614,0
"147.32.84.165",2880,"174.37.196.55",80,3,186,3,186,0,0,85399.81113,8.998298999998951,165.36458724034102,0
"147.32.84.165",2881,"72.20.15.61",80,3,186,3,186,0,0,85399.814329,8.9951449999935,165.42256961961985,0
"147.32.84.165",2882,"67.19.72.206",80,3,186,3,186,0,0,85399.81753,8.991989999994985,165.48061107728432,0
"147.32.84.165",2883,"193.23.181.44",80,3,186,3,186,0,0,85399.82073,8.988836999997147,165.53865644693215,0
"147.32.84.165",2884,"174.37.196.55",80,3,186,3,186,0,0,85399.82393,8.98568100000557,165.59679783859204,0
"147.32.84.165",2885,"193.23.181.44",179,3,186,3,186,0,0,85399.827159,8.982499000005191,165.65545957746727,0
"147.32.84.165",2886,"67.19.72.206",80,3,186,3,186,0,0,85399.83033,8.979372000001604,165.71314786821776,0
"147.32.84.165",2887,"193.23.181.44",179,3,186,3,186,0,0,85399.83353,8.97621700000309,165.7713934499899,0
"147.32.84.165",2888,"193.23.181.44",80,3,186,3,186,0,0,85399.855147,8.954645000005257,166.1707415535877,0
"147.32.84.165",2889,"184.154.10.50",8339,7,424,4,242,3,182,85399.861931,0.4442469999921741,4357.936013150578,3277.4560098901043
"147.32.84.165",2890,"174.37.196.55",80,3,186,3,186,0,0,85400.081638,9.028596999996807,164.80965979548387,0
"147.32.84.165",2891,"174.128.246.102",80,3,186,3,186,0,0,85400.08191,9.02838500001235,164.81352977281813,0
"147.32.84.165",2892,"193.23.181.44",80,3,186,3,186,0,0,85400.092313,9.018003000004683,165.00327178857972,0
"147.32.84.165",2893,"174.128.246.102",80,3,186,3,186,0,0,85400.181433,9.028450999991037,164.8123249493714,0
"147.32.84.165",2894,"72.20.15.61",80,3,186,3,186,0,0,85400.181592,9.028413000007276,164.81301863337453,0
"147.32.84.165",2895,"72.20.15.61",80,3,186,3,186,0,0,85400.18178,9.028273000003537,164.81557436282853,0
"147.32.84.165",2896,"174.37.196.55",80,3,186,3,186,0,0,85400.181921,9.028178000007756,164.81730865283356,0
"147.32.84.165",2897,"46.4.36.120",443,6,366,3,186,3,180,85400.205301,1.0075520000100369,1476.8468525546841,1429.206631504533
"147.32.84.165",2898,"174.128.246.102",80,3,186,3,186,0,0,85400.281753,9.028722999995807,164.80735980057102,0
"147.32.84.165",2899,"67.19.72.206",80,3,186,3,186,0,0,85400.282516,9.028060999989975,164.81944461846817,0
"147.32.84.165",2900,"67.19.72.206",80,3,186,3,186,0,0,85400.282794,9.02780700000585,164.82408186163437,0
"147.32.84.165",2901,"174.37.196.55",80,3,186,3,186,0,0,85400.283034,9.027587000004132,164.82809858263553,0
"147.32.84.165",2902,"67.19.72.206",80,3,186,3,186,0,0,85400.283484,9.027163000006112,164.83584045164494,0
"147.32.84.165",2903,"193.23.181.44",179,3,186,3,186,0,0,85400.283834,9.02683600000455,164.841811682327,0
"147.32.84.165",2904,"174.128.246.102",80,9,754,6,572,3,182,85400.284156,9.35850400000345,488.9670400310042,155.5804218280468
"147.32.84.165",2905,"174.37.196.55",80,3,186,3,186,0,0,85400.390756,9.020349000013084,164.9603579637375,0
"147.32.84.165",2906,"193.23.181.44",179,3,186,3,186,0,0,85400.393956,9.017269999996643,165.01668465073732,0
"147.32.84.165",2907,"67.19.72.206",80,3,186,3,186,0,0,85400.397156,9.014117999991868,165.07438664563105,0
"147.32.84.165",2908,"67.19.72.206",80,3,186,3,186,0,0,85400.400356,9.01096200000029,165.1322023109133,0
"147.32.84.165",2909,"174.37.196.55",80,3,186,3,186,0,0,85400.403556,9.007810999988578,165.1899667968041,0
"147.32.84.165",2910,"72.20.15.61",80,3,186,3,186,0,0,85400.406756,9.004656000004616,165.24784511470924,0
"147.32.84.165",2911,"67.19.72.206",80,3,186,3,186,0,0,85400.482628,9.028638000003411,164.8089113772684,0
"147.32.84.165",2912,"67.19.72.206",80,6,366,3,186,3,180,85400.682413,1.363134999992326,1091.6013454341478,1056.3883988072398
"147.32.84.165",2913,"193.23.181.44",80,3,186,3,186,0,0,85400.792735,9.020141000000876,164.9641618684071,0
"147.32.84.165",2914,"174.128.246.102",80,3,186,3,186,0,0,85400.795935,9.016998999999487,165.02164411907827,0
"147.32.84.165",2915,"72.20.15.61",80,3,186,3,186,0,0,85400.799134,9.01382900000317,165.07967923503725,0
"147.32.84.165",2916,"174.128.246.102",80,3,186,3,186,0,0,85400.802335,9.01064999999653,165.13792012791228,0
"147.32.84.165",2917,"174.128.246.102",80,3,186,3,186,0,0,85400.80556,9.007446000003256,165.19666062937952,0
"147.32.84.165",2918,"193.23.181.44",80,3,186,3,186,0,0,85400.808754,9.004278000007616,165.2547822267084,0
"147.32.84.165",2919,"72.20.15.61",80,3,186,3,186,0,0,85400.811955,9.001101000001654,165.31311002950935,0
"147.32.84.165",2920,"67.19.72.206",80,3,186,3,186,0,0,85400.815164,8.997912999999244,165.37168118875178,0
"147.32.84.165",2921,"165.21.74.114",25,2,124,2,124,0,0,85400.89966,2.993672000011429,331.3656272284381,0
"147.32.84.165",2922,"174.37.196.55",80,3,186,3,186,0,0,85401.213084,9.000323000000208,165.32739991664363,0
"147.32.84.165",2923,"72.20.15.61",80,3,186,3,186,0,0,85401.213144,9.000327000001562,165.32732644044398,0
"147.32.84.165",2924,"174.128.246.102",80,3,186,3,186,0,0,85401.284669,9.029639000000316,164.7906411319376,0
"147.32.84.165",2925,"174.128.246.102",80,3,186,3,186,0,0,85401.384112,9.029821999996784,164.78730145517042,0
"147.32.84.165",2926,"67.19.72.206",80,3,186,3,186,0,0,85401.384257,9.02978300000541,164.78801317806958,0
"147.32.84.165",2927,"67.19.72.206",80,3,186,3,186,0,0,85402.046152,8.97081500000786,165.8712168290948,0
"147.32.84.165",2928,"193.23.181.44",80,3,186,3,186,0,0,85402.188242,9.02852900000289,164.81090108915012,0
"147.32.84.165",2929,"46.4.36.120",443,6,366,3,186,3,180,85402.212843,1.005617999995593,1479.6871177788396,1431.9552752698446
"147.32.84.165",2936,"67.231.152.94",25,2,124,2,124,0,0,85403.218674,2.9820869999966817,332.6529373559872,0
"147.32.84.165",2930,"174.128.246.102",80,3,186,3,186,0,0,85410.012752,8.930300000007264,166.62374164348225,0
"147.32.84.165",2938,"85.66.209.80",6667,1,62,1,62,0,0,85410.012817,0,0,0
"147.32.84.165",2941,"46.4.36.120",443,6,366,3,186,3,180,85411.517661,1.0312459999986459,1442.9146876709863,1396.3690525848253
"147.32.84.165",2942,"184.82.148.43",80,10,1919,5,979,5,940,85412.019136,0.3232350000034785,24230.04934464311,23264.807338063867
"147.32.84.165",2939,"209.191.88.254",25,3,186,3,186,0,0,85412.125863,8.924945999999181,166.72369782406935,0
"147.32.84.165",2931,"193.23.181.44",80,9,914,6,530,3,384,85412.520774,3.0307539999921573,1398.9918020436405,1013.6091546882226
"147.32.84.165",2986,"184.82.148.44",80,10,1514,5,596,5,918,85412.520888,0.32666700000118,14595.90347351516,22481.60971256194
"147.32.84.165",2950,"205.188.103.1",25,3,186,3,186,0,0,85412.549196,8.90206299998681,167.1522657166327,0
"147.32.84.165",2932,"193.23.181.44",80,9,893,6,509,3,384,85412.628471,3.027178999996977,1345.1467521425282,1014.8061941507482
"147.32.84.165",2963,"209.191.88.254",25,1,62,1,62,0,0,85412.628529,0,0,0
"147.32.84.165",2933,"174.37.196.55",80,18,1235,10,753,8,482,85412.628583,98.0647750000062,61.42878520854833,39.32094883203226
"147.32.84.165",2964,"67.231.152.94",25,1,62,1,62,0,0,85412.628635,0,0,0
"147.32.84.165",2934,"174.37.196.55",80,3,186,3,186,0,0,85413.022498,8.930155999987619,166.6264284747168,0
"147.32.84.165",2989,"217.163.21.36",80,14,6141,7,810,7,5331,85413.022564,0.1907480000081705,33971.52263574159,223582.9471248622
"147.32.84.165",2972,"165.21.74.114",25,1,62,1,62,0,0,85413.022618,0,0,0
"147.32.84.165",2935,"193.23.181.44",179,12,903,6,543,6,360,85413.069112,3.0512029999954393,1423.7007501652604,943.8900001095649
"147.32.84.165",2991,"66.111.4.71",25,3,186,3,186,0,0,85413.069153,8.883619999993243,167.49928520143047,0
"147.32.84.165",2992,"217.163.21.36",80,10,1451,5,701,5,750,85417.136009,0.13991600000008475,40081.19157206183,42882.872580665295
"147.32.84.165",2987,"64.12.139.193",25,1,62,1,62,0,0,85417.136076,0,0,0
"147.32.84.165",2937,"193.23.181.44",179,11,832,5,472,6,360,85417.182241,0.1926660000026459,19598.683732200512,14948.148609305475
"147.32.84.165",2993,"202.95.154.126",6667,3,184,2,124,1,60,85417.182272,3.6693469999881927,270.3478302823887,130.81346626567193
"147.32.84.165",2994,"46.4.36.120",443,6,366,3,186,3,180,85417.536896,1.0321719999919878,1441.6201950949555,1395.116317833828
"147.32.84.165",3059,"217.163.21.35",80,11,3826,6,2186,5,1640,85418.039438,0.23567099998763297,74205.14191783333,55670.82925217139
"147.32.84.165",2995,"209.191.88.254",25,3,186,3,186,0,0,85418.085518,8.988802999985637,165.53928259439857,0
"147.32.84.165",2940,"193.23.181.44",179,10,774,5,474,5,300,85418.085579,0.19243499998992775,19705.35505598502,12471.743706319632
"147.32.84.165",3011,"64.12.90.65",25,1,62,1,62,0,0,85418.085628,0,0,0
"147.32.84.165",2943,"174.128.246.102",80,10,1197,7,1013,3,184,85418.569212,9.267831999997725,874.4224107646739,158.82894726623888
"147.32.84.165",3221,"217.163.21.36",80,10,2277,5,1156,5,1121,85418.569243,0.14186099999642465,65190.57387324972,63216.8108234541
"147.32.84.165",3012,"165.21.74.114",25,2,124,2,124,0,0,85418.615164,2.936919999992824,337.7688190357326,0
"147.32.84.165",2944,"193.23.181.44",80,8,861,5,477,3,384,85420.04783,0.12284700000600424,31063.029620694768,25006.715669490128
"147.32.84.165",3382,"46.4.36.120",443,6,366,3,186,3,180,85420.047894,1.0303439999988768,1444.1778668111058,1397.5914840107475
"147.32.84.165",3292,"217.163.21.35",80,13,5774,7,2701,6,3073,85421.078477,0.1554009999963455,139046.72428432346,158197.18020204589
"147.32.84.165",3020,"69.10.230.70",25,1,62,1,62,0,0,85421.124504,0,0,0
"147.32.84.165",2945,"174.128.246.102",80,9,728,6,546,3,182,85425.066942,9.350011000002269,467.1652257948082,155.72174193160274
"147.32.84.165",3475,"79.140.237.191",6667,2,124,2,124,0,0,85425.067041,3.010133000003407,329.5535446436677,0
"147.32.84.165",3466,"46.4.36.120",443,6,366,3,186,3,180,85425.567976,1.0305889999872306,1443.8345451178277,1397.2592372108008
"147.32.84.165",3396,"184.82.148.43",80,10,1919,5,979,5,940,85426.598794,0.303805999996257,25779.609356288198,24752.638197048935
"147.32.84.165",3021,"207.115.21.24",25,3,186,3,186,0,0,85426.699096,9.0051070000045,165.23956905778647,0
"147.32.84.165",2946,"72.20.15.61",80,3,186,3,186,0,0,85427.074257,9.031501000004937,164.75666669351935,0
"147.32.84.165",3480,"46.4.36.120",443,6,366,3,186,3,180,85430.084998,1.0301909999980126,1444.3923505474913,1397.7990489169272
"147.32.84.165",3443,"173.241.240.4",80,9,2195,5,1165,4,1030,85430.085101,0.06814899999881163,136759.1600781012,120911.53208621824
"147.32.84.165",3023,"65.55.37.104",25,3,186,3,186,0,0,85430.101604,9.014171000002534,165.07341606894096,0
"147.32.84.165",2947,"72.20.15.61",80,3,186,3,186,0,0,85431.115409,9.004065999994054,165.25867313733403,0
"147.32.84.165",3479,"184.82.148.44",80,10,1514,5,596,5,918,85431.11547,0.32299200000124983,14761.975528748544,22737.40526072343
"147.32.84.165",3194,"209.191.88.254",25,3,186,3,186,0,0,85431.221936,8.997900999995181,165.3719017358378,0
"147.32.84.165",2948,"67.19.72.206",80,3,186,3,186,0,0,85431.221996,8.997962000008556,165.3707806277227,0
"147.32.84.165",3483,"217.163.21.36",80,13,6081,6,750,7,5331,85432.091091,0.18682100001024082,32116.303839884717,228282.68769390057
"147.32.84.165",3293,"64.12.139.193",25,3,186,3,186,0,0,85432.091221,9.032005000000936,164.74747301400362,0
"147.32.84.165",2949,"67.19.72.206",80,3,186,3,186,0,0,85432.136984,8.986329000006663,165.5848567305845,0
"147.32.84.165",3488,"46.4.36.120",443,6,366,3,186,3,180,85432.137043,0.9856940000026952,1509.5962844411463,1460.899630104335
"147.32.84.165",3490,"217.163.21.36",80,10,1451,5,701,5,750,85433.095476,0.13913500000489876,40306.177452133175,43123.585005848625
"147.32.84.165",3465,"205.188.190.1",25,3,186,3,186,0,0,85433.12297,9.003015000009327,165.27796521481508,0
"147.32.84.165",2951,"174.37.196.55",80,3,186,3,186,0,0,85433.14122,8.984877999988385,165.61159762012613,0
"147.32.84.165",3493,"93.116.166.52",6667,2,124,2,124,0,0,85433.496684,3.010796999995364,329.48086503391875,0
"147.32.84.165",3492,"217.163.21.35",80,13,5216,7,2251,6,2965,85433.998369,0.25393500000063796,70915.78553549042,93409.73083639675
"147.32.84.165",3473,"209.191.88.254",25,3,186,3,186,0,0,85434.044153,8.984909000006155,165.61102622174366,0
"147.32.84.165",2952,"193.23.181.44",80,8,861,5,477,3,384,85440.119352,0.13833600000361912,27585.010408716218,22206.80083217406
"147.32.84.165",3495,"216.157.130.15",25,3,186,3,186,0,0,85440.18801,8.86015400000906,167.94290482969916,0
"147.32.84.165",3499,"184.82.148.43",80,10,1899,5,979,5,920,85447.64385,0.3224860000045737,24286.325607588922,22822.69617873525
"147.32.84.165",3476,"205.188.190.1",25,3,186,3,186,0,0,85447.750669,9.023354000004474,164.90542208576346,0
"147.32.84.165",2953,"174.128.246.102",80,7,570,4,388,3,182,85447.750699,0.3314729999983683,9364.261945966276,4392.51462413882
"147.32.84.165",3508,"188.72.216.51",6667,6,366,3,186,3,180,85447.750723,1.0173539999959758,1462.6177318867237,1415.4365147290875
"147.32.84.165",3497,"46.4.36.120",443,6,366,3,186,3,180,85448.04475,1.030757000000449,1443.5992188259231,1397.031502089603
"147.32.84.165",3511,"184.82.148.44",80,10,1476,5,581,5,895,85448.768326,0.32127200000104494,14467.491720364309,22286.411514158444
"147.32.84.165",3477,"68.6.19.3",25,3,186,3,186,0,0,85448.874811,9.003725999995368,165.2649136591635,0
"147.32.84.165",2954,"174.37.196.55",80,3,186,3,186,0,0,85449.075712,9.00349199998891,165.26920888049136,0
"147.32.84.165",3515,"217.163.21.35",80,15,7589,7,2225,8,5364,85449.075771,0.19799699999566656,89900.35202750334,216730.55652832714
"147.32.84.165",3478,"64.12.139.193",25,3,186,3,186,0,0,85449.121611,8.957626000003074,166.11544174756673,0
"147.32.84.165",2955,"174.128.246.102",80,7,571,5,449,2,122,85449.121642,3.253454999998212,1104.0570716367597,299.9887811574269
"147.32.84.165",3481,"209.191.88.254",25,3,186,3,186,0,0,85449.121665,8.957607000003918,166.11579409538163,0
"147.32.84.165",2956,"193.23.181.44",80,9,898,5,454,4,444,85449.121688,0.12504300000728108,29046.008171497113,28406.228255825372
"147.32.84.165",3484,"212.82.111.207",25,3,186,3,186,0,0,85449.183901,8.995682000007946,165.41269466825145,0
"147.32.84.165",2957,"72.20.15.61",80,3,186,3,186,0,0,85450.151998,9.03068599999824,164.77153562866542,0
"147.32.84.165",3519,"46.4.36.120",443,6,366,3,186,3,180,85451.055451,1.030363000012585,1444.1512360030645,1397.56571226103
"147.32.84.165",3517,"217.163.21.35",80,13,5055,7,2227,6,2828,85452.086065,0.27367799999774434,65098.40031038973,82666.49127875266
"147.32.84.165",3485,"204.127.217.16",25,3,186,3,186,0,0,85452.131975,8.957330000004731,166.12093112559367,0
"147.32.84.165",2958,"174.37.196.55",80,3,186,3,186,0,0,85452.158914,9.03103800000099,164.76511337897557,0
"147.32.84.165",3522,"201.160.226.207",6667,2,124,2,124,0,0,85452.161583,3.0068740000133403,329.9107312097544,0
"147.32.84.165",3486,"64.12.90.65",25,3,186,3,186,0,0,85453.062085,9.030813000004855,164.76921845233647,0
"147.32.84.165",2959,"193.23.181.44",179,10,762,5,462,5,300,85454.064688,0.20354699999734294,18157.968430132827,11790.888590995342
"147.32.84.165",3528,"46.4.36.120",443,6,366,3,186,3,180,85454.064755,1.0314809999981662,1442.5859516584846,1396.0509209598238
"147.32.84.165",3487,"67.231.152.86",25,3,186,3,186,0,0,85454.131314,8.965328999998746,165.9727155579241,0
"147.32.84.165",2960,"174.37.196.55",80,3,186,3,186,0,0,85454.968938,9.030166999989888,164.78100571137458,0
"147.32.84.165",3489,"205.188.190.1",25,3,186,3,186,0,0,85455.096483,9.002875000005588,165.28053538442737,0
"147.32.84.165",2961,"72.20.15.61",80,3,186,3,186,0,0,85461.089444,9.031060000008438,164.76471200485986,0
"147.32.84.165",3534,"46.4.36.120",443,6,366,3,186,3,180,85461.0895,1.0310060000047088,1443.2505727349833,1396.694102646758
"147.32.84.165",3532,"184.82.148.43",80,10,1923,5,983,5,940,85462.120777,0.34258799999952316,22954.68609528339,21950.564526517177
"147.32.84.165",3491,"209.191.88.254",25,3,186,3,186,0,0,85462.233088,8.990739000000758,165.50363657535544,0
"147.32.84.165",2962,"174.37.196.55",80,9,723,6,541,3,182,85468.715122,9.171567000012146,471.8931890258522,158.75149797172847
"147.32.84.165",3542,"59.78.181.188",6667,1,62,1,62,0,0,85468.715263,0,0,0
"147.32.84.165",3545,"46.4.36.120",443,6,366,3,186,3,180,85469.921298,1.0294980000035139,1445.3646340205821,1398.7399684070149
"147.32.84.165",3543,"184.82.148.44",80,10,1513,5,596,5,917,85470.220874,0.3235839999979362,14734.968354524359,22671.083860904087
"147.32.84.165",3494,"65.54.188.110",25,3,186,3,186,0,0,85470.327382,8.922831000003498,166.76321674134775,0
"147.32.84.165",2965,"67.19.72.206",80,3,186,3,186,0,0,85470.951044,8.900574999992386,167.1802102674572,0
"147.32.84.165",3551,"184.82.148.43",80,10,1925,5,987,5,938,85471.223947,0.3045689999999013,25925.159816010688,24638.095144293846
"147.32.84.165",3500,"66.94.237.64",25,3,186,3,186,0,0,85471.324475,8.927842999997665,166.66959757249194,0
"147.32.84.165",2966,"193.23.181.44",179,10,793,5,493,5,300,85473.130315,0.20492899999953806,19245.68997071615,11711.373207332344
"147.32.84.165",3556,"27.251.19.95",6667,2,124,2,124,0,0,85473.197101,2.9426990000065416,337.1054939692421,0
"147.32.84.165",3557,"46.4.36.120",443,6,366,3,186,3,180,85474.133124,1.030968999999459,1443.302368937166,1396.744228003709
"147.32.84.165",3552,"217.163.21.36",80,13,6077,6,749,7,5328,85475.13648,0.1870070000004489,32041.581331103203,227927.29683860863
"147.32.84.165",3501,"204.127.217.16",25,3,186,3,186,0,0,85475.164334,8.90147500000603,167.1633072045916,0
"147.32.84.165",3562,"173.192.170.88",80,19,4122,9,763,10,3359,85475.182354,41.39419700000144,147.46028289906886,649.1731196041577
"147.32.84.165",2967,"193.23.181.44",80,8,808,5,424,3,384,85475.383192,0.1237610000098357,27407.6647710541,24822.036019067866
"147.32.84.165",3555,"184.82.148.44",80,10,1512,5,594,5,918,85475.444664,0.34026100000482984,13965.749821262347,21583.4315419509
"147.32.84.165",3502,"209.191.88.254",25,3,186,3,186,0,0,85475.557003,8.910428000002867,166.9953452291541,0
"147.32.84.165",2968,"174.37.196.55",80,3,186,3,186,0,0,85475.557061,8.910503999999491,166.99392088259933,0
"147.32.84.165",3563,"217.163.21.36",80,10,1448,5,699,5,749,85475.557115,0.13913999999931548,40189.73695578202,43064.5393131341
"147.32.84.165",3503,"64.12.139.193",25,3,186,3,186,0,0,85475.602985,8.86464299999352,167.85785958905367,0
"147.32.84.165",2969,"193.23.181.44",80,9,875,5,423,4,452,85476.03956,0.1426589999900898,23720.90089118162,25347.156507834734
"147.32.84.165",3565,"217.163.21.35",80,14,5294,7,2259,7,3035,85476.101977,0.24417499999981374,74012.49104131784,99436.87928747218
"147.32.84.165",3504,"200.69.107.59",25,3,186,3,186,0,0,85476.139905,8.929160999992746,166.64499609775305,0
"147.32.84.165",2970,"67.19.72.206",80,3,186,3,186,0,0,85476.147981,8.921212000001105,166.79348052706467,0
"147.32.84.165",3568,"212.117.171.138",65500,217,169965,130,163369,87,6596,85476.14803,103.77629000000888,12593.936437695818,508.4783817189406
"147.32.84.165",3566,"217.163.21.36",80,13,6078,6,750,7,5328,85476.148056,0.18777599999157246,31952.9652366079,226993.86504086253
"147.32.84.165",3505,"124.108.110.37",25,3,186,3,186,0,0,85476.194018,8.87522600000375,167.6577024629425,0
"147.32.84.165",2971,"193.23.181.44",179,10,781,5,481,5,300,85478.747893,0.18568699999013916,20723.044694590073,12924.975900991729
"147.32.84.165",3572,"66.94.236.34",25,3,186,3,186,0,0,85478.808717,8.969121999994968,165.90252646812417,0
"147.32.84.165",3571,"46.4.36.120",443,6,366,3,186,3,180,85483.163206,1.0304529999993974,1444.025103523276,1397.443648570912
"147.32.84.165",3573,"217.163.21.36",80,10,1449,5,700,5,749,85484.193883,0.13968399999430403,40090.489964694265,42896.824262222864
"147.32.84.165",3507,"64.12.139.193",25,3,186,3,186,0,0,85484.239794,8.955371000003652,166.1572703129098,0
"147.32.84.165",2973,"174.37.196.55",80,3,186,3,186,0,0,85484.239865,8.955436999996891,166.15604576309525,0
"147.32.84.165",3581,"59.113.54.127",6667,1,62,1,62,0,0,85488.780804,0,0,0
"147.32.84.165",3588,"46.4.36.120",443,6,366,3,186,3,180,85491.288684,1.0312799999956042,1442.867116599122,1396.3230160636665
"147.32.84.165",3577,"184.82.148.43",80,10,1917,5,979,5,938,85491.89097,0.35829000000376254,21859.387646648673,20943.92810271344
"147.32.84.165",3509,"205.188.103.1",25,3,186,3,186,0,0,85492.009444,9.013443000003463,165.08674875953932,0
"147.32.84.165",2974,"67.19.72.206",80,3,186,3,186,0,0,85492.292626,9.031224999998813,164.7617017625179,0
"147.32.84.165",3592,"119.152.220.218",6667,2,124,2,124,0,0,85492.320206,2.9824379999918165,332.6137877812454,0
"147.32.84.165",3598,"46.4.36.120",443,6,366,3,186,3,180,85496.104384,1.031764999992447,1442.1888705382455,1395.6666489079796
"147.32.84.165",3587,"217.163.21.35",80,13,5241,7,2265,6,2976,85496.505684,0.28162500000325963,64340.878827484325,84537.94939982046
"147.32.84.165",3597,"208.73.210.29",80,50,36633,22,3380,28,33253,85496.551615,16.348251000003074,1653.999562399361,16272.32173031537
"147.32.84.165",3510,"209.191.88.254",25,3,186,3,186,0,0,85496.727469,9.012193000002299,165.10964645337938,0
"147.32.84.165",2975,"193.23.181.44",179,11,841,5,481,6,360,85497.108854,0.18842299999960233,20422.135301996685,15284.758230184629
"147.32.84.165",3595,"184.82.148.44",80,10,1511,5,594,5,917,85497.108888,0.32200299999385606,14757.626482022435,22782.39643773497
"147.32.84.165",3514,"64.12.139.193",25,3,186,3,186,0,0,85497.136371,9.004415999996127,165.25224956295224,0
"147.32.84.165",2976,"193.23.181.44",179,10,782,5,482,5,300,85497.169553,0.1875209999998333,20563.030273960932,12798.566560556597
"147.32.84.165",3518,"207.115.21.24",25,3,186,3,186,0,0,85497.169612,8.971233999996912,165.8634698415527,0
"147.32.84.165",2977,"174.37.196.55",80,3,186,3,186,0,0,85497.215502,9.026299999997718,164.8516003235408,0
"147.32.84.165",3520,"205.188.103.1",25,3,186,3,186,0,0,85497.215562,9.026341999997385,164.850833261185,0
"147.32.84.165",2978,"193.23.181.44",80,8,933,5,547,3,386,85497.215613,0.12177100000553764,35936.306672368606,25359.0756408305
"147.32.84.165",3521,"209.85.143.27",25,3,186,3,186,0,0,85497.215668,9.026259999998729,164.8523308657417,0
"147.32.84.165",2979,"174.128.246.102",80,7,601,4,419,3,182,85498.814723,0.32724499999312684,10243.090039787934,4449.265840671608
"147.32.84.165",3608,"46.4.36.120",443,6,366,3,186,3,180,85498.814822,1.0308859999931883,1443.4185739352674,1396.8566844534846
"147.32.84.165",3606,"217.163.21.36",80,14,6137,7,809,7,5328,85499.817974,0.18751599999086466,34514.38810722979,227308.60301028469
"147.32.84.165",3607,"74.125.232.217",80,8,1909,5,1035,3,874,85499.845909,13.054174999997485,634.2798376765744,535.6140851491073
"147.32.84.165",3523,"207.115.36.22",25,3,186,3,186,0,0,85499.854066,8.898287999996683,167.22317821142164,0
"147.32.84.165",2980,"72.20.15.61",80,3,186,3,186,0,0,85499.863857,8.888621999998577,167.40502633594255,0
"147.32.84.165",3619,"61.17.216.4",6667,10,1152,5,594,5,558,85505.238115,1.0617999999958556,4475.419099659585,4204.181578468096
"147.32.84.165",3618,"46.4.36.120",443,6,366,3,186,3,180,85505.436211,1.0343120000034105,1438.6374710871512,1392.2298107295012
"147.32.84.165",3614,"217.163.21.36",80,10,1448,5,699,5,749,85506.470775,0.139433000003919,40105.283540071774,42974.04488056331
"147.32.84.165",3613,"67.214.158.5",80,10,1714,5,859,5,855,85506.51671,0.33024000001023524,20809.108526486838,20712.20930168364
"147.32.84.165",3529,"205.188.190.1",25,3,186,3,186,0,0,85506.620233,8.857993000012357,167.98387625706232,0
"147.32.84.165",2981,"174.128.246.102",80,10,966,6,722,4,244,85508.350607,3.3789620000025025,1709.4006976094204,577.692202516203
"147.32.84.165",3627,"46.4.36.120",443,6,366,3,186,3,180,85508.350739,1.0307949999987613,1443.546000903951,1396.9800008747911
"147.32.84.165",3617,"184.82.148.43",80,10,1917,5,979,5,938,85509.381776,0.325077000001329,24092.753409093788,23083.76169328904
"147.32.84.165",3615,"208.73.211.25",80,6,883,3,703,3,180,85509.488228,0.3656170000031125,15382.216909914263,3938.547715198531
"147.32.84.165",3533,"209.191.88.254",25,3,186,3,186,0,0,85509.6633,9.025135999996564,164.87286174973613,0
"147.32.84.165",2982,"72.20.15.61",80,3,186,3,186,0,0,85509.663374,9.025197000009939,164.87174739768687,0
"147.32.84.165",3631,"95.155.98.55",6667,2,124,2,124,0,0,85509.66343,3.0046819999988656,330.1514103656808,0
"147.32.84.165",3633,"46.4.36.120",443,6,366,3,186,3,180,85512.969665,1.0312280000071041,1442.9398736164546,1396.39342608044
"147.32.84.165",3624,"217.163.21.35",80,11,3832,6,2204,5,1628,85513.271236,0.23264499999640975,75789.29270034646,55982.290615319434
"147.32.84.165",3535,"207.115.36.22",25,3,186,3,186,0,0,85513.317006,8.982487000001129,165.6556808821224,0
"147.32.84.165",2983,"193.23.181.44",80,8,892,5,508,3,384,85513.317079,0.12843599999905564,31642.218692811064,23918.527515825685
"147.32.84.165",3632,"184.82.148.44",80,10,1512,5,594,5,918,85513.380941,0.3066970000072615,15494.11960302021,23945.45756830396
"147.32.84.165",3536,"64.12.90.65",25,3,186,3,186,0,0,85513.481464,9.019081000005826,164.9835498759839,0
"147.32.84.165",2984,"174.128.246.102",80,9,693,5,451,4,242,85514.001139,3.310148999997182,1089.9811458647546,584.8679319274294
"147.32.84.165",3638,"217.163.21.36",80,10,2274,5,1154,5,1120,85514.001214,0.1395489999995334,66155.9738875296,64206.83774179649
"147.32.84.165",3537,"200.147.36.13",25,3,186,3,186,0,0,85514.047063,8.95525899999484,166.15934837851785,0
"147.32.84.165",3644,"173.192.170.88",80,11,1099,6,542,5,557,85517.685752,59.09572299999127,73.37248416438938,75.4030879696769
"147.32.84.165",2985,"193.23.181.44",179,10,784,5,484,5,300,85517.886461,0.1914039999974193,20229.462289462113,12538.922906691392
"147.32.84.165",3643,"46.4.36.120",443,6,366,3,186,3,180,85517.949222,0.9669010000070557,1538.937285191702,1489.2941469597115
"147.32.84.165",3639,"217.163.21.36",80,13,6081,6,750,7,5331,85518.085947,0.23161800000525545,25904.72243031137,184130.76703465322
"147.32.84.165",3538,"64.12.139.193",25,3,186,3,186,0,0,85518.086097,9.030248999988544,164.77950940244148,0
"147.32.84.165",2988,"174.128.246.102",80,7,601,4,419,3,182,85518.131762,0.32038099999772385,10462.543034773642,4544.589098636761
"147.32.84.165",3640,"217.163.21.35",80,13,5815,7,2719,6,3096,85518.131837,0.16936400000122376,128433.43331429837,146241.23190182704
"147.32.84.165",3539,"72.4.117.21",25,3,186,3,186,0,0,85518.177747,8.93872000000556,166.46678719090366,0
"147.32.84.165",2990,"174.128.246.102",80,8,661,4,419,4,242,85518.228568,0.32001099998888094,10474.63993461621,6049.792038608885
"147.32.84.165",3647,"184.82.148.43",80,10,1917,5,979,5,938,85518.231768,0.3077929999999469,25445.672903546703,24380.021637923197
"147.32.84.165",3540,"209.191.88.254",25,3,186,3,186,0,0,85518.333417,8.98326399999496,165.64135263094067,0
"147.32.84.165",2996,"72.20.15.61",80,10,778,6,536,4,242,85518.916345,9.375081999998656,457.3826660930128,206.50486043751698
"147.32.84.165",3650,"173.241.240.4",80,9,2194,5,1164,4,1030,85518.916417,0.06800499999371823,136931.10801941284,121167.56121992717
"147.32.84.165",3541,"168.95.5.40",25,3,186,3,186,0,0,85518.932767,8.98864599999797,165.5421739826372,0
"147.32.84.165",2997,"174.37.196.55",80,3,186,3,186,0,0,85520.795125,9.033762999999453,164.715412613779,0
"147.32.84.165",3655,"193.220.38.27",6667,2,124,2,124,0,0,85520.795275,3.009189000003971,329.65692749730607,0
"147.32.84.165",3657,"46.4.36.120",443,6,366,3,186,3,180,85525.911922,1.0311470000015106,1443.0532213135664,1396.5031174002256
"147.32.84.165",3651,"217.163.21.36",80,10,1451,5,701,5,750,85526.943316,0.1393779999925755,40235.9052382638,43048.400754205206
"147.32.84.165",3544,"207.126.147.12",25,3,186,3,186,0,0,85526.989259,8.960453000006964,166.06303275055888,0
"147.32.84.165",2998,"193.23.181.44",80,8,830,5,446,3,384,85527.517192,0.12851100000261795,27764.16026587074,23904.56848003221
"147.32.84.165",3654,"184.82.148.44",80,10,1512,5,594,5,918,85527.580959,0.3042520000017248,15618.631923448525,24137.885699874994
"147.32.84.165",3546,"205.188.103.1",25,3,186,3,186,0,0,85527.681679,8.970166999992216,165.88319927614404,0
"147.32.84.165",2999,"174.128.246.102",80,8,658,6,536,2,122,85534.544577,9.253792000003159,463.3776077956514,105.47027640124901
"147.32.84.165",3670,"41.239.162.145",6667,1,62,1,62,0,0,85534.544705,0,0,0
"147.32.84.165",3668,"46.4.36.120",443,6,366,3,186,3,180,85535.046753,1.030612000002293,1443.802323276548,1397.2280547837559
"147.32.84.165",3664,"184.82.148.43",80,10,1923,5,983,5,940,85535.949585,0.3395730000047479,23158.49611096891,22145.45914985837
"147.32.84.165",3547,"211.48.62.135",25,3,186,3,186,0,0,85536.061831,9.017529000004288,165.01194506824348,0
"147.32.84.165",3000,"193.23.181.44",179,10,781,5,481,5,300,85536.077602,0.19615199998952448,19617.439537733506,12235.409275093663
"147.32.84.165",3665,"217.163.21.35",80,13,5271,7,2266,6,3005,85536.140281,0.23619500000495464,76750.14288879836,101780.308641147
"147.32.84.165",3548,"66.94.236.34",25,3,186,3,186,0,0,85536.186103,8.993854999993346,165.44629638804506,0
"147.32.84.165",3001,"193.23.181.44",179,10,741,5,441,5,300,85539.159959,0.19103200000245124,18468.110054622943,12563.340173212888
"147.32.84.165",3684,"27.255.59.59",6667,6,366,3,186,3,180,85539.159989,1.352666999999201,1100.0490142813264,1064.5635622077352
"147.32.84.165",3681,"46.4.36.120",443,6,366,3,186,3,180,85539.222622,0.968525000003865,1536.3568312579046,1486.7969334753916
"147.32.84.165",3667,"217.163.21.36",80,14,6141,7,810,7,5331,85539.259792,0.18858600000385195,34360.98119620568,226146.16142836105
"147.32.84.165",3549,"205.188.103.1",25,3,186,3,186,0,0,85539.305803,8.98403400000825,165.62715590776187,0
"147.32.84.165",3002,"72.20.15.61",80,3,186,3,186,0,0,85539.305832,8.984026000005542,165.6273033937215,0
"147.32.84.165",3679,"184.82.148.44",80,10,1514,5,596,5,918,85539.863064,0.304640999995172,15651.209128369339,24107.06372456888
"147.32.84.165",3553,"216.32.181.178",25,3,186,3,186,0,0,85539.963663,9.028321999998298,164.8146798486231,0
"147.32.84.165",3003,"193.23.181.44",179,10,745,5,445,5,300,85540.191334,0.21747999999206513,16369.321317499947,11035.497517415695
"147.32.84.165",3680,"195.113.232.88",80,19,17684,12,1087,7,16597,85540.262229,62.86745299999893,138.32276615373854,2111.9990339039546
"147.32.84.165",3558,"208.89.132.27",25,3,186,3,186,0,0,85540.263174,8.929192999989027,166.64439888373212,0
"147.32.84.165",3004,"193.23.181.44",80,8,861,5,477,3,384,85540.512856,0.12354200000117999,30888.280908221917,24866.037460706953
"147.32.84.165",3687,"217.163.21.36",80,10,1451,5,701,5,750,85540.573252,0.13926999999966938,40267.107058327805,43081.78358594273
"147.32.84.165",3559,"64.12.90.65",25,3,186,3,186,0,0,85540.619148,8.974262000003364,165.8075059541879,0
"147.32.84.165",3005,"174.37.196.55",80,3,186,3,186,0,0,85541.768728,9.029309000005014,164.79666384206962,0
"147.32.84.165",3696,"67.197.202.25",6667,6,366,3,186,3,180,85545.981938,1.334736000004341,1114.8272017800978,1078.8650339807398
"147.32.84.165",3692,"46.4.36.120",443,6,366,3,186,3,180,85547.316917,1.0003109999961453,1487.5373758818348,1439.5522992404854
"147.32.84.165",3688,"217.163.21.36",80,14,6141,7,810,7,5331,85547.888191,0.1890549999952782,34275.73986491679,225585.1471850264
"147.32.84.165",3575,"209.191.88.254",25,3,186,3,186,0,0,85547.934152,8.983783999996376,165.63176496681135,0
"147.32.84.165",3006,"193.23.181.44",179,11,810,5,450,6,360,85548.317462,0.19720399999641813,18255.207805447088,14604.166244357672
"147.32.84.165",3691,"217.163.21.35",80,11,3855,6,2225,5,1630,85548.380179,0.22583900000608992,78817.2104885339,57740.248582611355
"147.32.84.165",3578,"209.85.143.27",25,3,186,3,186,0,0,85548.42617,8.993940000000293,165.4447327867377,0
"147.32.84.165",3007,"72.20.15.61",80,3,186,3,186,0,0,85548.590985,9.02947700000368,164.79359768006424,0
"147.32.84.165",3699,"184.82.148.43",80,10,1919,5,979,5,940,85548.59111,0.32315700000617653,24235.8977210777,23270.42273525336
"147.32.84.165",3579,"17.148.17.44",25,3,186,3,186,0,0,85548.698114,9.02242500000284,164.9224016824226,0
"147.32.84.165",3712,"98.126.71.122",80,9,4018,6,645,3,3373,85557.119186,14.110435000009602,365.68681263167923,1912.3435953591536
"147.32.84.165",3008,"174.37.196.55",80,3,186,3,186,0,0,85557.2191,9.033219000004465,164.7253321323511,0
"147.32.84.165",3710,"27.251.19.95",6667,1,62,1,62,0,0,85557.219196,0,0,0
"147.32.84.165",3708,"46.4.36.120",443,6,366,3,186,3,180,85557.29481,1.055265999995754,1410.071015275757,1364.5848534926681
"147.32.84.165",3704,"217.163.21.36",80,10,1451,5,701,5,750,85558.350281,0.13994099998672027,40074.03120266521,42875.2117004264
"147.32.84.165",3580,"64.12.139.193",25,3,186,3,186,0,0,85558.396168,8.960201999987476,166.0676846350205,0
"147.32.84.165",3719,"95.100.248.96",80,11,4467,6,1260,5,3207,85560.32937,10.900470999986283,924.7306836569434,2353.65976387922
"147.32.84.165",3009,"193.23.181.44",80,8,810,5,424,3,386,85560.33004,0.1340409999975236,25305.690050526828,23037.727262979613
"147.32.84.165",3728,"59.48.7.167",6667,6,366,3,186,3,180,85560.396787,1.8649489999952493,797.877046505717,772.1390772635971
"147.32.84.165",3724,"46.4.36.120",443,6,366,3,186,3,180,85561.031333,1.0322129999985918,1441.5629332337705,1395.0609031294553
"147.32.84.165",3706,"217.163.21.36",80,10,2277,5,1156,5,1121,85561.232024,0.1397350000042934,66182.41671532438,64178.62382169432
"147.32.84.165",3584,"65.55.37.88",25,3,186,3,186,0,0,85561.277893,8.986808999994537,165.57601257586586,0
"147.32.84.165",3730,"195.113.232.81",80,8,2617,5,762,3,1855,85561.633362,9.596676000001025,635.2199449058558,1546.368763517536
"147.32.84.165",3010,"174.37.196.55",80,7,559,4,377,3,182,85561.634239,0.24205499999516178,12459.978104398935,6015.161843502934
"147.32.84.165",3707,"184.82.148.44",80,10,1513,5,596,5,917,85561.6343,0.3407829999923706,13991.308252191997,21526.895414865874
"147.32.84.165",3585,"209.191.88.254",25,3,186,3,186,0,0,85561.746842,8.919598000007682,166.823661783717,0
"147.32.84.165",3732,"74.125.232.217",80,8,1293,5,578,3,715,85561.746872,9.483347000001231,487.59156445497564,603.1625754071065
"147.32.84.165",3013,"193.23.181.44",80,8,820,5,436,3,384,85561.755092,0.14212099999713246,24542.46733466818,21615.384074570142
"147.32.84.165",3716,"184.82.148.43",80,10,1925,5,987,5,938,85561.825599,0.3099870000005467,25472.03592404222,24207.466764692603
"147.32.84.165",3586,"205.188.103.1",25,3,186,3,186,0,0,85561.92636,8.839673000009498,168.3320186163449,0
"147.32.84.165",3733,"77.238.175.247",80,9,1636,5,638,4,998,85562.063759,0.15160399999876972,33666.65787209717,52663.51811340592
"147.32.84.165",3014,"193.23.181.44",179,11,804,5,444,6,360,85562.10969,0.20661400000972208,17191.477827411807,13939.036076279845
"147.32.84.165",3721,"217.163.21.35",80,11,3855,6,2225,5,1630,85562.176699,0.304640999995172,58429.430051378826,42804.481341010105
"147.32.84.165",3589,"204.89.9.25",25,3,186,3,186,0,0,85562.222627,8.844458000006853,168.24094817329078,0
"147.32.84.165",3735,"68.67.185.209",80,8,1365,5,625,3,740,85562.261975,8.968420000004699,557.5118025245674,660.0939741890878
"147.32.84.165",3015,"193.23.181.44",179,10,781,5,481,5,300,85562.2912,0.26142799999797717,14719.157856196636,9180.347935257778
"147.32.84.165",3731,"217.163.21.35",80,13,5847,7,2740,6,3107,85562.291259,0.19649199998821132,111556.70460535343,126498.78876234785
"147.32.84.165",3590,"205.188.190.1",25,3,186,3,186,0,0,85562.291309,8.877498000001651,167.61479416832572,0
"147.32.84.165",3737,"64.236.79.229",80,9,1494,5,780,4,714,85562.838108,0.368916999999783,16914.373693821835,15483.157458190757
"147.32.84.165",3016,"174.37.196.55",80,9,741,6,559,3,182,85562.955929,11.002456999995047,406.4546673531206,132.33407774287647
"147.32.84.165",3755,"61.89.186.155",6667,2,124,2,124,0,0,85567.054624,3.010013999999501,329.5665734445636,0
"147.32.84.165",3752,"46.4.36.120",443,6,366,3,186,3,180,85568.960448,1.031490000008489,1442.5733647323327,1396.038740063548
"147.32.84.165",3739,"217.163.21.36",80,14,6137,7,809,7,5328,85569.463113,0.18971500000043306,34114.3293887422,224673.85288407718
"147.32.84.165",3591,"205.188.103.1",25,3,186,3,186,0,0,85569.508925,10.080866999996942,147.60635171562637,0
"147.32.84.165",3738,"64.236.79.229",80,9,1664,5,964,4,700,85569.509096,0.3650120000093011,21128.07250118759,15341.961359783521
"147.32.84.165",3017,"193.23.181.44",179,10,751,5,451,5,300,85569.626773,0.19331100000999868,18664.22500433696,12415.22727561217
"147.32.84.165",3741,"184.82.148.44",80,10,1512,5,594,5,918,85569.689473,0.3048009999911301,15590.50003162157,24094.409139778792
"147.32.84.165",3594,"209.191.88.254",25,3,186,3,186,0,0,85569.763236,9.832978999998886,151.32748681759298,0
"147.32.84.165",3740,"64.236.79.229",80,9,1625,5,968,4,657,85569.789855,0.37858600000618026,20455.06172936554,13883.239210943348
"147.32.84.165",3018,"193.23.181.44",80,8,860,5,474,3,386,85569.789913,0.12195499999506865,31093.43610473808,25320.81505575717
"147.32.84.165",3759,"212.117.171.138",65500,219,170103,128,163267,91,6836,85569.789962,73.78573800000595,17701.74068056207,741.1730434951479
"147.32.84.165",3747,"217.163.21.36",80,10,2277,5,1156,5,1121,85569.790017,0.13912100000015926,66474.50780248427,64461.87132057514
"147.32.84.165",3599,"64.12.90.65",25,3,186,3,186,0,0,85569.835886,9.763504000002285,152.40430075100616,0
"147.32.84.165",3743,"77.238.167.32",80,8,1647,5,695,3,952,85569.992165,0.15129300000262447,36749.88267734496,50339.40763860777
"147.32.84.165",3019,"174.37.196.55",80,3,186,3,186,0,0,85570.037964,9.689004999992903,153.5761412034662,0
"147.32.84.165",3768,"65.55.16.187",443,128,165001,67,5392,61,159609,85570.038024,10.02626300000702,4302.300867229375,127352.73351587784
"147.32.84.165",3748,"173.241.240.4",80,9,2195,5,1165,4,1030,85570.200017,0.06536800001049414,142577.40788311977,126055.56233443206
"147.32.84.165",3600,"128.241.52.1",25,3,186,3,186,0,0,85570.216475,9.513709999999264,156.40586059487993,0
"147.32.84.165",3022,"193.23.181.44",179,10,772,5,472,5,300,85573.830568,2.807455000001937,1344.9903916527228,854.8667743555441
"147.32.84.165",3772,"46.4.36.120",443,6,366,3,186,3,180,85575.218995,3.5369019999925513,420.7071612397329,407.13596249006406
"147.32.84.165",3761,"217.163.21.36",80,10,1448,5,699,5,749,85579.723783,0.1387749999994412,40295.44226281763,43177.80580093048
"147.32.84.165",3610,"205.188.103.1",25,3,186,3,186,0,0,85579.733386,8.596856999996817,173.08651289657965,0
"147.32.84.165",3778,"173.192.170.88",80,7,860,4,423,3,437,85579.736617,5.813576000000467,582.0857936663645,601.3510445205703
"147.32.84.165",3024,"174.37.196.55",80,3,186,3,186,0,0,85579.769571,8.96174900000915,166.03901760677306,0
"147.32.84.165",3777,"62.113.176.118",6667,1,62,1,62,0,0,85579.769603,0,0,0
"147.32.84.165",3786,"46.4.36.120",443,6,366,3,186,3,180,85579.937388,0.9961379999876954,1493.7689356478522,1445.5828409495346
"147.32.84.165",3766,"217.163.21.35",80,13,5847,7,2740,6,3107,85580.93379,0.1666840000107186,131506.3233339159,149120.49145929806
"147.32.84.165",3611,"205.188.190.1",25,3,186,3,186,0,0,85580.979943,8.956955999994534,166.12786754796028,0
"147.32.84.165",3025,"193.23.181.44",80,10,930,6,484,4,446,85580.979975,0.13008700001228135,29764.695931449332,27427.798316996697
"147.32.84.165",3767,"217.163.21.36",80,14,6141,7,810,7,5331,85581.042306,0.1887799999967683,34325.670092758395,225913.7620549321
"147.32.84.165",3612,"64.18.6.14",25,3,186,3,186,0,0,85581.088328,8.948692999998457,166.28126587874414,0
"147.32.84.165",3026,"67.19.72.206",80,3,186,3,186,0,0,85582.109393,9.032255999991321,164.74289479853425,0
"147.32.84.165",3791,"94.100.176.20",25,3,186,3,186,0,0,85582.209679,9.031880999988061,164.74973485611324,0
"147.32.84.165",3769,"184.82.148.43",80,10,1917,5,979,5,938,85582.812194,0.3420509999996284,22897.17030503787,21938.248974591952
"147.32.84.165",3620,"209.191.88.254",25,3,186,3,186,0,0,85582.924837,9.018731000003754,164.9899525775168,0
"147.32.84.165",3027,"67.19.72.206",80,3,186,3,186,0,0,85582.924912,9.01870699999563,164.99039163826046,0
"147.32.84.165",3792,"46.4.36.120",443,6,366,3,186,3,180,85582.924981,1.019295999998576,1459.8310991135832,1412.7397733357257
"147.32.84.165",3787,"217.163.21.35",80,11,3851,6,2223,5,1628,85583.112886,0.25112000000081025,70818.73208005185,51863.650844050564
"147.32.84.165",3622,"209.85.143.27",25,3,186,3,186,0,0,85583.158659,8.98621900001308,165.58688364904464,0
"147.32.84.165",3028,"174.128.246.102",80,7,562,4,380,3,182,85583.213361,0.3191579999984242,9525.06282159623,4562.003772448721
"147.32.84.165",3789,"173.241.240.4",80,9,2195,5,1165,4,1030,85583.213501,0.0732819999975618,127179.93504967236,112442.34600958158
"147.32.84.165",3623,"66.147.244.209",25,3,186,3,186,0,0,85583.229828,9.015714000008302,165.045164476006,0
"147.32.84.165",3029,"174.128.246.102",80,8,635,6,513,2,122,85583.944594,9.322214999992866,440.23872008992936,104.69614785764402
"147.32.84.165",3790,"217.163.21.36",80,10,1451,5,701,5,750,85583.944636,0.14094500000646804,39788.570007752285,42569.79672726707
"147.32.84.165",3625,"168.95.5.66",25,3,186,3,186,0,0,85583.99202,8.956366999991587,166.138792660171,0
"147.32.84.165",3030,"174.37.196.55",80,3,186,3,186,0,0,85590.739059,9.032107000006363,164.74561251311036,0
"147.32.84.165",3802,"116.90.164.27",6667,1,62,1,62,0,0,85590.739188,0,0,0
"147.32.84.165",3801,"46.4.36.120",443,6,366,3,186,3,180,85590.739248,1.0314280000020517,1442.6600790331852,1396.122657128889
"147.32.84.165",3794,"184.82.148.44",80,10,1511,5,594,5,917,85591.141788,0.30426200000511017,15618.11859489581,24110.799244982252
"147.32.84.165",3808,"174.133.57.141",80,9,1177,5,654,4,523,85591.242222,0.5627689999964787,9296.887355260751,7434.666799390478
"147.32.84.165",3630,"209.191.88.254",25,3,186,3,186,0,0,85591.403774,8.969270999994478,165.89977044967378,0
"147.32.84.165",3031,"193.23.181.44",80,8,841,5,455,3,386,85591.770894,0.12149099999805912,29961.067075406005,25417.520639794984
"147.32.84.165",3795,"217.163.21.36",80,10,2274,5,1154,5,1120,85591.831199,0.1392820000037318,66282.79318040123,64329.92059103066
"147.32.84.165",3634,"216.32.180.22",25,3,186,3,186,0,0,85591.876987,8.997517000010703,165.37895955053267,0
"147.32.84.165",3032,"72.20.15.61",80,3,186,3,186,0,0,85592.144756,9.031256000002031,164.76113621401777,0
"147.32.84.165",3819,"115.240.73.24",6667,1,62,1,62,0,0,85601.978892,0,0,0
"147.32.84.165",3815,"46.4.36.120",443,6,366,3,186,3,180,85602.179587,1.0323689999931958,1441.3451004532365,1394.8500972128095
"147.32.84.165",3797,"217.163.21.35",80,11,3855,6,2225,5,1630,85603.083333,0.22800799999095034,78067.43623340622,57190.975757506574
"147.32.84.165",3635,"205.188.190.1",25,3,186,3,186,0,0,85603.129335,8.983232999991742,165.64192423834135,0
"147.32.84.165",3033,"67.19.72.206",80,3,186,3,186,0,0,85603.18422,9.028325999999652,164.81460682745146,0
"147.32.84.165",3829,"74.125.93.27",25,3,186,3,186,0,0,85603.212187,9.000381999998353,165.32631614972257,0
"147.32.84.165",3810,"184.82.148.43",80,10,1927,5,987,5,940,85604.086946,0.3260830000072019,24214.69380441669,23061.613147063515
"147.32.84.165",3641,"209.191.88.254",25,3,186,3,186,0,0,85604.187063,9.028765999988536,164.80657489649076,0
"147.32.84.165",3034,"174.128.246.102",80,6,544,4,422,2,122,85604.187202,0.3286229999939678,10273.170167827479,2969.9686267178968
"147.32.84.165",3811,"217.163.21.36",80,13,6077,6,749,7,5328,85604.18727,0.1880210000090301,31868.780613400744,226698.08158638075
"147.32.84.165",3642,"80.237.177.89",25,3,186,3,186,0,0,85604.194663,9.021213999993051,164.9445407238035,0
"147.32.84.165",3035,"174.37.196.55",80,3,186,3,186,0,0,85604.233235,8.98269099999743,165.65191878474118,0
"147.32.84.165",3832,"46.4.36.120",443,6,366,3,186,3,180,85604.233315,0.9844259999954375,1511.5407354203328,1462.7813568583865
"147.32.84.165",3814,"217.163.21.35",80,13,5853,7,2738,6,3115,85604.888828,0.160531000001356,136447.1659667913,155234.81445820123
"147.32.84.165",3645,"69.175.13.98",7691,7,424,4,242,3,182,85604.934773,0.4310890000051586,4490.951984339274,3377.492814668379
"147.32.84.165",3036,"193.23.181.44",179,10,781,5,481,5,300,85605.06678,0.20469600000069477,18798.608668400648,11724.703951185436
"147.32.84.165",3830,"217.163.21.36",80,10,2277,5,1156,5,1121,85605.133813,0.13945700001204386,66314.34778606538,64306.56043960146
"147.32.84.165",3656,"209.191.88.254",25,3,186,3,186,0,0,85605.17961,8.940062999987276,166.44178010849785,0
"147.32.84.165",3037,"72.20.15.61",80,3,186,3,186,0,0,85605.179668,8.940130000002682,166.44053274388108,0
"147.32.84.165",3833,"184.82.148.44",80,10,1513,5,596,5,917,85605.179722,0.34125399999902584,13971.997397872585,21497.183915854297
"147.32.84.165",3658,"184.154.10.50",8339,7,424,4,242,3,182,85605.217992,0.43499599999631755,4450.615637882623,3347.157215267096
"147.32.84.165",3038,"174.128.246.102",80,7,602,4,420,3,182,85605.292354,0.3351819999952568,10024.404651942968,4343.90868250862
"147.32.84.165",3841,"178.122.100.224",6667,2,124,2,124,0,0,85605.292413,3.007754999998724,329.8140972254791,0
"147.32.84.165",3834,"217.163.21.36",80,10,1448,5,699,5,749,85605.355987,0.14069800000288524,39744.70141640483,42587.670044187726
"147.32.84.165",3660,"174.37.108.140",25,3,186,3,186,0,0,85605.402103,9.019828000004054,164.96988634365658,0
"147.32.84.165",3039,"174.37.196.55",80,3,186,3,186,0,0,85612.212417,9.03467599999567,164.69876728293445,0
"147.32.84.165",3845,"46.4.36.120",443,6,366,3,186,3,180,85612.212521,1.0306510000082199,1443.7476895555649,1397.1751834408694
"147.32.84.165",3838,"173.241.240.4",80,9,2194,5,1164,4,1030,85612.313025,0.06780400000570808,137337.03025213955,121526.75357362864
"147.32.84.165",3661,"209.191.88.254",25,3,186,3,186,0,0,85612.329446,9.018446999994921,164.99514827783963,0
"147.32.84.165",3040,"174.128.246.102",80,3,186,3,186,0,0,85612.814481,9.034819000007701,164.69616048741338,0
"147.32.84.165",3840,"217.163.21.35",80,13,5857,7,2740,6,3117,85612.814583,0.15680799999972805,139788.7862866564,159022.49885237517
"147.32.84.165",3662,"65.55.92.152",25,3,186,3,186,0,0,85612.860457,8.988941999996314,165.53672278679852,0
"147.32.84.165",3041,"67.19.72.206",80,3,186,3,186,0,0,85613.116352,9.034067000000505,164.709869873659,0
"147.32.84.165",3842,"217.163.21.36",80,14,6137,7,809,7,5328,85613.116481,0.1987619999999879,32561.556031839056,214447.42958916994
"147.32.84.165",3663,"76.225.135.7",25,3,186,3,186,0,0,85613.16238,8.988099000009242,165.552248589882,0
"147.32.84.165",3042,"67.19.72.206",80,3,186,3,186,0,0,85613.243281,9.008126999993692,165.18417202610954,0
"147.32.84.165",3843,"217.163.21.35",80,13,5269,7,2283,6,2986,85613.243312,0.2605069999990519,70109.44043755626,91698.11175932677
"147.32.84.165",3671,"64.12.139.193",25,3,186,3,186,0,0,85613.28922,8.962231999990763,166.0300692954092,0
"147.32.84.165",3043,"174.128.246.102",80,7,628,4,446,3,182,85622.25123,0.3372910000034608,10578.402625517403,4316.747259740286
"147.32.84.165",3860,"202.129.54.51",6667,1,62,1,62,0,0,85622.251357,0,0,0
"147.32.84.165",3857,"46.4.36.120",443,6,366,3,186,3,180,85624.160395,1.029569000005722,1445.264960378304,1398.64351004352
"147.32.84.165",3853,"184.82.148.43",80,10,1923,5,983,5,940,85624.260353,0.34089599999424536,23068.619168698817,22059.51375236713
"147.32.84.165",3672,"195.50.106.142",25,3,186,3,186,0,0,85624.26046,8.932048999995459,166.5911147599791,0
"147.32.84.165",3044,"72.20.15.61",80,3,186,3,186,0,0,85624.373136,8.919782000011764,166.82022049395798,0
"147.32.84.165",3871,"74.125.39.27",25,3,186,3,186,0,0,85625.190177,8.907363000005716,167.05280788478532,0
"147.32.84.165",3854,"173.241.240.4",80,9,2195,5,1165,4,1030,85625.263312,0.06670500000473112,139719.66118490323,123528.97083300457
"147.32.84.165",3674,"209.191.88.254",25,3,186,3,186,0,0,85625.27963,8.918609000000288,166.842161148667,0
"147.32.84.165",3047,"193.23.181.44",80,8,864,5,480,3,384,85625.279689,0.12846300000092015,29891.87548144209,23913.50038515367
"147.32.84.165",3866,"212.117.171.138",65500,15,929,9,546,6,383,85625.343485,231.749358999994,18.84794857188845,13.221180042185486
"147.32.84.165",3856,"217.163.21.36",80,10,1448,5,699,5,749,85625.343544,0.13928999999188818,40146.457034429324,43018.16354619108
"147.32.84.165",3675,"64.12.90.65",25,3,186,3,186,0,0,85625.389399,8.908715999990818,167.0274369506822,0
"147.32.84.165",3048,"193.23.181.44",80,8,861,5,477,3,384,85626.467095,0.12138799999956973,31436.38580430954,25307.27913806051
"147.32.84.165",3875,"61.28.22.201",6667,2,124,2,124,0,0,85626.527462,2.95133199999691,336.11941997750125,0
"147.32.84.165",3880,"46.4.36.120",443,6,366,3,186,3,180,85632.290009,1.030345999999554,1444.175063522976,1397.588771151267
"147.32.84.165",3873,"184.82.148.44",80,10,1513,5,596,5,917,85633.29295,0.3253039999981411,14657.059243130261,22551.21363414505
"147.32.84.165",3676,"216.178.66.140",25,3,186,3,186,0,0,85633.320571,9.789923999996972,151.9930083216642,0
"147.32.84.165",3049,"174.37.196.55",80,3,186,3,186,0,0,85633.400768,9.716152999986662,153.14703257575738,0
"147.32.84.165",3877,"65.55.16.187",443,140,165661,70,5572,70,160089,85633.79512,9.920561000006273,4493.294280431501,129096.73152548431
"147.32.84.165",3878,"217.163.21.35",80,11,3857,6,2219,5,1638,85633.957004,0.22017300000879914,80627.50654844394,59516.83448686398
"147.32.84.165",3677,"209.191.88.254",25,3,186,3,186,0,0,85634.002997,9.402695999990101,158.25248418129934,0
"147.32.84.165",3050,"193.23.181.44",80,8,865,5,479,3,386,85634.097609,0.12322100000164937,31098.595206569553,25060.663360617636
"147.32.84.165",3889,"184.82.148.43",80,10,1929,5,991,5,938,85634.158824,0.40389699999650475,19628.766740205072,18578.99414965929
"147.32.84.165",3682,"209.191.88.254",25,3,186,3,186,0,0,85634.198375,9.210521999993944,161.55436141414987,0
"147.32.84.165",3045,"67.19.72.206",80,3,186,3,186,0,0,85634.198433,9.21368899999652,161.49883070728367,0
"147.32.84.165",3892,"217.163.21.36",80,14,6137,7,809,7,5328,85634.271412,0.29542500000388827,21907.42151109357,144280.2741793653
"147.32.84.165",3683,"205.178.149.7",25,3,186,3,186,0,0,85634.418265,8.997057999993558,165.3873966357742,0
"147.32.84.165",3051,"174.37.196.55",80,3,186,3,186,0,0,85643.104093,8.249400000000605,180.3767546730539,0
"147.32.84.165",3903,"88.135.194.91",6667,3,186,3,186,0,0,85643.107324,8.246268000002601,180.44526323902286,0
"147.32.84.165",3899,"46.4.36.120",443,6,366,3,186,3,180,85645.233537,1.0308350000123028,1443.4899862560362,1396.9257931510028
"147.32.84.165",3896,"217.163.21.36",80,10,2274,5,1154,5,1120,85645.334495,0.13985300000058487,66012.16992099842,64067.27063389794
"147.32.84.165",3685,"205.188.190.1",25,3,186,3,186,0,0,85645.38047,8.98384800000349,165.63058502319072,0
"147.32.84.165",3052,"193.23.181.44",179,10,781,5,481,5,300,85646.137329,0.21224500000244007,18129.991283449606,11307.68687117439
"147.32.84.165",3912,"85.29.156.118",6667,2,124,2,124,0,0,85646.206301,2.9406980000057956,337.3348776372293,0
"147.32.84.165",3915,"66.111.4.71",25,3,186,3,186,0,0,85646.264602,9.002474000008078,165.2878975266871,0
"147.32.84.165",3900,"184.82.148.44",80,10,1512,5,594,5,918,85646.336999,0.3270069999998668,14531.799013482694,22458.23483901871
"147.32.84.165",3695,"209.191.88.254",25,3,186,3,186,0,0,85646.444955,9.022907000005944,164.91359159514997,0
"147.32.84.165",3053,"174.37.196.55",80,3,186,3,186,0,0,85646.445017,9.022898999988683,164.91373781329773,0
"147.32.84.165",3901,"217.163.21.36",80,10,1448,5,699,5,749,85646.445069,0.13891000000876375,40256.28104274137,43135.84334908911
"147.32.84.165",3698,"64.12.90.65",25,3,186,3,186,0,0,85646.490881,8.977095999987796,165.7551618031068,0
"147.32.84.165",3054,"174.128.246.102",80,9,745,6,561,3,184,85654.364442,6.401400999995531,701.0965255891848,229.94966258183604
"147.32.84.165",3921,"46.4.36.120",443,6,366,3,186,3,180,85654.464185,1.0310650000028545,1443.1679864954008,1396.6141804794202
"147.32.84.165",3909,"184.82.148.43",80,10,1927,5,987,5,940,85655.066545,0.35824200000206474,22040.96672069297,20991.39687685045
"147.32.84.165",3700,"205.188.103.1",25,3,186,3,186,0,0,85655.18495,8.91347400000086,166.9382779374076,0
"147.32.84.165",3055,"72.20.15.61",80,3,186,3,186,0,0,85655.267214,8.931347999998252,166.60419009541351,0
"147.32.84.165",3933,"46.34.171.217",6667,6,366,3,186,3,180,85655.367791,1.800757999997586,826.3186946841246,799.6632529201205
"147.32.84.165",3914,"217.163.21.35",80,13,5835,7,2734,6,3101,85655.495468,0.15839400001277681,138086.03860143502,156622.09425861377
"147.32.84.165",3701,"65.55.88.22",25,3,186,3,186,0,0,85655.54141,8.857778999998118,167.98793467305023,0
"147.32.84.165",3057,"67.19.72.206",80,3,186,3,186,0,0,85657.168799,8.835316999990027,168.4150098974015,0
"147.32.84.165",3936,"46.4.36.120",443,6,366,3,186,3,180,85657.542763,0.9630889999971259,1545.0285487680167,1495.1889181625968
"147.32.84.165",3917,"217.163.21.35",80,11,3847,6,2219,5,1628,85658.506166,0.22400499999639578,79248.23106754594,58141.55934112879
"147.32.84.165",3702,"68.6.19.3",25,3,186,3,186,0,0,85658.552119,8.85645900000236,168.01297222734317,0
"147.32.84.165",3058,"67.19.72.206",80,3,186,3,186,0,0,85661.890286,8.929201000006287,166.64424958055622,0
"147.32.84.165",3944,"93.178.250.214",6667,6,366,3,186,3,180,85661.890413,1.072147999992012,1387.8680928482693,1343.0981543692928
"147.32.84.165",3943,"46.4.36.120",443,6,366,3,186,3,180,85662.962865,0.9618489999993471,1547.020374300966,1497.1164912589995
"147.32.84.165",3918,"217.163.21.36",80,14,6141,7,810,7,5331,85663.396371,0.18752300000051036,34555.76115987033,227428.10215218362
"147.32.84.165",3703,"209.191.88.254",25,3,186,3,186,0,0,85663.442355,8.98376499999722,165.63211526575554,0
"147.32.84.165",3056,"193.23.181.44",179,10,780,5,480,5,300,85663.924959,0.20366800000192598,18854.21372019015,11783.883575118844
"147.32.84.165",3932,"184.82.148.44",80,10,1513,5,596,5,917,85663.991703,0.3253969999932451,14652.870186568956,22544.768391080088
"147.32.84.165",3709,"205.188.190.1",25,3,186,3,186,0,0,85664.098516,9.028854000003776,164.80496860392003,0
"147.32.84.165",3060,"193.23.181.44",179,10,781,5,481,5,300,85664.098572,0.18573099999048281,20718.13536887853,12921.913951483491
"147.32.84.165",3934,"173.241.240.4",80,9,2194,5,1164,4,1030,85664.098624,0.06585899999481626,141392.97591419463,125115.77765603134
"147.32.84.165",3713,"205.188.103.1",25,3,186,3,186,0,0,85664.115217,9.012275000000955,165.10814417001728,0
"147.32.84.165",3061,"174.128.246.102",80,7,576,5,454,2,122,85664.115252,3.312521999992896,1096.445548137579,294.6395525832261
"147.32.84.165",3956,"217.199.111.74",6667,2,124,2,124,0,0,85666.305071,3.009816999998293,329.58814439567675,0
"147.32.84.165",3955,"46.4.36.120",443,6,366,3,186,3,180,85667.209143,1.029725000000326,1445.0460074287105,1398.4316200923006
"147.32.84.165",3942,"217.163.21.36",80,10,2274,5,1154,5,1120,85667.267686,0.13981799999601208,66028.69444751975,64083.308302618825
"147.32.84.165",3714,"216.82.249.99",25,3,186,3,186,0,0,85667.313543,9.024820000006002,164.87863469842173,0
"147.32.84.165",3062,"174.37.196.55",80,3,186,3,186,0,0,85667.408688,9.029751000009128,164.78859716048603,0
"147.32.84.165",3959,"216.157.130.15",25,3,186,3,186,0,0,85668.239105,9.002129999993485,165.29421370287665,0
"147.32.84.165",3950,"184.82.148.43",80,10,1929,5,991,5,938,85676.137832,0.32273900001018774,24564.74116778493,23250.986090194012
"147.32.84.165",3715,"209.191.88.254",25,3,186,3,186,0,0,85676.238012,9.029712999996264,164.7892906452969,0
"147.32.84.165",3064,"174.128.246.102",80,3,186,3,186,0,0,85676.238138,9.029687999995076,164.78974688835444,0
"147.32.84.165",4029,"184.164.142.139",6667,6,366,3,186,3,180,85676.244462,1.3581429999903776,1095.6136430482964,1060.2712674660934
"147.32.84.165",3966,"46.4.36.120",443,6,366,3,186,3,180,85676.438574,1.0314170000056038,1442.6754649108125,1396.137546687883
"147.32.84.165",3952,"217.163.21.36",80,10,1451,5,701,5,750,85677.4702,0.1393030000035651,40257.56803411612,43071.57778257787
"147.32.84.165",3717,"64.12.139.193",25,3,186,3,186,0,0,85677.516166,8.955914000005578,166.14719614313773,0
"147.32.84.165",3063,"72.20.15.61",80,3,186,3,186,0,0,85677.602822,8.969666999997571,165.89244617446812,0
"147.32.84.165",3962,"217.163.21.35",80,13,5835,7,2734,6,3101,85678.043757,0.20796999998856336,105169.01476752791,119286.4355501478
"147.32.84.165",3718,"65.54.188.72",25,3,186,3,186,0,0,85678.089639,8.984951000005822,165.61025207583612,0
"147.32.84.165",3065,"67.19.72.206",80,3,186,3,186,0,0,85679.448023,9.030816999991657,164.7691454717081,0
"147.32.84.165",4151,"89.215.49.24",6667,2,124,2,124,0,0,85682.959489,3.0117949999985285,329.3716869841688,0
"147.32.84.165",4101,"46.4.36.120",443,6,366,3,186,3,180,85684.46506,1.0319460000027902,1441.9359152474806,1395.421853465304
"147.32.84.165",3963,"217.163.21.36",80,13,6077,6,749,7,5328,85685.497226,0.19567999998980667,30621.422732584495,217825.0204528841
"147.32.84.165",3720,"209.191.88.254",25,3,186,3,186,0,0,85685.543202,8.955830000006245,166.1487544983505,0
"147.32.84.165",3066,"174.37.196.55",80,3,186,3,186,0,0,85688.378565,8.930525999996462,166.61952498661216,0
"147.32.84.165",4208,"46.4.36.120",443,6,366,3,186,3,180,85688.378692,1.0301970000000438,1444.3839382175804,1397.7909079524973
"147.32.84.165",4073,"184.82.148.44",80,10,1512,5,594,5,918,85688.478901,0.32287499999802094,14717.770034933417,22745.644599442556
"147.32.84.165",3722,"65.55.37.120",25,3,186,3,186,0,0,85688.585514,8.924382999990485,166.73421568769365,0
"147.32.84.165",3067,"193.23.181.44",179,10,781,5,481,5,300,85689.281391,0.19546499999705702,19686.388867868605,12278.413015302664
"147.32.84.165",4082,"217.163.21.35",80,11,3851,6,2221,5,1630,85689.343166,0.2829529999871738,62794.881131514485,46085.39227571752
"147.32.84.165",3723,"218.106.61.139",25,3,186,3,186,0,0,85689.38908,8.923956000013277,166.74219370846137,0
"147.32.84.165",3068,"193.23.181.44",80,10,952,6,506,4,446,85689.418286,0.14085999999952037,28737.753798195256,25330.115007895423
"147.32.84.165",4100,"173.241.240.4",80,9,2194,5,1164,4,1030,85689.421502,0.0760290000034729,122479.58015460732,108379.6972158467
"147.32.84.165",3725,"205.188.103.1",25,3,186,3,186,0,0,85689.437839,8.875317999991239,167.65596455264688,0
"147.32.84.165",3069,"174.37.196.55",80,3,186,3,186,0,0,85697.208927,9.029446000000462,164.794163451437,0
"147.32.84.165",4233,"190.37.39.215",6667,1,62,1,62,0,0,85697.509775,0,0,0
"147.32.84.165",4228,"46.4.36.120",443,6,366,3,186,3,180,85698.413532,1.0309149999957299,1443.3779700617058,1396.8173903822958
"147.32.84.165",4193,"184.82.148.43",80,10,1927,5,987,5,940,85698.514177,0.3406889999896521,23176.56278964049,22072.916942514752
"147.32.84.165",3726,"216.17.3.48",25,3,186,3,186,0,0,85698.626749,9.016428000002634,165.03209474966863,0
"147.32.84.165",3070,"72.20.15.61",80,8,677,4,435,4,242,85699.015627,0.36959299999580253,9415.762744531206,5238.194446382879
"147.32.84.165",4203,"217.163.21.36",80,10,1448,5,699,5,749,85699.200412,0.1390359999932116,40219.799190663056,43096.75192247014
"147.32.84.165",3744,"64.12.139.193",25,3,186,3,186,0,0,85699.246387,8.99833599998965,165.36390728260332,0
"147.32.84.165",3071,"67.19.72.206",80,3,186,3,186,0,0,85699.44468,9.00141500000609,165.30734334535106,0
"147.32.84.165",4221,"217.163.21.36",80,13,6081,6,750,7,5331,85699.444737,0.18742299999576062,32013.146732982164,227549.44697803722
"147.32.84.165",3750,"68.6.19.3",25,3,186,3,186,0,0,85699.490736,8.955478999996558,166.15526651344635,0
"147.32.84.165",3072,"174.128.246.102",80,3,186,3,186,0,0,85700.420283,9.028078000003006,164.81913426085868,0
"147.32.84.165",4278,"119.154.70.142",6667,1,62,1,62,0,0,85706.439476,0,0,0
"147.32.84.165",4277,"46.4.36.120",443,6,366,3,186,3,180,85707.542901,1.030919000011636,1443.372369684917,1396.811970662823
"147.32.84.165",4261,"184.82.148.44",80,10,1514,5,596,5,918,85708.574055,0.3212479999929201,14842.115748907638,22860.842713921495
"147.32.84.165",3751,"202.2.82.207",25,3,186,3,186,0,0,85708.680059,8.99592999999004,165.40813456770422,0
"147.32.84.165",3073,"72.20.15.61",80,3,186,3,186,0,0,85709.549067,9.029664999994566,164.79016663418804,0
"147.32.84.165",4448,"46.4.36.120",443,6,366,3,186,3,180,85710.351614,1.0302599999995437,1444.295614699842,1397.7054335804921
"147.32.84.165",4270,"217.163.21.36",80,10,2277,5,1156,5,1121,85710.351748,0.139844000004814,66130.83149567837,64128.60043828326
"147.32.84.165",3754,"217.72.192.188",25,3,186,3,186,0,0,85710.397909,8.983626999994158,165.6346595869316,0
"147.32.84.165",3074,"174.37.196.55",80,3,186,3,186,0,0,85711.382112,9.003480999992462,165.26941079802864,0
"147.32.84.165",4452,"77.89.69.181",6667,2,124,2,124,0,0,85711.382172,2.9830179999989923,332.54911636481415,0
"147.32.84.165",4456,"46.4.36.120",443,6,366,3,186,3,180,85717.575734,1.0304860000032932,1443.9788604554014,1397.3988972149045
"147.32.84.165",4272,"217.163.21.35",80,11,3847,6,2219,5,1628,85718.277751,0.23020499999984168,77113.8767620695,56575.66082408704
"147.32.84.165",3756,"209.191.88.254",25,3,186,3,186,0,0,85718.323609,8.88253899999836,167.51966977012708,0
"147.32.84.165",3075,"174.128.246.102",80,3,186,3,186,0,0,85718.606434,8.900949000002583,167.17318569060086,0
"147.32.84.165",4273,"217.163.21.36",80,10,1451,5,701,5,750,85718.60651,0.1392139999952633,40283.304841401085,43099.113596363495
"147.32.84.165",3757,"205.188.103.1",25,3,186,3,186,0,0,85718.652382,8.85512700000254,168.0382449624464,0
"147.32.84.165",3076,"174.37.196.55",80,7,599,4,417,3,182,85719.682005,0.24239400000078604,13762.716898888511,6006.749341960934
"147.32.84.165",4464,"46.4.36.120",443,6,366,3,186,3,180,85719.803192,1.0100019999954384,1473.264409384061,1425.7397510168332
"147.32.84.165",4443,"184.82.148.43",80,10,1929,5,991,5,938,85720.284316,0.32314199999382254,24534.1057496443,23221.98909502155
"147.32.84.165",3760,"207.115.36.22",25,3,186,3,186,0,0,85720.39107,8.924247999995714,166.7367379302676,0
"147.32.84.165",3077,"174.37.196.55",80,3,186,3,186,0,0,85720.485231,8.930976999996346,166.61111096810671,0
"147.32.84.165",4450,"217.163.21.36",80,13,6081,6,750,7,5331,85720.485356,0.1864439999917522,32181.24477197134,228744.28783917226
"147.32.84.165",3771,"210.87.250.90",25,3,186,3,186,0,0,85720.531342,8.884987999990699,167.4734957437824,0
"147.32.84.165",3078,"67.19.72.206",80,4,246,3,186,1,60,85720.813415,9.056448000003002,164.3028260085529,53.000911615662226
"147.32.84.165",4468,"218.248.255.243",6667,2,124,2,124,0,0,85721.488924,3.008935999998357,329.68464600129136,0
"147.32.84.165",4473,"46.4.36.120",443,6,366,3,186,3,180,85727.607971,1.031392999997479,1442.7090352597286,1396.170034122318
"147.32.84.165",4451,"217.163.21.35",80,13,5839,7,2736,6,3103,85728.639641,0.16451999999117106,133041.575499481,150887.43010778129
"147.32.84.165",3773,"209.191.88.254",25,3,186,3,186,0,0,85728.685512,8.962335000003804,166.02816118783423,0
"147.32.84.165",3079,"174.128.246.102",80,7,606,4,424,3,182,85728.685542,0.33145800000056624,10233.574087800582,4392.713405612514
"147.32.84.165",4461,"217.163.21.36",80,10,2274,5,1154,5,1120,85728.851645,0.139761999991606,66055.15090335332,64108.98527881779
"147.32.84.165",3774,"64.12.139.193",25,3,186,3,186,0,0,85728.897549,8.951002000001608,166.2383719721806,0
"147.32.84.165",3080,"193.23.181.44",179,10,728,5,428,5,300,85729.616356,0.19816200000059325,17278.792099341696,12111.302873370349
"147.32.84.165",4486,"46.4.36.120",443,6,366,3,186,3,180,85729.681202,0.9664889999985462,1539.5933114626637,1489.9290110929003
"147.32.84.165",4462,"217.163.21.35",80,13,5272,7,2281,6,2991,85729.870141,0.23797399998875335,76680.64578845756,100548.7994534312
"147.32.84.165",4485,"184.82.148.43",80,10,1899,5,959,5,940,85729.916012,0.3255780000035884,23564.24574116016,23097.383729604328
"147.32.84.165",3779,"207.115.36.22",25,3,186,3,186,0,0,85730.023668,9.029676999998628,164.78994763602574,0
"147.32.84.165",3081,"193.23.181.44",179,11,888,5,528,6,360,85730.023717,0.1913970000023255,22069.31143094551,15047.257793826484
"147.32.84.165",4469,"217.163.21.36",80,10,1451,5,701,5,750,85730.086353,0.1386989999882644,40432.879836729204,43259.14390520243
"147.32.84.165",3780,"205.188.190.1",25,3,186,3,186,0,0,85730.132146,9.021660999991582,164.93636814788192,0
"147.32.84.165",3082,"193.23.181.44",80,8,861,5,477,3,384,85730.519824,0.13445599999977276,28381.031713024702,22847.62301425888
"147.32.84.165",4481,"173.241.240.4",80,9,2195,5,1165,4,1030,85730.586709,0.06634900000062771,140469.33638655936,124191.77380099238
"147.32.84.165",4491,"184.82.148.44",80,10,1513,5,596,5,917,85730.603076,0.35873399999400135,13291.185112310874,20449.692530183005
"147.32.84.165",3781,"209.191.88.254",25,3,186,3,186,0,0,85730.647931,9.007463999994798,165.19633050999255,0
"147.32.84.165",3083,"174.128.246.102",80,13,1064,9,818,4,246,85730.647966,21.308971999998903,307.1006897939674,92.35546416786795
"147.32.84.165",4495,"91.214.134.197",6667,2,124,2,124,0,0,85730.647991,2.9840059999987716,332.43900984126986,0
"147.32.84.165",4483,"217.163.21.35",80,13,5835,7,2734,6,3101,85730.721392,0.16484800000034738,132679.80199913806,150490.14850011963
"147.32.84.165",3783,"205.188.103.1",25,3,186,3,186,0,0,85730.767482,8.988930000006803,165.5369437740503,0
"147.32.84.165",3084,"67.19.72.206",80,3,186,3,186,0,0,85730.76754,8.988991000005626,165.5358204273504,0
"147.32.84.165",4492,"217.163.21.35",80,13,5260,7,2281,6,2979,85731.323332,0.2871630000008736,63545.79106620452,82991.19315485455
"147.32.84.165",4497,"217.163.21.34",80,13,6071,6,749,7,5322,85731.369385,0.18647400000190828,32133.166017453805,228321.37455926454
"147.32.84.165",3784,"68.6.19.3",25,3,186,3,186,0,0,85731.415277,8.941635000010137,166.41251851572034,0
"147.32.84.165",3085,"193.23.181.44",179,10,781,5,481,5,300,85737.647745,0.19130400000722148,20114.582025753476,12545.477354939798
"147.32.84.165",4501,"46.4.36.120",443,6,366,3,186,3,180,85737.710339,0.9680450000014389,1537.1186256814385,1487.534153885263
"147.32.84.165",4500,"217.163.21.34",80,10,1444,5,697,5,747,85738.678623,0.14223599999968428,39202.45226252409,42014.67982798493
"147.32.84.165",3785,"64.29.145.41",25,3,186,3,186,0,0,85738.724524,8.957528999992064,166.11724059183265,0
"147.32.84.165",3086,"174.128.246.102",80,10,916,7,732,3,184,85739.254056,9.300319999994827,629.6557537808653,158.27412390120114
"147.32.84.165",4508,"184.82.148.43",80,10,1919,5,979,5,940,85739.254183,0.32271000000764616,24269.467942779684,23302.655634538205
"147.32.84.165",3793,"209.191.88.254",25,3,186,3,186,0,0,85739.360868,9.023208999991766,164.90807206187486,0
"147.32.84.165",3087,"193.23.181.44",179,10,744,5,444,5,300,85739.554968,0.1928829999960726,18415.308762681645,12442.776191001112
"147.32.84.165",4511,"217.163.21.41",80,11,3843,6,2217,5,1626,85739.615636,0.25448899999901187,69692.59968041394,51114.19354098019
"147.32.84.165",3798,"205.188.103.1",25,3,186,3,186,0,0,85739.661606,9.023305000009714,164.90631758523048,0
"147.32.84.165",3088,"174.37.196.55",80,3,186,3,186,0,0,85741.360478,9.029960999992909,164.78476485127328,0
"147.32.84.165",4522,"92.112.3.72",6667,2,124,2,124,0,0,85741.360541,3.0099709999922197,329.57128158462797,0
"147.32.84.165",4518,"46.4.36.120",443,6,366,3,186,3,180,85741.460962,1.0308050000021467,1443.531996834417,1396.9664485494357
"147.32.84.165",4513,"184.82.148.44",80,10,1514,5,596,5,918,85742.491922,0.32622400000400376,14615.724164811547,22512.13889814933
"147.32.84.165",3799,"189.21.116.60",25,3,186,3,186,0,0,85742.599771,8.994144000011147,165.44098026428705,0
"147.32.84.165",3089,"67.19.72.206",80,3,186,3,186,0,0,85747.179984,9.029079999992973,164.80084349691862,0
"147.32.84.165",4529,"46.4.36.120",443,6,366,3,186,3,180,85747.18011,1.0317400000058115,1442.2238160695704,1395.7004671641005
"147.32.84.165",4520,"217.163.21.34",80,10,2270,5,1152,5,1118,85748.212101,0.14005499999620952,65802.72036163953,63860.62618429947
"147.32.84.165",3800,"64.12.90.65",25,3,186,3,186,0,0,85748.25812,8.955776999995578,166.1497377615292,0
"147.32.84.165",3090,"72.20.15.61",80,3,186,3,186,0,0,85749.889545,8.928723000004538,166.65317089568617,0
"147.32.84.165",4541,"61.167.116.133",6667,10,1163,5,605,5,558,85751.19288,1.9848090000014054,2438.5217922714846,2249.082909235518
"147.32.84.165",4536,"46.4.36.120",443,6,366,3,186,3,180,85751.669922,1.0563620000029914,1408.6080339843597,1363.1690651461547
"147.32.84.165",4528,"217.163.21.34",80,13,6081,6,750,7,5331,85751.795698,0.18673000000126194,32131.95522925856,228393.93776956986
"147.32.84.165",3803,"64.12.90.65",25,3,186,3,186,0,0,85751.841576,8.882852999988245,167.5137481169585,0
"147.32.84.165",3091,"174.128.246.102",80,7,603,5,481,2,122,85751.84165,3.302306999990833,1165.245993183154,295.5509587699476
"147.32.84.165",4534,"184.82.148.43",80,10,1923,5,983,5,940,85751.841704,0.3224320000008447,24389.638745470045,23322.74712181266
"147.32.84.165",3804,"89.161.158.92",25,3,186,3,186,0,0,85751.948113,8.876793999996153,167.62808734782456,0
"147.32.84.165",3092,"193.23.181.44",80,8,866,5,482,3,384,85752.396542,0.15485700000135694,24900.391974313152,19837.656676631224
"147.32.84.165",4535,"217.163.21.41",80,13,5833,7,2732,6,3101,85752.457054,0.1609560000069905,135788.66273423028,154129.0787477482
"147.32.84.165",3805,"75.180.132.243",25,3,186,3,186,0,0,85752.502995,8.923798000003444,166.74514595684772,0
"147.32.84.165",3093,"174.128.246.102",80,7,570,4,388,3,182,85752.726503,0.32925900000554975,9427.229020156416,4422.050725949659
"147.32.84.165",4545,"217.163.21.34",80,10,1451,5,701,5,750,85752.726563,0.13930799999798182,40256.12312344764,43070.031872447544
"147.32.84.165",3806,"64.136.173.100",25,3,186,3,186,0,0,85752.772586,8.85483799999929,168.04372931499358,0
"147.32.84.165",3094,"174.128.246.102",80,3,186,3,186,0,0,85757.213773,8.929062000010163,166.646843755627,0
"147.32.84.165",4555,"218.167.197.117",6667,2,124,2,124,0,0,85759.621056,3.009303999991971,329.64432971964504,0
"147.32.84.165",4552,"46.4.36.120",443,6,366,3,186,3,180,85760.323281,1.0308879999938654,1443.4157735940807,1396.8539744458847
"147.32.84.165",4546,"184.82.148.44",80,10,1513,5,596,5,917,85760.624297,0.304669000004651,15649.77073455853,24078.590207366058
"147.32.84.165",3807,"209.191.88.254",25,3,186,3,186,0,0,85760.725017,9.02882099999988,164.80557095993152,0
"147.32.84.165",3095,"174.128.246.102",80,3,186,3,186,0,0,85761.354409,9.001834999988205,165.29963057553817,0
"147.32.84.165",4548,"92.240.244.181",80,10,1756,6,1362,4,394,85761.354468,10.580615999992006,1029.8077163000937,297.9032600750638
"147.32.84.165",3812,"122.50.126.89",25,3,186,3,186,0,0,85761.363404,8.9929620000039,165.4627251843558,0
"147.32.84.165",3096,"193.23.181.44",179,10,781,5,481,5,300,85763.534308,0.21770999999716878,17674.888613522766,11023.8390520932
"147.32.84.165",4562,"46.4.36.120",443,6,366,3,186,3,180,85763.605221,0.9603319999878295,1549.4641436699576,1499.4814293580237
"147.32.84.165",4549,"173.241.240.4",80,9,2192,5,1162,4,1030,85764.565763,0.0685339999909047,135640.70390220464,120232.29347613663
"147.32.84.165",3816,"216.17.3.48",25,3,186,3,186,0,0,85764.582407,8.984333000000333,165.62164381039136,0
"147.32.84.165",3097,"174.128.246.102",80,9,720,5,478,4,242,85769.152024,3.3504220000031637,1141.348761438526,577.837657464693
"147.32.84.165",4567,"74.115.3.63",6667,2,124,2,124,0,0,85769.152124,3.0095299999957206,329.6195751500768,0
"147.32.84.165",4566,"46.4.36.120",443,6,366,3,186,3,180,85770.857905,1.030534000004991,1443.9116031036274,1397.3338094551232
"147.32.84.165",4550,"217.163.21.41",80,11,3851,6,2221,5,1630,85771.88866,0.24255900000571273,73252.28088663596,53760.11609419928
"147.32.84.165",3818,"64.12.90.65",25,3,186,3,186,0,0,85771.934772,8.957115000011981,166.12491857009869,0
"147.32.84.165",3098,"193.23.181.44",179,10,781,5,481,5,300,85772.262187,0.19544300000416115,19688.60486135637,12279.795131823099
"147.32.84.165",4557,"184.82.148.43",80,10,1913,5,991,5,922,85772.326234,0.30560500000137836,25941.983933391937,24135.73076345849
"147.32.84.165",3820,"65.55.92.184",25,3,186,3,186,0,0,85772.426935,8.966211000006297,165.95638893607958,0
"147.32.84.165",3099,"174.37.196.55",80,3,186,3,186,0,0,85772.864296,9.030664999998407,164.77191879006278,0
"147.32.84.165",4581,"46.4.36.120",443,6,366,3,186,3,180,85773.466159,1.0304709999909392,1443.9998796793736,1397.4192383993939
"147.32.84.165",4559,"217.163.21.34",80,14,6137,7,809,7,5328,85773.666727,0.18865299999015406,34306.37201813795,225938.6280749555
"147.32.84.165",3821,"173.203.27.138",25,3,186,3,186,0,0,85773.712718,8.985918000005768,165.592430289153,0
"147.32.84.165",3100,"67.19.72.206",80,3,186,3,186,0,0,85774.496866,9.004109000001336,165.257883928302,0
"147.32.84.165",4588,"61.17.216.23",6667,2,124,2,124,0,0,85778.182961,3.009845000007772,329.58507830052326,0
"147.32.84.165",4587,"46.4.36.120",443,6,366,3,186,3,180,85781.795341,1.0312330000015208,1442.9328774368212,1396.3866555840207
"147.32.84.165",4577,"217.163.21.34",80,10,2277,5,1156,5,1121,85782.297242,0.13966899999650195,66213.69094238248,64208.95116471519
"147.32.84.165",4583,"173.192.170.88",80,20,4257,10,823,10,3434,85782.34306,37.637788000007276,174.93057774805277,729.9047436048762
"147.32.84.165",3822,"209.191.88.254",25,3,186,3,186,0,0,85782.397249,8.930422999997973,166.6214467109047,0
"147.32.84.165",3101,"174.128.246.102",80,3,186,3,186,0,0,85782.543838,8.884638000003179,167.48009316749514,0
"147.32.84.165",4580,"184.82.148.44",80,10,1311,5,584,5,727,85782.826807,0.3589349999965634,13016.284285580206,16203.490882905497
"147.32.84.165",3823,"64.12.90.65",25,3,186,3,186,0,0,85782.945342,8.884120999995503,167.48983945634615,0
"147.32.84.165",3102,"72.20.15.61",80,3,186,3,186,0,0,85782.945401,8.884213999990607,167.48808617189695,0
"147.32.84.165",4600,"46.4.36.120",443,6,366,3,186,3,180,85785.608646,1.0303100000019185,1444.2255243540578,1397.6376042136042
"147.32.84.165",4582,"217.163.21.34",80,10,1448,5,699,5,749,85786.639222,0.14513099999749102,38530.70674147269,41286.83740967531
"147.32.84.165",3825,"184.154.89.154",8735,7,424,4,242,3,182,85786.685402,0.43922400000155903,4407.773709981987,3314.9372529616594
"147.32.84.165",3103,"174.37.196.55",80,3,186,3,186,0,0,85786.82037,8.92346199999156,166.75142450333823,0
"147.32.84.165",4607,"123.192.69.237",6667,2,124,2,124,0,0,85786.820433,2.9023809999926016,341.78834550065227,0
"147.32.84.165",4610,"46.4.36.120",443,6,366,3,186,3,180,85792.332286,1.0315459999983432,1442.4950511197658,1395.9629526965475
"147.32.84.165",4593,"184.82.148.43",80,10,1907,5,987,5,920,85792.834576,0.30427800001052674,25949.953659899274,24188.406653604186
"147.32.84.165",3826,"68.6.19.3",25,3,186,3,186,0,0,85792.935017,9.031755999996676,164.75201500135162,0
"147.32.84.165",3104,"174.128.246.102",80,10,764,7,580,3,184,85793.336502,12.419379999992088,373.60963268721594,118.52443519732368
"147.32.84.165",4596,"217.163.21.41",80,13,5839,7,2736,6,3103,85793.336556,0.15545900000142865,140795.96549443167,159681.97402383824
"147.32.84.165",3827,"207.115.36.22",25,3,186,3,186,0,0,85793.364084,9.004316999998991,165.25406646613692,0
"147.32.84.165",3106,"193.23.181.44",80,10,972,6,528,4,444,85793.382374,0.18282000000181142,23104.693140565298,19428.946504566273
"147.32.84.165",4599,"217.163.21.41",80,16,7302,8,2231,8,5071,85793.448655,0.23776800000632647,75064.76901654177,170620.1002612655
"147.32.84.165",3836,"67.231.144.94",25,3,186,3,186,0,0,85793.44869,9.020208999994793,164.96291826507112,0
"147.32.84.165",3105,"193.23.181.44",179,11,842,5,482,6,360,85793.838203,0.19769999998970889,19504.299444616696,14567.52655614525
"147.32.84.165",4618,"184.82.148.44",80,10,1476,5,581,5,895,85793.903096,0.32306500000413507,14387.197622585263,22162.72267162446
"147.32.84.165",3837,"64.12.90.65",25,3,186,3,186,0,0,85794.009941,8.95981300000858,166.07489464328944,0
"147.32.84.165",3107,"193.23.181.44",179,10,794,5,494,5,300,85794.640213,0.20490299999073613,19287.174908023182,11712.859255884523
"147.32.84.165",4627,"46.4.36.120",443,6,366,3,186,3,180,85794.707329,0.9641030000057071,1543.4035574945742,1493.6163459624913
"147.32.84.165",4619,"217.163.21.41",80,13,5275,7,2279,6,2996,85795.443048,0.2709409999952186,67291.40292654766,88462.06369808546
"147.32.84.165",3846,"209.191.88.254",25,3,186,3,186,0,0,85795.48893,8.985954999996466,165.59174845640615,0
"147.32.84.165",4629,"208.73.210.29",80,50,36043,22,3374,28,32669,85795.489026,19.33052800000587,1396.3405448620856,13520.168719650112
"147.32.84.165",3108,"174.37.196.55",80,7,600,4,418,3,182,85795.666156,0.24254300000029616,13787.245972862202,6003.059251341915
"147.32.84.165",4620,"173.241.240.4",80,9,2195,5,1165,4,1030,85795.671636,0.06745200000295881,138172.32994709088,122160.94407339365
"147.32.84.165",3847,"64.12.139.193",25,3,186,3,186,0,0,85795.688109,8.987357999998494,165.5658982317439,0
"147.32.84.165",3109,"193.23.181.44",80,8,861,5,477,3,384,85795.787117,0.13060000000405125,29218.989279338643,23522.205206008464
"147.32.84.165",4633,"61.28.22.201",6667,2,124,2,124,0,0,85795.851965,3.005019000003813,330.1143852996408,0
"147.32.84.165",4639,"46.4.36.120",443,6,366,3,186,3,180,85802.368228,1.0301889999973355,1444.395154679237,1397.80176259281
"147.32.84.165",4621,"92.240.244.181",80,10,1760,6,1366,4,394,85803.371039,11.083855999997468,985.9384676237671,284.3775667963135
"147.32.84.165",3848,"207.115.36.22",25,3,186,3,186,0,0,85803.379684,9.020644000003813,164.95496330410236,0
"147.32.84.165",4638,"74.125.232.218",80,8,1908,5,1034,3,874,85803.379745,11.440073999998276,723.0722458614557,611.184857720418
"147.32.84.165",3110,"174.128.246.102",80,6,541,4,419,2,122,85803.387881,0.46645300000091083,7186.147371746895,2092.3865855683084
"147.32.84.165",4624,"217.163.21.41",80,13,5100,7,2211,6,2889,85803.387947,0.43088700000953395,41050.20573748716,53638.192842876706
"147.32.84.165",3849,"209.191.88.254",25,3,186,3,186,0,0,85803.398627,9.001749000002746,165.30120979817877,0
"147.32.84.165",3111,"72.20.15.61",80,3,186,3,186,0,0,85803.433921,8.966497999994317,165.9510769980591,0
"147.32.84.165",4632,"217.163.21.41",80,15,7619,7,2255,8,5364,85803.433952,0.4345959999918705,41509.81601380927,98739.97920091926
"147.32.84.165",3851,"209.191.88.254",25,3,186,3,186,0,0,85803.433975,8.966490999999223,165.95120655339184,0
"147.32.84.165",3112,"174.37.196.55",80,3,186,3,186,0,0,85803.433998,8.966513999999734,165.95078087203612,0
"147.32.84.165",4642,"184.82.148.43",80,10,1923,5,983,5,940,85803.434022,0.48070000000006985,16359.475764507712,15643.852714788656
"147.32.84.165",3852,"206.225.164.234",25,3,186,3,186,0,0,85803.530086,8.970459000003757,165.8777995640331,0
"147.32.84.165",3113,"193.23.181.44",179,10,741,5,441,5,300,85803.634535,0.28895299999567214,12209.598100912057,8305.849048239494
"147.32.84.165",3858,"64.12.90.65",25,3,186,3,186,0,0,85803.787312,8.913683000006131,166.93436371912446,0
"147.32.84.165",4647,"67.214.158.5",80,10,1713,5,858,5,855,85803.790536,0.3724590000056196,18428.87405028859,18364.43742773513
"147.32.84.165",3114,"193.23.181.44",80,8,852,5,468,3,384,85803.873589,0.12992800000938587,28815.95960631686,23643.864292362552
"147.32.84.165",4649,"184.82.148.44",80,10,1514,5,596,5,918,85803.873719,0.3405170000041835,14002.237773566141,21567.205161298185
"147.32.84.165",3859,"207.115.36.22",25,3,186,3,186,0,0,85803.894386,9.007456999999704,165.1964588895677,0
"147.32.84.165",4650,"50.22.198.84",80,8,2195,5,1164,3,1031,85803.894447,0.38975099999515805,23892.17731350448,21162.22921840474
"147.32.84.165",3115,"72.20.15.61",80,3,186,3,186,0,0,85803.986041,9.016615000000456,165.02867206816802,0
"147.32.84.165",4651,"195.113.232.96",80,52,57186,31,3849,21,53337,85804.015386,104.15120700000261,295.64707781062225,4096.889630861304
"147.32.84.165",3861,"205.188.190.1",25,3,186,3,186,0,0,85804.016192,8.986587999999756,165.5800844547497,0
"147.32.84.165",4652,"195.113.232.83",80,8,1362,5,774,3,588,85812.400206,2.4197959999874,2558.8933943325146,1943.965524376639
"147.32.84.165",3116,"193.23.181.44",179,10,801,5,501,5,300,85812.400989,0.19150200000149198,20929.285333671574,12532.50618782729
"147.32.84.165",4661,"190.77.235.75",6667,1,62,1,62,0,0,85812.464034,0,0,0
"147.32.84.165",4660,"46.4.36.120",443,6,366,3,186,3,180,85814.005941,1.0316620000085095,1442.3328570672627,1395.8059907102543
"147.32.84.165",4653,"217.163.21.41",80,13,5093,7,2257,6,2836,85814.408558,0.2687339999974938,67189.11637592709,84425.4913788787
"147.32.84.165",3862,"209.191.88.254",25,3,186,3,186,0,0,85814.454541,8.887304999996559,167.4298339035935,0
"147.32.84.165",4657,"67.214.158.5",80,10,1776,5,880,5,896,85814.454601,0.3325959999929182,21166.821008520543,21551.672299584552
"147.32.84.165",3117,"193.23.181.44",80,8,838,5,452,3,386,85814.509367,0.12565799998992588,28776.520398939167,24574.639101748937
"147.32.84.165",4668,"94.100.176.20",25,3,186,3,186,0,0,85814.558236,8.884101999996346,167.49019765876304,0
"147.32.84.165",4658,"217.163.21.34",80,14,6141,7,810,7,5331,85814.57155,0.19547500000044238,33150.01918396386,218176.237370014
"147.32.84.165",3863,"64.12.90.65",25,3,186,3,186,0,0,85814.61758,8.925139999992098,166.72007385893303,0
"147.32.84.165",4659,"50.22.198.84",80,3,184,2,122,1,62,85814.617642,0.12103199999546632,8063.983079157244,4098.089761538927
"147.32.84.165",3118,"193.23.181.44",80,8,861,5,477,3,384,85815.010162,0.14185499999439344,26900.708470979665,21655.91625336728
"147.32.84.165",4669,"184.82.148.43",80,10,1903,5,979,5,924,85815.037813,0.3261259999999311,24015.25790645841,22666.086113960744
"147.32.84.165",3864,"62.149.128.163",25,3,186,3,186,0,0,85815.080641,8.86479400000826,167.85500035292569,0
"147.32.84.165",3120,"193.23.181.44",80,8,875,5,489,3,386,85815.145688,0.12822400000004563,30509.109059135637,24082.85500373488
"147.32.84.165",4675,"217.163.21.34",80,10,1451,5,701,5,750,85815.145734,0.1410150000010617,39768.818919673635,42548.66503531416
"147.32.84.165",3867,"205.188.103.1",25,3,186,3,186,0,0,85815.191794,8.85329100000672,168.0730928192545,0
"147.32.84.165",3119,"174.37.196.55",80,9,699,6,517,3,182,85816.716116,9.177523000005749,450.6662636527753,158.64847192418782
"147.32.84.165",4681,"116.193.138.134",6667,2,124,2,124,0,0,85816.716244,3.0105080000066664,329.51249423612336,0
"147.32.84.165",4683,"46.4.36.120",443,6,366,3,186,3,180,85822.438361,1.0313360000000102,1442.7887710697437,1396.2471978094295
"147.32.84.165",4679,"217.163.21.41",80,11,3861,6,2221,5,1640,85823.469933,0.24095000000670552,73741.44013075545,54451.13093851371
"147.32.84.165",4684,"173.192.170.88",80,11,1099,6,542,5,557,85823.515866,56.950671999991755,76.13606385541206,78.24315049347697
"147.32.84.165",3868,"203.188.197.119",25,3,186,3,186,0,0,85823.716821,8.95793699999922,166.1096745824546,0
"147.32.84.165",3121,"174.37.196.55",80,3,186,3,186,0,0,85824.346383,9.030368000007002,164.77733797768224,0
"147.32.84.165",4680,"184.82.148.44",80,10,1311,5,584,5,727,85824.346488,0.30406400001083966,15365.186276025595,19127.552093614053
"147.32.84.165",3869,"209.191.88.254",25,3,186,3,186,0,0,85824.446567,9.03080599999521,164.76934616918905,0
"147.32.84.165",3122,"67.19.72.206",80,3,186,3,186,0,0,85824.446702,9.030721000002814,164.77089703020792,0
"147.32.84.165",4687,"184.82.148.43",80,10,1929,5,991,5,938,85824.44718,0.32345599999825936,24510.288880226875,23199.445983504345
"147.32.84.165",3882,"124.108.110.37",25,3,186,3,186,0,0,85824.554166,9.029907000003732,164.78575028506773,0
"147.32.84.165",3123,"72.20.15.61",80,9,684,6,502,3,182,85824.947822,9.397628999999142,427.3418327112473,154.9326963216076
"147.32.84.165",4692,"46.4.36.120",443,6,366,3,186,3,180,85824.947995,1.0304990000004182,1443.9606443086273,1397.3812686857684
"147.32.84.165",4688,"217.163.21.34",80,10,2277,5,1156,5,1121,85825.978723,0.1397970000107307,66153.0647960266,64150.16058507424
"147.32.84.165",3883,"64.12.139.193",25,3,186,3,186,0,0,85826.024636,8.957729000001564,166.11353167747544,0
"147.32.84.165",3124,"193.23.181.44",80,8,807,5,423,3,384,85832.474611,0.1422210000018822,23793.95447898141,21600.185626309365
"147.32.84.165",4705,"46.4.36.120",443,6,366,3,186,3,180,85832.545137,0.9595420000114245,1550.739832109781,1500.7159665578527
"147.32.84.165",4693,"217.163.21.41",80,15,7240,7,2169,8,5071,85833.504927,0.19898299999476876,87203.42944098833,203876.71309140243
"147.32.84.165",3884,"209.191.88.254",25,3,186,3,186,0,0,85833.55085,8.95909400000528,166.08822275992674,0
"147.32.84.165",3125,"72.20.15.61",80,3,186,3,186,0,0,85833.550913,8.959153999996488,166.08711045714622,0
"147.32.84.165",4697,"212.117.171.138",65500,7,424,4,242,3,182,85833.550967,301.90721599999233,6.4125661706610195,4.822673731654155
"147.32.84.165",4694,"184.82.148.44",80,10,1511,5,594,5,917,85833.551019,0.32234600000083447,14741.923274952065,22758.154281365394
"147.32.84.165",3885,"64.12.90.65",25,3,186,3,186,0,0,85833.657807,8.951916999998502,166.22138029209262,0
"147.32.84.165",3126,"193.23.181.44",80,9,893,5,441,4,452,85834.162173,0.12118499999633059,29112.513925872227,29838.676404748858
"147.32.84.165",4698,"121.245.3.131",6667,3,186,3,186,0,0,85834.222464,8.989256999993813,165.53092207743356,0
"147.32.84.165",4725,"46.4.36.120",443,6,366,3,186,3,180,85835.483776,1.0317730000097072,1442.1776882957788,1395.6558273830117
"147.32.84.165",4701,"217.163.21.41",80,14,5904,7,2736,7,3168,85835.986632,0.16039099999761675,136466.5099682977,158013.85364750258
"147.32.84.165",3886,"190.5.69.5",25,3,186,3,186,0,0,85836.03267,8.984450000003562,165.61948700247763,0
"147.32.84.165",3127,"174.37.196.55",80,3,186,3,186,0,0,85836.08696,9.030245999994804,164.77956414485897,0
"147.32.84.165",4709,"98.137.54.237",25,3,186,3,186,0,0,85836.087066,9.03026200000022,164.7792721850112,0
"147.32.84.165",4726,"74.125.93.27",25,3,186,3,186,0,0,85836.515787,9.002628000002005,165.28507009282941,0
"147.32.84.165",4710,"184.82.148.43",80,10,1911,5,987,5,924,85844.716805,0.3408119999949122,23168.198303222525,21689.377134931725
"147.32.84.165",3887,"205.188.103.1",25,3,186,3,186,0,0,85844.829478,8.91794800000207,166.85452752131482,0
"147.32.84.165",3129,"174.128.246.102",80,7,562,5,440,2,122,85845.518558,3.3361359999980778,1055.1128611069896,292.55402057966535
"147.32.84.165",4727,"61.153.193.110",6667,3,186,3,186,0,0,85845.518621,8.930940999998711,166.61178256582534,0
"147.32.84.165",4732,"46.4.36.120",443,6,366,3,186,3,180,85845.619614,1.0302099999971688,1444.3657118491271,1397.7732695314135
"147.32.84.165",4712,"217.163.21.41",80,13,5063,7,2207,6,2856,85846.650059,0.24927699999534525,70828.83699791673,91657.07225466706
"147.32.84.165",3888,"64.12.139.193",25,3,186,3,186,0,0,85846.696085,8.856841000000713,168.0057257435106,0
"147.32.84.165",3130,"193.23.181.44",80,8,852,5,468,3,384,85846.696158,0.13382499999715947,27976.835419984825,22955.35213947473
"147.32.84.165",4744,"61.26.131.206",6667,2,124,2,124,0,0,85846.762888,2.969123999995645,334.10527819028607,0
"147.32.84.165",4713,"217.163.21.34",80,14,6137,7,809,7,5328,85847.023262,0.1887540000025183,34288.01508796451,225817.73101195908
"147.32.84.165",3891,"66.46.183.251",25,3,186,3,186,0,0,85847.069469,8.884602000005543,167.48077178911015,0
"147.32.84.165",3131,"193.23.181.44",179,11,805,5,445,6,360,85848.691468,0.18832000000111293,18903.993202946906,15293.118096766035
"147.32.84.165",4751,"46.4.36.120",443,6,366,3,186,3,180,85848.75306,1.0068570000003092,1477.866270979437,1430.1931654639714
"147.32.84.165",4728,"173.241.240.4",80,9,2195,5,1165,4,1030,85849.760168,0.06682600000931416,139466.6746281535,123305.30031501983
"147.32.84.165",3894,"209.191.88.254",25,3,186,3,186,0,0,85849.776714,8.886005999986082,167.45430961922943,0
"147.32.84.165",4760,"98.126.71.122",80,12,4254,7,767,5,3487,85854.549653,16.443215000006603,373.16303411452907,1696.5052150682698
"147.32.84.165",3132,"174.128.246.102",80,7,549,4,367,3,182,85854.725253,0.3364270000020042,8727.004669608888,4327.8333783891485
"147.32.84.165",4758,"46.4.36.120",443,6,366,3,186,3,180,85854.892725,0.9885920000087935,1505.1709906480776,1456.617087723946
"147.32.84.165",4729,"92.240.244.181",80,10,1760,6,1366,4,394,85855.151421,7.471101999995881,1462.7025571336096,421.89224561540425
"147.32.84.165",3902,"65.55.92.136",25,3,186,3,186,0,0,85855.160456,9.021575999999186,164.9379221546362,0
"147.32.84.165",4771,"95.100.248.97",80,15,5983,8,2148,7,3835,85855.881536,15.11155499999586,1137.1430670109535,2030.2344795097795
"147.32.84.165",3133,"193.23.181.44",80,8,879,5,495,3,384,85855.882755,0.13496500000474043,29340.94024273635,22761.456673153047
"147.32.84.165",4780,"200.53.110.7",6667,2,124,2,124,0,0,85855.949823,2.9135910000040894,340.47331969332953,0
"147.32.84.165",4784,"46.4.36.120",443,6,366,3,186,3,180,85856.957588,1.0307099999918137,1443.6650464357756,1397.09520622817
"147.32.84.165",4740,"184.82.148.44",80,10,1311,5,586,5,725,85857.057554,0.3438960000057705,13632.028287393097,16865.564007440265
"147.32.84.165",3904,"205.188.190.1",25,3,186,3,186,0,0,85857.170779,9.019100000004983,164.98320231499574,0
"147.32.84.165",4783,"195.113.232.89",80,8,1961,5,939,3,1022,85857.458932,13.534390000000712,555.0305554960072,604.0907643417671
"147.32.84.165",3134,"174.128.246.102",80,9,672,6,490,3,182,85857.459961,9.355758999998216,418.9932639351599,155.62606946163083
"147.32.84.165",4790,"74.125.39.27",25,3,186,3,186,0,0,85857.988558,9.003876999995555,165.26214207510105,0
"147.32.84.165",4746,"217.163.21.34",80,10,1448,5,699,5,749,85862.575975,0.1397750000032829,40007.154354274084,42868.89643970141
"147.32.84.165",3905,"209.191.88.254",25,3,186,3,186,0,0,85862.622085,8.98576999999932,165.5951576770953,0
"147.32.84.165",4791,"195.113.232.99",80,32,38276,19,1595,13,36681,85862.622156,8.371343999999226,1524.2474804525032,35053.869486193274
"147.32.84.165",3135,"193.23.181.44",179,10,772,5,472,5,300,85862.623368,0.19184200000017881,19682.86402350101,12510.29493019132
"147.32.84.165",4795,"46.4.36.120",443,6,366,3,186,3,180,85862.68634,1.0221230000024661,1455.793480820224,1408.8324007937651
"147.32.84.165",4762,"184.82.148.43",80,10,1929,5,991,5,938,85863.708723,0.3243289999954868,24444.314261476222,23136.999775241875
"147.32.84.165",3906,"205.188.190.1",25,3,186,3,186,0,0,85863.815415,8.99617600000056,165.40361149002726,0
"147.32.84.165",3136,"67.19.72.206",80,3,186,3,186,0,0,85863.81545,8.996269000010216,165.4019016103576,0
"147.32.84.165",4823,"178.122.240.223",6667,2,124,2,124,0,0,85865.788441,3.0092810000060126,329.6468491968739,0
"147.32.84.165",4820,"46.4.36.120",443,6,366,3,186,3,180,85866.490925,1.0301449999969918,1444.4568483119806,1397.8614661083682
"147.32.84.165",4789,"93.184.220.20",80,13,6567,8,761,5,5806,85866.6531,6.130232000010437,993.110864317963,7576.874741432448
"147.32.84.165",3907,"65.55.37.88",25,3,186,3,186,0,0,85866.669721,8.952288000000408,166.2144917589707,0
"147.32.84.165",3137,"193.23.181.44",179,10,727,5,427,5,300,85867.521307,0.20444400000269525,16708.73197528402,11739.155954532098
"147.32.84.165",4810,"217.163.21.41",80,11,3852,6,2224,5,1628,85867.584126,0.25447499999427237,69916.4947456546,51179.88014654932
"147.32.84.165",3908,"209.191.88.254",25,3,186,3,186,0,0,85867.63037,8.994896000003791,165.42714890748852,0
"147.32.84.165",3138,"67.19.72.206",80,3,186,3,186,0,0,85867.630429,8.995007000004989,165.4251075067729,0
"147.32.84.165",4818,"184.82.148.44",80,10,1511,5,594,5,917,85867.630487,0.34495099999185186,13775.869616589742,21266.788616856553
"147.32.84.165",3910,"64.12.90.65",25,3,186,3,186,0,0,85867.744585,8.981652000002214,165.67108144466445,0
"147.32.84.165",3139,"72.20.15.61",80,3,186,3,186,0,0,85867.995199,9.03078600000299,164.76971107492827,0
"147.32.84.165",4835,"46.4.36.120",443,6,366,3,186,3,180,85870.705099,1.0309879999986151,1443.2757704279766,1396.7184875109451
"147.32.84.165",4825,"195.113.232.98",80,11,2395,7,1241,4,1154,85871.736333,103.96325600000273,95.49527767771855,88.80060470595262
"147.32.84.165",3911,"203.151.232.194",25,3,186,3,186,0,0,85871.736364,9.00329700000293,165.272788401795,0
"147.32.84.165",3140,"193.23.181.44",179,10,781,5,481,5,300,85872.610777,0.19142200000351295,20102.182611870016,12537.74383276716
"147.32.84.165",4826,"216.52.121.177",80,9,1243,5,615,4,628,85872.673635,0.33988200000021607,14475.612124198611,14781.60067316541
"147.32.84.165",3919,"200.51.80.21",25,3,186,3,186,0,0,85872.783022,8.96045199999935,166.06305128358568,0
"147.32.84.165",3141,"193.23.181.44",179,10,777,5,477,5,300,85876.223918,0.19589699999778531,19479.62449676688,12251.336161488603
"147.32.84.165",4850,"93.177.150.210",6667,2,124,2,124,0,0,85876.28822,2.9463680000044405,336.6857093202563,0
"147.32.84.165",4844,"46.4.36.120",443,6,366,3,186,3,180,85878.230708,1.0314919999946142,1442.5705676900736,1396.0360332484584
"147.32.84.165",4828,"68.67.185.205",80,10,1585,6,771,4,814,85879.033755,22.04802600000403,279.75293570494125,295.35523951209103
"147.32.84.165",3920,"209.86.93.228",25,3,186,3,186,0,0,85879.063097,8.900990999987698,167.17239687154571,0
"147.32.84.165",3143,"174.128.246.102",80,12,910,8,664,4,246,85879.262453,18.45509000000311,287.8338713059164,106.63724750189071
"147.32.84.165",4855,"66.111.4.71",25,3,186,3,186,0,0,85882.6463,9.029877000008128,164.78629775340912,0
"147.32.84.165",4831,"217.163.21.34",80,10,2274,5,1154,5,1120,85884.753043,0.14233399998920504,64861.522901767516,62950.52482667211
"147.32.84.165",4858,"173.192.170.88",80,7,860,4,423,3,437,85884.800351,2.8604340000019874,1183.037259380097,1222.19215685367
"147.32.84.165",3922,"205.188.190.1",25,3,186,3,186,0,0,85885.001599,8.981788000004599,165.66857289430993,0
"147.32.84.165",3144,"174.37.196.55",80,3,186,3,186,0,0,85887.562909,9.030767000003834,164.7700577369971,0
"147.32.84.165",4867,"62.24.74.140",6667,6,366,3,186,3,180,85888.429361,0.9496930000022985,1566.8221204077513,1516.27947136234
"147.32.84.165",4857,"46.4.36.120",443,6,366,3,186,3,180,85888.666853,1.0301999999937834,1444.379732099572,1397.7868375157148
"147.32.84.165",4832,"217.163.21.34",80,13,6077,6,749,7,5328,85888.967398,0.18661500001326203,32108.887279019214,228406.0766657068
"147.32.84.165",3923,"64.12.139.193",25,3,186,3,186,0,0,85889.0133,8.984977999993134,165.60975441466155,0
"147.32.84.165",3142,"67.19.72.206",80,3,186,3,186,0,0,85889.379272,9.020306999998866,164.96112604595245,0
"147.32.84.165",4840,"184.82.148.43",80,10,1917,5,979,5,938,85889.69728,0.32449300000735093,24136.1138755615,23125.30624645218
"147.32.84.165",3924,"209.191.88.254",25,3,186,3,186,0,0,85889.803688,8.996727999998257,165.39346304570822,0
"147.32.84.165",3145,"193.23.181.44",80,8,852,5,468,3,384,85892.678864,0.1353850000014063,27654.466890431802,22690.84462804661
"147.32.84.165",4879,"200.168.146.138",6667,2,124,2,124,0,0,85892.679055,3.0114750000066124,329.4066860916401,0
"147.32.84.165",4878,"46.4.36.120",443,6,366,3,186,3,180,85892.74651,0.9642220000096131,1543.2130774709194,1493.4320104557285
"147.32.84.165",4856,"68.67.179.210",80,10,2158,6,949,4,1209,85893.682977,14.483410999993794,524.1859117305484,667.798490286863
"147.32.84.165",3925,"66.175.58.43",25,3,186,3,186,0,0,85893.710949,9.002410000000964,165.2890725927658,0
"147.32.84.165",3146,"174.37.196.55",80,3,186,3,186,0,0,85893.712259,9.001205999986269,165.31118163524644,0
"147.32.84.165",4866,"217.163.21.41",80,13,5850,7,2739,6,3111,85893.712299,0.15399899998737965,142286.63823658405,161611.4390485626
"147.32.84.165",3926,"68.142.202.129",25,3,186,3,186,0,0,85893.75826,8.955228999999235,166.15990501193517,0
"147.32.84.165",3147,"174.37.196.55",80,3,186,3,186,0,0,85900.004633,9.028640999997151,164.80885661534992,0
"147.32.84.165",4885,"46.4.36.120",443,6,366,3,186,3,180,85900.004735,1.030547000002116,1443.893388653739,1397.3161825681345
"147.32.84.165",4873,"217.163.21.34",80,10,1448,5,699,5,749,85901.035543,0.1397329999890644,40019.179438197374,42881.78168699547
"147.32.84.165",3927,"64.12.139.193",25,3,186,3,186,0,0,85901.081414,8.955103999993298,166.16222435843443,0
"147.32.84.165",3148,"193.23.181.44",80,8,838,5,452,3,386,85901.081474,0.13125599999330007,27549.21679911454,23526.54354968631
"147.32.84.165",4876,"184.82.148.44",80,10,1512,5,594,5,918,85901.146676,0.3420839999889722,13891.324938182408,21468.411268100084
"147.32.84.165",3928,"165.21.74.114",25,3,186,3,186,0,0,85901.259525,8.977503000001889,165.74764720208805,0
"147.32.84.165",3149,"72.20.15.61",80,3,186,3,186,0,0,85903.716301,9.02867200000037,164.80829074308372,0
"147.32.84.165",4893,"83.211.221.197",6667,6,366,3,186,3,180,85906.023496,1.100484000009601,1352.1323344882962,1308.5151624080286
"147.32.84.165",4892,"46.4.36.120",443,6,366,3,186,3,180,85907.124239,1.0335179999965476,1439.7427040506025,1393.299391016712
"147.32.84.165",4881,"74.125.232.217",80,8,1418,5,639,3,779,85908.157995,61.337627999993856,83.34199033585897,101.60158133276077
"147.32.84.165",3929,"64.12.90.65",25,3,186,3,186,0,0,85908.166083,8.893834999995306,167.30690416460226,0
"147.32.84.165",3150,"193.23.181.44",80,9,929,5,477,4,452,85908.632157,0.1260679999977583,30269.37843122644,28682.9330207848
"147.32.84.165",4895,"216.157.130.15",25,3,186,3,186,0,0,85908.694356,8.867448999997578,167.80474294246366,0
"147.32.84.165",4882,"173.241.240.4",80,9,2194,5,1164,4,1030,85909.234195,0.06498799999826588,143287.99163304732,126792.63864436318
"147.32.84.165",3935,"209.191.88.254",25,3,186,3,186,0,0,85909.250827,8.91286399999808,166.9497032604021,0
"147.32.84.165",3151,"67.19.72.206",80,3,186,3,186,0,0,85909.250885,8.912928000005195,166.94850446442882,0
"147.32.84.165",4904,"46.4.36.120",443,6,366,3,186,3,180,85909.250933,1.0134189999953378,1468.296923589202,1420.9325066992278
"147.32.84.165",4883,"92.240.244.181",80,10,1758,6,1364,4,394,85910.036658,8.803203999996185,1239.5486915905537,358.0514549022567
"147.32.84.165",3937,"207.171.178.25",25,3,186,3,186,0,0,85910.045208,8.92070300001069,166.8029974765685,0
"147.32.84.165",3152,"174.37.196.55",80,3,186,3,186,0,0,85910.264559,8.902195999995456,167.14976843924347,0
"147.32.84.165",4905,"93.116.154.250",6667,2,124,2,124,0,0,85910.437898,3.009511999989627,329.6215466173317,0
"147.32.84.165",4884,"217.163.21.39",80,13,5816,6,724,7,5092,85910.83914,0.1869109999970533,30988.010336958832,217943.29922071047
"147.32.84.165",3938,"65.55.37.72",25,3,186,3,186,0,0,85910.885011,8.883185999991838,167.50746860432363,0
"147.32.84.165",3153,"174.128.246.102",80,8,632,5,450,3,182,85914.651418,3.351711000010255,1074.0782841924574,434.40499494006053
"147.32.84.165",4912,"46.4.36.120",443,6,366,3,186,3,180,85914.651487,1.031157000004896,1443.0392268034207,1396.489574325891
"147.32.84.165",4887,"184.82.148.43",80,10,1927,5,987,5,940,85915.682888,0.32284700000309385,24457.405520027543,23292.767161930995
"147.32.84.165",3940,"64.12.139.193",25,3,186,3,186,0,0,85915.789615,8.996081999997841,165.4053397912955,0
"147.32.84.165",3154,"72.20.15.61",80,3,186,3,186,0,0,85917.832102,8.962459000002127,166.02586410712138,0
"147.32.84.165",4920,"46.4.36.120",443,6,366,3,186,3,180,85917.832166,0.961224000013317,1548.0262664887528,1498.0899353116963
"147.32.84.165",4888,"217.163.21.41",80,11,3857,6,2229,5,1628,85918.793616,0.22624800000630785,78816.16632855468,57565.14974557515
"147.32.84.165",3941,"209.191.88.254",25,3,186,3,186,0,0,85918.839475,8.957475000002887,166.11824202685693,0
"147.32.84.165",3155,"174.128.246.102",80,15,1479,10,1171,5,308,85922.17763,24.657181999995373,379.92987195380874,99.93031644899496
"147.32.84.165",4925,"115.184.216.90",6667,1,62,1,62,0,0,85924.685671,0,0,0
"147.32.84.165",4924,"46.4.36.120",443,6,366,3,186,3,180,85925.354858,0.9646359999896958,1542.5507652792294,1492.7910631734478
"147.32.84.165",4890,"217.163.21.34",80,13,6081,6,750,7,5331,85926.31976,0.2489720000012312,24099.09548049712,171296.37067537353
"147.32.84.165",3945,"209.191.88.254",25,3,186,3,186,0,0,85926.365865,8.9602259999956,166.06723982193424,0
"147.32.84.165",3156,"174.128.246.102",80,3,186,3,186,0,0,85926.365895,8.960319999998319,166.06549766082898,0
"147.32.84.165",4900,"68.67.185.212",80,10,1943,6,854,4,1089,85926.365919,14.554911999992328,469.39479950161166,598.56081575791
"147.32.84.165",3946,"64.12.90.65",25,3,186,3,186,0,0,85926.395835,9.030366999999387,164.77735622484678,0
"147.32.84.165",3157,"174.37.196.55",80,3,186,3,186,0,0,85926.395866,9.030437999987043,164.77606069629567,0
"147.32.84.165",4907,"74.125.232.205",80,16,6001,9,3959,7,2042,85926.39589,60.786710999993375,521.034934757425,268.74294942527456
"147.32.84.165",3947,"65.54.188.72",25,3,186,3,186,0,0,85926.404011,9.022317999988445,164.92435757661232,0
"147.32.84.165",3158,"174.37.196.55",80,3,186,3,186,0,0,85926.79432,9.033412999997381,164.7217945200149,0
"147.32.84.165",4908,"74.125.232.205",80,8,1458,5,952,3,506,85926.79445,60.388363999998546,126.11701154878419,67.0327813484084
"147.32.84.165",3948,"65.55.92.136",25,3,186,3,186,0,0,85926.794505,9.033351999998558,164.72290684568003,0
"147.32.84.165",3159,"72.20.15.61",80,3,186,3,186,0,0,85929.103097,9.032800999993924,164.7329549273809,0
"147.32.84.165",4935,"46.4.36.120",443,6,366,3,186,3,180,85929.604724,1.0319079999899259,1441.9890145386282,1395.4732398760918
"147.32.84.165",4909,"217.163.21.39",80,10,1521,5,704,5,817,85930.636868,0.1397419999993872,40302.84381234488,46771.908231087735
"147.32.84.165",3949,"64.12.139.193",25,3,186,3,186,0,0,85930.682875,8.958330000008573,166.1023873867759,0
"147.32.84.165",3160,"174.37.196.55",80,7,569,4,387,3,182,85930.682934,0.24249800000688992,12767.115604714412,6004.173230124091
"147.32.84.165",4938,"123.236.248.177",6667,2,124,2,124,0,0,85930.683033,2.936308000003919,337.8392185011504,0
"147.32.84.165",4910,"95.172.94.50",80,8,1196,5,807,3,389,85931.011299,0.07209799998963717,89544.78627601232,43163.47194717323
"147.32.84.165",3957,"68.6.19.3",25,3,186,3,186,0,0,85931.034595,9.007958999995026,165.18725273958526,0
"147.32.84.165",3161,"174.128.246.102",80,8,665,4,423,4,242,85931.211008,0.3409160000010161,9926.19882900748,5678.818242600024
"147.32.84.165",4911,"46.137.9.143",80,8,1441,5,739,3,702,85931.211139,0.13909199999761768,42504.241797524366,40376.153913209884
"147.32.84.165",3958,"65.55.37.88",25,3,186,3,186,0,0,85931.255585,8.987589999989723,165.56162441785858,0
"147.32.84.165",3162,"193.23.181.44",80,8,863,5,479,3,384,85931.81289,0.12848899999517016,29823.564664243968,23908.661442734203
"147.32.84.165",4946,"46.4.36.120",443,6,366,3,186,3,180,85931.876722,0.9668070000043372,1539.0869118586488,1489.4389469599828
"147.32.84.165",4918,"184.82.148.44",80,10,1514,5,596,5,918,85932.843743,0.32295000000158325,14763.895339763509,22740.36228507198
"147.32.84.165",3960,"205.188.190.1",25,3,186,3,186,0,0,85932.950296,9.00114300000132,165.31233866629844,0
"147.32.84.165",3163,"174.128.246.102",80,8,623,5,441,3,182,85936.831293,3.336689000003389,1057.335580270267,436.36071566709427
"147.32.84.165",4950,"46.4.36.120",443,6,366,3,186,3,180,85936.831432,1.0304069999983767,1444.0895684931722,1397.5060340256507
"147.32.84.165",4922,"217.163.21.34",80,10,2274,5,1154,5,1120,85936.831504,0.13957200000004377,66145.0720774733,64196.25712891691
"147.32.84.165",3965,"209.191.88.254",25,3,186,3,186,0,0,85936.877324,8.88697599999432,167.4360322342438,0
"147.32.84.165",3164,"72.20.15.61",80,3,186,3,186,0,0,85936.877382,8.88704199998756,167.43478876346967,0
"147.32.84.165",4929,"184.82.148.43",80,10,1909,5,991,5,918,85936.877436,0.3222480000113137,24602.169756590138,22789.900945055244
"147.32.84.165",3992,"64.12.90.65",25,3,186,3,186,0,0,85936.983889,8.88103499999852,167.5480391643821,0
"147.32.84.165",3165,"174.37.196.55",80,3,186,3,186,0,0,85937.862074,8.90532799999346,167.09098193812656,0
"147.32.84.165",4959,"46.4.36.120",443,6,366,3,186,3,180,85939.842069,1.0314429999998538,1442.6390988161352,1396.102353693034
"147.32.84.165",4933,"217.163.21.34",80,10,1451,5,701,5,750,85940.873745,0.14016899999114685,40008.8464664384,42805.47054183852
"147.32.84.165",3996,"165.21.74.122",25,3,186,3,186,0,0,85940.92052,8.857554000001983,167.99220191033177,0
"147.32.84.165",3166,"193.23.181.44",80,9,930,5,478,4,452,85946.867994,0.12530600000172853,30517.293664686844,28857.357189201786
"147.32.84.165",4961,"86.126.237.212",6667,1,62,1,62,0,0,85946.930168,0,0,0
"147.32.84.165",4965,"46.4.36.120",443,6,366,3,186,3,180,85947.36992,1.0311139999976149,1443.0994051127634,1396.5478113994484
"147.32.84.165",4940,"217.163.21.41",80,11,3980,6,2239,5,1741,85947.771228,0.23193100000207778,77229.86577835448,60052.34315324482
"147.32.84.165",3997,"205.188.103.1",25,3,186,3,186,0,0,85947.817134,8.985465999998269,165.60076016094064,0
"147.32.84.165",3167,"67.19.72.206",80,3,186,3,186,0,0,85948.401277,9.003117000000202,165.27609271321995,0
"147.32.84.165",4975,"46.4.36.120",443,6,366,3,186,3,180,85950.079344,1.0304790000081994,1443.988669335484,1397.4083896795007
"147.32.84.165",4954,"217.163.21.41",80,4,244,3,182,1,62,85951.110089,0.04615300000295974,31547.24503080251,10746.863691811845
"147.32.84.165",3998,"216.82.254.51",25,3,186,3,186,0,0,85951.155894,8.960579000005964,166.06069764007543,0
"147.32.84.165",3168,"193.23.181.44",80,8,808,5,424,3,384,85951.986409,0.12561899999855086,27002.284686545267,24454.89933875798
"147.32.84.165",4977,"14.98.87.197",6667,2,124,2,124,0,0,85952.048552,2.9481400000076974,336.483342038509,0
"147.32.84.165",4981,"46.4.36.120",443,6,366,3,186,3,180,85952.187334,1.0307949999987613,1443.546000903951,1396.9800008747911
"147.32.84.165",4955,"217.163.21.34",80,13,6081,6,750,7,5331,85953.218389,0.1876300000003539,31977.828705370586,227298.40643777413
"147.32.84.165",3999,"209.191.88.254",25,3,186,3,186,0,0,85953.264334,8.958444999996573,166.1002551224648,0
"147.32.84.165",3169,"174.37.196.55",80,3,186,3,186,0,0,85953.89273,9.033909999998286,164.71273236065915,0
"147.32.84.165",4957,"184.82.148.44",80,10,1474,5,579,5,895,85953.892859,0.3590070000063861,12902.255387548446,19943.900814949673
"147.32.84.165",4000,"65.54.188.126",25,3,186,3,186,0,0,85954.011397,9.015382000012323,165.0512424207833,0
"147.32.84.165",3170,"174.128.246.102",80,9,689,6,505,3,184,85956.902335,6.396053999997093,631.6394451957153,230.14189686338935
"147.32.84.165",4985,"46.4.36.120",443,6,366,3,186,3,180,85957.906323,1.032917999997153,1440.5790198293587,1394.1087288671213
"147.32.84.165",4963,"217.163.21.41",80,11,3861,6,2231,5,1630,85958.811249,0.23838699999032542,74869.8544833583,54700.96943427791
"147.32.84.165",4087,"205.188.190.1",25,3,186,3,186,0,0,85958.857201,8.98672099999385,165.57763393355802,0
"147.32.84.165",3171,"174.128.246.102",80,10,785,6,543,4,242,85958.93955,9.334467000007862,465.37204534510016,207.40337932507228
"147.32.84.165",4968,"184.82.148.43",80,10,1927,5,987,5,940,85958.93961,0.3049089999985881,25896.251012717115,24663.096202587727
"147.32.84.165",4096,"205.188.190.1",25,3,186,3,186,0,0,85959.040366,9.004358000005595,165.25331400629287,0
"147.32.84.165",3172,"72.20.15.61",80,3,186,3,186,0,0,85959.040427,9.004417999996804,165.25221285823562,0
"147.32.84.165",4994,"46.4.36.120",443,6,366,3,186,3,180,85960.088546,0.9579119999980321,1553.3785984548235,1503.2696114078938
"147.32.84.165",4974,"217.163.21.39",80,10,2427,5,1199,5,1228,85961.046686,0.13938799999596085,68815.1060369469,70479.52478179382
"147.32.84.165",4104,"68.6.19.3",25,3,186,3,186,0,0,85961.092467,8.959192000009352,166.08640600608254,0
"147.32.84.165",3173,"174.37.196.55",80,3,186,3,186,0,0,85961.821805,9.033225999999559,164.72520448398754,0
"147.32.84.165",4996,"222.23.80.7",6667,1,62,1,62,0,0,85966.940773,0,0,0
"147.32.84.165",4999,"46.4.36.120",443,6,366,3,186,3,180,85968.847278,1.0320879999926547,1441.7375262677117,1395.2298641300436
"147.32.84.165",4983,"217.163.21.34",80,10,1451,5,701,5,750,85969.449243,0.1402760000055423,39978.32843664225,42772.81929740612
"147.32.84.165",4112,"209.191.88.254",25,3,186,3,186,0,0,85969.495201,8.884675000008428,167.47939570086564,0
"147.32.84.165",3174,"193.23.181.44",80,8,821,5,437,3,384,85969.495261,0.13618299999507144,25671.339301722848,22557.881674740445
"147.32.84.165",4984,"217.163.21.41",80,17,7752,8,2325,9,5427,85969.560309,0.19064800000342075,97561.99907508217,227728.5888088047
"147.32.84.165",4131,"80.121.155.140",25,3,186,3,186,0,0,85969.60622,8.873903999992763,167.68267946117217,0
"147.32.84.165",3175,"174.37.196.55",80,3,186,3,186,0,0,85969.879628,8.900794000001042,167.17609687403458,0
"147.32.84.165",4990,"217.163.21.34",80,4,244,3,182,1,62,85969.879664,0.046404000007896684,31376.605459706683,10688.733728031946
"147.32.84.165",4135,"205.188.159.42",25,3,186,3,186,0,0,85969.925701,8.854858999999124,168.04333078597267,0
"147.32.84.165",3177,"67.19.72.206",80,3,186,3,186,0,0,85972.159653,8.928698000003351,166.653637517972,0
"147.32.84.165",1035,"93.180.230.38",6667,6,366,3,186,3,180,85974.26636,1.3201030000054743,1127.1847726986678,1090.8239735793559
"147.32.84.165",1036,"46.4.36.120",443,6,366,3,186,3,180,85975.069282,1.0302890000020852,1444.2549614690522,1397.666091744244
"147.32.84.165",4991,"184.82.148.44",80,10,1514,5,596,5,918,85975.586737,0.339931999988039,14026.334679193982,21604.32086493301
"147.32.84.165",4169,"216.82.254.179",25,3,186,3,186,0,0,85975.69922,8.90136300001177,167.16541051050638,0
"147.32.84.165",3176,"193.23.181.44",179,10,781,5,481,5,300,85976.099813,0.2256000000052154,17056.737588258165,10638.29787209449
"147.32.84.165",4997,"217.163.21.41",80,14,5033,7,2794,7,2239,85976.164019,0.16612599999643862,134548.4752566075,107821.77383662999
"147.32.84.165",4184,"64.12.90.65",25,3,186,3,186,0,0,85976.209907,8.99224000000686,165.47601042664175,0
"147.32.84.165",3178,"174.128.246.102",80,8,611,6,489,2,122,85976.975212,9.370690999989165,417.47188120966996,104.1545388703062
"147.32.84.165",1051,"77.120.37.254",6667,2,124,2,124,0,0,85979.783715,3.010955000005197,329.463575509527,0
"147.32.84.165",1048,"46.4.36.120",443,6,366,3,186,3,180,85979.984569,1.033011000006809,1440.4493272483953,1393.983219917802
"147.32.84.165",1029,"184.82.148.43",80,10,1917,5,991,5,926,85981.017778,0.3264590000035241,24284.82596563249,22691.97663388061
"147.32.84.165",4190,"65.54.188.110",25,3,186,3,186,0,0,85981.125636,8.994724000003771,165.43031225853915,0
"147.32.84.165",3179,"72.20.15.61",80,3,186,3,186,0,0,85981.991933,9.031294000000344,164.76044296641692,0
"147.32.84.165",1056,"46.4.36.120",443,6,366,3,186,3,180,85982.794805,1.0302820000069914,1444.2647741005885,1397.6755878392792
"147.32.84.165",1034,"217.163.21.41",80,4,244,3,182,1,62,85983.825331,0.046394999997573905,31382.69210208293,10690.807199610668
"147.32.84.165",4195,"65.55.92.184",25,3,186,3,186,0,0,85983.871442,8.957322000002023,166.12107949224824,0
"147.32.84.165",3180,"72.20.15.61",80,3,186,3,186,0,0,85986.175388,8.960794999991776,166.05669474654488,0
"147.32.84.165",1062,"46.4.36.120",443,6,366,3,186,3,180,85986.175448,0.9605180000071414,1549.1640968612112,1499.1910614785916
"147.32.84.165",1043,"217.163.21.34",80,13,6078,6,750,7,5328,85987.136258,0.18720000000030268,32051.282051230228,227692.30769193955
"147.32.84.165",4204,"64.12.139.193",25,3,186,3,186,0,0,85987.182264,8.956617000003462,166.1341553400603,0
"147.32.84.165",3181,"72.20.15.61",80,3,186,3,186,0,0,85990.521465,9.031638000000385,164.75416751645014,0
"147.32.84.165",1067,"180.251.135.144",6667,2,124,2,124,0,0,85990.521593,3.0095470000087516,329.61771322963733,0
"147.32.84.165",1066,"46.4.36.120",443,6,366,3,186,3,180,85990.822563,1.0301480000052834,1444.452641748922,1397.8573952408922
"147.32.84.165",1046,"217.163.21.41",80,13,5128,7,2268,6,2860,85991.852951,0.26560900000913534,68310.93825651976,86141.65935345966
"147.32.84.165",4216,"205.188.103.1",25,3,186,3,186,0,0,85991.898849,8.960286999994423,166.06610926646948,0
"147.32.84.165",3182,"193.23.181.44",80,8,863,5,477,3,386,85993.12982,0.14217799999460112,26839.59543772527,21719.25333115714
"147.32.84.165",1076,"46.4.36.120",443,6,366,3,186,3,180,85993.200346,0.9598350000014761,1550.2664520440612,1500.2578568168335
"147.32.84.165",1047,"74.125.232.220",80,47,34017,23,5796,24,28221,85994.160431,24.651347999999416,1880.9519057538394,9158.444398253814
"147.32.84.165",4217,"143.166.224.193",25,3,186,3,186,0,0,85994.168534,8.999278999996022,165.3465794316031,0
"147.32.84.165",3183,"72.20.15.61",80,3,186,3,186,0,0,85995.537423,9.034828000003472,164.69599642621068,0
"147.32.84.165",1082,"46.4.36.120",443,6,366,3,186,3,180,85995.53752,1.0305630000075325,1443.87097148755,1397.2944885363388
"147.32.84.165",1055,"184.82.148.44",80,10,1499,5,587,5,912,85996.568326,0.308260000005248,15233.893466294856,23668.331927190648
"147.32.84.165",4219,"209.191.88.254",25,3,186,3,186,0,0,85996.641535,9.0344780000014,164.70237682794397,0
"147.32.84.165",3184,"67.19.72.206",80,3,186,3,186,0,0,85996.670086,9.005984999996144,165.22345973268187,0
"147.32.84.165",1065,"217.163.21.34",80,10,1449,5,700,5,749,85997.243819,0.1394120000040857,40168.708574842065,42980.51817508101
"147.32.84.165",4239,"93.95.14.32",25,3,186,3,186,0,0,85997.289733,8.988649000006262,165.5421187320768,0
"147.32.84.165",3185,"67.19.72.206",80,3,186,3,186,0,0,86002.163372,8.930733000001055,166.61566301442716,0
"147.32.84.165",1088,"93.180.230.38",6667,6,366,3,186,3,180,86002.163503,1.3224929999996675,1125.1477323512293,1088.8526442108669
"147.32.84.165",1086,"46.4.36.120",443,6,366,3,186,3,180,86003.066979,1.0316600000078324,1442.3356532081334,1395.8086966530325
"147.32.84.165",1071,"184.82.148.43",80,10,1927,5,987,5,940,86003.48624,0.3264070000004722,24190.657675811417,23038.721596010873
"147.32.84.165",4243,"209.191.88.254",25,3,186,3,186,0,0,86003.594068,8.90401899999415,167.11554636181455,0
"147.32.84.165",3186,"174.37.196.55",80,3,186,3,186,0,0,86003.594128,8.904082000008202,167.11436395112145,0
"147.32.84.165",1074,"195.113.232.96",80,29,33285,21,1956,8,31329,86004.098746,14.712847999995574,1063.5602298076285,17034.907177731693
"147.32.84.165",4245,"205.188.103.1",25,3,186,3,186,0,0,86004.099581,8.900242000003345,167.18646526683665,0
"147.32.84.165",3187,"67.19.72.206",80,3,186,3,186,0,0,86004.09961,8.900312999991002,167.18513157924946,0
"147.32.84.165",1080,"74.125.232.218",80,55,40670,25,5816,30,34854,86004.099634,14.71205899999768,3162.57568026388,18952.615673988526
"147.32.84.165",4251,"203.188.197.119",25,3,186,3,186,0,0,86004.124002,8.875950000001467,167.64402683653626,0
"147.32.84.165",3188,"174.128.246.102",80,8,665,6,543,2,122,86004.87317,9.267629999987548,468.72825091267526,105.31279302273735
"147.32.84.165",1096,"46.4.36.120",443,6,366,3,186,3,180,86005.575951,1.0311789999977918,1443.0084398568886,1396.4597805066662
"147.32.84.165",1083,"70.32.97.26",80,11,2830,6,791,5,2039,86006.607237,0.5267729999904986,12012.76451168556,30965.89992329565
"147.32.84.165",4258,"65.54.188.72",25,3,186,3,186,0,0,86006.750792,8.857367999997223,167.99572965698914,0
"147.32.84.165",3189,"174.128.246.102",80,12,873,8,627,4,246,86008.083576,18.502605000001495,271.0969617521206,106.36340126159755
"147.32.84.165",1100,"222.124.57.154",6667,2,124,2,124,0,0,86008.083638,3.0104169999976875,329.5224548628187,0
"147.32.84.165",1103,"46.4.36.120",443,6,366,3,186,3,180,86012.79951,1.030828000002657,1443.4997885157995,1396.9352792088382
"147.32.84.165",1085,"217.163.21.41",80,13,5291,7,2290,6,3001,86013.830578,0.29870700000901707,61331.003288998836,80373.0746158452
"147.32.84.165",1114,"184.82.147.251",80,10,1886,5,958,5,928,86013.87651,0.33064200000080746,23179.14844448462,22453.28784601433
"147.32.84.165",4262,"209.191.88.254",25,3,186,3,186,0,0,86013.972031,8.96439000000828,165.9901008321398,0
"147.32.84.165",3190,"174.37.196.55",80,3,186,3,186,0,0,86013.972092,8.964452000000165,165.9889528104978,0
"147.32.84.165",1094,"74.125.232.220",80,8,2452,5,1123,3,1329,86013.972146,4.839250999997603,1856.4856420971862,2197.034210460517
"147.32.84.165",4406,"64.12.90.65",25,3,186,3,186,0,0,86013.972202,8.964389999993728,165.99010083240924,0
"147.32.84.165",3191,"174.128.246.102",80,16,1855,11,1547,5,308,86013.983175,45.332672000004095,273.0039826463104,54.35373410152786
"147.32.84.165",1095,"209.85.148.147",80,8,2168,5,1170,3,998,86013.984913,4.826980000012554,1939.100638489419,1654.0362711217438
"147.32.84.165",4437,"161.58.16.34",25,3,186,3,186,0,0,86014.027314,8.909325999993598,167.01600098605317,0
"147.32.84.165",3192,"193.23.181.44",179,10,728,5,428,5,300,86015.106696,0.20736000000033528,16512.345678985646,11574.074074055361
"147.32.84.165",1121,"46.4.36.120",443,6,366,3,186,3,180,86015.176631,0.9608480000024429,1548.6320416925641,1498.6761693799008
"147.32.84.165",1101,"195.113.232.82",80,8,2405,5,774,3,1631,86016.137752,2.6737510000093607,2315.847661198938,4880.035575472181
"147.32.84.165",1120,"184.82.147.252",80,10,1508,5,596,5,912,86016.13876,0.3044839999929536,15659.279305678923,23961.85021271674
"147.32.84.165",4438,"168.95.5.42",25,3,186,3,186,0,0,86016.239192,9.005005000013625,165.24144073187617,0
"147.32.84.165",3193,"72.20.15.61",80,3,186,3,186,0,0,86017.616494,9.032838999992236,164.73226191690995,0
"147.32.84.165",1125,"210.212.164.162",6667,5,306,3,186,2,120,86017.61663,2.812434999999823,529.078894267812,341.34122210826575
"147.32.84.165",1131,"46.4.36.120",443,6,366,3,186,3,180,86018.219052,1.041570999994292,1428.6112036607726,1382.5269712846186
"147.32.84.165",1124,"217.163.21.34",80,13,6078,6,750,7,5328,86019.260894,0.1865949999919394,32155.202445184437,228430.55817059026
"147.32.84.165",4439,"199.91.33.184",25,3,186,3,186,0,0,86019.306844,8.947540999986813,166.30267466806723,0
"147.32.84.165",3195,"193.23.181.44",80,8,863,5,477,3,386,86023.137605,0.14224400000239257,26827.14209341564,21709.17578209316
"147.32.84.165",1139,"46.4.36.120",443,6,366,3,186,3,180,86023.208294,0.9597599999979138,1550.3875969025949,1500.3750937767047
"147.32.84.165",1137,"217.163.21.34",80,10,1449,5,700,5,749,86024.168293,0.14475800000946037,38685.254007612864,41393.22178814576
"147.32.84.165",4440,"64.12.90.65",25,3,186,3,186,0,0,86024.214167,8.955331000004662,166.1580124731543,0
"147.32.84.165",3196,"72.20.15.61",80,3,186,3,186,0,0,86024.214197,8.955350000003818,166.15765994621825,0
"147.32.84.165",1142,"184.82.147.251",80,10,1906,5,978,5,928,86024.214221,0.3049230000033276,25658.93684607136,24347.130258848898
"147.32.84.165",4441,"209.191.88.254",25,3,186,3,186,0,0,86024.314765,8.955420999991475,166.15634262212984,0
"147.32.84.165",3197,"193.23.181.44",80,8,839,5,453,3,386,86024.541397,0.1372420000116108,26405.91072480295,22500.400750052842
"147.32.84.165",1147,"217.163.21.41",80,13,5292,7,2295,6,2997,86024.606248,0.22831600000790786,80414.86360729905,105012.35129894347
"147.32.84.165",4442,"216.32.181.178",25,3,186,3,186,0,0,86024.652221,9.019867000009981,164.96917304859966,0
"147.32.84.165",3198,"193.23.181.44",179,10,793,5,493,5,300,86025.043414,0.1916860000055749,20575.31588058228,12520.476195080495
"147.32.84.165",1148,"184.82.147.252",80,10,1508,5,596,5,912,86025.106418,0.305183999997098,15623.361644271452,23906.888959019405
"147.32.84.165",4444,"64.12.90.65",25,3,186,3,186,0,0,86025.207073,8.966199999995297,165.95659253650157,0
"147.32.84.165",3199,"174.128.246.102",80,12,1346,8,1100,4,246,86025.207111,9.33821600000374,942.3641517819331,210.74689212577775
"147.32.84.165",1153,"46.4.36.120",443,6,366,3,186,3,180,86025.207134,0.968393000002834,1536.5662494417509,1486.9995962339524
"147.32.84.165",1154,"217.163.21.34",80,14,6141,7,810,7,5331,86026.175759,0.18901199998799711,34283.537555348346,225636.46754020004
"147.32.84.165",4445,"205.188.103.1",25,3,186,3,186,0,0,86026.221887,8.965440999993007,165.9706421581672,0
"147.32.84.165",3200,"174.37.196.55",80,7,599,4,417,3,182,86027.652534,0.24282700000912882,13738.175737766338,5996.038331591064
"147.32.84.165",1159,"121.243.139.53",6667,2,124,2,124,0,0,86027.7738,2.9886479999986477,331.9226620198996,0
"147.32.84.165",1160,"46.4.36.120",443,6,366,3,186,3,180,86033.169375,1.031342999995104,1442.7789784844265,1396.237721113961
"147.32.84.165",1158,"217.163.21.34",80,10,1451,5,701,5,750,86034.20096,0.13969599999836646,40144.313366635964,42950.4065976847
"147.32.84.165",4446,"65.54.188.126",25,3,186,3,186,0,0,86034.246872,8.855184000000008,168.03716331586094,0
"147.32.84.165",3201,"174.128.246.102",80,7,579,4,397,3,182,86034.975355,0.3792739999917103,8373.893280502794,3838.9132923211805
"147.32.84.165",1168,"184.82.147.251",80,10,1906,5,978,5,928,86034.975438,0.36252300000342075,21582.078929960782,20478.70066155788
"147.32.84.165",4449,"209.191.88.254",25,3,186,3,186,0,0,86034.975467,8.928456000008737,166.65815455645904,0
"147.32.84.165",3202,"174.37.196.55",80,3,186,3,186,0,0,86034.975493,8.928550999989966,166.65638130998772,0
"147.32.84.165",1170,"217.163.21.41",80,11,3866,6,2236,5,1630,86035.088119,0.2997060000052443,59685.15812058149,43509.30578557595
"147.32.84.165",4453,"205.188.103.1",25,3,186,3,186,0,0,86035.134072,8.870408000002499,167.74876646030046,0
"147.32.84.165",3203,"174.128.246.102",80,12,1086,8,840,4,246,86035.134104,12.45932000000903,539.355277815734,157.95404564603638
"147.32.84.165",4454,"205.188.103.1",25,3,186,3,186,0,0,86035.134127,8.870475000003353,167.74749942922307,0
"147.32.84.165",3204,"193.23.181.44",80,10,950,6,506,4,444,86035.134151,0.15364999999292195,26345.590629264403,23117.47478140987
"147.32.84.165",1174,"46.4.36.120",443,6,366,3,186,3,180,86035.202625,1.0039749999996275,1482.108618243036,1434.2986628158415
"147.32.84.165",1175,"184.82.147.252",80,10,1507,5,596,5,911,86036.206839,0.327248999994481,14569.945210162328,22270.503500768256
"147.32.84.165",4455,"203.188.197.119",25,3,186,3,186,0,0,86036.313277,8.894978000011179,167.2854053150137,0
"147.32.84.165",3205,"174.37.196.55",80,3,186,3,186,0,0,86037.282912,8.928357000011601,166.66000250640363,0
"147.32.84.165",1179,"178.122.247.101",6667,2,124,2,124,0,0,86037.283026,2.9093310000025667,340.97185916594736,0
"147.32.84.165",1182,"46.4.36.120",443,6,366,3,186,3,180,86038.586967,1.0310040000040317,1443.2533724352004,1396.6968120340648
"147.32.84.165",1177,"217.163.21.34",80,10,2277,5,1156,5,1121,86039.618172,0.14661499999056105,63076.76568287951,61167.002016010316
"147.32.84.165",4457,"209.191.88.254",25,3,186,3,186,0,0,86039.664076,8.95476900000358,166.1684405258701,0
"147.32.84.165",3206,"67.19.72.206",80,3,186,3,186,0,0,86039.664107,8.95494699999108,166.16513754927664,0
"147.32.84.165",1178,"217.163.21.34",80,14,6137,7,809,7,5328,86040.19242,0.24187999998684973,26757.06962275452,176219.61304083568
"147.32.84.165",4458,"203.188.197.119",25,3,186,3,186,0,0,86040.238388,8.982585999998264,165.65385513707162,0
"147.32.84.165",3207,"174.128.246.102",80,7,550,5,428,2,122,86040.238419,3.303805999996257,1036.3804654401254,295.4168616441479
"147.32.84.165",1187,"217.163.21.41",80,13,5864,7,2751,6,3113,86040.238443,0.1691560000035679,130104.75537099363,147225.04669934686
"147.32.84.165",4463,"205.188.103.1",25,3,186,3,186,0,0,86040.284298,8.936734999995679,166.50376228015259,0
"147.32.84.165",3208,"174.37.196.55",80,3,186,3,186,0,0,86040.284356,8.936705000000075,166.5043212235368,0
"147.32.84.165",4466,"64.12.139.193",25,3,186,3,186,0,0,86040.284406,8.93668099999195,166.50476838116302,0
"147.32.84.165",3209,"31.192.109.161",80,10,1174,5,540,5,634,86043.20173,0.2444649999961257,17671.24128226316,20747.346246212674
"147.32.84.165",1191,"46.4.36.120",443,6,366,3,186,3,180,86043.280679,1.0536169999977574,1412.2778960506212,1366.720544565117
"147.32.84.165",1188,"92.240.244.181",80,10,1760,6,1366,4,394,86044.334536,11.653999000001932,937.7038731510264,270.465099576504
"147.32.84.165",4470,"209.191.88.254",25,3,186,3,186,0,0,86044.343032,8.991242999996757,165.4943593450357,0
"147.32.84.165",3210,"174.37.196.55",80,3,186,3,186,0,0,86044.343089,8.991309000004549,165.4931445465001,0
"147.32.84.165",1189,"173.241.240.4",80,9,2195,5,1165,4,1030,86044.343137,0.06975199999578763,133616.24040260984,118132.81340316578
"147.32.84.165",4471,"64.12.139.193",25,3,186,3,186,0,0,86044.359486,8.97497700000531,165.79429674294647,0
"147.32.84.165",3211,"193.23.181.44",179,10,812,5,512,5,300,86044.359546,0.20017399999778718,20462.19788806378,11989.56907503737
"147.32.84.165",1190,"217.163.21.34",80,10,1448,5,699,5,749,86044.425037,0.13996700001007412,39952.27446181969,42810.090946928394
"147.32.84.165",4474,"209.191.88.254",25,3,186,3,186,0,0,86044.470999,8.964650000008987,165.98528665352336,0
"147.32.84.165",3212,"193.23.181.44",179,10,786,5,486,5,300,86044.471071,0.1853839999967022,20972.683727124044,12946.101066125953
"147.32.84.165",1195,"184.82.147.251",80,10,1906,5,978,5,928,86044.471139,0.32331300000078045,24199.459965980685,22962.268761175947
"147.32.84.165",4475,"64.12.90.65",25,3,186,3,186,0,0,86044.577598,8.956751999998232,166.1316512950558,0
"147.32.84.165",3213,"193.23.181.44",80,8,856,5,472,3,384,86045.208389,0.13394399998651352,28190.885746134176,22934.957895160005
"147.32.84.165",1199,"217.163.21.41",80,11,3862,6,2234,5,1628,86045.269997,0.25901900000462774,68998.79931464753,50282.02564200814
"147.32.84.165",4476,"69.175.13.98",7691,7,424,4,242,3,182,86045.315926,0.48299499999848194,4008.323067539177,3014.5239598848357
"147.32.84.165",3214,"67.19.72.206",80,3,186,3,186,0,0,86045.450984,8.986797999998089,165.57621524377385,0
"147.32.84.165",1206,"46.4.36.120",443,6,366,3,186,3,180,86045.451043,0.9888730000093346,1504.7432784452137,1456.2031726889165
"147.32.84.165",1201,"184.82.147.252",80,10,1508,5,596,5,912,86045.609322,0.3048149999958696,15642.27482264524,23935.82992995379
"147.32.84.165",4477,"184.154.10.50",8339,7,424,4,242,3,182,86045.709902,0.5145150000025751,3762.76687752604,2829.8494698749555
"147.32.84.165",3215,"193.23.181.44",80,8,832,5,446,3,386,86045.850122,0.1286089999921387,27743.00399053018,24010.761301221188
"147.32.84.165",1207,"217.163.21.34",80,10,2274,5,1154,5,1120,86045.913895,0.139417999991565,66218.13539541917,64267.167801446674
"147.32.84.165",4478,"208.65.144.2",25,3,186,3,186,0,0,86045.959821,8.979382999998052,165.71294486495597,0
"147.32.84.165",3216,"174.37.196.55",80,3,186,3,186,0,0,86046.440153,9.000785999989603,165.31889548331878,0
"147.32.84.165",1208,"217.163.21.34",80,13,6081,6,750,7,5331,86046.440226,0.18858399998862296,31816.060749384742,226148.55980662676
"147.32.84.165",4479,"68.6.19.3",25,3,186,3,186,0,0,86046.48625,8.954813000003924,166.16762404746453,0
"147.32.84.165",3217,"72.20.15.61",80,3,186,3,186,0,0,86047.114366,9.028709999998682,164.8075970986129,0
"147.32.84.165",1212,"118.136.111.104",6667,1,62,1,62,0,0,86053.234039,0,0,0
"147.32.84.165",1216,"46.4.36.120",443,6,366,3,186,3,180,86055.139589,1.0307990000001155,1443.5403992435317,1396.9745799130953
"147.32.84.165",1210,"217.163.21.41",80,13,5860,7,2749,6,3111,86055.942214,0.17169400000420865,128088.34321211529,144955.56047031307
"147.32.84.165",4480,"205.188.190.1",25,3,186,3,186,0,0,86055.988183,8.983975000010105,165.6282436224863,0
"147.32.84.165",3218,"174.128.246.102",80,9,840,6,656,3,184,86056.170624,3.380232999988948,1552.5556966094227,435.47293929288685
"147.32.84.165",1218,"94.100.176.20",25,3,186,3,186,0,0,86056.170682,9.002126999999746,165.29426878781447,0
"147.32.84.165",1213,"217.163.21.34",80,10,1451,5,701,5,750,86057.246713,0.13957400000072084,40179.40304047342,42987.94904472905
"147.32.84.165",4484,"209.191.88.254",25,3,186,3,186,0,0,86057.293101,8.983351000002585,165.6397484635268,0
"147.32.84.165",3219,"67.19.72.206",80,3,186,3,186,0,0,86060.6572,9.032384999998612,164.740541949909,0
"147.32.84.165",1230,"178.122.89.175",6667,1,62,1,62,0,0,86061.26043,0,0,0
"147.32.84.165",1233,"46.4.36.120",443,6,366,3,186,3,180,86063.266033,1.0316369999927701,1442.3678096175574,1395.8398157589265
"147.32.84.165",1223,"184.82.147.251",80,10,1906,5,978,5,928,86064.297884,0.34002099999634083,23010.343479032763,21833.945550656852
"147.32.84.165",4499,"81.169.145.102",25,3,186,3,186,0,0,86064.410215,8.891872000007425,167.34383940735512,0
"147.32.84.165",3220,"193.23.181.44",179,10,742,5,442,5,300,86065.574366,0.21677199999976438,16312.069824533812,11071.540604887203
"147.32.84.165",1248,"46.4.36.120",443,6,366,3,186,3,180,86065.646055,0.9589779999951134,1551.6518627200858,1501.5985768258895
"147.32.84.165",1227,"92.240.244.181",80,10,1758,6,1364,4,394,86066.605301,7.827995999992709,1393.97107510149,402.6573340102545
"147.32.84.165",4502,"67.134.69.73",25,3,186,3,186,0,0,86066.61398,8.895389000012074,167.27767610814774,0
"147.32.84.165",3223,"174.37.196.55",80,3,186,3,186,0,0,86066.978353,8.931586000006064,166.59975059289468,0
"147.32.84.165",1253,"109.201.233.98",6667,2,124,2,124,0,0,86067.480501,2.9108740000083344,340.79111634414943,0
"147.32.84.165",1256,"46.4.36.120",443,6,366,3,186,3,180,86068.182621,1.03137300000526,1442.7370117236064,1396.197108119619
"147.32.84.165",1228,"173.241.240.4",80,9,2194,5,1164,4,1030,86069.214226,0.06772800000908319,137491.14101628782,121663.12306424095
"147.32.84.165",4504,"209.191.88.254",25,3,186,3,186,0,0,86069.230453,8.887163999999757,167.4324902747424,0
"147.32.84.165",3222,"193.23.181.44",179,10,783,5,483,5,300,86069.230512,0.1975630000088131,19558.31810525063,12148.023667857535
"147.32.84.165",1234,"217.163.21.41",80,13,5289,7,2296,6,2993,86069.293341,0.2400060000072699,76531.42004551397,99764.1725593307
"147.32.84.165",4505,"64.12.90.65",25,3,186,3,186,0,0,86069.339283,8.878571000008378,167.59453745412364,0
"147.32.84.165",3224,"67.19.72.206",80,3,186,3,186,0,0,86073.301908,9.030984000011813,164.76609857774676,0
"147.32.84.165",1260,"46.4.36.120",443,6,366,3,186,3,180,86073.302036,1.030259000006481,1444.297016566358,1397.7067902255078
"147.32.84.165",1246,"184.82.147.252",80,10,1508,5,596,5,912,86074.33253,0.3074939999933122,15505.99361322075,23727.292240364637
"147.32.84.165",4506,"65.54.188.72",25,3,186,3,186,0,0,86074.432996,9.00412199999846,165.25764533179964,0
"147.32.84.165",1267,"173.192.170.88",80,16,4013,8,703,8,3310,86076.913306,38.37424599999213,146.55662550349925,690.046131460288
"147.32.84.165",3225,"193.23.181.44",80,9,950,5,506,4,444,86077.113936,0.13446500001009554,30104.488154509196,26415.79593004364
"147.32.84.165",1269,"196.218.117.248",6667,2,124,2,124,0,0,86077.114266,3.009141999995336,329.66207643292927,0
"147.32.84.165",1268,"46.4.36.120",443,6,366,3,186,3,180,86077.18072,0.96418999999878,1543.2642943837654,1493.4815752100956
"147.32.84.165",1263,"184.82.147.251",80,10,1925,5,990,5,935,86078.145118,0.32312099999398924,24510.941721978234,23149.22273742389
"147.32.84.165",4509,"66.94.237.64",25,3,186,3,186,0,0,86078.217993,9.033293000000413,164.72398271593008,0
"147.32.84.165",3226,"174.37.196.55",80,3,186,3,186,0,0,86078.251896,8.999528000000282,165.34200460290288,0
"147.32.84.165",1272,"74.125.93.27",25,3,186,3,186,0,0,86078.251957,8.999532000001636,165.3419311137212,0
"147.32.84.165",1266,"217.163.21.34",80,13,6078,6,750,7,5328,86081.730274,0.1870950000011362,32069.269622189597,227820.0913960349
"147.32.84.165",4512,"205.188.103.1",25,3,186,3,186,0,0,86081.776092,8.988878999996814,165.53788297745774,0
"147.32.84.165",3227,"67.19.72.206",80,3,186,3,186,0,0,86083.33777,9.031992000003811,164.7477101396206,0
"147.32.84.165",1277,"46.4.36.120",443,6,366,3,186,3,180,86085.34287,1.0316660000098636,1442.3272648180453,1395.8005788561727
"147.32.84.165",1275,"184.82.147.252",80,10,1515,5,603,5,912,86086.374796,0.34070999998948537,14158.66866293585,21414.10583847014
"147.32.84.165",4521,"209.191.88.254",25,3,186,3,186,0,0,86086.486991,8.9926989999949,165.46756429864314,0
"147.32.84.165",3228,"193.23.181.44",80,8,892,5,508,3,384,86087.552345,0.12537300000258256,32415.27282521983,24502.88339544176
"147.32.84.165",1290,"117.204.65.119",6667,2,124,2,124,0,0,86087.614545,2.950083999996423,336.26161153418104,0
"147.32.84.165",1293,"46.4.36.120",443,6,366,3,186,3,180,86087.953986,1.0329670000064652,1440.5106842626017,1394.0425976734855
"147.32.84.165",1283,"217.163.21.34",80,10,1449,5,700,5,749,86088.987194,0.13873099999909755,40365.88794167438,43191.50009759158
"147.32.84.165",4524,"203.188.197.119",25,3,186,3,186,0,0,86089.032896,8.95536799999536,166.1573259748534,0
"147.32.84.165",3229,"67.19.72.206",80,3,186,3,186,0,0,86090.263062,9.029850000006263,164.78679047813284,0
"147.32.84.165",1301,"46.4.36.120",443,6,366,3,186,3,180,86090.263203,1.0304210000031162,1444.0699481042216,1397.4870465524723
"147.32.84.165",1288,"184.82.147.251",80,10,1926,5,998,5,928,86091.293843,0.327659999995376,24366.721602004127,22657.632912484798
"147.32.84.165",1298,"208.73.210.29",80,52,36134,23,3432,29,32702,86091.401718,17.762851000006776,1545.69781618894,14728.266312648808
"147.32.84.165",4525,"68.6.19.3",25,3,186,3,186,0,0,86091.590109,9.00706899999932,165.20357510307875,0
"147.32.84.165",3230,"193.23.181.44",80,8,830,5,446,3,384,86093.372732,0.1286779999936698,27728.12757561918,23873.544818470324
"147.32.84.165",1307,"46.4.36.120",443,6,366,3,186,3,180,86093.436757,0.9670039999909932,1538.7733659983408,1489.1355154822652
"147.32.84.165",1291,"217.163.21.34",80,14,6141,7,810,7,5331,86094.403975,0.1893700000073295,34218.72524554678,225209.906523469
"147.32.84.165",1308,"74.125.232.218",80,8,1905,5,1031,3,874,86094.450006,14.714789999998175,560.5244791125815,475.1681811293853
"147.32.84.165",4527,"64.12.90.65",25,3,186,3,186,0,0,86094.458296,8.847177000003285,168.18924273804487,0
"147.32.84.165",3231,"193.23.181.44",80,9,912,5,468,4,444,86095.479827,0.1339049999951385,27960.120982307817,26526.26862424075
"147.32.84.165",1317,"46.4.36.120",443,6,366,3,186,3,180,86095.546291,0.9636959999916144,1544.0553867744059,1494.2471484913606
"147.32.84.165",1299,"217.163.21.41",80,11,3864,6,2235,5,1629,86096.510217,0.24316199999884702,73531.22609653145,53593.90036297527
"147.32.84.165",1314,"67.214.158.5",80,10,1710,5,855,5,855,86096.556215,0.3295819999912055,20753.560571216014,20753.560571216014
"147.32.84.165",4530,"209.191.88.254",25,3,186,3,186,0,0,86096.659678,8.852997000009054,168.0786743741671,0
"147.32.84.165",3232,"174.37.196.55",80,7,577,4,395,3,182,86096.659739,0.24246100000164006,13033.023867667893,6005.089478267232
"147.32.84.165",1320,"115.98.215.108",6667,2,124,2,124,0,0,86096.780691,2.913574999998673,340.47518941522077,0
"147.32.84.165",1325,"46.4.36.120",443,6,366,3,186,3,180,86099.29305,1.0301570000010543,1444.4400222475576,1397.8451828202171
"147.32.84.165",1303,"184.82.147.252",80,10,1508,5,596,5,912,86099.293116,0.3419270000013057,13944.496924728941,21337.887911665763
"147.32.84.165",1315,"50.22.198.84",80,8,2186,5,1158,3,1028,86099.405912,0.37550399999599904,24670.84238809362,21901.231411882767
"147.32.84.165",4531,"209.191.88.254",25,3,186,3,186,0,0,86099.526865,8.896815999993123,167.25084569593776,0
"147.32.84.165",3233,"67.19.72.206",80,3,186,3,186,0,0,86099.526923,8.89687799999956,167.24968016871463,0
"147.32.84.165",1327,"74.125.39.27",25,3,186,3,186,0,0,86099.526981,8.896884999994654,167.24954857805784,0
"147.32.84.165",1313,"217.163.21.34",80,10,1451,5,701,5,750,86100.323438,0.13971099999616854,40140.00329361178,42945.79524994127
"147.32.84.165",1316,"195.113.232.83",80,8,1359,5,771,3,588,86100.369416,8.795257000005222,701.2870687003618,534.8337177637001
"147.32.84.165",4533,"66.76.67.68",25,3,186,3,186,0,0,86100.370257,8.855507999993279,168.03101527333376,0
"147.32.84.165",3234,"193.23.181.44",179,10,781,5,481,5,300,86102.70357,0.19877200000337325,19358.863421078913,12074.135189862109
"147.32.84.165",1333,"46.4.36.120",443,6,366,3,186,3,180,86102.768789,0.9671960000123363,1538.467901005609,1488.8399041989765
"147.32.84.165",1321,"217.163.21.34",80,10,2275,5,1155,5,1120,86103.406211,0.13936100000864826,66302.62411597648,64293.45368821961
"147.32.84.165",1323,"67.214.158.5",80,10,1773,5,877,5,896,86103.45203,0.3323149999923771,21112.49868396232,21569.896032873705
"147.32.84.165",4537,"203.188.197.119",25,3,186,3,186,0,0,86103.555391,8.980788000000757,165.68701989178172,0
"147.32.84.165",3235,"174.37.196.55",80,3,186,3,186,0,0,86103.555422,8.980881999988924,165.68528569931496,0
"147.32.84.165",1329,"184.82.147.251",80,10,1921,5,986,5,935,86103.736202,0.3266100000037113,24151.128256668097,22901.931967530094
"147.32.84.165",1330,"50.22.198.84",80,9,1790,5,1210,4,580,86103.844148,0.3841779999929713,25196.65363497415,12077.734800235543
"147.32.84.165",4538,"205.188.103.1",25,3,186,3,186,0,0,86103.964793,8.97255099999893,165.8391242357026,0
"147.32.84.165",3236,"193.23.181.44",80,8,861,5,477,3,384,86104.309106,0.12599099999351893,30287.87770710843,24382.694003206783
"147.32.84.165",1331,"217.163.21.34",80,13,6081,6,750,7,5331,86104.372062,0.19132600000011735,31360.0869719553,222907.49819665827
"147.32.84.165",1337,"68.67.185.210",80,8,1464,5,584,3,880,86104.417876,4.747026999990339,984.194949809535,1483.033486014368
"147.32.84.165",4539,"208.65.144.3",25,3,186,3,186,0,0,86104.441823,8.996979999996256,165.38883047429462,0
"147.32.84.165",3237,"193.23.181.44",80,8,859,5,473,3,386,86107.42015,0.14205399999627843,26637.757473208316,21738.212229721797
"147.32.84.165",1345,"42.201.166.157",6667,2,124,2,124,0,0,86107.490664,2.9386369999992894,337.57146595521664,0
"147.32.84.165",1344,"46.4.36.120",443,6,366,3,186,3,180,86109.927298,1.030815000005532,1443.5179930365919,1396.9528964870244
"147.32.84.165",1332,"217.163.21.41",80,11,3866,6,2236,5,1630,86110.958351,0.22348000000056345,80042.95686394711,58349.74046879865
"147.32.84.165",4540,"209.191.88.254",25,3,186,3,186,0,0,86111.004304,8.955648999995901,166.1521124823763,0
"147.32.84.165",3238,"72.20.15.61",80,3,186,3,186,0,0,86112.536444,9.029057000007015,164.80126329901827,0
"147.32.84.165",1354,"46.4.36.120",443,6,366,3,186,3,180,86113.438681,1.0304829999950016,1443.9830642593984,1397.402965412321
"147.32.84.165",1335,"217.163.21.41",80,13,5863,7,2750,6,3113,86114.469404,0.15652099999715574,140556.21929581193,159109.6402428591
"147.32.84.165",4543,"68.6.19.3",25,3,186,3,186,0,0,86114.515227,8.957099000006565,166.12521531791816,0
"147.32.84.165",1363,"173.192.170.88",80,11,1099,6,542,5,557,86115.344961,49.60462500000722,87.4112040963795,89.83033336103945
"147.32.84.165",3239,"72.20.15.61",80,3,186,3,186,0,0,86115.545962,9.029234000001452,164.79803270130785,0
"147.32.84.165",1364,"46.4.36.120",443,6,366,3,186,3,180,86115.545987,1.029869999998482,1444.8425529457052,1398.234728657134
"147.32.84.165",1339,"184.82.147.252",80,10,1515,5,603,5,912,86116.576093,0.32217500000842847,14973.228834868623,22646.07744179135
"147.32.84.165",4554,"203.188.197.119",25,3,186,3,186,0,0,86116.682662,8.997297999987495,165.38298498083182,0
"147.32.84.165",3240,"174.37.196.55",80,3,186,3,186,0,0,86120.460978,9.031222999998135,164.7617382496598,0
"147.32.84.165",1366,"61.17.216.21",6667,2,124,2,124,0,0,86120.46108,3.0112020000087796,329.43655058581516,0
"147.32.84.165",1368,"46.4.36.120",443,6,366,3,186,3,180,86121.265149,1.029936999999336,1444.7485622916347,1398.1437699596465
"147.32.84.165",1342,"217.163.21.34",80,10,1451,5,701,5,750,86122.295314,0.13983600000210572,40104.12197084836,42907.405817598104
"147.32.84.165",4556,"209.191.88.254",25,3,186,3,186,0,0,86122.341895,8.957018000000971,166.12671761961835,0
"147.32.84.165",3241,"174.128.246.102",80,3,186,3,186,0,0,86122.341926,8.957200000004377,166.1233421157586,0
"147.32.84.165",1371,"66.111.4.71",25,3,186,3,186,0,0,86123.472108,8.930418000003556,166.6215399995171,0
"147.32.84.165",1352,"217.163.21.34",80,10,2277,5,1156,5,1121,86124.575298,0.14032000000588596,65906.49942711001,63911.06043061447
"147.32.84.165",4558,"65.54.188.126",25,3,186,3,186,0,0,86124.621131,8.884919999996782,167.4747774882091,0
"147.32.84.165",3242,"174.128.246.102",80,6,505,4,383,2,122,86124.977028,0.3431740000087302,8928.415322612007,2844.0383011975587
"147.32.84.165",1379,"46.4.36.120",443,6,366,3,186,3,180,86124.977154,1.0315210000117077,1442.5300114909064,1395.9967853137805
"147.32.84.165",1355,"184.82.147.251",80,10,1926,5,998,5,928,86125.478557,0.3407160000060685,23433.005787394184,21789.408187075955
"147.32.84.165",4560,"205.188.190.1",25,3,186,3,186,0,0,86125.591287,8.918099000002258,166.85170236388083,0
"147.32.84.165",3243,"174.128.246.102",80,13,1208,9,962,4,246,86126.008879,21.20514700000058,362.9307545003008,92.80765655620998
"147.32.84.165",1361,"173.241.240.4",80,9,2194,5,1164,4,1030,86126.00894,0.0697130000044126,133576.23397946695,118198.90120176201
"147.32.84.165",4563,"209.191.88.254",25,3,186,3,186,0,0,86126.025388,8.884771000011824,167.47758608500092,0
"147.32.84.165",3244,"193.23.181.44",80,8,867,5,481,3,386,86126.025446,0.14178200000606012,27140.25757737602,21779.915644214438
"147.32.84.165",1362,"92.240.244.181",80,10,1759,6,1365,4,394,86126.095946,7.456430999998702,1464.5076176527216,422.7223453151446
"147.32.84.165",4565,"74.208.5.90",25,3,186,3,186,0,0,86126.104514,8.90570299999672,167.08394609617545,0
"147.32.84.165",3245,"72.20.15.61",80,3,186,3,186,0,0,86132.000883,8.929908000005526,166.6310559973383,0
"147.32.84.165",1386,"196.46.196.3",6667,1,62,1,62,0,0,86132.000952,0,0,0
"147.32.84.165",1387,"46.4.36.120",443,6,366,3,186,3,180,86133.50595,1.030782999994699,1443.5628061460584,1396.9962640123144
"147.32.84.165",1373,"217.163.21.34",80,14,6141,7,810,7,5331,86133.506083,0.18897699999797624,34289.88712948874,225678.25714482038
"147.32.84.165",4568,"205.188.103.1",25,3,186,3,186,0,0,86133.552078,8.98324900001171,165.64162921433663,0
"147.32.84.165",3246,"193.23.181.44",179,11,836,5,476,6,360,86134.536972,0.1969939999980852,19330.5379861164,14619.734611348538
"147.32.84.165",1374,"217.163.21.41",80,11,3866,6,2236,5,1630,86134.599032,0.23530800000298768,76019.51484765872,55416.730412202014
"147.32.84.165",4569,"64.12.139.193",25,3,186,3,186,0,0,86134.64504,8.99480699999549,165.42878574278984,0
"147.32.84.165",3247,"174.128.246.102",80,17,1530,12,1222,5,308,86135.4128,93.27321899999515,104.81036362646076,26.41701472745492
"147.32.84.165",1401,"212.117.171.138",65500,33,9772,17,5468,16,4304,86135.412937,119.1410179999948,367.1615429708844,289.00206308461713
"147.32.84.165",1382,"217.163.21.41",80,13,5864,7,2751,6,3113,86135.413002,0.16318600000522565,134864.51043162553,152611.1308519267
"147.32.84.165",4571,"207.115.36.22",25,3,186,3,186,0,0,86135.459029,8.983673999988241,165.63379303411364,0
"147.32.84.165",3248,"193.23.181.44",80,8,827,5,441,3,386,86137.620075,0.12538199999835342,28138.01024107393,24628.734587425253
"147.32.84.165",1406,"115.148.196.99",6667,2,124,2,124,0,0,86137.682337,2.9473119999893242,336.57787163476183,0
"147.32.84.165",1404,"46.4.36.120",443,6,366,3,186,3,180,86143.238828,1.0308769999974174,1443.4311755948845,1396.8688796079527
"147.32.84.165",1384,"184.82.147.252",80,10,1507,5,596,5,911,86143.539426,0.32311399999889545,14756.401765371662,22555.506725257692
"147.32.84.165",4572,"209.191.88.254",25,3,186,3,186,0,0,86143.646095,9.024053000001004,164.89264856931075,0
"147.32.84.165",3249,"193.23.181.44",80,8,830,5,446,3,384,86144.269931,0.12288599999737926,29035.040607360424,24998.779357009873
"147.32.84.165",1411,"98.126.71.122",80,9,4080,6,707,3,3373,86144.331009,14.316875000004075,395.0582791285382,1884.7688479498718
"147.32.84.165",1394,"217.163.21.34",80,10,1451,5,701,5,750,86144.442767,0.13916099999914877,40298.64689125763,43115.52805769361
"147.32.84.165",4573,"74.125.45.27",25,3,186,3,186,0,0,86144.488641,8.98381099999824,165.63126717606718,0
"147.32.84.165",3250,"193.23.181.44",80,8,810,5,424,3,386,86144.506139,0.13800999999511987,24577.92913643898,22375.190204399638
"147.32.84.165",1424,"216.157.130.15",25,3,186,3,186,0,0,86144.574745,8.9994069999957,165.34422768085844,0
"147.32.84.165",1395,"184.82.147.251",80,10,1909,5,990,5,919,86145.547408,0.30852900000172667,25670.19631851682,23829.20244112824
"147.32.84.165",4574,"207.115.36.22",25,3,186,3,186,0,0,86145.649135,9.028474999999162,164.81188683583198,0
"147.32.84.165",3251,"67.19.72.206",80,3,186,3,186,0,0,86145.649202,9.028531000003568,164.81086458023037,0
"147.32.84.165",1429,"95.100.248.97",80,11,4447,6,1393,5,3054,86146.550167,12.097950000010314,921.147797766605,2019.5157030719395
"147.32.84.165",1432,"93.180.230.38",6667,6,366,3,186,3,180,86146.551148,1.3384289999958128,1111.7511649886958,1075.8882241826088
"147.32.84.165",1430,"46.4.36.120",443,6,366,3,186,3,180,86147.052601,1.030903999999282,1443.3933712557487,1396.832294763628
"147.32.84.165",1398,"217.163.21.34",80,9,2217,5,1156,4,1061,86147.889686,0.8624840000120457,10722.517750904179,9841.341984177625
"147.32.84.165",4576,"206.46.232.11",25,3,186,3,186,0,0,86147.935453,8.949036000005435,166.27489262520524,0
"147.32.84.165",3252,"67.19.72.206",80,3,186,3,186,0,0,86148.083648,9.001761000006809,165.30098943960792,0
"147.32.84.165",1433,"195.113.232.83",80,17,17995,12,1184,5,16811,86148.083686,10.564618000003975,896.5776140695704,12730.039079496239
"147.32.84.165",1402,"173.241.240.4",80,9,2195,5,1165,4,1030,86148.08437,0.06704500000341795,139011.11193265519,122902.52814646767
"147.32.84.165",4584,"64.12.90.65",25,3,186,3,186,0,0,86148.100604,8.984919999988051,165.61082346887662,0
"147.32.84.165",3253,"174.37.196.55",80,9,723,6,541,3,182,86153.574029,9.284035000004224,466.1766139397397,156.82836180597528
"147.32.84.165",1435,"195.113.232.81",80,8,2617,5,762,3,1855,86154.57737,4.0711279999959515,1497.3737008529483,3645.181384622335
"147.32.84.165",1443,"83.17.186.77",6667,2,124,2,124,0,0,86154.578217,3.008134000003338,329.7725433770235,0
"147.32.84.165",1440,"46.4.36.120",443,6,366,3,186,3,180,86155.680581,1.031380000000354,1442.7272198408825,1396.18763210408
"147.32.84.165",1452,"184.82.147.251",80,10,1886,5,958,5,928,86156.483423,0.3435940000053961,22305.395320871838,21606.896511241197
"147.32.84.165",1403,"92.240.244.181",80,10,1760,6,1366,4,394,86156.596444,4.265796000006958,2561.772761750017,738.9007819396096
"147.32.84.165",4585,"205.188.190.1",25,3,186,3,186,0,0,86156.604978,8.915007000003243,166.90957169180672,0
"147.32.84.165",3254,"193.23.181.44",179,10,742,5,442,5,300,86156.712229,0.19163200000184588,18452.033063193725,12524.004341534202
"147.32.84.165",1447,"74.125.232.217",80,8,1293,5,578,3,715,86156.774969,1.8737120000005234,2467.828567036294,3052.763711818253
"147.32.84.165",1456,"184.82.147.252",80,10,1507,5,596,5,911,86156.783119,0.34225400000286754,13931.173923343633,21294.126584171223
"147.32.84.165",1425,"217.163.21.34",80,14,6137,7,809,7,5328,86156.895799,0.18816099999821745,34396.075701454145,226529.40832799464
"147.32.84.165",4586,"207.115.36.22",25,3,186,3,186,0,0,86156.941727,8.869917999996687,167.7580333888719,0
"147.32.84.165",3255,"174.37.196.55",80,8,661,5,479,3,182,86162.736546,3.1172780000051716,1229.2775941041007,467.07415892890674
"147.32.84.165",1467,"119.63.45.53",6667,2,124,2,124,0,0,86162.736608,2.8747739999962505,345.07060381139314,0
"147.32.84.165",1462,"46.4.36.120",443,6,366,3,186,3,180,86164.618101,1.0205520000017714,1458.0344754578084,1411.0011052817501
"147.32.84.165",1461,"217.163.21.37",80,14,6134,7,809,7,5325,86165.419203,0.18898600000829902,34245.92297691783,225413.5226849041
"147.32.84.165",4589,"209.191.88.254",25,3,186,3,186,0,0,86165.465407,8.97539800000959,165.78651999592776,0
"147.32.84.165",1473,"173.192.170.88",80,7,860,4,423,3,437,86165.520119,6.918377000009059,489.132060885894,505.32082885847683
"147.32.84.165",3256,"67.19.72.206",80,3,186,3,186,0,0,86165.638877,9.002999999996973,165.27824058652675,0
"147.32.84.165",1474,"184.82.147.251",80,10,1906,5,978,5,928,86165.638908,0.30407700000796467,25730.324884141406,24414.86860172109
"147.32.84.165",4590,"72.4.117.21",25,3,186,3,186,0,0,86165.720927,9.021827999997186,164.93331506657677,0
"147.32.84.165",3257,"72.20.15.61",80,3,186,3,186,0,0,86165.739475,9.00340000000142,165.2708976608576,0
"147.32.84.165",1475,"217.163.21.37",80,10,1446,5,698,5,748,86166.614742,0.13935399999900255,40070.61153637476,42940.99918224688
"147.32.84.165",4592,"218.102.53.138",25,3,186,3,186,0,0,86166.660665,8.986078000001726,165.58948186291218,0
"147.32.84.165",3258,"67.19.72.206",80,3,186,3,186,0,0,86168.322405,9.029240999996546,164.79790494024573,0
"147.32.84.165",1482,"46.4.36.120",443,6,366,3,186,3,180,86168.82337,1.030429999998887,1444.0573352887698,1397.4748406020353
"147.32.84.165",1478,"184.82.147.252",80,10,1508,5,596,5,912,86169.02407,0.36447400000179186,13081.865921784707,20017.88879306653
"147.32.84.165",4595,"209.191.88.254",25,3,186,3,186,0,0,86169.136337,9.017219999994268,165.0175996594234,0
"147.32.84.165",3259,"193.23.181.44",179,11,837,5,477,6,360,86169.136373,0.20685299999604467,18447.88327978307,13922.93077719477
"147.32.84.165",1483,"217.163.21.40",80,11,3860,6,2233,5,1627,86169.200382,0.23200100001122337,76999.66810115389,56103.20644898226
"147.32.84.165",4602,"64.12.90.65",25,3,186,3,186,0,0,86169.246455,9.007849999994505,165.18925159731876,0
"147.32.84.165",3260,"174.37.196.55",80,3,186,3,186,0,0,86169.854048,9.002425000013318,165.28879718495836,0
"147.32.84.165",1493,"178.123.248.251",6667,1,62,1,62,0,0,86177.552541,0,0,0
"147.32.84.165",1492,"46.4.36.120",443,6,366,3,186,3,180,86177.852599,1.031407999995281,1442.6880536187502,1396.149729308468
"147.32.84.165",1489,"217.163.21.37",80,13,6081,6,750,7,5331,86177.852736,0.18821500000194646,31878.436893647955,226591.92944004966
"147.32.84.165",4604,"64.12.139.193",25,3,186,3,186,0,0,86177.898753,8.982892999993055,165.64819373904936,0
"147.32.84.165",3261,"67.19.72.206",80,3,186,3,186,0,0,86178.884211,9.051759000009042,164.38793830000483,0
"147.32.84.165",1490,"217.163.21.37",80,10,2272,5,1153,5,1119,86178.884271,0.13900500000454485,66357.32527389961,64400.561128788955
"147.32.84.165",4606,"66.94.236.34",25,3,186,3,186,0,0,86178.930193,9.008995000011055,165.1682568364367,0
"147.32.84.165",3262,"193.23.181.44",179,11,841,5,481,6,360,86186.480661,0.18802400000276975,20465.472492571775,15317.19354953397
"147.32.84.165",1509,"61.17.216.6",6667,1,62,1,62,0,0,86186.542623,0,0,0
"147.32.84.165",1506,"46.4.36.120",443,6,366,3,186,3,180,86186.781102,1.0314740000030724,1442.5957416237034,1396.060395119713
"147.32.84.165",1499,"184.82.147.251",80,10,1906,5,978,5,928,86186.781236,0.30639300000621006,25535.83143166267,24230.31857728319
"147.32.84.165",4608,"209.191.88.254",25,3,186,3,186,0,0,86186.881809,9.029869999998482,164.7864254967403,0
"147.32.84.165",3263,"193.23.181.44",179,10,781,5,481,5,300,86187.684004,0.19725800000014715,19507.44709972285,12166.806922904063
"147.32.84.165",1501,"217.163.21.37",80,10,1451,5,701,5,750,86187.749654,0.13964900000428315,40157.82425816152,42964.86190245526
"147.32.84.165",4609,"165.212.8.32",25,3,186,3,186,0,0,86187.796098,8.91775599999528,166.85811991276591,0
"147.32.84.165",3265,"193.23.181.44",80,10,983,6,537,4,446,86187.812763,0.18078200001036748,23763.42777352631,19736.478188068406
"147.32.84.165",1504,"217.163.21.40",80,13,5859,7,2748,6,3111,86187.812823,0.17874299999675713,122992.22906854449,139239.01915292646
"147.32.84.165",4611,"64.12.90.65",25,3,186,3,186,0,0,86187.858763,8.855191000009654,168.03703048284083,0
"147.32.84.165",3264,"174.37.196.55",80,3,186,3,186,0,0,86187.858821,8.855148999995436,168.0378274832831,0
"147.32.84.165",1517,"184.82.147.252",80,10,1507,5,596,5,911,86187.858877,0.3568599999998696,13360.98189766783,20422.574679153346
"147.32.84.165",4612,"65.54.188.110",25,3,186,3,186,0,0,86187.932767,8.881710999994539,167.53528683841603,0
"147.32.84.165",3266,"193.23.181.44",179,10,728,5,428,5,300,86187.959269,0.27704200000152923,12359.136881704218,8662.9464124095
"147.32.84.165",1519,"217.163.21.40",80,11,3866,6,2236,5,1630,86187.959299,0.34300200000870973,52151.29940800863,38017.27103535513
"147.32.84.165",4613,"205.188.103.1",25,3,186,3,186,0,0,86187.959324,8.85527600000205,168.03541752957847,0
"147.32.84.165",3267,"193.23.181.44",80,8,836,5,452,3,384,86189.391028,0.12296200000855606,29407.45921299579,24983.328180952172
"147.32.84.165",1527,"46.4.36.120",443,6,366,3,186,3,180,86189.452151,0.9695289999945089,1534.7658502308107,1485.2572744169133
"147.32.84.165",1521,"92.240.244.181",80,10,1757,6,1363,4,394,86190.293918,9.576897000006284,1138.5733813356085,329.12539416451193
"147.32.84.165",4614,"68.1.17.3",25,3,186,3,186,0,0,86190.302421,8.91954899999837,166.82457823823515,0
"147.32.84.165",3268,"193.23.181.44",179,10,783,5,483,5,300,86190.421918,0.19164200000523124,20162.594837741857,12523.350830895562
"147.32.84.165",1522,"173.241.240.4",80,9,2193,5,1163,4,1030,86190.484704,0.07096799999999348,131101.3414496795,116108.66869576086
"147.32.84.165",4615,"209.191.88.254",25,3,186,3,186,0,0,86190.501096,8.921288999990793,166.79204092609663,0
"147.32.84.165",3269,"72.20.15.61",80,3,186,3,186,0,0,86190.501155,8.921363999994355,166.79063874099762,0
"147.32.84.165",1524,"217.163.21.37",80,14,6137,7,809,7,5328,86190.896285,0.1884120000031544,34350.25369876465,226227.62880966387
"147.32.84.165",4616,"46.4.35.23",25,3,186,3,186,0,0,86190.942308,8.88212399999611,167.5274968015141,0
"147.32.84.165",3270,"193.23.181.44",80,8,831,5,445,3,386,86197.918222,0.13426400000753347,26514.925816304076,22999.463741782864
"147.32.84.165",1532,"59.48.7.168",6667,6,366,3,186,3,180,86197.985128,1.9768710000062129,752.7046529567805,728.4238577001101
"147.32.84.165",1536,"46.4.36.120",443,6,366,3,186,3,180,86198.821113,1.0310429999954067,1443.198780270686,1396.6439809071155
"147.32.84.165",1525,"217.163.21.37",80,10,2277,5,1156,5,1121,86199.824504,0.13961899999412708,66237.40322154583,64231.945511550926
"147.32.84.165",4617,"209.191.88.254",25,3,186,3,186,0,0,86199.852349,9.003591000000597,165.2673916440564,0
"147.32.84.165",3271,"193.23.181.44",179,10,751,5,451,5,300,86199.85238,0.1955160000070464,18453.73268617386,12275.2102125325
"147.32.84.165",1533,"217.163.21.37",80,10,1448,5,699,5,749,86199.870622,0.13936699999612756,40124.2761927528,42994.39609209134
"147.32.84.165",4623,"64.12.139.193",25,3,186,3,186,0,0,86199.870652,8.985411000001477,165.60177380864997,0
"147.32.84.165",3272,"72.20.15.61",80,3,186,3,186,0,0,86199.916605,8.939506999988225,166.45213209206727,0
"147.32.84.165",1540,"184.82.147.251",80,10,1910,5,982,5,928,86199.916659,0.3228040000103647,24336.74923404839,22998.475854579337
"147.32.84.165",4636,"209.191.88.254",25,3,186,3,186,0,0,86199.962221,8.994057000003522,165.44258058398088,0
"147.32.84.165",3273,"67.19.72.206",80,3,186,3,186,0,0,86199.962252,8.994158000001335,165.44072274467263,0
"147.32.84.165",1545,"217.163.21.40",80,14,5934,7,2751,7,3183,86200.023332,0.171675999998115,128194.97192526414,148325.9162624921
"147.32.84.165",4637,"64.136.52.37",25,3,186,3,186,0,0,86200.069396,8.987048999988474,165.57159085278252,0
"147.32.84.165",3274,"174.128.246.102",80,3,186,3,186,0,0,86207.951583,9.030337000003783,164.77790363741425,0
"147.32.84.165",1552,"111.88.77.58",6667,3,186,3,186,0,0,86208.755412,9.029114000004483,164.80022292323048,0
"147.32.84.165",1551,"46.4.36.120",443,6,366,3,186,3,180,86208.856174,1.030895000003511,1443.4059724753074,1396.844489492233
"147.32.84.165",1546,"217.163.21.40",80,11,3862,6,2234,5,1628,86208.856248,0.258562000002712,69120.75246870206,50370.89750181153
"147.32.84.165",4640,"64.12.139.193",25,3,186,3,186,0,0,86208.902217,8.98330100000021,165.6406703949879,0
"147.32.84.165",3275,"174.128.246.102",80,3,186,3,186,0,0,86208.902274,8.983365000007325,165.6394903244816,0
"147.32.84.165",1547,"184.82.147.252",80,10,1508,5,596,5,912,86208.902327,0.32645799999590963,14605.247842171859,22348.9698524509
"147.32.84.165",4641,"64.136.52.37",25,3,186,3,186,0,0,86209.009988,8.974701999992249,165.79937695995758,0
"147.32.84.165",3276,"67.19.72.206",80,3,186,3,186,0,0,86209.010059,8.974751000001561,165.79847173473016,0
"147.32.84.165",1548,"173.241.240.4",80,9,2195,5,1165,4,1030,86209.010125,0.06797699999879114,137105.19734859938,121217.47061721662
"147.32.84.165",4643,"205.188.103.1",25,3,186,3,186,0,0,86209.026519,8.958339999997406,166.10220197050245,0
"147.32.84.165",3277,"67.19.72.206",80,3,186,3,186,0,0,86209.887322,9.000488999998197,165.3243507103112,0
"147.32.84.165",1549,"92.240.244.181",80,10,1760,6,1366,4,394,86209.887362,11.30810900000506,966.3861570484605,278.7380277284725
"147.32.84.165",4655,"209.191.88.254",25,3,186,3,186,0,0,86209.8959,8.992038999989745,165.4797093297412,0
"147.32.84.165",3278,"193.23.181.44",80,8,811,5,425,3,386,86211.263467,0.12301100000331644,27639.804569577795,25103.446032604774
"147.32.84.165",1563,"60.173.109.42",6667,10,1141,5,583,5,558,86211.324522,1.590570000000298,2932.2821378494036,2806.5410513206984
"147.32.84.165",1562,"46.4.36.120",443,6,366,3,186,3,180,86211.464546,1.0303989999956684,1444.1007803833809,1397.5168842419814
"147.32.84.165",1557,"184.82.147.251",80,10,1921,5,986,5,935,86211.641243,0.3411049999995157,23124.84425620029,21928.731622258892
"147.32.84.165",4662,"207.115.36.22",25,3,186,3,186,0,0,86211.754004,8.939841999992495,166.44589468149985,0
"147.32.84.165",3279,"174.128.246.102",80,3,186,3,186,0,0,86211.865972,9.028361999997287,164.8139496400839,0
"147.32.84.165",1559,"217.163.21.37",80,10,2274,5,1154,5,1120,86211.86604,0.14072700000542682,65602.19431696823,63669.37403379933
"147.32.84.165",4663,"64.12.139.193",25,3,186,3,186,0,0,86211.912192,8.982264999998733,165.65977512355846,0
"147.32.84.165",3280,"67.19.72.206",80,3,186,3,186,0,0,86211.912251,8.982254999995348,165.65995955367228,0
"147.32.84.165",1560,"217.163.21.37",80,14,6141,7,810,7,5331,86211.9123,0.1880680000031134,34455.62243386821,226769.04098142148
"147.32.84.165",4665,"129.41.169.122",25,3,186,3,186,0,0,86211.912353,8.982199999998556,165.66097392623624,0
"147.32.84.165",3281,"174.37.196.55",80,3,186,3,186,0,0,86212.495179,9.001385999988997,165.30787592064365,0
"147.32.84.165",1574,"117.207.5.248",6667,1,62,1,62,0,0,86220.894621,0,0,0
"147.32.84.165",1569,"46.4.36.120",443,6,366,3,186,3,180,86220.994823,1.0301690000051167,1444.4231965751342,1397.8288999114202
"147.32.84.165",1566,"184.82.147.252",80,10,1515,5,603,5,912,86221.094663,0.30377700000826735,15880.069919278661,24017.618186371707
"147.32.84.165",4667,"209.191.88.254",25,3,186,3,186,0,0,86221.195055,8.829299999997602,168.5297815229298,0
"147.32.84.165",3282,"174.37.196.55",80,3,186,3,186,0,0,86221.195113,8.829364000004716,168.52855992789574,0
"147.32.84.165",1567,"217.163.21.40",80,13,5860,7,2749,6,3111,86221.195167,0.15934199999901466,138017.59737003423,156192.3410033381
"147.32.84.165",4670,"64.12.139.193",25,3,186,3,186,0,0,86221.241139,8.883623999994597,167.49920978205571,0
"147.32.84.165",3283,"174.37.196.55",80,3,186,3,186,0,0,86222.025226,8.902247999998508,167.1487920804104,0
"147.32.84.165",1568,"217.163.21.37",80,10,1451,5,701,5,750,86222.025287,0.13917599999695085,40294.30361644869,43110.881187355946
"147.32.84.165",4672,"207.115.36.22",25,3,186,3,186,0,0,86222.071132,8.856465000004391,168.0128584033542,0
"147.32.84.165",3284,"72.20.15.61",80,3,186,3,186,0,0,86222.071163,8.85648200000287,168.0125359030276,0
"147.32.84.165",1589,"27.255.59.65",6667,2,124,2,124,0,0,86228.920941,3.0102179999958025,329.54423898913075,0
"147.32.84.165",1587,"46.4.36.120",443,6,366,3,186,3,180,86229.723684,1.0304310000065016,1444.0559338671017,1397.4734843875176
"147.32.84.165",1577,"184.82.147.251",80,10,1926,5,998,5,928,86229.924837,0.34318599999824073,23264.35227556173,21632.58407988105
"147.32.84.165",4674,"209.191.88.254",25,3,186,3,186,0,0,86230.037502,9.017749999999069,165.0079010839903,0
"147.32.84.165",3285,"67.19.72.206",80,3,186,3,186,0,0,86230.037563,9.017814999999246,165.00671171454775,0
"147.32.84.165",1581,"92.240.244.181",80,10,1758,6,1364,4,394,86230.754358,12.25955599998997,890.0811742292238,257.1055591248638
"147.32.84.165",4676,"209.85.143.27",25,3,186,3,186,0,0,86230.762824,8.994653000001563,165.43161809574437,0
"147.32.84.165",3286,"174.37.196.55",80,3,186,3,186,0,0,86230.827048,9.030976999987615,164.76622629002827,0
"147.32.84.165",1582,"173.241.240.4",80,9,2194,5,1164,4,1030,86230.827174,0.06737999999313615,138201.24667480844,122291.48116413462
"147.32.84.165",4682,"154.32.105.132",25,3,186,3,186,0,0,86230.843503,9.014615000007325,165.06528564989085,0
"147.32.84.165",3287,"174.37.196.55",80,3,186,3,186,0,0,86232.534464,9.028797000006307,164.80600903962738,0
"147.32.84.165",1599,"46.4.36.120",443,6,366,3,186,3,180,86232.534592,1.030058000003919,1444.5788489525237,1397.9795312443778
"147.32.84.165",1583,"217.163.21.37",80,14,6141,7,810,7,5331,86232.634364,0.1901309999957448,34081.76467880054,224308.5030897354
"147.32.84.165",4685,"205.188.190.1",25,3,186,3,186,0,0,86232.680402,8.98319199999969,165.64268024106033,0
"147.32.84.165",3288,"193.23.181.44",80,8,833,5,447,3,386,86232.835616,0.13698199999635108,26105.6197171545,22543.107854187107
"147.32.84.165",1585,"217.163.21.40",80,13,5293,7,2296,6,2997,86232.900112,0.2864350000018021,64126.241555272354,83704.85450398574
"147.32.84.165",4686,"209.191.88.254",25,3,186,3,186,0,0,86232.946193,9.018066999997245,165.00210078284564,0
"147.32.84.165",3289,"174.37.196.55",80,3,186,3,186,0,0,86233.437329,9.028786000009859,164.80620982692193,0
"147.32.84.165",1595,"184.82.147.252",80,10,1507,5,596,5,911,86233.564885,0.3054980000015348,15607.303484723454,23856.129990911184
"147.32.84.165",4689,"140.242.16.25",25,3,186,3,186,0,0,86233.665669,9.001099000000977,165.3131467612831,0
"147.32.84.165",3290,"193.23.181.44",80,8,866,5,480,3,386,86242.165001,0.1312069999985397,29266.731196069864,23535.32967017285
"147.32.84.165",1609,"61.82.197.229",6667,1,62,1,62,0,0,86242.230076,0,0,0
"147.32.84.165",1607,"46.4.36.120",443,6,366,3,186,3,180,86242.567591,1.029980000006617,1444.6882463644347,1398.0853997075174
"147.32.84.165",1600,"217.163.21.37",80,10,1451,5,701,5,750,86242.967878,0.13996500000939704,40067.15964436457,42867.8598192203
"147.32.84.165",4700,"216.99.131.15",25,3,186,3,186,0,0,86243.013753,8.983972999994876,165.62828049470414,0
"147.32.84.165",3291,"193.23.181.44",80,9,908,5,464,4,444,86243.597808,0.14679499999328982,25286.96481603379,24197.00943603233
"147.32.84.165",1605,"217.163.21.37",80,13,6077,6,749,7,5328,86243.668256,0.18684399999619927,32069.533943406732,228126.13731705083
"147.32.84.165",4702,"65.55.92.152",25,3,186,3,186,0,0,86243.714172,8.985796999986633,165.59466010663422,0
"147.32.84.165",3294,"193.23.181.44",80,8,908,5,524,3,384,86251.094861,0.1255469999887282,33389.885862476716,24468.92399082263
"147.32.84.165",1627,"46.4.36.120",443,6,366,3,186,3,180,86251.157144,0.968367000008584,1536.6075051987623,1487.0395211600924
"147.32.84.165",1612,"184.82.147.251",80,10,1910,5,982,5,928,86251.797141,0.34529499999189284,22751.560260601662,21500.45613221827
"147.32.84.165",4706,"64.12.139.193",25,3,186,3,186,0,0,86251.897393,8.928412999986904,166.65895719678096,0
"147.32.84.165",3295,"174.37.196.55",80,3,186,3,186,0,0,86251.910921,8.914984999995795,166.90998358389857,0
"147.32.84.165",1626,"212.117.171.138",65500,15,931,9,546,6,385,86251.91098,212.26681699999608,20.57787487339616,14.510039974830624
"147.32.84.165",1622,"217.163.21.40",80,13,5297,7,2296,6,3001,86251.911029,0.29492000000027474,62281.29662275495,81405.12681397544
"147.32.84.165",4707,"209.191.88.254",25,3,186,3,186,0,0,86251.957068,8.868862000002991,167.77800804652256,0
"147.32.84.165",3296,"67.19.72.206",80,3,186,3,186,0,0,86251.957127,8.868831999992835,167.7785755780696,0
"147.32.84.165",1628,"62.24.74.140",6667,4,244,2,124,2,120,86252.12575,0.48168699999223463,2059.4286331497265,1992.995451435219
"147.32.84.165",1625,"217.163.21.37",80,10,1448,5,699,5,749,86252.599639,0.13927500000863802,40150.78082680436,43022.79662271311
"147.32.84.165",4711,"64.12.139.193",25,3,186,3,186,0,0,86252.645625,8.882536999997683,167.51970748901897,0
"147.32.84.165",3297,"193.23.181.44",80,8,865,5,479,3,386,86252.645684,0.12550300000293646,30533.1346653892,24604.989521587122
"147.32.84.165",1636,"65.55.16.187",443,22,9092,12,4048,10,5044,86252.707975,1.9860550000012154,16305.691433510241,20317.66491863282
"147.32.84.165",1638,"184.82.147.252",80,10,1508,5,596,5,912,86252.870609,0.34073099998931866,13993.443508660699,21412.78604009825
"147.32.84.165",4715,"74.6.136.244",25,3,186,3,186,0,0,86252.983083,8.846338000003016,168.20519405877243,0
"147.32.84.165",3298,"193.23.181.44",80,8,855,5,469,3,386,86253.703287,0.1340070000005653,27998.53738971973,23043.572350600887
"147.32.84.165",1642,"46.4.36.120",443,6,366,3,186,3,180,86253.769738,0.964202999995905,1543.2434871145595,1493.461439143122
"147.32.84.165",1639,"217.163.21.40",80,11,3862,6,2234,5,1628,86254.004012,0.24118699999235105,74100.1795310974,53999.59367798862
"147.32.84.165",4730,"209.191.88.254",25,3,186,3,186,0,0,86254.050603,8.881571999998414,167.53790882968303,0
"147.32.84.165",3299,"72.20.15.61",80,3,186,3,186,0,0,86254.505453,8.92912499999511,166.6456679686772,0
"147.32.84.165",1641,"217.163.21.37",80,13,6081,6,750,7,5331,86254.706561,0.19162100000539795,31311.808203855428,222564.33271300438
"147.32.84.165",4733,"64.12.139.193",25,3,186,3,186,0,0,86254.734178,8.900651999996626,167.1787639827469,0
"147.32.84.165",3300,"174.128.246.102",80,3,186,3,186,0,0,86254.734237,8.900714999996126,167.17758067758012,0
"147.32.84.165",1645,"217.163.21.37",80,10,2274,5,1154,5,1120,86254.752418,0.13930799999798182,66270.42237440596,64317.914262855
"147.32.84.165",4734,"74.6.136.244",25,3,186,3,186,0,0,86254.752475,8.882526000001235,167.51991494309087,0
"147.32.84.165",3301,"174.37.196.55",80,9,722,6,540,3,182,86254.752523,9.126164000001154,473.36427440921,159.54129248606708
"147.32.84.165",1650,"89.46.59.46",6667,3,186,3,186,0,0,86262.631666,9.031285999997635,164.76058891285135,0
"147.32.84.165",1651,"46.4.36.120",443,6,366,3,186,3,180,86263.75709,1.0086880000017118,1475.1836048386367,1427.5970369406161
"147.32.84.165",1648,"217.163.21.40",80,13,5860,7,2749,6,3111,86263.935598,0.16342599999916274,134568.55090446238,152289.1094448099
"147.32.84.165",4735,"207.115.36.22",25,3,186,3,186,0,0,86263.982377,8.985196000008727,165.60573636886215,0
"147.32.84.165",3302,"193.23.181.44",80,8,822,5,436,3,386,86264.637896,0.13008499999705236,26813.237499166204,23738.324941922372
"147.32.84.165",1649,"217.163.21.37",80,10,1451,5,701,5,750,86264.701582,0.1407480000052601,39844.260662960856,42629.38016721918
"147.32.84.165",4737,"65.54.188.94",25,3,186,3,186,0,0,86264.749001,9.021005000002333,164.94836218354996,0
"147.32.84.165",3303,"174.37.196.55",80,3,186,3,186,0,0,86264.765997,9.004131000008783,165.2574801497833,0
"147.32.84.165",1655,"184.82.147.251",80,10,1910,5,982,5,928,86264.766057,0.3592099999950733,21870.215194754455,20667.576069991992
"147.32.84.165",4738,"205.188.190.1",25,3,186,3,186,0,0,86264.884537,8.986764999994193,165.5768232507428,0
"147.32.84.165",3304,"174.37.196.55",80,3,186,3,186,0,0,86272.867111,9.030830000003334,164.7689082841168,0
"147.32.84.165",1664,"194.67.211.76",6667,3,186,3,186,0,0,86272.86721,9.030836000005365,164.7687988132124,0
"147.32.84.165",1665,"46.4.36.120",443,6,366,3,186,3,180,86272.867245,1.0315069999924162,1442.5495900764026,1396.0157323320027
"147.32.84.165",1659,"92.240.244.181",80,10,1758,6,1364,4,394,86273.871365,10.910140000007232,1000.170483604497,288.90555024939283
"147.32.84.165",4739,"74.6.136.244",25,3,186,3,186,0,0,86273.879844,9.021022000000812,164.94805134050955,0
"147.32.84.165",3305,"174.37.196.55",80,3,186,3,186,0,0,86273.898855,9.00220599999011,165.29281822718062,0
"147.32.84.165",1660,"173.241.240.4",80,9,2194,5,1164,4,1030,86273.898886,0.07023599999956787,132581.58209546804,117318.75391609284
"147.32.84.165",4741,"208.65.145.12",25,3,186,3,186,0,0,86273.919832,8.981310999995912,165.67737159983406,0
"147.32.84.165",3306,"193.23.181.44",80,9,931,5,479,4,452,86274.973461,0.12538599999970756,30561.625699910175,28838.945336867222
"147.32.84.165",1674,"46.4.36.120",443,6,366,3,186,3,180,86275.035699,0.9692070000019157,1535.2757460450232,1485.7507219790548
"147.32.84.165",1662,"217.163.21.40",80,13,5297,7,2296,6,3001,86275.476279,0.23610999999800697,77794.24844417875,101681.41967812738
"147.32.84.165",4748,"98.139.54.60",25,3,186,3,186,0,0,86275.522685,8.983400999990408,165.6388265425966,0
"147.32.84.165",3307,"193.23.181.44",179,10,728,5,428,5,300,86275.676009,0.19165700000303332,17865.24885574651,12522.370693280265
"147.32.84.165",1677,"117.197.21.10",6667,2,124,2,124,0,0,86275.73851,2.9478329999983544,336.5183848612027,0
"147.32.84.165",1663,"184.82.147.252",80,10,1507,5,596,5,911,86276.005151,0.34173099999316037,13952.494798819627,21326.716043162214
"147.32.84.165",4752,"207.115.36.22",25,3,186,3,186,0,0,86276.118155,8.990064999990864,165.5160446561301,0
"147.32.84.165",3308,"193.23.181.44",179,10,728,5,428,5,300,86276.118215,0.19798199999786448,17294.50152052678,12122.314149901948
"147.32.84.165",1672,"184.82.147.251",80,10,1921,5,986,5,935,86276.183059,0.3247830000036629,24286.985463866764,23030.76207780469
"147.32.84.165",4753,"205.188.146.193",25,3,186,3,186,0,0,86276.289626,9.018907999998191,164.9867145778955,0
"147.32.84.165",3309,"174.37.196.55",80,9,692,6,510,3,182,86283.703448,9.172124999997322,444.8260354063198,158.74184008617686
"147.32.84.165",1683,"46.4.36.120",443,6,366,3,186,3,180,86283.703588,1.0312140000023646,1442.959463308865,1396.4123838472888
"147.32.84.165",1681,"217.163.21.37",80,14,6137,7,809,7,5328,86284.735145,0.18826300000364427,34377.44006987416,226406.67576302786
"147.32.84.165",4756,"74.6.136.244",25,3,186,3,186,0,0,86284.781047,8.854084999999031,168.05802067635028,0
"147.32.84.165",3310,"174.37.196.55",80,9,719,6,537,3,182,86284.781118,9.096913000001223,472.24811317854994,160.05429534170594
"147.32.84.165",1682,"184.82.147.252",80,10,1514,5,603,5,911,86284.781185,0.3415229999955045,14124.963765437464,21339.7047932231
"147.32.84.165",4757,"67.195.168.31",25,3,186,3,186,0,0,86284.893933,8.841912000003504,168.28939261094325,0
"147.32.84.165",3311,"174.37.196.55",80,3,186,3,186,0,0,86285.008248,8.92797000000428,166.6672267043109,0
"147.32.84.165",1691,"184.82.147.251",80,10,1926,5,998,5,928,86285.008375,0.3226589999976568,24744.38958794883,23008.811159936387
"147.32.84.165",4761,"64.12.90.65",25,3,186,3,186,0,0,86285.114859,8.921920000007958,166.78024461087668,0
"147.32.84.165",3312,"174.128.246.102",80,3,186,3,186,0,0,86285.810671,8.928117999996175,166.6644638882055,0
"147.32.84.165",1695,"79.119.209.87",6667,2,124,2,124,0,0,86285.911016,3.0095000000001164,329.6228609403428,0
"147.32.84.165",1696,"94.100.176.20",25,3,186,3,186,0,0,86292.230527,9.029443999999785,164.79419995295785,0
"147.32.84.165",1692,"217.163.21.37",80,10,1448,5,699,5,749,86293.836025,0.1393979999993462,40115.35316163953,42984.83478979686
"147.32.84.165",4763,"205.188.159.42",25,3,186,3,186,0,0,86293.881884,8.983295999991242,165.64076258885945,0
"147.32.84.165",3313,"193.23.181.44",80,8,826,5,440,3,386,86294.839106,0.12569800000346731,28003.627741912383,24566.818882677682
"147.32.84.165",1697,"46.4.36.120",443,6,366,3,186,3,180,86294.839245,1.0304290000058245,1444.058736692765,1397.47619679945
"147.32.84.165",1693,"217.163.21.37",80,14,6137,7,809,7,5328,86294.901521,0.1889309999969555,34255.8923633723,225606.173686091
"147.32.84.165",4764,"74.6.136.244",25,3,186,3,186,0,0,86294.947816,9.020621999996365,164.9553656056755,0
"147.32.84.165",3314,"193.23.181.44",179,11,841,5,481,6,360,86295.869926,0.19181099999696016,20061.414622002823,15014.780174471967
"147.32.84.165",1717,"200.104.20.184",6667,2,124,2,124,0,0,86295.93272,2.9192520000069635,339.8130754034368,0
"147.32.84.165",1694,"184.82.147.252",80,10,1507,5,596,5,911,86296.444318,0.32293500000378117,14764.581107480368,22568.009041803045
"147.32.84.165",4772,"207.173.161.49",25,3,186,3,186,0,0,86296.550885,9.023074999990058,164.91052108085543,0
"147.32.84.165",3315,"193.23.181.44",179,10,776,5,476,5,300,86297.246551,0.2055229999969015,18528.33989411117,11677.525143347377
"147.32.84.165",1720,"46.4.36.120",443,6,366,3,186,3,180,86297.314597,0.9635790000029374,1544.242869547244,1494.4285834328168
"147.32.84.165",1708,"184.82.147.251",80,10,1921,5,986,5,935,86298.278413,0.3231750000122702,24407.828574922292,23145.354683115966
"147.32.84.165",4781,"212.82.111.207",25,3,186,3,186,0,0,86298.385747,8.994747000004281,165.42988924527748,0
"147.32.84.165",3316,"193.23.181.44",179,10,781,5,481,5,300,86302.262467,0.1875419999996666,20518.07061888452,12797.133442131719
"147.32.84.165",1726,"46.4.36.120",443,6,366,3,186,3,180,86302.323112,0.9703600000066217,1533.4515025246774,1483.9853250238814
"147.32.84.165",1711,"217.163.21.40",80,13,4886,7,2294,6,2592,86303.293691,0.2384860000020126,76952.10620264974,86948.50012086667
"147.32.84.165",4787,"205.188.156.193",25,3,186,3,186,0,0,86303.340403,8.955311000012443,166.15838355562775,0
"147.32.84.165",3317,"193.23.181.44",179,10,741,5,441,5,300,86305.775336,0.19205299999157432,18369.92913495118,12496.550431939579
"147.32.84.165",1736,"60.249.196.250",6667,2,124,2,124,0,0,86305.838014,2.946884000004502,336.6267555826712,0
"147.32.84.165",1732,"46.4.36.120",443,6,366,3,186,3,180,86306.076169,1.0305509999889182,1443.8877843173223,1397.3107590167635
"147.32.84.165",1716,"217.163.21.37",80,10,1448,5,699,5,749,86306.778498,0.13995100000465754,39956.84203624054,42814.98524341082
"147.32.84.165",4792,"74.208.5.90",25,3,186,3,186,0,0,86306.824444,8.983277000006638,165.64111292559502,0
"147.32.84.165",3318,"193.23.181.44",80,8,827,5,441,3,386,86307.106942,0.12299099999654572,28685.0257343959,25107.528193824983
"147.32.84.165",1719,"217.163.21.37",80,14,6137,7,809,7,5328,86307.167942,0.18840800000180025,34350.982972793936,226232.43174171334
"147.32.84.165",4793,"205.188.59.194",25,3,186,3,186,0,0,86307.214398,8.995181000005687,165.42190757462905,0
"147.32.84.165",3319,"174.37.196.55",80,3,186,3,186,0,0,86312.295574,8.934007000003476,166.55460422175864,0
"147.32.84.165",1746,"46.4.36.120",443,6,366,3,186,3,180,86313.299245,1.0313259999966249,1442.8027607224774,1396.2607361830426
"147.32.84.165",1723,"184.82.147.252",80,10,1515,5,603,5,912,86314.330721,0.32268899999326095,14949.37850407279,22610.00529969218
"147.32.84.165",4800,"74.6.136.244",25,3,186,3,186,0,0,86314.437042,8.899120000001858,167.20754411668673,0
"147.32.84.165",3320,"174.128.246.102",80,3,186,3,186,0,0,86314.437101,8.899158999993233,167.20681134038975,0
"147.32.84.165",1752,"74.125.93.27",25,3,186,3,186,0,0,86314.905469,8.932088999994448,166.59036872571744,0
"147.32.84.165",1730,"195.113.232.88",80,30,29545,19,1506,11,28039,86316.008335,40.82666199999221,295.1012747503653,5494.25275081374
"147.32.84.165",4814,"64.12.90.98",25,3,186,3,186,0,0,86316.009921,8.931444000001648,166.60239934323337,0
"147.32.84.165",3321,"174.128.246.102",80,8,643,6,521,2,122,86317.616041,9.268332999999984,449.70330694851026,105.30480508199281
"147.32.84.165",1756,"78.138.22.163",6667,2,124,2,124,0,0,86317.616176,2.910860000003595,340.7927554051981,0
"147.32.84.165",1755,"46.4.36.120",443,6,366,3,186,3,180,86319.421143,0.9321440000057919,1596.3198818967394,1544.8256921581349
"147.32.84.165",1740,"184.82.147.251",80,10,1926,5,998,5,928,86320.353557,0.35805700000491925,22298.12571710736,20734.128923322274
"147.32.84.165",4815,"195.47.215.249",25,3,186,3,186,0,0,86320.471978,8.983852999997907,165.63049284091653,0
"147.32.84.165",3322,"72.20.15.61",80,3,186,3,186,0,0,86322.332568,9.028976000001421,164.80274175053358,0
"147.32.84.165",1763,"46.4.36.120",443,6,366,3,186,3,180,86324.23909,1.0574869999982184,1407.1094963838864,1361.7188674682773
"147.32.84.165",1742,"217.163.21.40",80,13,5325,7,2314,6,3011,86325.296817,0.2558380000118632,72358.28922654805,94153.33140066387
"147.32.84.165",4821,"64.12.90.97",25,3,186,3,186,0,0,86325.34286,9.028253999989829,164.81592121817533,0
"147.32.84.165",3323,"72.20.15.61",80,3,186,3,186,0,0,86327.749997,9.02994699998817,164.78502033311486,0
"147.32.84.165",1768,"184.106.213.57",6667,10,1165,5,607,5,558,86327.750126,0.45163399999728426,10752.069153405633,9884.109699506333
"147.32.84.165",1769,"46.4.36.120",443,6,366,3,186,3,180,86327.880932,1.0004049999988638,1487.3976039720812,1439.4170361020142
"147.32.84.165",1744,"217.163.21.37",80,10,1448,5,699,5,749,86328.151285,0.13982900000701193,39991.704150924204,42852.341071591174
"147.32.84.165",4833,"205.188.159.42",25,3,186,3,186,0,0,86328.197548,8.984131999997771,165.62534922687792,0
"147.32.84.165",3325,"193.23.181.44",179,10,741,5,441,5,300,86328.881617,0.19783399999141693,17833.132829306705,12131.382877079392
"147.32.84.165",1754,"217.163.21.37",80,14,6141,7,810,7,5331,86328.946399,0.18796100000326987,34475.236883647514,226898.13311941345
"147.32.84.165",4837,"122.28.30.180",25,3,186,3,186,0,0,86328.992394,8.992173999999068,165.4772249736442,0
"147.32.84.165",3324,"174.128.246.102",80,8,624,4,382,4,242,86332.365057,0.340146000002278,8984.37729674767,5691.6735754265355
"147.32.84.165",1780,"84.16.230.244",6667,2,124,2,124,0,0,86332.365185,3.010456999996677,329.51807649174026,0
"147.32.84.165",1778,"46.4.36.120",443,6,366,3,186,3,180,86333.267774,1.030109999992419,1444.505926562164,1397.908961189191
"147.32.84.165",1762,"184.82.147.252",80,10,1507,5,596,5,911,86334.298112,0.32362799999827985,14732.965009286412,22519.683093053558
"147.32.84.165",4838,"61.9.189.122",25,3,186,3,186,0,0,86334.405481,8.998224000009941,165.36596555035263,0
"147.32.84.165",3326,"72.20.15.61",80,3,186,3,186,0,0,86335.375794,9.030545999994501,164.77409007173054,0
"147.32.84.165",1788,"46.4.36.120",443,6,366,3,186,3,180,86335.37586,1.0307690000045113,1443.582412736013,1397.0152381316257
"147.32.84.165",1773,"217.163.21.40",80,11,3892,6,2254,5,1638,86335.876829,0.22567099999287166,79903.93094624291,58066.83180565478
"147.32.84.165",4839,"208.65.145.11",25,3,186,3,186,0,0,86335.92361,8.984832999994978,165.61242707581005,0
"147.32.84.165",3327,"174.37.196.55",80,3,186,3,186,0,0,86336.406853,9.002985000013723,165.2785159586217,0
"147.32.84.165",1790,"74.125.39.27",25,3,186,3,186,0,0,86336.980667,9.031016000008094,164.76551475478135,0
"147.32.84.165",1774,"184.82.147.251",80,10,1921,5,990,5,931,86341.495678,0.3448089999874355,22969.238042767436,21600.364260420687
"147.32.84.165",4846,"134.129.200.67",25,3,186,3,186,0,0,86341.608441,9.019828999997117,164.96986805409233,0
"147.32.84.165",3328,"174.37.196.55",80,3,186,3,186,0,0,86343.403783,8.930756000001566,166.61523391745774,0
"147.32.84.165",1796,"124.125.21.140",6667,2,124,2,124,0,0,86343.403816,3.00905999999668,329.6710600656333,0
"147.32.84.165",1791,"46.4.36.120",443,6,366,3,186,3,180,86346.412911,1.030627000000095,1443.7813098238867,1397.2077191844064
"147.32.84.165",1777,"217.163.21.37",80,10,1451,5,701,5,750,86347.443743,0.13924000000406522,40275.78281985255,43091.06578443569
"147.32.84.165",4847,"205.188.59.194",25,3,186,3,186,0,0,86347.48983,8.857576999987941,167.99176569416508,0
"147.32.84.165",3329,"174.128.246.102",80,3,186,3,186,0,0,86347.917804,8.947161999996752,166.3097192160531,0
"147.32.84.165",1805,"46.4.36.120",443,6,366,3,186,3,180,86349.222451,1.0325700000103097,1441.0645282984622,1394.5785757727053
"147.32.84.165",1786,"217.163.21.37",80,14,6134,7,809,7,5325,86350.026286,0.18952500000887085,34148.52921618295,224772.45744891744
"147.32.84.165",4848,"205.188.156.193",25,3,186,3,186,0,0,86350.072918,8.89554599999974,167.27472377749982,0
"147.32.84.165",3330,"174.37.196.55",80,3,186,3,186,0,0,86350.255238,8.913167999999132,166.94400913346914,0
"147.32.84.165",1802,"217.163.21.40",80,11,3886,6,2256,5,1630,86350.255298,0.24290699999255594,74300.04075861583,53683.09682470913
"147.32.84.165",4849,"61.9.189.122",25,3,186,3,186,0,0,86350.301236,8.867264999993495,167.80822497140795,0
"147.32.84.165",3331,"193.23.181.44",179,10,851,5,551,5,300,86350.301295,0.206757000007201,21319.713479333117,11607.829480580644
"147.32.84.165",1803,"217.163.21.37",80,10,2274,5,1154,5,1120,86350.370357,0.13923899999645073,66303.26273698697,64349.78705842756
"147.32.84.165",4853,"65.54.188.72",25,3,186,3,186,0,0,86350.416258,8.852133000007598,168.0950794569764,0
"147.32.84.165",3332,"174.37.196.55",80,3,186,3,186,0,0,86355.34528,9.030878000005032,164.76803252122008,0
"147.32.84.165",1814,"122.218.153.19",6667,6,366,3,186,3,180,86355.345409,1.9278809999959776,771.8318713671148,746.9340690649498
"147.32.84.165",1815,"46.4.36.120",443,6,366,3,186,3,180,86356.865112,1.0289119999943068,1446.187817819438,1399.5365978897785
"147.32.84.165",1813,"184.82.155.107",80,10,1888,5,961,5,927,86357.273534,0.3418709999968996,22488.014485199743,21692.39274482847
"147.32.84.165",4854,"205.188.159.42",25,3,186,3,186,0,0,86357.36612,9.013112000000547,165.09281145068536,0
"147.32.84.165",3333,"193.23.181.44",179,11,854,5,494,6,360,86357.386358,0.1958299999969313,20180.76903468278,14706.633304627127
"147.32.84.165",4859,"65.55.37.104",25,3,186,3,186,0,0,86357.450486,8.928868999995757,166.6504458740191,0
"147.32.84.165",3334,"193.23.181.44",80,8,829,5,445,3,384,86357.894253,0.13449099998979364,26470.172727321264,22841.6771399806
"147.32.84.165",1825,"184.82.155.108",80,10,1316,5,596,5,720,86357.961162,0.32355999998981133,14736.06131830307,17801.953270433238
"147.32.84.165",4860,"64.12.90.97",25,3,186,3,186,0,0,86357.966591,9.015020999999251,165.05785177872838,0
"147.32.84.165",3335,"193.23.181.44",179,11,844,5,484,6,360,86358.067735,0.19886099999712314,19470.886700036783,14482.477710771162
"147.32.84.165",1827,"66.111.4.71",25,3,186,3,186,0,0,86358.132872,8.947102999998606,166.31081591440625,0
"147.32.84.165",4863,"65.55.37.104",25,3,186,3,186,0,0,86358.166756,9.013107999999193,165.09288471858247,0
"147.32.84.165",3336,"193.23.181.44",179,10,788,5,488,5,300,86358.166863,0.18494899998768233,21108.52181012067,12976.55029310697
"147.32.84.165",4864,"64.12.90.98",25,3,186,3,186,0,0,86358.166904,9.013082000004943,165.09336096123212,0
"147.32.84.165",3337,"174.128.246.102",80,37,2642,21,1680,16,962,86362.573319,673.0455530000036,19.968930691382088,11.43459007446998
"147.32.84.165",1835,"211.157.110.34",6667,10,2620,9,2558,1,62,86362.573447,93.25321999999869,219.44550547423765,5.31885118819497
"147.32.84.165",1832,"46.4.36.120",443,6,366,3,186,3,180,86362.865364,1.0378840000048513,1433.68623082449,1387.4382878946676
"147.32.84.165",1830,"93.184.220.20",80,12,6546,8,769,4,5777,86363.903528,5.759239999999409,1068.196498149171,8024.669921726607
"147.32.84.165",4871,"24.71.223.11",25,3,186,3,186,0,0,86363.920013,8.968066000001272,165.92206167971878,0
"147.32.84.165",3338,"174.128.246.102",80,9,890,6,706,3,184,86368.381609,3.28161399999226,1721.1043102611463,448.5597635808087
"147.32.84.165",1843,"46.4.36.120",443,6,366,3,186,3,180,86368.381738,1.0291300000099,1445.881472686333,1399.2401348577416
"147.32.84.165",1839,"195.113.232.98",80,11,2429,7,1275,4,1154,86368.882399,88.05644700000994,115.83478947315292,104.84184082511253
"147.32.84.165",4874,"205.188.59.194",25,3,186,3,186,0,0,86368.882426,9.012711000003037,165.10015687837972,0
"147.32.84.165",3339,"193.23.181.44",179,10,772,5,472,5,300,86369.411147,0.2067349999997532,18264.92853171697,11609.064744735362
"147.32.84.165",1840,"63.251.249.49",80,9,1250,5,622,4,628,86369.478255,0.5570970000117086,8932.017224819769,9018.178162679766
"147.32.84.165",4875,"205.188.59.193",25,3,186,3,186,0,0,86369.662218,8.934076000005007,166.5533178807933,0
"147.32.84.165",3340,"174.128.246.102",80,10,1065,7,881,3,184,86370.985196,9.282005000000936,759.318703232684,158.58642610081029
"147.32.84.165",1853,"46.4.36.120",443,6,366,3,186,3,180,86371.156043,0.958282000006875,1552.7788270982076,1502.6891875143945
"147.32.84.165",1841,"68.67.179.210",80,10,1628,6,796,4,832,86371.285941,19.37400300000445,328.6878813840659,343.553162451687
"147.32.84.165",4877,"216.82.249.131",25,3,186,3,186,0,0,86371.31019,8.988881999990554,165.5378277300296,0
"147.32.84.165",3341,"193.23.181.44",80,8,821,5,437,3,384,86372.114714,0.12143500000820495,28789.064106425554,25297.484249124514
"147.32.84.165",1846,"184.82.155.107",80,10,1912,5,981,5,931,86372.17504,0.32321099999535363,24281.351810776305,23043.770169044587
"147.32.84.165",4886,"64.12.90.1",25,3,186,3,186,0,0,86372.281789,8.918560000005527,166.84307780617922,0
"147.32.84.165",1865,"173.192.170.88",80,22,6593,10,823,12,5770,86378.396152,40.076195999994525,164.2870495992409,1151.8059248938273
"147.32.84.165",3342,"67.19.72.206",80,3,186,3,186,0,0,86378.396283,9.012673000004725,165.10085298770076,0
"147.32.84.165",1864,"59.48.7.167",6667,6,366,3,186,3,180,86378.597457,1.9286530000099447,771.522922989427,746.6350867639617
"147.32.84.165",1863,"46.4.36.120",443,6,366,3,186,3,180,86378.997338,1.0283409999974538,1446.9908328109882,1400.313709171924
"147.32.84.165",1858,"68.67.185.216",80,10,2226,6,989,4,1237,86379.096898,11.562944999997853,684.2547465201528,855.8373320985128
"147.32.84.165",4891,"205.188.59.194",25,3,186,3,186,0,0,86379.120886,8.989027999996324,165.53513906070918,0
"147.32.84.165",3343,"193.23.181.44",179,10,728,5,428,5,300,86379.12092,0.19900199999392498,17205.8572280908,12060.180300063646
"147.32.84.165",1870,"216.157.130.15",25,3,186,3,186,0,0,86379.186161,8.923874999993131,166.74370719011026,0
"147.32.84.165",1862,"184.82.155.108",80,10,1511,5,599,5,912,86379.198084,0.34643099999811966,13832.480349697371,21060.47091640067
"147.32.84.165",4894,"64.12.90.97",25,3,186,3,186,0,0,86379.311656,8.998752999992575,165.35624435977158,0
"147.32.84.165",3344,"72.20.15.61",80,3,186,3,186,0,0,86380.025942,8.985748000006424,165.59556310714882,0
"147.32.84.165",1880,"60.243.195.59",6667,2,124,2,124,0,0,86384.905584,3.004493000000366,330.17217880017665,0
"147.32.84.165",1876,"46.4.36.120",443,6,366,3,186,3,180,86389.91243,1.0285779999976512,1446.6574241364272,1399.9910556158973
"147.32.84.165",1872,"217.163.21.37",80,14,5917,7,808,7,5109,86390.613655,0.18936600000597537,34134.95558757132,215836.00011992807
"147.32.84.165",4896,"85.158.140.211",25,3,186,3,186,0,0,86390.659686,8.884373000008054,167.48508870560153,0
"147.32.84.165",3346,"174.128.246.102",80,8,684,5,502,3,182,86390.941259,3.32723999999871,1207.0064077137679,437.5999326771031
"147.32.84.165",1873,"94.245.121.179",80,8,1103,5,652,3,451,86390.94132,0.10788599999796133,48347.329589553454,33442.70804430768
"147.32.84.165",4897,"64.12.90.1",25,3,186,3,186,0,0,86390.976103,8.867916000002879,167.79590605047645,0
"147.32.84.165",3345,"72.20.15.61",80,8,688,4,446,4,242,86390.97616,0.36550099999294616,9761.943195966247,5296.839133237291
"147.32.84.165",1874,"217.163.21.36",80,14,6141,7,810,7,5331,86390.976214,0.18973600000026636,34152.71746000181,224775.47750527115
"147.32.84.165",4898,"184.154.89.154",8735,26042,1625746,12999,779942,13043,845804,86391.022264,10464.860215000008,596.2369178191641,646.5859897775993
"147.32.84.165",3348,"72.20.15.61",80,3,186,3,186,0,0,86391.157118,8.887623999995412,167.4238244103,0
"147.32.84.165",1875,"184.82.155.107",80,10,1916,5,985,5,931,86391.157181,0.3226509999949485,24422.67341531057,23083.765431120955
"147.32.84.165",4899,"64.12.90.33",25,3,186,3,186,0,0,86391.263629,8.881596999999601,167.53743724243137,0
"147.32.84.165",3347,"174.128.246.102",80,15,1898,10,1590,5,308,86391.616663,21.68212000001222,586.6585001832308,113.64202393486482
"147.32.84.165",1891,"208.73.210.29",80,50,35835,22,3325,28,32510,86391.61679,19.734796999997343,1347.8729981364177,13178.752231402988
"147.32.84.165",1882,"95.172.94.54",80,8,1222,5,833,3,389,86391.803191,0.07114100000762846,93673.12800333729,43744.113797476835
"147.32.84.165",4902,"74.6.136.244",25,3,186,3,186,0,0,86391.826577,8.920373999993899,166.80914948196317,0
"147.32.84.165",3349,"67.19.72.206",80,3,186,3,186,0,0,86392.318319,8.930378000004566,166.62228631299135,0
"147.32.84.165",1894,"46.4.36.120",443,6,366,3,186,3,180,86392.318414,1.1340029999992112,1312.1658408320218,1269.8379104826017
"147.32.84.165",1895,"74.125.232.218",80,8,1908,5,1034,3,874,86393.22159,18.130214999997406,456.2549313398205,385.6545551170243
"147.32.84.165",1883,"74.125.232.204",80,16,6096,9,4054,7,2042,86393.229741,63.705910999997286,509.0893370946596,256.4283242099889
"147.32.84.165",4913,"64.12.90.1",25,3,186,3,186,0,0,86393.237811,8.913711000001058,166.93383934029535,0
"147.32.84.165",3351,"174.37.196.55",80,3,186,3,186,0,0,86393.469768,8.881764000005205,167.5342871077331,0
"147.32.84.165",1898,"190.136.214.243",6667,1,62,1,62,0,0,86399.342233,0,0,0
"147.32.84.165",1902,"46.4.36.120",443,6,366,3,186,3,180,86400.044857,1.0310889999964274,1443.1343948050612,1396.5816723919947
"147.32.84.165",1897,"67.214.158.5",80,10,1695,5,849,5,846,86400.145103,0.3268370000005234,20781.000927034343,20707.569828352243
"147.32.84.165",1884,"74.125.232.204",80,8,1473,5,967,3,506,86400.245355,62.11230799999612,124.54858383302201,65.1722682725017
"147.32.84.165",4914,"74.125.93.27",25,3,186,3,186,0,0,86400.245485,9.028894999995828,164.80422022857587,0
"147.32.84.165",3350,"67.19.72.206",80,3,186,3,186,0,0,86400.248724,9.025755999988178,164.86153625269162,0
"147.32.84.165",1899,"50.22.198.84",80,8,2195,5,1164,3,1031,86400.947597,0.3788769999955548,24577.89731260872,21769.59804922645
"147.32.84.165",1885,"217.163.21.37",80,10,1580,5,737,5,843,86401.068162,0.14262700000836048,41338.596476504375,47284.17480284015
"147.32.84.165",4915,"74.6.136.244",25,3,186,3,186,0,0,86401.076155,9.000784000003478,165.3189322173963,0
"147.32.84.165",3352,"174.128.246.102",80,3,186,3,186,0,0,86401.076216,9.000845999995363,165.3177934608332,0
"147.32.84.165",1900,"195.113.232.83",80,8,1362,5,774,3,588,86401.076266,10.275727000000188,602.5851017645648,457.77782924749886
"147.32.84.165",1886,"46.137.9.143",80,8,1448,5,746,3,702,86401.077079,0.14211000000068452,41995.637182262,39518.68271038596
"147.32.84.165",4917,"205.188.59.193",25,3,186,3,186,0,0,86401.114289,8.962822000001324,166.0191399538873,0
"147.32.84.165",3353,"67.19.72.206",80,3,186,3,186,0,0,86401.116579,8.960579000005964,166.06069764007543,0
"147.32.84.165",1906,"67.214.158.5",80,10,1760,5,871,5,889,86401.119781,0.33404800000425894,20859.277708326834,21290.35348186286
"147.32.84.165",1887,"68.67.185.216",80,10,1914,6,920,4,994,86401.223518,11.00592900000629,668.7304633707698,722.51965281581
"147.32.84.165",4919,"209.85.143.27",25,3,186,3,186,0,0,86401.252893,9.024562000005972,164.88334835519058,0
"147.32.84.165",3354,"193.23.181.44",179,10,781,5,481,5,300,86410.177178,0.19899600000644568,19337.07210132545,12060.543930140613
"147.32.84.165",1915,"147.32.84.171",139,22,3171,11,1639,11,1532,86410.242449,0.0232560000004014,563811.4894983525,527003.7839606322
"147.32.84.165",1914,"61.17.216.3",6667,1,62,1,62,0,0,86410.242699,0,0,0
"147.32.84.165",1912,"46.4.36.120",443,6,366,3,186,3,180,86411.581283,1.0307519999914803,1443.6062214890674,1397.0382788603877
"147.32.84.165",1888,"217.163.21.36",80,10,1451,5,701,5,750,86412.183221,0.13999799999874085,40057.715110576144,42857.75511117276
"147.32.84.165",4923,"205.188.159.42",25,3,186,3,186,0,0,86412.229142,8.984127000003355,165.62544140342678,0
"147.32.84.165",3355,"72.20.15.61",80,3,186,3,186,0,0,86412.61227,9.00211400000262,165.29450749008143,0
"147.32.84.165",1892,"184.82.155.108",80,10,1510,5,599,5,911,86412.785202,0.32268800000019837,14850.25783418365,22585.283617598176
"147.32.84.165",4927,"67.215.65.132",25,3,186,3,186,0,0,86412.891759,9.023858999993536,164.89619352441855,0
"147.32.84.165",3356,"174.37.196.55",80,3,186,3,186,0,0,86414.190035,9.030555999997887,164.7739076088281,0
"147.32.84.165",1924,"112.200.131.200",6667,6,366,3,186,3,180,86414.190166,3.1405919999961043,473.79602317074165,458.51228048781445
"147.32.84.165",1925,"46.4.36.120",443,6,366,3,186,3,180,86414.390572,1.0311039999942295,1443.1134007901505,1396.5613556033716
"147.32.84.165",1905,"184.82.155.107",80,10,1921,5,993,5,928,86415.421953,0.3398989999986952,23371.648636890648,21841.78241191795
"147.32.84.165",4928,"74.6.136.244",25,3,186,3,186,0,0,86415.534437,8.99043000000529,165.5093249153961,0
"147.32.84.165",3357,"174.128.246.102",80,3,186,3,186,0,0,86417.330992,8.999662999995053,165.33952438005934,0
"147.32.84.165",1929,"46.4.36.120",443,6,366,3,186,3,180,86417.331052,1.0002890000032494,1487.5700922385095,1439.5839602308156
"147.32.84.165",1908,"217.163.21.35",80,13,4177,7,2357,6,1820,86418.331581,0.23818399998708628,79165.68703616668,61129.21103344223
"147.32.84.165",4932,"61.9.189.122",25,3,186,3,186,0,0,86418.377779,8.956302999999025,166.13997985554553,0
"147.32.84.165",1932,"173.192.170.88",80,3,186,3,186,0,0,86420.209512,8.930116000003181,166.62717483171215,0
"147.32.84.165",3358,"193.23.181.44",80,8,838,5,452,3,386,86421.314093,0.1338710000127321,27011.077826086996,23066.98239130438
"147.32.84.165",1935,"186.110.109.63",6667,6,366,3,186,3,180,86421.314169,2.3858089999994263,623.6878140707651,603.5688523265468
"147.32.84.165",1934,"46.4.36.120",443,6,366,3,186,3,180,86421.380696,0.9644460000126855,1542.8546543616003,1493.085149382194
"147.32.84.165",1920,"217.163.21.35",80,13,5332,7,2316,6,3016,86422.116374,0.260813999993843,71039.13133665135,92510.37137795358
"147.32.84.165",4934,"205.188.59.193",25,3,186,3,186,0,0,86422.163941,8.882721999994828,167.51621856463214,0
"147.32.84.165",3359,"67.19.72.206",80,3,186,3,186,0,0,86422.31755,8.929847999999765,166.63217559806608,0
"147.32.84.165",1922,"217.163.21.36",80,13,6077,6,749,7,5328,86422.345296,0.19491500000003725,30741.60531513149,218679.9374085722
"147.32.84.165",4936,"64.12.90.98",25,3,186,3,186,0,0,86422.391208,8.856310999995912,168.01577993373164,0
"147.32.84.165",3360,"174.37.196.55",80,8,642,5,460,3,182,86423.70025,3.174234999998589,1159.3344538137962,458.69319694371944
"147.32.84.165",1947,"122.121.68.110",6667,6,366,3,186,3,180,86426.752809,1.9144450000021607,777.2487587777766,752.1762181720419
"147.32.84.165",1943,"46.4.36.120",443,6,366,3,186,3,180,86428.667506,1.0009200000058627,1486.6322982768697,1438.6764176872932
"147.32.84.165",1928,"184.82.155.108",80,10,1508,5,596,5,912,86429.668534,0.3263589999987744,14609.67829910591,22355.749343598305
"147.32.84.165",4937,"209.191.88.254",25,3,186,3,186,0,0,86429.774762,8.996708000006038,165.39383072108168,0
"147.32.84.165",3361,"72.20.15.61",80,3,186,3,186,0,0,86433.153545,9.028577000004589,164.81002487980595,0
"147.32.84.165",1953,"178.133.119.252",6667,3,184,2,124,1,60,86433.15365,2.6087030000053346,380.2655955844615,183.99948173441686
"147.32.84.165",1952,"46.4.36.120",443,6,366,3,186,3,180,86433.554803,1.030953999987105,1443.3233684709617,1396.7645501331888
"147.32.84.165",1933,"217.163.21.37",80,10,2502,5,1240,5,1262,86433.855159,0.13941099999647122,71156.50845522301,72418.9626374931
"147.32.84.165",4942,"74.6.136.244",25,3,186,3,186,0,0,86433.9009,8.98346100001072,165.6377202503828,0
"147.32.84.165",3363,"174.128.246.102",80,18,2180,14,1932,4,248,86433.90093,309.0729999999894,50.007603381727066,6.4191954651492305
"147.32.84.165",1941,"217.163.21.36",80,10,1448,5,699,5,749,86433.900954,0.13923100000829436,40163.469339923366,43036.39275479628
"147.32.84.165",4945,"85.119.248.7",25,3,186,3,186,0,0,86433.946848,8.937638999996125,166.4869212104724,0
"147.32.84.165",3364,"193.23.181.44",80,8,854,5,468,3,386,86434.585999,0.12852899999415968,29129.612773538473,24025.70626193558
"147.32.84.165",1944,"184.82.155.107",80,10,1920,5,989,5,931,86434.649904,0.3410349999903701,23199.964813650837,21839.400648644012
"147.32.84.165",4947,"64.12.90.97",25,3,186,3,186,0,0,86434.762502,9.02494800000568,164.87629624005186,0
"147.32.84.165",3365,"67.19.72.206",80,3,186,3,186,0,0,86436.464698,9.028023999999277,164.82012010602975,0
"147.32.84.165",1962,"46.4.36.120",443,6,366,3,186,3,180,86436.464826,1.0301590000017313,1444.4372179415986,1397.8424689757405
"147.32.84.165",1950,"217.163.21.36",80,14,6141,7,810,7,5331,86437.495208,0.18841600000450853,34391.98369482922,226350.2037989316
"147.32.84.165",4949,"65.54.188.126",25,3,186,3,186,0,0,86437.541144,8.954759000000195,166.16862609032444,0
"147.32.84.165",3366,"193.23.181.44",80,8,830,5,446,3,384,86439.273138,0.12833099999988917,27803.10291358348,23938.097575820753
"147.32.84.165",1967,"46.4.36.120",443,6,366,3,186,3,180,86439.336844,0.9713119999942137,1531.9485397162439,1482.5308448866876
"147.32.84.165",1956,"217.163.21.35",80,4,244,3,182,1,62,86440.30843,0.046331999998074025,31425.364760004413,10705.344039122383
"147.32.84.165",4951,"65.54.188.126",25,3,186,3,186,0,0,86440.35428,8.950832000002265,166.24152927902384,0
"147.32.84.165",3367,"67.19.72.206",80,3,186,3,186,0,0,86440.354339,8.950821000005817,166.241733579415,0
"147.32.84.165",1957,"217.163.21.35",80,11,3882,6,2254,5,1628,86440.354396,0.22850800000014715,78911.89805165853,56995.81633899738
"147.32.84.165",4952,"205.188.159.42",25,3,186,3,186,0,0,86440.35445,8.950761000000057,166.2428479544913,0
"147.32.84.165",3362,"67.19.72.206",80,3,186,3,186,0,0,86441.179077,9.02866000001086,164.80850978973737,0
"147.32.84.165",1970,"212.117.171.138",65500,216,169917,127,163201,89,6716,86441.179176,191.77803299999505,6807.912144974569,280.15721696343286
"147.32.84.165",1959,"184.82.155.108",80,10,1511,5,599,5,912,86441.179205,0.3265020000108052,14676.786052892216,22345.958063835897
"147.32.84.165",4953,"74.125.47.27",25,3,186,3,186,0,0,86441.287092,9.021441000004415,164.9403903433245,0
"147.32.84.165",1976,"173.192.170.88",80,13,1401,8,842,5,559,86443.084827,110.9880070000072,60.69124207266433,40.29264170857406
"147.32.84.165",3368,"174.128.246.102",80,12,1074,8,828,4,246,86443.285605,12.372283999997308,535.3902319087924,159.06521382797456
"147.32.84.165",1973,"77.238.177.9",25,3,186,3,186,0,0,86443.285714,8.929214999996475,166.64398830138902,0
"147.32.84.165",1975,"46.4.36.120",443,6,366,3,186,3,180,86443.286081,1.0304199999955017,1444.0713495530908,1397.4884027933138
"147.32.84.165",1964,"217.163.21.36",80,10,1451,5,701,5,750,86443.286145,0.13933900000120047,40247.16698090042,43060.449694258656
"147.32.84.165",4956,"74.6.136.244",25,3,186,3,186,0,0,86443.331974,8.98335799999768,165.63961939403777,0
"147.32.84.165",3369,"174.128.246.102",80,3,186,3,186,0,0,86444.316724,9.002316999991308,165.29078014042793,0
"147.32.84.165",1977,"109.200.239.148",6667,2,124,2,124,0,0,86444.316755,2.9823819999874104,332.62003324999534,0
"147.32.84.165",1988,"46.4.36.120",443,6,366,3,186,3,180,86448.301575,1.0308719999884488,1443.4381766278193,1396.8756548011156
"147.32.84.165",1974,"217.163.21.36",80,10,2274,5,1154,5,1120,86449.332668,0.14069499999459367,65617.11503859232,63683.85515010694
"147.32.84.165",4962,"205.188.159.42",25,3,186,3,186,0,0,86449.378493,8.956440000009025,166.13743853567942,0
"147.32.84.165",3370,"174.128.246.102",80,12,1146,8,900,4,246,86449.378551,12.399929999999586,580.648439144434,158.71057336614527
"147.32.84.165",1979,"184.82.155.107",80,10,1916,5,985,5,931,86449.378605,0.32236599999305326,24444.2652146002,23104.173517556126
"147.32.84.165",4964,"205.188.190.2",25,3,186,3,186,0,0,86449.485233,8.949613999997382,166.264153962443,0
"147.32.84.165",3371,"193.23.181.44",179,10,762,5,462,5,300,86450.8093,0.18795400000817608,19664.385965923695,12769.081796054348
"147.32.84.165",2000,"46.4.36.120",443,6,366,3,186,3,180,86450.870881,0.971306999999797,1531.9564257235982,1482.5384765067079
"147.32.84.165",1982,"217.163.21.36",80,14,6141,7,810,7,5331,86451.842435,0.25491600000532344,25420.13839800043,167302.17012313617
"147.32.84.165",4966,"65.55.92.136",25,3,186,3,186,0,0,86451.955571,8.886958000002778,167.43637136571758,0
"147.32.84.165",3372,"174.128.246.102",80,3,186,3,186,0,0,86454.924241,8.929004999998142,166.6479075776427,0
"147.32.84.165",2006,"190.114.77.46",6667,2,124,2,124,0,0,86454.924297,3.0096019999909913,329.6116895200659,0
"147.32.84.165",2012,"46.4.36.120",443,6,366,3,186,3,180,86455.826538,1.0315730000002077,1442.457295799425,1395.9264152897663
"147.32.84.165",1983,"217.163.21.35",80,13,5332,7,2316,6,3016,86456.858325,0.23414400000183377,79130.79130729334,103047.69714283105
"147.32.84.165",4967,"74.6.136.244",25,3,186,3,186,0,0,86456.904806,8.854983999990509,168.04095862867678,0
"147.32.84.165",3373,"174.37.196.55",80,3,186,3,186,0,0,86456.904867,8.8550499999983,168.0397061564063,0
"147.32.84.165",2023,"46.4.36.120",443,6,366,3,186,3,180,86458.334809,1.0309159999887925,1443.3765699787148,1396.8160354632723
"147.32.84.165",1998,"217.163.21.35",80,13,5895,7,2769,6,3126,86458.535498,0.169424000006984,130748.89035252888,147606.00622679858
"147.32.84.165",4969,"64.12.90.98",25,3,186,3,186,0,0,86458.581625,8.88294299998961,167.51205090494676,0
"147.32.84.165",3374,"193.23.181.44",179,10,757,5,457,5,300,86459.365921,0.1885669999901438,19388.334120981377,12727.571633029349
"147.32.84.165",1999,"184.82.155.108",80,10,1510,5,599,5,911,86459.427772,0.30810600001132116,15553.088871440092,23654.196931355465
"147.32.84.165",4978,"74.6.136.244",25,3,186,3,186,0,0,86459.529452,8.838929999998072,168.34616859736693,0
"147.32.84.165",3375,"193.23.181.44",80,8,852,5,468,3,384,86459.52951,0.12579900000127964,29761.762811802284,24419.907948145465
"147.32.84.165",2007,"217.163.21.36",80,10,1451,5,701,5,750,86459.529568,0.13966699999582488,40152.648801561154,42959.324680700236
"147.32.84.165",4979,"64.12.90.98",25,3,186,3,186,0,0,86459.5754,8.893167999995057,167.3194524157001,0
"147.32.84.165",3376,"67.19.72.206",80,3,186,3,186,0,0,86459.57546,8.89316800000961,167.31945241542633,0
"147.32.84.165",2033,"46.4.36.120",443,6,366,3,186,3,180,86461.244075,1.031542000011541,1442.500644649808,1395.9683657901367
"147.32.84.165",2021,"184.82.155.107",80,10,1921,5,993,5,928,86462.248095,0.304602000003797,26079.933814948603,24372.78809695096
"147.32.84.165",4982,"65.55.92.136",25,3,186,3,186,0,0,86462.275855,9.002246999996714,165.2920654143952,0
"147.32.84.165",3377,"174.128.246.102",80,3,186,3,186,0,0,86462.275913,9.002312999989954,165.2908535841467,0
"147.32.84.165",2038,"202.95.154.126",6667,5,306,3,186,2,120,86462.275966,8.598280999998678,173.05784726042668,111.65022403898494
"147.32.84.165",2025,"92.240.244.181",80,10,1758,6,1364,4,394,86462.348805,7.159652000002097,1524.0964225631083,440.24486106295063
"147.32.84.165",4986,"74.6.136.244",25,3,186,3,186,0,0,86462.357309,9.021269000004395,164.94353510567916,0
"147.32.84.165",3378,"72.20.15.61",80,3,186,3,186,0,0,86462.357368,9.021258000007947,164.94373622821664,0
"147.32.84.165",2043,"46.4.36.120",443,6,366,3,186,3,180,86464.15378,1.0313740000128746,1442.7356128634476,1396.1957543839815
"147.32.84.165",2026,"173.241.240.4",80,4,242,3,182,1,60,86464.254328,0.021082000006572343,69063.65617807086,22768.238300462923
"147.32.84.165",4987,"65.54.188.94",25,3,186,3,186,0,0,86464.270673,9.014614999992773,165.0652856501573,0
"147.32.84.165",3379,"174.37.196.55",80,3,186,3,186,0,0,86465.185371,9.004081999999471,165.25837947722903,0
"147.32.84.165",2030,"217.163.21.35",80,13,5328,7,2316,6,3012,86465.185432,0.24982599999930244,74163.6178782502,96451.12998673989
"147.32.84.165",4992,"64.12.90.98",25,3,186,3,186,0,0,86465.231519,8.958054000002448,166.10750504513518,0
"147.32.84.165",3381,"67.19.72.206",80,3,186,3,186,0,0,86465.231577,8.958045000006678,166.10767193052624,0
"147.32.84.165",2031,"217.163.21.36",80,15,6197,7,809,8,5388,86465.231631,0.20485599999665283,31592.923810411932,210411.21568664955
"147.32.84.165",4993,"205.188.156.193",25,3,186,3,186,0,0,86465.278324,9.010955000005197,165.13233059083547,0
"147.32.84.165",3380,"193.23.181.44",179,10,750,5,450,5,300,86468.368322,0.18432400000165217,19530.82615377125,13020.550769180833
"147.32.84.165",2054,"46.4.36.120",443,6,366,3,186,3,180,86468.429148,0.9708650000102352,1532.6538705013704,1483.2134230658423
"147.32.84.165",2042,"184.82.155.108",80,10,1507,5,596,5,911,86469.400221,0.32666799999424256,14595.85879267034,22310.113020340068
"147.32.84.165",4998,"174.123.49.130",25,3,186,3,186,0,0,86469.508156,8.994958000010229,165.4260086593298,0
"147.32.84.165",3383,"193.23.181.44",80,9,930,5,478,4,452,86470.374774,0.1312620000098832,29132.57454337186,27547.95751800017
"147.32.84.165",2065,"46.4.36.120",443,6,366,3,186,3,180,86470.439897,0.9659539999993285,1540.4460253811615,1490.7542181108013
"147.32.84.165",2049,"217.163.21.36",80,10,1448,5,699,5,749,86471.406086,0.14047699999355245,39807.22823135929,42654.66944962533
"147.32.84.165",5000,"220.181.12.68",25,3,186,3,186,0,0,86471.452013,8.957313999999315,166.12122785916782,0
"147.32.84.165",3384,"193.23.181.44",179,11,787,5,427,6,360,86472.884139,0.18574400000215974,18390.903609054832,15505.211473676203
"147.32.84.165",2069,"61.17.216.29",6667,2,124,2,124,0,0,86472.945078,2.949070999995456,336.3771167264296,0
"147.32.84.165",2070,"46.4.36.120",443,6,366,3,186,3,180,86477.800384,1.0308789999980945,1443.4283752048013,1396.8661695530336
"147.32.84.165",2062,"217.163.21.36",80,13,6077,6,749,7,5328,86478.402294,0.18764899999951012,31931.95807073655,227147.4934591246
"147.32.84.165",1025,"74.6.136.244",25,3,186,3,186,0,0,86478.448388,8.98420299999998,165.6240403294542,0
"147.32.84.165",3385,"72.20.15.61",80,3,186,3,186,0,0,86478.831489,9.005374000000302,165.23466987600406,0
"147.32.84.165",2067,"184.82.155.107",80,10,1909,5,981,5,928,86478.83152,0.30465199999161996,25760.53989540812,24368.78799484071
"147.32.84.165",1026,"64.12.90.33",25,3,186,3,186,0,0,86478.932506,9.004549000004772,165.24980873547486,0
"147.32.84.165",3386,"72.20.15.61",80,3,186,3,186,0,0,86479.50625,9.033020999995642,164.72894284212532,0
"147.32.84.165",2068,"217.163.21.35",80,13,5329,7,2314,6,3015,86479.506378,0.26849899999797344,68946.253059191,89832.73680789147
"147.32.84.165",1027,"64.12.90.98",25,3,186,3,186,0,0,86479.552312,8.987080999999307,165.5710013073338,0
"147.32.84.165",3387,"174.37.196.55",80,3,186,3,186,0,0,86480.509607,9.033785000006901,164.7150114817724,0
"147.32.84.165",2097,"41.212.41.40",6667,2,124,2,124,0,0,86483.418738,3.009689000013168,329.60216155079803,0
"147.32.84.165",2093,"46.4.36.120",443,6,366,3,186,3,180,86485.324993,1.0307360000006156,1443.6286304146856,1397.0599649174376
"147.32.84.165",2088,"217.163.21.36",80,10,1448,5,699,5,749,86486.328212,0.13998400000855327,39947.422560137726,42804.89198504028
"147.32.84.165",1028,"74.125.113.27",25,3,186,3,186,0,0,86486.355995,8.906219999989844,167.07424698712774,0
"147.32.84.165",3388,"67.19.72.206",80,3,186,3,186,0,0,86486.374661,8.887675999998464,167.42284484720832,0
"147.32.84.165",2117,"46.4.36.120",443,6,366,3,186,3,180,86488.438911,1.0311989999900106,1442.9804528654647,1396.4326963214176
"147.32.84.165",2090,"184.82.155.108",80,10,1507,5,596,5,911,86489.470304,0.30484499999147374,15640.735456160859,23907.231544568025
"147.32.84.165",1032,"74.6.136.244",25,3,186,3,186,0,0,86489.570772,8.902687999987393,167.1405310398508,0
"147.32.84.165",3390,"174.37.196.55",80,3,186,3,186,0,0,86489.570831,8.902656999998726,167.1411130407712,0
"147.32.84.165",2113,"217.163.21.35",80,11,3882,6,2254,5,1628,86489.570884,0.2287639999995008,78823.59112464963,56932.03476083833
"147.32.84.165",1037,"208.65.144.2",25,3,186,3,186,0,0,86489.616828,8.856681000004755,168.0087608438422,0
"147.32.84.165",3391,"193.23.181.44",179,10,744,5,444,5,300,86490.546116,0.18855999999505002,18837.505303846232,12728.044124220427
"147.32.84.165",2126,"46.4.36.120",443,6,366,3,186,3,180,86490.607828,0.8692380000138655,1711.8441669327208,1656.623387354246
"147.32.84.165",2116,"184.82.155.107",80,10,1920,5,989,5,931,86491.47732,0.3421620000008261,23123.549663553807,21767.466872364606
"147.32.84.165",1038,"205.178.149.7",25,3,186,3,186,0,0,86491.590586,8.989698999997927,165.52278335463103,0
"147.32.84.165",3392,"174.37.196.55",80,3,186,3,186,0,0,86492.351894,9.031664999987697,164.7536749870624,0
"147.32.84.165",2130,"98.126.71.122",80,12,4257,7,770,5,3487,86492.351989,17.165937999991,358.85018342739147,1625.0786878069014
"147.32.84.165",2131,"61.17.216.83",6667,6,366,3,186,3,180,86492.527163,1.4310159999877214,1039.820658897432,1006.2780569975148
"147.32.84.165",2135,"46.4.36.120",443,6,366,3,186,3,180,86493.958457,1.0307549999997718,1443.6020198789522,1397.034212786083
"147.32.84.165",2124,"217.163.21.36",80,14,6134,7,809,7,5325,86494.989422,0.18817700000363402,34393.15112832607,226382.607859501
"147.32.84.165",1040,"64.12.90.98",25,3,186,3,186,0,0,86495.035276,8.955835000000661,166.14866173839627,0
"147.32.84.165",3393,"72.20.15.61",80,9,666,5,424,4,242,86495.035335,3.30305300001055,1026.9287232112733,586.1244127762455
"147.32.84.165",2137,"95.100.248.96",80,11,4453,6,1399,5,3054,86498.155193,13.107556999995722,853.8585794441826,1863.9629032326905
"147.32.84.165",2149,"82.205.221.102",6667,2,124,2,124,0,0,86498.156451,2.925529000000097,339.0839742145667,0
"147.32.84.165",2146,"46.4.36.120",443,6,366,3,186,3,180,86498.473367,1.030958000003011,1443.3177685178778,1396.7591308237527
"147.32.84.165",2125,"217.163.21.36",80,10,2274,5,1154,5,1120,86499.37656,0.14083999999274965,65549.55978752667,63618.29026172433
"147.32.84.165",1041,"74.6.136.244",25,3,186,3,186,0,0,86499.422475,9.040024000001722,164.60133291678392,0
"147.32.84.165",3394,"67.19.72.206",80,3,186,3,186,0,0,86499.504551,9.001954999999725,165.29742705890501,0
"147.32.84.165",2152,"195.113.232.83",80,8,1233,5,861,3,372,86499.504626,11.75831200000539,585.798369697695,253.09755345823754
"147.32.84.165",2132,"184.82.155.108",80,10,1511,5,599,5,912,86499.505422,0.3224999999947613,14858.914728923539,22623.25581432098
"147.32.84.165",1045,"205.188.156.193",25,3,186,3,186,0,0,86499.612037,8.995011000006343,165.42503394369953,0
"147.32.84.165",3395,"193.23.181.44",179,10,745,5,445,5,300,86499.878277,0.1866790000058245,19070.168577552515,12856.293423069112
"147.32.84.165",2142,"217.163.21.36",80,10,1446,5,698,5,748,86499.940113,0.14143599999079015,39480.754548796715,42308.88882879648
"147.32.84.165",1049,"205.188.146.193",25,3,186,3,186,0,0,86499.986017,9.022826999993413,164.91505378536974,0
"147.32.84.165",3397,"193.23.181.44",179,10,758,5,458,5,300,86500.480601,0.19797199999447912,18507.667751511217,12122.926474789007
"147.32.84.165",2164,"46.4.36.120",443,6,366,3,186,3,180,86500.545841,0.96501200000057,1541.949737411681,1492.2094233016269
"147.32.84.165",2155,"217.163.21.35",80,13,5895,7,2769,6,3126,86501.483481,0.16554000000178348,133816.6002160284,151069.22797952502
"147.32.84.165",1050,"68.6.19.3",25,3,186,3,186,0,0,86501.511049,9.002668000000995,165.28433571024007,0
"147.32.84.165",3398,"193.23.181.44",80,10,951,6,507,4,444,86501.529369,0.12943400000222027,31336.434012163918,27442.557596451243
"147.32.84.165",2156,"184.82.155.107",80,10,1897,5,993,5,904,86501.591693,0.3260100000043167,24367.350694441317,22183.36860803117
"147.32.84.165",1052,"74.6.136.244",25,3,186,3,186,0,0,86501.699357,9.014049999997951,165.075631930191,0
"147.32.84.165",3399,"174.128.246.102",80,3,186,3,186,0,0,86501.699414,9.014127999995253,165.07420351705497,0
"147.32.84.165",2157,"217.163.21.36",80,13,6081,6,750,7,5331,86501.699465,0.1861429999989923,32233.28301377157,229114.17566188832
"147.32.84.165",1054,"203.188.197.119",25,3,186,3,186,0,0,86501.745295,8.968296999999438,165.91778795908445,0
"147.32.84.165",3400,"67.19.72.206",80,3,186,3,186,0,0,86507.302748,9.028449000004912,164.8123614586725,0
"147.32.84.165",2187,"93.178.250.214",6667,6,366,3,186,3,180,86507.302875,1.0725340000062715,1387.368605555907,1342.6147795702325
"147.32.84.165",2176,"46.4.36.120",443,6,366,3,186,3,180,86507.302935,1.0307259999972302,1443.642636359225,1397.0735190573146
"147.32.84.165",2160,"217.163.21.35",80,11,3880,6,2253,5,1627,86508.333895,0.2683169999945676,67174.27520568924,48509.78506864464
"147.32.84.165",1057,"205.188.156.193",25,3,186,3,186,0,0,86508.375645,8.959018000008655,166.08963169831364,0
"147.32.84.165",3401,"193.23.181.44",80,10,974,6,528,4,446,86508.375676,0.17629499999748077,23959.84004118302,20238.804277211413
"147.32.84.165",2168,"173.241.240.4",80,9,2194,5,1164,4,1030,86508.38012,0.12627300000167452,73744.98111137387,65255.43861229818
"147.32.84.165",1059,"74.125.93.27",25,3,186,3,186,0,0,86508.409651,8.925134000004618,166.7201859377383,0
"147.32.84.165",3402,"72.20.15.61",80,3,186,3,186,0,0,86508.468851,8.967151000004378,165.9389922171795,0
"147.32.84.165",2196,"46.4.36.120",443,6,366,3,186,3,180,86510.51386,1.0299669999949401,1444.7064808943492,1398.1030460267893
"147.32.84.165",2169,"92.240.244.181",80,10,1758,6,1364,4,394,86511.544125,9.203053999997792,1185.693357879093,342.4950022026119
"147.32.84.165",1060,"205.188.159.42",25,3,186,3,186,0,0,86511.552644,8.992076000009547,165.47902842440612,0
"147.32.84.165",3404,"67.19.72.206",80,3,186,3,186,0,0,86512.619964,9.028275000004214,164.8155378518383,0
"147.32.84.165",2202,"74.115.3.63",6667,2,124,2,124,0,0,86513.523306,3.0091799999936484,329.6579134522009,0
"147.32.84.165",2204,"46.4.36.120",443,6,366,3,186,3,180,86520.444325,1.031474999996135,1442.5943430578304,1396.059041668868
"147.32.84.165",2172,"184.82.155.108",80,10,1300,5,580,5,720,86520.645279,0.30558299999393057,15184.090738333476,18849.216088965695
"147.32.84.165",1061,"74.6.136.244",25,3,186,3,186,0,0,86520.746576,8.987389000001713,165.5653271489324,0
"147.32.84.165",2218,"173.192.170.88",80,13,1222,8,667,5,555,86521.046448,70.87570300001244,75.2867311947377,62.64488127897964
"147.32.84.165",3403,"174.37.196.55",80,3,186,3,186,0,0,86521.046574,8.928400999997393,166.65918119049923,0
"147.32.84.165",2229,"82.205.221.102",6667,2,124,2,124,0,0,86521.476026,2.881383999992977,344.27899925952875,0
"147.32.84.165",2222,"94.100.176.20",25,3,186,3,186,0,0,86522.450766,9.0289300000004,164.80358137674497,0
"147.32.84.165",2173,"217.163.21.36",80,10,1451,5,701,5,750,86522.651953,0.14701400000194553,38146.02690849705,40812.43963105961
"147.32.84.165",1064,"217.115.140.156",25,3,186,3,186,0,0,86522.698044,8.982101999994484,165.66278138468186,0
"147.32.84.165",3405,"72.20.15.61",80,3,186,3,186,0,0,86528.069326,9.028573000003234,164.8100978969176,0
"147.32.84.165",2233,"46.4.36.120",443,6,366,3,186,3,180,86528.069452,1.0302470000024186,1444.3138392992232,1397.7230702895708
"147.32.84.165",2193,"217.163.21.36",80,10,2272,5,1153,5,1119,86529.09994,0.14025300000503194,65766.86416453884,63827.51170868947
"147.32.84.165",1068,"65.54.188.94",25,3,186,3,186,0,0,86529.145867,8.955369999996037,166.15728886697684,0
"147.32.84.165",3406,"193.23.181.44",80,8,866,5,482,3,384,86529.272731,0.13136699999449775,29352.881622945693,23384.86834691109
"147.32.84.165",2197,"184.82.155.107",80,10,1920,5,989,5,931,86529.33795,0.3723469999968074,21248.99623219158,20002.84680704789
"147.32.84.165",1069,"74.6.136.244",25,3,186,3,186,0,0,86529.373511,9.028325000006589,164.81462508260546,0
"147.32.84.165",3408,"67.19.72.206",80,3,186,3,186,0,0,86529.373634,9.028260999999475,164.81579342910962,0
"147.32.84.165",2226,"93.184.220.20",80,13,6575,8,756,5,5819,86529.373687,5.274925999998231,1146.5563687532351,8825.147499702482
"147.32.84.165",1072,"205.188.59.193",25,3,186,3,186,0,0,86529.390023,9.01189599999634,165.11508787946556,0
"147.32.84.165",3407,"193.23.181.44",80,8,821,5,437,3,384,86529.450924,0.14984299999196082,23331.08653849404,20501.458194008494
"147.32.84.165",2235,"217.163.21.35",80,11,3886,6,2256,5,1630,86529.511268,0.27277899999171495,66163.45100080346,47804.26645891385
"147.32.84.165",1075,"205.188.159.42",25,3,186,3,186,0,0,86529.557161,8.945001000000047,166.34989755730516,0
"147.32.84.165",3409,"174.128.246.102",80,16,2205,11,1897,5,308,86529.557205,45.335593999989214,334.7480127866773,54.35023085835351
"147.32.84.165",2249,"217.163.21.35",80,13,5894,7,2768,6,3126,86529.557241,0.25420999999914784,87109.0830418718,98375.3589555243
"147.32.84.165",1077,"132.215.17.4",25,3,186,3,186,0,0,86529.557281,8.945005000001402,166.34982316944115,0
"147.32.84.165",3410,"174.128.246.102",80,17,1872,13,1624,4,248,86532.483284,189.12229699999443,68.69628915304673,10.490566323864279
"147.32.84.165",2267,"111.92.142.42",6667,2,124,2,124,0,0,86532.483333,3.0093090000009397,329.64378201098333,0
"147.32.84.165",2266,"46.4.36.120",443,6,366,3,186,3,180,86533.586391,1.0324319999926956,1441.25714818073,1394.764982110384
"147.32.84.165",2254,"68.67.179.210",80,10,1599,6,775,4,824,86534.619091,30.308841000005486,204.5607748577017,217.49429481644668
"147.32.84.165",1081,"74.6.136.244",25,3,186,3,186,0,0,86534.648148,8.97034500000882,165.8799076288077,0
"147.32.84.165",3411,"174.37.196.55",80,7,599,4,417,3,182,86534.648206,0.24250300000130665,13756.530846966945,6004.049434407635
"147.32.84.165",2255,"195.113.232.98",80,8,1339,5,701,3,638,86534.648259,60.31308900000295,92.98147538090323,84.62508030387485
"147.32.84.165",1084,"207.8.173.121",25,3,186,3,186,0,0,86534.648315,8.970274000006611,165.88122057351907,0
"147.32.84.165",3412,"67.19.72.206",80,3,186,3,186,0,0,86538.101116,9.02933099999791,164.79626231448867,0
"147.32.84.165",2290,"208.84.201.167",6667,2,124,2,124,0,0,86541.712275,3.0099719999998342,329.5711720906555,0
"147.32.84.165",2280,"46.4.36.120",443,6,366,3,186,3,180,86542.013084,1.0316039999888744,1442.4139495543325,1395.8844673106444
"147.32.84.165",2256,"63.251.249.49",80,9,1237,5,609,4,628,86543.044926,0.5521480000024894,8823.721176166597,9099.009685767853
"147.32.84.165",1087,"205.188.156.193",25,3,186,3,186,0,0,86543.226691,9.021653000003425,164.93651440588937,0
"147.32.84.165",3413,"174.37.196.55",80,3,186,3,186,0,0,86543.518708,9.03023899999971,164.77969187748494,0
"147.32.84.165",2298,"74.125.93.27",25,3,186,3,186,0,0,86543.71907,9.030380999989575,164.77710076703494,0
"147.32.84.165",2258,"184.82.155.108",80,10,1510,5,599,5,911,86548.134027,0.35876200000348035,13357.044502911436,20314.303075379496
"147.32.84.165",1089,"205.188.159.42",25,3,186,3,186,0,0,86548.252538,8.911013999997522,166.98436339572734,0
"147.32.84.165",3414,"193.23.181.44",179,10,754,5,454,5,300,86550.140559,0.19564700000046287,18564.046471407215,12266.991060401244
"147.32.84.165",2299,"46.4.36.120",443,6,366,3,186,3,180,86550.204735,0.9676119999930961,1537.8064761605033,1488.1998156391967
"147.32.84.165",2260,"217.163.21.36",80,10,2277,5,1156,5,1121,86550.442298,0.13998300000093877,66065.16505531372,64064.92216869089
"147.32.84.165",1090,"66.94.238.147",25,3,186,3,186,0,0,86550.488318,8.984085000003688,165.62621569134632,0
"147.32.84.165",3415,"72.20.15.61",80,3,186,3,186,0,0,86550.542947,8.929581000003964,166.63715800319628,0
"147.32.84.165",2262,"173.241.240.4",80,9,2193,5,1163,4,1030,86551.172566,0.06775600000401028,137316.25242708134,121612.8460876129
"147.32.84.165",1091,"65.55.92.136",25,3,186,3,186,0,0,86551.18905,8.88471600000048,167.47862283948294,0
"147.32.84.165",3416,"72.20.15.61",80,3,186,3,186,0,0,86555.558895,9.029747000007774,164.7886701586123,0
"147.32.84.165",2314,"46.175.169.64",6667,1,62,1,62,0,0,86555.559166,0,0,0
"147.32.84.165",2317,"46.4.36.120",443,6,366,3,186,3,180,86558.167684,1.0405270000046585,1430.0445831711606,1383.9141127462844
"147.32.84.165",2263,"92.240.244.181",80,10,1757,6,1363,4,394,86559.070773,5.857363000002806,1861.588568097073,538.1261157962192
"147.32.84.165",1092,"205.178.149.7",25,3,186,3,186,0,0,86559.079341,9.021329999988666,164.94241979861832,0
"147.32.84.165",3417,"193.23.181.44",179,10,749,5,449,5,300,86559.208451,0.19107100000837818,18799.29450226615,12560.775836703444
"147.32.84.165",2277,"68.67.185.218",80,10,2306,6,988,4,1318,86559.271073,11.010477000003448,717.8617238833091,957.6333523058718
"147.32.84.165",1097,"64.12.90.1",25,3,186,3,186,0,0,86559.300311,9.000832000005175,165.3180505978941,0
"147.32.84.165",3418,"193.23.181.44",179,10,781,5,481,5,300,86564.18737,0.1900279999972554,20249.647420672623,12629.71772599124
"147.32.84.165",2338,"112.110.99.104",6667,2,124,2,124,0,0,86564.24887,2.948946000004071,336.3913750874484,0
"147.32.84.165",2336,"46.4.36.120",443,6,366,3,186,3,180,86564.488089,1.030692000000272,1443.6902585831726,1397.1196050804897
"147.32.84.165",2284,"184.82.155.107",80,10,1921,5,993,5,928,86564.689078,0.34213600000657607,23218.836953279722,21698.97350719394
"147.32.84.165",1098,"205.188.190.2",25,3,186,3,186,0,0,86564.802163,9.016917999993893,165.02312652737973,0
"147.32.84.165",2345,"173.192.170.88",80,3,186,3,186,0,0,86565.519107,9.001990000004298,165.29678437759756,0
"147.32.84.165",3419,"174.128.246.102",80,3,186,3,186,0,0,86565.519169,9.001948999997694,165.29753723336816,0
"147.32.84.165",2347,"74.125.39.27",25,3,186,3,186,0,0,86565.519218,9.001919999995152,165.29806974521006,0
"147.32.84.165",2306,"217.163.21.36",80,14,6137,7,809,7,5328,86568.200848,0.1876300000003539,34493.41789685974,227170.49512295265
"147.32.84.165",1099,"68.6.19.3",25,3,186,3,186,0,0,86568.246834,8.982571000000462,165.6541317624902,0
"147.32.84.165",3420,"193.23.181.44",179,11,841,5,481,6,360,86569.204126,0.20389000000432134,18872.92167305137,14125.26362224219
"147.32.84.165",2351,"46.4.36.120",443,6,366,3,186,3,180,86569.270937,0.9638360000099055,1543.8311081809638,1494.0301046912555
"147.32.84.165",2312,"217.163.21.35",80,13,5899,7,2771,6,3128,86570.235016,0.18042900000000373,122862.73270926261,138691.67373315533
"147.32.84.165",1104,"74.6.136.244",25,3,186,3,186,0,0,86570.281249,8.955088999995496,166.1625026843115,0
"147.32.84.165",3421,"193.23.181.44",80,8,816,5,432,3,384,86571.511794,0.12862499999755528,26868.804665233718,23883.381924652193
"147.32.84.165",2366,"190.53.151.16",6667,2,124,2,124,0,0,86571.5119,3.009128999998211,329.6635006344327,0
"147.32.84.165",2365,"46.4.36.120",443,6,366,3,186,3,180,86571.575843,0.966524000003119,1539.5375593313754,1489.87505741746
"147.32.84.165",2333,"217.163.21.37",80,4,244,3,182,1,62,86572.113756,0.04930999998759944,29527.47922056697,10058.811602610725
"147.32.84.165",1105,"209.86.93.226",25,3,186,3,186,0,0,86572.159646,8.982999999992899,165.6462206391157,0
"147.32.84.165",3422,"193.23.181.44",179,10,781,5,481,5,300,86572.542599,0.20601900000474416,18677.88893214407,11649.410976389232
"147.32.84.165",2334,"77.246.37.4",80,4,244,3,182,1,62,86572.609719,0.022534000003361143,64613.472964534696,22011.183097808524
"147.32.84.165",1110,"217.5.218.234",25,3,186,3,186,0,0,86572.631974,9.01149199999054,165.12249026038774,0
"147.32.84.165",3423,"72.20.15.61",80,3,186,3,186,0,0,86578.233038,8.929576999988058,166.6372326485331,0
"147.32.84.165",2376,"46.4.36.120",443,6,366,3,186,3,180,86580.138705,1.0311649999930523,1443.0280314110987,1396.4787400752568
"147.32.84.165",2349,"184.82.155.108",80,10,1508,5,596,5,912,86580.340041,0.3235409999906551,14736.926695960372,22550.46501126822
"147.32.84.165",1112,"65.55.92.136",25,3,186,3,186,0,0,86580.446781,8.922355999995489,166.77209472484088,0
"147.32.84.165",3424,"193.23.181.44",179,10,783,5,483,5,300,86581.170112,0.19126999999571126,20201.808961607363,12547.707429569791
"147.32.84.165",2354,"217.163.21.36",80,10,1448,5,699,5,749,86581.232776,0.14037399999506306,39836.436948414026,42685.967488357805
"147.32.84.165",1113,"74.6.136.244",25,3,186,3,186,0,0,86581.27864,8.894095999989077,167.3019944918323,0
"147.32.84.165",3425,"193.23.181.44",80,8,864,5,480,3,384,86581.27871,0.12544699999853037,30610.53672104543,24488.429376836346
"147.32.84.165",2361,"173.241.240.4",80,9,2195,5,1165,4,1030,86581.278778,0.07031699999060947,132542.6284005951,117183.61137563342
"147.32.84.165",1115,"205.188.146.193",25,3,186,3,186,0,0,86581.295113,8.87774399999762,167.61014960562042,0
"147.32.84.165",3426,"174.128.246.102",80,3,186,3,186,0,0,86585.758232,9.02904700000363,164.8014458225106,0
"147.32.84.165",2397,"89.38.42.156",6667,1,62,1,62,0,0,86585.758378,0,0,0
"147.32.84.165",2398,"46.4.36.120",443,6,366,3,186,3,180,86586.46046,1.0325840000004973,1441.0449900436995,1394.5596677842252
"147.32.84.165",2362,"92.240.244.181",80,10,1760,6,1366,4,394,86587.493272,7.468175999994855,1463.2756378542133,422.05754122588587
"147.32.84.165",1116,"64.12.90.33",25,3,186,3,186,0,0,86587.50194,8.9908940000023,165.50078334808745,0
"147.32.84.165",3427,"67.19.72.206",80,3,186,3,186,0,0,86588.265855,9.029014999992796,164.802029900403,0
"147.32.84.165",2407,"66.111.4.71",25,3,186,3,186,0,0,86589.168711,9.028500999993412,164.81141221572506,0
"147.32.84.165",2373,"184.82.155.107",80,10,1920,5,989,5,931,86591.175371,0.3077449999982491,25709.59723162038,24201.85543239492
"147.32.84.165",1123,"218.57.22.44",25,3,186,3,186,0,0,86591.276997,9.02754600001208,164.8288471748589,0
"147.32.84.165",2419,"173.192.170.88",80,3,186,3,186,0,0,86593.082012,9.02807600000233,164.81917077344232,0
"147.32.84.165",3428,"72.20.15.61",80,3,186,3,186,0,0,86593.583421,9.028351999993902,164.8141321916785,0
"147.32.84.165",2417,"60.190.222.152",6667,12,2348,9,2162,3,186,86593.583484,93.64345299999695,184.70057912111125,15.890059073324094
"147.32.84.165",2409,"46.4.36.120",443,6,366,3,186,3,180,86593.916657,0.9986110000027111,1490.0697068187314,1442.0029420826434
"147.32.84.165",2391,"217.163.21.36",80,13,6081,6,750,7,5331,86594.915371,0.18617000000085682,32228.608261118257,229080.94752002857
"147.32.84.165",1129,"64.12.90.1",25,3,186,3,186,0,0,86594.961197,8.95432200000505,166.1767356589545,0
"147.32.84.165",3429,"67.19.72.206",80,3,186,3,186,0,0,86598.298196,9.04018699999142,164.5983650561003,0
"147.32.84.165",2426,"46.4.36.120",443,6,366,3,186,3,180,86598.298323,1.0299720000039088,1444.6994675528588,1398.0962589221213
"147.32.84.165",2394,"217.163.21.35",80,11,3892,6,2254,5,1638,86599.200888,0.2564259999926435,70320.48232440281,51102.4623102803
"147.32.84.165",1134,"74.6.136.244",25,3,186,3,186,0,0,86599.246823,8.993251000007149,165.45740800504925,0
"147.32.84.165",3430,"72.20.15.61",80,3,186,3,186,0,0,86599.328491,9.011301000005915,165.12599013161622,0
"147.32.84.165",2440,"184.82.155.107",80,10,1888,5,957,5,931,86601.408039,0.30397500000253785,25186.28176638237,24502.014968131647
"147.32.84.165",2441,"46.4.36.120",443,6,366,3,186,3,180,86601.508278,1.0309500000003027,1443.328968426755,1396.769969445247
"147.32.84.165",2424,"217.163.21.36",80,10,1451,5,701,5,750,86602.210512,0.13927299999340903,40266.239689425754,43080.855587830694
"147.32.84.165",1135,"168.95.5.38",25,3,186,3,186,0,0,86602.256359,8.982755999997607,165.6507201131141,0
"147.32.84.165",3431,"72.20.15.61",80,3,186,3,186,0,0,86602.539514,9.001405999995768,165.30750862706333,0
"147.32.84.165",2443,"184.82.155.108",80,10,1510,5,599,5,911,86602.539586,0.3232700000080513,14823.522132832159,22544.622141920026
"147.32.84.165",2438,"217.163.21.36",80,10,2274,5,1154,5,1120,86602.646307,0.14015700000163633,65868.98977498246,63928.30896705403
"147.32.84.165",1136,"64.12.90.98",25,3,186,3,186,0,0,86602.692467,8.948107000003802,166.2921554245348,0
"147.32.84.165",3432,"193.23.181.44",179,10,759,5,459,5,300,86608.53985,0.19578500000352506,18755.267257113093,12258.344612492217
"147.32.84.165",2450,"217.163.21.40",80,14,6137,7,809,7,5328,86608.60407,0.18833699999959208,34363.93273766715,226317.717708641
"147.32.84.165",2455,"61.17.216.83",6667,6,366,3,186,3,180,86608.65016,1.4763220000022557,1007.9101984511011,975.3969662430011
"147.32.84.165",2452,"46.4.36.120",443,6,366,3,186,3,180,86609.333347,1.030849999995553,1443.4689819143612,1396.9054663687366
"147.32.84.165",1138,"64.12.90.33",25,3,186,3,186,0,0,86610.126724,8.838340000002063,168.35740648126827,0
"147.32.84.165",3433,"174.128.246.102",80,3,186,3,186,0,0,86610.235817,8.931016000002273,166.61038340986303,0
"147.32.84.165",2463,"217.163.21.40",80,10,1448,5,699,5,749,86610.235943,0.1397059999871999,40026.913665213724,42890.06914913459
"147.32.84.165",2469,"216.157.130.15",25,3,186,3,186,0,0,86610.281822,8.88505399999849,167.47225171622512,0
"147.32.84.165",1140,"204.127.217.16",25,3,186,3,186,0,0,86610.364419,8.901966999997967,167.1540683087614,0
"147.32.84.165",3435,"67.19.72.206",80,3,186,3,186,0,0,86612.342968,8.929599000010057,166.6368221012303,0
"147.32.84.165",2467,"184.82.155.107",80,10,1916,5,985,5,931,86614.149149,0.34216499999456573,23029.82479249821,21767.276022148057
"147.32.84.165",2471,"46.4.36.120",443,6,366,3,186,3,180,86614.262147,1.0183819999947445,1461.1413006196879,1414.0077102771172
"147.32.84.165",1141,"65.55.92.152",25,3,186,3,186,0,0,86615.280738,8.902008000004571,167.1532984467365,0
"147.32.84.165",2479,"173.192.170.88",80,16,1766,10,1145,6,621,86615.855257,103.04074399999809,88.89687364835186,48.2139375857
"147.32.84.165",3434,"193.23.181.44",80,8,898,5,514,3,384,86616.056022,0.1468029999959981,28010.32676520299,20926.002875171103
"147.32.84.165",2470,"217.163.21.36",80,13,5325,7,2314,6,3011,86616.122941,0.2690100000036182,68815.2856761868,89543.13965903132
"147.32.84.165",2475,"212.117.171.138",65500,35,10056,17,5372,18,4684,86616.168769,66.30351800000062,648.1707350732067,565.1585486006888
"147.32.84.165",1143,"74.6.136.244",25,3,186,3,186,0,0,86616.168801,9.779278999994858,152.158456671579,0
"147.32.84.165",3436,"174.37.196.55",80,3,186,3,186,0,0,86616.168832,9.782441000003018,152.1092741575994,0
"147.32.84.165",2480,"184.82.155.108",80,10,1510,5,599,5,911,86620.168855,0.3414820000034524,14032.95049212419,21342.26694211208
"147.32.84.165",2476,"116.228.139.242",6667,3,186,3,186,0,0,86620.269552,10.577674000000115,140.6736490460931,0
"147.32.84.165",2487,"46.4.36.120",443,6,366,3,186,3,180,86620.281,1.0189059999975143,1460.3898691377126,1413.280518520367
"147.32.84.165",1146,"205.188.59.194",25,3,186,3,186,0,0,86621.300124,10.408723000000464,142.9570178781714,0
"147.32.84.165",3437,"174.128.246.102",80,3,186,3,186,0,0,86623.179713,9.610360999999102,154.83289337415513,0
"147.32.84.165",2497,"217.163.21.40",80,15,6197,7,809,8,5388,86623.179812,0.18830599999637343,34369.58992344717,228904.01793267415
"147.32.84.165",2481,"65.55.196.251",443,130,165145,70,5572,60,159573,86623.225724,9.813034999999218,4542.529400945126,130090.6396441164
"147.32.84.165",2498,"46.4.36.120",443,6,366,3,186,3,180,86623.325314,0.9847589999990305,1511.029602168109,1462.2867117755895
"147.32.84.165",1156,"64.12.90.33",25,3,186,3,186,0,0,86623.580966,9.218682999999146,161.41134259634893,0
"147.32.84.165",3438,"193.23.181.44",80,10,974,6,528,4,446,86623.581131,0.21423300000606105,19716.850344627088,16654.763738075155
"147.32.84.165",2499,"184.82.155.107",80,10,1916,5,985,5,931,86623.710664,0.3405639999982668,23138.088582586835,21869.604538465323
"147.32.84.165",2500,"190.114.77.46",6667,2,124,2,124,0,0,86623.823238,4.384810000003199,226.2355723507464,0
"147.32.84.165",1157,"72.4.117.21",25,3,186,3,186,0,0,86624.310266,9.001808000000892,165.30012637459637,0
"147.32.84.165",3439,"174.128.246.102",80,9,672,6,488,3,184,86632.573645,4.812694000007468,811.1880788585232,305.8578002253448
"147.32.84.165",2501,"217.163.21.40",80,10,1448,5,699,5,749,86632.576844,0.32881300000008196,17006.626866938368,18223.123781597766
"147.32.84.165",2508,"46.4.36.120",443,6,366,3,186,3,180,86632.580043,0.9606889999995474,1548.8883499245865,1498.9242096044386
"147.32.84.165",1162,"74.6.136.244",25,3,186,3,186,0,0,86632.783674,7.551464999996824,197.04785760122385,0
"147.32.84.165",3440,"67.19.72.206",80,3,186,3,186,0,0,86632.802846,8.836770999987493,168.3872989355621,0
"147.32.84.165",2506,"184.82.155.108",80,10,1510,5,599,5,911,86632.806049,0.3253169999952661,14730.24772781543,22402.764073522296
"147.32.84.165",1163,"67.231.144.94",25,3,186,3,186,0,0,86632.912744,9.028944999998203,164.80330758469523,0
"147.32.84.165",3441,"174.37.196.55",80,3,186,3,186,0,0,86633.312211,9.030337999996846,164.777885390394,0
"147.32.84.165",2523,"184.82.155.107",80,10,1921,5,993,5,928,86633.312265,0.30443400000513066,26094.32586329424,24386.238067610328
"147.32.84.165",2529,"218.241.209.6",6667,2,124,2,124,0,0,86633.412618,3.0090349999954924,329.67379907561264,0
"147.32.84.165",1164,"64.12.90.98",25,3,186,3,186,0,0,86633.540851,9.002697999996599,165.28378492764747,0
"147.32.84.165",3442,"193.23.181.44",80,8,831,5,447,3,384,86636.220802,0.14394900000479538,24842.13158744328,21340.891565051945
"147.32.84.165",2526,"217.163.21.36",80,11,3882,6,2254,5,1628,86636.291285,0.2577759999985574,69952.20656733333,50524.48637605087
"147.32.84.165",2533,"46.4.36.120",443,6,366,3,186,3,180,86636.337146,1.0297829999908572,1444.9646187723151,1398.352856876434
"147.32.84.165",1165,"66.94.238.147",25,3,186,3,186,0,0,86637.224362,9.03099199999997,164.76595262181664,0
"147.32.84.165",3444,"193.23.181.44",80,9,884,5,440,4,444,86637.367123,0.13607799999590497,25867.517160054733,26102.67640696432
"147.32.84.165",2528,"217.163.21.40",80,13,6077,6,749,7,5328,86637.43383,0.18738000000303145,31977.79912425585,227473.58308949953
"147.32.84.165",1166,"209.92.166.35",25,3,186,3,186,0,0,86637.479908,8.976009000005433,165.77523485093423,0
"147.32.84.165",3445,"174.128.246.102",80,3,186,3,186,0,0,86639.734057,8.92854300000181,166.65653063435977,0
"147.32.84.165",2531,"184.82.155.108",80,10,1507,5,596,5,911,86639.73422,0.34412199999496806,13855.551229127228,21178.535519689438
"147.32.84.165",2550,"46.4.36.120",443,6,366,3,186,3,180,86639.847517,1.0170599999983096,1463.040528584816,1415.8456728240155
"147.32.84.165",1167,"64.12.90.97",25,3,186,3,186,0,0,86640.864796,8.902304000002914,167.14774062978674,0
"147.32.84.165",3446,"67.19.72.206",80,3,186,3,186,0,0,86641.339103,8.928820000000997,166.65136042610715,0
"147.32.84.165",2539,"217.163.21.40",80,10,2274,5,1154,5,1120,86642.342659,0.1406600000045728,65633.4423411053,63699.7014055788
"147.32.84.165",2560,"46.4.36.120",443,6,366,3,186,3,180,86642.388867,0.9852430000028107,1510.2873098268701,1461.568364348584
"147.32.84.165",1169,"74.6.136.244",25,3,186,3,186,0,0,86643.374304,8.901072000007844,167.1708755977582,0
"147.32.84.165",3447,"174.128.246.102",80,3,186,3,186,0,0,86643.374364,8.901133999999729,167.16971118511927,0
"147.32.84.165",2549,"217.163.21.40",80,10,1448,5,699,5,749,86643.374416,0.13962299999548122,40050.70797920816,42915.56548845051
"147.32.84.165",2564,"31.42.162.114",6667,2,124,2,124,0,0,86643.420396,2.935339000003296,337.9507443599823,0
"147.32.84.165",2569,"46.4.36.120",443,6,366,3,186,3,180,86645.352307,1.0315240000054473,1442.525816163407,1395.992725319426
"147.32.84.165",1171,"132.72.23.17",25,3,186,3,186,0,0,86646.384051,8.902382000000216,167.14627613148525,0
"147.32.84.165",3448,"67.19.72.206",80,3,186,3,186,0,0,86649.766917,9.031294999993406,164.76042472326353,0
"147.32.84.165",2559,"184.82.155.107",80,10,1889,5,981,5,908,86649.767047,0.34065600000030827,23037.903339418353,21323.563947188442
"147.32.84.165",2576,"46.4.36.120",443,6,366,3,186,3,180,86649.879559,1.0179280000011204,1461.7929755330065,1414.6383634190386
"147.32.84.165",1180,"64.12.90.98",25,3,186,3,186,0,0,86650.897713,9.004069999995409,165.25859972220994,0
"147.32.84.165",3449,"193.23.181.44",179,10,783,5,483,5,300,86650.897773,0.1979929999943124,19515.841469703464,12121.640664412089
"147.32.84.165",2561,"217.163.21.40",80,14,6137,7,809,7,5328,86650.962662,0.1877589999930933,34469.719162533205,227014.41742642387
"147.32.84.165",1181,"65.54.188.72",25,3,186,3,186,0,0,86651.008611,8.9937440000067,165.44833831148534,0
"147.32.84.165",3450,"72.20.15.61",80,3,186,3,186,0,0,86652.275562,9.030487000010908,164.77516661041676,0
"147.32.84.165",2562,"217.163.21.36",80,13,5905,7,2769,6,3136,86653.88104,0.16217100000358187,136596.55548470892,154700.90213075015
"147.32.84.165",2593,"221.209.60.2",6667,2,124,2,124,0,0,86653.926873,2.9653049999906216,334.53557054101935,0
"147.32.84.165",2591,"46.4.36.120",443,6,366,3,186,3,180,86654.482204,1.0323590000043623,1441.3590621031176,1394.8636084868879
"147.32.84.165",1183,"65.54.188.110",25,3,186,3,186,0,0,86655.514803,9.002823000002536,165.28149003924446,0
"147.32.84.165",3451,"72.20.15.61",80,3,186,3,186,0,0,86658.196415,9.029460000005201,164.79390794124376,0
"147.32.84.165",2566,"217.163.21.36",80,11,3882,6,2254,5,1628,86658.196543,0.2613629999978002,68992.16798151142,49831.077850000256
"147.32.84.165",2606,"46.4.36.120",443,6,366,3,186,3,180,86658.242478,0.9852709999977378,1510.2443896181014,1461.5268286626788
"147.32.84.165",1184,"205.188.190.2",25,3,186,3,186,0,0,86658.396824,9.030385999998543,164.77700953206653,0
"147.32.84.165",3452,"174.37.196.55",80,3,186,3,186,0,0,86659.228006,9.001210999995237,165.31108980789222,0
"147.32.84.165",2582,"184.82.155.108",80,10,1470,5,581,5,889,86659.801278,0.3243150000052992,14331.745370778573,21929.29713360095
"147.32.84.165",1192,"74.6.136.244",25,3,186,3,186,0,0,86659.907849,9.02342700000736,164.9040879921549,0
"147.32.84.165",3454,"67.19.72.206",80,3,186,3,186,0,0,86661.808176,9.031254000001354,164.76117270090919,0
"147.32.84.165",2586,"217.163.21.40",80,10,1448,5,699,5,749,86661.808278,0.13971099999616854,40025.48117294526,42888.53418960802
"147.32.84.165",2617,"46.4.36.120",443,6,366,3,186,3,180,86661.854206,0.984943999996176,1510.7457885989224,1462.0120534828282
"147.32.84.165",1193,"207.115.11.16",25,3,186,3,186,0,0,86662.310942,9.030333000002429,164.77797662606682,0
"147.32.84.165",3455,"67.19.72.206",80,3,186,3,186,0,0,86662.839378,9.003028999999515,165.27770820243722,0
"147.32.84.165",2596,"92.240.244.181",80,10,1758,6,1364,4,394,86667.326554,9.277939000006882,1176.123274791083,339.7306233634067
"147.32.84.165",2626,"88.250.200.14",6667,10,1183,5,625,5,558,86667.335083,0.7287599999981467,6860.96931776266,6125.473406898503
"147.32.84.165",2630,"46.4.36.120",443,6,366,3,186,3,180,86667.448393,1.0093930000002729,1474.1532782569304,1426.5999467002553
"147.32.84.165",2640,"173.192.170.88",80,3,186,3,186,0,0,86668.458027,9.002651999995578,165.28462946259955,0
"147.32.84.165",1194,"205.188.159.42",25,3,186,3,186,0,0,86668.45806,9.002714000002015,165.2834911782899,0
"147.32.84.165",3453,"72.20.15.61",80,3,186,3,186,0,0,86669.836915,8.92814499999804,166.66395987076,0
"147.32.84.165",2598,"173.241.240.4",80,9,2194,5,1164,4,1030,86669.837044,0.06970500000170432,133591.56444691654,118212.46682158422
"147.32.84.165",2644,"46.4.36.120",443,6,366,3,186,3,180,86669.853491,1.0132270000030985,1468.575156401724,1421.201764259733
"147.32.84.165",1197,"65.55.92.168",25,3,186,3,186,0,0,86670.866965,8.901353000008385,167.1655983083244,0
"147.32.84.165",3456,"193.23.181.44",80,8,868,5,482,3,386,86672.043554,0.1313419999933103,29358.46873198519,23511.138860054532
"147.32.84.165",2612,"184.82.155.107",80,10,1904,5,989,5,915,86672.108735,0.3077249999914784,25711.268178468115,23787.472581696995
"147.32.84.165",2646,"79.135.138.210",6667,2,124,2,124,0,0,86672.210403,2.943052999995416,337.0649458237908,0
"147.32.84.165",2647,"46.4.36.120",443,6,366,3,186,3,180,86673.347517,1.0308470000018133,1443.473182729719,1396.9095316739215
"147.32.84.165",1202,"205.188.156.193",25,3,186,3,186,0,0,86674.378615,8.90244600000733,167.1450745108451,0
"147.32.84.165",3457,"174.128.246.102",80,3,186,3,186,0,0,86676.558203,8.929018000009819,166.64766495020658,0
"147.32.84.165",2614,"217.163.21.40",80,10,2274,5,1154,5,1120,86676.558331,0.13941900001373142,66217.66042713502,64266.70682702879
"147.32.84.165",2656,"46.4.36.120",443,6,366,3,186,3,180,86676.604343,0.9840120000008028,1512.176680770952,1463.3967878428568
"147.32.84.165",2655,"173.192.170.88",80,29,5364,14,1286,15,4078,86677.5886,45.00552799999423,228.59414070203374,724.8887292246451
"147.32.84.165",1204,"65.55.92.152",25,3,186,3,186,0,0,86677.588659,8.90212800000154,167.15104523320073,0
"147.32.84.165",3458,"193.23.181.44",179,10,781,5,481,5,300,86679.367572,0.20072900000377558,19170.124894398028,11956.418853054904
"147.32.84.165",2616,"217.163.21.36",80,15,7657,7,2290,8,5367,86679.430281,0.19240100000752136,95217.80031956088,223158.92328169572
"147.32.84.165",2658,"212.117.171.138",65500,219,170103,127,163207,92,6896,86679.476178,99.70128500000283,13095.678756797999,553.3328883373814
"147.32.84.165",2660,"46.4.36.120",443,6,366,3,186,3,180,86679.476236,1.0213559999974677,1456.8867270605833,1409.890381026371
"147.32.84.165",1211,"74.6.136.244",25,3,186,3,186,0,0,86680.169494,9.02974600000016,164.78868840828676,0
"147.32.84.165",3459,"72.20.15.61",80,3,186,3,186,0,0,86680.169585,9.029779000004055,164.78808617567847,0
"147.32.84.165",2622,"217.163.21.36",80,11,3882,6,2254,5,1628,86680.497787,0.2588859999959823,69652.27938273929,50307.85751335385
"147.32.84.165",2659,"65.55.16.187",443,23,9328,13,4380,10,4948,86680.543703,2.0684949999995297,16939.85240477157,19136.618652696285
"147.32.84.165",1214,"220.128.63.37",25,3,186,3,186,0,0,86680.70578,8.995192999995197,165.42168689441067,0
"147.32.84.165",3460,"174.128.246.102",80,3,186,3,186,0,0,86680.871567,9.029990000010002,164.78423564127445,0
"147.32.84.165",2649,"184.82.155.108",80,10,1311,5,589,5,722,86680.871664,0.39006099999824073,12080.16182089789,14807.940296584511
"147.32.84.165",2670,"186.90.182.143",6667,2,124,2,124,0,0,86680.97838,3.0043020000011893,330.19316966124154,0
"147.32.84.165",2671,"46.4.36.120",443,6,366,3,186,3,180,86683.281129,1.0296670000097947,1445.1274052541698,1398.5103921814548
"147.32.84.165",1215,"205.188.146.193",25,3,186,3,186,0,0,86683.781804,9.029043000002275,164.80151883202075,0
"147.32.84.165",3461,"174.128.246.102",80,9,954,6,770,3,184,86684.310926,3.2494059999880847,1895.7310967058559,453.00587245958116
"147.32.84.165",2664,"217.163.21.36",80,13,5895,7,2769,6,3126,86684.310957,0.16004100001009647,138414.5312676283,156259.95837580573
"147.32.84.165",1217,"67.108.254.7",25,3,186,3,186,0,0,86684.356894,8.95563700000639,166.15233511574198,0
"147.32.84.165",3462,"193.23.181.44",179,10,772,5,472,5,300,86687.895014,0.1910630000056699,19763.114783542314,12561.301769200623
"147.32.84.165",2666,"184.82.155.107",80,10,1921,5,993,5,928,86687.957627,0.3224350000091363,24637.52384131656,23024.795694603996
"147.32.84.165",2679,"46.4.36.120",443,6,366,3,186,3,180,86688.064113,0.9621539999934612,1546.5299733827562,1496.641909725248
"147.32.84.165",1219,"64.136.173.100",25,3,186,3,186,0,0,86689.026508,9.0023199999996,165.2907250575481,0
"147.32.84.165",3463,"193.23.181.44",80,9,926,5,482,4,444,86689.39955,0.13464699999894947,28637.845626193564,26380.09016188785
"147.32.84.165",2668,"217.163.21.36",80,12,3902,6,2233,6,1669,86689.461878,0.220365999994101,81065.13709228377,60590.10918361916
"147.32.84.165",1220,"64.12.90.97",25,3,186,3,186,0,0,86689.507794,9.021766999998363,164.93443025077792,0
"147.32.84.165",3464,"193.23.181.44",80,8,860,5,476,3,384,86691.807712,0.16131700000551064,23605.695617138415,19043.25024575872
"147.32.84.165",2669,"217.163.21.40",80,10,2274,5,1154,5,1120,86691.872649,0.14024700000300072,65826.71999973242,63887.28457513025
"147.32.84.165",2690,"218.201.21.157",6667,2,124,2,124,0,0,86691.918494,2.9985430000087945,330.8273384764169,0
"147.32.84.165",2687,"46.4.36.120",443,6,366,3,186,3,180,86695.318817,1.0305799999914598,1443.8471540417345,1397.271439395227
"147.32.84.165",1221,"74.6.136.244",25,3,186,3,186,0,0,86696.349641,9.002230000012787,165.29237755510428,0
"147.32.84.165",2695,"173.192.170.88",80,3,186,3,186,0,0,86697.928224,9.028890000001411,164.80431149341365,0
"147.32.84.165",3467,"72.20.15.61",80,3,186,3,186,0,0,86697.92835,9.028888000000734,164.80434799943018,0
"147.32.84.165",2676,"217.163.21.36",80,15,7279,7,2207,8,5072,86697.928404,0.18860699998913333,93612.64428688891,215135.17527100162
"147.32.84.165",2700,"46.4.36.120",443,6,366,3,186,3,180,86697.974514,0.983989999993355,1512.2104899542155,1463.4295064073053
"147.32.84.165",1222,"205.188.146.193",25,3,186,3,186,0,0,86698.529696,9.029236999995192,164.79797794661857,0
"147.32.84.165",3468,"67.19.72.206",80,3,186,3,186,0,0,86698.529751,9.029384000008577,164.79529500557143,0
"147.32.84.165",2677,"173.241.240.4",80,9,2194,5,1164,4,1030,86698.958749,0.06809699999575969,136746.11217204644,121003.86214536754
"147.32.84.165",1224,"205.188.146.193",25,3,186,3,186,0,0,86698.97525,8.984408999996958,165.62024280066765,0
"147.32.84.165",3469,"174.128.246.102",80,3,186,3,186,0,0,86698.97528,8.984425000002375,165.61994785415948,0
"147.32.84.165",2684,"184.82.155.108",80,10,1508,5,596,5,912,86698.975304,0.3215889999992214,14826.377767932185,22687.343161668043
"147.32.84.165",1225,"66.94.238.147",25,3,186,3,186,0,0,86699.081874,8.978543999997783,165.72842991028028,0
"147.32.84.165",2707,"208.73.210.29",80,50,35827,22,3323,28,32504,86701.239152,19.2256469999993,1382.7363001100025,13525.266535893928
"147.32.84.165",3470,"174.37.196.55",80,3,186,3,186,0,0,86701.420891,8.846384999997099,168.2043004007273,0
"147.32.84.165",2686,"217.163.21.36",80,13,5956,7,2748,6,3208,86701.740399,0.16077400000358466,136738.52737078033,159627.80051144955
"147.32.84.165",2708,"93.116.166.52",6667,2,124,2,124,0,0,86701.786264,2.963599000009708,334.7281464181728,0
"147.32.84.165",2705,"46.4.36.120",443,6,366,3,186,3,180,86704.849867,1.030947000006563,1443.3331684272105,1396.7740339618165
"147.32.84.165",1231,"94.245.120.86",25,3,186,3,186,0,0,86705.351935,8.929034000000684,166.64736633323224,0
"147.32.84.165",2714,"74.125.232.217",80,8,1908,5,1034,3,874,86705.881119,14.58389100000204,567.2011673701376,479.4330950498068
"147.32.84.165",3471,"193.23.181.44",80,9,868,5,424,4,444,86705.889269,0.12841999999363907,26413.331258121892,27659.243109920095
"147.32.84.165",2697,"184.82.155.107",80,10,1920,5,989,5,931,86705.953069,0.32286100000783335,24505.901920046203,23068.750947990913
"147.32.84.165",1232,"205.188.190.2",25,3,186,3,186,0,0,86706.059505,8.92389400000684,166.74335217326197,0
"147.32.84.165",2717,"67.214.158.5",80,10,1695,5,849,5,846,86707.959538,0.36957100000290666,18378.065378361887,18313.12521801432
"147.32.84.165",3472,"193.23.181.44",80,8,880,5,496,3,384,86708.063395,0.1653749999968568,23993.953137266322,18575.963719173928
"147.32.84.165",2702,"217.163.21.36",80,13,5895,7,2769,6,3126,86708.126005,0.16947000000800472,130713.40059570235,147565.94086752096
"147.32.84.165",2723,"46.4.36.120",443,6,366,3,186,3,180,86708.17195,1.0191579999955138,1460.0287688528667,1412.9310666318065
"147.32.84.165",1235,"205.188.59.194",25,3,186,3,186,0,0,86709.191364,8.901786999995238,167.15744827423933,0
"147.32.84.165",2718,"50.22.198.84",80,8,2195,5,1164,3,1031,86709.96647,0.39099800000258256,23815.978598198697,21094.73705733922
"147.32.84.165",3474,"174.37.196.55",80,3,186,3,186,0,0,86710.087289,9.009151999998721,165.16537849513597,0
"147.32.84.165",2703,"217.163.21.40",80,13,6081,6,750,7,5331,86710.087349,0.18685300000652205,32110.803678777283,228243.59254874891
"147.32.84.165",1237,"74.6.136.244",25,3,186,3,186,0,0,86710.133296,8.963243999998667,166.01132357885396,0
"147.32.84.165",2719,"195.113.232.88",80,8,1362,5,774,3,588,86710.133327,10.331860999998753,599.3111986311806,455.2906780298891
"147.32.84.165",3482,"72.20.15.61",80,3,186,3,186,0,0,86710.134127,8.962437000009231,166.02627164893514,0
"147.32.84.165",2711,"217.163.21.36",80,13,5256,7,2247,6,3009,86710.46877,0.2706369999941671,66421.07324714442,88945.70956860595
"147.32.84.165",2729,"46.4.36.120",443,6,366,3,186,3,180,86710.515098,0.9832289999903878,1513.3809112775832,1464.5621722041128
"147.32.84.165",1238,"65.54.188.72",25,3,186,3,186,0,0,86711.498565,9.003582999997889,165.26753848999326,0
"147.32.84.165",2726,"67.214.158.5",80,10,1760,5,871,5,889,86717.290625,0.341565000009723,20400.216649251677,20821.80551226721
"147.32.84.165",3496,"193.23.181.44",179,11,841,5,481,6,360,86717.394386,0.18626200000289828,20659.071629962764,15462.091032820364
"147.32.84.165",2712,"74.121.136.216",80,10,3559,6,1555,4,2004,86717.455316,22.655452999999397,549.0951781012867,707.6442038038448
"147.32.84.165",2732,"68.202.89.226",6667,1,62,1,62,0,0,86717.63673,0,0,0
"147.32.84.165",2736,"46.4.36.120",443,6,366,3,186,3,180,86717.993207,1.0306569999956992,1443.7392847535207,1397.1670497614716
"147.32.84.165",1239,"96.125.162.28",25,3,186,3,186,0,0,86719.024108,9.001879999996163,165.29880424984938,0
"147.32.84.165",2747,"173.192.170.88",80,3,186,3,186,0,0,86719.497595,9.029846000004909,164.7868634746585,0
"147.32.84.165",2731,"50.22.198.84",80,9,1796,5,1216,4,580,86719.497722,0.38424299999314826,25317.312222144497,12075.691684904446
"147.32.84.165",3498,"193.23.181.44",179,11,811,5,451,6,360,86719.618681,0.19112399998994078,18877.79661471032,15068.751178039282
"147.32.84.165",2720,"184.82.155.108",80,10,1511,5,599,5,912,86719.681413,0.3054530000081286,15688.174612370733,23885.83513603023
"147.32.84.165",1242,"65.55.37.120",25,3,186,3,186,0,0,86719.781946,8.946475999997347,166.32247155197658,0
"147.32.84.165",2742,"68.67.179.212",80,8,1456,5,575,3,881,86719.999975,0.4653870000038296,9884.24687402559,15144.385210463557
"147.32.84.165",3506,"174.128.246.102",80,3,186,3,186,0,0,86720.024174,9.006035999991582,165.2225240939955,0
"147.32.84.165",2727,"173.241.240.4",80,9,2194,5,1164,4,1030,86720.024237,0.06868199999735225,135581.37503798647,119973.2098703832
"147.32.84.165",2754,"46.4.36.120",443,6,366,3,186,3,180,86720.041392,0.9898320000065723,1503.2854059983108,1454.792328385462
"147.32.84.165",1243,"208.65.145.2",25,3,186,3,186,0,0,86721.031464,9.00091099999554,165.31659961983152,0
"147.32.84.165",3512,"193.23.181.44",179,11,788,5,428,6,360,86722.307685,0.19118699998944066,17909.167465304174,15063.785718480145
"147.32.84.165",2730,"217.163.21.40",80,10,1451,5,701,5,750,86722.370467,0.14039699999557342,39943.873445848665,42735.95589784093
"147.32.84.165",2759,"222.23.80.7",6667,2,124,2,124,0,0,86722.416479,3.000977999996394,330.5589044642087,0
"147.32.84.165",2761,"46.4.36.120",443,6,366,3,186,3,180,86726.320742,1.0316109999985201,1442.4041620360142,1395.8749955187234
"147.32.84.165",2764,"173.192.170.88",80,12,1161,7,604,5,557,86727.022431,59.89682100000209,80.6720610431033,74.39459933941811
"147.32.84.165",1244,"205.188.146.193",25,3,186,3,186,0,0,86727.022562,9.028980000002775,164.80266873993992,0
"147.32.84.165",3513,"174.37.196.55",80,3,186,3,186,0,0,86727.352604,9.000715999995009,165.32018119456552,0
"147.32.84.165",2737,"184.82.155.107",80,10,1921,5,993,5,928,86727.524444,0.3230140000086976,24593.361277796306,22983.52393332827
"147.32.84.165",1245,"74.6.136.244",25,3,186,3,186,0,0,86727.631193,9.022323000011966,164.92426617823665,0
"147.32.84.165",3516,"174.37.196.55",80,3,186,3,186,0,0,86730.132628,9.028941999989911,164.8033623431918,0
"147.32.84.165",2744,"74.125.232.219",80,9,3966,5,1288,4,2678,86730.132756,32.79557199998817,314.1887569457156,653.2589216619771
"147.32.84.165",2771,"46.4.36.120",443,6,366,3,186,3,180,86730.140994,1.0222329999960493,1455.6368264434338,1408.6807997839683
"147.32.84.165",1247,"64.12.90.97",25,3,186,3,186,0,0,86731.135556,9.028694000007818,164.80788915857727,0
"147.32.84.165",3524,"72.20.15.61",80,3,186,3,186,0,0,86731.163466,9.000903000007384,165.31674655296024,0
"147.32.84.165",2745,"94.127.76.145",80,8,1824,5,1125,3,699,86732.540172,30.38832700000785,296.16635361326985,184.01802771171165
"147.32.84.165",2776,"59.99.153.96",6667,2,124,2,124,0,0,86732.554658,2.9958110000006855,331.12903317324526,0
"147.32.84.165",2780,"46.4.36.120",443,6,366,3,186,3,180,86737.556583,1.030161999995471,1444.4330115132784,1397.8383982386565
"147.32.84.165",1251,"65.55.92.136",25,3,186,3,186,0,0,86738.586963,8.90382099999988,167.11926261770313,0
"147.32.84.165",3525,"72.20.15.61",80,3,186,3,186,0,0,86740.064707,8.931668999997783,166.5982024188726,0
"147.32.84.165",2752,"217.163.21.40",80,14,6141,7,810,7,5331,86740.064836,0.1892319999897154,34243.6797177654,225374.143920256
"147.32.84.165",2788,"46.4.36.120",443,6,366,3,186,3,180,86740.110611,0.9852939999982482,1510.2091355500445,1461.4927118226237
"147.32.84.165",1255,"64.12.90.1",25,3,186,3,186,0,0,86740.766338,8.932671999995364,166.57949603441975,0
"147.32.84.165",3526,"72.20.15.61",80,9,724,5,482,4,242,86741.096144,3.251508000001195,1185.9112756292104,595.4160346520102
"147.32.84.165",2765,"217.163.21.36",80,11,3976,6,2336,5,1640,86741.096175,0.2537259999953676,73654.25695569707,51709.32423259555
"147.32.84.165",2791,"85.185.226.13",6667,2,124,2,124,0,0,86741.142357,2.8357509999914328,349.8191484382786,0
"147.32.84.165",1258,"74.6.136.244",25,3,186,3,186,0,0,86741.970166,9.032596999997622,164.73667539915616,0
"147.32.84.165",3527,"72.20.15.61",80,8,654,4,412,4,242,86741.970294,0.36646200000541285,8994.111258333241,5282.948845914186
"147.32.84.165",2770,"184.82.155.108",80,10,1508,5,596,5,912,86741.970348,0.3433579999982612,13886.380978524296,21248.958812775432
"147.32.84.165",1261,"207.115.37.20",25,3,186,3,186,0,0,86742.083163,9.019633000003523,164.97345291093538,0
"147.32.84.165",3530,"72.20.15.61",80,3,186,3,186,0,0,86747.591377,9.028563999992912,164.81026218578816,0
"147.32.84.165",2781,"184.82.155.107",80,10,1920,5,989,5,931,86747.591525,0.3428130000102101,23079.63816939368,21726.130571997488
"147.32.84.165",2795,"46.4.36.120",443,6,366,3,186,3,180,86747.704411,1.0180229999969015,1461.6565637559554,1414.5063520218923
"147.32.84.165",1262,"205.188.146.193",25,3,186,3,186,0,0,86747.993124,9.028154999992694,164.8177285393532,0
"147.32.84.165",3531,"174.37.196.55",80,3,186,3,186,0,0,86748.293806,9.028871000002255,164.80465830109085,0
"147.32.84.165",2789,"217.163.21.40",80,10,1451,5,701,5,750,86748.595396,0.1410829999949783,39749.65091612463,42528.15718558269
"147.32.84.165",1264,"74.6.136.244",25,3,186,3,186,0,0,86748.641856,8.981532000005245,165.67329493444225,0
"147.32.84.165",3550,"174.37.196.55",80,3,186,3,186,0,0,86748.722579,9.00153200000932,165.30519471557278,0
"147.32.84.165",2793,"217.163.21.40",80,10,2277,5,1156,5,1121,86748.722618,0.14051700000709388,65814.10078163583,63821.45932198423
"147.32.84.165",1265,"65.55.37.72",25,3,186,3,186,0,0,86748.722655,9.001596000001882,165.3040194205215,0
"147.32.84.165",3554,"193.23.181.44",179,10,784,5,484,5,300,86752.106154,0.1961250000022119,19742.511153378364,12237.093690110556
"147.32.84.165",2803,"217.163.21.40",80,13,6081,6,750,7,5331,86752.106219,0.18690900001092814,32101.182926714035,228175.20824308338
"147.32.84.165",2807,"46.4.36.120",443,6,366,3,186,3,180,86752.152561,0.984509000001708,1511.4133034816527,1462.6580356274058
"147.32.84.165",2815,"173.192.170.88",80,3,186,3,186,0,0,86752.170179,8.966489000013098,165.9512435690075,0
"147.32.84.165",1270,"192.48.157.12",25,3,186,3,186,0,0,86752.170211,8.966549999997369,165.95011459261775,0
"147.32.84.165",3560,"174.128.246.102",80,3,186,3,186,0,0,86753.137193,9.002701999997953,165.2837114902102,0
"147.32.84.165",2804,"217.163.21.36",80,11,3966,6,2336,5,1630,86753.137225,0.23398099999758415,79869.73301333422,55731.020895434405
"147.32.84.165",2809,"212.117.171.138",65500,61,28128,31,25240,30,2888,86753.183104,41.115331000008155,4911.063466811442,561.9315091977593
"147.32.84.165",2816,"94.100.176.20",25,3,186,3,186,0,0,86753.183136,8.956882999991649,166.12922151616667,0
"147.32.84.165",1271,"64.126.190.250",25,3,186,3,186,0,0,86757.623251,9.041079000002355,164.58212565111003,0
"147.32.84.165",2828,"184.82.147.251",80,10,1893,5,958,5,935,86759.531032,0.39400499999464955,19451.52980318543,18984.5306534221
"147.32.84.165",3561,"193.23.181.44",179,10,781,5,481,5,300,86759.645591,0.23293800000101328,16519.41718389984,10303.170800769132
"147.32.84.165",2805,"217.163.21.36",80,13,6059,7,2851,6,3208,86759.708727,0.1594699999986915,143023.76622679594,160933.0908648058
"147.32.84.165",2811,"112.205.111.114",6667,3,186,3,186,0,0,86759.754598,9.013032000002568,165.09427682045023,0
"147.32.84.165",2823,"46.4.36.120",443,6,366,3,186,3,180,86761.738627,1.0308559999975841,1443.4605803366205,1396.8973358096328
"147.32.84.165",1274,"64.12.90.98",25,3,186,3,186,0,0,86762.769766,9.775529000005918,152.21682632204346,0
"147.32.84.165",2835,"184.82.147.252",80,10,1515,5,603,5,912,86763.159473,0.3254069999966305,14824.512072727235,22421.15258760736
"147.32.84.165",3564,"67.19.72.206",80,3,186,3,186,0,0,86763.268089,9.70800600000075,153.2755542178162,0
"147.32.84.165",2844,"98.126.71.122",80,9,4080,6,707,3,3373,86769.069071,15.51938599999994,364.447407906474,1738.7285811436163
"147.32.84.165",2820,"65.55.196.251",443,157,166615,75,5872,82,160743,86769.244728,10.009349999992992,4693.211846926413,128474.27655151437
"147.32.84.165",2841,"46.4.36.120",443,6,366,3,186,3,180,86769.3434,1.0467000000062399,1421.610776718381,1375.7523645661752
"147.32.84.165",1276,"64.12.90.97",25,3,186,3,186,0,0,86769.368155,9.639958999992814,154.3575029728974,0
"147.32.84.165",2840,"217.163.21.37",80,14,6141,7,810,7,5331,86769.660146,0.27400600000692066,23649.117172019345,155646.226721031
"147.32.84.165",3569,"72.20.15.61",80,3,186,3,186,0,0,86769.705988,9.308502999992925,159.85384545733413,0
"147.32.84.165",2850,"95.100.248.97",80,11,4649,6,1393,5,3256,86769.834421,14.754157999996096,755.3125024147735,1765.4684191403462
"147.32.84.165",2836,"94.137.182.140",6667,3,186,3,186,0,0,86769.840807,9.18010100000538,162.089719927823,0
"147.32.84.165",1279,"74.6.136.244",25,3,186,3,186,0,0,86770.39037,9.002069000009215,165.2953337725446,0
"147.32.84.165",2858,"173.192.170.88",80,13,1335,9,1089,4,246,86773.847309,44.67671200000041,195.0009212853426,44.04979489090383
"147.32.84.165",2846,"184.82.147.251",80,10,1925,5,990,5,935,86773.850511,1.91209300000628,4142.057943820718,3911.943613608456
"147.32.84.165",3570,"72.20.15.61",80,3,186,3,186,0,0,86774.71215,8.190757999997004,181.66816795228772,0
"147.32.84.165",2853,"195.113.232.83",80,27,22991,16,1465,11,21526,86774.715312,9.873359000004712,1187.032700825971,17441.68322046406
"147.32.84.165",2855,"124.125.21.140",6667,2,124,2,124,0,0,86774.759292,3.088845999998739,321.15553834681464,0
"147.32.84.165",2856,"46.4.36.120",443,6,366,3,186,3,180,86775.620892,2.6919490000000224,552.7593576252699,534.9284106050999
"147.32.84.165",1280,"216.99.131.21",25,3,186,3,186,0,0,86779.01134,8.307767000005697,179.10950078390255,0
"147.32.84.165",2852,"217.163.21.37",80,10,1451,5,701,5,750,86779.017708,0.1394940000027418,40202.44598254959,43012.6026917435
"147.32.84.165",3574,"174.128.246.102",80,3,186,3,186,0,0,86779.063709,8.956945000012638,166.1280715688106,0
"147.32.84.165",2859,"74.125.93.27",25,3,186,3,186,0,0,86779.063771,8.957011000005878,166.12684744933588,0
"147.32.84.165",1281,"61.111.244.139",25,3,186,3,186,0,0,86780.696439,9.031952999997884,164.7484215208326,0
"147.32.84.165",2863,"184.82.147.252",80,10,1514,5,603,5,911,86783.70685,0.3239400000020396,14891.646601128688,22497.993455436543
"147.32.84.165",3576,"174.128.246.102",80,7,597,4,415,3,182,86783.813763,0.340660999994725,9745.758980486198,4274.043697466236
"147.32.84.165",2872,"27.255.59.54",6667,6,366,3,186,3,180,86783.813827,1.350150999991456,1102.0989504206686,1066.5473713748406
"147.32.84.165",2869,"46.4.36.120",443,6,366,3,186,3,180,86784.208777,1.030627000000095,1443.7813098238867,1397.2077191844064
"147.32.84.165",1284,"65.55.37.104",25,3,186,3,186,0,0,86785.164216,9.123344999999972,163.09807422606562,0
"147.32.84.165",2868,"217.163.21.36",80,13,5493,7,2401,6,3092,86785.239677,0.2866799999901559,67001.53481463503,86284.3588699923
"147.32.84.165",3582,"67.19.72.206",80,3,186,3,186,0,0,86785.28575,9.005010000008042,165.24134898225222,0
"147.32.84.165",2880,"46.4.36.120",443,6,366,3,186,3,180,86787.819752,1.0337589999980992,1439.4070571600694,1392.9745714452283
"147.32.84.165",2882,"173.192.170.88",80,15,3024,8,665,7,2359,86788.853743,36.910713999997824,144.13159279444753,511.2878607550402
"147.32.84.165",1285,"205.188.59.193",25,3,186,3,186,0,0,86788.853806,9.001940999994986,165.29768413288076,0
"147.32.84.165",2874,"184.82.147.251",80,10,1926,5,998,5,928,86790.330891,0.3410289999883389,23411.498729647636,21769.409640393795
"147.32.84.165",3593,"174.128.246.102",80,3,186,3,186,0,0,86790.443582,9.019776999994065,164.97081912346383,0
"147.32.84.165",2884,"85.130.81.228",6667,2,124,2,124,0,0,86790.443614,3.526747999989311,281.27895727253735,0
"147.32.84.165",2887,"46.4.36.120",443,6,366,3,186,3,180,86790.632457,1.0301860000035958,1444.3993608870692,1397.8058331165184
"147.32.84.165",1286,"74.6.136.244",25,3,186,3,186,0,0,86790.73209,9.032179999994696,164.7442810042397,0
"147.32.84.165",2876,"217.163.21.37",80,14,6137,7,809,7,5328,86790.732223,0.18850499999825843,34333.30680915516,226116.0181448439
"147.32.84.165",3601,"174.37.196.55",80,3,186,3,186,0,0,86790.778074,8.98629699999583,165.58544637470703,0
"147.32.84.165",1287,"65.55.37.104",25,3,186,3,186,0,0,86791.434829,9.045858999990742,164.49515739760292,0
"147.32.84.165",2889,"184.82.147.252",80,10,1508,5,596,5,912,86791.434933,0.34223999999812804,13931.7438055928,21318.373071645357
"147.32.84.165",3602,"174.37.196.55",80,3,186,3,186,0,0,86791.548617,9.018153000011807,165.00052726961405,0
"147.32.84.165",2886,"212.117.171.138",65500,27,5117,13,3376,14,1741,86791.548677,16.831038999996963,1604.6543531866853,827.5187289389867
"147.32.84.165",1289,"68.6.19.3",25,3,186,3,186,0,0,86791.54878,9.018101000008755,165.0014786925269,0
"147.32.84.165",2891,"217.163.21.37",80,10,1448,5,699,5,749,86791.662847,0.14457600000605453,38678.61885628195,41445.329790207696
"147.32.84.165",3603,"67.19.72.206",80,3,186,3,186,0,0,86791.708601,8.957986999987043,166.10874742307087,0
"147.32.84.165",2893,"65.54.234.75",443,41,30826,22,2404,19,28422,86791.708633,2.7394289999938337,7020.441121139949,83001.2385794674
"147.32.84.165",1292,"66.94.238.147",25,3,186,3,186,0,0,86791.872387,8.99535100000503,165.41878132372688,0
"147.32.84.165",2894,"217.163.21.37",80,13,6081,6,750,7,5331,86799.364145,0.1899039999989327,31594.91111316097,224576.62819234817
"147.32.84.165",3604,"174.128.246.102",80,9,725,6,543,3,182,86799.410087,9.229164000003948,470.68185157378736,157.76076793080904
"147.32.84.165",2896,"46.4.36.120",443,6,366,3,186,3,180,86799.410124,0.9829150000005029,1513.864372808675,1465.0300382019434
"147.32.84.165",2898,"174.123.157.154",80,9,1153,5,654,4,499,86800.06498,0.44314899999881163,11806.41274157006,9008.256816580213
"147.32.84.165",1296,"64.12.90.97",25,3,186,3,186,0,0,86800.210994,8.883832999999868,167.49526921544137,0
"147.32.84.165",2895,"217.163.21.36",80,13,5490,7,2399,6,3091,86800.393279,0.2447329999995418,78420.15584345361,101040.72601588792
"147.32.84.165",3605,"67.19.72.206",80,3,186,3,186,0,0,86800.439485,8.855300000010175,168.03496211289175,0
"147.32.84.165",2902,"212.117.171.138",65500,31,8300,15,6372,16,1928,86800.439544,15.876065000004019,3210.871207694545,971.5253748328755
"147.32.84.165",2913,"74.125.39.27",25,3,186,3,186,0,0,86800.439597,8.855322999996133,168.0345256746309,0
"147.32.84.165",1300,"74.6.136.244",25,3,186,3,186,0,0,86801.770679,8.928702000004705,166.65356285820894,0
"147.32.84.165",2918,"173.192.170.88",80,13,7071,8,773,5,6298,86804.880172,10.050034999992931,615.3212401752182,5013.315874027846
"147.32.84.165",2909,"184.82.147.251",80,10,1910,5,982,5,928,86804.880301,0.360566999996081,21787.906270084026,20589.793298002012
"147.32.84.165",3609,"174.37.196.55",80,3,186,3,186,0,0,86804.998846,9.01100199999928,165.1314692861148,0
"147.32.84.165",2906,"202.9.159.34",6667,1,62,1,62,0,0,86804.99889,0,0,0
"147.32.84.165",2915,"46.4.36.120",443,6,366,3,186,3,180,86806.083945,1.0325269999884767,1441.1245420377447,1394.6366535849143
"147.32.84.165",1302,"65.55.92.152",25,3,186,3,186,0,0,86806.184647,9.029112999996869,164.80024117546387,0
"147.32.84.165",2924,"50.23.235.4",80,23,12363,12,2349,11,10014,86807.116744,16.191625000006752,1160.600001543524,4947.7430461714985
"147.32.84.165",2910,"217.163.21.37",80,10,1451,5,701,5,750,86807.270895,0.14541800000006333,38564.689378189476,41260.36666710715
"147.32.84.165",3621,"174.37.196.55",80,3,186,3,186,0,0,86807.322363,8.994200000001001,165.4399501901041,0
"147.32.84.165",2911,"74.125.47.106",443,17,4509,9,1437,8,3072,86807.322425,1.144730999993044,10042.534010234593,21468.799220209236
"147.32.84.165",1304,"196.34.191.132",25,3,186,3,186,0,0,86807.435309,8.982325000004494,165.65866855176756,0
"147.32.84.165",2926,"87.248.203.253",80,13,4629,7,683,6,3946,86809.795962,5.134126999997534,1064.2510401481352,6148.659742934907
"147.32.84.165",2921,"184.82.147.252",80,10,1507,5,596,5,911,86809.813349,0.3456999999907566,13792.305467536846,21081.862887459843
"147.32.84.165",3629,"72.20.15.61",80,7,597,4,415,3,182,86809.92768,0.369395000001532,8987.6690263437,3941.5801513121764
"147.32.84.165",2928,"210.211.186.114",6667,2,124,2,124,0,0,86810.110526,2.9986539999954402,330.815092371947,0
"147.32.84.165",2927,"46.4.36.120",443,6,366,3,186,3,180,86811.702751,1.0304159999941476,1444.0769553349826,1397.4938277435315
"147.32.84.165",1305,"205.188.159.42",25,3,186,3,186,0,0,86812.504715,9.031149000002188,164.7630882847398,0
"147.32.84.165",2935,"67.201.31.224",80,65,81693,40,3132,25,78561,86812.733876,10.57487399999809,2369.3899331570783,59432.19749002338
"147.32.84.165",2925,"217.163.21.36",80,13,5497,7,2401,6,3096,86812.762771,0.2831890000088606,67827.49329740564,87461.02426021153
"147.32.84.165",3636,"193.23.181.44",80,10,951,6,505,4,446,86812.805853,0.16410999999789055,24617.634513752542,21741.514837888382
"147.32.84.165",1306,"173.10.227.233",25,3,186,3,186,0,0,86812.810357,9.02730000000156,164.83333887205953,0
"147.32.84.165",2936,"67.201.31.224",80,40,45218,25,2172,15,43046,86812.869643,10.438924999994924,1664.5392126113034,32988.83745214833
"147.32.84.165",2934,"217.163.21.37",80,14,6137,7,809,7,5328,86812.869716,0.22883500000170898,28282.386872426272,186265.21292495326
"147.32.84.165",3637,"174.128.246.102",80,16,2044,12,1796,4,248,86812.92196,93.09951799998817,154.3294778389919,21.310529233891977
"147.32.84.165",2933,"212.117.171.138",65500,15,931,9,546,6,385,86812.925182,41.6510019999987,104.87142662258489,73.94780082361756
"147.32.84.165",1309,"65.55.92.184",25,3,186,3,186,0,0,86812.928361,9.009833999996772,165.15287629056573,0
"147.32.84.165",2938,"69.16.175.10",80,8,1265,5,569,3,696,86814.912725,8.39620499999728,542.149697393224,663.1567476022565
"147.32.84.165",2945,"217.163.21.37",80,10,1448,5,699,5,749,86814.929912,0.1417259999871021,39456.415904695714,42278.76325124047
"147.32.84.165",3646,"72.20.15.61",80,7,617,4,435,3,182,86814.975876,0.3740360000083456,9303.917269787811,3892.673432416969
"147.32.84.165",2946,"74.125.47.106",443,20,7632,10,1564,10,6068,86815.163908,1.1874830000015208,10536.571891963064,40879.743120480736
"147.32.84.165",2951,"46.4.36.120",443,6,366,3,186,3,180,86815.278275,1.0446509999892442,1424.3991534161366,1378.4507936285195
"147.32.84.165",1312,"205.188.190.2",25,3,186,3,186,0,0,86816.323162,9.026471000004676,164.8484773284298,0
"147.32.84.165",2960,"173.192.170.88",80,10,1040,6,543,4,497,86821.134125,82.06347999999707,52.934630605479505,48.45029725768566
"147.32.84.165",2954,"68.67.185.217",80,8,1608,5,644,3,964,86821.134224,2.173936999999569,2369.893883769871,3547.4809067611113
"147.32.84.165",2948,"184.82.147.251",80,10,1910,5,982,5,928,86821.16403,0.34479499999724794,22784.553140453616,21531.63473965474
"147.32.84.165",3648,"72.20.15.61",80,3,186,3,186,0,0,86821.276904,8.990709000005154,165.50418882416804,0
"147.32.84.165",2959,"111.88.1.3",6667,2,124,2,124,0,0,86821.334796,3.0114580000081332,329.4085456271749,0
"147.32.84.165",2958,"46.4.36.120",443,6,366,3,186,3,180,86822.740658,1.0308300000033341,1443.4969878594795,1396.9325688962704
"147.32.84.165",1319,"64.12.90.98",25,3,186,3,186,0,0,86823.771698,9.002711000008276,165.28354625608134,0
"147.32.84.165",2953,"217.163.21.36",80,13,5486,7,2399,6,3087,86824.948739,0.26923900000110734,71282.39222371597,91725.19582935024
"147.32.84.165",3649,"193.23.181.44",179,10,776,5,476,5,300,86824.994868,0.18993800001044292,20048.647452277237,12635.70217580498
"147.32.84.165",2965,"66.111.4.71",25,3,186,3,186,0,0,86825.056186,9.022488999995403,164.9212318242514,0
"147.32.84.165",2975,"173.192.170.88",80,14,1827,9,1266,5,561,86827.255525,61.86222599999746,163.71864795166627,72.54831082218386
"147.32.84.165",1324,"74.6.136.244",25,3,186,3,186,0,0,86827.255633,8.93104600001243,166.60982375389503,0
"147.32.84.165",2966,"184.82.147.252",80,10,1507,5,596,5,911,86828.460609,0.3112059999984922,15321.041368171247,23418.571621483232
"147.32.84.165",3652,"193.23.181.44",80,8,861,5,477,3,384,86828.564565,0.12820400000782683,29765.061930727854,23961.81086247274
"147.32.84.165",2971,"212.117.171.138",65500,15,930,9,546,6,384,86828.62963,206.75471800001105,21.12648283073166,14.858185727107982
"147.32.84.165",2972,"46.4.36.120",443,6,366,3,186,3,180,86828.629663,1.0664309999992838,1395.3082759231486,1350.2983315385309
"147.32.84.165",1326,"205.188.59.193",25,3,186,3,186,0,0,86829.69636,8.898197000002256,167.22488836779212,0
"147.32.84.165",2987,"217.163.21.37",80,14,6137,7,809,7,5328,86833.57728,0.19219100000918843,33674.83388759402,221779.37571458702
"147.32.84.165",3653,"174.128.246.102",80,3,186,3,186,0,0,86833.62389,8.883734000002733,167.49713577641364,0
"147.32.84.165",2974,"77.238.177.9",25,3,186,3,186,0,0,86833.623952,8.883740000004764,167.4970226502804,0
"147.32.84.165",2995,"46.4.36.120",443,6,366,3,186,3,180,86833.878882,1.032439999995404,1441.245980402371,1394.7541745829399
"147.32.84.165",1347,"196.23.143.5",25,3,186,3,186,0,0,86833.978965,8.929942000002484,166.63042156372194,0
"147.32.84.165",2991,"184.82.147.251",80,10,1910,5,982,5,928,86834.911563,0.30801599999540485,25505.168563052568,24102.644018852123
"147.32.84.165",3659,"174.37.196.55",80,3,186,3,186,0,0,86834.982641,8.929604000004474,166.63672879550475,0
"147.32.84.165",2982,"109.201.233.98",6667,1,62,1,62,0,0,86835.013264,0,0,0
"147.32.84.165",3009,"46.4.36.120",443,6,366,3,186,3,180,86837.289946,1.0373779999936232,1434.3855373924903,1388.1150361862808
"147.32.84.165",1348,"64.12.90.98",25,3,186,3,186,0,0,86838.327588,8.99645999999484,165.398390033508,0
"147.32.84.165",3001,"217.163.21.37",80,10,1448,5,699,5,749,86838.327635,0.14956100001290906,37389.42638466805,40063.92040359995
"147.32.84.165",3666,"174.37.196.55",80,3,186,3,186,0,0,86838.376876,8.947276999999303,166.30758162512637,0
"147.32.84.165",3013,"119.154.129.1",6667,2,124,2,124,0,0,86838.376938,2.9265350000059698,338.9674136813592,0
"147.32.84.165",3017,"46.4.36.120",443,6,366,3,186,3,180,86842.206945,1.0397260000027018,1431.146282766934,1384.98027364542
"147.32.84.165",1349,"74.6.136.244",25,3,186,3,186,0,0,86843.247003,8.994766000003438,165.42953980119452,0
"147.32.84.165",3006,"184.82.147.252",80,10,1508,5,596,5,912,86843.247064,0.3336530000087805,14290.295606137286,21867.029518116116
"147.32.84.165",3669,"193.23.181.44",80,8,830,5,446,3,384,86843.359127,0.12970099999802187,27509.425525280585,23685.245295308843
"147.32.84.165",1350,"72.4.117.21",25,3,186,3,186,0,0,86843.423316,9.018547999992734,164.99330047377902,0
"147.32.84.165",3014,"217.163.21.36",80,11,3967,6,2339,5,1628,86844.714316,0.26535400000284426,70517.12052503234,49081.60419613196
"147.32.84.165",3673,"67.19.72.206",80,3,186,3,186,0,0,86844.760827,8.986430999997538,165.5829772687742,0
"147.32.84.165",3036,"46.4.36.120",443,6,366,3,186,3,180,86845.016162,1.0483990000066115,1419.3069623212311,1373.5228667624817
"147.32.84.165",1351,"205.188.190.2",25,3,186,3,186,0,0,86846.019855,9.0305939999962,164.77321425374967,0
"147.32.84.165",3031,"184.82.147.251",80,10,1925,5,990,5,935,86846.064842,0.34793299999728333,22763.00322206241,21498.39193194783
"147.32.84.165",3678,"174.37.196.55",80,3,186,3,186,0,0,86846.178094,8.972710999994888,165.8361670180671,0
"147.32.84.165",3040,"216.157.130.15",25,3,186,3,186,0,0,86846.178156,8.97277400000894,165.83500264227288,0
"147.32.84.165",1356,"213.146.65.56",25,3,186,3,186,0,0,86848.227106,9.032915999996476,164.73085767658867,0
"147.32.84.165",3035,"217.163.21.37",80,13,6081,6,750,7,5331,86850.636249,0.24133000000438187,24862.22185344158,176720.67293426275
"147.32.84.165",3686,"72.20.15.61",80,3,186,3,186,0,0,86850.695624,8.971802000000025,165.85296911367368,0
"147.32.84.165",3047,"182.72.80.42",6667,1,62,1,62,0,0,86854.548549,0,0,0
"147.32.84.165",3043,"46.4.36.120",443,6,366,3,186,3,180,86854.949652,1.0421639999985928,1427.7983119758592,1381.7403019121218
"147.32.84.165",3058,"173.192.170.88",80,17,8391,9,892,8,7499,86855.050271,17.365042999997968,410.9405315034829,3454.7567777406034
"147.32.84.165",1357,"205.188.159.42",25,3,186,3,186,0,0,86855.050399,9.03145900000527,164.75743287979623,0
"147.32.84.165",3037,"217.163.21.37",80,10,2274,5,1154,5,1120,86855.954727,0.17115899999043904,53938.15107891318,52348.98544920516
"147.32.84.165",3689,"193.23.181.44",179,10,780,5,480,5,300,86855.992045,0.19163799998932518,20037.77956466828,12523.612227917674
"147.32.84.165",1358,"119.235.1.2",25,3,186,3,186,0,0,86856.010603,8.974677999998676,165.79982033898258,0
"147.32.84.165",3042,"184.82.147.252",80,10,1514,5,603,5,911,86856.054625,0.32332599999790546,14919.92601903729,22540.71741847922
"147.32.84.165",3690,"193.23.181.44",80,8,870,5,484,3,386,86856.161305,0.13098299999546725,29561.088081155514,23575.57851100419
"147.32.84.165",1359,"68.1.17.3",25,3,186,3,186,0,0,86856.161365,9.02475699999195,164.87978568301918,0
"147.32.84.165",3053,"217.163.21.37",80,10,1451,5,701,5,750,86864.484261,0.17354099999647588,32315.130142812835,34573.9623496571
"147.32.84.165",3694,"174.128.246.102",80,3,186,3,186,0,0,86864.547948,8.865297999989707,167.84545764865746,0
"147.32.84.165",3076,"196.218.117.248",6667,1,62,1,62,0,0,86864.548009,0,0,0
"147.32.84.165",3073,"46.4.36.120",443,6,366,3,186,3,180,86865.085314,1.0382380000082776,1433.1973978877065,1386.9652237622965
"147.32.84.165",3082,"174.36.246.56",80,19,13317,11,1095,8,12222,86865.787826,0.4164989999990212,21032.46346334706,234756.86616349567
"147.32.84.165",1360,"205.188.59.193",25,3,186,3,186,0,0,86865.908999,8.909067000000505,167.02085639269697,0
"147.32.84.165",3063,"184.82.147.251",80,10,1926,5,998,5,928,86866.123798,0.3416120000038063,23371.544324880393,21732.257648786577
"147.32.84.165",3697,"193.23.181.44",80,10,978,6,532,4,446,86866.236867,0.1345020000007935,31642.652153684645,26527.486579968707
"147.32.84.165",3095,"195.113.232.82",80,4,244,3,182,1,62,86866.303653,0.0018530000088503584,0,0
"147.32.84.165",1365,"74.6.136.244",25,3,186,3,186,0,0,86866.305117,8.914248000000953,166.92378313906468,0
"147.32.84.165",3069,"217.163.21.36",80,13,6060,7,2854,6,3206,86866.991576,0.17501999999512918,130453.66244220898,146543.2522038269
"147.32.84.165",3705,"174.37.196.55",80,3,186,3,186,0,0,86867.040731,8.981398000003537,165.67576673469028,0
"147.32.84.165",3096,"195.113.232.82",80,35,32804,17,1231,18,31573,86867.095135,5.441177000000607,1809.9025266038766,46420.83872661592
"147.32.84.165",1367,"209.85.227.27",25,3,186,3,186,0,0,86867.098337,9.024315000002389,164.88786129469173,0
"147.32.84.165",3071,"217.163.21.37",80,14,6137,7,809,7,5328,86869.198437,0.19050599999900442,33972.68327524499,223740.9845370894
"147.32.84.165",3727,"193.23.181.44",80,9,884,5,440,4,444,86869.245266,0.1389469999994617,25333.400505326757,25563.704146284275
"147.32.84.165",3111,"113.193.156.31",6667,2,124,2,124,0,0,86869.313875,2.994881999999052,331.23174802890867,0
"147.32.84.165",3108,"46.4.36.120",443,6,366,3,186,3,180,86871.606061,1.0360300000029383,1436.2518459849423,1389.9211412757506
"147.32.84.165",1369,"205.188.59.194",25,3,186,3,186,0,0,86872.642347,8.999823999998625,165.33656658177173,0
"147.32.84.165",3127,"173.192.170.88",80,7,860,4,423,3,437,86875.11956,28.07976399999461,120.51383337839482,124.5024708897365
"147.32.84.165",3090,"217.163.21.36",80,13,5493,7,2401,6,3092,86875.119782,0.30750999999872874,62463.00933328804,80439.6604991781
"147.32.84.165",3729,"67.19.72.206",80,3,186,3,186,0,0,86875.167622,8.983841000008397,165.6307140786006,0
"147.32.84.165",3122,"46.4.36.120",443,6,366,3,186,3,180,86876.022278,1.032229999997071,1441.5391918508687,1395.037927597615
"147.32.84.165",1370,"119.235.1.2",25,3,186,3,186,0,0,86876.926348,9.030437000008533,164.7760789426463,0
"147.32.84.165",3102,"184.82.147.252",80,10,1508,5,596,5,912,86877.054738,0.3086579999944661,15447.517965144221,23637.81272518713
"147.32.84.165",3734,"174.37.196.55",80,3,186,3,186,0,0,86877.127034,9.030594999989262,164.77319600776798,0
"147.32.84.165",1375,"64.136.52.37",25,3,186,3,186,0,0,86877.127185,9.030541000000085,164.77418130320055,0
"147.32.84.165",3107,"92.240.244.181",80,10,1758,6,1364,4,394,86877.156517,8.01512900000671,1361.425374437625,393.2563031733315
"147.32.84.165",3736,"67.19.72.206",80,3,186,3,186,0,0,86877.165338,8.992411999992328,165.47284532795757,0
"147.32.84.165",1376,"205.188.146.193",25,3,186,3,186,0,0,86877.1654,8.99237799999537,165.4734709773951,0
"147.32.84.165",3109,"173.241.240.4",80,9,2194,5,1164,4,1030,86885.154535,0.06919600001128856,134574.2528250311,119082.02784345533
"147.32.84.165",3742,"67.19.72.206",80,3,186,3,186,0,0,86885.171242,9.012295000007725,165.10777776345807,0
"147.32.84.165",3135,"82.226.248.139",6667,1,62,1,62,0,0,86885.171303,0,0,0
"147.32.84.165",3134,"46.4.36.120",443,6,366,3,186,3,180,86886.859638,1.0344130000012228,1438.497002646178,1392.0938735285595
"147.32.84.165",1377,"222.124.4.102",25,3,186,3,186,0,0,86887.261326,9.036896999998135,164.6582892336061,0
"147.32.84.165",3115,"217.163.21.37",80,10,1448,5,699,5,749,86887.894309,0.15182700000877958,36831.39362350989,39465.97113592118
"147.32.84.165",3746,"193.23.181.44",179,10,785,5,485,5,300,86887.941912,0.21751899999799207,17837.522239601214,11033.518911093535
"147.32.84.165",1378,"65.55.92.168",25,3,186,3,186,0,0,86888.013233,8.979405999998562,165.7125204050511,0
"147.32.84.165",3124,"184.82.147.251",80,10,1925,5,990,5,935,86888.063543,0.3471810000046389,22812.30827693386,21544.957817104205
"147.32.84.165",3749,"174.37.196.55",80,3,186,3,186,0,0,86888.164339,9.028725000011036,164.80732329295455,0
"147.32.84.165",1380,"74.6.136.244",25,3,186,3,186,0,0,86888.181092,9.01209899999958,165.1113686167972,0
"147.32.84.165",3131,"217.163.21.37",80,13,6081,6,750,7,5331,86893.681909,0.191527999995742,31327.012239115902,222672.40299563584
"147.32.84.165",3762,"174.128.246.102",80,18,2264,14,2016,4,248,86893.728169,309.08596000001126,52.17965901783249,6.418926307749235
"147.32.84.165",3159,"95.111.183.113",6667,1,62,1,62,0,0,86893.72823,0,0,0
"147.32.84.165",3161,"46.4.36.120",443,6,366,3,186,3,180,86895.185985,1.0338150000025053,1439.3290869221225,1392.8991163762475
"147.32.84.165",1388,"65.55.37.104",25,3,186,3,186,0,0,86896.189708,8.928033999996842,166.6660319618548,0
"147.32.84.165",3156,"217.163.21.36",80,11,3967,6,2339,5,1628,86896.22002,0.22986600000876933,81403.94838421576,56659.09703698302
"147.32.84.165",3763,"193.23.181.44",80,9,885,5,441,4,444,86896.266619,0.1372339999943506,25707.914949248978,25882.798724413937
"147.32.84.165",1390,"74.6.136.244",25,3,186,3,186,0,0,86896.333812,8.884439000001294,167.48384450608341,0
"147.32.84.165",3160,"184.82.147.252",80,10,1515,5,603,5,912,86896.333863,0.3250559999869438,14840.519787955802,22445.36326138589
"147.32.84.165",3765,"193.23.181.44",80,8,834,5,450,3,384,86896.441971,0.1287200000078883,27967.681788217702,23865.755125945772
"147.32.84.165",1391,"222.124.4.102",25,3,186,3,186,0,0,86896.505981,8.91291500000807,166.94874796838664,0
"147.32.84.165",3221,"217.163.21.37",80,10,1451,5,701,5,750,86896.506044,0.14215500000864267,39449.896237621244,42207.44961229091
"147.32.84.165",3775,"174.128.246.102",80,3,186,3,186,0,0,86896.552687,8.866408000001684,167.8244448033203,0
"147.32.84.165",1392,"205.188.59.194",25,3,186,3,186,0,0,86896.5528,8.866339999993215,167.82573192559033,0
"147.32.84.165",3443,"184.82.147.251",80,10,1930,5,1002,5,928,86897.895187,0.32547100000374485,24628.92239218784,22810.019940070175
"147.32.84.165",3776,"72.20.15.61",80,3,186,3,186,0,0,86898.00297,9.021274999991874,164.94342540287712,0
"147.32.84.165",3480,"46.4.36.120",443,6,366,3,186,3,180,86898.095938,1.0310840000020107,1443.1413929389828,1396.588444779661
"147.32.84.165",1396,"74.6.136.244",25,3,186,3,186,0,0,86898.096074,9.028762999994797,164.80662965689294,0
"147.32.84.165",3466,"217.163.21.37",80,10,2274,5,1154,5,1120,86898.096132,0.1444459999911487,63913.15786221642,62030.10121809567
"147.32.84.165",3782,"174.128.246.102",80,3,186,3,186,0,0,86898.143666,8.981308000002173,165.67742694044566,0
"147.32.84.165",1399,"216.82.250.179",25,3,186,3,186,0,0,86898.143727,8.981297999998787,165.67761140986536,0
"147.32.84.165",3477,"217.163.21.37",80,14,6138,7,810,7,5328,86899.127241,0.1988510000082897,32587.21354043913,214351.44906599962
"147.32.84.165",3788,"72.20.15.61",80,3,186,3,186,0,0,86899.175002,8.9524689999962,166.21113125335947,0
"147.32.84.165",3489,"27.255.33.216",6667,2,124,2,124,0,0,86899.175063,2.933646999998018,338.14565965184977,0
"147.32.84.165",3492,"46.4.36.120",443,6,366,3,186,3,180,86905.218141,1.0340020000003278,1439.0687832320714,1392.6472095794238
"147.32.84.165",1407,"207.115.21.24",25,3,186,3,186,0,0,86906.252361,8.999287999991793,165.34641407201957,0
"147.32.84.165",3478,"217.163.21.36",80,13,5493,7,2401,6,3092,86908.227943,0.2760859999980312,69572.52450373063,89595.27103937323
"147.32.84.165",3796,"67.19.72.206",80,3,186,3,186,0,0,86908.274001,8.985014999998384,165.60907243897395,0
"147.32.84.165",3510,"59.48.7.167",6667,6,366,3,186,3,180,86908.93046,1.938204999998561,767.7206487451558,742.9554665275701
"147.32.84.165",3509,"46.4.36.120",443,6,366,3,186,3,180,86909.13115,1.0308559999975841,1443.4605803366205,1396.8973358096328
"147.32.84.165",1409,"64.12.90.98",25,3,186,3,186,0,0,86909.131281,9.03033600001072,164.77792188443857,0
"147.32.84.165",3486,"184.82.147.252",80,10,1508,5,596,5,912,86910.162206,0.32938900000590365,14475.286059687916,22150.102158448623
"147.32.84.165",3809,"72.20.15.61",80,3,186,3,186,0,0,86910.271087,8.995555000001332,165.41502997867053,0
"147.32.84.165",1412,"142.55.2.48",25,3,186,3,186,0,0,86910.27112,8.995584999996936,165.41447832470115,0
"147.32.84.165",3488,"217.163.21.36",80,13,6060,7,2854,6,3206,86910.868915,0.16918399999849498,134953.65992176038,151598.2598840798
"147.32.84.165",3813,"72.20.15.61",80,3,186,3,186,0,0,86910.915813,8.952814000003855,166.20472624577695,0
"147.32.84.165",1413,"74.6.136.244",25,3,186,3,186,0,0,86910.915874,8.95281299999624,166.2047448104439,0
"147.32.84.165",3491,"217.163.21.37",80,10,1449,5,700,5,749,86914.749441,0.1403239999926882,39907.64231558249,42701.17727767326
"147.32.84.165",3817,"193.23.181.44",80,8,861,5,477,3,384,86914.795897,0.13918199999898206,27417.338449137886,22071.819632010374
"147.32.84.165",3540,"202.141.255.46",6667,2,124,2,124,0,0,86914.86555,2.995301999995718,331.1853028514047,0
"147.32.84.165",3528,"46.4.36.120",443,6,366,3,186,3,180,86917.158367,1.0320840000058524,1441.7431139244115,1395.235271539753
"147.32.84.165",1414,"68.6.19.3",25,3,186,3,186,0,0,86917.459594,9.030687999998918,164.77149913718404,0
"147.32.84.165",3504,"184.82.147.251",80,10,1925,5,990,5,935,86918.190698,0.36076999999932013,21953.04487627831,20733.431272040623
"147.32.84.165",3824,"174.128.246.102",80,16,2314,12,2066,4,248,86918.31084,93.17313599999761,177.39018680234636,21.293691348974782
"147.32.84.165",1415,"205.178.149.7",25,3,186,3,186,0,0,86918.310901,8.981901999999536,165.66647019752352,0
"147.32.84.165",3521,"217.163.21.37",80,14,6141,7,810,7,5331,86919.065873,0.19336499999917578,33511.752385527994,220556.97773734538
"147.32.84.165",3828,"193.23.181.44",179,11,872,5,512,6,360,86919.112442,0.18806100000801962,21780.167072520784,15314.179972866177
"147.32.84.165",1417,"207.115.21.24",25,3,186,3,186,0,0,86919.166425,9.030157000001054,164.78118818973206,0
"147.32.84.165",3522,"173.241.240.4",80,9,2194,5,1164,4,1030,86919.166486,0.07188499999756459,129540.23788433586,114627.53008665459
"147.32.84.165",3831,"72.20.15.61",80,3,186,3,186,0,0,86919.173078,9.023571999990963,164.90143814461615,0
"147.32.84.165",1419,"205.188.159.42",25,3,186,3,186,0,0,86919.186244,9.010430000009364,165.14195215971418,0
"147.32.84.165",3523,"92.240.244.181",80,10,1758,6,1364,4,394,86927.292956,6.2451489999948535,1747.2761658703407,504.71173706225386
"147.32.84.165",3835,"72.20.15.61",80,3,186,3,186,0,0,86927.301805,8.921252000000095,166.79273267922306,0
"147.32.84.165",3577,"117.201.114.47",6667,2,124,2,124,0,0,86927.301864,2.901579000012134,341.8828162169121,0
"147.32.84.165",3562,"46.4.36.120",443,6,366,3,186,3,180,86929.200123,1.0322569999989355,1441.5014865498945,1395.0014385966722
"147.32.84.165",3586,"184.82.147.251",80,10,1890,5,962,5,928,86930.10314,0.32492099999217317,23685.75746161493,22848.63089852251
"147.32.84.165",1420,"206.46.232.11",25,3,186,3,186,0,0,86930.21162,9.021485000004759,164.93958588848898,0
"147.32.84.165",3542,"217.163.21.36",80,13,5492,7,2400,6,3092,86930.232574,0.26194300000497606,73298.38934285422,94432.75827004385
"147.32.84.165",3839,"193.23.181.44",179,10,749,5,449,5,300,86930.27846,0.19117499999993015,18789.067608219237,12553.942722640915
"147.32.84.165",1421,"74.6.136.244",25,3,186,3,186,0,0,86930.340977,8.992331000001286,165.47433585349418,0
"147.32.84.165",3563,"217.163.21.37",80,10,1451,5,701,5,750,86930.341012,0.13997799999197014,40063.4385426403,42863.87861195467
"147.32.84.165",3844,"67.19.72.206",80,3,186,3,186,0,0,86930.387302,8.94611900000018,166.32910874536432,0
"147.32.84.165",3595,"184.82.147.252",80,10,1508,5,596,5,912,86930.805356,0.34333000000333413,13887.51347086971,21250.69175408251
"147.32.84.165",1422,"65.55.92.184",25,3,186,3,186,0,0,86930.919078,9.016215999989072,165.03597518091885,0
"147.32.84.165",3596,"217.163.21.36",80,14,5553,7,2401,7,3152,86931.206322,0.2631709999986924,72986.76525945273,95816.02836226365
"147.32.84.165",3850,"174.37.196.55",80,3,186,3,186,0,0,86931.252977,8.983065000007628,165.6450220496831,0
"147.32.84.165",3599,"46.4.36.120",443,6,366,3,186,3,180,86931.808461,1.032182000009925,1441.6062283450901,1395.1028016242808
"147.32.84.165",3597,"217.163.21.36",80,14,6141,7,810,7,5331,86932.840926,0.19112699999823235,33904.157968575506,223139.58781540248
"147.32.84.165",1431,"205.178.149.7",25,3,186,3,186,0,0,86932.888894,8.952464999994845,166.21120551723538,0
"147.32.84.165",3855,"193.23.181.44",179,10,784,5,484,5,300,86932.888983,0.2011190000048373,19252.283473500123,11933.233557954622
"147.32.84.165",1434,"142.55.2.48",25,3,186,3,186,0,0,86932.956412,8.985350999995717,165.6028796204744,0
"147.32.84.165",3870,"174.37.196.55",80,3,186,3,186,0,0,86938.430347,9.030899999997928,164.76763113314746,0
"147.32.84.165",3616,"61.17.216.2",6667,1,62,1,62,0,0,86938.430531,0,0,0
"147.32.84.165",3615,"46.4.36.120",443,6,366,3,186,3,180,86939.233284,1.034085999999661,1438.9518860138207,1392.5340832391814
"147.32.84.165",3613,"217.163.21.36",80,10,1451,5,701,5,750,86940.135998,0.14800600000307895,37890.35579559841,40538.89707089701
"147.32.84.165",1437,"74.6.136.244",25,3,186,3,186,0,0,86940.136131,9.030984999990324,164.7660803336064,0
"147.32.84.165",3872,"174.128.246.102",80,3,186,3,186,0,0,86940.182662,8.984514999989187,165.6182888004295,0
"147.32.84.165",3625,"184.82.147.251",80,10,1910,5,982,5,928,86940.182735,0.3795959999988554,20695.686993602903,19557.634959331463
"147.32.84.165",1438,"209.191.88.254",25,3,186,3,186,0,0,86940.26758,8.99951599999622,165.34222507083993,0
"147.32.84.165",3874,"193.23.181.44",179,10,772,5,472,5,300,86940.301332,0.20627999999851454,18305.216211107192,11634.671320618978
"147.32.84.165",3632,"217.163.21.41",80,13,5485,7,2401,6,3084,86940.362222,0.2589280000102008,74182.78440046374,95285.17579801341
"147.32.84.165",1439,"220.64.7.31",25,3,186,3,186,0,0,86940.408658,8.958522000000812,166.09882746281866,0
"147.32.84.165",3876,"193.23.181.44",179,10,759,5,459,5,300,86940.838104,0.19445500000438187,18883.54632134558,12342.187138134366
"147.32.84.165",3635,"184.82.147.252",80,10,1508,5,596,5,912,86940.904062,0.34116500000527594,13975.642284308957,21385.546582700954
"147.32.84.165",1441,"205.188.146.193",25,3,186,3,186,0,0,86941.016782,8.953011999998125,166.20105055151402,0
"147.32.84.165",3879,"193.23.181.44",80,8,836,5,452,3,384,86950.872285,0.1262599999899976,28639.31570003534,24330.746081445952
"147.32.84.165",3650,"201.67.253.254",6667,3,186,3,186,0,0,86950.932644,8.869940000004135,167.75761730060253,0
"147.32.84.165",3641,"46.4.36.120",443,6,366,3,186,3,180,86951.273369,1.0328969999973197,1440.6083084798013,1394.1370727223884
"147.32.84.165",3640,"217.163.21.36",80,14,6138,7,810,7,5328,86951.374023,0.1930209999991348,33571.47667885383,220825.71326534968
"147.32.84.165",1442,"68.71.11.7",25,3,186,3,186,0,0,86951.420169,8.883695999989868,167.49785224547273,0
"147.32.84.165",3881,"67.19.72.206",80,3,186,3,186,0,0,86951.975328,8.931003999998211,166.61060727330297,0
"147.32.84.165",3661,"184.82.147.251",80,10,1902,5,982,5,920,86952.276922,0.33010799999465235,23798.272081037918,22295.733517876663
"147.32.84.165",1444,"76.96.62.116",25,3,186,3,186,0,0,86952.306543,8.900668000002042,167.17846345910874,0
"147.32.84.165",3890,"72.20.15.61",80,3,186,3,186,0,0,86952.389415,8.918069000006653,166.85226364573876,0
"147.32.84.165",3682,"27.255.59.70",6667,2,124,2,124,0,0,86953.981923,3.011845999993966,329.366109688871,0
"147.32.84.165",3679,"46.4.36.120",443,6,366,3,186,3,180,86961.106933,1.0310259999969276,1443.222576350581,1396.6670093715302
"147.32.84.165",3668,"217.163.21.36",80,10,1449,5,700,5,749,86961.207358,0.14261999999871477,39265.1801994844,42013.742813448305
"147.32.84.165",1446,"205.188.159.42",25,3,186,3,186,0,0,86961.254084,8.985027000002447,165.6088512588326,0
"147.32.84.165",3893,"193.23.181.44",179,10,736,5,436,5,300,86961.307632,0.1966580000007525,17736.37482322943,12203.927630662452
"147.32.84.165",3674,"184.82.147.252",80,10,1501,5,592,5,909,86961.372791,0.32757999999739695,14457.53709029133,22199.157457896654
"147.32.84.165",1453,"80.156.94.72",25,3,186,3,186,0,0,86961.479562,8.960305000000517,166.06577566276084,0
"147.32.84.165",3895,"174.128.246.102",80,36,2530,19,1506,17,1024,86961.909194,743.6700929999934,16.20073217062947,11.015637279365587
"147.32.84.165",3701,"184.82.147.251",80,10,1909,5,990,5,919,86961.90933,0.33109600000898354,23920.554762924072,22205.040229421436
"147.32.84.165",1454,"168.243.220.232",25,3,186,3,186,0,0,86962.019555,9.021710999993957,164.93545403981537,0
"147.32.84.165",3897,"174.128.246.102",80,3,186,3,186,0,0,86962.138206,9.003543999991962,165.26825436753887,0
"147.32.84.165",3706,"217.163.21.41",80,13,5453,7,2396,6,3057,86962.138287,0.2660220000107074,72054.19100385865,91932.24620150079
"147.32.84.165",1458,"65.55.92.136",25,3,186,3,186,0,0,86962.185249,8.956596999996691,166.13452631625043,0
"147.32.84.165",3898,"67.19.72.206",80,3,186,3,186,0,0,86970.439753,9.029737999997451,164.78883440476568,0
"147.32.84.165",3717,"60.173.109.42",6667,10,1129,5,571,5,558,86970.439843,1.6178919999947539,2823.4270272767353,2759.1458515243753
"147.32.84.165",3715,"46.4.36.120",443,6,366,3,186,3,180,86970.762157,1.008888999989722,1474.8897054236481,1427.3126181519176
"147.32.84.165",3710,"70.32.97.26",80,8,2665,5,734,3,1931,86971.771269,0.3557779999973718,16504.67426328603,43420.33515314077
"147.32.84.165",1463,"65.54.188.126",25,3,186,3,186,0,0,86971.843593,9.030112000007648,164.78200934813873,0
"147.32.84.165",3913,"193.23.181.44",80,8,862,5,478,3,384,86971.883636,0.12403799999447074,30829.26200172901,24766.603783815775
"147.32.84.165",3712,"184.82.147.252",80,10,1495,5,592,5,903,86971.94527,0.32335299999976996,14646.531808900394,22340.909161211242
"147.32.84.165",1464,"64.12.90.98",25,3,186,3,186,0,0,86972.051848,9.023397999990266,164.9046179722545,0
"147.32.84.165",3916,"193.23.181.44",179,11,818,5,458,6,360,86972.345652,0.19217499998921994,19065.955510370924,14986.340575837407
"147.32.84.165",3713,"195.113.232.88",80,13,10793,9,1291,4,9502,86972.409044,62.48101400000451,165.29821363013178,1216.6255816526043
"147.32.84.165",1465,"74.6.136.244",25,3,186,3,186,0,0,86972.409719,8.965409999989788,165.971216040504,0
"147.32.84.165",3930,"174.128.246.102",80,3,186,3,186,0,0,86972.947671,9.029479000004358,164.7935611788102,0
"147.32.84.165",3740,"46.4.36.120",443,6,366,3,186,3,180,86972.94777,1.0313310000055935,1442.79576585202,1396.253966953568
"147.32.84.165",3730,"184.82.147.251",80,10,1926,5,998,5,928,86973.248565,0.36459100000502076,21898.510933868507,20362.543233096167
"147.32.84.165",1466,"66.196.94.104",25,3,186,3,186,0,0,86973.348664,9.030222999994294,164.77998383881996,0
"147.32.84.165",3931,"174.128.246.102",80,7,572,5,450,2,122,86973.367175,3.345216999994591,1076.1633699714612,291.75984697004054
"147.32.84.165",3737,"195.113.232.82",80,16,5187,9,1981,7,3206,86973.367234,74.82875400000194,211.79024309291037,342.7559411185617
"147.32.84.165",1468,"205.188.59.194",25,3,186,3,186,0,0,86973.368018,9.011072000008426,165.13018650817668,0
"147.32.84.165",3939,"174.37.196.55",80,3,186,3,186,0,0,86973.979375,9.001321000003372,165.3090696353838,0
"147.32.84.165",3757,"173.192.170.88",80,14,4015,7,643,7,3372,86982.278453,39.435232999996515,130.4417296076444,684.0583394043185
"147.32.84.165",3755,"61.17.216.20",6667,3,186,3,186,0,0,86982.478558,8.929433999990579,166.63990125259562,0
"147.32.84.165",3756,"46.4.36.120",443,6,366,3,186,3,180,86982.47932,1.0318960000004154,1442.0057835279922,1395.489467930315
"147.32.84.165",3738,"70.32.97.26",80,9,2669,5,807,4,1862,86983.080874,0.35411000000021886,18231.622942012396,42066.02468157012
"147.32.84.165",1469,"205.188.59.194",25,3,186,3,186,0,0,86983.181459,8.929034999993746,166.6473476698257,0
"147.32.84.165",3951,"193.23.181.44",80,9,924,5,480,4,444,86983.181588,0.13439999999536667,28571.428572413548,26428.57142948253
"147.32.84.165",3744,"184.82.147.252",80,10,1507,5,596,5,911,86983.193916,0.3315520000032848,14380.851269040037,21981.46896995885
"147.32.84.165",1471,"64.12.90.98",25,3,186,3,186,0,0,86983.24695,8.863666999997804,167.8763428274515,0
"147.32.84.165",3953,"67.19.72.206",80,3,186,3,186,0,0,86983.24701,8.863655999986804,167.87655116604427,0
"147.32.84.165",3750,"173.201.33.10",80,12,4151,6,881,6,3270,86983.304259,0.5883319999993546,11979.630548750929,44464.690005011966
"147.32.84.165",1472,"64.12.90.33",25,3,186,3,186,0,0,86983.487134,8.924830000003567,166.72586480632182,0
"147.32.84.165",3954,"193.23.181.44",179,10,758,5,458,5,300,86983.511456,0.19863000001350883,18446.357547957567,12082.766952810633
"147.32.84.165",3751,"70.32.97.26",80,8,1504,5,849,3,655,86983.576785,0.35078100000100676,19362.508231576132,14938.095278777815
"147.32.84.165",1476,"69.175.13.98",7691,8,484,5,302,3,182,86983.689744,3.3340170000010403,724.6513740029659,436.7104306905291
"147.32.84.165",3961,"174.37.196.55",80,3,186,3,186,0,0,86983.821453,8.891170000002603,167.3570519964824,0
"147.32.84.165",3753,"46.137.82.8",80,12,2903,7,1382,5,1521,86983.821493,64.3712940000114,171.7535769903591,189.02835788881058
"147.32.84.165",1479,"184.154.10.50",8339,7,424,4,242,3,182,86983.863751,0.45558900000469293,4249.444126131354,3195.8629378343244
"147.32.84.165",3964,"174.37.196.55",80,3,186,3,186,0,0,86984.001489,8.911668000000645,166.9721089250511,0
"147.32.84.165",3777,"184.82.147.251",80,10,1925,5,990,5,935,86984.001527,0.3249340000038501,24374.180602541306,23020.05945795568
"147.32.84.165",1480,"65.54.188.94",25,3,186,3,186,0,0,86984.108845,8.904799000010826,167.10090817301895,0
"147.32.84.165",4066,"193.23.181.44",179,10,780,5,480,5,300,86992.81279,0.20424400000774767,18801.041890358276,11750.651181473922
"147.32.84.165",3793,"111.88.4.78",6667,3,186,3,186,0,0,86992.879843,8.969574000002467,165.8941662111925,0
"147.32.84.165",3791,"46.4.36.120",443,6,366,3,186,3,180,86993.013781,1.0306089999940014,1443.8065260527135,1397.2321219864968
"147.32.84.165",3781,"217.163.21.36",80,13,6077,6,749,7,5328,86993.314798,0.1871359999931883,32019.493845214747,227770.17784686806
"147.32.84.165",1484,"207.115.21.24",25,3,186,3,186,0,0,86993.360733,8.991096000012476,165.4970650961724,0
"147.32.84.165",4097,"193.23.181.44",80,9,949,5,497,4,452,86994.044631,0.13388200000918005,29697.79357738436,27008.858545226823
"147.32.84.165",3801,"94.100.176.20",25,3,186,3,186,0,0,86994.111166,8.942685999994865,166.39296068327283,0
"147.32.84.165",3784,"173.241.240.6",80,10,1665,5,841,5,824,86994.317752,0.05582199999480508,120525.95751900904,118089.6420875903
"147.32.84.165",1485,"74.6.136.244",25,3,186,3,186,0,0,86994.317897,9.03638000000501,164.66770985717454,0
"147.32.84.165",4171,"193.23.181.44",179,10,740,5,440,5,300,86994.334207,0.18740899999102112,18782.44908285432,12806.21528376431
"147.32.84.165",3785,"173.241.240.6",80,9,1172,5,669,4,503,86994.396371,0.05144100000325125,104041.5232919604,78225.53993401508
"147.32.84.165",1486,"64.12.90.98",25,3,186,3,186,0,0,86994.4128,8.941589999987627,166.41335601409358,0
"147.32.84.165",4220,"174.128.246.102",80,3,186,3,186,0,0,86994.921235,9.03536300000269,164.686244481772,0
"147.32.84.165",3830,"61.26.131.206",6667,2,124,2,124,0,0,86994.921364,3.012216000002809,329.3256526089347,0
"147.32.84.165",3833,"46.4.36.120",443,6,366,3,186,3,180,87003.454527,1.031505000006291,1442.5523870373142,1396.0184390683685
"147.32.84.165",3786,"68.67.179.210",80,10,1728,6,702,4,1026,87004.157064,11.286514000006719,497.58499391367934,727.2396064892237
"147.32.84.165",3840,"208.73.210.29",80,50,35915,22,3326,28,32589,87004.182672,14.425239000003785,1844.54482868485,18073.322736623748
"147.32.84.165",1491,"65.54.188.72",25,3,186,3,186,0,0,87004.365101,9.02497399999993,164.8758212489046,0
"147.32.84.165",4222,"72.20.15.61",80,3,186,3,186,0,0,87004.45788,9.032813999991049,164.73271784423707,0
"147.32.84.165",3789,"184.82.147.252",80,10,1514,5,603,5,911,87004.486263,0.3107049999962328,15525.9812364091,23456.333178057528
"147.32.84.165",1494,"68.6.19.3",25,3,186,3,186,0,0,87004.588783,9.002565999995568,165.28620839888677,0
"147.32.84.165",4223,"174.37.196.55",80,3,186,3,186,0,0,87005.061385,9.03111200001149,164.7637633104436,0
"147.32.84.165",3851,"212.117.171.138",65500,15,930,9,546,6,384,87011.584983,130.04235600000538,33.58905616874412,23.623072470325535
"147.32.84.165",3866,"46.4.36.120",443,6,366,3,186,3,180,87011.585103,1.0304400000022724,1444.0433212964545,1397.461278673988
"147.32.84.165",3816,"184.82.147.251",80,10,1926,5,998,5,928,87012.615816,0.3059579999971902,26095.084946539468,24264.76836712287
"147.32.84.165",3865,"74.125.232.218",80,8,1908,5,1034,3,874,87012.716795,5.891344999996363,1404.0936322698988,1186.8257588045371
"147.32.84.165",1495,"85.158.143.35",25,3,186,3,186,0,0,87012.724969,8.993740999998408,165.44839349946406,0
"147.32.84.165",4255,"67.19.72.206",80,3,186,3,186,0,0,87013.892743,8.928453000000445,166.6582105544965,0
"147.32.84.165",3860,"205.188.159.42",25,3,186,3,186,0,0,87014.393404,8.929793999996036,166.6331832515577,0
"147.32.84.165",3892,"46.4.36.120",443,6,366,3,186,3,180,87015.096255,1.0310220000101253,1443.2281755242727,1396.6724279267157
"147.32.84.165",3821,"217.163.21.36",80,10,1448,5,699,5,749,87015.397171,0.13934100000187755,40131.763084265585,43002.41852663079
"147.32.84.165",3887,"94.127.76.180",80,8,1422,5,830,3,592,87015.397272,3.2111540000041714,2067.7924509355125,1474.859193920269
"147.32.84.165",1496,"65.55.88.22",25,3,186,3,186,0,0,87015.412004,8.914526000007754,166.9185776112724,0
"147.32.84.165",4259,"193.23.181.44",179,10,756,5,456,5,300,87015.443416,0.18926700000884011,19274.3584451046,12680.4989770425
"147.32.84.165",3862,"178.122.89.175",6667,3,186,3,186,0,0,87015.50789,8.91938000000664,166.8277391476641,0
"147.32.84.165",3896,"74.125.93.27",25,3,186,3,186,0,0,87016.127549,8.900915000005625,167.17382426402898,0
"147.32.84.165",3826,"173.201.33.10",80,10,1631,5,920,5,711,87025.329506,0.627835999999661,11722.80659281082,9059.6907472701
"147.32.84.165",1497,"64.12.90.98",25,3,186,3,186,0,0,87025.43006,9.028950000007171,164.80321632070377,0
"147.32.84.165",4263,"174.128.246.102",80,3,186,3,186,0,0,87025.512704,8.946432000011555,166.3232895525365,0
"147.32.84.165",3914,"173.192.170.88",80,13,2864,8,666,5,2198,87025.512765,50.801940999997896,104.8778825202805,346.1285071765413
"147.32.84.165",3894,"14.98.87.197",6667,3,186,3,186,0,0,87025.530315,9.028440000009141,164.81252575179028,0
"147.32.84.165",3906,"46.4.36.120",443,6,366,3,186,3,180,87026.032619,1.030109999992419,1444.505926562164,1397.908961189191
"147.32.84.165",3829,"68.67.179.209",80,10,2133,6,825,4,1308,87027.062931,41.01191500001005,160.92884226445858,255.14536446292342
"147.32.84.165",1498,"65.55.92.168",25,3,186,3,186,0,0,87027.09232,8.971811000010348,165.85280273941166,0
"147.32.84.165",4274,"67.19.72.206",80,3,186,3,186,0,0,87033.656123,9.029822000011336,164.78730145490488,0
"147.32.84.165",3922,"78.138.22.163",6667,3,186,3,186,0,0,87033.656232,9.029837000009138,164.78702771694486,0
"147.32.84.165",3934,"46.4.36.120",443,6,366,3,186,3,180,87034.660017,1.0315899999986868,1442.4335249487629,1395.903411240738
"147.32.84.165",3858,"68.67.185.210",80,10,2622,6,1177,4,1445,87034.860017,21.526586000007228,437.41260225828836,537.0103740554177
"147.32.84.165",1500,"74.6.136.244",25,3,186,3,186,0,0,87034.889451,9.001537000003736,165.30510289513694,0
"147.32.84.165",4447,"72.20.15.61",80,3,186,3,186,0,0,87035.361341,9.031917000000249,164.74907818572282,0
"147.32.84.165",3948,"200.29.244.194",6667,2,124,2,124,0,0,87035.691865,2.979940000004717,332.89260857548464,0
"147.32.84.165",3861,"217.163.21.36",80,15,6194,7,809,8,5385,87036.365073,0.4381190000131028,14772.242244245153,98329.4493019285
"147.32.84.165",1502,"64.12.90.97",25,3,186,3,186,0,0,87036.419665,8.976852000007057,165.75966719723465,0
"147.32.84.165",4460,"174.37.196.55",80,3,186,3,186,0,0,87036.465429,9.031627999997,164.75434993563667,0
"147.32.84.165",3958,"46.4.36.120",443,6,366,3,186,3,180,87037.067143,1.030960000003688,1443.3149685678175,1396.756421194662
"147.32.84.165",3889,"184.82.147.252",80,10,1507,5,596,5,911,87038.098374,0.32872499999939464,14504.525058966554,22170.507262950556
"147.32.84.165",1503,"207.115.21.22",25,3,186,3,186,0,0,87038.204992,8.997197000004235,165.38484152334328,0
"147.32.84.165",4465,"72.20.15.61",80,3,186,3,186,0,0,87046.501294,8.927702999993926,166.67221120606413,0
"147.32.84.165",3979,"89.43.210.7",6667,2,124,2,124,0,0,87046.501425,3.008125000007567,329.7735300220252,0
"147.32.84.165",3962,"74.125.39.27",25,3,186,3,186,0,0,87046.600143,8.928942999991705,166.64906473267692,0
"147.32.84.165",3899,"217.163.21.41",80,11,3978,6,2350,5,1628,87048.105869,0.5355219999910332,35105.934023839895,24320.195996089933
"147.32.84.165",1505,"64.12.90.98",25,3,186,3,186,0,0,87048.160384,8.874093999998877,167.67908926817637,0
"147.32.84.165",4467,"193.23.181.44",80,8,884,5,498,3,386,87051.716596,0.1378649999969639,28897.834839065297,22398.72338931567
"147.32.84.165",3971,"46.4.36.120",443,6,366,3,186,3,180,87051.785158,0.9631410000001779,1544.9451326438445,1495.10819288114
"147.32.84.165",3912,"184.82.147.251",80,10,1925,5,990,5,935,87052.748607,0.32931400000234134,24049.994837582643,22713.884013272498
"147.32.84.165",1507,"74.6.136.244",25,3,186,3,186,0,0,87052.85593,8.895162999993772,167.28192614357283,0
"147.32.84.165",4472,"72.20.15.61",80,3,186,3,186,0,0,87052.85599,8.895153000004939,167.28211420300178,0
"147.32.84.165",3932,"68.67.185.210",80,10,2672,6,1199,4,1473,87052.856056,15.219014000002062,630.2642207963473,774.2945765079396
"147.32.84.165",1508,"64.22.125.242",25,3,186,3,186,0,0,87052.856112,8.895074000000022,167.28359988910674,0
"147.32.84.165",4004,"98.126.71.122",80,11,4199,7,766,4,3433,87054.62669,18.199454999994487,336.7133796040517,1509.056177781605
"147.32.84.165",4482,"193.23.181.44",80,8,836,5,452,3,384,87054.803519,0.1354390000051353,26698.366053078476,22681.79770881003
"147.32.84.165",4008,"59.90.211.177",6667,2,124,2,124,0,0,87054.870663,2.966219000009005,334.43248795756097,0
"147.32.84.165",4006,"46.4.36.120",443,6,366,3,186,3,180,87055.829914,1.0315149999951245,1442.538402259815,1396.0049054127242
"147.32.84.165",3950,"217.163.21.41",80,15,7478,7,2385,8,5093,87056.332019,0.239835000000312,79554.69385191977,169883.46154625888
"147.32.84.165",1510,"64.12.90.33",25,3,186,3,186,0,0,87056.386451,8.975791999997455,165.77924265629395,0
"147.32.84.165",4487,"72.20.15.61",80,3,186,3,186,0,0,87056.861557,9.002525999996578,165.2869427981175,0
"147.32.84.165",3955,"173.241.240.7",80,9,1439,5,762,4,677,87057.335291,0.05680500000016764,107314.49696297878,95343.719742699
"147.32.84.165",1511,"207.115.21.22",25,3,186,3,186,0,0,87057.351608,9.014609000005294,165.0653955151162,0
"147.32.84.165",4488,"72.20.15.61",80,3,186,3,186,0,0,87057.351641,9.014698999992106,165.06374755289144,0
"147.32.84.165",3960,"217.163.21.36",80,10,1446,5,698,5,748,87057.351669,0.13858600000094157,40292.67025501899,43178.96468589427
"147.32.84.165",1512,"64.12.90.98",25,3,186,3,186,0,0,87057.397464,8.968925000008312,165.90617047178128,0
"147.32.84.165",4489,"174.37.196.55",80,3,186,3,186,0,0,87057.397499,8.968936999997823,165.90594849761587,0
"147.32.84.165",3967,"217.163.21.36",80,14,6137,7,809,7,5328,87057.397524,0.18710599999758415,34590.018492638206,227806.69781060118
"147.32.84.165",1513,"81.169.145.101",25,3,186,3,186,0,0,87057.397548,8.968935000011697,165.90598549304454,0
"147.32.84.165",4493,"67.19.72.206",80,3,186,3,186,0,0,87057.435703,9.030308000001241,164.7784328064774,0
"147.32.84.165",4019,"46.4.36.120",443,6,366,3,186,3,180,87059.141269,1.0339890000032028,1439.0868761615363,1392.6647188660029
"147.32.84.165",4001,"217.163.21.41",80,16,7527,8,2435,8,5092,87060.175477,0.1934540000074776,100695.77263456449,210572.02228139728
"147.32.84.165",1526,"74.6.136.244",25,3,186,3,186,0,0,87060.222105,8.95204800000647,166.21894788755873,0
"147.32.84.165",4021,"95.100.248.96",80,16,6157,8,2148,8,4009,87061.750965,11.28794100000232,1522.332549399086,2841.2621929892625
"147.32.84.165",4494,"72.20.15.61",80,3,186,3,186,0,0,87061.75269,9.026784000001498,164.84276127574927,0
"147.32.84.165",4028,"46.4.36.120",443,6,366,3,186,3,180,87061.752751,1.0288979999895673,1446.2074958014184,1399.555641098147
"147.32.84.165",4002,"173.241.240.7",80,9,1429,5,752,4,677,87062.781865,0.06156600000394974,97716.27196202525,87970.63313602538
"147.32.84.165",1534,"205.188.190.2",25,3,186,3,186,0,0,87062.798228,8.985136000002967,165.60684223360767,0
"147.32.84.165",4032,"195.113.232.96",80,8,1968,5,945,3,1023,87067.569676,5.469450999997207,1382.2228227300802,1496.311055717325
"147.32.84.165",4503,"72.20.15.61",80,3,186,3,186,0,0,87067.570727,9.032705999998143,164.73468747906838,0
"147.32.84.165",4034,"184.82.147.251",80,10,1897,5,962,5,935,87067.570786,0.34275399999751244,22453.42140443541,21823.23182239824
"147.32.84.165",4037,"61.17.216.90",6667,2,124,2,124,0,0,87067.683146,2.9960510000091745,331.10250793359734,0
"147.32.84.165",4036,"46.4.36.120",443,6,366,3,186,3,180,87069.073998,1.0332429999980377,1440.1258948793516,1393.6702208509855
"147.32.84.165",1535,"205.188.59.194",25,3,186,3,186,0,0,87070.107507,8.99384700000519,165.44644355181285,0
"147.32.84.165",4507,"193.23.181.44",80,10,925,6,481,4,444,87071.783213,0.1353149999922607,28437.349888926467,26249.861435932122
"147.32.84.165",4044,"184.82.147.252",80,10,1515,5,603,5,912,87071.850438,0.34449200000381097,14003.22794127769,21179.01141367372
"147.32.84.165",4041,"66.111.4.71",25,3,186,3,186,0,0,87071.963359,8.943342999991728,166.3807370466923,0
"147.32.84.165",1537,"207.115.21.22",25,3,186,3,186,0,0,87073.799622,9.01347999999416,165.08607108474905,0
"147.32.84.165",4514,"193.23.181.44",179,10,781,5,481,5,300,87077.405066,0.20503800000005867,18767.25289945717,11705.147338538774
"147.32.84.165",4062,"173.192.170.88",80,3,186,3,186,0,0,87077.470954,8.95374399999855,166.18746303225117,0
"147.32.84.165",4050,"217.163.21.41",80,13,6078,6,750,7,5328,87077.905434,0.19100999999500345,31411.967960614373,223150.6203922045
"147.32.84.165",4056,"124.125.21.140",6667,2,124,2,124,0,0,87077.953007,2.9535699999978533,335.8647331875395,0
"147.32.84.165",4047,"46.4.36.120",443,6,366,3,186,3,180,87078.399111,1.030120999988867,1444.4905016168796,1397.8940338227867
"147.32.84.165",1538,"66.94.238.147",25,3,186,3,186,0,0,87078.499037,8.928962000005413,166.64871011872353,0
"147.32.84.165",4515,"174.37.196.55",80,3,186,3,186,0,0,87079.429455,8.901835999989999,167.15652815909795,0
"147.32.84.165",4060,"184.82.147.251",80,10,1925,5,990,5,935,87081.208341,0.3240069999883417,24443.91633602044,23085.920984019303
"147.32.84.165",4077,"46.4.36.120",443,6,366,3,186,3,180,87081.315195,1.023801999996067,1453.4060296871037,1406.5219642133263
"147.32.84.165",1539,"74.6.136.244",25,3,186,3,186,0,0,87082.111318,8.927833000008832,166.66978425767238,0
"147.32.84.165",4519,"193.23.181.44",80,9,921,5,477,4,444,87082.339238,0.1287960000045132,29628.249323474967,27578.496225624498
"147.32.84.165",4068,"217.163.21.41",80,10,1449,5,700,5,749,87082.403069,0.14098899999225978,39719.410736351325,42499.769487895916
"147.32.84.165",1541,"64.12.90.1",25,3,186,3,186,0,0,87082.448873,8.891654999999446,167.34792341809177,0
"147.32.84.165",4523,"67.19.72.206",80,3,186,3,186,0,0,87083.816361,8.927937999993446,166.66782408223403,0
"147.32.84.165",4078,"184.82.147.252",80,10,1514,5,603,5,911,87091.039295,0.3231999999989057,14925.742574307962,22549.504950571398
"147.32.84.165",4093,"190.55.176.74",6667,1,62,1,62,0,0,87091.145948,0,0,0
"147.32.84.165",4089,"46.4.36.120",443,6,366,3,186,3,180,87091.641466,1.0305110000044806,1443.9438298024284,1397.3649965829952
"147.32.84.165",1550,"205.188.156.193",25,3,186,3,186,0,0,87092.672204,9.000711999993655,165.32025466441422,0
"147.32.84.165",4526,"72.20.15.61",80,3,186,3,186,0,0,87092.845378,9.028254000004381,164.81592121790968,0
"147.32.84.165",4084,"217.163.21.40",80,11,3980,6,2351,5,1629,87094.750766,0.23506200000701938,80012.9327557766,55440.69224124206
"147.32.84.165",4119,"175.100.132.205",6667,6,366,3,186,3,180,87094.797282,1.600218000006862,929.8733047582388,899.8773917015213
"147.32.84.165",4114,"216.157.130.15",25,3,186,3,186,0,0,87096.397747,8.987685000000056,165.55987442817485,0
"147.32.84.165",1553,"124.108.96.211",25,3,186,3,186,0,0,87098.362294,9.029674999997951,164.78998413567905,0
"147.32.84.165",4542,"67.19.72.206",80,3,186,3,186,0,0,87099.466155,9.02992099999392,164.78549480122828,0
"147.32.84.165",4126,"173.192.170.88",80,11,1102,7,605,4,497,87099.466298,88.29601299999922,54.81561211603113,45.030345820937974
"147.32.84.165",4107,"184.82.147.251",80,10,1926,5,998,5,928,87100.368652,0.3248929999972461,24574.244443763564,22850.600043900387
"147.32.84.165",4132,"89.41.159.184",6667,2,124,2,124,0,0,87100.475315,3.0033859999966808,330.29387498013784,0
"147.32.84.165",4116,"46.4.36.120",443,6,366,3,186,3,180,87101.672789,1.0813320000015665,1376.0806116880333,1331.6909145368063
"147.32.84.165",1554,"213.188.129.250",25,3,186,3,186,0,0,87102.676826,9.029353000005358,164.79586078859882,0
"147.32.84.165",4547,"174.37.196.55",80,3,186,3,186,0,0,87102.754406,8.951896000013221,166.2217702258608,0
"147.32.84.165",4111,"217.163.21.41",80,14,6137,7,809,7,5328,87103.077468,0.18938699999125674,34173.41211539751,225062.96631747577
"147.32.84.165",1555,"64.12.90.98",25,3,186,3,186,0,0,87103.123587,8.983592000004137,165.63530489800903,0
"147.32.84.165",4551,"67.19.72.206",80,3,186,3,186,0,0,87103.378466,9.030647000006866,164.7722472153843,0
"147.32.84.165",4120,"217.163.21.41",80,10,2275,5,1155,5,1120,87103.378595,0.14014000000315718,65934.06593258052,63936.06393462353
"147.32.84.165",1556,"207.115.21.22",25,3,186,3,186,0,0,87103.424495,8.984689000004437,165.61508139004758,0
"147.32.84.165",4553,"72.20.15.61",80,3,186,3,186,0,0,87104.782916,9.030131000006804,164.7816626357778,0
"147.32.84.165",4137,"184.82.147.252",80,10,1507,5,596,5,911,87104.783047,0.30509199999505654,15628.0728438545,23887.876444213838
"147.32.84.165",4144,"46.4.36.120",443,6,366,3,186,3,180,87104.883784,1.0318330000009155,1442.0938271975017,1395.5746714814532
"147.32.84.165",1561,"74.6.136.244",25,3,186,3,186,0,0,87105.915845,9.000765000004321,165.31928119435244,0
"147.32.84.165",4561,"67.19.72.206",80,3,186,3,186,0,0,87113.712393,8.928281000000425,166.66142116269964,0
"147.32.84.165",4140,"217.163.21.41",80,10,1448,5,699,5,749,87113.912843,0.18299499999557156,30558.21197374423,32744.06404625812
"147.32.84.165",4162,"61.17.216.21",6667,1,62,1,62,0,0,87113.967426,0,0,0
"147.32.84.165",4153,"46.4.36.120",443,6,366,3,186,3,180,87116.221073,1.0299180000001797,1444.775215113961,1398.1695630135105
"147.32.84.165",1570,"65.55.92.136",25,3,186,3,186,0,0,87117.251211,8.90095100000326,167.1731481275939,0
"147.32.84.165",4564,"193.23.181.44",179,10,776,5,476,5,300,87117.424203,0.2546719999954803,14952.566438664562,9423.886410923044
"147.32.84.165",4142,"217.163.21.40",80,13,6085,7,2866,6,3219,87117.495064,0.24250399999436922,94546.89407404567,106192.06281380077
"147.32.84.165",1571,"64.12.90.1",25,3,186,3,186,0,0,87117.549761,8.905268000002252,167.0921077276533,0
"147.32.84.165",4570,"193.23.181.44",179,10,802,5,502,5,300,87119.330712,0.19235500000650063,20878.063995551347,12476.93067463228
"147.32.84.165",4149,"217.163.21.41",80,13,6077,6,749,7,5328,87119.393496,0.2563700000027893,23372.469477453706,166259.7027715265
"147.32.84.165",4166,"212.117.171.138",65500,33,9734,16,5408,17,4326,87119.449473,96.02177700000175,450.5644589351769,360.41824137455166
"147.32.84.165",4188,"46.4.36.120",443,6,366,3,186,3,180,87119.449518,1.0129050000105053,1469.0420128092637,1421.6535607831584
"147.32.84.165",1572,"74.6.136.244",25,3,186,3,186,0,0,87120.462663,9.0034799999994,165.26942915407145,0
"147.32.84.165",4575,"193.23.181.44",179,10,728,5,428,5,300,87120.462729,0.18596099999558646,18412.46282866442,12905.931889250762
"147.32.84.165",4161,"184.82.147.251",80,10,1910,5,982,5,928,87120.523454,0.32338000000163447,24293.400952317068,22957.5112869147
"147.32.84.165",4185,"205.188.190.1",25,3,186,3,186,0,0,87120.630604,8.935728999989806,166.52250756504563,0
"147.32.84.165",4202,"46.4.36.120",443,6,366,3,186,3,180,87123.644329,1.030895000003511,1443.4059724753074,1396.844489492233
"147.32.84.165",1573,"204.209.205.52",25,3,186,3,186,0,0,87123.644482,9.03177400000277,164.75168665641365,0
"147.32.84.165",4578,"193.23.181.44",179,10,729,5,429,5,300,87124.045862,0.2036039999948116,16856.250368791658,11787.587670483677
"147.32.84.165",4177,"217.163.21.40",80,11,3978,6,2350,5,1628,87124.108257,0.24661200000264216,76233.11112110756,52811.70421496303
"147.32.84.165",4193,"109.87.192.82",6667,1,62,1,62,0,0,87124.154409,0,0,0
"147.32.84.165",1575,"205.188.156.193",25,3,186,3,186,0,0,87124.346701,9.03182000000379,164.7508475588946,0
"147.32.84.165",4579,"174.37.196.55",80,7,574,4,392,3,182,87124.675346,0.24222200000076555,12946.800868583732,6011.014688985304
"147.32.84.165",4186,"92.240.244.181",80,10,1759,6,1365,4,394,87124.796409,9.93220699999074,1099.4535252849826,317.3514204851891
"147.32.84.165",1576,"91.195.118.50",25,3,186,3,186,0,0,87124.804883,8.974674999990384,165.79987576169546,0
"147.32.84.165",4591,"174.128.246.102",80,3,186,3,186,0,0,87126.252376,9.031992999996874,164.7476918992868,0
"147.32.84.165",4187,"173.241.240.4",80,9,2194,5,1164,4,1030,87126.252518,0.06564900001103524,141845.26799242492,125516.00174587428
"147.32.84.165",4226,"46.4.36.120",443,6,366,3,186,3,180,87126.269086,1.015847999995458,1464.786070363532,1417.534906803418
"147.32.84.165",1578,"74.6.136.244",25,3,186,3,186,0,0,87126.855422,9.031094000005396,164.7640917035202,0
"147.32.84.165",4597,"67.19.72.206",80,3,186,3,186,0,0,87127.285154,9.002519000001485,165.28707131856703,0
"147.32.84.165",4194,"217.163.21.41",80,10,1448,5,699,5,749,87127.285226,0.1986239999969257,28153.69743881179,30167.552763476437
"147.32.84.165",1584,"205.188.156.193",25,3,186,3,186,0,0,87127.339573,8.94816699999501,166.29104038858793,0
"147.32.84.165",4622,"174.128.246.102",80,6,562,4,440,2,122,87127.339645,0.3551009999937378,9912.672732721325,2748.51380316364
"147.32.84.165",4200,"184.82.147.252",80,10,1508,5,596,5,912,87127.339715,0.3424270000105025,13924.135654763677,21306.73106903435
"147.32.84.165",1586,"204.209.205.52",25,3,186,3,186,0,0,87127.452351,8.935670000006212,166.52360707131817,0
"147.32.84.165",4625,"174.128.246.102",80,3,186,3,186,0,0,87127.452423,8.935731999998097,166.52245165816487,0
"147.32.84.165",4214,"217.163.21.41",80,10,2274,5,1154,5,1120,87127.452489,0.19962099999247584,46247.639278172006,44885.05718505429
"147.32.84.165",1588,"74.6.136.244",25,3,186,3,186,0,0,87127.452558,8.93566099999589,166.52377479412934,0
"147.32.84.165",4626,"174.37.196.55",80,3,186,3,186,0,0,87127.452631,8.93565500000841,166.5238866091629,0
"147.32.84.165",4232,"217.163.21.40",80,13,5516,7,2410,6,3106,87134.682477,0.23333600000478327,82627.62711113917,106490.21153825654
"147.32.84.165",4241,"117.240.58.147",6667,1,62,1,62,0,0,87134.728446,0,0,0
"147.32.84.165",4237,"46.4.36.120",443,6,366,3,186,3,180,87136.287518,1.032414000001154,1441.2822762945261,1394.7892996398639
"147.32.84.165",1590,"64.136.52.37",25,3,186,3,186,0,0,87137.320154,9.00046100000327,165.32486502629803,0
"147.32.84.165",4630,"193.23.181.44",179,10,781,5,481,5,300,87138.193961,0.19223800000327174,20016.854107588042,12484.524391427054
"147.32.84.165",4235,"217.163.21.41",80,13,6081,6,750,7,5331,87138.25658,0.18748300000152085,32002.9015961518,227476.624545447
"147.32.84.165",1591,"203.169.255.16",25,3,186,3,186,0,0,87138.302419,9.022635999994236,164.91854486881113,0
"147.32.84.165",4631,"174.128.246.102",80,15,1162,10,854,5,308,87138.494546,30.59360399999423,223.31465099702828,80.53971019564955
"147.32.84.165",4236,"217.163.21.40",80,13,6082,7,2865,6,3217,87138.494685,0.15890700000454672,144235.30743984974,161956.36440977195
"147.32.84.165",4268,"46.4.36.120",443,6,366,3,186,3,180,87138.540701,0.9846549999929266,1511.1891982579575,1462.4411596044752
"147.32.84.165",1596,"74.6.136.244",25,3,186,3,186,0,0,87139.525593,9.003289000000223,165.27293525732244,0
"147.32.84.165",4634,"67.19.72.206",80,3,186,3,186,0,0,87139.525719,9.003336000008858,165.27207248496958,0
"147.32.84.165",4238,"184.82.147.251",80,10,1906,5,982,5,924,87141.604106,0.3070759999973234,25583.243236425107,24072.216650159673
"147.32.84.165",4272,"92.47.55.219",6667,6,366,3,186,3,180,87141.70499,1.4403180000081193,1033.105189264879,999.7792154176248
"147.32.84.165",4273,"46.4.36.120",443,6,366,3,186,3,180,87143.14552,0.9971389999991516,1492.2693827051855,1444.1316606824378
"147.32.84.165",1598,"80.12.242.9",25,3,186,3,186,0,0,87144.142922,8.903116000001319,167.13249608336898,0
"147.32.84.165",4278,"173.192.170.88",80,11,1826,8,1640,3,186,87144.715398,17.950536000003922,730.8973949299973,82.89446064449969
"147.32.84.165",4635,"193.23.181.44",80,8,863,5,477,3,386,87144.715528,0.13783399999374524,27685.47673413792,22403.76104691245
"147.32.84.165",4269,"217.163.21.41",80,10,1451,5,701,5,750,87144.784682,0.1418439999979455,39536.392093294235,42299.99154061438
"147.32.84.165",1606,"64.12.90.97",25,3,186,3,186,0,0,87144.831731,8.916542999999365,166.88081916950392,0
"147.32.84.165",4644,"193.23.181.44",80,8,864,5,480,3,384,87145.41797,0.1312060000054771,29266.95425391904,23413.563403135235
"147.32.84.165",4270,"173.241.240.4",80,9,2194,5,1164,4,1030,87145.482494,0.06969499999831896,133610.73248044486,118229.4282258232
"147.32.84.165",4284,"46.4.36.120",443,6,366,3,186,3,180,87145.499497,1.0500120000069728,1417.1266614001731,1371.4128981292
"147.32.84.165",1608,"74.6.136.244",25,3,186,3,186,0,0,87145.819959,8.93137299999944,166.6037237499871,0
"147.32.84.165",4645,"193.23.181.44",179,10,744,5,444,5,300,87145.820088,0.18996900001366157,18697.78753241086,12633.640224601933
"147.32.84.165",4271,"92.240.244.181",80,10,1758,6,1364,4,394,87145.882735,12.530780999994022,870.8156339182055,251.54058633707697
"147.32.84.165",1610,"212.227.15.186",25,3,186,3,186,0,0,87145.891959,8.85950999999477,167.95511264176895,0
"147.32.84.165",4646,"193.23.181.44",80,8,864,5,480,3,384,87146.320508,0.13085299999511335,29345.907240517245,23476.725792413796
"147.32.84.165",4276,"184.82.147.252",80,10,1491,5,592,5,899,87146.384964,0.32592099999601487,14531.12870928203,22066.69714466984
"147.32.84.165",4287,"95.111.183.113",6667,2,124,2,124,0,0,87146.492711,2.838071000005584,349.5331864488408,0
"147.32.84.165",1611,"80.12.242.148",25,3,186,3,186,0,0,87146.549643,8.904282999996212,167.11059161087232,0
"147.32.84.165",4648,"67.19.72.206",80,3,186,3,186,0,0,87147.926579,8.931902999989688,166.59383784191542,0
"147.32.84.165",4282,"217.163.21.40",80,13,5519,7,2412,6,3107,87147.926707,0.23912999998719897,80692.51035433842,103943.4617209492
"147.32.84.165",4291,"46.4.36.120",443,6,366,3,186,3,180,87147.974098,0.9871279999933904,1507.4032952261139,1458.7773824768844
"147.32.84.165",1613,"205.188.156.193",25,3,186,3,186,0,0,87148.428739,8.931362000002991,166.60392894157707,0
"147.32.84.165",4654,"67.19.72.206",80,3,186,3,186,0,0,87148.961452,8.900230999992345,167.18667189663725,0
"147.32.84.165",4289,"217.163.21.40",80,15,7760,7,2396,8,5364,87148.961487,0.18909400000120513,101367.57379862841,226934.75202664555
"147.32.84.165",1614,"205.188.59.194",25,3,186,3,186,0,0,87149.007488,8.854322999992291,168.05350335664232,0
"147.32.84.165",4656,"193.23.181.44",179,10,728,5,428,5,300,87158.262884,0.2177220000012312,15726.476883276093,11023.231460240251
"147.32.84.165",4298,"217.163.21.40",80,13,5355,7,2402,6,2953,87158.326921,0.34398799999326,55862.41380622728,68676.81430882147
"147.32.84.165",4312,"89.228.163.103",6667,2,124,2,124,0,0,87158.381515,2.991251999992528,331.63371056750753,0
"147.32.84.165",4301,"46.4.36.120",443,6,366,3,186,3,180,87159.265941,1.0306579999887617,1443.7378839694886,1397.1656941640213
"147.32.84.165",1615,"65.55.92.152",25,3,186,3,186,0,0,87160.296846,9.004442999997991,165.25175405078716,0
"147.32.84.165",4664,"193.23.181.44",179,10,762,5,462,5,300,87160.469737,0.19141299999319017,19309.033347429333,12538.333342486581
"147.32.84.165",4300,"184.82.147.251",80,10,1910,5,982,5,928,87160.532548,0.3224409999966156,24364.147239595644,23024.367248823582
"147.32.84.165",1618,"65.54.188.94",25,3,186,3,186,0,0,87160.639141,8.962655999988783,166.0222148436649,0
"147.32.84.165",4671,"174.128.246.102",80,3,186,3,186,0,0,87162.877333,9.032193000006373,164.74404388822848,0
"147.32.84.165",4316,"195.113.232.88",80,27,30504,17,1732,10,28772,87162.877464,61.81609999999637,224.14872500854653,3723.560690499943
"147.32.84.165",4325,"46.4.36.120",443,6,366,3,186,3,180,87162.87839,1.0305269999953452,1443.9214110903656,1397.3433010551923
"147.32.84.165",1621,"74.6.136.244",25,3,186,3,186,0,0,87163.909159,9.0052330000035,165.2372570481432,0
"147.32.84.165",4673,"193.23.181.44",80,9,932,5,480,4,452,87165.086565,0.13158699999621604,29182.214049339407,27479.918229794606
"147.32.84.165",4322,"184.82.147.252",80,10,1507,5,596,5,911,87165.152673,0.35877399999299087,13289.703267497503,20313.623618607762
"147.32.84.165",4332,"46.4.36.120",443,6,366,3,186,3,180,87165.272446,1.0441779999964638,1425.0443889883136,1379.075215149981
"147.32.84.165",1629,"207.115.21.22",25,3,186,3,186,0,0,87165.788067,9.032516999999643,164.73813445355916,0
"147.32.84.165",4677,"67.19.72.206",80,3,186,3,186,0,0,87166.316852,9.006290999997873,165.21784605897716,0
"147.32.84.165",4339,"173.192.170.88",80,3,186,3,186,0,0,87166.792102,9.03144199999224,164.75774300507922,0
"147.32.84.165",4334,"217.163.21.41",80,14,6137,7,809,7,5328,87166.792233,0.4537759999948321,14262.543634025835,93931.80776525298
"147.32.84.165",4340,"78.249.161.87",6667,2,124,2,124,0,0,87166.846762,2.955965000001015,335.5926068135649,0
"147.32.84.165",4344,"46.4.36.120",443,6,366,3,186,3,180,87167.494656,1.03137300000526,1442.7370117236064,1396.197108119619
"147.32.84.165",1630,"205.188.156.193",25,3,186,3,186,0,0,87168.526281,9.002604000008432,165.28551072540859,0
"147.32.84.165",4678,"193.23.181.44",179,10,784,5,484,5,300,87168.526312,0.20080599999346305,19282.292362409728,11951.83410893165
"147.32.84.165",4343,"217.163.21.41",80,10,1448,5,699,5,749,87168.59185,0.19929099999717437,28059.470824469172,30066.58604796482
"147.32.84.165",1631,"74.6.136.244",25,3,186,3,186,0,0,87168.646392,8.983164000004763,165.64319653957236,0
"147.32.84.165",4690,"174.128.246.102",80,3,186,3,186,0,0,87168.646452,8.983233999999356,165.64190579919287,0
"147.32.84.165",1632,"65.54.188.94",25,3,186,3,186,0,0,87168.6465,8.983246999996481,165.64166609251453,0
"147.32.84.165",4691,"193.23.181.44",80,8,822,5,436,3,386,87168.646552,0.12530499999411404,27836.079966193225,24643.868960895838
"147.32.84.165",1633,"65.54.188.126",25,3,186,3,186,0,0,87168.646604,8.98320300001069,165.64247741014304,0
"147.32.84.165",4695,"174.37.196.55",80,3,186,3,186,0,0,87169.401247,9.030860999992,164.7683426864081,0
"147.32.84.165",4348,"217.163.21.40",80,13,5554,7,2429,6,3125,87169.902968,0.3616000000038184,53738.93805252987,69137.16814086285
"147.32.84.165",4354,"46.4.36.120",443,6,366,3,186,3,180,87169.957305,0.9763099999981932,1524.1060728690209,1474.941360840988
"147.32.84.165",1646,"74.6.136.244",25,3,186,3,186,0,0,87170.933863,9.003422000008868,165.27049381874295,0
"147.32.84.165",4699,"174.128.246.102",80,3,186,3,186,0,0,87170.933923,9.003484999993816,165.26933737336398,0
"147.32.84.165",4349,"184.82.147.251",80,10,1910,5,982,5,928,87170.933972,0.3081689999962691,25492.50573579792,24090.67751814712
"147.32.84.165",1652,"74.125.113.27",25,3,186,3,186,0,0,87171.035624,9.001157999999123,165.31206318122014,0
"147.32.84.165",4708,"174.128.246.102",80,3,186,3,186,0,0,87172.91428,8.928486000004341,166.6575945797839,0
"147.32.84.165",4358,"184.82.147.252",80,10,1507,5,596,5,911,87172.914367,0.3057509999925969,15594.388898533272,23836.38974255673
"147.32.84.165",4359,"46.4.36.120",443,6,366,3,186,3,180,87173.016325,1.0288389999914216,1446.2904302931818,1399.6359002837244
"147.32.84.165",1653,"12.102.252.75",25,3,186,3,186,0,0,87174.045407,8.901276999997208,167.1670255852578,0
"147.32.84.165",4721,"174.128.246.102",80,3,186,3,186,0,0,87181.240895,9.028801000007661,164.80593602613874,0
"147.32.84.165",4366,"217.163.21.41",80,15,6197,7,809,8,5388,87181.241027,0.40769200000795536,15874.728961749828,105726.87224463298
"147.32.84.165",4373,"1.23.71.127",6667,6,366,3,186,3,180,87181.286943,1.4249089999939315,1044.2772134966774,1010.5908517709782
"147.32.84.165",4369,"46.4.36.120",443,6,366,3,186,3,180,87181.542638,1.0301159999944502,1444.4975129092418,1397.9008189444276
"147.32.84.165",1654,"74.6.136.244",25,3,186,3,186,0,0,87182.572993,9.00221700000111,165.29261625217615,0
"147.32.84.165",4722,"67.19.72.206",80,3,186,3,186,0,0,87182.573023,9.002252999998746,165.29195524722616,0
"147.32.84.165",4378,"184.82.147.251",80,10,1910,5,982,5,928,87182.573047,0.30814599999575876,25494.408495025502,24092.47564499355
"147.32.84.165",1656,"216.69.186.201",25,3,186,3,186,0,0,87182.674857,9.000778999994509,165.31902405346335,0
"147.32.84.165",4742,"174.37.196.55",80,7,569,4,387,3,182,87182.712095,0.24327000000630505,12726.600073662014,5985.119414487045
"147.32.84.165",4382,"217.163.21.41",80,10,1448,5,699,5,749,87182.712154,0.13979800000379328,40000.57225316719,42861.84351591163
"147.32.84.165",1658,"74.6.136.244",25,3,186,3,186,0,0,87182.758171,9.018023000011453,165.00290584733597,0
"147.32.84.165",4743,"72.20.15.61",80,3,186,3,186,0,0,87182.758242,9.01807700000063,165.0019178146179,0
"147.32.84.165",4383,"184.82.147.252",80,10,1508,5,596,5,912,87182.946585,0.34159700000600424,13957.968014696244,21358.50139161573
"147.32.84.165",1666,"74.6.136.244",25,3,186,3,186,0,0,87183.059125,9.017342000006465,165.01536705593878,0
"147.32.84.165",4745,"174.128.246.102",80,17,1776,13,1528,4,248,87183.059183,189.11600799999724,64.63757420260362,10.49091518471577
"147.32.84.165",4386,"217.163.21.40",80,11,4002,6,2374,5,1628,87183.059233,0.23227599999518134,81764.79705347947,56071.22561207438
"147.32.84.165",1667,"209.85.229.27",25,3,186,3,186,0,0,87183.105225,8.971342999997432,165.86145463398577,0
"147.32.84.165",4754,"72.20.15.61",80,3,186,3,186,0,0,87184.85266,9.029790999993565,164.78786718331136,0
"147.32.84.165",4388,"217.163.21.41",80,14,6141,7,810,7,5331,87184.85279,0.1903899999888381,34035.40102095646,224003.36153422084
"147.32.84.165",4391,"46.4.36.120",443,6,366,3,186,3,180,87184.898702,0.9842700000008335,1511.780304183547,1463.013197596981
"147.32.84.165",1668,"74.6.136.244",25,3,186,3,186,0,0,87185.883217,9.002642999999807,165.28479469862705,0
"147.32.84.165",4755,"174.37.196.55",80,9,744,6,562,3,182,87186.759105,9.272209000002476,484.8898466372791,157.0283844981936
"147.32.84.165",4389,"217.163.21.41",80,10,2274,5,1154,5,1120,87186.75924,0.1398509999999078,66013.11395704061,64068.18685605328
"147.32.84.165",4399,"85.66.209.80",6667,2,124,2,124,0,0,87186.805148,2.963128000003053,334.7813526783109,0
"147.32.84.165",4403,"46.4.36.120",443,6,366,3,186,3,180,87187.260335,1.0304579999938142,1444.0180968161076,1397.4368678865555
"147.32.84.165",1669,"65.55.92.136",25,3,186,3,186,0,0,87188.291001,9.0034799999994,165.26942915407145,0
"147.32.84.165",4765,"174.37.196.55",80,3,186,3,186,0,0,87189.567504,9.032008999987738,164.74740005263726,0
"147.32.84.165",4407,"173.192.170.88",80,17,3343,10,968,7,2375,87189.567632,23.750778000001446,326.0524771019934,799.9737945425974
"147.32.84.165",4397,"217.163.21.41",80,10,1451,5,701,5,750,87190.369829,0.13931800000136718,40253.23360904525,43066.940380576234
"147.32.84.165",4409,"46.4.36.120",443,6,366,3,186,3,180,87190.41586,0.9859859999996843,1509.1492171293269,1460.4669843187035
"147.32.84.165",1673,"209.85.229.27",25,3,186,3,186,0,0,87191.402115,9.004437999989023,165.25184581223326,0
"147.32.84.165",4766,"67.19.72.206",80,3,186,3,186,0,0,87191.402175,9.004502000010689,165.25067127512813,0
"147.32.84.165",4402,"217.163.21.40",80,13,6125,7,2889,6,3236,87192.076602,0.1665110000030836,138801.64072987364,155473.2119771101
"147.32.84.165",1684,"205.188.156.193",25,3,186,3,186,0,0,87192.122626,8.986082999996142,165.58938972638455,0
"147.32.84.165",4782,"174.37.196.55",80,3,186,3,186,0,0,87194.985616,9.031694999997853,164.75312773519852,0
"147.32.84.165",4416,"217.163.21.40",80,11,4006,6,2376,5,1630,87198.800615,0.238601999997627,79664.04305156304,54651.679366181714
"147.32.84.165",4429,"112.205.182.117",6667,3,184,2,124,1,60,87198.846534,0.8569450000068173,1157.600546116855,560.1292965081557
"147.32.84.165",4425,"46.4.36.120",443,6,366,3,186,3,180,87202.513087,1.0303779999958351,1444.1302124133226,1397.5453668516027
"147.32.84.165",1685,"74.6.136.244",25,3,186,3,186,0,0,87203.543746,8.904104000001098,167.11395104996714,0
"147.32.84.165",4785,"193.23.181.44",179,10,783,5,483,5,300,87203.543777,0.18794299999717623,20559.424932336162,12769.829150519354
"147.32.84.165",4417,"184.82.147.251",80,10,1910,5,982,5,928,87203.605383,0.322424999991199,24365.35628507231,23025.509809111103
"147.32.84.165",1686,"207.115.21.22",25,3,186,3,186,0,0,87203.711902,8.836141000007046,168.39930462843603,0
"147.32.84.165",4811,"174.37.196.55",80,7,546,4,364,3,182,87203.716825,0.2437659999995958,11945.882526705236,5972.941263352618
"147.32.84.165",4423,"173.241.240.4",80,9,2194,5,1164,4,1030,87203.71695,0.1034419999923557,90021.46130863819,79658.1659346197
"147.32.84.165",1687,"74.6.136.244",25,3,186,3,186,0,0,87203.733372,8.9147740000044,166.91393410525782,0
"147.32.84.165",4824,"67.19.72.206",80,3,186,3,186,0,0,87203.733431,8.914839000004577,166.9127171000212,0
"147.32.84.165",4424,"92.240.244.181",80,10,1758,6,1364,4,394,87203.733487,5.650716999996803,1931.0823741493643,557.8053192190979
"147.32.84.165",1688,"61.111.244.139",25,3,186,3,186,0,0,87203.744309,8.904010999991442,167.11569651041876,0
"147.32.84.165",4829,"193.23.181.44",80,8,866,5,480,3,386,87203.816851,0.1254670000053011,30605.65726316686,24612.049382463352
"147.32.84.165",4435,"217.163.21.41",80,10,2277,5,1156,5,1121,87203.879248,0.1398239999980433,66140.29065202981,64137.773201492586
"147.32.84.165",1689,"64.12.90.97",25,3,186,3,186,0,0,87203.925248,8.924029999994673,166.74081104623005,0
"147.32.84.165",4841,"72.20.15.61",80,9,710,5,468,4,242,87204.11867,3.377097999997204,1108.6441672711599,573.2732659820955
"147.32.84.165",4464,"184.82.147.252",80,10,1507,5,596,5,911,87206.92934,0.3052400000015041,15620.495347845976,23876.294063569938
"147.32.84.165",4490,"111.88.72.94",6667,2,124,2,124,0,0,87207.030298,3.0092080000031274,329.6548460588198,0
"147.32.84.165",4485,"46.4.36.120",443,6,366,3,186,3,180,87207.312516,1.0495179999998072,1417.7936919617132,1372.0584115758516
"147.32.84.165",1690,"74.125.113.27",25,3,186,3,186,0,0,87208.362244,8.900255999993533,167.18620228464005,0
"147.32.84.165",4851,"67.19.72.206",80,3,186,3,186,0,0,87209.3375,8.928911000009975,166.6496619798694,0
"147.32.84.165",4481,"217.163.21.40",80,13,6139,7,2891,6,3248,87209.337628,0.16446200000063982,140628.2302289284,157993.94388915927
"147.32.84.165",4510,"46.4.36.120",443,6,366,3,186,3,180,87209.383896,0.9845380000042496,1511.368784133855,1462.6149523876015
"147.32.84.165",1698,"206.46.232.11",25,3,186,3,186,0,0,87210.368683,8.900222000011127,167.18684095724126,0
"147.32.84.165",4865,"174.37.196.55",80,3,186,3,186,0,0,87212.347472,9.028302000006079,164.81504495518627,0
"147.32.84.165",4496,"217.163.21.41",80,13,6077,6,749,7,5328,87212.347599,0.18711400000029244,32023.258548214646,227796.9580038553
"147.32.84.165",4495,"212.117.171.138",65500,27,5045,13,3272,14,1773,87212.393543,297.3109229999973,88.04251029821813,47.70763164998189
"147.32.84.165",4528,"46.4.36.120",443,6,366,3,186,3,180,87212.393602,0.9846350000007078,1511.2198936650946,1462.4708648371882
"147.32.84.165",1700,"68.142.202.129",25,3,186,3,186,0,0,87212.547916,9.028965999998036,164.80292427730083,0
"147.32.84.165",4869,"72.20.15.61",80,7,565,4,383,3,182,87213.049796,0.3661839999986114,8367.378148722006,3976.143141168159
"147.32.84.165",4511,"173.241.240.4",80,9,2195,5,1165,4,1030,87213.232806,0.07033299999602605,132512.47636993442,117156.9533571094
"147.32.84.165",4517,"65.55.196.251",443,22,9060,12,4016,10,5044,87213.249526,2.299717999994755,13970.408545775299,17546.499179504634
"147.32.84.165",1701,"74.6.136.244",25,3,186,3,186,0,0,87213.349171,8.929398000007495,166.64057308216647,0
"147.32.84.165",4870,"72.20.15.61",80,3,186,3,186,0,0,87213.378446,9.000832999998238,165.31803223104922,0
"147.32.84.165",4513,"92.240.244.181",80,10,1760,6,1366,4,394,87213.378506,2.7485560000059195,3975.905893849885,1146.7839840240517
"147.32.84.165",1702,"74.125.113.27",25,3,186,3,186,0,0,87213.386937,8.99243800000113,165.47236689313988,0
"147.32.84.165",4872,"193.23.181.44",179,10,781,5,481,5,300,87213.386997,0.18699600000400096,20577.98027721271,12834.499133396703
"147.32.84.165",4534,"184.82.147.251",80,10,1910,5,982,5,928,87213.447812,0.40417900000466034,19436.93264595493,18368.099282531744
"147.32.84.165",1703,"205.188.146.193",25,3,186,3,186,0,0,87213.560603,9.019415999995545,164.97742204159726,0
"147.32.84.165",4880,"174.37.196.55",80,7,546,4,364,3,182,87215.958832,0.2438069999916479,11943.873638163615,5971.936819081808
"147.32.84.165",4536,"217.163.21.41",80,10,1448,5,699,5,749,87216.080239,0.14034699999319855,39844.10069521256,42694.17942877569
"147.32.84.165",4557,"190.55.176.74",6667,2,124,2,124,0,0,87216.126511,2.942657000006875,337.11030541367285,0
"147.32.84.165",4549,"46.4.36.120",443,6,366,3,186,3,180,87222.579919,1.0309410000045318,1443.3415685218251,1396.7821630856374
"147.32.84.165",1704,"81.17.254.9",25,3,186,3,186,0,0,87223.611082,9.001070999991498,165.31366100782958,0
"147.32.84.165",4889,"174.37.196.55",80,9,793,6,611,3,182,87224.586377,9.271643999993103,527.1988441320262,157.03795357124187
"147.32.84.165",4546,"184.82.147.252",80,10,1507,5,596,5,911,87224.586475,0.3244940000004135,14693.64610745938,22459.583228012576
"147.32.84.165",4599,"46.4.36.120",443,6,366,3,186,3,180,87224.686738,1.0308399999921676,1443.4829847612684,1396.919017510905
"147.32.84.165",1705,"205.188.156.193",25,3,186,3,186,0,0,87224.693264,9.021955999996862,164.93097505690756,0
"147.32.84.165",4901,"67.19.72.206",80,3,186,3,186,0,0,87224.887939,9.028156000000308,164.81771028324602,0
"147.32.84.165",4566,"217.163.21.40",80,11,4012,6,2374,5,1638,87225.717836,0.22720500000286847,83589.70973244526,57674.78708582364
"147.32.84.165",4618,"78.153.48.99",6667,2,124,2,124,0,0,87225.763783,2.935782000000472,337.89974868700756,0
"147.32.84.165",4621,"46.4.36.120",443,6,366,3,186,3,180,87229.301468,1.0308489999879384,1443.4703821970147,1396.906821480982
"147.32.84.165",1706,"206.46.232.11",25,3,186,3,186,0,0,87230.332557,9.001743000000715,165.30131997768453,0
"147.32.84.165",4903,"72.20.15.61",80,8,629,5,447,3,182,87230.332615,3.348227999988012,1068.0276253626705,434.8568854944206
"147.32.84.165",4593,"184.82.147.251",80,10,1925,5,990,5,935,87230.332665,0.3226510000095004,24546.646375702527,23182.94379927461
"147.32.84.165",1712,"205.188.146.193",25,3,186,3,186,0,0,87230.439155,8.995657999999821,165.41313598182919,0
"147.32.84.165",4906,"174.37.196.55",80,3,186,3,186,0,0,87230.439213,8.99572399999306,165.4119223756918,0
"147.32.84.165",4603,"217.163.21.41",80,13,6077,6,749,7,5328,87230.439265,0.19054400001186877,31446.804935483484,223696.3640804486
"147.32.84.165",1713,"74.6.136.244",25,3,186,3,186,0,0,87230.485494,8.949491999999736,166.26642048510058,0
"147.32.84.165",4916,"67.19.72.206",80,3,186,3,186,0,0,87230.485553,8.949479999995674,166.2666434251732,0
"147.32.84.165",4619,"217.163.21.41",80,10,2274,5,1154,5,1120,87230.4856,0.141405999995186,65287.18725028848,63363.6479378883
"147.32.84.165",1721,"205.178.149.7",25,3,186,3,186,0,0,87230.485654,8.94942699999956,166.26762808390674,0
"147.32.84.165",4921,"193.23.181.44",179,10,742,5,442,5,300,87231.307434,0.21057899999141227,16791.797853272186,11397.14786421189
"147.32.84.165",4632,"184.82.147.252",80,10,1515,5,603,5,912,87231.376366,0.30506400000012945,15813.07528911295,23916.29297457879
"147.32.84.165",4649,"46.4.36.120",443,6,366,3,186,3,180,87231.476794,0.9620670000003884,1546.6698265291288,1496.777251479802
"147.32.84.165",1724,"205.188.190.2",25,3,186,3,186,0,0,87232.439114,9.001666000011028,165.30273396037768,0
"147.32.84.165",4926,"67.19.72.206",80,3,186,3,186,0,0,87232.611976,9.029360999993514,164.79571477993503,0
"147.32.84.165",4633,"217.163.21.40",80,13,6125,7,2889,6,3236,87232.612103,0.16163799999048933,142986.17900097684,160160.35834100418
"147.32.84.165",1725,"65.54.188.72",25,3,186,3,186,0,0,87232.658002,8.983435000001919,165.63819964186106,0
"147.32.84.165",4930,"67.19.72.206",80,3,186,3,186,0,0,87233.615219,9.030713000000105,164.77104299516358,0
"147.32.84.165",4638,"217.163.21.41",80,10,1448,5,699,5,749,87233.615274,0.14007400000991765,39921.75564061903,42777.389091307086
"147.32.84.165",4661,"46.4.36.120",443,6,366,3,186,3,180,87233.661278,0.984641000002739,1511.2106849053216,1462.4619531341823
"147.32.84.165",1727,"205.188.146.193",25,3,186,3,186,0,0,87234.317218,8.929724000001443,166.63448948699417,0
"147.32.84.165",4931,"193.23.181.44",179,10,781,5,481,5,300,87234.317322,0.2040089999936754,18861.912955405372,11764.186874473204
"147.32.84.165",4653,"217.163.21.41",80,14,6141,7,810,7,5331,87234.384262,0.18905199998698663,34276.28377613593,225588.72692664276
"147.32.84.165",1728,"74.6.136.244",25,3,186,3,186,0,0,87234.430299,8.917493999993894,166.8630222796919,0
"147.32.84.165",4939,"67.19.72.206",80,3,186,3,186,0,0,87234.618639,8.929045000011683,166.64716103436066,0
"147.32.84.165",4658,"173.241.240.4",80,9,2194,5,1164,4,1030,87234.618667,0.07239000000117812,128636.5520078526,113827.87677670806
"147.32.84.165",1731,"209.86.93.228",25,3,186,3,186,0,0,87234.634976,8.912805999992997,166.95078968409825,0
"147.32.84.165",4941,"174.37.196.55",80,7,600,4,418,3,182,87234.646186,0.24270099999557715,13778.27038232615,5999.151219098946
"147.32.84.165",4659,"92.240.244.181",80,10,1758,6,1364,4,394,87234.646246,8.140420999989146,1340.4712115030106,387.2035610939781
"147.32.84.165",1733,"213.161.194.44",25,3,186,3,186,0,0,87234.65513,8.89267899999686,167.32865315396242,0
"147.32.84.165",4943,"193.23.181.44",80,8,840,5,454,3,386,87242.645836,0.15363100000831764,23641.062023962364,20100.110002752142
"147.32.84.165",4668,"217.163.21.40",80,11,4002,6,2374,5,1628,87242.70706,0.23729699999967124,80034.72441719158,54884.80680336474
"147.32.84.165",4692,"89.103.213.96",6667,4,244,3,182,1,62,87242.753046,0.04320200000074692,33702.14341870347,11480.94995582206
"147.32.84.165",4688,"46.4.36.120",443,6,366,3,186,3,180,87242.789868,0.9861389999859966,1508.9150718317903,1460.2403920952809
"147.32.84.165",1734,"205.188.146.193",25,3,186,3,186,0,0,87243.77625,9.000990000000456,165.3151486669716,0
"147.32.84.165",4944,"67.19.72.206",80,3,186,3,186,0,0,87244.550983,9.028727000011713,164.8072867856199,0
"147.32.84.165",4680,"217.163.21.41",80,10,1451,5,701,5,750,87244.551109,0.139391999997315,40231.864096275414,43044.07713581535
"147.32.84.165",4696,"94.100.176.20",25,3,186,3,186,0,0,87244.597044,8.982761999999639,165.65060946733976,0
"147.32.84.165",1735,"74.6.136.244",25,3,186,3,186,0,0,87245.654368,9.029354999991483,164.7958242866078,0
"147.32.84.165",4948,"174.37.196.55",80,7,599,4,417,3,182,87245.654493,0.24850400000286754,13424.331197733256,5859.060618674946
"147.32.84.165",4703,"184.82.147.251",80,10,1925,5,990,5,935,87245.654548,0.3225229999952717,24556.388226936095,23192.144436550756
"147.32.84.165",4726,"210.212.164.162",6667,6,366,3,186,3,180,87245.76101,3.7702339999959804,394.67046342523736,381.93915815345554
"147.32.84.165",4723,"46.4.36.120",443,6,366,3,186,3,180,87245.854662,1.0312689999991562,1442.8825068931749,1396.3379098966207
"147.32.84.165",1738,"66.94.238.147",25,3,186,3,186,0,0,87246.886173,9.002278999992996,165.29147785812435,0
"147.32.84.165",4958,"72.20.15.61",80,8,621,4,379,4,242,87249.531559,0.36925499999779277,8211.127811453125,5242.989262194344
"147.32.84.165",4717,"217.163.21.41",80,10,2274,5,1154,5,1120,87249.716134,0.14938400000391994,61800.46055640327,59979.649760114095
"147.32.84.165",4740,"46.4.36.120",443,6,366,3,186,3,180,87249.762267,1.0359860000025947,1436.3128459228922,1389.9801734737664
"147.32.84.165",1745,"64.12.90.97",25,3,186,3,186,0,0,87250.798503,9.00164400000358,165.30313796006686,0
"147.32.84.165",4960,"67.19.72.206",80,3,186,3,186,0,0,87251.372386,9.029951000004075,164.7849473379566,0
"147.32.84.165",4720,"217.163.21.40",80,11,4016,6,2376,5,1640,87253.379267,0.24221700000634883,78475.08638742026,54166.30541892645
"147.32.84.165",4767,"88.154.52.66",6667,5,306,3,186,2,120,87253.426822,5.058560000004945,294.1548582993076,189.77732793503714
"147.32.84.165",4762,"46.4.36.120",443,6,366,3,186,3,180,87253.579851,1.0308199999999488,1443.5109912497564,1396.9461205642804
"147.32.84.165",1747,"205.188.146.193",25,3,186,3,186,0,0,87254.610897,9.001932999992277,165.2978310326545,0
"147.32.84.165",4970,"193.23.181.44",179,10,772,5,472,5,300,87254.610957,0.21164900000439957,17840.859157952593,11339.529125817326
"147.32.84.165",4729,"184.82.147.252",80,10,1514,5,603,5,911,87254.681416,0.35271999999531545,13676.570651122898,20662.281696804246
"147.32.84.165",1748,"74.6.136.244",25,3,186,3,186,0,0,87254.794101,9.018865999998525,164.98748290530577,0
"147.32.84.165",4971,"193.23.181.44",80,10,987,6,541,4,446,87254.794161,0.18031300000438932,24002.706404389282,19787.813412860665
"147.32.84.165",4750,"217.163.21.40",80,14,6191,7,2889,7,3302,87254.794216,0.17676800000481308,130747.64662931471,149438.81245067398
"147.32.84.165",1749,"65.55.37.104",25,3,186,3,186,0,0,87254.840533,8.972559000001638,165.83897637226218,0
"147.32.84.165",4972,"174.128.246.102",80,3,186,3,186,0,0,87255.386467,9.028892000002088,164.8042749874133,0
"147.32.84.165",4770,"217.163.21.41",80,10,2277,5,1156,5,1121,87255.386594,0.13994200000888668,66084.52072582018,64083.69181111109
"147.32.84.165",1750,"68.6.19.3",25,3,186,3,186,0,0,87255.432644,8.982837000003201,165.64922640803454,0
"147.32.84.165",4973,"193.23.181.44",179,10,781,5,481,5,300,87255.587442,0.20230699999956414,19020.59740892945,11863.158467107765
"147.32.84.165",4774,"184.82.147.251",80,10,1926,5,998,5,928,87255.587574,0.3044389999995474,26225.286510637172,24385.837556985265
"147.32.84.165",4791,"46.4.36.120",443,6,366,3,186,3,180,87255.653219,0.9645849999942584,1542.6323237546274,1492.8699907302846
"147.32.84.165",1751,"68.6.19.3",25,3,186,3,186,0,0,87255.688029,9.027832000007038,164.8236254284351,0
"147.32.84.165",4976,"193.23.181.44",179,10,773,5,473,5,300,87255.688087,0.20162900000286754,18767.141631145245,11903.049660345821
"147.32.84.165",4780,"173.241.240.4",80,9,2194,5,1164,4,1030,87255.688141,0.06775099999504164,137444.46577440185,121621.82108903256
"147.32.84.165",1753,"205.188.146.193",25,3,186,3,186,0,0,87255.705877,9.010106000001542,165.1478906019247,0
"147.32.84.165",4980,"174.37.196.55",80,7,569,4,387,3,182,87255.705937,0.24259899999015033,12761.800337700071,6001.67354382794
"147.32.84.165",4783,"217.163.21.41",80,14,6137,7,809,7,5328,87255.82689,0.19020399999863002,34026.62404600647,224096.2335193109
"147.32.84.165",1757,"80.12.242.148",25,3,186,3,186,0,0,87255.872923,8.943337000004249,166.38084866971838,0
"147.32.84.165",4988,"67.19.72.206",80,3,186,3,186,0,0,87256.618029,9.00217700000212,165.29335070835083,0
"147.32.84.165",4789,"217.163.21.40",80,13,6125,7,2887,6,3238,87256.618103,0.16305400000419468,141646.3257534672,158867.6144058631
"147.32.84.165",1758,"64.12.90.33",25,3,186,3,186,0,0,87256.664086,8.956242999993265,166.14109286685488,0
"147.32.84.165",4989,"72.20.15.61",80,9,716,6,534,3,182,87258.485622,9.306152000004658,459.05117388990226,156.45564353550975
"147.32.84.165",4796,"184.82.147.252",80,10,1508,5,596,5,912,87264.8164,0.3234900000097696,14739.250053652366,22554.02021632711
"147.32.84.165",4808,"190.55.176.74",6667,2,124,2,124,0,0,87264.923086,3.0056660000118427,330.0433248391842,0
"147.32.84.165",4804,"46.4.36.120",443,6,366,3,186,3,180,87265.620412,1.0309249999991152,1443.3639692521542,1396.8038412117621
"147.32.84.165",1759,"74.6.136.244",25,3,186,3,186,0,0,87266.651466,8.901444000002812,167.16388936441436,0
"147.32.84.165",4995,"67.19.72.206",80,3,186,3,186,0,0,87267.608456,8.84686900000088,168.19509817539426,0
"147.32.84.165",4798,"217.163.21.41",80,10,1448,5,699,5,749,87267.608517,0.13925799999560695,40155.682260095695,43028.04865924417
"147.32.84.165",4822,"74.125.93.27",25,3,186,3,186,0,0,87267.654584,8.901570999994874,167.16150441319368,0
"147.32.84.165",1760,"205.188.146.193",25,3,186,3,186,0,0,87267.928858,8.928450000006706,166.65826655229995,0
"147.32.84.165",1030,"193.23.181.44",80,8,824,5,438,3,386,87271.841256,0.12951600000087637,27054.572407859185,23842.614039802844
"147.32.84.165",4799,"92.240.244.181",80,10,1760,6,1366,4,394,87271.905051,5.192632000005688,2104.5204050639504,607.0139382102462
"147.32.84.165",4832,"60.243.195.59",6667,2,124,2,124,0,0,87271.913583,2.8366649999952642,349.7064334356211,0
"147.32.84.165",4827,"46.4.36.120",443,6,366,3,186,3,180,87272.44302,1.0311039999942295,1443.1134007901505,1396.5613556033716
"147.32.84.165",1761,"65.54.188.126",25,3,186,3,186,0,0,87273.474334,8.901400000002468,167.16471566265838,0
"147.32.84.165",1031,"193.23.181.44",179,10,728,5,428,5,300,87275.752999,0.19936699999379925,17174.35683993085,12038.100588736577
"147.32.84.165",4801,"173.241.240.4",80,9,2195,5,1165,4,1030,87275.818288,0.06990400000358932,133325.7038155392,117875.94414592735
"147.32.84.165",4842,"46.4.36.120",443,6,366,3,186,3,180,87275.834621,1.0501030000013998,1417.0038558103506,1371.2940540100167
"147.32.84.165",1764,"64.12.90.97",25,3,186,3,186,0,0,87276.355296,9.0299010000017,164.7858597784981,0
"147.32.84.165",1033,"174.37.196.55",80,9,750,5,508,4,242,87276.757233,1.2751240000070538,3187.1410152875474,1518.2837120070599
"147.32.84.165",4819,"184.82.147.251",80,10,1925,5,990,5,935,87276.878445,0.322838000007323,24532.428028362054,23169.51536011972
"147.32.84.165",1765,"65.55.37.104",25,3,186,3,186,0,0,87276.88497,9.001852999994298,165.29930004421783,0
"147.32.84.165",1042,"193.23.181.44",80,8,883,5,497,3,386,87276.985181,0.1335840000101598,29764.043595771975,23116.54090134403
"147.32.84.165",4820,"217.163.21.41",80,14,6141,7,810,7,5331,87277.051484,0.18865999999979977,34347.50344538788,226057.4578609417
"147.32.84.165",1766,"74.6.136.244",25,3,186,3,186,0,0,87277.097276,8.990294000002905,165.51182864537236,0
"147.32.84.165",1044,"67.19.72.206",80,3,186,3,186,0,0,87277.097363,8.99033000000054,165.51116588600314,0
"147.32.84.165",4828,"217.163.21.40",80,11,4012,6,2374,5,1638,87277.559118,0.2346770000003744,80928.2545795698,55838.45029542347
"147.32.84.165",1767,"74.6.136.244",25,3,186,3,186,0,0,87277.605088,8.984147000010125,165.62507269731037,0
"147.32.84.165",1053,"193.23.181.44",179,11,841,5,481,6,360,87277.605159,0.19116800000483636,20128.891864237998,15065.282892153178
"147.32.84.165",4843,"173.192.170.88",80,23,4667,11,885,12,3782,87277.667873,41.69150499999523,169.8187676362561,725.7113889269159
"147.32.84.165",4866,"46.4.36.120",443,6,366,3,186,3,180,87278.261705,1.0306730000011157,1443.7168723721193,1397.1453603601153
"147.32.84.165",1771,"205.188.146.193",25,3,186,3,186,0,0,87279.292631,9.002123999991454,165.29432387305624,0
"147.32.84.165",1058,"174.37.196.55",80,7,594,4,412,3,182,87279.292701,0.24406300000555348,13504.70984919878,5965.672797461597
"147.32.84.165",4856,"184.82.147.252",80,10,1515,5,603,5,912,87279.413943,0.3217059999878984,14995.05759973847,22679.09209114674
"147.32.84.165",1772,"213.4.149.253",25,3,186,3,186,0,0,87279.520057,8.975206999995862,165.7900480736195,0
"147.32.84.165",1063,"174.128.246.102",80,3,186,3,186,0,0,87280.870196,9.029138999991119,164.79976662242808,0
"147.32.84.165",4857,"217.163.21.41",80,10,1451,5,701,5,750,87280.870269,0.1398639999970328,40096.093348674236,42898.815993588694
"147.32.84.165",4873,"46.4.36.120",443,4,246,3,186,1,60,87280.916142,9.021643999993103,164.93667894689014,53.20538030544843
"147.32.84.165",1775,"74.6.136.244",25,3,186,3,186,0,0,87287.592041,9.030901999998605,164.7675946433955,0
"147.32.84.165",1073,"193.23.181.44",179,10,736,5,436,5,300,87288.294633,0.19228400000429247,18139.83482724582,12481.537725169143
"147.32.84.165",4862,"217.163.21.41",80,10,2274,5,1154,5,1120,87288.357173,0.140467000004719,65723.62191610734,63787.22404336241
"147.32.84.165",4882,"186.110.109.63",6667,2,122,1,62,1,60,87288.403367,0.448060999988229,1106.9921283330405,1071.282704838426
"147.32.84.165",1779,"205.188.59.193",25,3,186,3,186,0,0,87288.594954,9.031428999995114,164.7579801602609,0
"147.32.84.165",1078,"72.20.15.61",80,8,684,4,442,4,242,87288.896506,0.3694309999991674,9571.476134942572,5240.491458497969
"147.32.84.165",4878,"217.163.21.40",80,11,4006,6,2376,5,1630,87289.081156,0.23870499999611638,79629.66842047402,54628.09744333866
"147.32.84.165",4925,"74.125.39.27",25,3,186,3,186,0,0,87289.127116,9.00197099999059,165.29713326132193,0
"147.32.84.165",1781,"205.188.146.193",25,3,186,3,186,0,0,87289.93804,8.993398000005982,165.4547035502054,0
"147.32.84.165",1079,"193.23.181.44",179,10,781,5,481,5,300,87294.415552,0.20455699999001808,18811.38264731969,11732.67108980438
"147.32.84.165",4879,"217.163.21.41",80,13,6078,6,750,7,5328,87294.4827,0.18715000001247972,32059.84504194444,227753.1391779733
"147.32.84.165",4954,"59.48.7.162",6667,6,366,3,186,3,180,87294.528635,1.941023999999743,766.6056679362013,741.876452841485
"147.32.84.165",4946,"46.4.36.120",443,3,186,3,186,0,0,87296.46985,8.985119000004488,165.60715556457924,0
"147.32.84.165",1782,"207.115.21.22",25,3,186,3,186,0,0,87297.425201,8.932200999988709,166.58827986538603,0
"147.32.84.165",4977,"208.73.210.29",80,50,36122,22,3323,28,32799,87297.929132,17.365672999992967,1530.8361501457944,15109.80887409928
"147.32.84.165",1093,"174.128.246.102",80,3,186,3,186,0,0,87298.107475,8.852236000006087,168.09312359035354,0
"147.32.84.165",4904,"184.82.147.251",80,10,1929,5,994,5,935,87298.107534,0.3668880000041099,21674.189398156715,20387.69324675707
"147.32.84.165",1784,"74.6.136.244",25,3,186,3,186,0,0,87298.129229,8.929879000002984,166.63159713580697,0
"147.32.84.165",1102,"174.37.196.55",80,7,559,4,377,3,182,87298.129285,0.2436020000022836,12380.850731815532,5976.962422255774
"147.32.84.165",4922,"217.163.21.40",80,13,6125,7,2889,6,3236,87298.226361,0.22200900000461843,104103.88767806352,116607.88526348687
"147.32.84.165",1787,"67.231.152.94",25,3,186,3,186,0,0,87298.250525,8.909434000001056,167.01397642092905,0
"147.32.84.165",1111,"67.19.72.206",80,3,186,3,186,0,0,87298.272509,8.887569999991683,167.4248416610381,0
"147.32.84.165",4935,"217.163.21.41",80,10,2277,5,1156,5,1121,87298.346385,0.15405500000633765,60030.50858212682,58212.975882840976
"147.32.84.165",1792,"199.239.254.18",25,3,186,3,186,0,0,87298.395982,8.864262999995844,167.86505544800482,0
"147.32.84.165",1035,"74.125.232.218",80,8,1908,5,1034,3,874,87300.536524,14.758496000009472,560.4907166688727,473.76101196189046
"147.32.84.165",1117,"193.23.181.44",80,9,929,5,477,4,452,87300.54466,0.13088799999968614,29154.697145721155,27626.673186301807
"147.32.84.165",4975,"217.163.21.41",80,10,1449,5,700,5,749,87300.609669,0.14052499999525025,39850.560399852555,42640.09962784223
"147.32.84.165",1036,"61.17.216.90",6667,2,124,2,124,0,0,87300.655906,2.991198000003351,331.6396975388753,0
"147.32.84.165",1793,"205.188.146.193",25,3,186,3,186,0,0,87308.564181,9.028382000004058,164.81358453810785,0
"147.32.84.165",1038,"94.127.76.180",80,18,6742,10,3793,8,2949,87308.564311,6.730887000012444,4508.172548423989,3505.0358147382926
"147.32.84.165",1119,"67.19.72.206",80,3,186,3,186,0,0,87308.57816,9.014523999998346,165.06695195445405,0
"147.32.84.165",1031,"184.82.147.252",80,10,1515,5,603,5,912,87308.578222,0.32620300000417046,14788.337323502008,22366.440529077667
"147.32.84.165",1794,"65.55.88.22",25,3,186,3,186,0,0,87308.685971,9.007301999998163,165.19930163330858,0
"147.32.84.165",1055,"94.127.76.180",80,8,1420,5,829,3,591,87309.567192,5.728180999998585,1157.7846440260246,825.3929126892407
"147.32.84.165",1122,"174.37.196.55",80,9,727,6,545,3,182,87309.56732,9.271380999998655,470.26435436108517,157.04240824535322
"147.32.84.165",1032,"173.241.240.4",80,9,2194,5,1164,4,1030,87310.069125,0.07144900001003407,130330.72539422878,115327.01645709248
"147.32.84.165",1061,"115.97.135.112",6667,2,124,2,124,0,0,87310.085486,2.992827000009129,331.459185578376,0
"147.32.84.165",1065,"66.111.4.71",25,3,186,3,186,0,0,87310.871672,9.030215000006137,164.7801298196099,0
"147.32.84.165",1795,"74.6.136.244",25,3,186,3,186,0,0,87316.390309,9.029613000006066,164.79111563241972,0
"147.32.84.165",1126,"193.23.181.44",80,8,854,5,468,3,386,87317.492327,0.17369900000630878,21554.528234843132,17777.880125319334
"147.32.84.165",1033,"217.163.21.40",80,13,6129,7,2891,6,3238,87317.563572,0.15947300000698306,145027.68493091158,162435.02034115937
"147.32.84.165",1797,"205.188.59.193",25,3,186,3,186,0,0,87317.609619,9.0138830000069,165.07869028240782,0
"147.32.84.165",1132,"193.23.181.44",179,10,730,5,428,5,302,87318.395105,0.20490099999005906,16710.508978316935,11791.060073485314
"147.32.84.165",1041,"217.163.21.40",80,13,5563,7,2435,6,3128,87318.457796,0.23345899999549147,83440.77546968074,107187.98590109295
"147.32.84.165",1083,"46.4.36.120",443,5,306,3,186,2,120,87318.504004,3.549008000001777,419.27208955270174,270.49812229206566
"147.32.84.165",1798,"205.188.146.193",25,3,186,3,186,0,0,87318.716886,9.010064000001876,165.14866043123448,0
"147.32.84.165",1133,"72.20.15.61",80,7,598,4,416,3,182,87319.199944,0.36578299998654984,9098.290516842973,3980.502101118801
"147.32.84.165",1050,"184.82.147.251",80,10,1930,5,1002,5,928,87319.200076,0.3267950000008568,24529.139062650844,22717.60583846306
"147.32.84.165",1800,"209.85.143.27",25,3,186,3,186,0,0,87319.300367,9.028884999992442,164.8044027586181,0
"147.32.84.165",1144,"174.128.246.102",80,16,1660,11,1352,5,308,87319.308322,45.31209099999978,238.70008559084266,54.37842186536948
"147.32.84.165",1058,"217.163.21.41",80,14,6141,7,810,7,5331,87319.308381,0.18810800000210293,34448.295659554926,226720.81995195962
"147.32.84.165",1801,"64.12.90.33",25,3,186,3,186,0,0,87319.354156,8.975218999999925,165.78982640980823,0
"147.32.84.165",1145,"67.19.72.206",80,3,186,3,186,0,0,87319.382864,8.946559000003617,166.32092852675518,0
"147.32.84.165",1080,"173.241.240.4",80,9,2195,5,1165,4,1030,87322.053253,0.07048599999689031,132224.8389809491,116902.64733937988
"147.32.84.165",1091,"93.115.96.73",6667,2,124,2,124,0,0,87322.069699,2.949133999994956,336.3699309701413,0
"147.32.84.165",1101,"46.4.36.120",443,5,306,3,186,2,120,87326.423075,6.564700999995694,226.6668352451964,146.23666790012672
"147.32.84.165",1804,"205.188.146.193",25,3,186,3,186,0,0,87329.733875,8.931391999998596,166.60336932924162,0
"147.32.84.165",1149,"72.20.15.61",80,7,594,4,412,3,182,87329.734009,0.3663399999932153,8997.106513241913,3974.449964587447
"147.32.84.165",1086,"173.192.170.88",80,3,186,3,186,0,0,87329.917056,8.848769999996875,168.15896446630722,0
"147.32.84.165",1121,"190.72.90.65",6667,2,124,2,124,0,0,87331.940969,3.0113520000013523,329.42014085352844,0
"147.32.84.165",1131,"216.157.130.15",25,3,186,3,186,0,0,87332.988034,8.887054000006174,167.43456267948483,0
"147.32.84.165",1806,"74.6.136.244",25,3,186,3,186,0,0,87336.457645,8.928868999995757,166.6504458740191,0
"147.32.84.165",1150,"67.19.72.206",80,3,186,3,186,0,0,87336.457749,8.928903000007267,166.6498112924722,0
"147.32.84.165",1089,"184.82.147.252",80,10,1508,5,596,5,912,87336.457777,0.34297299999161623,13901.968959995542,21272.811562946197
"147.32.84.165",1138,"46.4.36.120",443,3,186,3,186,0,0,87336.570509,9.016291000007186,165.03460236574153,0
"147.32.84.165",1808,"193.252.22.65",25,3,186,3,186,0,0,87337.360667,9.029381999993348,164.79533150785915,0
"147.32.84.165",1151,"193.23.181.44",80,8,866,5,480,3,386,87338.564874,0.1305819999979576,29406.809514788103,23647.975984808767
"147.32.84.165",1090,"217.163.21.41",80,10,1451,5,701,5,750,87338.629582,0.13888700000825338,40378.14914042887,43200.58752542318
"147.32.84.165",1816,"68.142.202.129",25,3,186,3,186,0,0,87338.675569,9.018418999999994,164.9956605475972,0
"147.32.84.165",1152,"174.128.246.102",80,3,186,3,186,0,0,87339.668335,9.028579000005266,164.8099883712744,0
"147.32.84.165",1114,"184.82.147.251",80,10,1925,5,990,5,935,87339.668467,0.32309299999906216,24513.065897506258,23151.228903200354
"147.32.84.165",1154,"114.58.187.40",6667,2,124,2,124,0,0,87339.775299,3.0030600000027334,330.3297303414174,0
"147.32.84.165",1817,"205.188.146.193",25,3,186,3,186,0,0,87340.270169,9.029123000000254,164.80005865463988,0
"147.32.84.165",1155,"193.23.181.44",80,8,863,5,477,3,386,87340.270301,0.169250999999349,22546.395590068463,18245.09160957322
"147.32.84.165",1140,"217.163.21.41",80,13,6081,6,750,7,5331,87340.270362,0.22133400000166148,27108.352083073365,192686.16660648547
"147.32.84.165",1818,"74.6.136.244",25,3,186,3,186,0,0,87340.316347,8.98308000000543,165.6447454546882,0
"147.32.84.165",1161,"193.23.181.44",80,10,980,6,534,4,446,87340.337039,0.15967999999702442,26753.507014526596,22344.6893791739
"147.32.84.165",1147,"217.163.21.40",80,11,4006,6,2376,5,1630,87340.337098,0.2868190000008326,66271.76023884339,45464.21262176546
"147.32.84.165",1819,"193.252.22.92",25,3,186,3,186,0,0,87340.382942,9.016466000000946,165.03139922003186,0
"147.32.84.165",1172,"72.20.15.61",80,7,597,4,415,3,182,87346.490325,0.37052899999252986,8960.162362640802,3929.5169879533155
"147.32.84.165",1158,"184.82.147.252",80,10,1514,5,603,5,911,87346.675241,0.34118399998988025,14138.998312180767,21360.907897838606
"147.32.84.165",1820,"194.2.0.84",25,3,186,3,186,0,0,87346.787832,8.931689999997616,166.59781071671736,0
"147.32.84.165",1173,"174.37.196.55",80,7,580,4,398,3,182,87350.80382,0.24280999999609776,13113.133726169312,5996.4581360874745
"147.32.84.165",1163,"217.163.21.41",80,10,1451,5,701,5,750,87350.924952,0.13962200000241864,40165.589949312096,42973.17041652507
"147.32.84.165",1187,"190.151.53.33",6667,6,366,3,186,3,180,87350.971137,1.8597529999969993,800.1062506700625,774.2963716161896
"147.32.84.165",1826,"64.12.90.33",25,3,186,3,186,0,0,87352.831198,9.007868999993661,165.18890316911214,0
"147.32.84.165",1176,"174.128.246.102",80,12,1122,8,876,4,246,87353.91381,12.47009600000456,561.9844466311597,157.81755008135306
"147.32.84.165",1164,"217.163.21.41",80,10,2277,5,1156,5,1121,87353.91395,0.14001699999789707,66049.12260753263,64049.36543515924
"147.32.84.165",1833,"74.6.136.244",25,3,186,3,186,0,0,87353.959805,8.982633999999962,165.65296994177947,0
"147.32.84.165",1185,"193.23.181.44",80,10,951,6,505,4,446,87353.959882,0.12691000000631902,31833.58285240598,28114.41178648132
"147.32.84.165",1181,"184.82.147.251",80,10,1929,5,994,5,935,87354.022229,0.3308380000089528,24035.932993745613,22609.25286635025
"147.32.84.165",1834,"65.55.92.152",25,3,186,3,186,0,0,87354.130193,9.013228999989224,165.09066839439885,0
"147.32.84.165",1186,"72.20.15.61",80,7,556,4,374,3,182,87356.521917,0.37044800000148825,8076.707122154742,3930.3761931341255
"147.32.84.165",1191,"173.192.170.88",80,3,186,3,186,0,0,87356.706904,8.944317999994382,166.3626002564907,0
"147.32.84.165",1206,"180.222.136.3",6667,2,124,2,124,0,0,87357.62545,3.009837999998126,329.58584481976027,0
"147.32.84.165",1836,"222.156.254.70",25,3,186,3,186,0,0,87358.427784,9.029146999993827,164.7996206065775,0
"147.32.84.165",1196,"67.19.72.206",80,3,186,3,186,0,0,87359.732664,8.929151000003912,166.64518272782576,0
"147.32.84.165",1193,"217.163.21.40",80,11,4006,6,2376,5,1630,87361.337776,0.7706400000024587,24665.213329102247,16921.00072661476
"147.32.84.165",1216,"46.4.36.120",443,3,186,3,186,0,0,87361.337908,8.930253999991692,166.6245999275479,0
"147.32.84.165",1837,"65.55.92.152",25,3,186,3,186,0,0,87361.383647,8.884646000005887,167.4799423633777,0
"147.32.84.165",1198,"67.19.72.206",80,3,186,3,186,0,0,87361.383703,8.884644999998272,167.47996121401468,0
"147.32.84.165",1194,"217.163.21.41",80,14,6134,7,809,7,5325,87361.383757,0.26791599999705795,24156.82527385849,159005.0612896124
"147.32.84.165",1838,"205.188.59.194",25,3,186,3,186,0,0,87361.429626,8.838757000004989,168.34946361792277,0
"147.32.84.165",1200,"174.128.246.102",80,3,186,3,186,0,0,87361.455667,8.912375999992946,166.9588446449272,0
"147.32.84.165",1201,"217.163.21.40",80,13,6129,7,2891,6,3238,87361.45887,0.20597799999814015,112283.83613885382,125761.003603462
"147.32.84.165",1844,"205.188.146.193",25,3,186,3,186,0,0,87361.46205,8.906117999998969,167.07616045511324,0
"147.32.84.165",1203,"193.23.181.44",179,10,784,5,484,5,300,87367.759164,0.1898700000019744,20392.90040532857,12640.227523963991
"147.32.84.165",1204,"184.82.147.252",80,10,1514,5,603,5,911,87367.822045,0.30503700001281686,15814.474964667592,23892.183570169447
"147.32.84.165",1235,"79.119.209.87",6667,2,124,2,124,0,0,87367.922421,2.9473180000059074,336.57718644476495,0
"147.32.84.165",1845,"149.170.190.144",25,3,186,3,186,0,0,87372.576801,9.030405999990762,164.77664459399966,0
"147.32.84.165",1205,"174.128.246.102",80,3,186,3,186,0,0,87373.779924,9.03066299999773,164.77195528173004,0
"147.32.84.165",1223,"217.163.21.41",80,10,1446,5,698,5,748,87373.78007,0.13981900000362657,39937.34756975207,42798.18908620995
"147.32.84.165",1847,"205.188.59.193",25,3,186,3,186,0,0,87373.826051,8.984655000007479,165.6157081155327,0
"147.32.84.165",1209,"174.128.246.102",80,3,186,3,186,0,0,87375.084121,9.030978999988292,164.76618980089856,0
"147.32.84.165",1224,"173.241.240.4",80,9,2195,5,1165,4,1030,87375.084252,0.07263300000340678,128316.33003679945,113447.05574068964
"147.32.84.165",1848,"207.115.37.22",25,3,186,3,186,0,0,87375.10118,9.014045999996597,165.0757051828404,0
"147.32.84.165",1226,"193.23.181.44",80,8,867,5,481,3,386,87377.593386,0.12605299999995623,30526.841883980043,24497.631948474627
"147.32.84.165",1225,"92.240.244.181",80,10,1760,6,1366,4,394,87377.656114,3.1601150000060443,3458.1019994459375,997.4320554770859
"147.32.84.165",1261,"92.112.3.72",6667,2,124,2,124,0,0,87377.665387,2.9386200000008103,337.57341881554146,0
"147.32.84.165",1849,"210.210.26.203",25,3,186,3,186,0,0,87379.399022,9.031600999995135,164.75484246932538,0
"147.32.84.165",1229,"193.23.181.44",80,8,870,5,484,3,386,87380.70436,0.13016999998944812,29745.717141537018,23722.824001308447
"147.32.84.165",1227,"217.163.21.41",80,10,2277,5,1156,5,1121,87380.768856,0.14099900001019705,65589.11764857329,63603.28796198153
"147.32.84.165",1854,"64.12.90.98",25,3,186,3,186,0,0,87380.816075,9.019763000003877,164.97107518228145,0
"147.32.84.165",1236,"174.128.246.102",80,3,186,3,186,0,0,87382.309715,9.030385999998543,164.77700953206653,0
"147.32.84.165",1228,"184.82.147.251",80,10,1926,5,998,5,928,87382.309813,0.37855199999467004,21090.893721635108,19611.57251871481
"147.32.84.165",1857,"64.12.90.97",25,3,186,3,186,0,0,87382.309848,9.030373999994481,164.77722849584185,0
"147.32.84.165",1240,"193.23.181.44",80,10,1020,6,574,4,446,87382.409873,0.30431900000257883,15089.429184379178,11724.539052670929
"147.32.84.165",1251,"217.163.21.40",80,11,4000,6,2373,5,1627,87382.423942,0.34441800000786316,55119.07043060058,37791.288491608575
"147.32.84.165",1860,"207.115.37.22",25,3,186,3,186,0,0,87382.469789,8.970779000010225,165.87188247512327,0
"147.32.84.165",1241,"174.128.246.102",80,3,186,3,186,0,0,87382.469846,8.970842999988236,165.87069910842843,0
"147.32.84.165",1253,"217.163.21.41",80,14,6137,7,809,7,5328,87382.469899,0.34185599999909755,18931.94795474435,124684.0775066476
"147.32.84.165",1866,"208.65.145.11",25,3,186,3,186,0,0,87382.509795,8.930942999999388,166.61174525468385,0
"147.32.84.165",1249,"193.23.181.44",179,10,728,5,428,5,300,87382.536229,0.3315749999892432,10326.472140876362,7238.1814071563285
"147.32.84.165",1275,"217.163.21.40",80,13,6129,7,2891,6,3238,87382.539392,0.25609999999869615,90308.47325309546,101147.98906728576
"147.32.84.165",1868,"65.55.92.168",25,3,186,3,186,0,0,87382.542595,8.998134999987087,165.3676011753697,0
"147.32.84.165",1250,"193.23.181.44",179,10,727,5,427,5,300,87382.73979,0.19802399999753106,17250.43429100811,12119.743061598205
"147.32.84.165",1280,"184.82.147.252",80,10,1507,5,596,5,911,87382.742989,0.3049519999913173,15635.24751480809,23898.84309729894
"147.32.84.165",1869,"205.188.159.42",25,3,186,3,186,0,0,87382.843744,8.998726000005263,165.35674049850277,0
"147.32.84.165",1252,"174.37.196.55",80,7,604,4,422,3,182,87392.645408,0.2426080000004731,13915.452087290676,6001.450900205931
"147.32.84.165",1281,"217.163.21.41",80,10,2272,5,1153,5,1119,87392.766289,0.1487289999931818,62018.839637346166,60190.010020980364
"147.32.84.165",1297,"219.145.198.122",6667,3,184,2,122,1,62,87392.812135,0.3325440000044182,2934.949961469859,1491.5319476322234
"147.32.84.165",1291,"46.4.36.120",443,4,246,3,186,1,60,87393.647907,6.422812999997404,231.67419010962973,74.73360971278379
"147.32.84.165",1877,"65.54.188.126",25,3,186,3,186,0,0,87394.852585,8.930554999999003,166.61898392654948,0
"147.32.84.165",1330,"98.126.71.122",80,11,4203,7,770,4,3433,87396.156342,16.541201,372.403430681968,1660.3389318586962
"147.32.84.165",1254,"174.128.246.102",80,3,186,3,186,0,0,87396.331647,8.95605799999612,166.14452474522216,0
"147.32.84.165",1285,"173.241.240.4",80,9,2195,5,1165,4,1030,87396.331709,0.06998499999463093,133171.3938803316,117739.51561952065
"147.32.84.165",1326,"27.255.59.70",6667,2,124,2,124,0,0,87396.348138,2.9202649999933783,339.6951988953911,0
"147.32.84.165",1879,"12.102.252.75",25,3,186,3,186,0,0,87400.37177,9.028690999999526,164.80794392011845,0
"147.32.84.165",1332,"95.100.248.96",80,11,4657,6,1399,5,3258,87401.776131,14.33503099999507,780.7447364434614,1818.2032532757664
"147.32.84.165",1257,"174.37.196.55",80,7,594,4,412,3,182,87401.777122,0.24306199999409728,13560.326172252524,5990.241173179513
"147.32.84.165",1286,"92.240.244.181",80,10,1760,6,1366,4,394,87401.898459,10.411458999995375,1049.6127391948482,302.7433523007102
"147.32.84.165",1347,"174.123.157.154",80,9,1294,5,654,4,640,87401.906932,0.47178900000290014,11089.703235912322,10852.30897703958
"147.32.84.165",1881,"61.9.168.122",25,3,186,3,186,0,0,87402.062766,8.943364999999176,166.38032776255213,0
"147.32.84.165",1351,"195.113.232.83",80,8,1274,5,902,3,372,87402.679599,13.431752000004053,537.2344575746948,221.56454347869897
"147.32.84.165",1259,"72.20.15.61",80,10,1425,6,503,4,922,87402.68079,1.5488800000021001,2598.0063013238882,4762.150715349155
"147.32.84.165",1287,"217.163.21.41",80,10,1448,5,699,5,749,87402.863655,0.1400640000065323,39924.60589258625,42780.44322395866
"147.32.84.165",1352,"174.133.57.141",80,9,1177,5,654,4,523,87402.909534,0.5406019999936689,9678.099600188814,7739.520016664755
"147.32.84.165",1896,"61.9.168.122",25,3,186,3,186,0,0,87403.069813,8.939280000005965,166.45635890127696,0
"147.32.84.165",1273,"193.23.181.44",179,10,762,5,462,5,300,87403.069845,0.19667499999923166,18792.424049901812,12202.872759676502
"147.32.84.165",1312,"184.82.147.251",80,10,1910,5,982,5,928,87403.133117,0.3056829999986803,25699.826290745365,24286.597553779735
"147.32.84.165",1903,"61.9.189.122",25,3,186,3,186,0,0,87403.234495,8.975067000006675,165.79263419413954,0
"147.32.84.165",1282,"67.19.72.206",80,3,186,3,186,0,0,87403.28177,9.031365999995614,164.75912946067322,0
"147.32.84.165",1316,"217.163.21.40",80,4,244,3,182,1,62,87403.381255,0.04810600000200793,30266.494822667173,10310.564170359146
"147.32.84.165",1913,"65.55.92.168",25,3,186,3,186,0,0,87403.428963,8.981532000005245,165.67329493444225,0
"147.32.84.165",1294,"67.19.72.206",80,3,186,3,186,0,0,87403.429011,8.981606999994256,165.67191149656756,0
"147.32.84.165",1317,"217.163.21.41",80,14,6137,7,809,7,5328,87403.429078,0.18838900000264402,34354.4474460248,226255.24844551313
"147.32.84.165",1916,"65.55.37.104",25,3,186,3,186,0,0,87403.474946,8.935719999994035,166.52267528537078,0
"147.32.84.165",1295,"67.19.72.206",80,3,186,3,186,0,0,87403.481944,9.028898999997182,164.8041472166722,0
"147.32.84.165",1355,"217.163.21.40",80,11,4002,6,2374,5,1628,87403.482068,0.23009599999932107,82539.46179010517,56602.46158142006
"147.32.84.165",1918,"98.139.175.224",25,3,186,3,186,0,0,87403.528115,8.98282800000743,165.64939237384587,0
"147.32.84.165",1310,"67.19.72.206",80,3,186,3,186,0,0,87403.783281,9.028390999999829,164.81342024287918,0
"147.32.84.165",1358,"184.82.147.252",80,10,1507,5,596,5,911,87403.783336,0.34068500000284985,13995.332932063682,21392.195136090628
"147.32.84.165",1921,"65.55.37.104",25,3,186,3,186,0,0,87403.896044,9.01688200001081,165.0237853837076,0
"147.32.84.165",1311,"174.128.246.102",80,3,186,3,186,0,0,87403.896074,9.0169109999988,165.02325463789074,0
"147.32.84.165",1360,"217.163.21.41",80,10,1448,5,699,5,749,87403.896098,0.13938999999663793,40117.65549992739,42987.30181608815
"147.32.84.165",1927,"98.139.175.224",25,3,186,3,186,0,0,87403.941974,8.971032000001287,165.8672045757708,0
"147.32.84.165",1318,"193.23.181.44",179,10,810,5,510,5,300,87403.942035,0.19394300000567455,21037.108840641962,12374.769906259977
"147.32.84.165",1361,"217.163.21.41",80,10,2274,5,1154,5,1120,87404.006756,0.1398709999921266,66003.67481836602,64059.02582025125
"147.32.84.165",1930,"162.39.147.49",25,3,186,3,186,0,0,87404.006787,9.005413999999291,165.2339359412146,0
"147.32.84.165",1322,"174.37.196.55",80,8,661,5,479,3,182,87412.109313,1.2349749999993946,3102.8968197752006,1178.9712342360888
"147.32.84.165",1362,"217.163.21.40",80,13,5555,7,2434,6,3121,87412.230492,0.26212899999518413,74284.03572423403,95250.81162503468
"147.32.84.165",1369,"59.113.50.63",6667,2,122,1,62,1,60,87412.276314,0.351477000003797,1411.1876452645315,1365.665463159224
"147.32.84.165",1931,"65.55.92.184",25,3,186,3,186,0,0,87412.71121,9.030094000001554,164.7823378139523,0
"147.32.84.165",1328,"67.19.72.206",80,5,306,3,186,2,120,87415.82148,3.7760620000044582,394.0613263230962,254.23311375683625
"147.32.84.165",1364,"217.163.21.41",80,14,6137,7,809,7,5328,87415.82158,0.20030399999814108,32310.887451374227,212796.54924712222
"147.32.84.165",1394,"58.215.78.1",6667,10,1127,5,569,5,558,87415.867447,1.714071000009426,2655.665955479655,2604.326191841208
"147.32.84.165",1390,"46.4.36.120",443,4,246,3,186,1,60,87416.202541,6.54172799999651,227.4628355078037,73.37510822832378
"147.32.84.165",1936,"98.139.175.224",25,3,186,3,186,0,0,87421.440052,9.029007999997702,164.80215766786102,0
"147.32.84.165",1334,"193.23.181.44",80,8,875,5,489,3,386,87421.440183,0.1705670000083046,22935.26883752151,18104.322640661154
"147.32.84.165",1365,"217.163.21.40",80,13,6125,7,2889,6,3236,87421.507879,0.16680800000904128,138554.50577158944,155196.39344993542
"147.32.84.165",1406,"77.127.115.2",6667,2,124,2,124,0,0,87421.554328,2.995557000002009,331.15711034686865,0
"147.32.84.165",1942,"65.55.92.184",25,3,186,3,186,0,0,87422.744154,8.92890100000659,166.6498486206647,0
"147.32.84.165",1336,"31.192.109.161",80,10,1174,5,540,5,634,87422.744241,0.2396300000109477,18027.792846482647,21165.964193833333
"147.32.84.165",1379,"184.82.147.251",80,10,1910,5,982,5,928,87422.822786,0.32301799999549985,24320.626095479034,22983.239324444545
"147.32.84.165",1945,"98.139.175.224",25,3,186,3,186,0,0,87422.929268,8.843794999993406,168.25356083006326,0
"147.32.84.165",1340,"174.128.246.102",80,16,2044,12,1796,4,248,87422.929329,93.11291999999958,154.307264770561,21.307461950500628
"147.32.84.165",1396,"217.163.21.41",80,10,1448,5,699,5,749,87422.929378,0.14037599999574013,39835.86938058995,42685.35932197693
"147.32.84.165",1946,"81.80.40.173",25,3,186,3,186,0,0,87422.975801,8.897527000008267,167.23748070656234,0
"147.32.84.165",1341,"67.19.72.206",80,3,186,3,186,0,0,87423.045304,8.928813999998965,166.6514724128168,0
"147.32.84.165",1407,"173.192.170.88",80,15,1704,9,1085,6,619,87423.045392,72.4396490000072,119.82388263641556,68.3603533197615
"147.32.84.165",1949,"65.54.188.110",25,3,186,3,186,0,0,87423.2472,8.927412999997614,166.67762542187728,0
"147.32.84.165",1346,"193.23.181.44",80,8,882,5,496,3,386,87424.249118,0.2042339999898104,19428.694537628264,15119.9114748478
"147.32.84.165",1413,"173.241.240.4",80,9,2194,5,1164,4,1030,87424.31575,0.13440300000365824,69284.1677622266,61308.15532224519
"147.32.84.165",1951,"98.139.175.224",25,3,186,3,186,0,0,87424.332333,8.84511900000507,168.22837544629382,0
"147.32.84.165",1353,"67.19.72.206",80,3,186,3,186,0,0,87424.332363,8.845152000008966,168.2277478101554,0
"147.32.84.165",1417,"217.163.21.40",80,13,5559,7,2434,6,3125,87424.332386,0.2741190000087954,71034.84252961384,91201.2666002643
"147.32.84.165",1954,"65.55.37.104",25,3,186,3,186,0,0,87424.349889,8.928199000001769,166.66295184501433,0
"147.32.84.165",1372,"174.128.246.102",80,3,186,3,186,0,0,87424.349948,8.928199999994831,166.6629331781167,0
"147.32.84.165",1419,"184.82.147.252",80,10,1508,5,596,5,912,87424.349975,0.3613530000002356,13194.853785624835,20190.782973976256
"147.32.84.165",1961,"98.139.175.224",25,3,186,3,186,0,0,87424.378958,8.899210999996285,167.20583431504446,0
"147.32.84.165",1381,"193.23.181.44",80,10,943,6,497,4,446,87424.379003,0.15219200000865385,26124.894868152853,23444.070646269964
"147.32.84.165",1963,"74.6.136.65",25,3,186,3,186,0,0,87424.379036,8.899160000000848,167.20679255119114,0
"147.32.84.165",1383,"193.23.181.44",80,9,942,5,490,4,452,87424.476152,0.13129099999787286,29857.339802907365,27541.87263451863
"147.32.84.165",1965,"207.115.21.22",25,3,186,3,186,0,0,87424.479382,8.89862500000163,167.21684529910266,0
"147.32.84.165",1385,"174.128.246.102",80,8,665,6,543,2,122,87424.485779,9.239388000001782,470.16101066425205,105.63470221185773
"147.32.84.165",1971,"194.71.21.134",25,3,186,3,186,0,0,87424.489027,8.889068999997107,167.3966081262823,0
"147.32.84.165",1393,"174.128.246.102",80,18,2042,14,1794,4,248,87424.549954,309.08608500000264,46.43366588308198,6.418923711819582
"147.32.84.165",1972,"98.139.175.224",25,3,186,3,186,0,0,87424.549982,8.928702000004705,166.65356285820894,0
"147.32.84.165",1397,"72.20.15.61",80,7,634,4,452,3,182,87425.051699,0.3660620000009658,9878.108080025951,3977.4682977095645
"147.32.84.165",1424,"217.163.21.41",80,13,6081,6,750,7,5331,87425.234654,0.18718199999420904,32054.364202677745,227842.42075263342
"147.32.84.165",1978,"194.42.191.233",25,3,186,3,186,0,0,87425.281108,8.899587000007159,167.19877001020419,0
"147.32.84.165",1400,"72.20.15.61",80,7,573,4,391,3,182,87433.679711,0.3909389999898849,8001.248276792373,3724.366205565759
"147.32.84.165",1425,"217.163.21.41",80,10,1451,5,701,5,750,87433.865769,0.14136000000871718,39671.76004282806,42444.821729131305
"147.32.84.165",1435,"80.191.187.36",6667,4,244,2,124,2,120,87433.913323,6.232055999993463,159.17700354442266,154.04226149460257
"147.32.84.165",1984,"64.12.90.34",25,3,186,3,186,0,0,87434.682382,9.029064000002109,164.801135532947,0
"147.32.84.165",1405,"174.128.246.102",80,6,511,4,389,2,122,87436.789155,0.3426309999922523,9082.657436339296,2848.5455198801906
"147.32.84.165",1437,"184.82.147.251",80,10,1910,5,982,5,928,87436.789217,0.32352600000740495,24282.43788697103,22947.151078522522
"147.32.84.165",1442,"46.4.36.120",443,3,186,3,186,0,0,87436.89565,9.02327599999262,164.90684757966142,0
"147.32.84.165",1985,"205.188.146.193",25,3,186,3,186,0,0,87443.912077,9.0284629999951,164.81210589231054,0
"147.32.84.165",1408,"174.37.196.55",80,7,600,4,418,3,182,87444.213065,0.24223499999789055,13804.776353661198,6010.692096570187
"147.32.84.165",1441,"217.163.21.40",80,13,5562,7,2436,6,3126,87444.334151,0.24215799999365117,80476.38318994595,103271.41783734443
"147.32.84.165",1452,"217.19.6.21",6667,1,62,1,62,0,0,87444.379941,0,0,0
"147.32.84.165",1986,"74.6.136.65",25,3,186,3,186,0,0,87445.316496,9.028405000004568,164.81316467296793,0
"147.32.84.165",1416,"174.37.196.55",80,7,618,4,436,3,182,87445.416986,0.24317899999732617,14343.343792179225,5987.359105909676
"147.32.84.165",1449,"184.82.147.252",80,10,1508,5,596,5,912,87445.417051,0.3390769999969052,14061.702799197581,21517.236498100996
"147.32.84.165",1987,"205.188.156.193",25,3,186,3,186,0,0,87445.516945,9.028604999999516,164.80951376210166,0
"147.32.84.165",1418,"174.37.196.55",80,7,546,4,364,3,182,87445.529432,0.24253600000520237,12006.465019368416,6003.232509684208
"147.32.84.165",1465,"184.82.147.251",80,10,1925,5,990,5,935,87445.529463,0.3230210000037914,24518.529754743624,23156.38921281342
"147.32.84.165",1989,"98.139.175.224",25,3,186,3,186,0,0,87445.538667,9.00694300000032,165.20588617025192,0
"147.32.84.165",1423,"193.23.181.44",80,8,863,5,477,3,386,87445.636028,0.1314330000022892,29033.80429521913,23494.86049885657
"147.32.84.165",1466,"217.163.21.41",80,14,6141,7,810,7,5331,87445.700796,0.18699799999012612,34652.777036878244,228066.61035012087
"147.32.84.165",1990,"207.115.21.22",25,3,186,3,186,0,0,87445.74652,9.000073999995948,165.33197393717762,0
"147.32.84.165",1427,"174.128.246.102",80,3,186,3,186,0,0,87446.219426,9.028728000004776,164.80726853209146,0
"147.32.84.165",1468,"184.82.147.252",80,10,1515,5,603,5,912,87446.219488,0.32179099999484606,14991.096705865804,22673.10148548858
"147.32.84.165",1991,"192.135.120.61",25,3,186,3,186,0,0,87446.325844,9.022600999989663,164.91918461225367,0
"147.32.84.165",1428,"67.19.72.206",80,4,246,3,186,1,60,87446.821504,9.188232000000426,161.946280851412,52.24073575852
"147.32.84.165",1469,"217.163.21.41",80,10,1451,5,701,5,750,87455.749649,0.13859499999671243,40463.22017484776,43291.605037283625
"147.32.84.165",1474,"89.228.163.103",6667,1,62,1,62,0,0,87455.795375,0,0,0
"147.32.84.165",1993,"209.85.227.27",25,3,186,3,186,0,0,87456.009863,8.868786999999429,167.7794268821763,0
"147.32.84.165",1445,"174.128.246.102",80,6,541,4,419,2,122,87456.852976,0.35674200000357814,9396.146234439397,2735.870741292617
"147.32.84.165",1471,"217.163.21.41",80,14,6141,7,810,7,5331,87456.853044,0.18732499999168795,34592.286135259754,227668.49060132066
"147.32.84.165",1994,"64.12.138.161",25,3,186,3,186,0,0,87456.898893,8.882856999989599,167.51367268455886,0
"147.32.84.165",1457,"174.128.246.102",80,3,186,3,186,0,0,87457.95687,8.928332000010414,166.6604691669468,0
"147.32.84.165",1484,"184.82.147.251",80,10,1925,5,990,5,935,87457.956937,0.34044600000197534,23263.6012758383,21971.178982736175
"147.32.84.165",1995,"200.143.5.118",25,3,186,3,186,0,0,87458.069415,8.916000999990501,166.89096378539944,0
"147.32.84.165",1470,"72.20.15.61",80,7,565,4,383,3,182,87464.878722,0.3693410000123549,8295.856674177807,3942.156435248984
"147.32.84.165",1486,"217.163.21.40",80,13,5683,7,2436,6,3247,87465.063036,0.27815600000030827,70061.40439170251,93386.44501636208
"147.32.84.165",1499,"89.46.59.46",6667,1,62,1,62,0,0,87465.108926,0,0,0
"147.32.84.165",1496,"46.4.36.120",443,5,306,3,186,2,120,87466.283145,3.5509040000033565,419.0482198332012,270.35369021496854
"147.32.84.165",1996,"64.12.90.98",25,3,186,3,186,0,0,87466.484218,9.028527999995276,164.8109193437489,0
"147.32.84.165",1477,"72.20.15.61",80,11,1476,6,494,5,982,87466.484283,0.9171920000080718,4308.8033911822395,8565.273137937163
"147.32.84.165",1489,"217.163.21.41",80,10,1451,5,701,5,750,87466.666943,0.13977199999499135,40122.48519160461,42927.05263010479
"147.32.84.165",1997,"64.182.71.51",25,3,186,3,186,0,0,87466.68473,9.028838000012911,164.80526065456843,0
"147.32.84.165",1481,"67.19.72.206",80,3,186,3,186,0,0,87466.713456,9.00017700000899,165.33008184155867,0
"147.32.84.165",1490,"184.82.147.252",80,10,1514,5,603,5,911,87466.885143,0.3578519999864511,13480.433252245746,20365.96134792019
"147.32.84.165",2001,"98.139.175.224",25,3,186,3,186,0,0,87467.003729,9.010597000000416,165.13889146301085,0
"147.32.84.165",1487,"193.23.181.44",179,10,729,5,429,5,300,87467.286551,0.19734800000151154,17390.599347212607,12161.25828476406
"147.32.84.165",1504,"195.113.232.88",80,31,33441,21,2004,10,31437,87467.351582,69.70368900000176,230.00217391649954,3608.0730246571834
"147.32.84.165",2002,"85.158.228.111",25,3,186,3,186,0,0,87467.353006,8.962115999995149,166.03221828425401,0
"147.32.84.165",1488,"193.23.181.44",179,10,751,5,451,5,300,87469.834196,0.19433900000876747,18565.496374053728,12349.554129082302
"147.32.84.165",1506,"184.82.147.251",80,10,1926,5,998,5,928,87469.899523,0.34045899999910034,23450.694503658582,21805.856211818802
"147.32.84.165",2004,"207.115.21.22",25,3,186,3,186,0,0,87470.011652,9.01229699999385,165.1077411231582,0
"147.32.84.165",1514,"174.128.246.102",80,18,1859,13,1551,5,308,87476.917395,189.3751440000051,65.52074225749324,13.011211228438373
"147.32.84.165",1509,"217.163.21.40",80,13,5559,7,2441,6,3118,87476.917458,0.24719700000423472,78997.72246291608,100907.37346963226
"147.32.84.165",1526,"178.125.53.75",6667,1,62,1,62,0,0,87476.917492,0,0,0
"147.32.84.165",1532,"46.4.36.120",443,3,186,3,186,0,0,87476.963201,8.98274500000116,165.6509229639501,0
"147.32.84.165",1536,"173.192.170.88",80,9,1320,7,1196,2,124,87477.82009,12.1773710000125,785.7196762741464,81.46257513210215
"147.32.84.165",2005,"168.95.5.30",25,3,186,3,186,0,0,87477.820155,9.028549000009662,164.8105360006805,0
"147.32.84.165",1515,"72.20.15.61",80,7,597,4,415,3,182,87479.024021,0.36599500000011176,9071.162174343874,3978.196423447193
"147.32.84.165",1519,"217.163.21.41",80,14,6134,7,809,7,5325,87479.207014,0.1872319999965839,34566.740728711346,227525.2093700716
"147.32.84.165",1545,"94.100.176.20",25,3,186,3,186,0,0,87479.252899,9.00037500000326,165.32644473140965,0
"147.32.84.165",2008,"205.188.156.193",25,3,186,3,186,0,0,87486.949007,8.928925000000163,166.64940068372988,0
"147.32.84.165",1516,"193.23.181.44",80,9,933,5,481,4,452,87487.55135,0.1492490000091493,25782.41730104797,24227.96802510121
"147.32.84.165",1527,"184.82.147.252",80,10,1508,5,596,5,912,87487.618198,0.32166899999720044,14822.690405483578,22681.7007546997
"147.32.84.165",1559,"190.77.235.75",6667,3,186,3,186,0,0,87487.724782,8.855289999992237,168.03515186982068,0
"147.32.84.165",2009,"209.85.227.27",25,3,186,3,186,0,0,87487.752326,8.927922000002582,166.66812277252978,0
"147.32.84.165",1518,"174.128.246.102",80,3,186,3,186,0,0,87487.752395,8.927920000001905,166.668160108926,0
"147.32.84.165",1553,"184.82.147.251",80,10,1925,5,990,5,935,87487.752422,0.3076569999975618,25742.954004175972,24312.78989283286
"147.32.84.165",2011,"205.188.146.194",25,3,186,3,186,0,0,87487.85411,8.926256000006106,166.6992297777458,0
"147.32.84.165",1520,"174.37.196.55",80,8,619,5,437,3,182,87488.052696,0.24589099999866448,14217.681818443896,5921.322862601348
"147.32.84.165",1555,"217.163.21.41",80,10,1446,5,698,5,748,87488.175408,0.1394600000057835,40040.15488146011,42908.36081852746
"147.32.84.165",2013,"74.6.136.65",25,3,186,3,186,0,0,87488.221155,8.860783999989508,167.93096412256094,0
"147.32.84.165",1523,"193.23.181.44",179,10,745,5,445,5,300,87488.353967,0.18582299999252427,19158.01596219639,12915.516379008803
"147.32.84.165",1575,"217.163.21.41",80,13,6081,6,750,7,5331,87488.414908,0.18620899999223184,32221.8582359086,229032.96834083833
"147.32.84.165",2014,"205.188.146.193",25,3,186,3,186,0,0,87488.460675,8.921767000007094,166.78310473685502,0
"147.32.84.165",1528,"72.20.15.61",80,8,662,4,420,4,242,87491.062064,0.3710350000037579,9055.749457506621,5217.836592182387
"147.32.84.165",1576,"184.82.147.252",80,10,1325,5,603,5,722,87491.24701,0.3054569999949308,15792.730237251255,18909.371859528037
"147.32.84.165",1582,"94.52.57.11",6667,2,124,2,124,0,0,87491.347494,2.8251750000054017,351.1286911423552,0
"147.32.84.165",2016,"98.139.175.224",25,3,186,3,186,0,0,87497.883794,9.029059000007692,164.80122679436832,0
"147.32.84.165",1529,"174.128.246.102",80,12,1120,8,874,4,246,87498.787444,12.449857999992673,561.6128312470805,158.07409209013935
"147.32.84.165",1577,"217.163.21.40",80,13,5563,7,2438,6,3125,87498.78751,0.3053680000011809,63870.47758745047,81868.43415126445
"147.32.84.165",2017,"216.178.72.158",25,3,186,3,186,0,0,87498.833984,8.981889000002411,165.66670997599732,0
"147.32.84.165",1530,"67.19.72.206",80,3,186,3,186,0,0,87500.191619,9.028749999997672,164.8068669528322,0
"147.32.84.165",1578,"217.163.21.41",80,10,1451,5,701,5,750,87507.013408,0.13971800000581425,40137.992239844745,42943.64362322904
"147.32.84.165",1589,"212.117.171.138",65500,33,10358,16,5712,17,4646,87507.059375,24.934471000000485,1832.643652235458,1490.6271723189666
"147.32.84.165",1606,"46.4.36.120",443,4,246,3,186,1,60,87507.059407,9.02099800000724,164.94849017800536,53.20919038000173
"147.32.84.165",2018,"76.96.62.116",25,3,186,3,186,0,0,87507.916147,9.028604000006453,164.80953201612746,0
"147.32.84.165",1531,"174.128.246.102",80,3,186,3,186,0,0,87508.618117,9.028810999996495,164.80575349296578,0
"147.32.84.165",1586,"217.163.21.40",80,16,7474,8,2402,8,5072,87508.618188,0.21562200000334997,89118.92107345937,188181.1688944987
"147.32.84.165",1607,"74.125.47.104",443,17,4437,9,1469,8,2968,87508.664103,1.1286660000041593,10412.2920332115,21037.224475542367
"147.32.84.165",1609,"74.125.93.27",25,3,186,3,186,0,0,87508.718994,9.028730999998515,164.8072137712647,0
"147.32.84.165",2019,"64.12.90.33",25,3,186,3,186,0,0,87508.775613,8.972177999996347,165.8460186590821,0
"147.32.84.165",1542,"174.128.246.102",80,18,1988,12,1620,6,368,87508.818579,138.2517119999975,93.74205796453526,21.294492179598134
"147.32.84.165",1599,"173.192.170.88",80,15,3207,9,906,6,2301,87508.818643,11.399762999993982,635.8026916878733,1614.7704123331089
"147.32.84.165",1610,"190.122.143.202",6667,3,186,3,186,0,0,87509.11986,9.02920499999891,164.79856199966437,0
"147.32.84.165",2022,"209.85.227.27",25,3,186,3,186,0,0,87509.42117,9.02850000000035,164.8114304701714,0
"147.32.84.165",1543,"193.23.181.44",80,8,864,5,478,3,386,87512.029352,0.14647700000205077,26106.487707602297,21081.80806513491
"147.32.84.165",1600,"184.82.147.251",80,10,1905,5,990,5,915,87512.095684,0.3225550000061048,24553.952038722397,22693.804157001003
"147.32.84.165",1625,"61.17.216.11",6667,2,124,2,124,0,0,87512.201867,2.9373020000057295,337.72489175374716,0
"147.32.84.165",2024,"64.12.90.66",25,3,186,3,186,0,0,87516.080589,8.890013999989606,167.3788140268103,0
"147.32.84.165",1544,"72.20.15.61",80,8,617,4,375,4,242,87518.951348,0.3739039999927627,8023.449869640518,5177.799649208014
"147.32.84.165",1618,"217.163.21.40",80,11,4011,6,2381,5,1630,87519.136104,0.3220349999901373,59148.85028206054,40492.49305323759
"147.32.84.165",1642,"46.4.36.120",443,4,246,3,186,1,60,87519.182243,8.942620999994688,166.3941701209169,53.67553874868287
"147.32.84.165",2027,"64.12.90.98",25,3,186,3,186,0,0,87519.854299,8.928188999998383,166.66313851557908,0
"147.32.84.165",1558,"67.19.72.206",80,3,186,3,186,0,0,87521.259143,8.92841700000281,166.65888253197983,0
"147.32.84.165",1621,"217.163.21.40",80,11,3958,6,2334,5,1624,87527.077403,0.2589239999942947,72113.82490773906,50176.88588267705
"147.32.84.165",1627,"212.117.171.138",65500,211,169712,126,163154,85,6558,87527.124148,182.6805480000039,7144.8876976216,287.189854499445
"147.32.84.165",2032,"77.95.34.201",25,3,186,3,186,0,0,87527.124184,8.982143000001088,165.66202519819822,0
"147.32.84.165",1564,"72.20.15.61",80,7,566,4,384,3,182,87528.125006,0.3712649999943096,8274.413155150862,3921.72706832671
"147.32.84.165",1629,"184.82.147.252",80,10,1476,5,588,5,888,87528.310303,0.3235889999923529,14536.958920455161,21953.77469619759
"147.32.84.165",1654,"65.55.196.251",443,24,9798,14,4450,10,5348,87528.417183,3.6538520000030985,9743.14230570089,11709.28652828952
"147.32.84.165",2034,"98.139.175.224",25,3,186,3,186,0,0,87528.51865,8.991775999995298,165.48454943726114,0
"147.32.84.165",1565,"174.128.246.102",80,18,2078,14,1830,4,248,87528.909823,309.0632680000126,47.36894194750896,6.419397597258044
"147.32.84.165",1653,"217.163.21.41",80,10,2277,5,1156,5,1121,87528.913022,0.13950000000477303,66293.90680776758,64286.7383490549
"147.32.84.165",1655,"202.106.32.73",6667,3,186,3,186,0,0,87528.958854,8.953229000006104,166.197022325575,0
"147.32.84.165",1674,"46.4.36.120",443,5,306,3,186,2,120,87529.685506,1.0033200000034412,1483.0761870538774,956.8233464863725
"147.32.84.165",2035,"74.6.136.65",25,3,186,3,186,0,0,87529.685572,9.029073999990942,164.80095301040757,0
"147.32.84.165",1579,"174.128.246.102",80,9,818,6,634,3,184,87530.087475,3.280129000006127,1546.2806493252326,448.7628382899729
"147.32.84.165",1656,"184.82.147.251",80,10,1930,5,1002,5,928,87530.087502,0.3229460000002291,24821.487183598227,22988.363379619914
"147.32.84.165",1677,"74.125.39.27",25,3,186,3,186,0,0,87530.193942,9.022007999999914,164.93002444688744,0
"147.32.84.165",2036,"68.6.19.3",25,3,186,3,186,0,0,87530.387566,9.029188000000431,164.79887227953708,0
"147.32.84.165",1580,"174.128.246.102",80,3,186,3,186,0,0,87537.00888,9.028785000002244,164.8062280804815,0
"147.32.84.165",1668,"217.163.21.40",80,13,5671,7,2849,6,2822,87537.008943,0.19171800000185613,118882.94265420742,117756.28788001872
"147.32.84.165",1682,"202.86.18.246",6667,1,62,1,62,0,0,87537.05483,0,0,0
"147.32.84.165",2039,"209.85.143.27",25,3,186,3,186,0,0,87540.821055,9.028605000014068,164.80951376183603,0
"147.32.84.165",1592,"193.23.181.44",80,8,900,5,514,3,386,87542.225684,0.14108699999633245,29145.137398249954,21887.204349658525
"147.32.84.165",1673,"217.163.21.40",80,16,7838,8,2474,8,5364,87542.288579,0.19628699999884702,100831.94506063192,218618.65533760292
"147.32.84.165",1705,"217.219.211.243",6667,2,124,2,124,0,0,87542.334369,3.0007709999918006,330.5817071688278,0
"147.32.84.165",2041,"205.188.59.193",25,3,186,3,186,0,0,87542.726981,9.028724999996484,164.80732329322018,0
"147.32.84.165",1593,"72.20.15.61",80,9,719,5,477,4,242,87547.141085,3.376568000006955,1130.1416112431734,573.3632493099539
"147.32.84.165",1683,"184.82.147.252",80,10,1508,5,596,5,912,87548.144215,0.3564030000125058,13378.114100702564,20471.2081540952
"147.32.84.165",1720,"46.4.36.120",443,3,186,3,186,0,0,87548.256383,8.916654999993625,166.87872301900924,0
"147.32.84.165",2044,"64.12.90.1",25,3,186,3,186,0,0,87549.548813,8.928421000004164,166.65880786751723,0
"147.32.84.165",1594,"193.23.181.44",179,10,778,5,478,5,300,87549.950269,0.24549700001080055,15576.565089723152,9776.086876395284
"147.32.84.165",1697,"217.163.21.40",80,13,6134,7,2896,6,3238,87550.013144,0.18949800000700634,122259.86553495766,136698.01263887875
"147.32.84.165",2045,"64.12.90.34",25,3,186,3,186,0,0,87550.060779,8.91826599999331,166.84857796359924,0
"147.32.84.165",1597,"193.23.181.44",80,8,810,5,424,3,386,87550.333685,0.14238900000054855,23822.06490660748,21687.06852346813
"147.32.84.165",1698,"216.137.61.189",80,14,12556,9,1828,5,10728,87550.404243,61.05291300000681,239.52993037364766,1405.7314513394379
"147.32.84.165",1738,"196.2.13.199",6667,2,124,2,124,0,0,87550.42615,2.934869000004255,338.00486495259645,0
"147.32.84.165",2046,"208.77.218.115",25,3,186,3,186,0,0,87550.752561,8.928805999996257,166.6516217286638,0
"147.32.84.165",1601,"174.128.246.102",80,8,665,6,543,2,122,87551.254455,9.271485999997822,468.5333073901013,105.26899355726033
"147.32.84.165",1704,"184.82.147.251",80,10,1925,5,990,5,935,87551.254486,0.32280599999648985,24534.859947107925,23171.812172268597
"147.32.84.165",1745,"66.111.4.71",25,3,186,3,186,0,0,87551.361191,8.922039999990375,166.77800144379594,0
"147.32.84.165",2047,"204.94.92.91",25,3,186,3,186,0,0,87551.454897,8.928529999990133,166.65677328761222,0
"147.32.84.165",1602,"193.23.181.44",179,10,828,5,528,5,300,87557.172977,0.203934000004665,20712.583482417722,11768.513342282797
"147.32.84.165",1713,"217.163.21.40",80,13,5380,7,2431,6,2949,87557.23481,0.2727569999988191,71301.56146344256,86494.57209201649
"147.32.84.165",2050,"209.85.227.27",25,3,186,3,186,0,0,87557.282272,9.020241000005626,164.9623330462093,0
"147.32.84.165",1603,"67.19.72.206",80,3,186,3,186,0,0,87561.787799,9.02909599999839,164.80055146165967,0
"147.32.84.165",1731,"217.163.21.41",80,14,6141,7,810,7,5331,87563.694075,0.1935069999890402,33487.16067308683,220395.1278373159
"147.32.84.165",1769,"213.33.174.74",6667,6,366,3,186,3,180,87563.740767,1.126577000002726,1320.8151772993763,1278.2082360961706
"147.32.84.165",2051,"85.248.69.94",25,3,186,3,186,0,0,87564.8675,8.958967000013217,166.0905771834861,0
"147.32.84.165",1604,"193.23.181.44",80,8,863,5,477,3,386,87567.205582,0.12984500000311527,29388.88674888094,23782.201855488558
"147.32.84.165",1736,"173.241.240.4",80,4,242,3,182,1,60,87567.270111,0.019652999995741993,74085.38138276375,24423.75210420783
"147.32.84.165",2052,"98.139.175.224",25,3,186,3,186,0,0,87567.289618,8.944295000008424,166.36302805292073,0
"147.32.84.165",1616,"174.37.196.55",80,7,424,4,242,3,182,87569.211499,1.0135910000099102,1910.040637674438,1436.4768432097012
"147.32.84.165",1746,"184.82.147.252",80,10,1514,5,603,5,911,87569.332542,0.3509889999986626,13744.02046793028,20764.183493009095
"147.32.84.165",1812,"119.154.131.100",6667,2,124,2,124,0,0,87569.446969,2.974881000001915,333.4587164997059,0
"147.32.84.165",1827,"46.4.36.120",443,3,186,3,186,0,0,87570.515509,9.029148000001442,164.79960235448155,0
"147.32.84.165",2053,"216.17.3.48",25,3,186,3,186,0,0,87571.017507,9.028721000009682,164.8073963076724,0
"147.32.84.165",1617,"174.128.246.102",80,11,668,7,422,4,246,87571.720143,9.299253999997745,363.03987395126734,211.62987912798997
"147.32.84.165",1759,"195.113.232.88",80,24,30320,17,1710,7,28610,87571.721052,61.401949000006425,222.79423084760012,3727.5689734209586
"147.32.84.165",2055,"205.178.149.7",25,3,186,3,186,0,0,87571.721912,9.026556000011624,164.84692500640153,0
"147.32.84.165",1620,"193.23.181.44",80,6,364,4,242,2,122,87572.321636,0.12593500000366475,15373.009885604968,7750.029777040521
"147.32.84.165",1768,"184.82.147.251",80,10,1930,5,1002,5,928,87572.383878,0.32615000000805594,24577.648320717475,22762.53257647287
"147.32.84.165",1839,"216.157.130.15",25,3,186,3,186,0,0,87572.421916,9.02916199999163,164.79934682768783,0
"147.32.84.165",2056,"205.188.156.193",25,3,186,3,186,0,0,87572.492043,8.95905700000003,166.08890868759906,0
"147.32.84.165",1619,"174.37.196.55",80,7,559,4,377,3,182,87578.340662,0.2451290000026347,12303.72579322554,5939.729693281295
"147.32.84.165",1790,"217.163.21.41",80,10,1451,5,701,5,750,87578.461653,0.13984599999093916,40101.25423940156,42904.33763131408
"147.32.84.165",1864,"222.23.100.200",6667,2,124,2,124,0,0,87578.507806,2.943213000005926,337.04662217719294,0
"147.32.84.165",2057,"74.6.136.65",25,3,186,3,186,0,0,87582.855028,8.928622999999789,166.65503740050792,0
"147.32.84.165",1623,"193.23.181.44",80,6,364,4,242,2,122,87584.761384,0.1254040000058012,15438.104047003608,7782.845841877852
"147.32.84.165",1824,"217.163.21.41",80,13,6077,6,749,7,5328,87584.823549,0.21778700000140816,27513.120617673492,195714.16108272946
"147.32.84.165",1883,"173.192.170.88",80,23,4889,12,1385,11,3504,87584.8815,56.52426900000137,196.0219954370349,495.92857184936474
"147.32.84.165",2059,"64.12.90.98",25,3,186,3,186,0,0,87585.082284,8.908246999999392,167.0362305849963,0
"147.32.84.165",1634,"174.37.196.55",80,6,364,3,182,3,182,87585.864657,0.24285399999644142,5995.371704898149,5995.371704898149
"147.32.84.165",1840,"184.82.147.252",80,10,1507,5,596,5,911,87585.98568,0.3414400000037858,13964.386129179748,21344.892220944213
"147.32.84.165",2060,"195.200.70.104",25,3,186,3,186,0,0,87586.098178,8.895663999996032,167.2725048968423,0
"147.32.84.165",1635,"174.37.196.55",80,6,364,3,182,3,182,87588.171876,0.24826500000199303,5864.701025067212,5864.701025067212
"147.32.84.165",1872,"217.163.21.40",80,13,5598,7,2461,6,3137,87588.292836,0.2567420000123093,76683.9862549021,97747.93371866229
"147.32.84.165",1898,"59.48.7.173",6667,6,366,3,186,3,180,87588.338866,1.9808869999978924,751.1786386611569,726.9470696720873
"147.32.84.165",2061,"207.115.21.22",25,3,186,3,186,0,0,87590.319879,8.987427000000025,165.5646271174159,0
"147.32.84.165",1637,"67.19.72.206",80,3,186,3,186,0,0,87591.482842,9.02865799999563,164.8085462978795,0
"147.32.84.165",1878,"184.82.147.251",80,10,1925,5,990,5,935,87591.98442,0.3256820000096923,24318.199961202343,22967.188852246658
"147.32.84.165",2063,"64.12.90.34",25,3,186,3,186,0,0,87592.091912,9.021475999994436,164.93975043561804,0
"147.32.84.165",1640,"174.37.196.55",80,6,364,3,182,3,182,87592.686329,0.2591359999933047,5618.671277003653,5618.671277003653
"147.32.84.165",1890,"217.163.21.41",80,10,1448,5,699,5,749,87592.807188,0.1438099999941187,38884.639456426485,41666.08720009075
"147.32.84.165",1914,"46.4.36.120",443,4,246,3,186,1,60,87592.853571,9.005730000004405,165.22813808533812,53.29939938236714
"147.32.84.165",2064,"98.139.175.224",25,3,186,3,186,0,0,87593.388814,9.028563999992912,164.81026218578816,0
"147.32.84.165",1643,"193.23.181.44",80,6,364,4,242,2,122,87593.38888,0.1258979999984149,15377.527840191067,7752.307423567398
"147.32.84.165",1894,"217.163.21.41",80,13,6077,6,749,7,5328,87593.4492,0.1955900000029942,30635.513062571048,217925.25179890325
"147.32.84.165",1924,"218.94.106.74",6667,6,366,3,186,3,180,87593.495349,1.9307849999895552,770.6709965159505,745.8106417896295
"147.32.84.165",2071,"64.12.90.33",25,3,186,3,186,0,0,87594.793304,9.028775999991922,164.806392361637,0
"147.32.84.165",1644,"174.37.196.55",80,6,364,3,182,3,182,87595.426315,0.2448199999926146,5947.226533959328,5947.226533959328
"147.32.84.165",1912,"184.82.147.252",80,10,1515,5,603,5,912,87595.547756,0.3666090000042459,13158.433098871361,19901.311751526835
"147.32.84.165",2072,"74.6.136.65",25,3,186,3,186,0,0,87595.655768,8.968995999995968,165.9048571323556,0
"147.32.84.165",1647,"193.23.181.44",179,7,422,4,242,3,180,87595.655801,0.165156000002753,11722.250478140235,8719.029281261332
"147.32.84.165",1915,"217.163.21.40",80,13,5614,7,2464,6,3150,87595.718365,0.26947900000959635,73148.55702781308,93513.78029123832
"147.32.84.165",2074,"209.85.227.27",25,3,186,3,186,0,0,87595.765033,8.95971300000383,166.0767482171989,0
"147.32.84.165",1657,"193.23.181.44",80,6,364,4,242,2,122,87601.859424,0.13457300000300165,14386.24389704337,7252.5692373524425
"147.32.84.165",1928,"217.163.21.41",80,10,1448,5,699,5,749,87601.925869,0.13918300000659656,40177.320504192096,43051.234703347465
"147.32.84.165",1952,"109.86.117.4",6667,6,366,3,186,3,180,87601.971546,0.9871379999967758,1507.388024779575,1458.7626046253952
"147.32.84.165",1962,"46.4.36.120",443,4,246,3,186,1,60,87602.9588,9.027730000001611,164.82548769178237,53.16951215863947
"147.32.84.165",2075,"213.163.160.52",25,3,186,3,186,0,0,87603.822155,9.028384999997797,164.8135297730838,0
"147.32.84.165",1661,"174.128.246.102",80,3,186,3,186,0,0,87606.029139,9.028690999999526,164.80794392011845,0
"147.32.84.165",1933,"217.163.21.41",80,14,6141,7,810,7,5331,87606.029202,0.19029699999373406,34052.0344525314,224112.8341561048
"147.32.84.165",1976,"113.255.129.49",6667,6,366,3,186,3,180,87606.075206,2.033511000001454,731.7393414635752,708.1348465776534
"147.32.84.165",2076,"64.12.90.98",25,3,186,3,186,0,0,87607.032163,9.028684999997495,164.80805344304434,0
"147.32.84.165",1670,"67.19.72.206",80,3,186,3,186,0,0,87608.108843,8.955316999999923,166.15827223090068,0
"147.32.84.165",1956,"184.82.147.251",80,10,1929,5,994,5,935,87608.108881,0.34048000001348555,23355.263156969693,21968.98496153588
"147.32.84.165",2077,"67.195.168.230",25,3,186,3,186,0,0,87608.221478,8.942818999988958,166.39048604269382,0
"147.32.84.165",1671,"193.23.181.44",179,7,422,4,242,3,180,87611.345967,0.14906899999186862,12987.274350170755,9659.956128226182
"147.32.84.165",1959,"217.163.21.40",80,13,5604,7,2464,6,3140,87611.411088,0.28195200000482146,69912.60923725642,89093.17897929592
"147.32.84.165",2012,"120.138.121.194",6667,2,124,2,124,0,0,87611.457001,2.9989389999973355,330.7836538191945,0
"147.32.84.165",2078,"98.139.175.224",25,3,186,3,186,0,0,87611.986647,8.88992899999721,167.38041439931263,0
"147.32.84.165",1675,"193.23.181.44",80,6,364,4,242,2,122,87611.986681,0.13140700000803918,14732.852891258151,7427.306003030969
"147.32.84.165",1979,"217.163.21.41",80,10,1451,5,701,5,750,87612.051456,0.1389729999937117,40353.162126843,43173.85391602318
"147.32.84.165",2079,"183.177.144.152",25,3,186,3,186,0,0,87612.097252,8.879705999992439,167.57311559653743,0
"147.32.84.165",1676,"174.128.246.102",80,5,304,3,182,2,122,87612.550008,0.3587709999992512,4058.299026406925,2720.3982484705757
"147.32.84.165",1988,"184.82.147.252",80,10,1515,5,603,5,912,87612.550071,0.3437989999947604,14031.454425619386,21221.70221586216
"147.32.84.165",2080,"64.12.90.66",25,3,186,3,186,0,0,87612.66384,8.914803000006941,166.91339113145196,0
"147.32.84.165",1678,"193.23.181.44",80,6,364,4,242,2,122,87613.151915,0.14258100000733975,13578.246750270646,6845.23183278107
"147.32.84.165",2026,"217.163.21.40",80,13,5613,7,2466,6,3147,87613.213469,0.25529100000858307,77276.51973370284,98616.87250687867
"147.32.84.165",2033,"46.4.36.120",443,3,186,3,186,0,0,87613.259292,8.921149000001606,166.7946584010347,0
"147.32.84.165",2082,"128.120.32.9",25,3,186,3,186,0,0,87614.456022,8.92812799999956,166.66427721467178,0
"147.32.84.165",1679,"193.23.181.44",80,6,364,4,242,2,122,87615.860316,0.14982099999906495,12922.087023929107,6514.440565782443
"147.32.84.165",2030,"217.163.21.41",80,14,6141,7,810,7,5331,87615.930698,0.18781000000308268,34502.95511364484,227080.56013684033
"147.32.84.165",2083,"135.11.29.14",25,3,186,3,186,0,0,87615.976613,8.912515999996685,166.95622201413758,0
"147.32.84.165",1680,"67.19.72.206",80,3,186,3,186,0,0,87616.763392,8.928301000007195,166.66104782968236,0
"147.32.84.165",2065,"217.163.21.41",80,10,1451,5,701,5,750,87624.788879,0.6380729999946197,8788.963018412136,9403.312787174182
"147.32.84.165",2117,"46.148.34.36",6667,2,124,2,124,0,0,87624.834571,2.9636350000073435,334.7240803936861,0
"147.32.84.165",2067,"98.126.71.122",80,9,4018,6,645,3,3373,87627.898909,9.45971000001009,545.4712670890012,2852.5187347150404
"147.32.84.165",2084,"173.227.91.231",25,3,186,3,186,0,0,87627.999238,9.028905999992276,164.80401944612925,0
"147.32.84.165",1699,"193.23.181.44",179,7,422,4,242,3,180,87628.073422,0.14351199999509845,13490.161101971422,10034.004125433288
"147.32.84.165",2068,"184.82.147.251",80,10,1925,5,990,5,935,87628.137753,0.3222109999915119,24580.166413339826,23214.601612598723
"147.32.84.165",2085,"205.188.190.2",25,3,186,3,186,0,0,87628.244077,8.984653999999864,165.615726548849,0
"147.32.84.165",1707,"174.37.196.55",80,6,364,3,182,3,182,87629.102898,0.24384599999757484,5970.981685221331,5970.981685221331
"147.32.84.165",2132,"217.163.21.40",80,13,5603,7,2466,6,3137,87629.224262,0.25692200000048615,76785.95059964764,97679.45135080886
"147.32.84.165",2087,"209.85.227.27",25,3,186,3,186,0,0,87629.270301,8.961248999999953,166.04828188570676,0
"147.32.84.165",1709,"67.19.72.206",80,3,186,3,186,0,0,87633.015112,9.028922000012244,164.80372739934867,0
"147.32.84.165",2146,"184.82.147.252",80,10,1515,5,603,5,912,87633.015181,0.3255770000105258,14816.771454507048,22409.44538393106
"147.32.84.165",2164,"117.240.58.147",6667,2,124,2,124,0,0,87633.122843,3.0019999999931315,330.4463690880312,0
"147.32.84.165",2089,"64.12.90.98",25,3,186,3,186,0,0,87633.617172,9.029192999994848,164.79878102072345,0
"147.32.84.165",1710,"67.19.72.206",80,3,186,3,186,0,0,87634.219151,9.028678000002401,164.8081812198424,0
"147.32.84.165",2168,"217.163.21.41",80,14,6141,7,810,7,5331,87634.219213,0.18880999999237247,34320.21609163592,225877.86664754458
"147.32.84.165",2173,"95.100.248.96",80,11,4467,6,1260,5,3207,87634.26495,3.0937879999983124,3258.1417989873576,8292.746626470202
"147.32.84.165",2091,"165.21.74.116",25,3,186,3,186,0,0,87634.265514,8.982375000006869,165.65774641994597,0
"147.32.84.165",1714,"193.23.181.44",80,6,364,4,242,2,122,87635.422744,0.13036599999759346,14850.49782946273,7486.614608241542
"147.32.84.165",2176,"217.163.21.41",80,10,1451,5,701,5,750,87635.487493,0.13866300000518095,40443.377107018205,43270.3749361821
"147.32.84.165",2204,"46.4.36.120",443,4,246,3,186,1,60,87635.533253,3.500849999996717,425.03963323232796,137.10955910720256
"147.32.84.165",2092,"74.6.136.65",25,3,186,3,186,0,0,87636.927357,9.028851000010036,164.80502336325475,0
"147.32.84.165",1715,"67.19.72.206",80,3,186,3,186,0,0,87637.730464,9.028647000013734,164.80874709109088,0
"147.32.84.165",2218,"217.163.21.40",80,11,4046,6,2406,5,1640,87637.930989,0.24820699999690987,77548.17551575755,52859.10550533765
"147.32.84.165",2095,"64.12.90.34",25,3,186,3,186,0,0,87637.976944,8.982574000008754,165.65407643717157,0
"147.32.84.165",1718,"193.23.181.44",179,7,424,4,242,3,182,87647.963033,0.1291449999989709,14990.901699759397,11274.149212215745
"147.32.84.165",2233,"184.82.147.251",80,10,1929,5,994,5,935,87648.025603,0.32188799999130424,24704.244955434257,23237.89641180184
"147.32.84.165",2266,"117.242.61.2",6667,3,186,3,186,0,0,87648.132044,8.860455999994883,167.9371806598734,0
"147.32.84.165",2267,"173.192.170.88",80,10,1040,6,543,4,497,87649.066461,21.871318000004976,198.61628823644793,181.79059899358126
"147.32.84.165",2098,"216.33.127.20",25,3,186,3,186,0,0,87649.267074,8.928145999991102,166.66394120363657,0
"147.32.84.165",1722,"174.128.246.102",80,3,186,3,186,0,0,87649.267248,8.927993999997852,166.6667786739505,0
"147.32.84.165",2249,"217.163.21.41",80,10,2277,5,1156,5,1121,87649.267281,0.13910600000235718,66481.67584319362,64468.82233583048
"147.32.84.165",2099,"205.188.190.2",25,3,186,3,186,0,0,87649.313078,8.882191999990027,167.5262142500039,0
"147.32.84.165",1729,"67.19.72.206",80,4,246,3,186,1,60,87650.169994,9.188435999996727,161.942685349338,52.239575919141295
"147.32.84.165",2333,"184.82.147.252",80,10,1514,5,603,5,911,87650.170056,0.338755000004312,14240.380215608906,21514.073592735844
"147.32.84.165",2102,"98.139.175.224",25,3,186,3,186,0,0,87650.282276,9.016390999997384,165.03277198165338,0
"147.32.84.165",1737,"174.128.246.102",80,12,730,8,484,4,246,87650.972406,21.33995799999684,181.4436560747014,92.22136238507552
"147.32.84.165",2338,"217.163.21.40",80,13,6174,7,2921,6,3253,87650.972434,0.16422200000670273,142295.185779288,158468.41470045323
"147.32.84.165",2103,"68.232.129.163",25,3,186,3,186,0,0,87651.018333,8.982921999995597,165.64765896895568,0
"147.32.84.165",1739,"174.128.246.102",80,11,672,7,426,4,246,87654.583914,18.41613199999847,185.055146216387,106.86283091368826
"147.32.84.165",2347,"217.163.21.41",80,14,6137,7,809,7,5328,87654.583977,0.18693599999824073,34621.47472964495,228013.86571019568
"147.32.84.165",2354,"201.67.253.254",6667,2,124,2,124,0,0,87654.629837,2.9636889999965206,334.71798154299074,0
"147.32.84.165",2362,"46.4.36.120",443,3,186,3,186,0,0,87655.186017,9.02844300000288,164.81247098746985,0
"147.32.84.165",2104,"209.85.227.27",25,3,186,3,186,0,0,87657.894244,9.0291300000099,164.79993089017086,0
"147.32.84.165",1741,"174.128.246.102",80,3,186,3,186,0,0,87658.697086,9.028810999996495,164.80575349296578,0
"147.32.84.165",2351,"173.241.240.4",80,9,2195,5,1165,4,1030,87658.697148,0.06923599999572616,134612.0515421935,119013.2301188492
"147.32.84.165",2105,"205.188.59.194",25,3,186,3,186,0,0,87658.713407,9.012558000002173,165.10295967023362,0
"147.32.84.165",1743,"193.23.181.44",80,6,364,4,242,2,122,87658.897634,0.1253910000086762,15439.70460293037,7783.652733708699
"147.32.84.165",2373,"217.163.21.41",80,10,1448,5,699,5,749,87658.959962,0.1402690000104485,39866.25697469474,42717.9205637287
"147.32.84.165",2106,"74.6.136.65",25,3,186,3,186,0,0,87659.005726,9.021546999996644,164.93845235196952,0
"147.32.84.165",1770,"174.37.196.55",80,6,364,3,182,3,182,87668.027207,0.2449859999906039,5943.196754328178,5943.196754328178
"147.32.84.165",2398,"184.82.147.251",80,10,1929,5,994,5,935,87668.150078,0.32240900000033434,24664.323886714556,23200.344903499106
"147.32.84.165",2441,"61.17.216.3",6667,3,186,3,186,0,0,87668.256542,8.999607999998261,165.34053483221575,0
"147.32.84.165",2107,"148.123.15.75",25,3,186,3,186,0,0,87669.029745,9.028802999993786,164.8058995196843,0
"147.32.84.165",1776,"67.19.72.206",80,6,366,3,186,3,180,87670.234386,1.371885000000475,1084.6390185762543,1049.6506631383108
"147.32.84.165",2438,"217.163.21.40",80,11,4032,6,2404,5,1628,87670.234456,0.23053399998752866,83423.70323267026,56494.92049200798
"147.32.84.165",2108,"200.80.144.166",25,3,186,3,186,0,0,87670.280383,8.982403000001796,165.65723003072813,0
"147.32.84.165",1783,"174.37.196.55",80,7,424,4,242,3,182,87671.337208,0.7370559999981197,2626.6660877937893,1975.4265618945026
"147.32.84.165",2474,"184.82.147.252",80,10,1514,5,603,5,911,87671.458435,0.3222070000047097,14971.7417682716,22618.999586891256
"147.32.84.165",2487,"89.39.65.2",6667,2,124,2,124,0,0,87671.565128,2.982250999993994,332.63464410004315,0
"147.32.84.165",2109,"64.59.192.8",25,3,186,3,186,0,0,87671.606384,8.960206999996444,166.06759196529617,0
"147.32.84.165",1785,"193.23.181.44",80,6,364,4,242,2,122,87672.039307,0.12536600000748876,15442.783528902195,7785.204919529206
"147.32.84.165",2481,"217.163.21.41",80,10,2274,5,1154,5,1120,87672.101559,0.13921199999458622,66316.1221759548,64362.26762311038
"147.32.84.165",2112,"65.55.92.168",25,3,186,3,186,0,0,87672.147403,9.021183999997447,164.9450892477552,0
"147.32.84.165",1789,"72.20.15.61",80,7,424,4,242,3,182,87676.25373,0.36615200000233017,5287.421617218203,3976.4906377426155
"147.32.84.165",2498,"217.163.21.41",80,13,6077,6,749,7,5328,87676.436391,0.1861159999971278,32194.97517726832,229018.46160812496
"147.32.84.165",2114,"216.33.127.20",25,3,186,3,186,0,0,87676.482173,8.90021500000148,167.18697244951414,0
"147.32.84.165",1799,"193.23.181.44",80,6,364,4,242,2,122,87678.962,0.1673410000075819,11569.191052475386,5832.402100834699
"147.32.84.165",2500,"217.163.21.40",80,13,6170,7,2919,6,3251,87679.025874,0.15606799999659415,149627.08563260635,166645.3084589254
"147.32.84.165",2539,"46.4.36.120",443,3,186,3,186,0,0,87679.071706,8.919188999992912,166.83131168104887,0
"147.32.84.165",2115,"64.12.138.161",25,3,186,3,186,0,0,87679.764263,8.928573999990476,166.6559520032636,0
"147.32.84.165",1807,"72.20.15.61",80,6,364,3,182,3,182,87680.065722,0.3663070000038715,3974.808016184816,3974.808016184816
"147.32.84.165",2508,"184.82.147.251",80,10,1929,5,994,5,935,87680.248448,0.34180900000501424,23264.454709745343,21883.566552929475
"147.32.84.165",2118,"205.188.156.193",25,3,186,3,186,0,0,87680.361939,8.832306000011158,168.4724238492326,0
"147.32.84.165",1810,"193.23.181.44",80,6,364,4,242,2,122,87688.091139,0.12532000000646804,15448.451962177456,7788.062559444834
"147.32.84.165",2526,"217.163.21.41",80,10,1448,5,699,5,749,87688.153378,0.13903900000150315,40218.931378530804,43095.822035078076
"147.32.84.165",2569,"190.53.151.16",6667,3,186,3,186,0,0,87688.19919,9.020568000007188,164.95635308096055,0
"147.32.84.165",2119,"98.139.175.224",25,3,186,3,186,0,0,87689.194318,9.02896700000565,164.8029060244731,0
"147.32.84.165",1821,"174.37.196.55",80,6,364,3,182,3,182,87689.996654,0.2485900000028778,5857.033669830423,5857.033669830423
"147.32.84.165",2560,"173.241.240.4",80,9,2194,5,1164,4,1030,87690.118209,0.06634800000756513,140350.87717697935,124193.64561193192
"147.32.84.165",2120,"205.188.146.193",25,3,186,3,186,0,0,87690.134679,8.99176499999885,165.4847518813259,0
"147.32.84.165",1822,"67.19.72.206",80,6,366,3,186,3,180,87691.200777,1.3693989999883343,1086.608066759707,1051.5561936384263
"147.32.84.165",2566,"184.82.147.252",80,10,1514,5,603,5,911,87692.504836,0.33903500001179054,14228.619463572306,21496.305690405257
"147.32.84.165",2121,"74.6.136.65",25,3,186,3,186,0,0,87692.57033,8.963569999992615,166.00528584048834,0
"147.32.84.165",1823,"174.128.246.102",80,3,186,3,186,0,0,87692.617089,9.344714999999269,159.23439077597513,0
"147.32.84.165",2616,"184.82.147.251",80,10,1922,5,998,5,924,87692.617121,0.35850799999025185,22270.074866438383,20618.786750089246
"147.32.84.165",2626,"212.117.171.138",65500,219,169998,129,163140,90,6858,87692.735615,27.66659599999548,47173.1325386113,1983.041209695944
"147.32.84.165",2122,"195.23.53.116",25,3,186,3,186,0,0,87692.735649,9.549383000005037,155.82158554109884,0
"147.32.84.165",1828,"193.23.181.44",179,6,362,4,242,2,120,87693.107041,0.1435980000096606,13482.08192223955,6685.329878796471
"147.32.84.165",2617,"217.163.21.40",80,13,5579,7,2464,6,3115,87693.16959,0.24162000000069384,81582.65044260987,103137.15751977668
"147.32.84.165",2644,"202.86.18.246",6667,2,124,2,124,0,0,87693.215836,3.001191999996081,330.5353339610713,0
"147.32.84.165",2123,"65.55.92.168",25,3,186,3,186,0,0,87697.421207,10.072996999995667,147.72167608117428,0
"147.32.84.165",1829,"67.19.72.206",80,6,366,3,186,3,180,87700.029143,1.366954999990412,1088.5508301373761,1053.4362872297188
"147.32.84.165",2647,"217.163.21.41",80,14,6137,7,809,7,5328,87700.731582,0.18844300000637304,34344.602876101104,226190.41300848787
"147.32.84.165",2646,"65.55.196.251",443,127,165054,68,5534,59,159520,87700.777504,9.1076849999954,4860.949846203768,140119.03134557736
"147.32.84.165",2129,"208.47.184.2",25,3,186,3,186,0,0,87700.877047,8.984356999993906,165.62120138380624,0
"147.32.84.165",1831,"67.19.72.206",80,6,366,3,186,3,180,87701.233204,3.339764999996987,445.5403299337954,431.16806122625366
"147.32.84.165",2649,"184.82.147.252",80,10,1314,5,592,5,722,87701.233229,0.3210069999913685,14753.57235240149,17993.377091949114
"147.32.84.165",2684,"61.17.216.27",6667,2,124,2,124,0,0,87701.33928,3.975323999999091,249.5394086117828,0
"147.32.84.165",2679,"46.4.36.120",443,4,246,3,186,1,60,87701.396225,9.003482999993139,165.26937408568816,53.31270131796392
"147.32.84.165",2133,"65.54.188.126",25,3,186,3,186,0,0,87709.214203,10.053264000001946,148.01163084941487,0
"147.32.84.165",1842,"193.23.181.44",80,6,364,4,242,2,122,87709.772605,0.13852499998756684,13975.816640850124,7045.659628858327
"147.32.84.165",2655,"195.113.232.88",80,27,31374,19,2570,8,28804,87709.841205,88.20692099998996,233.08828566867604,2612.4027161091612
"147.32.84.165",2134,"129.178.88.73",25,3,186,3,186,0,0,87709.841934,10.509166999996523,141.59067031673322,0
"147.32.84.165",1850,"193.23.181.44",80,6,364,4,242,2,122,87710.261577,0.15302800000063144,12651.27950435222,6377.917766656904
"147.32.84.165",2676,"184.82.147.251",80,10,1925,5,990,5,935,87710.332263,0.3072410000022501,25777.809602045294,24345.70906859833
"147.32.84.165",2136,"205.188.190.2",25,3,186,3,186,0,0,87710.39984,9.957626999996137,149.43319326990027,0
"147.32.84.165",1851,"174.37.196.55",80,6,364,3,182,3,182,87710.433671,0.2605619999958435,5587.9214928624515,5587.9214928624515
"147.32.84.165",2677,"217.163.21.41",80,10,1448,5,699,5,749,87710.554405,0.13874899999063928,40302.99317744463,43185.89683820605
"147.32.84.165",2707,"212.117.171.138",65500,202,178379,95,6459,107,171920,87710.600171,166.72946699999738,309.91522332402593,8249.05174080609
"147.32.84.165",2138,"202.168.25.162",25,3,186,3,186,0,0,87710.600202,9.766864999997779,152.35185497089788,0
"147.32.84.165",1852,"193.23.181.44",179,10,754,5,454,5,300,87711.164799,0.21047700000053737,17256.042227847825,11402.67107567037
"147.32.84.165",2686,"217.163.21.40",80,15,7450,7,2378,8,5072,87711.231634,0.1886159999994561,100861.00861037694,215124.90987040868
"147.32.84.165",2708,"65.55.16.187",443,121,164536,67,5474,54,159062,87711.27751,9.294953999997233,4711.373504378078,136901.80715260978
"147.32.84.165",2719,"46.4.36.120",443,3,186,3,186,0,0,87711.439346,8.934120999998413,166.5524789736186,0
"147.32.84.165",2139,"98.139.175.224",25,3,186,3,186,0,0,87714.873065,7.62785299999814,195.07455112209988,0
"147.32.84.165",1855,"174.37.196.55",80,6,364,3,182,3,182,87714.882665,2.3262160000012955,625.9092018966378,625.9092018966378
"147.32.84.165",2711,"184.82.147.252",80,10,1515,5,603,5,912,87717.081494,3.394916999997804,1420.947846443115,2149.0952503418257
"147.32.84.165",2714,"86.105.106.56",6667,2,122,1,62,1,60,87719.270693,0.055143999998108484,8994.632235909863,8704.48280894503
"147.32.84.165",2736,"94.100.176.20",25,3,186,3,186,0,0,87719.72627,6.987579000007827,212.949291878966,0
"147.32.84.165",2140,"205.188.159.42",25,3,186,3,186,0,0,87720.347866,7.068404000005103,210.5142829978204,0
"147.32.84.165",1856,"193.23.181.44",179,7,422,4,242,3,180,87721.798367,0.1583320000063395,12227.471388743172,9094.813429643682
"147.32.84.165",2712,"217.163.21.40",80,13,5630,7,2479,6,3151,87721.865166,0.23585800000000745,84084.49151607906,106877.86719127273
"147.32.84.165",2776,"14.98.87.197",6667,2,124,2,124,0,0,87721.910923,2.9973529999988386,330.95868254435976,0
"147.32.84.165",2141,"98.139.54.60",25,3,186,3,186,0,0,87727.717178,9.029579999987618,164.79171788743668,0
"147.32.84.165",1859,"174.37.196.55",80,6,364,3,182,3,182,87729.121701,0.24304200000187848,5990.734111753304,5990.734111753304
"147.32.84.165",2717,"217.163.21.40",80,13,5349,7,2426,6,2923,87729.242955,0.22097300000314135,87829.7348532359,105822.88333718406
"147.32.84.165",2143,"208.89.132.27",25,3,186,3,186,0,0,87729.28878,8.96194999999716,166.03529365824085,0
"147.32.84.165",1861,"67.19.72.206",80,6,366,3,186,3,180,87730.827147,1.3687349999963772,1087.1352014845377,1052.0663240172944
"147.32.84.165",2743,"184.82.147.251",80,10,1922,5,998,5,924,87731.329146,0.34032699999806937,23459.790143142603,21720.286665594955
"147.32.84.165",2811,"77.239.2.219",6667,2,124,2,124,0,0,87731.441629,2.99702100000286,330.9953450439798,0
"147.32.84.165",2144,"74.6.136.65",25,3,186,3,186,0,0,87731.529645,9.028940000003786,164.8033988485222,0
"147.32.84.165",1867,"193.23.181.44",80,6,364,4,242,2,122,87732.196002,0.12819499999750406,15101.993057745573,7613.401458863471
"147.32.84.165",2752,"217.163.21.41",80,14,6141,7,810,7,5331,87732.259593,0.18840800000180025,34393.4440147875,226359.81486769402
"147.32.84.165",2145,"64.18.4.10",25,3,186,3,186,0,0,87732.305303,8.955346999995527,166.1577156084229,0
"147.32.84.165",1871,"174.128.246.102",80,3,186,3,186,0,0,87732.331835,9.028988999998546,164.80250446647344,0
"147.32.84.165",2816,"184.82.147.252",80,10,1312,5,592,5,720,87732.331895,0.3204249999980675,14780.369821420185,17976.12545848401
"147.32.84.165",2147,"220.181.15.198",25,3,186,3,186,0,0,87732.437973,9.02306600000884,164.91068556946632,0
"147.32.84.165",1889,"72.20.15.61",80,7,424,4,242,3,182,87734.53909,0.6049930000008317,3200.0370252173802,2406.6394156593524
"147.32.84.165",2821,"217.163.21.41",80,10,1451,5,701,5,750,87734.723081,0.13883299998997245,40393.85448996313,43217.39068113031
"147.32.84.165",2824,"46.4.36.120",443,3,186,3,186,0,0,87734.769263,8.998950000008335,165.35262447270202,0
"147.32.84.165",2148,"65.54.188.126",25,3,186,3,186,0,0,87737.749022,8.928847000002861,166.65085648791197,0
"147.32.84.165",1893,"67.19.72.206",80,6,366,3,186,3,180,87738.752317,1.3623200000001816,1092.2543895705867,1057.0203770037936
"147.32.84.165",2823,"93.184.220.20",80,12,6545,8,768,4,5777,87739.454797,9.275391000002855,662.3979517411296,4982.647092719409
"147.32.84.165",2852,"74.125.93.27",25,3,186,3,186,0,0,87739.471001,8.9120760000078,166.96446484508184,0
"147.32.84.165",2151,"24.248.72.37",25,3,186,3,186,0,0,87740.114772,8.87066899999627,167.74383082049684,0
"147.32.84.165",1901,"67.19.72.206",80,6,366,3,186,3,180,87747.78137,1.366156999996747,1089.186674740563,1054.0516207166738
"147.32.84.165",2840,"217.163.21.40",80,11,4093,6,2453,5,1640,87748.683929,0.2986419999942882,65710.78415084055,43932.19975840951
"147.32.84.165",2880,"117.204.73.9",6667,3,186,3,186,0,0,87748.730004,8.983286000002408,165.6409469763738,0
"147.32.84.165",2153,"64.12.90.1",25,3,186,3,186,0,0,87749.147648,8.966304999994463,165.95464910026135,0
"147.32.84.165",1904,"174.37.196.55",80,6,364,3,182,3,182,87750.188591,0.2437670000072103,5972.916760500533,5972.916760500533
"147.32.84.165",2859,"195.113.232.98",80,11,2424,7,1270,4,1154,87750.310068,109.78025099998922,92.54852222920312,84.09527137992157
"147.32.84.165",2154,"98.139.175.224",25,3,186,3,186,0,0,87750.3101,9.00798899999063,165.1867026038273,0
"147.32.84.165",1907,"174.128.246.102",80,16,972,12,724,4,248,87752.496641,189.1096409999882,30.627735156032376,10.49126839598899
"147.32.84.165",2863,"74.125.232.202",80,18,6662,10,4432,8,2230,87752.496703,65.62091599999985,540.3155298837962,271.86453782510506
"147.32.84.165",2915,"180.251.135.144",6667,2,124,2,124,0,0,87752.50472,3.0010089999996126,330.5554898369609,0
"147.32.84.165",2161,"74.6.136.65",25,3,186,3,186,0,0,87753.199031,9.028573000003234,164.8100978969176,0
"147.32.84.165",1917,"174.37.196.55",80,8,679,5,497,3,182,87753.399144,1.7161170000035781,2316.8583493967544,848.4270011875439
"147.32.84.165",2868,"63.251.249.49",80,9,1249,5,621,4,628,87753.520194,0.537213999996311,9247.71134042321,9351.95285311719
"147.32.84.165",2162,"205.188.190.2",25,3,186,3,186,0,0,87753.69684,8.931813999995939,166.59549784631392,0
"147.32.84.165",1919,"72.20.15.61",80,6,364,3,182,3,182,87755.706244,0.3665739999996731,3971.9129016277707,3971.9129016277707
"147.32.84.165",2869,"184.82.147.251",80,10,1910,5,982,5,928,87755.889175,0.34044299999368377,23075.815922623617,21806.881034821505
"147.32.84.165",2170,"208.97.132.221",25,3,186,3,186,0,0,87756.001618,8.934105000007548,166.55277725063036,0
"147.32.84.165",1923,"174.128.246.102",80,3,186,3,186,0,0,87758.716087,9.028693000000203,164.80790741250883,0
"147.32.84.165",2872,"68.67.185.217",80,10,1627,6,795,4,832,87758.716153,22.375,284.24581005586595,297.47486033519556
"147.32.84.165",2935,"46.4.36.120",443,3,186,3,186,0,0,87758.745205,8.999639999994542,165.33994693131083,0
"147.32.84.165",2171,"203.188.197.119",25,3,186,3,186,0,0,87760.421616,9.028498999992735,164.8114487248874,0
"147.32.84.165",1926,"174.37.196.55",80,7,424,4,242,3,182,87761.023322,3.2887190000037663,588.6790571033229,442.7255718710941
"147.32.84.165",2909,"217.163.21.41",80,10,2277,5,1156,5,1121,87761.144192,0.13929300000017975,66392.42460129416,64382.27333741414
"147.32.84.165",2959,"202.80.173.5",6667,2,124,2,124,0,0,87761.190082,2.943513999998686,337.01215621887405,0
"147.32.84.165",2953,"74.125.39.27",25,3,186,3,186,0,0,87767.845111,8.928725999998278,166.65311490130696,0
"147.32.84.165",2174,"64.12.90.34",25,3,186,3,186,0,0,87769.751514,8.928125999998883,166.66431454934508,0
"147.32.84.165",1937,"72.20.15.61",80,7,424,4,242,3,182,87770.1527,1.9797819999948842,977.8854439554469,735.4345074375675
"147.32.84.165",2918,"74.125.232.202",80,8,1470,5,964,3,506,87770.335272,64.337824000002,119.8672805595626,62.91788792856709
"147.32.84.165",2175,"209.85.227.27",25,3,186,3,186,0,0,87770.335305,8.846401000002516,168.20399617873719,0
"147.32.84.165",1938,"193.23.181.44",80,6,364,4,242,2,122,87771.356197,0.13049199999659322,14836.158538841795,7479.385709664045
"147.32.84.165",2933,"184.82.147.252",80,10,1508,5,596,5,912,87771.419876,0.339680999997654,14036.699138406122,21478.975862795945
"147.32.84.165",3031,"95.111.235.248",6667,2,124,2,124,0,0,87771.532178,2.9339380000019446,338.11212097847414,0
"147.32.84.165",2177,"205.188.59.194",25,3,186,3,186,0,0,87774.266128,8.928073999995831,166.66528525645003,0
"147.32.84.165",1939,"67.19.72.206",80,6,366,3,186,3,180,87774.666845,1.2637220000033267,1177.4741596617635,1139.4911222533194
"147.32.84.165",2948,"68.67.185.206",80,10,2377,6,1061,4,1316,87775.930698,12.129121000005398,699.8033905339244,867.9936493333123
"147.32.84.165",2178,"212.77.101.4",25,3,186,3,186,0,0,87775.954342,8.945309000002453,166.34416988832828,0
"147.32.84.165",1940,"174.128.246.102",80,3,186,3,186,0,0,87776.874124,9.028432999999495,164.8126535357889,0
"147.32.84.165",2960,"217.163.21.40",80,14,6305,7,2968,7,3337,87776.874186,0.20888200000626966,113671.83385493876,127804.21481601436
"147.32.84.165",2179,"168.95.5.24",25,3,186,3,186,0,0,87776.920033,8.982585999998264,165.65385513707162,0
"147.32.84.165",1948,"67.19.72.206",80,6,366,3,186,3,180,87777.877337,1.363654000000679,1091.1858873286474,1055.9863425761102
"147.32.84.165",2975,"184.82.147.251",80,10,1925,5,990,5,935,87779.241122,0.3228649999946356,24530.3764735465,23167.577780571697
"147.32.84.165",2180,"74.6.136.65",25,3,186,3,186,0,0,87779.347884,8.962390999993659,166.02712378884752,0
"147.32.84.165",1955,"67.19.72.206",80,6,366,3,186,3,180,87779.682804,1.3622699999978067,1092.2944790697848,1057.05917329334
"147.32.84.165",3035,"217.163.21.41",80,13,6081,6,750,7,5331,87781.045187,0.1865150000085123,32168.99444938031,228657.21254619522
"147.32.84.165",3095,"46.4.36.120",443,5,306,3,186,2,120,87781.090984,0.9995000000053551,1488.7443721781167,960.480240114914
"147.32.84.165",2181,"164.139.14.160",25,3,186,3,186,0,0,87781.388412,9.028583999999682,164.80989710014907,0
"147.32.84.165",1958,"174.37.196.55",80,7,424,4,242,3,182,87787.909415,1.706105999997817,1134.7477823783968,853.4053569953232
"147.32.84.165",3057,"46.228.164.11",80,10,1345,6,644,4,701,87788.030404,10.017612999989069,514.2941736724729,559.8139996031109
"147.32.84.165",3098,"83.17.186.77",6667,1,62,1,62,0,0,87788.059665,0,0,0
"147.32.84.165",2182,"94.245.120.86",25,3,186,3,186,0,0,87788.812317,9.02929399999266,164.7969376123105,0
"147.32.84.165",1960,"174.37.196.55",80,7,424,4,242,3,182,87790.718282,3.5021010000054957,552.8110125884325,415.7504309549368
"147.32.84.165",3058,"217.163.21.41",80,14,5916,7,807,7,5109,87790.839209,0.18702900000789668,34518.71100057968,218532.9547731866
"147.32.84.165",3134,"66.111.4.71",25,3,186,3,186,0,0,87790.884962,8.962673000001814,166.02189993986156,0
"147.32.84.165",2183,"67.215.65.132",25,3,186,3,186,0,0,87791.219899,9.028716000000713,164.8074875762935,0
"147.32.84.165",1966,"67.19.72.206",80,6,366,3,186,3,180,87794.128879,1.3641029999998864,1090.8267190968159,1055.6387604162735
"147.32.84.165",3063,"173.241.240.4",80,4,242,3,182,1,60,87795.232573,0.01634899999771733,89057.4347179209,29359.593863050846
"147.32.84.165",3173,"49.114.102.212",6667,1,62,1,62,0,0,87795.248779,0,0,0
"147.32.84.165",3180,"46.4.36.120",443,4,246,3,186,1,60,87795.493098,9.016846999991685,165.02442594416564,53.23368578844053
"147.32.84.165",2184,"208.65.144.3",25,3,186,3,186,0,0,87796.938209,9.033035000000382,164.72868753413854,0
"147.32.84.165",1968,"174.37.196.55",80,7,424,4,242,3,182,87797.941107,4.744628000000375,408.04041960715296,306.8733734235613
"147.32.84.165",3082,"184.82.147.252",80,10,1515,5,603,5,912,87797.941185,0.32247600000118837,14959.252781547226,22624.939530300282
"147.32.84.165",2185,"98.139.175.224",25,3,186,3,186,0,0,87798.047861,8.926498999993782,166.69469183842807,0
"147.32.84.165",1980,"193.23.181.44",80,6,364,4,242,2,122,87798.06252,0.13416299999516923,14430.208031049611,7274.7329743307955
"147.32.84.165",3099,"217.163.21.41",80,10,1451,5,701,5,750,87798.129159,0.13849599999957718,40492.14417757279,43322.55083192524
"147.32.84.165",2186,"76.96.62.116",25,3,186,3,186,0,0,87798.17493,8.899155999999493,167.20686770746403,0
"147.32.84.165",1981,"67.19.72.206",80,6,366,3,186,3,180,87800.348657,1.3621450000064215,1092.3947156822403,1057.1561764666842
"147.32.84.165",3131,"184.82.147.251",80,10,1930,5,1002,5,928,87801.710937,0.3044990000053076,26325.20960614083,24381.03244959949
"147.32.84.165",3189,"61.17.216.69",6667,2,124,2,124,0,0,87801.811577,2.9553520000044955,335.6622155325291,0
"147.32.84.165",2189,"65.55.37.104",25,3,186,3,186,0,0,87802.458248,8.929957000000286,166.63014166809003,0
"147.32.84.165",1992,"72.20.15.61",80,10,1476,6,554,4,922,87804.510198,3.2333199999993667,1370.727301968524,2281.2465206046554
"147.32.84.165",3167,"217.163.21.41",80,4,244,3,182,1,62,87804.695131,0.04591200000140816,31712.841957556702,10803.27583169514
"147.32.84.165",2190,"65.55.92.184",25,3,186,3,186,0,0,87804.740888,8.853912000005948,168.06130442667606,0
"147.32.84.165",2003,"72.20.15.61",80,7,424,4,242,3,182,87807.977052,2.4930979999917326,776.543882352968,584.0123412737198
"147.32.84.165",3169,"95.172.94.28",80,8,1221,5,832,3,389,87808.159966,0.053542999987257645,124311.30122675268,58121.50982837355
"147.32.84.165",3199,"46.4.36.120",443,4,246,3,186,1,60,87808.177438,6.521194000000833,228.1790727280633,73.60615249292364
"147.32.84.165",2191,"205.188.59.193",25,3,186,3,186,0,0,87809.782726,9.028871000002255,164.80465830109085,0
"147.32.84.165",2010,"193.23.181.44",179,7,424,4,242,3,182,87811.789238,0.1352270000061253,14316.66752876501,10767.080538162116
"147.32.84.165",3172,"46.137.16.7",80,4,244,3,182,1,62,87811.855917,0.044355000005452894,32826.06244664644,11182.504789516921
"147.32.84.165",3209,"89.228.163.103",6667,2,124,2,124,0,0,87811.900131,2.9990120000002207,330.7756020982667,0
"147.32.84.165",3210,"216.157.130.15",25,3,186,3,186,0,0,87812.190618,9.029037000000244,164.80162834640723,0
"147.32.84.165",2194,"64.12.90.98",25,3,186,3,186,0,0,87817.909143,9.028407000005245,164.81312816304532,0
"147.32.84.165",2015,"193.23.181.44",179,7,422,4,242,3,180,87818.009526,0.12488500001200009,15502.262079625027,11530.60815839878
"147.32.84.165",3186,"217.163.21.41",80,14,6141,7,810,7,5331,87818.071223,0.18896799998765346,34291.52025963857,225689.00556065832
"147.32.84.165",2195,"209.85.227.27",25,3,186,3,186,0,0,87818.117456,9.020834999988438,164.95147067892353,0
"147.32.84.165",2020,"174.37.196.55",80,7,424,4,242,3,182,87819.012202,3.00696300000709,643.8389830521477,484.2094831218631
"147.32.84.165",3187,"217.163.21.40",80,13,5631,7,2518,6,3113,87819.112998,0.2697489999991376,74676.82920071771,92322.86310636785
"147.32.84.165",2198,"64.12.90.34",25,3,186,3,186,0,0,87819.133937,9.007686999990256,165.19224080517114,0
"147.32.84.165",2028,"72.20.15.61",80,11,1508,6,526,5,982,87819.159171,3.024266999986139,1391.4115387362579,2597.654241519021
"147.32.84.165",3191,"184.82.147.252",80,10,1508,5,596,5,912,87819.343858,0.32117800001287833,14845.350552680497,22716.375342356732
"147.32.84.165",2199,"74.6.136.65",25,3,186,3,186,0,0,87819.450264,8.992091000007349,165.4787523834872,0
"147.32.84.165",2029,"193.23.181.44",80,6,364,4,242,2,122,87823.426374,0.1343369999958668,14411.517303941326,7265.310376367114
"147.32.84.165",3205,"184.82.147.251",80,10,1925,5,990,5,935,87823.492882,0.3073749999894062,25766.571778033234,24335.0955681425
"147.32.84.165",3226,"79.135.138.210",6667,2,124,2,124,0,0,87823.593888,2.942455999989761,337.13333351576097,0
"147.32.84.165",2201,"67.215.65.132",25,3,186,3,186,0,0,87825.633841,9.028443999995943,164.81245273279302,0
"147.32.84.165",2037,"174.37.196.55",80,6,364,3,182,3,182,87826.736926,0.24289100000169128,5994.458419578584,5994.458419578584
"147.32.84.165",3219,"217.163.21.41",80,10,1451,5,701,5,750,87826.858043,0.1390629999950761,40327.04601654334,43145.91228588802
"147.32.84.165",2203,"207.115.21.22",25,3,186,3,186,0,0,87826.903948,8.96252899999672,166.02456739616065,0
"147.32.84.165",2040,"174.37.196.55",80,6,364,3,182,3,182,87828.041274,0.2432869999902323,5984.701196769482,5984.701196769482
"147.32.84.165",3222,"195.113.232.88",80,4,244,3,182,1,62,87828.162271,0.0011030000023311004,0,0
"147.32.84.165",3238,"46.4.36.120",443,3,186,3,186,0,0,87828.163218,9.006913000004715,165.20643643379492,0
"147.32.84.165",2205,"64.33.108.52",25,3,186,3,186,0,0,87830.84991,8.929025999997975,166.64751564172144,0
"147.32.84.165",2048,"67.19.72.206",80,6,366,3,186,3,180,87833.257618,1.3693729999940842,1086.6286979562385,1051.576159312489
"147.32.84.165",3223,"217.163.21.41",80,14,6141,7,810,7,5331,87834.627122,0.18918899999698624,34251.46282343702,225425.36828610214
"147.32.84.165",3243,"86.101.54.123",6667,2,124,2,124,0,0,87834.672938,2.99926699999196,330.74747930166245,0
"147.32.84.165",2207,"205.188.59.193",25,3,186,3,186,0,0,87838.073307,9.028852999996161,164.80498685720463,0
"147.32.84.165",2058,"174.128.246.102",80,3,186,3,186,0,0,87838.876207,9.0281590000086,164.8176555152144,0
"147.32.84.165",3229,"184.82.147.252",80,10,1515,5,603,5,912,87838.876275,0.3402970000024652,14175.852270120082,21440.094975704003
"147.32.84.165",2208,"192.118.80.172",25,3,186,3,186,0,0,87838.98905,9.016275999994832,165.0348769271097,0
"147.32.84.165",2066,"174.128.246.102",80,3,186,3,186,0,0,87839.076122,9.029144000000088,164.79967536235833,0
"147.32.84.165",3237,"217.163.21.40",80,12,4148,6,2458,6,1690,87839.076189,0.2845300000044517,69110.462867509,47516.95778929627
"147.32.84.165",2209,"66.83.9.58",25,3,186,3,186,0,0,87839.121959,8.983331000010367,165.6401172347187,0
"147.32.84.165",2073,"67.19.72.206",80,6,366,3,186,3,180,87840.079288,1.3641810000117403,1090.7643487097343,1055.5784019771622
"147.32.84.165",3244,"184.82.147.251",80,10,1930,5,1002,5,928,87840.380576,0.32832700001017656,24414.684140358673,22611.603674903043
"147.32.84.165",2210,"208.88.253.155",25,3,186,3,186,0,0,87840.488239,9.021481999996467,164.9396407375842,0
"147.32.84.165",2081,"174.128.246.102",80,11,668,7,424,4,244,87841.443583,98.09093200000643,34.58015874494676,19.899902673978794
"147.32.84.165",3250,"217.163.21.41",80,10,1451,5,701,5,750,87841.443615,0.14445200000773184,38822.584662724155,41536.288868820426
"147.32.84.165",3259,"95.58.134.226",6667,2,124,2,124,0,0,87841.495183,2.998410000000149,330.842012933505,0
"147.32.84.165",2211,"98.139.175.224",25,3,186,3,186,0,0,87846.60027,9.02883200001088,164.80537017392803,0
"147.32.84.165",2086,"72.20.15.61",80,6,364,3,182,3,182,87847.804346,0.3704020000004675,3930.8643041834607,3930.8643041834607
"147.32.84.165",3256,"217.163.21.41",80,13,6081,6,750,7,5331,87847.988787,0.18678899999940768,32121.80588802888,228321.79625210928
"147.32.84.165",2212,"64.12.90.66",25,3,186,3,186,0,0,87848.034528,8.999066999997012,165.3504746659286,0
"147.32.84.165",2094,"193.23.181.44",179,6,362,4,242,2,120,87848.105205,0.1361999999935506,14214.390602728887,7048.458150113498
"147.32.84.165",3258,"184.82.147.252",80,10,1508,5,596,5,912,87848.172264,0.3349970000126632,14232.963279730162,21779.299515291794
"147.32.84.165",2213,"20.132.170.5",25,3,186,3,186,0,0,87848.279849,8.95432800000708,166.1766243093645,0
"147.32.84.165",2100,"193.23.181.44",80,6,364,4,242,2,122,87849.108615,0.1615709999896353,11982.34831822662,6040.68799513904
"147.32.84.165",3261,"217.163.21.40",80,13,5689,7,2518,6,3171,87849.179162,0.2557119999983115,78776.12313905101,99205.35602618378
"147.32.84.165",3272,"212.117.171.138",65500,46,4564,23,2197,23,2367,87849.226153,108.325582999998,162.2516077296378,174.80635206920925
"147.32.84.165",2214,"64.12.90.1",25,3,186,3,186,0,0,87849.226189,9.01173500000732,165.1180377584107,0
"147.32.84.165",2101,"193.23.181.44",179,6,362,4,242,2,120,87851.817125,0.12702200000057928,15241.454236204523,7557.745902250176
"147.32.84.165",3271,"217.163.21.41",80,10,1451,5,701,5,750,87851.879731,0.13956100000359584,40183.145720190514,42991.953338292275
"147.32.84.165",3275,"205.188.186.137",587,51,16731,24,14229,27,2502,87851.925946,25.30091099999845,4499.126533428262,791.1177585661333
"147.32.84.165",3278,"46.4.36.120",443,3,186,3,186,0,0,87852.043503,9.002942999999505,165.2792870064913,0
"147.32.84.165",2215,"74.6.136.65",25,3,186,3,186,0,0,87858.137744,9.028288999994402,164.81528227562526,0
"147.32.84.165",2110,"67.19.72.206",80,6,366,3,186,3,180,87859.140474,1.3620369999989634,1092.4813349425401,1057.2400015572969
"147.32.84.165",3273,"217.163.21.41",80,13,6081,6,750,7,5331,87860.043483,0.1873349999950733,32028.184803468615,227656.33758305493
"147.32.84.165",3279,"61.17.216.26",6667,3,186,3,186,0,0,87860.090146,8.98228100000415,165.6594800362305,0
"147.32.84.165",2216,"210.254.56.38",25,3,186,3,186,0,0,87860.143757,9.028468000004068,164.8120146185742,0
"147.32.84.165",2111,"174.128.246.102",80,3,186,3,186,0,0,87860.502619,8.870116999998572,167.75426975768633,0
"147.32.84.165",3276,"184.82.147.251",80,10,1910,5,982,5,928,87860.502652,0.3235899999999674,24277.635279213795,22942.61256528554
"147.32.84.165",2217,"74.125.159.27",25,3,186,3,186,0,0,87860.609495,8.86353699999745,167.87880504142174,0
"147.32.84.165",2127,"193.23.181.44",179,6,362,4,242,2,120,87861.547971,0.14886299999488983,13005.24643508769,6448.882529795549
"147.32.84.165",3280,"217.163.21.40",80,13,5615,7,2518,6,3097,87861.613404,0.2618309999961639,76935.12227465477,94625.92282947015
"147.32.84.165",3286,"93.177.150.210",6667,2,124,2,124,0,0,87861.659231,2.998552999997628,330.82623518770043,0
"147.32.84.165",2219,"205.188.59.193",25,3,186,3,186,0,0,87867.668036,9.155180999994627,162.53092101629375,0
"147.32.84.165",2150,"72.20.15.61",80,7,424,4,242,3,182,87869.072497,3.167386000000988,611.2295754288855,459.68505259527757
"147.32.84.165",3284,"217.163.21.41",80,10,1451,5,701,5,750,87869.257961,0.14308000000892207,39194.85602215754,41934.58204938396
"147.32.84.165",2220,"98.139.175.224",25,3,186,3,186,0,0,87869.27259,9.030171000005794,164.780932719773,0
"147.32.84.165",2158,"174.37.196.55",80,7,424,4,242,3,182,87869.304068,3.326991000009002,581.9071948180087,437.6326837061057
"147.32.84.165",3285,"184.82.147.252",80,10,1508,5,596,5,912,87869.425077,0.3260539999901084,14623.344599804474,22376.661535271276
"147.32.84.165",2221,"84.103.237.8",25,3,186,3,186,0,0,87869.532704,8.970814000000246,165.87123531933213,0
"147.32.84.165",2159,"193.23.181.44",80,6,364,4,242,2,122,87870.175489,0.1346990000020014,14372.786731684973,7245.785046551929
"147.32.84.165",3289,"195.113.232.88",80,13,10783,9,1281,4,9502,87870.242172,63.78593300000648,160.66238303669493,1191.7361152339386
"147.32.84.165",2223,"217.72.192.149",25,3,186,3,186,0,0,87870.24331,8.96379499998875,166.00111894592274,0
"147.32.84.165",2163,"193.23.181.44",179,7,422,4,242,3,180,87872.984455,0.12417199999617878,15591.276616786214,11596.817318270738
"147.32.84.165",3300,"184.82.147.251",80,10,1925,5,990,5,935,87873.045107,0.34118600000510924,23213.14473595458,21923.5255839571
"147.32.84.165",3308,"83.152.81.217",6667,2,124,2,124,0,0,87873.157576,2.9369929999957094,337.7604236719152,0
"147.32.84.165",3315,"46.4.36.120",443,5,306,3,186,2,120,87877.700257,3.5583459999907063,418.17181353468334,269.7882667965699
"147.32.84.165",2224,"216.33.127.20",25,3,186,3,186,0,0,87879.106148,9.029849999991711,164.78679047839842,0
"147.32.84.165",2165,"174.37.196.55",80,8,659,5,477,3,182,87881.012779,4.5048099999985425,847.0945500478898,323.21007989248625
"147.32.84.165",3318,"173.192.170.88",80,18,4921,11,1108,7,3813,87881.134256,21.742073000001255,407.6888160572126,1402.9940935254076
"147.32.84.165",3304,"217.163.21.40",80,11,4088,6,2458,5,1630,87881.21345,0.23565800000505988,83442.955467575,55334.42531006804
"147.32.84.165",3326,"60.243.195.59",6667,2,124,2,124,0,0,87881.258722,2.964827999996487,334.5893927071572,0
"147.32.84.165",2227,"74.6.136.65",25,3,186,3,186,0,0,87881.259219,8.983309999995981,165.64050444665335,0
"147.32.84.165",2166,"174.37.196.55",80,7,424,4,242,3,182,87881.514667,4.164676000000327,464.8620925132827,349.6070282537911
"147.32.84.165",3307,"217.163.21.41",80,14,6141,7,810,7,5331,87881.514744,0.18902299999899697,34281.54245797805,225623.3368438037
"147.32.84.165",2228,"64.12.90.34",25,3,186,3,186,0,0,87881.5606,8.983072999995784,165.64487453243433,0
"147.32.84.165",2167,"193.23.181.44",179,7,422,4,242,3,180,87887.734391,0.13005699998757336,14885.780851357329,11072.06840183603
"147.32.84.165",3313,"184.82.147.252",80,10,1515,5,603,5,912,87887.798405,0.3214890000090236,15005.179025921881,22694.40011880722
"147.32.84.165",3330,"46.4.36.120",443,4,246,3,186,1,60,87887.905027,6.551355999996304,227.12855170759147,73.26727474438434
"147.32.84.165",2230,"98.139.54.60",25,3,186,3,186,0,0,87888.637472,9.029882999995607,164.78618825966228,0
"147.32.84.165",2188,"174.128.246.102",80,25,1514,17,1026,8,488,87890.342894,415.55250000000524,19.752016893172094,9.394721485251445
"147.32.84.165",3327,"184.82.147.251",80,10,1926,5,998,5,928,87890.342956,0.32330100001126993,24695.253029596835,22963.12105357301
"147.32.84.165",2231,"205.188.159.42",25,3,186,3,186,0,0,87890.343125,9.028361000004224,164.81396789509233,0
"147.32.84.165",2192,"174.37.196.55",80,7,424,4,242,3,182,87890.449681,1.3727959999960149,1410.2605194112018,1060.6091509621435
"147.32.84.165",3328,"217.163.21.41",80,10,2277,5,1156,5,1121,87890.543741,0.14038199999777135,65877.39168943894,63882.83398257877
"147.32.84.165",2232,"50.58.22.130",25,3,186,3,186,0,0,87890.570912,9.001367000004393,165.30822485065588,0
"147.32.84.165",2200,"67.19.72.206",80,6,366,3,186,3,180,87890.589624,1.4188279999943916,1048.752914381364,1014.9221752077716
"147.32.84.165",3329,"217.163.21.41",80,10,1451,5,701,5,750,87891.245782,0.14097100000071805,39781.23160062307,42561.94536443267
"147.32.84.165",3348,"122.55.28.99",6667,2,124,2,124,0,0,87891.292322,2.9631910000025528,334.7742349376552,0
"147.32.84.165",2236,"205.188.190.2",25,3,186,3,186,0,0,87892.008564,8.868015000000014,167.79403282470741,0
"147.32.84.165",2206,"193.23.181.44",179,7,422,4,242,3,180,87897.766798,0.1291159999964293,14994.268720015643,11152.761857862875
"147.32.84.165",3343,"184.82.147.252",80,14,2632,11,1840,3,792,87897.829433,195.70691299998725,75.21451222318835,32.37494221780716
"147.32.84.165",2237,"209.85.227.27",25,3,186,3,186,0,0,87900.174177,8.928303000007872,166.6610104964726,0
"147.32.84.165",2225,"67.19.72.206",80,6,366,3,186,3,180,87902.18067,1.3629669999936596,1091.7358967656019,1056.518609773163
"147.32.84.165",3344,"217.163.21.41",80,13,6081,6,750,7,5331,87902.482014,0.1951790000020992,30741.012096257633,218507.11398019924
"147.32.84.165",3360,"178.90.22.31",6667,2,124,2,124,0,0,87902.527715,2.963896000001114,334.694604668864,0
"147.32.84.165",2238,"204.126.122.130",25,3,186,3,186,0,0,87903.543786,8.969450000004144,165.89645964906572,0
"147.32.84.165",2234,"193.23.181.44",80,6,364,4,242,2,122,87903.792703,0.17063700000289828,11345.722205425065,5719.744252321728
"147.32.84.165",3345,"217.163.21.40",80,14,6310,7,2973,7,3337,87903.857071,0.20836299999791663,114146.94547610568,128122.5553493995
"147.32.84.165",2239,"98.139.175.224",25,3,186,3,186,0,0,87903.902938,9.012224000005517,165.10907851370416,0
"147.32.84.165",2245,"193.23.181.44",179,7,422,4,242,3,180,87906.394163,0.15577299999131355,12428.341240830941,9244.220757642848
"147.32.84.165",3349,"217.163.21.40",80,11,4088,6,2458,5,1630,87906.466405,0.22998699999880046,85500.48481045694,56698.856892207004
"147.32.84.165",2240,"64.12.139.193",25,3,186,3,186,0,0,87906.512321,9.010739999997895,165.136270716983,0
"147.32.84.165",2252,"174.128.246.102",80,3,186,3,186,0,0,87907.798768,9.028533000004245,164.8108280713268,0
"147.32.84.165",3358,"184.82.147.251",80,10,1925,5,990,5,935,87907.798841,0.3046719999983907,25995.168574866857,24550.99254292981
"147.32.84.165",3372,"46.4.36.120",443,3,186,3,186,0,0,87907.899084,9.028420999995433,164.81287259430556,0
"147.32.84.165",2241,"165.212.8.32",25,3,186,3,186,0,0,87909.60456,9.028383999990183,164.81354802826485,0
"147.32.84.165",2253,"193.23.181.44",80,6,364,4,242,2,122,87911.309747,0.12554199999431148,15421.1339638346,7774.290675982733
"147.32.84.165",3362,"217.163.21.41",80,10,1451,5,701,5,750,87911.372071,0.1389729999937117,40353.162126843,43173.85391602318
"147.32.84.165",3376,"210.211.186.109",6667,2,124,2,124,0,0,87911.418018,3.001711000004434,330.47818394193666,0
"147.32.84.165",2242,"188.121.52.56",25,3,186,3,186,0,0,87911.510354,9.028661000003922,164.808491535938,0
"147.32.84.165",2257,"72.20.15.61",80,7,424,4,242,3,182,87912.915232,1.932730000000447,1001.6919073018746,753.3385418551288
"147.32.84.165",3365,"173.241.240.4",80,4,242,3,182,1,60,87913.097827,0.016543999998248182,88007.73695322615,29013.53965490972
"147.32.84.165",2243,"64.12.90.98",25,3,186,3,186,0,0,87913.114232,8.929644999996526,166.63596369179052,0
"147.32.84.165",2261,"193.23.181.44",80,6,364,4,242,2,122,87917.830641,0.1346170000033453,14381.54170685641,7250.198711721
"147.32.84.165",3368,"217.163.21.41",80,10,2277,5,1156,5,1121,87917.897426,0.13903800000844058,66514.19036118602,64500.352417724505
"147.32.84.165",2244,"64.12.90.34",25,3,186,3,186,0,0,87917.943211,9.016671999997925,165.02762881918545,0
"147.32.84.165",2271,"174.37.196.55",80,7,424,4,242,3,182,87921.141012,0.7075480000057723,2736.2101228244665,2057.8109188184003
"147.32.84.165",3373,"184.82.147.252",80,13,1695,10,903,3,792,87921.262072,99.03076500000316,72.94702812807485,63.980117693726775
"147.32.84.165",3386,"212.117.171.138",65500,190,160269,96,6519,94,153750,87921.262103,71.50146400000085,729.3836668854693,17202.4449737139
"147.32.84.165",2246,"205.188.156.193",25,3,186,3,186,0,0,87921.262126,9.008084999994026,165.18494219370564,0
"147.32.84.165",2276,"72.20.15.61",80,7,424,4,242,3,182,87924.552129,2.970973999996204,651.6381496446868,490.07497204683057
"147.32.84.165",3378,"217.163.21.40",80,11,4088,6,2458,5,1630,87924.736836,0.2447470000042813,80344.19216438208,53279.50904310122
"147.32.84.165",3393,"205.188.186.137",587,30,3587,14,1814,16,1773,87924.782689,32.863953000007314,441.57804144853696,431.5975013716957
"147.32.84.165",2247,"74.6.136.65",25,3,186,3,186,0,0,87924.900558,8.8808260000078,167.55198221411982,0
"147.32.84.165",2281,"174.128.246.102",80,3,186,3,186,0,0,87924.953226,8.928557999999612,166.65625065100824,0
"147.32.84.165",3390,"184.82.147.251",80,10,1926,5,998,5,928,87924.953287,0.30480399999942165,26193.88197010259,24356.635739734673
"147.32.84.165",3399,"124.81.2.139",6667,2,124,2,124,0,0,87925.053843,3.009191999997711,329.6565988480478,0
"147.32.84.165",2248,"62.24.139.61",25,3,186,3,186,0,0,87927.561678,8.928515999999945,166.65703460687186,0
"147.32.84.165",2291,"193.23.181.44",179,10,775,5,475,5,300,87927.862428,0.1857950000121491,20452.649424104624,12917.462794171342
"147.32.84.165",3392,"217.163.21.40",80,4,244,3,182,1,62,87927.923106,0.046053999991272576,31615.060587048207,10769.965694488948
"147.32.84.165",2250,"216.32.181.178",25,3,186,3,186,0,0,87927.969007,8.922412999992957,166.77102931697675,0
"147.32.84.165",2307,"174.128.246.102",80,16,974,11,666,5,308,87928.966149,93.30598900000041,57.102443874208085,26.407736806690824
"147.32.84.165",3401,"217.163.21.41",80,10,2277,5,1156,5,1121,87928.966213,0.13924399999086745,66415.7881173088,64404.92948053906
"147.32.84.165",2251,"173.227.207.20",25,3,186,3,186,0,0,87929.012096,8.983150999993086,165.6434362509486,0
"147.32.84.165",2309,"193.23.181.44",80,6,364,4,242,2,122,87930.671559,0.14243800000986084,13591.878570788502,6852.104072876848
"147.32.84.165",3402,"184.82.147.252",80,3,186,3,186,0,0,87930.74204,8.857803999999305,167.98746054892575,0
"147.32.84.165",3410,"46.4.36.120",443,3,186,3,186,0,0,87930.742077,8.857824999999139,167.98706228675152,0
"147.32.84.165",2259,"98.139.175.224",25,3,186,3,186,0,0,87932.477121,9.02882999999565,164.8054066806792,0
"147.32.84.165",2311,"174.128.246.102",80,3,186,3,186,0,0,87933.981957,9.030368000007002,164.77733797768224,0
"147.32.84.165",3408,"217.163.21.40",80,14,6310,7,2973,7,3337,87933.982021,0.21195099999022204,112214.6156474715,125953.64023397658
"147.32.84.165",3412,"200.206.215.4",6667,2,124,2,124,0,0,87934.027935,2.963631999999052,334.7244192262458,0
"147.32.84.165",2264,"66.175.58.41",25,3,186,3,186,0,0,87937.894761,9.029991999996128,164.78419914443313,0
"147.32.84.165",2330,"193.23.181.44",80,7,424,4,242,3,182,87938.898108,0.12872200000856537,15040.16407351638,11311.197774297443
"147.32.84.165",3414,"184.82.147.251",80,10,1905,5,990,5,915,87938.961873,0.3231060000107391,24512.079626304567,22655.10389703907
"147.32.84.165",2265,"128.200.1.6",25,3,186,3,186,0,0,87939.067933,8.959896000000299,166.0733562085933,0
"147.32.84.165",2332,"67.19.72.206",80,6,366,3,186,3,180,87942.20957,1.3586389999982202,1095.2136660304534,1059.8841929326968
"147.32.84.165",3420,"173.241.240.4",80,9,2195,5,1165,4,1030,87943.568328,0.06619399999908637,140798.2596629398,124482.58150457339
"147.32.84.165",3428,"190.122.143.202",6667,2,124,2,124,0,0,87943.584681,2.9384850000060396,337.5889276269782,0
"147.32.84.165",2268,"205.188.146.193",25,3,186,3,186,0,0,87945.821313,9.038426000013715,164.6304345466503,0
"147.32.84.165",2344,"72.20.15.61",80,6,364,3,182,3,182,87947.927509,0.3709930000040913,3924.602350944474,3924.602350944474
"147.32.84.165",3432,"217.163.21.41",80,14,6138,7,810,7,5328,87948.112427,0.18900399999984074,34284.9886775172,225519.03663433532
"147.32.84.165",2269,"207.115.11.16",25,3,186,3,186,0,0,87948.158767,9.004084000000148,165.2583427697893,0
"147.32.84.165",2346,"193.23.181.44",179,7,422,4,242,3,180,87948.529483,0.3474409999907948,5572.169087848852,4144.588577738816
"147.32.84.165",3440,"217.163.21.41",80,10,1449,5,700,5,749,87948.590976,0.1394799999980023,40149.12532320193,42959.56409582607
"147.32.84.165",2270,"64.12.90.33",25,3,186,3,186,0,0,87948.637083,9.027362000007997,164.8322067951503,0
"147.32.84.165",2360,"72.20.15.61",80,6,364,3,182,3,182,87948.930625,0.49782000000413973,2924.7519183397458,2924.7519183397458
"147.32.84.165",3444,"217.163.21.40",80,11,4096,6,2457,5,1639,87949.115292,0.23387899999215733,84043.45837231699,56063.17796997458
"147.32.84.165",2272,"74.6.136.65",25,3,186,3,186,0,0,87949.161316,9.002875000005588,165.28053538442737,0
"147.32.84.165",2368,"72.20.15.61",80,6,364,3,182,3,182,87950.03443,0.37124999999650754,3921.885521922416,3921.885521922416
"147.32.84.165",3446,"217.163.21.41",80,10,2275,5,1155,5,1120,87950.219995,0.13911399999051355,66420.34590788916,64407.608153104644
"147.32.84.165",2273,"64.12.90.66",25,3,186,3,186,0,0,87950.265831,9.002940999998827,165.27932372323596,0
"147.32.84.165",2369,"193.23.181.44",80,6,364,4,242,2,122,87951.639438,0.12525100000493694,15456.962418852463,7792.35295495868
"147.32.84.165",3447,"217.163.21.41",80,14,6141,7,810,7,5331,87951.70155,0.1869379999989178,34663.89926091813,228139.81106167228
"147.32.84.165",3449,"201.165.227.159",6667,2,124,2,124,0,0,87951.747471,3.012213000009069,329.325980598654,0
"147.32.84.165",3453,"46.4.36.120",443,4,246,3,186,1,60,87953.545945,6.523198999988381,228.10893857486954,73.58352857253857
"147.32.84.165",3459,"184.82.148.43",80,3,186,3,186,0,0,87958.666483,9.012530000007246,165.10347260966716,0
"147.32.84.165",2274,"216.97.236.88",25,3,186,3,186,0,0,87958.965055,9.013100000011036,165.09303125430517,0
"147.32.84.165",2371,"193.23.181.44",80,6,364,4,242,2,122,87960.069224,0.14495699999679346,13355.684789577776,6733.03117491111
"147.32.84.165",3457,"94.100.176.20",25,3,186,3,186,0,0,87960.136336,8.945034999997006,166.3492652628523,0
"147.32.84.165",2275,"10.123.229.200",25,3,186,3,186,0,0,87966.87901,8.91055200000119,166.99302130774853,0
"147.32.84.165",2382,"193.23.181.44",80,6,364,4,242,2,122,87969.179819,0.13332200000877492,14521.234303960166,7320.622252409671
"147.32.84.165",3462,"212.117.171.138",65500,53,5050,26,2377,27,2673,87969.242087,53.81419900000037,353.363988563685,397.36724502765253
"147.32.84.165",2278,"98.139.175.224",25,3,186,3,186,0,0,87969.242119,8.852988999991794,168.07882625872224,0
"147.32.84.165",2393,"72.20.15.61",80,7,424,4,242,3,182,87969.680675,4.186690000002272,462.41780499605875,347.76876243505245
"147.32.84.165",3469,"64.12.175.136",587,45,13357,21,11035,24,2322,87969.863468,22.613154000006034,3903.922469195427,821.4687787468764
"147.32.84.165",2279,"68.1.17.3",25,3,186,3,186,0,0,87969.981173,8.913486000004923,166.9380531925644,0
"147.32.84.165",2396,"174.37.196.55",80,6,366,3,186,3,180,87970.08156,1.3229040000005625,1124.798171295398,1088.5143593181272
"147.32.84.165",3470,"155.97.153.147",6667,3,186,3,186,0,0,87970.182036,8.914730999997118,166.91473921091742,0
"147.32.84.165",2282,"64.12.90.98",25,3,186,3,186,0,0,87971.283489,8.912530000001425,166.9559597555085,0
"147.32.84.165",2406,"174.128.246.102",80,3,186,3,186,0,0,87971.404564,8.892789000004996,167.32658336987015,0
"147.32.84.165",3512,"112.205.111.114",6667,2,124,2,124,0,0,87971.404594,2.884472999998252,343.9103087463815,0
"147.32.84.165",2283,"216.32.181.178",25,3,186,3,186,0,0,87972.084107,8.914566999999806,166.9178099171875,0
"147.32.84.165",2437,"174.37.196.55",80,6,366,3,186,3,180,87979.594689,1.3226690000010421,1124.9980153755985,1088.7077568150953
"147.32.84.165",3513,"46.4.36.120",443,4,246,3,186,1,60,87979.897996,3.5021669999987353,424.8797958522644,137.0579986620208
"147.32.84.165",3531,"184.82.147.251",80,11,2595,7,1736,4,859,87980.91748,9.34252099999867,1486.5366639263618,735.5616326686319
"147.32.84.165",2285,"74.125.113.27",25,3,186,3,186,0,0,87980.998741,9.011163999995915,165.12850060221683,0
"147.32.84.165",2458,"174.37.196.55",80,6,366,3,186,3,180,87984.024417,1.2997960000066087,1144.7950293680196,1107.8661574529222
"147.32.84.165",3521,"212.117.171.138",65500,46,4663,22,2137,24,2526,87985.324327,122.55125200000475,139.5008188084389,164.89427623309157
"147.32.84.165",3542,"74.125.93.27",25,3,186,3,186,0,0,87985.324359,8.985818000001018,165.59427310900705,0
"147.32.84.165",2286,"67.210.124.15",25,3,186,3,186,0,0,87987.808081,9.010234000001219,165.14554449970984,0
"147.32.84.165",2462,"174.37.196.55",80,6,366,3,186,3,180,87989.909572,1.3266639999928884,1121.610294700072,1085.4293174516827
"147.32.84.165",3540,"64.12.175.136",587,30,3653,14,1880,16,1773,87990.110404,33.04110299999593,455.19061515597264,429.283489718904
"147.32.84.165",2287,"98.139.175.224",25,3,186,3,186,0,0,87990.110467,9.015027999994345,165.05772361449496,0
"147.32.84.165",2465,"72.20.15.61",80,7,424,4,242,3,182,87990.911321,6.132334999987506,315.7035615314467,237.42995123439383
"147.32.84.165",3550,"59.99.153.96",6667,3,186,3,186,0,0,87991.093941,8.934408000000985,166.5471288080683,0
"147.32.84.165",3595,"184.82.147.252",80,10,1315,5,593,5,722,87991.115048,0.33933499999693595,13980.284969257036,17021.527399331502
"147.32.84.165",2288,"194.0.130.47",25,3,186,3,186,0,0,87991.115073,9.013460000001942,165.0864373947052,0
"147.32.84.165",2483,"193.23.181.44",80,8,894,5,508,3,386,87991.236348,0.13517399999545887,30064.953320435357,22844.629885212693
"147.32.84.165",3596,"113.20.239.202",6667,2,124,2,124,0,0,87991.303053,2.9068420000112383,341.26381825918463,0
"147.32.84.165",3597,"217.163.21.39",80,16,7541,8,2469,8,5072,87992.368794,0.44703300000401214,44184.65750810952,90767.34827101316
"147.32.84.165",2289,"207.115.11.16",25,3,186,3,186,0,0,87992.434367,8.998554000005242,165.3599011573563,0
"147.32.84.165",2486,"193.23.181.44",80,6,364,4,242,2,122,87993.006023,0.19937000000209082,9710.5883532111,4895.420574759315
"147.32.84.165",2292,"64.12.90.98",25,3,186,3,186,0,0,87993.074582,8.960128999999142,166.06903762213048,0
"147.32.84.165",2493,"67.19.72.206",80,6,366,3,186,3,180,87995.414705,1.3576539999921806,1096.008261315895,1060.6531561121565
"147.32.84.165",3621,"46.4.36.120",443,3,186,3,186,0,0,87996.772683,8.973908999993,165.81402820121764,0
"147.32.84.165",3605,"217.163.21.39",80,13,5374,7,2449,6,2925,88002.034784,0.23382300000230316,83789.87524669095,100075.69828361414
"147.32.84.165",2293,"207.115.11.16",25,3,186,3,186,0,0,88002.080626,8.983084999999846,165.6446532566513,0
"147.32.84.165",2496,"174.37.196.55",80,6,366,3,186,3,180,88002.080657,1.279009000005317,1163.4007266515046,1125.871670953069
"147.32.84.165",3637,"201.249.127.77",6667,2,124,2,124,0,0,88003.359788,2.9890359999990324,331.87957589012683,0
"147.32.84.165",3629,"184.82.155.107",80,5,308,4,246,1,62,88006.348895,30.044676999998046,65.50245156571755,16.50874795558735
"147.32.84.165",2294,"64.12.90.34",25,3,186,3,186,0,0,88007.95382,8.928498000008403,166.6573705900589,0
"147.32.84.165",2502,"67.19.72.206",80,6,366,3,186,3,180,88008.856469,1.3573990000004414,1096.2141566330283,1060.8524096448662
"147.32.84.165",3650,"74.125.39.27",25,3,186,3,186,0,0,88010.214009,8.87567599999602,167.6492021566208,0
"147.32.84.165",3646,"195.113.232.96",80,19,19421,14,1510,5,17911,88011.163936,64.15105300000869,188.30556062732694,2233.6032426463926
"147.32.84.165",2295,"208.65.145.12",25,3,186,3,186,0,0,88011.164697,8.928186999997706,166.6631758497422,0
"147.32.84.165",2504,"174.128.246.102",80,16,972,12,724,4,248,88012.067033,189.20339900000545,30.612557864247634,10.486069544659411
"147.32.84.165",3668,"150.186.92.225",6667,6,366,3,186,3,180,88012.067102,2.120020000002114,701.8801709410836,679.2388751042745
"147.32.84.165",2296,"74.6.136.65",25,3,186,3,186,0,0,88012.167115,9.0288559999899,164.80493209789418,0
"147.32.84.165",2522,"174.37.196.55",80,6,366,3,186,3,180,88013.471645,1.3247810000029858,1123.204514554969,1086.9721108596473
"147.32.84.165",2297,"98.139.54.60",25,3,186,3,186,0,0,88014.073392,8.92860600000131,166.6553547104421,0
"147.32.84.165",2530,"193.23.181.44",179,6,362,4,242,2,120,88014.187234,0.13057200000912417,14827.068589473358,7352.265416267781
"147.32.84.165",2300,"98.139.175.224",25,3,186,3,186,0,0,88014.251616,8.85093900001084,168.11775564131418,0
"147.32.84.165",2532,"193.23.181.44",80,6,364,4,242,2,122,88014.796574,0.19774499999766704,9790.386609132169,4935.649447579027
"147.32.84.165",2301,"200.91.27.32",25,3,186,3,186,0,0,88014.862976,8.841181999989203,168.30328795423702,0
"147.32.84.165",2538,"67.19.72.206",80,6,366,3,186,3,180,88017.684954,1.3653659999981755,1089.8176752621555,1054.662266382731
"147.32.84.165",3697,"124.123.147.161",6667,6,366,3,186,3,180,88017.985869,1.367208000010578,1088.3493952555043,1053.2413502472623
"147.32.84.165",3706,"46.4.36.120",443,3,186,3,186,0,0,88019.050443,8.967340000002878,165.93549480665644,0
"147.32.84.165",2302,"74.125.113.27",25,3,186,3,186,0,0,88019.35321,8.96534700000484,165.97238232933947,0
"147.32.84.165",2546,"72.20.15.61",80,7,424,4,242,3,182,88027.315405,2.8915220000053523,669.5435829284427,503.5410417065147
"147.32.84.165",3727,"178.122.89.175",6667,1,62,1,62,0,0,88027.500133,0,0,0
"147.32.84.165",3746,"184.82.147.251",80,15,2233,11,1358,4,875,88028.921036,49.77080100000603,218.28059387669256,140.64471254941532
"147.32.84.165",2303,"65.54.188.126",25,3,186,3,186,0,0,88031.12784,9.028544999993755,164.81060901851063,0
"147.32.84.165",2547,"193.23.181.44",179,6,362,4,242,2,120,88032.130681,0.12366800000017975,15654.817737791394,7762.719539400691
"147.32.84.165",3755,"66.111.4.71",25,3,186,3,186,0,0,88032.191636,8.968317999999272,165.9173994499438,0
"147.32.84.165",2304,"64.12.90.98",25,3,186,3,186,0,0,88033.234241,9.029630999997607,164.7907871318766,0
"147.32.84.165",2568,"67.19.72.206",80,6,366,3,186,3,180,88035.039985,1.3559910000039963,1097.3524160526247,1061.9539510186692
"147.32.84.165",3763,"196.46.196.3",6667,2,124,2,124,0,0,88035.140794,3.0090979999949923,329.66689685801225,0
"147.32.84.165",2305,"64.12.90.33",25,3,186,3,186,0,0,88035.742343,9.02879799999937,164.80599078638195,0
"147.32.84.165",2584,"174.128.246.102",80,33,1984,17,1022,16,962,88036.39609,647.5430909999995,12.626186756735862,11.884923346359981
"147.32.84.165",2308,"209.85.227.27",25,3,186,3,186,0,0,88036.396124,8.976969999988796,165.75748832867404,0
"147.32.84.165",2594,"174.37.196.55",80,6,366,3,186,3,180,88039.053173,1.3246820000058506,1123.288457149284,1087.0533456283397
"147.32.84.165",2310,"206.225.164.180",25,3,186,3,186,0,0,88040.056837,8.927519999997457,166.675627721968,0
"147.32.84.165",2599,"174.128.246.102",80,42,2532,23,1384,19,1148,88040.356997,672.862518000009,16.455070246608464,13.64914786351627
"147.32.84.165",2313,"202.144.65.81",25,3,186,3,186,0,0,88040.35706,8.928660999998101,166.6543281238157,0
"147.32.84.165",2618,"174.37.196.55",80,6,366,3,186,3,180,88040.37796,1.3036140000040177,1141.442175364344,1104.6214600300104
"147.32.84.165",2315,"74.6.136.65",25,3,186,3,186,0,0,88040.377993,8.907787000003736,167.0448563711027,0
"147.32.84.165",2624,"174.37.196.55",80,6,366,3,186,3,180,88041.071478,1.3135159999947064,1132.8373617116174,1096.2942210112426
"147.32.84.165",3804,"46.4.36.120",443,3,186,3,186,0,0,88041.07151,8.916827000008198,166.8755040328395,0
"147.32.84.165",3809,"184.82.147.252",80,10,1515,5,603,5,912,88049.085111,0.3227540000079898,14946.367821562495,22605.451829626858
"147.32.84.165",2316,"205.188.146.193",25,3,186,3,186,0,0,88049.085177,9.028294999996433,164.81517274309135,0
"147.32.84.165",2632,"174.37.196.55",80,6,366,3,186,3,180,88052.094801,1.32441299999482,1123.5166069842412,1087.2741357912012
"147.32.84.165",3816,"84.229.253.152",6667,3,186,3,186,0,0,88053.097863,9.028540999992401,164.81068203613987,0
"147.32.84.165",3870,"216.157.130.15",25,3,186,3,186,0,0,88053.419327,9.01303000000189,165.09431345504098,0
"147.32.84.165",3848,"184.82.147.251",80,11,1992,6,1064,5,928,88054.201252,6.339411000008113,1342.7114916494777,1171.086714521349
"147.32.84.165",2318,"98.139.175.224",25,3,186,3,186,0,0,88054.201316,9.029220999989775,164.7982699727568,0
"147.32.84.165",2645,"193.23.181.44",179,6,362,4,242,2,120,88056.709688,0.14536399999633431,13318.290636256712,6604.111059300849
"147.32.84.165",3862,"89.108.150.205",6667,1,62,1,62,0,0,88056.78063,0,0,0
"147.32.84.165",3850,"217.163.21.37",80,14,6138,7,810,7,5328,88057.311182,0.18736499999067746,34584.90113053355,227491.79410306516
"147.32.84.165",2319,"205.188.190.2",25,3,186,3,186,0,0,88057.356986,8.982883999997284,165.64835970279142,0
"147.32.84.165",2648,"174.37.196.55",80,6,366,3,186,3,180,88061.022928,1.3252229999925476,1122.8298935412138,1086.6095743947228
"147.32.84.165",3887,"217.163.21.37",80,10,1449,5,700,5,749,88061.324407,0.13905900000827387,40270.6764730568,43089.62382617078
"147.32.84.165",2320,"67.195.168.230",25,3,186,3,186,0,0,88061.324473,9.028928999992786,164.8035996297223,0
"147.32.84.165",2650,"193.23.181.44",179,6,362,4,242,2,120,88061.370194,0.1272820000012871,15210.320390789137,7542.307631796267
"147.32.84.165",3895,"184.82.147.252",80,10,1507,5,596,5,911,88061.4329,0.36012500000651926,13239.84727501197,20237.417562979706
"147.32.84.165",2321,"218.102.53.139",25,3,186,3,186,0,0,88061.432931,9.020198999991408,164.963101146817,0
"147.32.84.165",2661,"67.19.72.206",80,6,366,3,186,3,180,88062.025986,1.368402000007336,1087.3997553292254,1052.3223438669925
"147.32.84.165",3897,"217.163.21.39",80,13,5685,7,2522,6,3163,88062.348255,0.26727099998970516,75488.92323064286,94675.44178371267
"147.32.84.165",2323,"173.0.129.6",25,3,186,3,186,0,0,88062.394354,8.961939000000712,166.0354974520449,0
"147.32.84.165",2662,"174.128.246.102",80,3,186,3,186,0,0,88063.394504,8.964626000000862,165.98573102769228,0
"147.32.84.165",3906,"212.52.133.252",6667,2,124,2,124,0,0,88063.394536,2.9453119999961928,336.80642322486796,0
"147.32.84.165",3916,"46.4.36.120",443,4,246,3,186,1,60,88069.149142,3.510963000007905,423.8153463869171,136.71462786674746
"147.32.84.165",3898,"217.163.21.37",80,14,6137,7,809,7,5328,88070.152368,0.18749399999796879,34518.437923720834,227335.27473125415
"147.32.84.165",2324,"64.12.90.34",25,3,186,3,186,0,0,88070.198166,8.88226699999359,167.52479969371265,0
"147.32.84.165",2665,"72.20.15.61",80,7,424,4,242,3,182,88074.165232,0.591669000001275,3272.099771993848,2460.8353657143816
"147.32.84.165",3951,"184.82.147.251",80,10,1910,5,982,5,928,88074.348073,0.34484099999826867,22781.513799227592,21528.762531245626
"147.32.84.165",2325,"98.139.175.224",25,3,186,3,186,0,0,88074.348104,8.846540999991703,168.2013342843712,0
"147.32.84.165",2674,"72.20.15.61",80,7,424,4,242,3,182,88074.348126,0.41095900000073016,4710.932234107442,3542.932506642787
"147.32.84.165",3950,"212.117.171.138",65500,45,4615,21,2077,24,2538,88074.34815,57.29972499998985,289.98393971354915,354.3472503577216
"147.32.84.165",3960,"217.163.21.37",80,10,1448,5,699,5,749,88074.348176,0.13888100000622217,40264.6870324196,43144.85062558266
"147.32.84.165",2326,"205.188.156.193",25,3,186,3,186,0,0,88074.394128,8.899986999997054,167.19125544795656,0
"147.32.84.165",2675,"72.20.15.61",80,7,424,4,242,3,182,88074.465879,0.4221140000008745,4586.4387345503565,3449.305164000681
"147.32.84.165",3971,"178.122.22.89",6667,6,366,3,186,3,180,88074.46594,1.0959020000009332,1357.7856414156859,1313.986104595825
"147.32.84.165",3998,"217.163.21.39",80,11,4104,6,2466,5,1638,88075.268769,0.25392799999099225,77691.31407603661,51605.179422768844
"147.32.84.165",2327,"65.55.37.72",25,3,186,3,186,0,0,88075.314828,8.88242999999784,167.52172547381312,0
"147.32.84.165",2678,"174.128.246.102",80,3,186,3,186,0,0,88075.561981,8.836077999992995,168.4005052921873,0
"147.32.84.165",3999,"205.188.186.137",587,30,3686,14,1913,16,1773,88075.562012,32.40831300000718,472.2245184436662,437.66548416132787
"147.32.84.165",4000,"184.82.147.252",80,10,1508,5,596,5,912,88075.679732,0.3423130000010133,13928.772789773939,21313.826819251397
"147.32.84.165",2328,"206.54.145.17",25,3,186,3,186,0,0,88075.679763,8.918239000005997,166.84908309801963,0
"147.32.84.165",2683,"193.23.181.44",80,6,364,4,242,2,122,88078.277926,0.12585100000433158,15383.270692591765,7755.20258056279
"147.32.84.165",4001,"217.163.21.37",80,10,2274,5,1154,5,1120,88078.340191,0.14076700000441633,65583.55296135004,63651.2819035633
"147.32.84.165",2329,"65.55.88.22",25,3,186,3,186,0,0,88078.386075,9.021147999999812,164.9457474813661,0
"147.32.84.165",2685,"174.128.246.102",80,16,972,12,724,4,248,88079.18072,189.10314199999266,30.628787754358015,10.491628954531475
"147.32.84.165",4021,"61.17.216.19",6667,2,124,2,124,0,0,88079.180783,3.009940000003553,329.5746759067719,0
"147.32.84.165",4006,"217.163.21.37",80,13,6081,6,750,7,5331,88082.290918,0.18788700000732206,31934.088041036244,226987.49779568563
"147.32.84.165",2331,"168.95.5.68",25,3,186,3,186,0,0,88082.338349,8.981379999997444,165.6760987732869,0
"147.32.84.165",2689,"193.23.181.44",179,7,422,4,242,3,180,88082.391584,0.17387400000006892,11134.499695177155,8281.859277404496
"147.32.84.165",4019,"217.163.21.39",80,14,6316,7,2981,7,3335,88082.45837,0.20982800000638235,113654.99361035998,127151.76239199951
"147.32.84.165",2335,"64.12.90.98",25,3,186,3,186,0,0,88082.504654,9.015455000000657,165.04990596701904,0
"147.32.84.165",2691,"174.128.246.102",80,32,1924,16,962,16,962,88083.294191,627.9264710000134,12.256212081238786,12.256212081238786
"147.32.84.165",4050,"217.163.21.37",80,10,1451,5,701,5,750,88083.294219,0.13903199999185745,40336.03774906811,43155.53254179898
"147.32.84.165",2337,"74.6.136.65",25,3,186,3,186,0,0,88083.33993,8.983196999994107,165.6425880453224,0
"147.32.84.165",2701,"193.23.181.44",179,7,422,4,242,3,180,88084.598076,0.21169200001168065,9145.362129382198,6802.3354681355195
"147.32.84.165",4056,"184.82.147.251",80,10,1910,5,982,5,928,88084.658739,0.3606979999894975,21779.993235972324,20582.315400185656
"147.32.84.165",2339,"74.85.246.28",25,3,186,3,186,0,0,88084.777957,8.949474000008195,166.2667548951634,0
"147.32.84.165",2709,"67.19.72.206",80,6,366,3,186,3,180,88091.119022,1.3684400000056485,1087.3695594939186,1052.293122090889
"147.32.84.165",4104,"125.99.28.64",6667,2,124,2,124,0,0,88092.487576,2.945089000000735,336.8319259620855,0
"147.32.84.165",4084,"46.4.36.120",443,4,246,3,186,1,60,88095.232168,6.520716999992146,228.19576436177067,73.61153689089377
"147.32.84.165",4060,"92.240.244.181",80,10,1758,6,1364,4,394,88095.332415,9.465766000008443,1152.7857333458555,332.9894273740961
"147.32.84.165",2340,"205.188.146.194",25,3,186,3,186,0,0,88095.341229,9.020811000009417,164.9519095343475,0
"147.32.84.165",2713,"174.37.196.55",80,6,366,3,186,3,180,88096.235085,1.3256260000052862,1122.4885450300962,1086.2792371258995
"147.32.84.165",4062,"173.241.240.4",80,9,2194,5,1164,4,1030,88096.636765,0.06845700000121724,136026.99504556763,120367.52998018441
"147.32.84.165",2341,"205.188.190.2",25,3,186,3,186,0,0,88096.653196,9.01272600000084,165.0998821000285,0
"147.32.84.165",2716,"193.23.181.44",179,7,422,4,242,3,180,88097.560817,0.15123899999889545,12800.930976891803,9521.353619175721
"147.32.84.165",4137,"212.117.171.138",65500,14,870,8,486,6,384,88097.627802,50.59611899999436,76.84383855608438,60.71611935295556
"147.32.84.165",4066,"217.163.21.39",80,11,4108,6,2468,5,1640,88097.627833,0.24170099999173544,81687.70505986782,54281.94339472578
"147.32.84.165",2342,"198.96.178.145",25,3,186,3,186,0,0,88097.674023,8.994617000003927,165.4322802181961,0
"147.32.84.165",2725,"174.128.246.102",80,3,186,3,186,0,0,88099.44579,9.028698000009172,164.8078161434227,0
"147.32.84.165",4153,"205.188.186.137",587,32,3818,14,1925,18,1893,88099.445859,32.296778999996604,476.8277356699137,468.9012486354008
"147.32.84.165",4078,"184.82.147.252",80,10,1508,5,596,5,912,88099.445885,0.3657130000065081,13037.545834890067,19950.070136610302
"147.32.84.165",2348,"205.188.159.42",25,3,186,3,186,0,0,88099.445913,9.028596000003745,164.80967804954201,0
"147.32.84.165",2741,"174.37.196.55",80,6,366,3,186,3,180,88103.357869,1.3251670000026934,1122.8773430042972,1086.655493229965
"147.32.84.165",4169,"92.112.3.72",6667,1,62,1,62,0,0,88103.559024,0,0,0
"147.32.84.165",4131,"184.82.147.251",80,10,1925,5,990,5,935,88104.362109,0.34463200000755023,22981.03484245946,21704.310684545042
"147.32.84.165",2350,"98.139.175.224",25,3,186,3,186,0,0,88104.475643,8.914629999999306,166.91663030323366,0
"147.32.84.165",2746,"193.23.181.44",179,6,362,4,242,2,120,88104.683155,0.13989399999263696,13839.049566828437,6862.33862817939
"147.32.84.165",4166,"217.163.21.37",80,10,2277,5,1156,5,1121,88104.752185,0.1398769999941578,66115.22981180793,64113.47112373416
"147.32.84.165",2352,"205.188.190.2",25,3,186,3,186,0,0,88104.797991,8.892959000004339,167.32338471360026,0
"147.32.84.165",2749,"174.37.196.55",80,6,366,3,186,3,180,88104.798025,1.289216999997734,1154.1889379387762,1116.9570367149447
"147.32.84.165",4177,"217.163.21.37",80,13,6081,6,750,7,5331,88105.264412,0.18585599999642,32283.057851861515,229467.97521103165
"147.32.84.165",2353,"98.139.175.224",25,3,186,3,186,0,0,88105.310204,8.88259600001038,167.51859478898524,0
"147.32.84.165",2751,"193.23.181.44",80,6,364,4,242,2,122,88105.310243,0.12164899999334011,15914.6396608767,8023.082804243626
"147.32.84.165",4200,"184.82.147.252",80,10,1514,5,603,5,911,88105.370751,0.3647869999986142,13224.155466116737,19978.782138693776
"147.32.84.165",2355,"207.115.21.22",25,3,186,3,186,0,0,88105.491917,8.901430999991135,167.16413349735362,0
"147.32.84.165",2753,"193.23.181.44",179,7,422,4,242,3,180,88105.765559,0.23782599999685772,8140.40517027398,6054.846820864944
"147.32.84.165",4202,"217.163.21.39",80,14,6320,7,2983,7,3337,88105.829654,0.20888700000068638,114243.58624481938,127801.15564832794
"147.32.84.165",2356,"65.55.92.152",25,3,186,3,186,0,0,88105.875457,8.919450000001234,166.82642988074312,0
"147.32.84.165",2762,"193.23.181.44",80,6,364,4,242,2,122,88106.087355,0.208385999998427,9290.45137396281,4683.615981915135
"147.32.84.165",4214,"217.163.21.37",80,10,1451,5,701,5,750,88106.15373,0.13873700000112876,40421.80528593218,43247.295241724874
"147.32.84.165",2357,"74.6.136.65",25,3,186,3,186,0,0,88106.199605,8.996264000001247,165.40199353862823,0
"147.32.84.165",2763,"72.20.15.61",80,7,424,4,242,3,182,88113.691021,0.36648699999204837,5282.588468464107,3972.8557903325104
"147.32.84.165",4239,"113.36.206.49",6667,6,366,3,186,3,180,88113.873795,1.8304999999963911,812.8926522824003,786.6703086603874
"147.32.84.165",4263,"46.4.36.120",443,3,186,3,186,0,0,88115.295945,9.029013999999734,164.80204815277105,0
"147.32.84.165",4217,"217.163.21.37",80,14,6134,7,809,7,5325,88116.299435,0.18682700001227204,34641.67384572292,228018.43415139004
"147.32.84.165",2358,"64.12.90.66",25,3,186,3,186,0,0,88116.34519,8.983051000002888,165.6452802059703,0
"147.32.84.165",2777,"174.37.196.55",80,6,366,3,186,3,180,88117.603589,1.3246329999965383,1123.3300091450906,1087.0935572371843
"147.32.84.165",4276,"86.101.54.123",6667,2,124,2,124,0,0,88118.606476,3.0099040000059176,329.5786177891553,0
"147.32.84.165",4222,"173.241.240.4",80,9,2195,5,1165,4,1030,88118.928355,0.06819200000609271,136672.92349787793,120835.28858610666
"147.32.84.165",2359,"65.55.37.104",25,3,186,3,186,0,0,88118.944601,8.991804000004777,165.48403412699048,0
"147.32.84.165",2778,"72.20.15.61",80,7,424,4,242,3,182,88120.412213,0.370134999990114,5230.523998140432,3933.699866370077
"147.32.84.165",4223,"92.240.244.181",80,10,1760,6,1366,4,394,88120.596976,4.880852000002051,2238.953363059443,645.7888909556519
"147.32.84.165",2363,"200.245.83.211",25,3,186,3,186,0,0,88120.605364,8.936558999994304,166.50704146875194,0
"147.32.84.165",2792,"193.23.181.44",179,6,362,4,242,2,120,88125.328181,0.15284899999096524,12666.095297414018,6280.708411940835
"147.32.84.165",4232,"217.163.21.39",80,11,4108,6,2468,5,1640,88125.388831,0.24780899999313988,79674.26526295081,52944.001228216905
"147.32.84.165",2364,"98.139.175.224",25,3,186,3,186,0,0,88125.428733,9.028363000004902,164.81393138481386,0
"147.32.84.165",2796,"174.128.246.102",80,3,186,3,186,0,0,88125.436626,9.020533000002615,164.95699311776463,0
"147.32.84.165",4255,"184.82.147.251",80,10,1929,5,994,5,935,88125.436656,0.3424079999967944,23223.75645450587,21845.283988896368
"147.32.84.165",2367,"62.146.106.39",25,3,186,3,186,0,0,88125.549791,9.008214000001317,165.18257670163948,0
"147.32.84.165",2797,"193.23.181.44",179,7,422,4,242,3,180,88126.43179,0.19460200000321493,9948.510292638392,7399.718399483101
"147.32.84.165",4272,"217.163.21.37",80,10,1446,5,698,5,748,88126.494463,0.15050699999846984,37101.26439339546,39758.94808919743
"147.32.84.165",2370,"64.12.90.1",25,3,186,3,186,0,0,88126.540474,9.020281000004616,164.96160152873713,0
"147.32.84.165",2802,"193.23.181.44",179,10,774,5,472,5,302,88126.833106,0.19680499999958556,19186.50440795687,12276.110871192743
"147.32.84.165",4332,"212.117.171.138",65500,218,170043,126,163147,92,6896,88126.897766,51.99821800000791,25100.398632887795,1060.9594351866367
"147.32.84.165",4298,"217.163.21.37",80,10,2277,5,1156,5,1121,88126.897798,0.14262899999448564,64839.54876187556,62876.41363500216
"147.32.84.165",2372,"205.188.190.2",25,3,186,3,186,0,0,88126.946329,9.015620999998646,165.04686698788953,0
"147.32.84.165",2812,"193.23.181.44",179,7,422,4,242,3,180,88127.2344,0.12927000000490807,14976.405971427977,11139.475515938166
"147.32.84.165",4343,"64.12.138.161",25,3,186,3,186,0,0,88127.297041,8.965739000006579,165.9651256855579,0
"147.32.84.165",4301,"184.82.147.252",80,10,1514,5,603,5,911,88135.360206,0.36064600000099745,13375.99751553229,20208.181984494055
"147.32.84.165",2374,"65.54.188.94",25,3,186,3,186,0,0,88135.47974,8.909278000006452,167.01690080822738,0
"147.32.84.165",2817,"174.37.196.55",80,6,366,3,186,3,180,88136.363514,1.3241430000052787,1123.7456981565194,1087.495836925664
"147.32.84.165",4354,"58.252.109.242",6667,3,186,3,186,0,0,88137.366394,8.928656000003684,166.65442144925126,0
"147.32.84.165",4397,"46.4.36.120",443,4,246,3,186,1,60,88137.687784,6.400536000001011,232.48052975559622,74.99371927599879
"147.32.84.165",4339,"217.163.21.39",80,13,5695,7,2525,6,3170,88139.97471,0.2623170000006212,77006.06518049598,96676.92143452367
"147.32.84.165",2375,"207.115.21.22",25,3,186,3,186,0,0,88140.020518,8.882706999997026,167.5165014449422,0
"147.32.84.165",2818,"67.19.72.206",80,6,366,3,186,3,180,88141.479566,1.3684750000102213,1087.3417490190805,1052.2662087281424
"147.32.84.165",4403,"27.255.59.70",6667,6,366,3,186,3,180,88142.848183,1.3888430000079097,1071.395398897878,1036.8342569979463
"147.32.84.165",4344,"217.163.21.39",80,14,6320,7,2983,7,3337,88144.23714,0.2078719999990426,114801.41625668638,128425.18472965554
"147.32.84.165",2377,"66.94.237.64",25,3,186,3,186,0,0,88144.283045,8.93365900000208,166.5610921571613,0
"147.32.84.165",2831,"193.23.181.44",179,7,424,4,242,3,182,88146.395142,0.12733900001330767,15203.51188400786,11434.046127642274
"147.32.84.165",4383,"184.82.147.251",80,10,1930,5,1002,5,928,88146.457988,0.34307000000262633,23365.493922344227,21639.898562809823
"147.32.84.165",2378,"98.139.175.224",25,3,186,3,186,0,0,88146.495835,9.02874600001087,164.80693996688007,0
"147.32.84.165",2838,"72.20.15.61",80,7,424,4,242,3,182,88146.571288,0.4012359999906039,4825.090470559315,3628.787048106592
"147.32.84.165",4388,"217.163.21.37",80,14,6137,7,809,7,5328,88146.755927,0.18874399999913294,34289.83172990787,225829.6952496281
"147.32.84.165",2379,"209.85.227.27",25,3,186,3,186,0,0,88146.801773,9.024483000001055,164.88479173818888,0
"147.32.84.165",2847,"72.20.15.61",80,7,424,4,242,3,182,88147.498759,0.366109000009601,5288.042631973619,3976.9576818975147
"147.32.84.165",4441,"222.85.179.42",6667,2,124,2,124,0,0,88147.681383,2.927074999999604,338.9048794445425,0
"147.32.84.165",4425,"173.241.240.4",80,9,2195,5,1165,4,1030,88147.899917,0.06482499999401625,143771.69303293937,127111.45392611805
"147.32.84.165",2380,"24.113.32.85",25,3,186,3,186,0,0,88147.916095,9.013037000011536,165.09418523391122,0
"147.32.84.165",2849,"67.19.72.206",80,6,366,3,186,3,180,88148.201009,1.3646969999972498,1090.3519242754976,1055.1792815569331
"147.32.84.165",4429,"92.240.244.181",80,10,1760,6,1366,4,394,88149.565824,6.97224199998891,1567.3581037516171,452.07839888589837
"147.32.84.165",2381,"64.12.90.34",25,3,186,3,186,0,0,88149.574635,8.959180999998352,166.08660992564762,0
"147.32.84.165",2851,"67.19.72.206",80,6,366,3,186,3,180,88156.126395,1.3571669999946607,1096.4015482294028,1061.033756351035
"147.32.84.165",4439,"184.82.147.252",80,10,1508,5,596,5,912,88156.427398,0.33392400000593625,14278.698146629886,21849.28307001083
"147.32.84.165",2383,"74.125.113.27",25,3,186,3,186,0,0,88156.537904,9.019408000007388,164.97756837242324,0
"147.32.84.165",2860,"174.128.246.102",80,3,186,3,186,0,0,88157.483678,8.9754469999898,165.78561491162404,0
"147.32.84.165",4472,"117.204.73.246",6667,6,366,3,186,3,180,88157.483708,1.8750529999961145,793.5775682090498,767.9782918152094
"147.32.84.165",4471,"46.4.36.120",443,3,186,3,186,0,0,88158.333303,9.028753999999026,164.80679393858338,0
"147.32.84.165",4440,"217.163.21.37",80,10,1448,5,699,5,749,88159.358879,0.1397069999948144,40026.6271568895,42889.762146652705
"147.32.84.165",2384,"74.6.136.65",25,3,186,3,186,0,0,88159.40461,8.960955999995349,166.05371123357511,0
"147.32.84.165",2877,"72.20.15.61",80,7,424,4,242,3,182,88160.941809,0.36639300000388175,5283.943743410734,3973.875046697329
"147.32.84.165",4465,"184.82.147.251",80,10,1921,5,990,5,931,88161.12444,0.36142600000312086,21913.199382256982,20607.261237253788
"147.32.84.165",2385,"65.55.92.184",25,3,186,3,186,0,0,88161.243568,9.027854999992996,164.8232055124007,0
"147.32.84.165",2878,"174.37.196.55",80,6,366,3,186,3,180,88163.951835,1.3240610000066226,1123.8152924922322,1087.5631862828052
"147.32.84.165",4482,"190.114.77.46",6667,2,124,2,124,0,0,88165.255436,3.00984499999322,329.58507830211676,0
"147.32.84.165",4470,"217.163.21.37",80,14,6141,7,810,7,5331,88165.275996,0.1886979999981122,34340.58654604091,226011.93441598036
"147.32.84.165",2386,"216.163.188.57",25,3,186,3,186,0,0,88165.322134,9.638842999993358,154.37537472091051,0
"147.32.84.165",2890,"174.128.246.102",80,3,186,3,186,0,0,88167.562755,9.555416999995941,155.72318821885347,0
"147.32.84.165",4477,"217.163.21.39",80,11,4094,6,2466,5,1628,88167.562824,0.23170200000458863,85143.8485624177,56210.13197875751
"147.32.84.165",2387,"205.188.146.193",25,3,186,3,186,0,0,88167.608603,9.512768999993568,156.42133221157857,0
"147.32.84.165",2900,"174.37.196.55",80,6,366,3,186,3,180,88167.864201,1.3249399999913294,1123.0697239193757,1086.8416683090734
"147.32.84.165",4492,"212.117.171.138",65500,49,4803,24,2257,25,2546,88168.968056,96.04945099999895,187.98649874636135,212.05743279053434
"147.32.84.165",4480,"184.82.147.252",80,10,1499,5,599,5,900,88168.968119,0.36484599999675993,13134.308722152788,19734.353672683654
"147.32.84.165",2388,"212.23.3.96",25,3,186,3,186,0,0,88169.08884,9.613731999997981,154.778602107934,0
"147.32.84.165",2912,"174.128.246.102",80,3,186,3,186,0,0,88169.189257,9.568488999997498,155.51044684279714,0
"147.32.84.165",4503,"65.55.196.251",443,147,166051,71,5632,76,160419,88169.189296,9.783334000007017,4605.382991111996,131177.3675517037
"147.32.84.165",4487,"217.163.21.37",80,10,1451,5,701,5,750,88169.288293,0.13923699999577366,40276.65060415136,43091.99422698077
"147.32.84.165",2389,"66.94.238.147",25,3,186,3,186,0,0,88169.334315,9.426628999994136,157.8507014544569,0
"147.32.84.165",2923,"67.19.72.206",80,6,366,3,186,3,180,88171.303771,2.9573469999886584,503.1536711808613,486.9229075943819
"147.32.84.165",4512,"222.252.117.126",6667,2,124,2,124,0,0,88174.964195,3.0187839999998687,328.60913533397655,0
"147.32.84.165",4502,"217.163.21.37",80,10,2274,5,1154,5,1120,88177.986145,0.8269560000044294,11163.834593316393,10834.917456251613
"147.32.84.165",2390,"205.188.190.2",25,3,186,3,186,0,0,88178.705792,8.31947700001183,178.8573969250572,0
"147.32.84.165",2930,"174.37.196.55",80,6,366,3,186,3,180,88178.999649,1.324414999995497,1123.5149103604679,1087.272493897227
"147.32.84.165",4523,"173.192.170.88",80,12,4368,7,645,5,3723,88179.300494,7.635229999999865,675.8146120025318,3900.864806954149
"147.32.84.165",4524,"46.4.36.120",443,3,186,3,186,0,0,88180.303965,9.02831100000185,164.81488065704596,0
"147.32.84.165",4504,"217.163.21.39",80,15,7877,7,2513,8,5364,88180.32418,0.1884859999991022,106660.44162481966,227666.77631338348
"147.32.84.165",2392,"98.139.175.224",25,3,186,3,186,0,0,88180.370165,8.962171000006492,166.0311993599455,0
"147.32.84.165",2937,"67.19.72.206",80,6,366,3,186,3,180,88182.209383,1.3682770000013988,1087.4990955767573,1052.4184795904102
"147.32.84.165",4526,"61.17.216.28",6667,2,124,2,124,0,0,88182.510506,3.009953000000678,329.5732524726388,0
"147.32.84.165",4505,"184.82.147.251",80,10,1925,5,990,5,935,88183.577843,0.3613399999885587,21918.414790089042,20700.72507952854
"147.32.84.165",2395,"209.85.227.27",25,3,186,3,186,0,0,88183.697153,8.94623600000341,166.32693347229304,0
"147.32.84.165",2940,"174.128.246.102",80,3,186,3,186,0,0,88186.222436,9.02883500000462,164.80531541436284,0
"147.32.84.165",4506,"217.163.21.39",80,11,4098,6,2468,5,1630,88186.222509,0.2852030000067316,69227.88329552629,45721.81919437109
"147.32.84.165",2399,"209.85.227.27",25,3,186,3,186,0,0,88186.268658,8.982674999992014,165.6522138451322,0
"147.32.84.165",2941,"67.19.72.206",80,6,366,3,186,3,180,88186.268688,1.4136890000081621,1052.5653096200147,1018.6115899548529
"147.32.84.165",4525,"217.163.21.39",80,14,6316,7,2981,7,3335,88187.682529,0.2031669999996666,117381.26762731711,131320.53926102066
"147.32.84.165",2400,"208.43.37.100",25,3,186,3,186,0,0,88187.728399,9.02757500000007,164.8283176822113,0
"147.32.84.165",2942,"193.23.181.44",80,6,364,4,242,2,122,88188.529656,0.14201700000558048,13632.170795918277,6872.416682239792
"147.32.84.165",4528,"184.82.147.252",80,10,1515,5,603,5,912,88188.600096,0.34152200000244193,14125.005124019852,21363.191829363357
"147.32.84.165",2401,"65.55.92.152",25,3,186,3,186,0,0,88188.713282,8.945868000009796,166.33377554848457,0
"147.32.84.165",2943,"67.19.72.206",80,6,366,3,186,3,180,88189.031366,1.3574900000094203,1096.1406713785545,1060.7812948824721
"147.32.84.165",4531,"217.163.21.39",80,13,5539,7,2515,6,3024,88190.034572,0.24429599998984486,82359.10535103468,99027.40937635343
"147.32.84.165",2402,"64.12.90.34",25,3,186,3,186,0,0,88190.08105,8.982131000011577,165.6622465201278,0
"147.32.84.165",2944,"174.37.196.55",80,6,366,3,186,3,180,88190.235738,1.3242059999902267,1123.692235204328,1087.4440985848335
"147.32.84.165",4533,"217.163.21.37",80,10,2277,5,1156,5,1121,88190.389092,0.13926100000389852,66407.68054043206,64397.06737528057
"147.32.84.165",2403,"66.94.238.147",25,3,186,3,186,0,0,88190.434933,8.929088999997475,166.64633984501899,0
"147.32.84.165",2947,"72.20.15.61",80,7,424,4,242,3,182,88191.560098,0.3668400000024121,5277.50517933505,3969.032820822228
"147.32.84.165",4534,"173.241.240.4",80,9,2194,5,1164,4,1030,88191.74316,0.0651380000053905,142958.02756040078,126500.66012647147
"147.32.84.165",2404,"74.125.113.27",25,3,186,3,186,0,0,88191.760059,9.008632000011858,165.17491223951,0
"147.32.84.165",2955,"174.37.196.55",80,6,366,3,186,3,180,88199.063118,1.3252379999903496,1122.817184544086,1086.5972753652447
"147.32.84.165",4543,"93.180.230.38",6667,2,122,1,62,1,60,88199.063212,0.11253900000883732,4407.36100339483,4265.188067801448
"147.32.84.165",4547,"94.100.176.20",25,3,186,3,186,0,0,88200.388476,8.907457000008435,167.05104498383668,0
"147.32.84.165",4536,"92.240.244.181",80,10,1758,6,1364,4,394,88201.370415,7.4303190000064205,1468.577594042809,424.20789739946247
"147.32.84.165",2405,"205.188.190.2",25,3,186,3,186,0,0,88201.37048,8.92846300000383,166.65802389497068,0
"147.32.84.165",2964,"72.20.15.61",80,7,424,4,242,3,182,88201.378817,0.37040099999285303,5226.767746408232,3930.8749167202404
"147.32.84.165",4537,"217.163.21.37",80,14,6141,7,810,7,5331,88201.563553,0.18750499999441672,34559.0784256044,227449.93467518155
"147.32.84.165",2408,"209.85.227.27",25,3,186,3,186,0,0,88201.609543,8.890371999994386,167.3720739695639,0
"147.32.84.165",2973,"174.128.246.102",80,3,186,3,186,0,0,88201.609574,8.890405999991344,167.3714338806854,0
"147.32.84.165",4539,"195.113.232.96",80,28,31964,18,1797,10,30167,88201.609597,67.5443249999953,212.83801414850177,3573.001876915889
"147.32.84.165",2410,"77.238.177.9",25,3,186,3,186,0,0,88201.61036,8.889643999995315,167.38578057802812,0
"147.32.84.165",2979,"67.19.72.206",80,6,366,3,186,3,180,88204.580835,1.3647469999996247,1090.311977238572,1055.1406231341018
"147.32.84.165",4554,"113.255.129.49",6667,6,366,3,186,3,180,88205.945708,2.018817999996827,737.0649558317484,713.2886669339501
"147.32.84.165",4553,"46.4.36.120",443,4,246,3,186,1,60,88207.964664,8.993654999998398,165.4499755661369,53.37095986004417
"147.32.84.165",4540,"217.163.21.39",80,14,6315,7,2978,7,3337,88208.69384,0.20882599998731166,114085.41082742358,127838.48755242191
"147.32.84.165",2411,"87.54.12.92",25,3,186,3,186,0,0,88208.73993,8.982881000003545,165.64841502402322,0
"147.32.84.165",2984,"72.20.15.61",80,7,424,4,242,3,182,88209.095371,0.37026399999740534,5228.701683160034,3932.329365021182
"147.32.84.165",4542,"184.82.147.251",80,10,1929,5,994,5,935,88209.280057,0.35239000000001397,22565.907091573783,21226.482022758035
"147.32.84.165",2412,"65.55.92.136",25,3,186,3,186,0,0,88209.396697,9.02844300000288,164.81247098746985,0
"147.32.84.165",2986,"193.23.181.44",80,6,364,4,242,2,122,88209.596858,0.13077599999087397,14803.939561808751,7463.143084878791
"147.32.84.165",4551,"217.163.21.37",80,10,1451,5,701,5,750,88209.661648,0.13956500000494998,40181.99405152509,42990.721167822856
"147.32.84.165",2413,"207.115.21.22",25,3,186,3,186,0,0,88209.707572,9.018571000007796,164.9928796922166,0
"147.32.84.165",3026,"174.128.246.102",80,3,186,3,186,0,0,88211.001547,9.029125999993994,164.80000389860433,0
"147.32.84.165",4565,"59.90.211.177",6667,2,124,2,124,0,0,88211.001621,3.0092920000024606,329.64564422435205,0
"147.32.84.165",4557,"173.241.240.4",80,9,2195,5,1165,4,1030,88211.302292,0.06467900000279769,144096.22906348063,127398.38277715453
"147.32.84.165",2414,"202.108.252.141",25,3,186,3,186,0,0,88211.3188,9.01270600000862,165.10024847127787,0
"147.32.84.165",3034,"193.23.181.44",179,6,364,4,242,2,122,88212.706624,0.13826999999582767,14001.59109031908,7058.653359582346
"147.32.84.165",4558,"92.240.244.181",80,10,1760,6,1366,4,394,88212.775939,1.372828000006848,7960.210601725408,2295.990466383463
"147.32.84.165",2415,"205.188.190.2",25,3,186,3,186,0,0,88212.784761,8.950585999991745,166.2460983003093,0
"147.32.84.165",3065,"174.37.196.55",80,6,366,3,186,3,180,88212.784793,1.2474119999969844,1192.8697174659192,1154.390049160567
"147.32.84.165",4561,"184.82.147.252",80,10,1515,5,603,5,912,88214.032317,0.3518999999942025,13708.439897924054,20733.162830691104
"147.32.84.165",2416,"74.6.136.65",25,3,186,3,186,0,0,88214.148607,8.991708000001381,165.48580091788696,0
"147.32.84.165",3067,"174.128.246.102",80,3,186,3,186,0,0,88216.958432,8.990594000002602,165.50630581244903,0
"147.32.84.165",4563,"217.163.21.39",80,13,5699,7,2528,6,3171,88216.958463,0.26257999999506865,77020.3366607503,96610.55678450919
"147.32.84.165",2418,"205.188.159.42",25,3,186,3,186,0,0,88217.004269,8.944818999996642,166.3532822744159,0
"147.32.84.165",3068,"67.19.72.206",80,6,366,3,186,3,180,88221.334118,1.3569359999964945,1096.5881957615127,1061.2143829950123
"147.32.84.165",4574,"80.75.1.194",6667,2,124,2,124,0,0,88222.337401,3.0095799999980954,329.6140989774745,0
"147.32.84.165",4571,"46.4.36.120",443,5,306,3,186,2,120,88222.53804,1.0033839999960037,1482.9815903043366,956.7623163253784
"147.32.84.165",4568,"217.163.21.37",80,14,6141,7,810,7,5331,88222.691177,0.18709700000181329,34634.44095809766,227945.93178718348
"147.32.84.165",2420,"203.142.24.35",25,3,186,3,186,0,0,88222.736961,8.930775000000722,166.61487944773882,0
"147.32.84.165",3070,"193.23.181.44",179,6,364,4,242,2,122,88227.654608,0.12752399999590125,15181.456040135387,7653.46130948974
"147.32.84.165",4575,"74.125.93.27",25,3,186,3,186,0,0,88227.71764,8.865145999996457,167.8483354927933,0
"147.32.84.165",4570,"184.82.147.251",80,10,1929,5,994,5,935,88229.761727,0.33421200000157114,23793.28091140539,22381.003674209293
"147.32.84.165",2421,"68.1.17.3",25,3,186,3,186,0,0,88229.872201,8.918030999993789,166.85297460852473,0
"147.32.84.165",3080,"67.19.72.206",80,6,366,3,186,3,180,88230.463625,1.3559989999921527,1097.3459420018828,1061.9476858082737
"147.32.84.165",4584,"212.117.171.138",65500,48,4769,24,2257,24,2512,88230.764488,118.07174200000009,152.92397396830128,170.2016050546623
"147.32.84.165",4578,"217.163.21.37",80,10,1451,5,701,5,750,88230.76456,0.13863100000889972,40452.7125941527,43280.36297519903
"147.32.84.165",2422,"98.139.175.224",25,3,186,3,186,0,0,88230.81038,8.883010000005015,167.51078744695323,0
"147.32.84.165",3094,"193.23.181.44",80,6,364,4,242,2,122,88231.819773,0.18674600000667851,10367.022586458417,5226.350229536888
"147.32.84.165",4590,"64.12.168.40",587,32,3766,14,1873,18,1893,88231.886193,33.22637200000463,450.9670812088034,455.7825332238467
"147.32.84.165",4592,"184.82.147.252",80,10,1515,5,603,5,912,88232.004346,0.35060399999201763,13759.11284557458,20809.80251270981
"147.32.84.165",2423,"17.148.17.43",25,3,186,3,186,0,0,88232.118584,8.878659000009065,167.5928763564949,0
"147.32.84.165",3101,"174.128.246.102",80,3,186,3,186,0,0,88232.36958,8.928438000002643,166.65849054443336,0
"147.32.84.165",4599,"74.115.3.63",6667,2,124,2,124,0,0,88232.369642,2.909531999990577,340.9483037145537,0
"147.32.84.165",4597,"217.163.21.39",80,12,4158,6,2468,6,1690,88235.077998,0.2446300000010524,80709.64313418248,55267.1381267295
"147.32.84.165",2425,"212.77.101.4",25,3,186,3,186,0,0,88235.123897,8.983091000001878,165.6445426189815,0
"147.32.84.165",3106,"174.37.196.55",80,6,366,3,186,3,180,88235.479467,1.3254410000081407,1122.6452176980047,1086.4308558367786
"147.32.84.165",4611,"46.4.36.120",443,4,246,3,186,1,60,88236.805061,6.499739999999292,228.93223421247035,73.84910781047431
"147.32.84.165",4603,"217.163.21.37",80,14,6141,7,810,7,5331,88237.686501,0.18777899999986403,34508.65112714783,227118.0483442285
"147.32.84.165",2427,"205.188.159.42",25,3,186,3,186,0,0,88237.732353,8.982759999998962,165.65064634924812,0
"147.32.84.165",3113,"72.20.15.61",80,7,424,4,242,3,182,88237.73239,0.36772699998982716,5264.775227420227,3959.459055332567
"147.32.84.165",4606,"217.163.21.37",80,10,2277,5,1156,5,1121,88237.887102,0.13885300001129508,66602.81016072909,64586.289091848885
"147.32.84.165",2428,"209.85.227.27",25,3,186,3,186,0,0,88237.916514,8.999597000001813,165.34073692407563,0
"147.32.84.165",3117,"193.23.181.44",179,7,422,4,242,3,180,88237.932841,0.17849599999317434,10846.181427449535,8067.407673309573
"147.32.84.165",4612,"217.163.21.37",80,10,1451,5,701,5,750,88237.99549,0.13845199999923352,40505.01256775667,43336.31872441869
"147.32.84.165",2429,"65.55.92.184",25,3,186,3,186,0,0,88237.995521,9.020850000000792,164.95119639500373,0
"147.32.84.165",3153,"72.20.15.61",80,7,424,4,242,3,182,88243.605649,0.3762690000003204,5145.25512332494,3869.5720348972686
"147.32.84.165",4618,"61.17.216.16",6667,2,124,2,124,0,0,88243.788414,2.9266400000051362,338.9552524390629,0
"147.32.84.165",4613,"217.163.21.39",80,14,6320,7,2983,7,3337,88247.718696,0.20825399999739602,114590.83619185413,128189.61460684454
"147.32.84.165",2430,"209.85.227.27",25,3,186,3,186,0,0,88247.764442,8.982990999997128,165.64638659890406,0
"147.32.84.165",3157,"72.20.15.61",80,7,424,4,242,3,182,88247.764476,0.36603800000739284,5289.068347988184,3977.7290881564027
"147.32.84.165",4614,"184.82.147.251",80,10,1929,5,994,5,935,88247.947098,0.33535500000289176,23712.185594165676,22304.7218617152
"147.32.84.165",2431,"66.94.238.147",25,3,186,3,186,0,0,88248.057232,8.99102899999707,165.49829835945195,0
"147.32.84.165",3158,"174.128.246.102",80,3,186,3,186,0,0,88248.621136,9.029026000003796,164.80182912302772,0
"147.32.84.165",4615,"217.163.21.39",80,11,4098,6,2468,5,1630,88248.621199,0.28068599999824073,70341.94794226912,46457.607433508376
"147.32.84.165",2432,"87.54.12.92",25,3,186,3,186,0,0,88248.666934,8.983287000010023,165.6409285374429,0
"147.32.84.165",3396,"67.19.72.206",80,6,366,3,186,3,180,88250.828433,1.3582969999988563,1095.4894253622388,1060.1510568021665
"147.32.84.165",4645,"116.111.184.69",6667,2,124,2,124,0,0,88251.731523,3.0097160000004806,329.5992047089631,0
"147.32.84.165",4636,"74.125.39.27",25,3,186,3,186,0,0,88252.186841,8.97440700000152,165.80482699299776,0
"147.32.84.165",4634,"173.241.240.4",80,9,2195,5,1165,4,1030,88253.035614,0.07374800000980031,126376.30849326725,111731.84356057104
"147.32.84.165",2433,"65.54.188.126",25,3,186,3,186,0,0,88253.051893,9.012519000010798,165.10367412243096,0
"147.32.84.165",3465,"193.23.181.44",179,10,753,5,451,5,302,88255.342932,0.1917410000023665,18817.050082952886,12600.33065421679
"147.32.84.165",4635,"184.82.147.252",80,10,1515,5,603,5,912,88255.405618,0.3518320000002859,13711.089383558288,20737.17001294388
"147.32.84.165",2434,"64.12.90.33",25,3,186,3,186,0,0,88255.521983,8.95043500000611,166.24890298616594,0
"147.32.84.165",3476,"193.23.181.44",80,7,424,4,242,3,182,88256.145758,0.12542300000495743,15435.765369377852,11608.716104242847
"147.32.84.165",4637,"217.163.21.37",80,10,2277,5,1156,5,1121,88256.208159,0.1390149999933783,66525.19512599727,64511.02399328974
"147.32.84.165",2435,"94.84.48.26",25,3,186,3,186,0,0,88256.253969,9.020680000001448,164.95430499693606,0
"147.32.84.165",3484,"174.37.196.55",80,6,366,3,186,3,180,88257.750906,1.3247839999967255,1123.2019710410739,1086.9696493945876
"147.32.84.165",4664,"46.4.36.120",443,4,246,3,186,1,60,88258.954811,8.96604600000137,165.9594429919022,53.53530419093619
"147.32.84.165",4658,"217.163.21.37",80,14,6141,7,810,7,5331,88259.054982,0.19838899999740534,32663.10128124417,214971.59621026256
"147.32.84.165",2436,"74.6.136.65",25,3,186,3,186,0,0,88259.075836,8.90733299999556,167.05337052075427,0
"147.32.84.165",3485,"67.19.72.206",80,6,366,3,186,3,180,88259.100907,1.418571999995038,1048.9421756563677,1015.1053312803559
"147.32.84.165",4662,"184.82.147.251",80,10,1909,5,994,5,915,88260.519621,0.36304999999993015,21903.319102056274,20162.512050685604
"147.32.84.165",2439,"98.139.175.224",25,3,186,3,186,0,0,88260.638912,8.848953000007896,168.1554868693135,0
"147.32.84.165",3499,"174.37.196.55",80,6,366,3,186,3,180,88267.782444,1.3254699999961304,1122.620655317996,1086.407085791609
"147.32.84.165",4678,"81.199.182.101",6667,2,122,1,62,1,60,88267.920986,0.5572939999983646,890.0149651735987,861.3048050067084
"147.32.84.165",4703,"46.4.36.120",443,3,186,3,186,0,0,88268.987122,9.028536999991047,164.81075505383382,0
"147.32.84.165",4663,"217.163.21.39",80,14,6320,7,2983,7,3337,88269.108052,0.20847300000605173,114470.45900096057,128054.95195648858
"147.32.84.165",2444,"207.115.36.20",25,3,186,3,186,0,0,88269.15377,8.961704999994254,166.03983282209737,0
"147.32.84.165",3502,"193.23.181.44",179,6,364,4,242,2,122,88269.588678,0.13603900000452995,14231.213107531908,7174.413219499557
"147.32.84.165",4673,"217.163.21.37",80,10,1451,5,701,5,750,88269.655713,0.13842400000430644,40513.20580120161,43345.08466605023
"147.32.84.165",2445,"64.12.90.1",25,3,186,3,186,0,0,88269.701372,9.015750999999,165.04448714257583,0
"147.32.84.165",3517,"193.23.181.44",80,6,364,4,242,2,122,88273.099213,0.12202200001047458,15865.991377241893,7998.55763646079
"147.32.84.165",4722,"86.123.31.54",6667,6,366,3,186,3,180,88273.15964,1.094771000003675,1359.1883599355526,1315.34357413118
"147.32.84.165",4726,"66.111.4.71",25,3,186,3,186,0,0,88274.002468,9.02883299998939,164.80535192108974,0
"147.32.84.165",4677,"184.82.147.252",80,10,1477,5,588,5,889,88274.254525,0.35208300000522286,13360.486021563722,20199.7824373642
"147.32.84.165",2447,"91.121.35.190",25,3,186,3,186,0,0,88274.371062,8.961117999991984,166.05070929780535,0
"147.32.84.165",3543,"193.23.181.44",179,7,424,4,242,3,182,88276.410151,0.13340799999423325,14511.87335155078,10913.888223067115
"147.32.84.165",4702,"184.82.147.251",80,10,1926,5,998,5,928,88276.472105,0.36047600000165403,22148.492548639482,20594.99106727198
"147.32.84.165",2448,"208.65.144.13",25,3,186,3,186,0,0,88276.591277,8.94784300000174,166.29706176110943,0
"147.32.84.165",3553,"174.37.196.55",80,6,366,3,186,3,180,88277.212739,1.3246210000070278,1123.340185601848,1087.1034054211432
"147.32.84.165",4741,"201.160.226.207",6667,2,124,2,124,0,0,88277.814407,3.009548000001814,329.6176037064044,0
"147.32.84.165",4708,"173.241.240.4",80,9,2195,5,1165,4,1030,88278.537628,0.06559800000104588,142077.5023606117,125613.58577805152
"147.32.84.165",2451,"64.12.90.97",25,3,186,3,186,0,0,88278.553922,8.99165099998936,165.48684996801597,0
"147.32.84.165",3556,"174.128.246.102",80,3,186,3,186,0,0,88280.022,9.029301000002306,164.79680985268072,0
"147.32.84.165",4711,"217.163.21.39",80,11,4098,6,2468,5,1630,88280.022063,0.22901599999750033,86212.31704429167,56939.25315323964
"147.32.84.165",2453,"209.85.227.27",25,3,186,3,186,0,0,88280.067804,8.983554999998887,165.63598708976394,0
"147.32.84.165",3557,"174.37.196.55",80,6,366,3,186,3,180,88281.526569,1.3247289999999339,1123.2486040541683,1087.0147781169371
"147.32.84.165",4734,"217.163.21.39",80,16,7929,8,2562,8,5367,88282.851412,0.19122100000095088,107184.88032118899,224536.00807331043
"147.32.84.165",2454,"207.115.21.22",25,3,186,3,186,0,0,88282.897306,8.961897000001045,166.03627557868904,0
"147.32.84.165",3558,"72.20.15.61",80,7,424,4,242,3,182,88290.054102,0.370095999998739,5231.075180511533,3934.114391954955
"147.32.84.165",4785,"178.137.128.94",6667,2,124,2,124,0,0,88290.153665,3.009686999997939,329.6023805800003,0
"147.32.84.165",4738,"184.82.147.252",80,10,1508,5,596,5,912,88290.238581,0.36069299999508075,13218.997873718168,20227.72828998485
"147.32.84.165",2456,"69.13.193.154",25,3,186,3,186,0,0,88290.358099,8.92544999999518,166.7142833135364,0
"147.32.84.165",3559,"174.37.196.55",80,6,366,3,186,3,180,88290.755736,1.3250999999872874,1122.9341181905331,1086.7104369585804
"147.32.84.165",4800,"46.4.36.120",443,4,246,3,186,1,60,88292.080976,6.399635000008857,232.51326052156736,75.00427758760237
"147.32.84.165",4756,"217.163.21.37",80,10,2277,5,1156,5,1121,88293.865927,0.13947499998903368,66305.78957323628,64298.261342212696
"147.32.84.165",2457,"65.54.188.126",25,3,186,3,186,0,0,88293.911766,8.882696000000578,167.5167088910735,0
"147.32.84.165",3566,"72.20.15.61",80,11,1518,6,536,5,982,88295.069491,0.5178789999918081,8279.926392203253,15169.56663646193
"147.32.84.165",4824,"216.157.130.15",25,3,186,3,186,0,0,88295.253937,8.844958000001498,168.2314376167471,0
"147.32.84.165",4764,"217.163.21.39",80,13,5533,7,2505,6,3028,88295.370957,0.27191499999025837,73699.50168515144,89086.66311482577
"147.32.84.165",2459,"64.12.90.1",25,3,186,3,186,0,0,88295.417006,8.88191499999084,167.5314388846926,0
"147.32.84.165",3589,"174.37.196.55",80,6,366,3,186,3,180,88297.476958,1.3249260000011418,1123.0815909709054,1086.853152552489
"147.32.84.165",4829,"116.73.89.104",6667,2,124,2,124,0,0,88298.802,2.988937000001897,331.8905684527209,0
"147.32.84.165",4780,"184.82.147.251",80,10,1925,5,990,5,935,88299.483583,0.3446620000031544,22979.034532172143,21702.421502607023
"147.32.84.165",2460,"212.77.101.4",25,3,186,3,186,0,0,88299.597398,9.015274999997928,165.0532013721536,0
"147.32.84.165",3594,"67.19.72.206",80,6,366,3,186,3,180,88300.988477,1.3639779999939492,1090.9266865056481,1055.735503069982
"147.32.84.165",4798,"217.163.21.37",80,14,6141,7,810,7,5331,88302.35257,0.18747399999119807,34564.792986250024,227487.54495024553
"147.32.84.165",2461,"119.205.212.219",25,3,186,3,186,0,0,88302.398397,9.023727000007057,164.89860564252845,0
"147.32.84.165",3598,"72.20.15.61",80,7,424,4,242,3,182,88303.797426,0.448815999989165,4313.571708777623,3244.091119824493
"147.32.84.165",4819,"217.163.21.39",80,14,6320,7,2983,7,3337,88303.897712,0.2625289999996312,90900.43385695876,101687.81353693307
"147.32.84.165",2464,"65.54.188.126",25,3,186,3,186,0,0,88303.943445,8.982887999998638,165.6482859410276,0
"147.32.84.165",3607,"72.20.15.61",80,7,424,4,242,3,182,88303.943474,0.4138470000034431,4678.057349657948,3518.2084199906885
"147.32.84.165",4827,"195.113.232.96",80,20,19434,13,1489,7,17945,88303.943498,60.44362100001308,197.07621421286825,2375.105885862942
"147.32.84.165",2466,"208.65.145.12",25,3,186,3,186,0,0,88304.010647,8.915750999993179,166.89564345181225,0
"147.32.84.165",3612,"67.19.72.206",80,6,366,3,186,3,180,88304.055448,1.4010319999943022,1062.0742424199102,1027.8137829870097
"147.32.84.165",4841,"184.82.147.252",80,10,1515,5,603,5,912,88305.456597,0.34307499999704305,14061.06536483736,21266.486919953026
"147.32.84.165",2468,"74.6.136.65",25,3,186,3,186,0,0,88305.569798,8.962263000008534,166.02949500573496,0
"147.32.84.165",3631,"193.23.181.44",80,8,855,5,469,3,386,88310.518931,0.13034499999776017,28785.147110088412,23690.973954145258
"147.32.84.165",4871,"178.133.29.206",6667,3,184,2,124,1,60,88310.583449,0.7384410000086064,1343.3706958151545,650.018078620236
"147.32.84.165",4853,"217.163.21.37",80,10,1451,5,701,5,750,88311.321961,0.13953100000799168,40191.785335723245,43001.19686418321
"147.32.84.165",2472,"64.12.90.98",25,3,186,3,186,0,0,88311.367791,8.982334000000264,165.65850256736792,0
"147.32.84.165",3633,"193.23.181.44",179,6,364,4,242,2,122,88313.929728,0.1373559999919962,14094.761059675671,7105.6233441340155
"147.32.84.165",4889,"46.4.36.120",443,3,186,3,186,0,0,88313.996997,8.961580000002868,166.0421488174545,0
"147.32.84.165",4857,"173.241.240.4",80,9,2195,5,1165,4,1030,88314.832383,0.06874000000243541,135583.35757448064,119871.9813748627
"147.32.84.165",2473,"65.55.92.184",25,3,186,3,186,0,0,88314.848721,9.012902999995276,165.09663978418274,0
"147.32.84.165",3638,"174.128.246.102",80,3,186,3,186,0,0,88316.136844,9.029269000006025,164.79739389744697,0
"147.32.84.165",4879,"212.117.171.138",65500,51,5073,23,2255,28,2818,88316.136905,152.5445039999904,118.26057004322577,147.7863797702041
"147.32.84.165",4863,"217.163.21.37",80,14,6135,7,810,7,5325,88316.136934,0.1869799999985844,34656.11295351941,227831.85367591464
"147.32.84.165",2477,"64.12.138.161",25,3,186,3,186,0,0,88316.182725,8.983411999986856,165.63862372138527,0
"147.32.84.165",3660,"174.128.246.102",80,3,186,3,186,0,0,88316.337432,9.028707999998005,164.80763360608503,0
"147.32.84.165",4901,"64.12.175.136",587,30,3672,14,1899,16,1773,88316.337501,32.59336699999403,466.10710700747126,435.1805691017622
"147.32.84.165",4872,"184.82.147.251",80,10,1929,5,994,5,935,88316.455136,0.3519569999916712,22593.669113522898,21252.59619833391
"147.32.84.165",2478,"66.94.238.147",25,3,186,3,186,0,0,88316.571493,8.9954340000113,165.41725502050605,0
"147.32.84.165",3665,"67.19.72.206",80,6,366,3,186,3,180,88320.650895,1.3664459999999963,1088.956314409793,1053.8286913643158
"147.32.84.165",4916,"220.194.21.2",6667,1,62,1,62,0,0,88322.017605,0,0,0
"147.32.84.165",4882,"217.163.21.39",80,13,5700,7,2533,6,3167,88323.460505,0.2393620000075316,84658.38353357001,105848.04605243437
"147.32.84.165",2482,"168.95.6.70",25,3,186,3,186,0,0,88323.50936,8.879112000009627,167.58432599998588,0
"147.32.84.165",3667,"67.19.72.206",80,6,366,3,186,3,180,88323.961941,1.3563629999989644,1097.0514530410635,1061.6626964913519
"147.32.84.165",4907,"217.163.21.37",80,10,1447,5,699,5,748,88324.964787,0.13885599999048281,40271.936397298465,43095.00490011338
"147.32.84.165",2484,"74.6.136.65",25,3,186,3,186,0,0,88325.010864,8.882450999997673,167.52132941689067,0
"147.32.84.165",3672,"193.23.181.44",80,6,364,4,242,2,122,88325.010897,0.123808000003919,15637.11553323467,7883.173946506735
"147.32.84.165",4908,"184.82.147.252",80,10,1515,5,603,5,912,88325.072226,0.34136199999193195,14131.625664584853,21373.204985242763
"147.32.84.165",2485,"207.115.21.22",25,3,186,3,186,0,0,88325.18518,8.908987000002526,167.02235618927025,0
"147.32.84.165",3698,"174.128.246.102",80,3,186,3,186,0,0,88325.318418,8.876742000007653,167.62906931379973,0
"147.32.84.165",4936,"184.82.147.251",80,10,1926,5,998,5,928,88325.318449,0.36111300000629853,22109.42281186427,20558.661692795635
"147.32.84.165",2488,"212.82.111.207",25,3,186,3,186,0,0,88325.437773,8.85719500000414,167.99901097348592,0
"147.32.84.165",3704,"67.19.72.206",80,6,366,3,186,3,180,88326.570152,1.364650999996229,1090.3886781339052,1055.214849807005
"147.32.84.165",4949,"121.243.139.53",6667,2,124,2,124,0,0,88327.934935,2.848748999997042,348.2230270202921,0
"147.32.84.165",4964,"147.32.84.171",139,23,3231,12,1699,11,1532,88332.289018,0.6879180000105407,19758.168851217346,17816.076915871086
"147.32.84.165",4937,"217.163.21.39",80,11,4099,6,2471,5,1628,88332.289236,0.2963630000012927,66701.98371562501,43946.10663255262
"147.32.84.165",2489,"205.188.59.194",25,3,186,3,186,0,0,88332.335015,8.981850999989547,165.66741087129276,0
"147.32.84.165",3707,"193.23.181.44",80,6,364,4,242,2,122,88333.993636,0.12522699999681208,15459.924776999249,7793.84637518144
"147.32.84.165",4939,"217.163.21.37",80,14,6141,7,810,7,5331,88334.055888,0.18744599999627098,34569.95614805817,227521.52620407174
"147.32.84.165",2490,"205.188.190.2",25,3,186,3,186,0,0,88334.101743,9.020818999997573,164.9517632490354,0
"147.32.84.165",3711,"193.23.181.44",80,6,364,4,242,2,122,88334.89663,0.1417490000021644,13657.944676649844,6885.410126244963
"147.32.84.165",4942,"184.82.147.252",80,10,1507,5,596,5,911,88334.967146,0.3467240000027232,13751.571855315906,21019.60060435032
"147.32.84.165",2491,"74.125.159.27",25,3,186,3,186,0,0,88335.081873,8.94419399999606,166.36490666466486,0
"147.32.84.165",3735,"72.20.15.61",80,7,424,4,242,3,182,88335.799689,0.36656399999628775,5281.478814121426,3972.0212569012374
"147.32.84.165",4982,"46.4.36.120",443,4,246,3,186,1,60,88335.982396,8.984624999997322,165.6162611127836,53.42460035896246
"147.32.84.165",4971,"217.163.21.37",80,10,2273,5,1154,5,1119,88337.103446,0.13937699999951292,66237.61452773602,64228.67474569896
"147.32.84.165",2492,"64.12.90.66",25,3,186,3,186,0,0,88337.149376,8.98338399999193,165.6391399946097,0
"147.32.84.165",3739,"174.37.196.55",80,6,366,3,186,3,180,88337.505047,1.3249570000043605,1123.0553142442382,1086.827723462166
"147.32.84.165",4987,"79.113.153.241",6667,2,124,2,124,0,0,88338.830147,2.9886549999937415,331.92188459426643,0
"147.32.84.165",4973,"184.82.147.251",80,10,1925,5,990,5,935,88344.026007,0.3529780000098981,22437.659003614703,21191.122392302772
"147.32.84.165",2494,"74.6.136.65",25,3,186,3,186,0,0,88344.1429,9.01210199999332,165.11131365369621,0
"147.32.84.165",3741,"174.128.246.102",80,3,186,3,186,0,0,88344.427165,9.035424999994575,164.6851144247109,0
"147.32.84.165",4978,"217.163.21.37",80,10,1451,5,701,5,750,88344.427234,0.13880400000198279,40402.293881443555,43226.41998727912
"147.32.84.165",2495,"66.104.196.196",25,3,186,3,186,0,0,88344.473069,8.99269300000742,165.46767469975592,0
"147.32.84.165",3743,"67.19.72.206",80,6,366,3,186,3,180,88344.967136,1.3202649999875575,1127.0464641674384,1090.6901266136501
"147.32.84.165",1044,"46.4.36.120",443,3,186,3,186,0,0,88346.13279,9.028427999990527,164.81274481023289,0
"147.32.84.165",4984,"217.163.21.37",80,14,6137,7,809,7,5328,88346.287526,0.18668199999956414,34668.580795229915,228324.10194930158
"147.32.84.165",2503,"65.55.88.22",25,3,186,3,186,0,0,88346.333157,9.028667000005953,164.80838201242983,0
"147.32.84.165",3760,"174.37.196.55",80,6,366,3,186,3,180,88346.333319,1.3248220000095898,1123.1697541173298,1086.9384717264481
"147.32.84.165",1056,"79.135.138.210",6667,2,124,2,124,0,0,88347.658277,2.9884280000114813,331.94709726859367,0
"147.32.84.165",4986,"217.163.21.39",80,15,6383,7,2986,8,3397,88353.355534,0.20877299999119714,114420.92608243035,130170.08904956996
"147.32.84.165",2505,"208.97.132.210",25,3,186,3,186,0,0,88353.401359,8.882231000010506,167.52547867739986,0
"147.32.84.165",3779,"193.23.181.44",179,7,424,4,242,3,182,88354.058141,0.12885199999436736,15024.989911562338,11299.785801257625
"147.32.84.165",1031,"184.82.147.252",80,10,1514,5,603,5,911,88354.120608,0.3334969999996247,14464.89773522829,21853.27004443279
"147.32.84.165",2507,"207.115.11.16",25,3,186,3,186,0,0,88354.230952,8.855251000000862,168.03589192444744,0
"147.32.84.165",3780,"174.128.246.102",80,3,186,3,186,0,0,88355.161294,8.928335999997216,166.66039450133417,0
"147.32.84.165",1033,"217.163.21.39",80,14,5756,7,2533,7,3223,88355.161319,0.708864000000176,28586.58360418214,36373.69086311845
"147.32.84.165",2509,"64.12.90.97",25,3,186,3,186,0,0,88355.207057,8.882594999988214,167.5186136485987,0
"147.32.84.165",3783,"67.19.72.206",80,6,366,3,186,3,180,88356.063946,1.3666900000098394,1088.7618991792485,1053.6405475928211
"147.32.84.165",1122,"178.122.247.101",6667,2,124,2,124,0,0,88357.430772,2.847143999999389,348.41932828132786,0
"147.32.84.165",1055,"217.163.21.37",80,10,1448,5,699,5,749,88358.171142,0.13879899999301415,40288.474702854124,43170.339846119794
"147.32.84.165",2510,"165.21.74.113",25,3,186,3,186,0,0,88358.217181,8.88184000000183,167.5328535528329,0
"147.32.84.165",3810,"193.23.181.44",179,6,364,4,242,2,122,88364.089564,0.13027700000384357,14860.643090820959,7491.729161488252
"147.32.84.165",1083,"184.82.147.251",80,10,1910,5,1002,5,908,88364.153826,0.3435520000057295,23332.71236920849,21143.815200839632
"147.32.84.165",2511,"205.188.146.193",25,3,186,3,186,0,0,88364.267259,8.951597000006586,166.22732234247198,0
"147.32.84.165",3820,"67.19.72.206",80,6,366,3,186,3,180,88365.092672,1.3707940000022063,1085.5022709448722,1050.486068656328
"147.32.84.165",1090,"173.241.240.4",80,4,242,3,182,1,60,88365.393743,0.016263000012259,89528.37723067525,29514.84963648635
"147.32.84.165",2512,"98.139.175.224",25,3,186,3,186,0,0,88365.409864,9.012786999999662,165.0987646773474,0
"147.32.84.165",3823,"193.23.181.44",179,7,424,4,242,3,182,88366.463581,0.2024260000034701,9563.98881550202,7192.75191909656
"147.32.84.165",1102,"217.163.21.37",80,14,6137,7,809,7,5328,88366.526197,0.18860500000300817,34315.102992480446,225996.12947334463
"147.32.84.165",2513,"68.6.19.3",25,3,186,3,186,0,0,88366.572088,8.95424500000081,166.17816465820013,0
"147.32.84.165",3825,"174.128.246.102",80,3,186,3,186,0,0,88367.099095,9.029210000007879,164.7984707409288,0
"147.32.84.165",1126,"217.163.21.39",80,11,4099,6,2471,5,1628,88367.099124,0.2612269999954151,75673.64782486862,49857.0209060648
"147.32.84.165",2514,"205.188.146.194",25,3,186,3,186,0,0,88367.145259,8.983109000007971,165.6442107068588,0
"147.32.84.165",3827,"174.37.196.55",80,6,366,3,186,3,180,88367.299737,1.3251020000025164,1122.9324233132047,1086.7087967547143
"147.32.84.165",1164,"119.152.220.218",6667,2,124,2,124,0,0,88368.624959,2.988507000001846,331.9383223794983,0
"147.32.84.165",1172,"46.4.36.120",443,3,186,3,186,0,0,88374.121806,9.028783000001567,164.80626458734713,0
"147.32.84.165",1150,"184.82.147.252",80,10,1469,5,581,5,888,88374.322385,0.34776099999726284,13365.501019483449,20427.82255645663
"147.32.84.165",2515,"74.6.136.65",25,3,186,3,186,0,0,88374.437357,9.014173000003211,165.07337944362394,0
"147.32.84.165",3832,"67.19.72.206",80,6,366,3,186,3,180,88375.124707,1.3574789999984205,1096.1495536960288,1060.789890673576
"147.32.84.165",1161,"217.163.21.37",80,10,1448,5,699,5,749,88376.128405,0.13969000001088716,40031.498314583514,42894.981741949996
"147.32.84.165",2516,"65.55.92.152",25,3,186,3,186,0,0,88376.174437,8.982371999998577,165.65780174771606,0
"147.32.84.165",3857,"67.19.72.206",80,6,366,3,186,3,180,88376.482296,1.4069109999982174,1057.6361973158823,1023.5189006282732
"147.32.84.165",1163,"217.163.21.37",80,10,2274,5,1154,5,1120,88376.482328,0.13912999999593012,66355.20736196404,64400.201252512765
"147.32.84.165",2517,"64.12.90.33",25,3,186,3,186,0,0,88376.528145,8.929596999994828,166.63685942387565,0
"147.32.84.165",3863,"193.23.181.44",179,7,422,4,242,3,180,88379.13823,0.13486600000760518,14354.989396073344,10677.264840054553
"147.32.84.165",1224,"219.94.105.182",6667,2,124,2,124,0,0,88379.20385,2.9434439999895403,337.02017093021817,0
"147.32.84.165",1194,"184.82.147.251",80,10,1925,5,990,5,935,88384.154127,0.3427019999944605,23110.457482384172,21826.543177807274
"147.32.84.165",2518,"209.85.227.27",25,3,186,3,186,0,0,88384.267333,8.915212000007159,166.90573370535722,0
"147.32.84.165",3864,"193.23.181.44",80,6,364,4,242,2,122,88385.25718,0.14833399999770336,13051.626734463945,6579.745709109923
"147.32.84.165",1200,"217.163.21.39",80,15,7870,7,2506,8,5364,88385.322296,0.1888219999964349,106174.06870162651,227261.65383700104
"147.32.84.165",2519,"64.12.90.1",25,3,186,3,186,0,0,88385.36831,8.917818000001716,166.85695985270317,0
"147.32.84.165",3900,"72.20.15.61",80,7,424,4,242,3,182,88386.461121,0.37050900000031106,5225.244191094885,3929.7291023936737
"147.32.84.165",1206,"217.163.21.39",80,11,4099,6,2471,5,1628,88386.645895,0.2634620000026189,75031.69337438986,49434.07398361258
"147.32.84.165",2520,"98.139.175.224",25,3,186,3,186,0,0,88386.691666,8.898944000000483,167.2108510852433,0
"147.32.84.165",3904,"72.20.15.61",80,7,424,4,242,3,182,88387.564986,0.37056999999913387,5224.384057005492,3929.0822246900802
"147.32.84.165",1275,"118.34.142.43",6667,2,124,2,124,0,0,88387.749815,2.9250729999912437,339.13683521846104,0
"147.32.84.165",1251,"184.82.147.252",80,10,1514,5,603,5,911,88388.166663,0.35180200000468176,13712.258599825476,20716.19831582257
"147.32.84.165",2521,"98.139.175.225",25,3,186,3,186,0,0,88388.28298,9.012587999997777,165.1024100957868,0
"147.32.84.165",3925,"72.20.15.61",80,7,424,4,242,3,182,88394.185845,0.36681099999987055,5277.92241781376,3969.346611744233
"147.32.84.165",1254,"217.163.21.39",80,14,6321,7,2986,7,3335,88394.368734,0.20378499999060296,117221.58157421566,130922.29556262867
"147.32.84.165",2524,"66.94.238.147",25,3,186,3,186,0,0,88394.414692,9.000795999992988,165.31871181183968,0
"147.32.84.165",3929,"193.23.181.44",179,6,364,4,242,2,122,88395.088475,0.1522640000039246,12714.758576880286,6409.919613137995
"147.32.84.165",1261,"217.163.21.39",80,13,5528,7,2508,6,3020,88395.157619,0.2218659999925876,90432.96404437961,108894.55798007433
"147.32.84.165",2525,"204.127.208.75",25,3,186,3,186,0,0,88395.203502,9.014127999995253,165.07420351705497,0
"147.32.84.165",3949,"72.20.15.61",80,7,424,4,242,3,182,88395.389911,0.36682299998938106,5277.7497595735385,3969.2167613321653
"147.32.84.165",1273,"217.163.21.37",80,10,2274,5,1154,5,1120,88395.572822,0.13914699999440927,66347.10055100669,64392.33329040511
"147.32.84.165",2527,"74.6.136.65",25,3,186,3,186,0,0,88395.618578,9.000560000000405,165.32304656598401,0
"147.32.84.165",3982,"193.23.181.44",179,6,364,4,242,2,122,88397.095016,0.1269169999868609,15254.063680991709,7690.065161491688
"147.32.84.165",1332,"46.4.36.120",443,4,246,3,186,1,60,88397.157543,9.00452000000223,165.2503409398426,53.30656159349761
"147.32.84.165",1285,"217.163.21.37",80,13,6077,6,749,7,5328,88397.39598,0.18636399999377318,32152.13238715742,228713.70007847095
"147.32.84.165",2534,"207.115.21.22",25,3,186,3,186,0,0,88397.44201,8.982673000005889,165.65225072748663,0
"147.32.84.165",3994,"193.23.181.44",80,6,364,4,242,2,122,88404.217563,0.13386899999750312,14461.899319753711,7290.709574421292
"147.32.84.165",1336,"61.17.216.17",6667,1,62,1,62,0,0,88404.283983,0,0,0
"147.32.84.165",1297,"184.82.147.251",80,10,1913,5,994,5,919,88405.221045,0.3444909999961965,23083.33164026868,21341.631566807762
"147.32.84.165",2535,"64.12.90.33",25,3,186,3,186,0,0,88405.334621,9.01548499999626,165.0493567457122,0
"147.32.84.165",4007,"174.128.246.102",80,32,1924,16,962,16,962,88406.162178,612.5796770000015,12.563263668311315,12.563263668311315
"147.32.84.165",1316,"173.241.240.4",80,9,2194,5,1164,4,1030,88406.322367,0.06495299999369308,143365.20254498164,126860.96101488925
"147.32.84.165",2536,"72.22.190.201",25,3,186,3,186,0,0,88406.324369,9.028900000004796,164.8041289635736,0
"147.32.84.165",4009,"72.20.15.61",80,10,1488,6,566,4,922,88406.338882,0.3681349999969825,12299.835658215368,20036.12805101514
"147.32.84.165",1326,"195.113.232.96",80,17,15523,12,1422,5,14101,88406.521595,63.05063399999926,180.42641728234062,1789.1651969748839
"147.32.84.165",2537,"208.65.144.12",25,3,186,3,186,0,0,88406.522375,8.930938999998034,166.61181987698356,0
"147.32.84.165",4011,"72.20.15.61",80,7,424,4,242,3,182,88407.628585,0.36653699999442324,5281.867860623773,3972.3138455930853
"147.32.84.165",1365,"210.212.69.248",6667,2,124,2,124,0,0,88407.811299,2.9273680000042077,338.87095848508767,0
"147.32.84.165",1364,"46.4.36.120",443,4,246,3,186,1,60,88409.333867,6.520831000001635,228.19177494396448,73.61024998192403
"147.32.84.165",1328,"217.163.21.39",80,4,244,3,182,1,62,88414.249847,0.046002999995835125,31650.109778314865,10781.905528876492
"147.32.84.165",2540,"64.12.138.161",25,3,186,3,186,0,0,88414.295702,8.882285999992746,167.52444134327754,0
"147.32.84.165",4015,"174.37.196.55",80,6,366,3,186,3,180,88415.453385,1.3250989999942249,1122.934965618784,1086.7112570504362
"147.32.84.165",1340,"217.163.21.37",80,10,1448,5,699,5,749,88416.256289,0.13894499999878462,40246.14055956612,43124.97750946355
"147.32.84.165",2541,"65.55.92.184",25,3,186,3,186,0,0,88416.302174,8.882792999997037,167.51487961055676,0
"147.32.84.165",4040,"174.128.246.102",80,34,2044,18,1082,16,962,88416.657468,621.3002509999933,13.932072272734514,12.386925625111461
"147.32.84.165",1361,"184.82.147.252",80,10,1493,5,591,5,902,88416.778606,0.3341789999976754,14148.10625453092,21593.218006069186
"147.32.84.165",2542,"209.85.227.27",25,3,186,3,186,0,0,88416.817808,8.868590999991284,167.7831348859658,0
"147.32.84.165",4049,"72.20.15.61",80,7,424,4,242,3,182,88416.888959,0.36662600000272505,5280.585664916319,3971.34954964781
"147.32.84.165",1397,"184.82.147.251",80,10,1930,5,1002,5,928,88417.071747,0.3609030000079656,22210.95418941676,20570.624239300152
"147.32.84.165",2543,"64.12.90.1",25,3,186,3,186,0,0,88417.191019,8.896462999997311,167.25748199036514,0
"147.32.84.165",4052,"193.23.181.44",179,10,746,5,444,5,302,88418.463309,0.18604200000117999,19092.462992106466,12986.314918054399
"147.32.84.165",1424,"70.177.48.84",6667,2,124,2,124,0,0,88418.524131,2.9483130000007804,336.4635979964601,0
"147.32.84.165",1417,"217.163.21.39",80,13,5741,7,2546,6,3195,88424.281557,0.22741700000187848,89562.34582213186,112392.65314285595
"147.32.84.165",2544,"98.139.175.224",25,3,186,3,186,0,0,88424.32775,8.982527000000118,165.65494320250642,0
"147.32.84.165",4065,"174.37.196.55",80,6,366,3,186,3,180,88426.288046,1.3245920000044862,1123.3647794905603,1087.1272059586067
"147.32.84.165",1419,"70.32.97.26",80,8,2653,5,727,3,1926,88427.291613,0.3528280000027735,16483.95252064542,43670.00351411702
"147.32.84.165",2545,"212.27.48.6",25,3,186,3,186,0,0,88427.391838,9.028858999998192,164.8048773383545,0
"147.32.84.165",4067,"193.23.181.44",80,6,364,4,242,2,122,88427.403716,0.12848499999381602,15067.906760269134,7596.21745765634
"147.32.84.165",1465,"212.117.171.138",65500,236,175356,130,167518,106,7838,88427.467437,41.33189099999436,32423.97014934988,1517.0851969973637
"147.32.84.165",1423,"184.82.147.252",80,10,1508,5,596,5,912,88427.467467,0.3416390000056708,13956.252067008909,21355.875646161283
"147.32.84.165",2548,"66.94.238.147",25,3,186,3,186,0,0,88427.580762,8.93974000000162,166.44779378368165,0
"147.32.84.165",4069,"67.19.72.206",80,6,366,3,186,3,180,88427.612753,1.3410700000094948,1109.5617678342405,1073.7694527428134
"147.32.84.165",1474,"89.38.42.156",6667,2,124,2,124,0,0,88427.792818,3.0097359999926994,329.5970144897779,0
"147.32.84.165",1488,"46.4.36.120",443,4,246,3,186,1,60,88428.953936,9.014813000001595,165.0616601808309,53.24569683252609
"147.32.84.165",1466,"184.82.147.251",80,10,1925,5,990,5,935,88434.313647,0.3607179999962682,21956.2095600495,20736.420140046754
"147.32.84.165",2551,"209.85.227.27",25,3,186,3,186,0,0,88434.432741,9.010861000002478,165.13405322749855,0
"147.32.84.165",4070,"174.37.196.55",80,6,366,3,186,3,180,88434.432772,1.3065800000040326,1138.851046239348,1102.1139157154983
"147.32.84.165",1481,"205.188.186.167",587,33,3970,15,2019,18,1951,88435.216572,33.28946799998812,485.1985018206288,468.8569970540103
"147.32.84.165",1484,"217.163.21.37",80,13,6081,6,750,7,5331,88435.334343,0.1859240000048885,32271.250617683792,229384.0493904964
"147.32.84.165",2552,"64.12.90.1",25,3,186,3,186,0,0,88435.380162,8.965584000005038,165.9679949459136,0
"147.32.84.165",4071,"67.19.72.206",80,6,366,3,186,3,180,88435.380192,1.3950670000049286,1066.6154385378932,1032.2084889076386
"147.32.84.165",1486,"195.113.232.96",80,8,2205,5,771,3,1434,88435.739494,64.39750500000082,95.78010825108709,178.14354764209972
"147.32.84.165",2553,"216.32.181.178",25,3,186,3,186,0,0,88435.739529,9.00728400000662,165.19963176457034,0
"147.32.84.165",4083,"193.23.181.44",179,7,424,4,242,3,182,88436.775377,0.1423030000005383,13604.772914082461,10231.688720508297
"147.32.84.165",1514,"184.82.147.252",80,10,1514,5,603,5,911,88436.837999,0.34486500000639353,13988.082292811874,21132.907079190078
"147.32.84.165",2554,"207.115.21.22",25,3,186,3,186,0,0,88436.951524,8.99918099999195,165.34838003606453,0
"147.32.84.165",4086,"174.128.246.102",80,7,424,4,242,3,182,88437.223117,0.32554399999207817,5946.968766271567,4472.513700253823
"147.32.84.165",1526,"60.190.222.152",6667,12,2546,9,2360,3,186,88437.385688,93.56776800000807,201.77888607964198,15.902912207971784
"147.32.84.165",1515,"217.163.21.37",80,10,1451,5,701,5,750,88437.713598,0.138611000002129,40458.54946514969,43286.607844311366
"147.32.84.165",2555,"64.12.90.97",25,3,186,3,186,0,0,88437.724485,9.028678000002401,164.8081812198424,0
"147.32.84.165",4103,"174.128.246.102",80,7,424,4,242,3,182,88437.759437,0.41036399999575224,4717.762766763263,3548.0695188054297
"147.32.84.165",1519,"173.201.33.10",80,12,4160,6,882,6,3278,88437.922229,0.5867250000010245,12026.07695255474,44695.55583954018
"147.32.84.165",2556,"98.139.175.224",25,3,186,3,186,0,0,88437.968892,8.985621999992873,165.5978851548819,0
"147.32.84.165",4136,"193.23.181.44",80,6,364,4,242,2,122,88437.968928,0.13009099999908358,14881.890369154193,7502.440599325668
"147.32.84.165",1530,"94.100.176.20",25,3,186,3,186,0,0,88438.032812,9.021626999994623,164.93698974706965,0
"147.32.84.165",1520,"70.32.97.26",80,8,1494,5,841,3,653,88438.104044,0.40968399999837857,16422.413372322637,12751.291239151822
"147.32.84.165",2557,"213.165.64.102",25,3,186,3,186,0,0,88438.125722,9.02899000000616,164.80248621373872,0
"147.32.84.165",4148,"72.20.15.61",80,10,1452,6,530,4,922,88438.21611,0.38636699999915436,10974.022108537427,19090.657328436806
"147.32.84.165",1525,"217.163.21.37",80,14,6137,7,809,7,5328,88438.401038,0.18701100000180304,34607.58992753154,227922.4216735328
"147.32.84.165",2558,"74.6.136.65",25,3,186,3,186,0,0,88438.446809,9.0087019999919,165.17362878707033,0
"147.32.84.165",4176,"174.128.246.102",80,8,484,5,302,3,182,88444.345686,3.2752110000001267,737.6623979340283,444.55151133772563
"147.32.84.165",1543,"46.4.36.120",443,3,186,3,186,0,0,88444.511004,8.96360000000277,166.00473024226204,0
"147.32.84.165",1529,"217.163.21.39",80,11,4133,6,2493,5,1640,88445.349043,0.22285499999998137,89493.1682035479,58872.360952193565
"147.32.84.165",2563,"74.125.148.10",25,3,186,3,186,0,0,88445.394904,8.882232000003569,167.52545981678952,0
"147.32.84.165",4182,"174.128.246.102",80,9,544,6,362,3,182,88448.459016,9.189157000000705,315.15404514252805,158.44761385618816
"147.32.84.165",1532,"173.241.240.6",80,10,1606,5,891,5,715,88448.559021,0.058548000000882894,121746.2594775656,97697.61563014524
"147.32.84.165",2565,"209.86.93.227",25,3,186,3,186,0,0,88448.575191,8.91228499999852,166.96054939897536,0
"147.32.84.165",4192,"193.23.181.44",179,7,422,4,242,3,180,88448.618658,0.15839699999196455,12222.453708707948,9091.081270939796
"147.32.84.165",1580,"212.117.171.138",65500,247,174665,129,166053,118,8612,88448.684193,40.58193500000925,32734.368136948055,1697.7012062136587
"147.32.84.165",1536,"173.241.240.6",80,9,1126,5,717,4,409,88448.684224,0.05531599999812897,103695.13341879414,59151.05936999554
"147.32.84.165",2567,"216.99.131.24",25,3,186,3,186,0,0,88448.700499,8.887486999999965,167.4264052369366,0
"147.32.84.165",4197,"193.23.181.44",179,7,422,4,242,3,180,88456.684894,0.12710699999297503,15231.261851093954,11329.037740483105
"147.32.84.165",1588,"92.47.5.149",6667,3,186,3,186,0,0,88456.747582,9.424511000004713,157.88617573890633,0
"147.32.84.165",1542,"217.163.21.37",80,10,1448,5,699,5,749,88457.889022,0.13890199999150354,40258.59959066144,43138.32774449988
"147.32.84.165",2570,"209.85.227.27",25,3,186,3,186,0,0,88457.934899,9.532741000002716,156.09361462768956,0
"147.32.84.165",4198,"72.20.15.61",80,7,424,4,242,3,182,88458.691953,0.37002400000346825,5232.093053374521,3934.879899645301
"147.32.84.165",1597,"65.55.196.251",443,154,167670,72,5692,82,161978,88458.876437,10.00028900000325,4553.468404761623,129578.65517682329
"147.32.84.165",1564,"184.82.147.251",80,10,1925,5,990,5,935,88458.975882,0.33435600000666454,23687.327279433102,22371.364652797933
"147.32.84.165",2571,"64.12.90.66",25,3,186,3,186,0,0,88458.992573,9.650267000004533,154.19262492937253,0
"147.32.84.165",4211,"72.20.15.61",80,7,424,4,242,3,182,88459.086008,0.5487859999993816,3527.786787567798,2653.1289063526415
"147.32.84.165",1621,"61.17.216.15",6667,10,1184,5,626,5,558,88459.092903,1.1884209999989253,4213.994872191361,3756.244630483673
"147.32.84.165",1625,"74.125.93.27",25,3,186,3,186,0,0,88459.419873,9.229365999999573,161.2245088124221,0
"147.32.84.165",1577,"217.163.21.37",80,10,2277,5,1156,5,1121,88459.426247,0.13935199999832548,66364.31482943286,64355.01463996041
"147.32.84.165",2572,"216.32.180.22",25,3,186,3,186,0,0,88459.455046,9.200627999991411,161.7280907348269,0
"147.32.84.165",4212,"174.37.196.55",80,6,366,3,186,3,180,88459.4721,1.8096680000016931,822.2502691093658,795.7260668800315
"147.32.84.165",1589,"173.201.33.10",80,10,1632,5,921,5,711,88461.814039,1.8312789999909,4023.417513135144,3106.02589776231
"147.32.84.165",2573,"98.139.175.224",25,3,186,3,186,0,0,88462.59644,8.334577000001445,178.53335568196707,0
"147.32.84.165",4215,"174.37.196.55",80,6,366,3,186,3,180,88466.092839,2.249370999998064,661.5182644398283,640.1789655869305
"147.32.84.165",1637,"111.253.202.95",6667,2,124,2,124,0,0,88466.70724,2.6180460000032326,378.90854476918093,0
"147.32.84.165",1642,"46.4.36.120",443,3,186,3,186,0,0,88468.652439,8.698499999998603,171.0639765477081,0
"147.32.84.165",1592,"217.163.21.34",80,13,6132,6,825,7,5307,88469.525916,0.18621400000120047,35443.092355877925,227995.74682744744
"147.32.84.165",2574,"205.188.190.2",25,3,186,3,186,0,0,88469.571932,8.982804999992368,165.64981651068504,0
"147.32.84.165",4221,"72.20.15.61",80,7,424,4,242,3,182,88469.626172,0.3668059999909019,5277.994362273299,3969.4007187344646
"147.32.84.165",1593,"67.217.162.198",80,10,1178,5,636,5,542,88469.809087,0.35731599999417085,14239.496692236016,12134.916992440127
"147.32.84.165",2575,"195.50.106.142",25,3,186,3,186,0,0,88469.927529,9.028164000003017,164.81756423559682,0
"147.32.84.165",4227,"193.23.181.44",80,6,364,4,242,2,122,88477.752648,0.12558700000226963,15415.608303128605,7771.505012321033
"147.32.84.165",1653,"212.117.171.138",65500,49,4978,25,2317,24,2661,88477.814974,160.46388600001228,115.51508854770339,132.66536496566192
"147.32.84.165",1671,"173.192.170.88",80,22,4957,12,1164,10,3793,88477.815004,51.21473100000003,181.82268691404423,592.4857830455067
"147.32.84.165",1620,"217.163.21.39",80,13,5746,7,2551,6,3195,88478.015654,0.255671999999322,79821.02068296145,99971.83891887958
"147.32.84.165",2577,"74.6.136.65",25,3,186,3,186,0,0,88478.061743,9.051789999997709,164.38737531475837,0
"147.32.84.165",4234,"174.128.246.102",80,7,424,4,242,3,182,88478.955773,0.3280280000035418,5901.935200589878,4438.645481435363
"147.32.84.165",1655,"65.55.16.187",443,125,164663,68,5452,57,159211,88479.119549,10.28684100000828,4239.979989966297,123817.2146336251
"147.32.84.165",1627,"184.82.147.252",80,10,1514,5,603,5,911,88479.281395,0.34952000000339467,13801.785305427866,20851.453421633145
"147.32.84.165",2578,"64.12.139.193",25,3,186,3,186,0,0,88479.39461,9.438954999990528,157.6445697645018,0
"147.32.84.165",4256,"67.19.72.206",80,6,366,3,186,3,180,88479.959582,2.643751000010525,562.8366665370817,544.6806450358855
"147.32.84.165",1661,"200.206.208.45",6667,1,62,1,62,0,0,88480.05976,0,0,0
"147.32.84.165",1629,"217.163.21.39",80,14,6360,7,3008,7,3352,88480.260287,0.2561439999990398,93947.1547258191,104691.11125031437
"147.32.84.165",2579,"205.188.59.194",25,3,186,3,186,0,0,88480.30645,8.882681999995839,167.5169729143402,0
"147.32.84.165",4267,"193.23.181.44",80,6,364,4,242,2,122,88480.460858,0.4278749999939464,4524.685948062847,2281.040023403584
"147.32.84.165",1675,"74.125.39.27",25,3,186,3,186,0,0,88480.531353,8.857824000006076,167.9870812514427,0
"147.32.84.165",1643,"184.82.147.251",80,10,1930,5,1002,5,928,88483.803134,2.052255000002333,3905.947360338207,3617.4841820297966
"147.32.84.165",2580,"209.86.93.227",25,3,186,3,186,0,0,88483.900734,7.9969790000031935,186.07026478366464,0
"147.32.84.165",4280,"193.23.181.44",80,6,364,4,242,2,122,88484.819956,1.7772109999932582,1089.347297539428,549.1750838835133
"147.32.84.165",1678,"61.17.216.90",6667,2,124,2,124,0,0,88485.722733,2.680051999996067,370.14207187079046,0
"147.32.84.165",1654,"217.163.21.34",80,4,244,3,182,1,62,88489.289013,0.045889000000897795,31728.736733672864,10808.6905356468
"147.32.84.165",2581,"208.43.248.154",25,3,186,3,186,0,0,88489.334764,8.98371600000246,165.6330186750775,0
"147.32.84.165",4285,"193.23.181.44",80,6,364,4,242,2,122,88489.991878,0.12655000000086147,15298.301066667886,7712.366653444141
"147.32.84.165",1673,"217.163.21.37",80,14,6134,7,809,7,5325,88490.05405,0.1871370000008028,34584.28851575175,227640.7124182671
"147.32.84.165",2583,"209.85.227.27",25,3,186,3,186,0,0,88490.099806,9.020870000007562,164.95083068470697,0
"147.32.84.165",4286,"193.23.181.44",80,6,364,4,242,2,122,88490.49334,0.12910700000065845,14995.313964309653,7559.6210894453625
"147.32.84.165",1698,"46.4.36.120",443,4,246,3,186,1,60,88490.553734,6.460223999994923,230.3325705116679,74.30082919731223
"147.32.84.165",1676,"173.241.240.4",80,9,2195,5,1165,4,1030,88490.894007,0.06897100000060163,135129.25722287197,119470.5020940413
"147.32.84.165",2585,"212.27.48.7",25,3,186,3,186,0,0,88490.910175,9.013080000004265,165.0933975954164,0
"147.32.84.165",4288,"193.23.181.44",179,7,424,4,242,3,182,88499.019886,0.14173100001062267,13659.679250516103,10272.9819156774
"147.32.84.165",1705,"67.197.150.10",6667,1,62,1,62,0,0,88499.088813,0,0,0
"147.32.84.165",1679,"184.82.147.252",80,10,1507,5,596,5,911,88500.023469,0.3421889999881387,13933.820199262027,21298.17147907333
"147.32.84.165",2587,"98.139.175.224",25,3,186,3,186,0,0,88500.136721,9.015791999991052,165.0437365903602,0
"147.32.84.165",4290,"193.23.181.44",179,7,424,4,242,3,182,88500.324385,0.20103399999788962,9630.211805069408,7242.555985630712
"147.32.84.165",1715,"208.73.210.29",80,51,35767,23,3437,28,32330,88500.393382,20.88329500000691,1316.6504615287436,12385.01874344611
"147.32.84.165",1697,"217.163.21.37",80,10,1446,5,698,5,748,88500.573091,0.14073800000187475,39676.56212199702,42518.72273245526
"147.32.84.165",2588,"64.12.90.97",25,3,186,3,186,0,0,88500.618859,8.934776000009151,166.54026916830102,0
"147.32.84.165",4292,"67.19.72.206",80,6,366,3,186,3,180,88501.227313,1.3661640000063926,1089.1810939192053,1054.0462199218116
"147.32.84.165",1704,"184.82.147.251",80,10,1925,5,990,5,935,88501.427811,0.34248700000171084,23124.965327035585,21840.245031089165
"147.32.84.165",2589,"205.188.103.2",25,3,186,3,186,0,0,88501.541126,9.015518000000156,165.04875260633656,0
"147.32.84.165",4293,"193.23.181.44",179,11,844,5,484,6,360,88502.593696,0.19616000000678468,19738.988580067686,14681.89233228175
"147.32.84.165",1729,"66.111.4.71",25,3,186,3,186,0,0,88502.657815,9.002498000001651,165.28745688138193,0
"147.32.84.165",1718,"217.163.21.37",80,14,6134,7,809,7,5325,88503.935587,0.18714900000486523,34582.070969290515,227626.11608340172
"147.32.84.165",2590,"64.207.20.170",25,3,186,3,186,0,0,88503.981312,8.983179000002565,165.64291995067393,0
"147.32.84.165",4296,"67.19.72.206",80,6,366,3,186,3,180,88509.052222,1.3621229999989737,1092.4123592371036,1057.1732508746163
"147.32.84.165",1737,"74.125.232.218",80,8,1908,5,1034,3,874,88510.055622,11.221168999996735,737.1780961504463,623.1079845604353
"147.32.84.165",1759,"46.4.36.120",443,4,246,3,186,1,60,88510.063701,8.958033999995678,166.10787590231496,53.583185774940304
"147.32.84.165",1720,"217.163.21.39",80,13,5741,7,2550,6,3191,88510.356439,0.2601940000022296,78403.03773271172,98111.40917846396
"147.32.84.165",2592,"64.12.139.193",25,3,186,3,186,0,0,88510.402238,8.882332000008319,167.52357376403026,0
"147.32.84.165",4297,"174.37.196.55",80,6,366,3,186,3,180,88510.441441,1.3396740000025602,1110.7179806409292,1074.8883683621896
"147.32.84.165",1738,"201.165.227.159",6667,3,186,3,186,0,0,88511.159021,8.928750000006403,166.65266694654156,0
"147.32.84.165",1731,"184.82.147.252",80,10,1514,5,603,5,911,88511.781244,0.3628739999985555,13293.870599765216,20084.106328998525
"147.32.84.165",2595,"64.12.90.34",25,3,186,3,186,0,0,88511.901506,8.88839100000041,167.40937701772248,0
"147.32.84.165",4314,"72.20.15.61",80,7,424,4,242,3,182,88511.961115,0.4477049999986775,4324.276029987869,3252.1414770983147
"147.32.84.165",1764,"67.214.158.5",80,10,1695,5,849,5,846,88512.145712,0.3611430000019027,18806.95458575749,18740.49891584315
"147.32.84.165",1739,"217.163.21.37",80,10,1446,5,698,5,748,88512.249287,0.13929300000017975,40088.15949109283,42959.80415377857
"147.32.84.165",2597,"208.97.132.72",25,3,186,3,186,0,0,88512.294989,8.896135000002687,167.2636487642724,0
"147.32.84.165",4319,"174.37.196.55",80,6,366,3,186,3,180,88519.021866,1.2872900000074878,1155.916693201489,1118.6290579369247
"147.32.84.165",1765,"50.22.198.84",80,4,244,3,182,1,62,88520.309275,0.12099699999089353,12033.356199819676,4099.27518894956
"147.32.84.165",1782,"46.4.36.120",443,3,186,3,186,0,0,88520.430134,8.98661500000162,165.57958697459853,0
"147.32.84.165",1745,"184.82.147.251",80,10,1926,5,998,5,928,88521.090595,0.33555999999225605,23793.062344094207,22124.210275871166
"147.32.84.165",2600,"209.85.227.27",25,3,186,3,186,0,0,88521.201019,9.018611999999848,164.99212960930407,0
"147.32.84.165",4320,"193.23.181.44",80,6,364,4,242,2,122,88521.49201,0.12842700000328477,15074.711703539622,7599.648048891875
"147.32.84.165",1772,"74.115.3.63",6667,3,186,3,186,0,0,88521.555955,8.964429999992717,165.98936017138948,0
"147.32.84.165",1767,"217.163.21.37",80,13,6077,6,749,7,5328,88522.494749,0.18591999998898245,32228.915664560474,229259.8967433621
"147.32.84.165",2601,"206.46.232.11",25,3,186,3,186,0,0,88522.540517,8.983288999996148,165.64089166013005,0
"147.32.84.165",4333,"193.23.181.44",179,7,424,4,242,3,182,88523.598538,0.13533799999277107,14304.925446684665,10758.24971610169
"147.32.84.165",1789,"190.79.152.22",6667,2,124,2,124,0,0,88523.665354,2.942611999998917,337.1154606860725,0
"147.32.84.165",1792,"216.157.130.15",25,3,186,3,186,0,0,88524.902782,9.028983999989578,164.8025957296765,0
"147.32.84.165",1795,"173.192.170.88",80,15,3031,8,664,7,2367,88531.323258,67.59756100000232,78.5827169119285,280.12845019658846
"147.32.84.165",1768,"217.163.21.39",80,11,4127,6,2490,5,1637,88532.125836,0.2545699999900535,78249.5973633119,51443.610796683366
"147.32.84.165",2602,"205.188.59.194",25,3,186,3,186,0,0,88532.171637,8.982555999988108,165.65440838910104,0
"147.32.84.165",4345,"67.19.72.206",80,6,366,3,186,3,180,88532.828303,1.3703919999970822,1085.8206994810012,1050.7942253041947
"147.32.84.165",1800,"221.209.60.2",6667,2,124,2,124,0,0,88533.229526,3.009025000006659,329.6748946910726,0
"147.32.84.165",1784,"184.82.147.252",80,10,1507,5,596,5,911,88534.198806,0.3609040000010282,13211.269478826547,20193.735730219774
"147.32.84.165",2603,"98.139.175.224",25,3,186,3,186,0,0,88534.318156,8.943003000007593,166.38706260064282,0
"147.32.84.165",4347,"72.20.15.61",80,7,424,4,242,3,182,88534.533818,0.3663430000015069,5284.664917828474,3974.417417540423
"147.32.84.165",1785,"217.163.21.37",80,10,1448,5,699,5,749,88534.716669,0.13889000000199303,40262.07790279902,43142.054862942015
"147.32.84.165",2604,"98.139.175.225",25,3,186,3,186,0,0,88534.762526,9.000442999997176,165.3251956598655,0
"147.32.84.165",4350,"174.128.246.102",80,7,424,4,242,3,182,88539.649561,0.319841999997152,6052.98866320633,4552.247672328727
"147.32.84.165",1797,"184.82.147.251",80,10,1925,5,990,5,935,88539.809182,0.34358800000336487,23050.863242960862,21770.259729463036
"147.32.84.165",2605,"205.188.156.193",25,3,186,3,186,0,0,88539.922732,8.85628499998711,168.01627318928485,0
"147.32.84.165",4355,"174.37.196.55",80,6,366,3,186,3,180,88541.455525,1.3244110000086948,1123.518303600794,1087.2757776781878
"147.32.84.165",1798,"217.163.21.37",80,10,2272,5,1153,5,1119,88542.257987,0.14049599999270868,65653.11468282867,63717.11650484414
"147.32.84.165",2607,"68.67.38.68",25,3,186,3,186,0,0,88542.303838,8.882421999995131,167.5218763531856,0
"147.32.84.165",4387,"193.23.181.44",80,6,364,4,242,2,122,88542.558688,0.13198900000134017,14667.888990600297,7394.5556068315545
"147.32.84.165",1820,"46.4.36.120",443,4,246,3,186,1,60,88542.620996,8.904580999995233,167.10499910111398,53.90483841971419
"147.32.84.165",1807,"217.163.21.37",80,14,6134,7,809,7,5325,88542.780082,0.1912060000031488,33848.310198913314,222796.35575922544
"147.32.84.165",2609,"206.46.232.11",25,3,186,3,186,0,0,88542.825866,8.862599000000046,167.89657300302002,0
"147.32.84.165",4393,"72.20.15.61",80,7,424,4,242,3,182,88542.825897,0.3659559999941848,5290.25347317919,3978.620380655424
"147.32.84.165",1808,"217.163.21.39",80,11,4129,6,2491,5,1638,88543.00845,0.25415500000235625,78408.84499543684,51559.087957657786
"147.32.84.165",2610,"68.1.17.3",25,3,186,3,186,0,0,88543.054203,8.834807999999612,168.42471279512418,0
"147.32.84.165",4400,"72.20.15.61",80,7,424,4,242,3,182,88543.562054,0.36990000000514556,5233.846985598997,3936.1989726405677
"147.32.84.165",1822,"95.134.172.70",6667,2,124,2,124,0,0,88543.746715,2.9254870000004303,339.08884230210356,0
"147.32.84.165",1816,"184.82.147.252",80,10,1514,5,603,5,911,88545.970412,0.352100000003702,13700.653223371997,20698.665151727844
"147.32.84.165",2613,"208.65.144.12",25,3,186,3,186,0,0,88546.086988,8.911698000010801,166.9715468363264,0
"147.32.84.165",4404,"193.23.181.44",179,6,362,4,242,2,120,88549.682116,0.17485999999917112,11071.7145145212,5490.106370836959
"147.32.84.165",1819,"217.163.21.39",80,14,6355,7,3005,7,3350,88549.749043,0.20670199999585748,116302.6966380673,129655.252491689
"147.32.84.165",2615,"74.6.136.65",25,3,186,3,186,0,0,88549.794972,9.016457999998238,165.03154564689268,0
"147.32.84.165",4414,"72.20.15.61",80,9,544,5,302,4,242,88551.52569,3.4445660000055796,701.3946023957986,562.0446813900109
"147.32.84.165",1821,"217.163.21.37",80,10,1446,5,698,5,748,88551.710209,0.1388370000058785,40219.82612533811,43100.902495348004
"147.32.84.165",2619,"98.139.175.224",25,3,186,3,186,0,0,88551.755985,8.961303999996744,166.0472627644973,0
"147.32.84.165",4415,"174.37.196.55",80,6,366,3,186,3,180,88551.756017,1.2569019999937154,1183.8631810653815,1145.6740461923046
"147.32.84.165",1838,"46.4.36.120",443,3,186,3,186,0,0,88553.013038,9.008095999990474,165.18474048251414,0
"147.32.84.165",1823,"217.163.21.37",80,10,2274,5,1154,5,1120,88553.092781,0.14051100000506267,65703.0410406827,63767.249536884425
"147.32.84.165",2620,"64.12.90.97",25,3,186,3,186,0,0,88553.138551,8.982790000009118,165.65009312234724,0
"147.32.84.165",4422,"174.128.246.102",80,33,1984,17,1022,16,962,88555.199328,614.3238039999997,13.308942200781145,12.52759530053959
"147.32.84.165",1839,"80.72.108.202",6667,2,124,2,124,0,0,88555.363302,2.946525000006659,336.6677696601109,0
"147.32.84.165",1828,"184.82.147.251",80,10,1909,5,994,5,915,88555.701367,0.36276799999177456,21920.345786233363,20178.185507448216
"147.32.84.165",2621,"66.94.238.147",25,3,186,3,186,0,0,88555.820606,9.009339000011096,165.1619502827197,0
"147.32.84.165",4426,"174.37.196.55",80,6,366,3,186,3,180,88559.713766,1.3243749999965075,1123.5488437972053,1087.305332706973
"147.32.84.165",1831,"173.241.240.4",80,4,242,3,182,1,60,88560.817241,0.016323000003467314,89199.28932737352,29406.359118914348
"147.32.84.165",2623,"98.139.175.225",25,3,186,3,186,0,0,88560.833423,9.012703999993391,165.10028510878544,0
"147.32.84.165",4430,"193.23.181.44",179,6,364,4,242,2,122,88561.038258,0.12363400000322144,15659.122894588503,7894.268566693378
"147.32.84.165",1836,"217.163.21.37",80,13,6077,6,749,7,5328,88561.099118,0.18711500000790693,32023.087404787406,227795.74057771335
"147.32.84.165",2625,"209.85.227.27",25,3,186,3,186,0,0,88561.144981,9.00211099999433,165.29456257548227,0
"147.32.84.165",4452,"67.19.72.206",80,6,366,3,186,3,180,88563.225086,1.3630290000000969,1091.6862370499045,1056.4705519837785
"147.32.84.165",1852,"117.242.61.2",6667,2,124,2,124,0,0,88563.926993,3.009445000003325,329.62888505983796,0
"147.32.84.165",1837,"217.163.21.39",80,11,4117,6,2490,5,1627,88564.588268,0.23513799998909235,84716.20920873723,55354.7278645042
"147.32.84.165",2627,"205.188.159.42",25,3,186,3,186,0,0,88564.634004,9.024149999997462,164.89087614904656,0
"147.32.84.165",4459,"193.23.181.44",179,7,424,4,242,3,182,88567.036789,0.17226799999480136,11238.303109448208,8451.94696660981
"147.32.84.165",1840,"217.163.21.39",80,14,6366,7,3006,7,3360,88567.101279,0.197465999997803,121782.99049085694,136124.69994986005
"147.32.84.165",2628,"216.200.145.235",25,3,186,3,186,0,0,88567.147053,9.019158000010066,164.9821413482655,0
"147.32.84.165",4461,"193.23.181.44",80,6,364,4,242,2,122,88569.745356,0.17513699999835808,11054.20328096376,5572.780166436276
"147.32.84.165",1842,"184.82.147.252",80,10,1474,5,587,5,887,88569.809184,0.362024999994901,12971.47987035741,19600.856294730875
"147.32.84.165",2629,"213.254.204.150",25,3,186,3,186,0,0,88569.929266,8.945267999995849,166.3449323151291,0
"147.32.84.165",4462,"193.23.181.44",80,6,364,4,242,2,122,88570.849219,0.19525000000430737,9915.492957527735,4998.71959015861
"147.32.84.165",1849,"217.163.21.37",80,10,1448,5,699,5,749,88570.915976,0.14015999999537598,39897.260275288856,42751.14155392182
"147.32.84.165",2631,"74.6.136.65",25,3,186,3,186,0,0,88570.961799,8.916104999996605,166.88901712132895,0
"147.32.84.165",4468,"174.128.246.102",80,7,424,4,242,3,182,88574.059149,0.32784100000571925,5905.301655272605,4441.17727793229
"147.32.84.165",1868,"203.84.189.77",6667,6,366,3,186,3,180,88574.160069,1.9968129999906523,745.1874562149615,721.1491511757691
"147.32.84.165",1854,"184.82.147.251",80,10,1902,5,998,5,904,88574.222527,0.333543999993708,23936.871897412668,21682.29678883873
"147.32.84.165",2633,"207.115.11.16",25,3,186,3,186,0,0,88574.332628,8.85558599999058,168.02953525623067,0
"147.32.84.165",4473,"193.23.181.44",80,6,364,4,242,2,122,88576.157004,0.13022400000772905,14866.69123882767,7494.778227838743
"147.32.84.165",1871,"46.4.36.120",443,3,186,3,186,0,0,88576.221858,8.873033999989275,167.6991207293693,0
"147.32.84.165",1856,"217.163.21.37",80,10,2272,5,1153,5,1119,88576.868829,0.13886300000012852,66425.1816537988,64466.416539983395
"147.32.84.165",2634,"98.139.175.224",25,3,186,3,186,0,0,88576.914584,8.882591000001412,167.51868908517386,0
"147.32.84.165",1878,"173.192.170.88",80,9,936,7,812,2,124,88579.777581,15.882165999995777,409.01222163285075,62.45999443654372
"147.32.84.165",4491,"72.20.15.61",80,7,424,4,242,3,182,88579.777651,0.3667310000018915,5279.073762485349,3970.2124990592297
"147.32.84.165",1889,"202.44.45.5",6667,6,366,3,186,3,180,88579.960632,1.9704259999998612,755.1666492423998,730.8064347507094
"147.32.84.165",1860,"173.241.240.4",80,4,242,3,182,1,60,88581.784098,0.016344999996363185,89079.22914187609,29366.778837981128
"147.32.84.165",2635,"208.88.6.52",25,3,186,3,186,0,0,88581.8003,9.01269799999136,165.1003950206061,0
"147.32.84.165",4497,"67.19.72.206",80,6,366,3,186,3,180,88581.93121,1.4209439999976894,1047.1911630595012,1013.4108029608075
"147.32.84.165",1864,"217.163.21.39",80,15,7889,7,2525,8,5364,88582.08495,0.1889789999986533,106890.18356613141,227072.84936583322
"147.32.84.165",2636,"67.195.168.31",25,3,186,3,186,0,0,88582.130902,8.982913999992888,165.6478064914323,0
"147.32.84.165",4520,"193.23.181.44",179,6,364,4,242,2,122,88583.352297,0.14577099999587517,13281.105295667741,6695.433248229192
"147.32.84.165",1866,"217.163.21.39",80,11,4119,6,2491,5,1628,88583.412874,0.23224800000025425,85804.82932028772,56077.9856015369
"147.32.84.165",2637,"74.125.113.27",25,3,186,3,186,0,0,88583.458865,8.95900800000527,166.08981708679408,0
"147.32.84.165",4535,"174.128.246.102",80,10,606,6,362,4,244,88585.595956,3.2770149999996647,883.731078435801,595.6640418186062
"147.32.84.165",1904,"80.98.191.57",6667,2,124,2,124,0,0,88585.763561,2.942853999993531,337.0877386381318,0
"147.32.84.165",1869,"184.82.147.252",80,10,1301,5,580,5,721,88588.104155,0.3336249999993015,13907.830648211959,17288.872236829004
"147.32.84.165",2638,"199.228.142.102",25,3,186,3,186,0,0,88588.214369,9.018737999998848,164.9898245187065,0
"147.32.84.165",4541,"67.19.72.206",80,6,366,3,186,3,180,88590.813084,1.3767350000125589,1080.8180223401207,1045.9529248452782
"147.32.84.165",1893,"217.163.21.39",80,14,6355,7,3005,7,3350,88591.916141,0.2024410000012722,118750.64833630009,132384.25022515983
"147.32.84.165",2641,"209.85.227.27",25,3,186,3,186,0,0,88591.961872,8.983670999994501,165.63384834561626,0
"147.32.84.165",4544,"174.128.246.102",80,9,548,6,366,3,182,88592.189932,9.281604000003426,315.4627152805613,156.8694376531753
"147.32.84.165",1919,"61.28.22.201",6667,2,124,2,124,0,0,88595.227348,3.0091019999963464,329.6664586315799,0
"147.32.84.165",1894,"184.82.147.251",80,10,1925,5,990,5,935,88597.132827,0.35275400000682566,22451.90699424174,21204.578827894977
"147.32.84.165",2642,"220.244.226.66",25,3,186,3,186,0,0,88597.249415,9.012707000001683,165.10023015279674,0
"147.32.84.165",4559,"193.23.181.44",179,7,424,4,242,3,182,88597.835355,0.14652100000239443,13213.123033342403,9937.142115984781
"147.32.84.165",1901,"217.163.21.39",80,13,5539,7,2527,6,3012,88597.898043,0.229155000008177,88219.76391210589,105151.53498348355
"147.32.84.165",2643,"205.188.59.193",25,3,186,3,186,0,0,88597.943845,9.020275999995647,164.96169296823268,0
"147.32.84.165",4562,"67.19.72.206",80,6,366,3,186,3,180,88601.304637,1.4098720000038156,1055.4149596530556,1021.3693157932797
"147.32.84.165",1936,"50.16.214.154",80,10,1371,5,854,5,517,88601.847945,0.3724530000035884,18343.254047985054,11104.75684169587
"147.32.84.165",1924,"46.4.36.120",443,3,186,3,186,0,0,88601.969508,8.907162000003154,167.05657761691918,0
"147.32.84.165",1926,"173.192.170.88",80,3,186,3,186,0,0,88602.714641,8.864268999997876,167.86494182434632,0
"147.32.84.165",1903,"217.163.21.37",80,10,2274,5,1154,5,1120,88602.851371,0.13898000000335742,66426.82400184902,64469.707870078775
"147.32.84.165",2651,"209.106.160.100",25,3,186,3,186,0,0,88602.89721,8.882935000001453,167.51220176661843,0
"147.32.84.165",4600,"174.37.196.55",80,6,366,3,186,3,180,88603.153013,1.3240720000030706,1123.8059561689615,1087.554151131253
"147.32.84.165",1933,"212.117.171.138",65500,184,154057,92,6279,92,147778,88604.456385,87.6339650000009,573.2024107319518,13490.477122654303
"147.32.84.165",1907,"93.184.220.20",80,13,6640,8,821,5,5819,88604.456447,7.5439469999982975,870.6317793591978,6170.775059794363
"147.32.84.165",2652,"17.148.17.43",25,3,186,3,186,0,0,88604.472787,8.911824999988312,166.96916737053877,0
"147.32.84.165",4629,"67.19.72.206",80,6,366,3,186,3,180,88604.477179,1.33891500000027,1111.3476210212746,1075.4976977625238
"147.32.84.165",1937,"205.188.186.167",587,30,3820,14,2047,16,1773,88605.816241,32.55724700000428,502.99093163490903,435.6633716603291
"147.32.84.165",1917,"173.241.240.4",80,4,242,3,182,1,60,88605.93374,0.016624000010779127,87584.21553512504,28873.917209381878
"147.32.84.165",2653,"74.6.136.65",25,3,186,3,186,0,0,88605.950223,8.838833999994677,168.34799703228913,0
"147.32.84.165",4650,"193.23.181.44",80,6,364,4,242,2,122,88609.272094,0.12166900000011083,15912.023605012258,8021.763966163205
"147.32.84.165",1945,"222.252.117.126",6667,1,62,1,62,0,0,88609.332496,0,0,0
"147.32.84.165",1921,"184.82.147.252",80,10,1515,5,603,5,912,88611.880361,0.3612719999946421,13352.820036071278,20195.309905301834
"147.32.84.165",1948,"174.133.57.141",80,9,1177,5,654,4,523,88612.000204,0.6248320000013337,8373.450783552751,6696.199938529188
"147.32.84.165",2654,"205.188.190.2",25,3,186,3,186,0,0,88612.164432,8.945498000000953,166.34065537769294,0
"147.32.84.165",4660,"193.23.181.44",80,6,364,4,242,2,122,88612.883785,0.13464000000385568,14379.08496690849,7248.960189929073
"147.32.84.165",1923,"195.113.232.96",80,31,34624,23,2728,8,31896,88612.950545,112.91339099999459,193.28088375276096,2259.8559634083813
"147.32.84.165",2663,"68.6.19.3",25,3,186,3,186,0,0,88612.951332,8.960743000003276,166.05765838831178,0
"147.32.84.165",4666,"174.128.246.102",80,11,668,8,486,3,182,88618.200431,45.29163100000005,85.84367385665567,32.1472194278011
"147.32.84.165",1956,"61.177.120.254",6667,10,1132,5,574,5,558,88618.902386,1.5136530000017956,3033.7204101564575,2949.156775030145
"147.32.84.165",1938,"217.163.21.39",80,14,6351,7,3001,7,3350,88619.198286,0.19664900000498164,122085.5432745237,136283.42884693583
"147.32.84.165",2667,"74.6.136.65",25,3,186,3,186,0,0,88619.244049,8.988131999998586,165.55164076364633,0
"147.32.84.165",4669,"174.128.246.102",80,36,2168,19,1144,17,1024,88619.244079,619.7625970000081,14.766944704796183,13.217964491006374
"147.32.84.165",1939,"68.67.185.206",80,10,1603,6,777,4,826,88619.244103,20.83872600000177,298.2907880260757,317.1019188024949
"147.32.84.165",2672,"124.108.110.37",25,3,186,3,186,0,0,88619.312453,8.919787999999244,166.82010828061453,0
"147.32.84.165",4675,"193.23.181.44",80,6,364,4,242,2,122,88621.912009,0.14251700000022538,13584.344323813568,6848.305816137419
"147.32.84.165",1940,"195.113.232.98",80,11,2434,7,1219,4,1215,88621.982602,80.66006599999673,120.90245500171541,120.50572832410519
"147.32.84.165",2673,"64.12.90.33",25,3,186,3,186,0,0,88621.982633,8.958322999998927,166.10251717873737,0
"147.32.84.165",4679,"193.23.181.44",80,6,364,4,242,2,122,88622.91548,0.14393900000141002,13450.142073941288,6780.65013644974
"147.32.84.165",1942,"216.120.27.21",80,9,1237,5,609,4,628,88622.981957,0.5599940000101924,8700.0932151261,8971.524694744156
"147.32.84.165",2680,"212.27.48.6",25,3,186,3,186,0,0,88623.166764,8.97817900001246,165.73516745410566,0
"147.32.84.165",4683,"174.37.196.55",80,6,366,3,186,3,180,88623.617398,1.3247279999923194,1123.2494519694815,1087.0155986801433
"147.32.84.165",1965,"82.227.106.170",6667,2,124,2,124,0,0,88623.817953,3.010370999996667,329.5274901336408,0
"147.32.84.165",1966,"46.4.36.120",443,3,186,3,186,0,0,88624.942257,9.008394000004046,165.17927612839,0
"147.32.84.165",1968,"173.192.170.88",80,3,186,3,186,0,0,88625.423448,9.028632999994443,164.80900264756755,0
"147.32.84.165",1946,"184.82.147.251",80,10,1914,5,1002,5,912,88626.828401,0.3540719999873545,22639.463160843803,20605.978445797955
"147.32.84.165",2681,"74.6.136.65",25,3,186,3,186,0,0,88626.94474,9.012106999987736,165.11122204852037,0
"147.32.84.165",4716,"174.128.246.102",80,8,484,5,302,3,182,88627.381509,3.3110880000022007,729.6695225250414,439.7346129124422
"147.32.84.165",1949,"217.163.21.37",80,13,6081,6,750,7,5331,88627.381541,0.18609699999797158,32241.250530988673,229170.80877426747
"147.32.84.165",2682,"64.12.90.33",25,3,186,3,186,0,0,88627.427419,8.931251000001794,166.60599954023252,0
"147.32.84.165",4727,"72.20.15.61",80,7,424,4,242,3,182,88627.427453,0.39510100000188686,4900.012908068455,3685.1336746630523
"147.32.84.165",1960,"173.241.240.4",80,9,2194,5,1164,4,1030,88627.611397,0.06742000000667758,138119.25243366504,122218.92612257302
"147.32.84.165",2692,"128.121.85.2",25,3,186,3,186,0,0,88627.62762,8.931498000005377,166.60139206201515,0
"147.32.84.165",4728,"67.19.72.206",80,6,366,3,186,3,180,88633.147805,1.3574959999968996,1096.135826553742,1060.776606342331
"147.32.84.165",1981,"71.224.19.142",6667,2,124,2,124,0,0,88633.950722,3.0096100000082515,329.61081336029594,0
"147.32.84.165",1961,"68.67.179.211",80,10,2381,6,1058,4,1323,88634.505437,11.429038000002038,740.5697662391613,926.0621935107848
"147.32.84.165",2693,"74.6.136.65",25,3,186,3,186,0,0,88634.534551,8.845883000001777,168.2138459212835,0
"147.32.84.165",4749,"193.23.181.44",80,6,364,4,242,2,122,88634.534585,0.1516319999936968,12767.753509024991,6436.63606653326
"147.32.84.165",1974,"184.82.147.252",80,10,1308,5,586,5,722,88634.599814,0.34349400000064634,13647.982206359293,16815.432001691825
"147.32.84.165",2694,"207.115.11.16",25,3,186,3,186,0,0,88634.713477,8.868270000006305,167.78920804158443,0
"147.32.84.165",4758,"193.23.181.44",179,7,424,4,242,3,182,88639.969764,0.13591100000485312,14244.615961407606,10712.892995769356
"147.32.84.165",1976,"217.163.21.37",80,10,1451,5,701,5,750,88640.036772,0.13963299999886658,40162.42578792635,42969.78507980709
"147.32.84.165",2696,"165.212.65.113",25,3,186,3,186,0,0,88640.08267,8.915968000001158,166.8915814861389,0
"147.32.84.165",4759,"72.20.15.61",80,7,424,4,242,3,182,88640.270582,0.36662699999578763,5280.571261860811,3971.3387175978005
"147.32.84.165",1984,"217.163.21.40",80,13,5830,6,729,7,5101,88640.453597,0.18741399999998976,31118.272914511825,217742.53791073363
"147.32.84.165",2698,"205.188.156.193",25,3,186,3,186,0,0,88640.499504,8.900140999990981,167.1883625216171,0
"147.32.84.165",4771,"193.23.181.44",179,7,422,4,242,3,180,88642.879022,0.14026000000012573,13802.937401955402,10266.647654346993
"147.32.84.165",1985,"46.137.9.143",80,8,1390,5,684,3,706,88642.947253,0.13253199998871423,41288.14173532406,42616.122902249685
"147.32.84.165",2699,"168.61.70.66",25,3,186,3,186,0,0,88642.988882,9.019208999990951,164.98120844095007,0
"147.32.84.165",4776,"67.19.72.206",80,6,366,3,186,3,180,88644.08301,1.3569120000029216,1096.607591352126,1061.2331529214125
"147.32.84.165",2003,"83.238.197.86",6667,2,124,2,124,0,0,88645.440057,2.9562909999949625,335.5555999059938,0
"147.32.84.165",1986,"217.163.21.39",80,15,7515,7,2444,8,5071,88645.888392,0.1953650000068592,100079.33867025074,207652.34304289753
"147.32.84.165",2704,"74.6.136.65",25,3,186,3,186,0,0,88645.934286,8.982881999996607,165.64839658369797,0
"147.32.84.165",4777,"193.23.181.44",80,6,364,4,242,2,122,88645.934317,0.1252939999976661,15451.657701374867,7789.678675899726
"147.32.84.165",1987,"184.82.147.251",80,10,1910,5,982,5,928,88645.996591,0.36113299999851733,21753.758310739406,20557.523128682453
"147.32.84.165",2710,"64.12.90.97",25,3,186,3,186,0,0,88646.115969,9.001792999988538,165.300401820159,0
"147.32.84.165",4778,"193.23.181.44",80,6,364,4,242,2,122,88646.390044,0.2563220000010915,7552.999742479209,3807.7106139771217
"147.32.84.165",1991,"217.163.21.39",80,13,5735,7,2553,6,3182,88646.454934,0.280921000012313,72703.71385231007,90616.22306229951
"147.32.84.165",2715,"74.6.136.65",25,3,186,3,186,0,0,88646.500643,9.018723999994108,164.99008063679207,0
"147.32.84.165",4790,"174.128.246.102",80,32,1924,16,962,16,962,88646.500674,610.7276189999975,12.60136231042145,12.60136231042145
"147.32.84.165",1992,"95.172.94.59",80,8,1192,5,803,3,389,88646.500698,0.11049399999319576,58138.90347345187,28164.425219393248
"147.32.84.165",2721,"205.188.59.193",25,3,186,3,186,0,0,88646.546649,8.972787000006065,165.83476237639368,0
"147.32.84.165",4794,"193.23.181.44",179,9,542,5,302,4,240,88647.895034,3.1935640000010608,756.5215539751819,601.2091819670319
"147.32.84.165",2009,"46.4.36.120",443,3,186,3,186,0,0,88647.955683,8.967958000008366,165.9240598582879,0
"147.32.84.165",1993,"74.125.232.199",80,16,5902,9,3860,7,2042,88648.496626,61.91684100001294,498.7334544408289,263.8377497326872
"147.32.84.165",2722,"68.6.19.3",25,3,186,3,186,0,0,88648.504626,9.02102700000978,164.94795991613668,0
"147.32.84.165",4795,"72.20.15.61",80,7,424,4,242,3,182,88650.001837,0.44240800000261515,4376.0510659584725,3291.0797272910827
"147.32.84.165",1994,"74.125.232.199",80,8,1440,5,934,3,506,88650.184605,60.22896100000071,124.05991861622704,67.2101914559003
"147.32.84.165",2724,"64.12.90.34",25,3,186,3,186,0,0,88650.184635,8.945967999999993,166.33191623310088,0
"147.32.84.165",4797,"67.19.72.206",80,6,366,3,186,3,180,88655.619547,1.3629800000053365,1091.72548386196,1056.5085327696386
"147.32.84.165",2014,"117.204.73.9",6667,2,124,2,124,0,0,88656.982641,2.9507290000037756,336.1881080908246,0
"147.32.84.165",1995,"217.163.21.40",80,4,244,3,182,1,62,88660.033664,0.04597500000090804,31669.38553499169,10788.47199543673
"147.32.84.165",2728,"207.115.21.22",25,3,186,3,186,0,0,88660.079497,8.983261000001221,165.64140794749233,0
"147.32.84.165",4823,"67.19.72.206",80,6,366,3,186,3,180,88661.036606,1.362877000006847,1091.8079914713685,1056.5883788432598
"147.32.84.165",1996,"79.125.30.17",80,4,244,3,182,1,62,88661.438254,0.042651000010664575,34137.53486755147,11629.270119715336
"147.32.84.165",2733,"74.6.136.65",25,3,186,3,186,0,0,88661.480766,8.986302000004798,165.585354242402,0
"147.32.84.165",4826,"174.128.246.102",80,9,725,6,543,3,182,88662.399605,3.2623400000011316,1331.5595554106847,446.3054126790877
"147.32.84.165",2004,"217.163.21.39",80,13,5509,7,2483,6,3026,88662.399637,0.2319100000022445,85653.91746715429,104385.32189110306
"147.32.84.165",2734,"68.6.19.3",25,3,186,3,186,0,0,88662.445404,9.024552000002586,164.88353106055277,0
"147.32.84.165",4834,"174.128.246.102",80,8,634,5,452,3,182,88662.445434,0.3253580000018701,11113.911445174903,4475.070537658921
"147.32.84.165",2008,"184.82.147.252",80,10,1507,5,596,5,911,88662.445458,0.36422200000379235,13090.917077909502,20009.77425834825
"147.32.84.165",2735,"205.188.156.193",25,3,186,3,186,0,0,88662.565988,9.004847000003792,165.24434007589173,0
"147.32.84.165",4835,"67.19.72.206",80,6,366,3,186,3,180,88664.04702,1.3578640000050655,1095.8387585166474,1060.4891211451427
"147.32.84.165",2026,"117.240.58.147",6667,2,124,2,124,0,0,88665.405045,2.9553699999960372,335.6601711465333,0
"147.32.84.165",2015,"184.82.147.251",80,10,1925,5,990,5,935,88667.156343,0.3618550000101095,21887.220018456926,20671.263350764875
"147.32.84.165",2738,"200.48.7.157",25,3,186,3,186,0,0,88667.275926,8.909895000004326,167.00533507962524,0
"147.32.84.165",4844,"72.20.15.61",80,7,424,4,242,3,182,88667.557494,0.3704240000079153,5226.443210911364,3930.6308445697036
"147.32.84.165",2024,"217.163.21.37",80,13,6077,6,749,7,5328,88667.742225,0.18618400000559632,32183.21660196307,228934.81716322998
"147.32.84.165",2739,"205.188.103.2",25,3,186,3,186,0,0,88667.788072,8.898948000001837,167.21077592538947,0
"147.32.84.165",4850,"193.23.181.44",179,7,424,4,242,3,182,88668.961978,0.13126299998839386,14749.015336927992,11092.23467487973
"147.32.84.165",2030,"212.117.171.138",65500,65,27591,33,2866,32,24725,88669.024512,154.62197100000049,148.2842305767783,1279.2489884894778
"147.32.84.165",2034,"184.82.147.252",80,10,1515,5,603,5,912,88669.024544,0.36025599999993574,13390.47788239713,20252.265055963817
"147.32.84.165",2740,"64.12.90.97",25,3,186,3,186,0,0,88669.143782,8.847164999999222,168.18947086441034,0
"147.32.84.165",4852,"72.20.15.61",80,7,424,4,242,3,182,88669.564152,0.3701369999907911,5230.495735492986,3933.6786109905925
"147.32.84.165",2036,"64.12.168.40",587,51,15723,23,13161,28,2562,88669.748821,22.23802099999739,4734.593964094753,921.6647470565122
"147.32.84.165",2035,"217.163.21.37",80,10,1448,5,699,5,749,88669.866522,0.13863000000128523,40337.58926601859,43222.96761122736
"147.32.84.165",2748,"61.9.189.122",25,3,186,3,186,0,0,88669.912262,8.881865000003017,167.53238199404004,0
"147.32.84.165",4855,"67.19.72.206",80,6,366,3,186,3,180,88670.065908,1.3573820000019623,1096.227885737286,1060.865695874793
"147.32.84.165",2041,"46.4.36.120",443,6,366,3,186,3,180,88671.169148,1.0309180000040215,1443.3737697801334,1396.8133255936775
"147.32.84.165",2039,"217.163.21.37",80,14,6141,7,810,7,5331,88671.423409,0.18723900000622962,34608.17457786254,227773.0600920805
"147.32.84.165",2750,"209.86.93.226",25,3,186,3,186,0,0,88671.46923,8.829349999999977,168.52882715035693,0
"147.32.84.165",4858,"174.128.246.102",80,10,604,7,422,3,182,88672.20018,21.197050999995554,159.26743772049744,68.68880015433776
"147.32.84.165",2046,"94.100.176.20",25,3,186,3,186,0,0,88672.360094,8.841008000003058,168.30660033329744,0
"147.32.84.165",2040,"217.163.21.39",80,13,5742,7,2551,6,3191,88680.097506,0.2585549999930663,78930.98180482793,98733.34493892822
"147.32.84.165",2755,"74.6.136.65",25,3,186,3,186,0,0,88680.143356,8.983150000000023,165.6434546901695,0
"147.32.84.165",4861,"72.20.15.61",80,7,424,4,242,3,182,88680.143387,0.3737649999966379,5179.725228465519,3895.4958329782003
"147.32.84.165",2048,"111.253.202.95",6667,3,186,3,186,0,0,88680.326377,9.000674999988405,165.32093426347657,0
"147.32.84.165",2050,"46.4.36.120",443,6,366,3,186,3,180,88681.000496,1.031025000003865,1443.2239761348385,1396.6683640014567
"147.32.84.165",2047,"217.163.21.37",80,10,1451,5,701,5,750,88682.031643,0.13966100000834558,40154.373802742986,42961.17025971076
"147.32.84.165",2757,"213.165.64.102",25,3,186,3,186,0,0,88682.077579,8.954917999988538,166.16567566580784,0
"147.32.84.165",4868,"72.20.15.61",80,7,424,4,242,3,182,88682.405127,0.3701979999896139,5229.633871750565,3933.0304324735653
"147.32.84.165",2053,"184.82.147.251",80,10,1929,5,994,5,935,88682.589907,0.34239000000525266,23224.977364636838,21846.432430518555
"147.32.84.165",2758,"64.12.90.34",25,3,186,3,186,0,0,88682.703007,9.172913000002154,162.2167352944098,0
"147.32.84.165",4918,"193.23.181.44",80,6,364,4,242,2,122,88683.508623,0.13392100000055507,14456.283928524845,7287.8786747108725
"147.32.84.165",2065,"143.107.171.10",6667,2,124,2,124,0,0,88683.575167,2.9431990000011865,337.0482254171737,0
"147.32.84.165",2064,"46.4.36.120",443,6,366,3,186,3,180,88688.223588,1.030599000005168,1443.820535428948,1397.2456794473692
"147.32.84.165",2059,"217.163.21.39",80,11,4128,6,2498,5,1630,88688.725504,0.29353500000433996,68080.46740492457,44424.003951171755
"147.32.84.165",2760,"205.188.190.2",25,3,186,3,186,0,0,88688.771279,8.982452000011108,165.65632635700808,0
"147.32.84.165",4924,"174.128.246.102",80,9,544,6,362,3,182,88689.254298,9.259155000007013,312.7715218070987,157.2497706322982
"147.32.84.165",2063,"184.82.147.252",80,10,1515,5,603,5,912,88689.254329,0.33282100000360515,14494.277704675324,21921.69364289203
"147.32.84.165",2766,"207.115.21.22",25,3,186,3,186,0,0,88689.364479,8.991594999999506,165.4878806263051,0
"147.32.84.165",4929,"193.23.181.44",179,7,424,4,242,3,182,88690.02957,0.12883400000282563,15027.089122107045,11301.364546378025
"147.32.84.165",2072,"217.163.21.37",80,10,2277,5,1156,5,1121,88690.092095,0.1392489999998361,66413.40332792973,64402.61689499067
"147.32.84.165",2767,"65.254.254.52",25,3,186,3,186,0,0,88690.137883,9.020437999992282,164.9587303855171,0
"147.32.84.165",4974,"72.20.15.61",80,7,424,4,242,3,182,88690.83199,0.37017299998842645,5229.987060267847,3933.296053589868
"147.32.84.165",2075,"46.4.36.120",443,6,366,3,186,3,180,88691.01671,1.3475640000106068,1104.214716323891,1068.5948867650557
"147.32.84.165",2073,"217.163.21.37",80,14,6141,7,810,7,5331,88692.336829,0.21849499999370892,29657.42923264412,195189.82128299482
"147.32.84.165",2768,"74.6.136.65",25,3,186,3,186,0,0,88692.364385,9.001153000004706,165.31215500938848,0
"147.32.84.165",1029,"193.23.181.44",80,6,364,4,242,2,122,88692.382561,0.16961499999160878,11414.084839759325,5754.208059713379
"147.32.84.165",2074,"217.163.21.39",80,14,6365,7,3013,7,3352,88692.443877,0.1742530000046827,138327.60411213725,153891.18120938735
"147.32.84.165",2769,"205.188.156.193",25,3,186,3,186,0,0,88692.489721,8.975808999995934,165.77892867380245,0
"147.32.84.165",1030,"193.23.181.44",179,6,362,4,242,2,120,88693.239532,0.13008099999569822,14883.03441750927,7380.017066533523
"147.32.84.165",2081,"61.26.131.206",6667,2,124,2,124,0,0,88693.303692,2.945269999996526,336.81122613586194,0
"147.32.84.165",2082,"74.125.93.27",25,3,186,3,186,0,0,88699.660003,8.92877800000133,166.6521443359638,0
"147.32.84.165",2077,"184.82.147.251",80,10,1925,5,990,5,935,88701.365608,0.36129000000073574,21921.44814410549,20703.589913877404
"147.32.84.165",2772,"207.115.21.22",25,3,186,3,186,0,0,88701.485077,8.909117999995942,167.01990028650172,0
"147.32.84.165",1040,"193.23.181.44",80,6,364,4,242,2,122,88701.485108,0.1255480000108946,15420.396978303124,7773.919137822237
"147.32.84.165",2083,"46.4.36.120",443,6,366,3,186,3,180,88701.547692,1.0488690000056522,1418.6709684355067,1372.9073888085547
"147.32.84.165",2078,"217.163.21.37",80,10,1451,5,701,5,750,88702.596677,0.13888199999928474,40379.60282850824,43202.14282650668
"147.32.84.165",2773,"65.55.37.120",25,3,186,3,186,0,0,88702.642509,8.85519000000204,168.03704945909203,0
"147.32.84.165",1045,"193.23.181.44",179,7,424,4,242,3,182,88703.07143,0.1309880000044359,14779.979844981506,11115.522032176175
"147.32.84.165",2108,"61.17.216.70",6667,2,124,2,124,0,0,88703.135544,2.8449649999965914,348.68618770395716,0
"147.32.84.165",2109,"46.4.36.120",443,6,366,3,186,3,180,88703.672864,1.0307620000094175,1443.5922162307156,1397.0247253845635
"147.32.84.165",2079,"173.241.240.4",80,9,2195,5,1165,4,1030,88704.703745,0.06827899999916553,136498.7770780753,120681.32222353439
"147.32.84.165",2774,"205.188.146.194",25,3,186,3,186,0,0,88704.720021,8.884368999992148,167.48516411253462,0
"147.32.84.165",1077,"174.37.196.55",80,6,366,3,186,3,180,88709.692179,1.3248299999977462,1123.1629718549032,1086.9319082466805
"147.32.84.165",2111,"46.4.36.120",443,6,366,3,186,3,180,88709.692248,1.0303339999954915,1444.1918834150006,1397.6050484661296
"147.32.84.165",2101,"184.82.147.252",80,10,1515,5,603,5,912,88710.293995,0.39287500000500586,12278.714603725191,18570.79223647989
"147.32.84.165",2775,"74.6.136.65",25,3,186,3,186,0,0,88710.413291,9.010129000002053,165.1474690317598,0
"147.32.84.165",1082,"193.23.181.44",80,6,364,4,242,2,122,88710.413322,0.15743100001418497,12297.450945655944,6199.54138582655
"147.32.84.165",2104,"217.163.21.39",80,14,5804,7,2558,7,3246,88710.475713,0.23826299999200273,85888.2831185995,108988.80649060749
"147.32.84.165",2779,"205.188.156.193",25,3,186,3,186,0,0,88710.521549,9.001569000000018,165.3045152461751,0
"147.32.84.165",1084,"174.128.246.102",80,3,186,3,186,0,0,88710.521579,9.001600000003236,165.30394596510232,0
"147.32.84.165",2129,"184.82.147.251",80,10,1914,5,1002,5,912,88710.723298,0.34283000000868924,23381.851062616544,21281.68479950727
"147.32.84.165",2782,"77.238.184.241",25,3,186,3,186,0,0,88710.836722,8.987760000003618,165.55849288358846,0
"147.32.84.165",1085,"72.20.15.61",80,7,424,4,242,3,182,88711.017125,0.3663150000065798,5285.068861404052,3974.7212098162704
"147.32.84.165",2133,"217.163.21.37",80,14,6141,7,810,7,5331,88711.096751,0.18867699999827892,34344.408698776795,226037.089843431
"147.32.84.165",2783,"80.12.242.9",25,3,186,3,186,0,0,88711.142659,8.98271399999794,165.6514946374048,0
"147.32.84.165",1087,"193.23.181.44",80,6,364,4,242,2,122,88711.199725,0.12566800000786316,15405.672087395858,7766.495845711962
"147.32.84.165",2134,"184.82.147.252",80,10,1305,5,584,5,721,88711.26216,0.34670399999595247,13475.471872417227,16636.669897282227
"147.32.84.165",2784,"205.188.59.193",25,3,186,3,186,0,0,88711.37615,8.949831999998423,166.2601041003074,0
"147.32.84.165",1088,"174.37.196.55",80,6,366,3,186,3,180,88713.303355,1.3244980000017677,1123.4445050109657,1087.2043596880314
"147.32.84.165",2141,"219.145.198.122",6667,10,1164,5,606,5,558,88713.404384,1.564836000005016,3098.088234156461,2852.6951066985234
"147.32.84.165",2139,"46.4.36.120",443,6,366,3,186,3,180,88713.736287,0.999958999993396,1488.061010511258,1440.0590424302497
"147.32.84.165",2136,"217.163.21.37",80,10,1451,5,701,5,750,88714.62798,0.14142099999298807,39654.64818010094,42426.5137447585
"147.32.84.165",2785,"64.12.90.97",25,3,186,3,186,0,0,88714.674545,8.962115999995149,166.03221828425401,0
"147.32.84.165",1098,"174.128.246.102",80,7,424,4,242,3,182,88714.736373,0.3275289999874076,5910.926971579411,4445.407887716747
"147.32.84.165",2138,"217.163.21.39",80,15,7515,7,2446,8,5069,88714.736409,0.19567699999606702,100001.53314080501,207239.48139441563
"147.32.84.165",2786,"205.188.103.2",25,3,186,3,186,0,0,88714.782207,8.954454999999143,166.17426744566168,0
"147.32.84.165",1123,"174.37.196.55",80,6,366,3,186,3,180,88719.724312,1.3252899999934016,1122.7731289056799,1086.5546408764644
"147.32.84.165",2164,"221.209.60.2",6667,2,124,2,124,0,0,88720.626765,3.0098370000050636,329.5859543218889,0
"147.32.84.165",2161,"46.4.36.120",443,6,366,3,186,3,180,88721.049721,1.0090599999966798,1474.639763745363,1427.0707391084159
"147.32.84.165",2150,"217.163.21.39",80,11,4128,6,2498,5,1630,88722.058904,0.28422499999578577,70310.49344813547,45879.1450442197
"147.32.84.165",2787,"74.6.136.65",25,3,186,3,186,0,0,88722.104752,8.955191999993986,166.16059153181746,0
"147.32.84.165",1124,"67.19.72.206",80,6,366,3,186,3,180,88723.536111,1.36498000001302,1090.125862639604,1054.9605122318749
"147.32.84.165",2176,"74.125.39.27",25,3,186,3,186,0,0,88724.901208,8.967912000007345,165.92491094903488,0
"147.32.84.165",2153,"217.163.21.39",80,13,5493,7,2482,6,3011,88725.643334,0.26347000000532717,75363.4189835599,91425.96879915344
"147.32.84.165",2794,"205.188.59.193",25,3,186,3,186,0,0,88725.689109,8.983003999994253,165.64614687925686,0
"147.32.84.165",1146,"67.19.72.206",80,6,366,3,186,3,180,88725.689141,1.4188040000008186,1048.7706547198495,1014.9393432772738
"147.32.84.165",2182,"46.4.36.120",443,6,366,3,186,3,180,88727.108083,0.9701300000015181,1533.8150557117826,1484.3371506888218
"147.32.84.165",2167,"184.82.147.251",80,10,1910,5,982,5,928,88728.078327,0.3620820000069216,21696.74272637089,20503.64282084744
"147.32.84.165",2798,"64.12.90.97",25,3,186,3,186,0,0,88728.197792,8.916843999992125,166.875185884301,0
"147.32.84.165",1159,"193.23.181.44",179,7,422,4,242,3,180,88728.197823,0.1513190000114264,12794.16332287293,9516.319826930277
"147.32.84.165",2195,"124.123.147.161",6667,6,366,3,186,3,180,88728.260453,1.369367000006605,1086.6334591039677,1051.5807668748073
"147.32.84.165",2199,"46.4.36.120",443,6,366,3,186,3,180,88729.629959,1.055993000001763,1409.100249715212,1363.6454029502052
"147.32.84.165",2179,"217.163.21.37",80,10,2277,5,1156,5,1121,88730.686088,0.15987499999755528,57845.191556787584,56093.823300310454
"147.32.84.165",2799,"77.238.184.241",25,3,186,3,186,0,0,88730.731903,8.855256999988342,168.0357780696776,0
"147.32.84.165",1160,"174.128.246.102",80,3,186,3,186,0,0,88730.731934,8.855293000000529,168.03509494264176,0
"147.32.84.165",2190,"195.113.232.96",80,27,30436,17,1664,10,28772,88730.731958,62.07247400000051,214.45898869762934,3708.1815040914607
"147.32.84.165",2800,"205.188.103.2",25,3,186,3,186,0,0,88730.73272,8.854529000003822,168.04959360338168,0
"147.32.84.165",1162,"67.19.72.206",80,6,366,3,186,3,180,88730.732751,1.3936069999908796,1067.7328687425781,1033.2898729766887
"147.32.84.165",2198,"184.82.147.252",80,10,1507,5,596,5,911,88731.561575,0.34634299999743234,13766.699485871948,21042.723543002256
"147.32.84.165",2801,"165.21.74.122",25,3,186,3,186,0,0,88731.675133,8.915376999997534,166.9026447227539,0
"147.32.84.165",1179,"174.128.246.102",80,32,1924,16,962,16,962,88731.862976,610.7268449999974,12.601378280661681,12.601378280661681
"147.32.84.165",2206,"46.4.36.120",443,6,366,3,186,3,180,88732.023142,0.9707699999999022,1532.803856732439,1483.3585710313926
"147.32.84.165",2201,"217.163.21.39",80,14,6360,7,3008,7,3352,88732.126479,0.23171200000797398,103853.05896618163,115729.87156071835
"147.32.84.165",2806,"74.6.136.65",25,3,186,3,186,0,0,88732.163808,8.928444999997737,166.65835988241818,0
"147.32.84.165",1192,"67.19.72.206",80,6,366,3,186,3,180,88732.163869,1.36785900000541,1087.8314212167445,1052.7400850484623
"147.32.84.165",2207,"217.163.21.37",80,14,6134,7,809,7,5325,88732.172251,0.2127970000001369,30413.962602836677,200190.79216329457
"147.32.84.165",2813,"71.74.56.243",25,3,186,3,186,0,0,88732.237492,8.854823000001488,168.04401397969784,0
"147.32.84.165",1202,"72.20.15.61",80,7,424,4,242,3,182,88732.364361,0.4504889999952866,4297.552215526364,3232.043401759497
"147.32.84.165",2208,"173.241.240.4",80,9,2195,5,1165,4,1030,88732.549095,0.06497800000943244,143433.16197246878,126812.15178681789
"147.32.84.165",2814,"205.188.190.2",25,3,186,3,186,0,0,88732.565661,8.927702000000863,166.6722298750402,0
"147.32.84.165",1208,"174.128.246.102",80,3,186,3,186,0,0,88732.994025,8.900788999992074,167.17619078503324,0
"147.32.84.165",2212,"68.202.89.226",6667,2,124,2,124,0,0,88732.994056,2.9821369999990566,332.6473599302493,0
"147.32.84.165",2209,"217.163.21.37",80,10,1446,5,698,5,748,88733.531873,0.13840300000447314,40345.94625708638,43236.057020487984
"147.32.84.165",2822,"74.6.136.65",25,3,186,3,186,0,0,88733.577657,8.918846000000485,166.83772766117042,0
"147.32.84.165",1210,"174.37.196.55",80,6,366,3,186,3,180,88733.577691,1.315734000003431,1130.927679908036,1094.4461418464864
"147.32.84.165",2216,"46.4.36.120",443,6,366,3,186,3,180,88734.270319,1.030944999991334,1443.3359684682578,1396.776743678959
"147.32.84.165",2215,"217.163.21.39",80,11,4122,6,2495,5,1627,88734.893536,0.23082399999839254,86472.81045358803,56389.283610415914
"147.32.84.165",2825,"64.191.223.38",25,3,186,3,186,0,0,88734.939325,8.861355000000913,167.9201431383628,0
"147.32.84.165",1211,"67.19.72.206",80,6,366,3,186,3,180,88735.301395,1.2307000000000698,1209.068010075498,1170.065816202095
"147.32.84.165",2221,"217.163.21.37",80,10,2272,5,1153,5,1119,88735.674609,0.13932600000407547,66204.44138014574,64252.185519846564
"147.32.84.165",2826,"205.188.59.193",25,3,186,3,186,0,0,88735.720559,8.883726000000024,167.49728661149567,0
"147.32.84.165",1220,"174.37.196.55",80,6,366,3,186,3,180,88735.77545,1.2245359999942593,1215.1541481891718,1175.9556272798438
"147.32.84.165",2224,"46.4.36.120",443,6,366,3,186,3,180,88736.532242,0.9764960000029532,1523.8157657537765,1474.6604184713967
"147.32.84.165",2223,"217.163.21.39",80,14,6360,7,3010,7,3350,88737.000109,0.21365599999262486,112704.53439562293,125435.27914463017
"147.32.84.165",2827,"71.74.56.243",25,3,186,3,186,0,0,88737.045832,8.961758999997983,166.038832331949,0
"147.32.84.165",1242,"174.128.246.102",80,11,668,7,424,4,244,88737.045862,9.315658999999869,364.11809406076884,209.53965790289527
"147.32.84.165",2225,"184.82.147.251",80,10,1910,5,982,5,928,88737.045886,0.34292499998991843,22908.799300812003,21649.048626429267
"147.32.84.165",2829,"205.188.103.2",25,3,186,3,186,0,0,88737.159093,8.949314000012237,166.26972748949981,0
"147.32.84.165",1266,"72.20.15.61",80,10,1417,6,495,4,922,88737.508855,0.3712870000017574,10665.603697358798,19866.033553464265
"147.32.84.165",2227,"173.241.240.4",80,9,2193,5,1163,4,1030,88737.693476,0.06726599999819882,138316.53435984201,122498.73636340264
"147.32.84.165",2830,"74.6.136.65",25,3,186,3,186,0,0,88737.709777,9.0006560000038,165.32128324861785,0
"147.32.84.165",1271,"67.19.72.206",80,6,366,3,186,3,180,88737.709812,1.333543999993708,1115.8236998606876,1079.8293869619558
"147.32.84.165",2234,"46.4.36.120",443,6,366,3,186,3,180,88739.04351,0.9724359999963781,1530.1778214767266,1480.8172465903806
"147.32.84.165",2230,"184.82.147.252",80,10,1507,5,596,5,911,88740.016064,0.3445790000114357,13837.1752191566,21150.447356798093
"147.32.84.165",2837,"67.195.168.31",25,3,186,3,186,0,0,88740.130028,8.987869000004139,165.55648507998,0
"147.32.84.165",1274,"72.20.15.61",80,7,424,4,242,3,182,88742.998275,0.3771419999975478,5133.345000059892,3860.614834755787
"147.32.84.165",2244,"218.201.21.157",6667,2,124,2,124,0,0,88743.182851,2.92548999999417,339.0884945776526,0
"147.32.84.165",2241,"46.4.36.120",443,6,366,3,186,3,180,88745.806919,1.031235000002198,1442.9300789798917,1396.383947399895
"147.32.84.165",2239,"217.163.21.37",80,13,6077,6,749,7,5328,88746.838274,0.1861380000045756,32191.169991365045,228991.3934766261
"147.32.84.165",2839,"205.188.59.193",25,3,186,3,186,0,0,88746.884031,8.95498100000259,166.16450665831337,0
"147.32.84.165",1277,"67.19.72.206",80,6,366,3,186,3,180,88746.884061,1.3887509999913163,1071.4663751884277,1036.9029437307365
"147.32.84.165",2252,"66.111.4.71",25,3,186,3,186,0,0,88748.27293,8.971037999988766,165.8670936408767,0
"147.32.84.165",2251,"184.82.147.251",80,10,1894,5,982,5,912,88749.318148,0.3648619999876246,21531.4283215749,19996.601455474854
"147.32.84.165",2842,"68.6.19.3",25,3,186,3,186,0,0,88749.43866,9.009210000003804,165.1643151840585,0
"147.32.84.165",1278,"174.128.246.102",80,11,668,7,424,4,244,88752.62924,9.478852000000188,357.8492416592149,205.932110766152
"147.32.84.165",2259,"46.4.36.120",443,6,366,3,186,3,180,88752.629303,1.0300879999995232,1444.5367774410427,1397.9388168784285
"147.32.84.165",2253,"217.163.21.37",80,10,1448,5,699,5,749,88753.130897,0.13955600000917912,40069.93608037056,42936.16899026831
"147.32.84.165",2845,"205.188.103.2",25,3,186,3,186,0,0,88753.176933,8.982637000008253,165.6529146172369,0
"147.32.84.165",1279,"174.37.196.55",80,6,366,3,186,3,180,88753.176967,1.2779329999902984,1164.3802922463824,1126.8196376577896
"147.32.84.165",2273,"61.17.216.10",6667,2,124,2,124,0,0,88753.531748,3.009427000011783,329.6308566368667,0
"147.32.84.165",2269,"184.82.147.252",80,10,1306,5,586,5,720,88753.659501,0.36022299999604,13014.16067283748,15990.095024646735
"147.32.84.165",2848,"65.55.92.184",25,3,186,3,186,0,0,88753.778761,8.982629999998608,165.65304370771486,0
"147.32.84.165",1283,"67.19.72.206",80,6,366,3,186,3,180,88754.454967,1.3383370000083232,1111.8275890084083,1075.9621829113628
"147.32.84.165",2282,"46.4.36.120",443,6,366,3,186,3,180,88755.793434,0.9760709999973187,1524.4792643200008,1475.3025138580654
"147.32.84.165",2275,"217.163.21.39",80,13,5741,7,2556,6,3185,88755.83908,0.23950899999181274,85374.66233293523,106384.31124037509
"147.32.84.165",2854,"205.188.59.193",25,3,186,3,186,0,0,88755.88483,8.983001000000513,165.64620219901067,0
"147.32.84.165",1288,"193.23.181.44",179,7,424,4,242,3,182,88755.884861,0.18437899999844376,10500.111184117175,7896.777832683165
"147.32.84.165",2276,"93.184.220.20",80,13,6571,8,762,5,5809,88755.950733,21.003644999989774,290.235337723665,2212.5683423054725
"147.32.84.165",2857,"74.6.136.65",25,3,186,3,186,0,0,88755.967067,9.001650999998674,165.30300941463062,0
"147.32.84.165",1315,"174.37.196.55",80,6,366,3,186,3,180,88756.64174,1.3246499999950174,1123.315592802323,1087.079605937732
"147.32.84.165",2286,"68.67.185.206",80,10,1589,6,773,4,816,88756.769618,20.184980999998515,306.3664018311662,323.408776059808
"147.32.84.165",2861,"193.253.177.101",25,3,186,3,186,0,0,88756.798719,8.972559000001638,165.83897637226218,0
"147.32.84.165",1324,"174.37.196.55",80,6,366,3,186,3,180,88757.966514,1.3041050000028918,1141.0124184760434,1104.2055662671387
"147.32.84.165",2295,"46.4.36.120",443,6,366,3,186,3,180,88757.966546,1.0098740000103135,1473.4511433949222,1425.9204613499246
"147.32.84.165",2287,"195.113.232.98",80,11,2396,7,1242,4,1154,88758.147108,83.83010900000227,118.52543338575083,110.12749607661551
"147.32.84.165",2862,"64.12.90.66",25,3,186,3,186,0,0,88758.147171,9.02835100000084,164.81415044672738,0
"147.32.84.165",1331,"72.20.15.61",80,7,424,4,242,3,182,88758.97653,0.3661839999986114,5286.959561333487,3976.143141168159
"147.32.84.165",2289,"63.251.249.49",80,9,1243,5,615,4,628,88759.159263,0.5365910000109579,9168.994634460001,9362.810781204684
"147.32.84.165",2864,"205.188.59.193",25,3,186,3,186,0,0,88759.337078,8.84170200000517,168.2933896662803,0
"147.32.84.165",1350,"193.23.181.44",80,6,364,4,242,2,122,88759.350368,0.12552499999583233,15423.222466156374,7775.3435573185025
"147.32.84.165",2291,"195.113.232.96",80,10,1383,6,875,4,508,88759.412596,60.7992360000062,115.1330256847189,66.84294519752822
"147.32.84.165",2865,"195.130.137.67",25,3,186,3,186,0,0,88759.412626,8.866377999991528,167.8250126490684,0
"147.32.84.165",1354,"174.128.246.102",80,32,1924,16,962,16,962,88761.15605,610.4193200000009,12.607726767232709,12.607726767232709
"147.32.84.165",2296,"46.4.36.120",443,6,366,3,186,3,180,88761.156078,1.031684999994468,1442.3007022569668,1395.7748731519034
"147.32.84.165",2292,"68.67.179.211",80,10,2406,6,1064,4,1342,88762.187877,14.766609999991488,576.4356206336395,727.0456794082182
"147.32.84.165",2866,"65.55.88.22",25,3,186,3,186,0,0,88762.216988,8.871226999995997,167.7332797369148,0
"147.32.84.165",1356,"174.37.196.55",80,6,366,3,186,3,180,88769.181545,1.3250689999986207,1122.9603892337295,1086.7358605487707
"147.32.84.165",2309,"27.255.33.216",6667,1,62,1,62,0,0,88769.382652,0,0,0
"147.32.84.165",2311,"46.4.36.120",443,6,366,3,186,3,180,88770.385805,1.0309810000035213,1443.2855697582377,1396.7279707337784
"147.32.84.165",2294,"184.82.147.251",80,10,1910,5,982,5,928,88770.506726,0.33680799999274313,23324.861642743836,22042.231776442237
"147.32.84.165",2867,"209.86.93.229",25,3,186,3,186,0,0,88770.618699,8.996238000006997,165.40247156631946,0
"147.32.84.165",1357,"67.19.72.206",80,6,366,3,186,3,180,88771.416904,1.3337009999959264,1115.6923478384922,1079.7022721017665
"147.32.84.165",2330,"117.96.96.152",6667,2,124,2,124,0,0,88772.750752,2.951811999999336,336.0647629321322,0
"147.32.84.165",2323,"216.157.130.15",25,3,186,3,186,0,0,88774.699683,9.028286000000662,164.81533704181402,0
"147.32.84.165",2307,"217.163.21.40",80,14,5878,7,785,7,5093,88776.906373,0.1924929999950109,32624.562971966603,211664.83976589286
"147.32.84.165",2870,"205.188.59.193",25,3,186,3,186,0,0,88776.954176,8.98095199999807,165.68399430264407,0
"147.32.84.165",1359,"193.23.181.44",80,7,424,4,242,3,182,88776.954207,0.1337550000025658,14474.22526232935,10885.574370842734
"147.32.84.165",2328,"46.4.36.120",443,6,366,3,186,3,180,88777.020738,1.0250859999941895,1451.5855255153563,1404.7601859826027
"147.32.84.165",2310,"74.121.138.200",80,10,1491,6,710,4,781,88777.709096,8.068204999988666,703.9979772462375,774.3977749708612
"147.32.84.165",2871,"74.6.136.65",25,3,186,3,186,0,0,88777.73503,9.00256600001012,165.2862083986196,0
"147.32.84.165",1363,"174.128.246.102",80,3,186,3,186,0,0,88778.045928,8.99247299999115,165.47172285104045,0
"147.32.84.165",2355,"46.4.36.120",443,6,366,3,186,3,180,88779.113398,1.035042000003159,1437.622821098524,1391.2478913856685
"147.32.84.165",2327,"184.82.147.252",80,10,1507,5,596,5,911,88779.414237,0.36873499999637716,12930.695486045117,19764.871791589096
"147.32.84.165",2873,"205.188.103.2",25,3,186,3,186,0,0,88779.535611,9.007763000001432,165.19084705045674,0
"147.32.84.165",1387,"67.19.72.206",80,6,366,3,186,3,180,88780.148556,1.3320180000009714,1117.1020211430439,1081.0664720739132
"147.32.84.165",2346,"95.172.94.59",80,8,1196,5,807,3,389,88780.217271,0.05521700000099372,116920.51360783479,56359.45451480512
"147.32.84.165",2875,"65.55.92.136",25,3,186,3,186,0,0,88780.235401,9.010214000009,165.14591107364527,0
"147.32.84.165",1401,"193.23.181.44",80,6,364,4,242,2,122,88780.317305,0.1974320000008447,9805.907856840415,4943.474208820375
"147.32.84.165",2347,"74.125.232.199",80,16,6016,9,3974,7,2042,88780.387874,61.58914100000402,516.1948922131894,265.24156263194084
"147.32.84.165",2879,"205.188.59.193",25,3,186,3,186,0,0,88780.395874,8.949711000008392,166.26235193500713,0
"147.32.84.165",1404,"193.23.181.44",179,10,753,5,451,5,302,88781.480701,0.19219900001189671,18772.210051960064,12570.304735458845
"147.32.84.165",2364,"173.192.170.88",80,26,5159,12,945,14,4214,88781.543907,39.29789800000435,192.37670167496395,857.8575882098393
"147.32.84.165",2368,"210.212.69.248",6667,2,124,2,124,0,0,88783.126167,3.0095410000067204,329.61837037534457,0
"147.32.84.165",2363,"46.4.36.120",443,6,366,3,186,3,180,88784.73131,1.0378099999943515,1433.7884583961406,1387.5372178027167
"147.32.84.165",2348,"74.125.232.199",80,8,1459,5,953,3,506,88785.769244,62.73183699999936,121.53318577296051,64.5286379864827
"147.32.84.165",2881,"74.6.136.65",25,3,186,3,186,0,0,88785.769274,8.994703999997,165.43068009803284,0
"147.32.84.165",1412,"193.23.181.44",80,6,364,4,242,2,122,88785.7693,0.1298149999929592,14913.530794630846,7518.391557623814
"147.32.84.165",2350,"79.125.30.17",80,8,1510,5,808,3,702,88785.83379,0.13656800000171643,47331.73217678196,41122.371272402146
"147.32.84.165",2883,"205.188.103.2",25,3,186,3,186,0,0,88785.876847,8.987718999997014,165.5592481251911,0
"147.32.84.165",1569,"31.192.109.161",80,6,364,4,242,2,122,88785.87688,0.18524200000683777,10451.193573425773,5268.783537016299
"147.32.84.165",2351,"217.163.21.40",80,10,1523,5,705,5,818,88785.971627,0.15076599999156315,37408.96488807565,43405.01174247643
"147.32.84.165",2888,"205.188.59.193",25,3,186,3,186,0,0,88786.018173,8.946518999990076,166.32167214998935,0
"147.32.84.165",2354,"184.82.147.251",80,10,1921,5,990,5,931,88786.018206,0.36849600001005456,21492.77061293447,20211.888323880798
"147.32.84.165",2892,"74.6.136.65",25,3,186,3,186,0,0,88786.138392,9.02714800000831,164.83611435180083,0
"147.32.84.165",2356,"217.163.21.37",80,13,6077,6,749,7,5328,88786.138423,0.19563899999775458,30627.840052692827,217870.66996094445
"147.32.84.165",2899,"64.12.90.97",25,3,186,3,186,0,0,88786.185594,8.980080000008456,165.70008284988538,0
"147.32.84.165",2378,"46.4.36.120",443,6,366,3,186,3,180,88789.446489,1.030188000004273,1444.3965567389916,1397.8031194248306
"147.32.84.165",2374,"217.163.21.39",80,11,4250,6,2507,5,1743,88790.47695,0.2434250000078464,82390.88014523376,57282.53055171219
"147.32.84.165",2903,"209.198.194.11",25,3,186,3,186,0,0,88790.523242,8.859156999998959,167.96180494376327,0
"147.32.84.165",2393,"46.4.36.120",443,6,366,3,186,3,180,88791.653656,1.0308179999992717,1443.5137919604151,1396.948830929434
"147.32.84.165",2375,"184.82.147.252",80,10,1499,5,599,5,900,88792.684724,0.3489289999997709,13733.452937426086,20634.570356733682
"147.32.84.165",2904,"207.115.21.22",25,3,186,3,186,0,0,88792.804123,8.886180000001332,167.45103070158123,0
"147.32.84.165",2395,"81.214.131.58",6667,2,124,2,124,0,0,88795.768391,3.0107389999902807,329.48721227685377,0
"147.32.84.165",2401,"46.4.36.120",443,6,366,3,186,3,180,88798.779212,1.0330550000071526,1440.3879754608395,1393.9238472201673
"147.32.84.165",2377,"217.163.21.37",80,10,1448,5,699,5,749,88798.980761,0.14020399999571964,39884.73938097858,42737.72503054787
"147.32.84.165",2905,"64.12.90.66",25,3,186,3,186,0,0,88799.027109,8.98408599999675,165.6261972559633,0
"147.32.84.165",2414,"208.73.210.29",80,48,35277,21,3320,27,31957,88799.482217,18.393018000002485,1444.0262060308107,13899.622128351391
"147.32.84.165",2388,"217.163.21.40",80,10,2429,5,1200,5,1229,88799.662583,0.14044899999862537,68352.21325957436,70004.0584133474
"147.32.84.165",2907,"203.237.240.2",25,3,186,3,186,0,0,88799.709213,9.005684000003384,165.22898205171765,0
"147.32.84.165",2406,"212.117.171.138",65500,177,159408,94,6399,83,153009,88799.812522,123.40836500001024,414.81790962870105,9918.873813779954
"147.32.84.165",2398,"217.163.21.39",80,16,7970,8,2603,8,5367,88799.812582,0.22217000000819098,93730.02655278507,193257.41548551575
"147.32.84.165",2908,"74.6.136.65",25,3,186,3,186,0,0,88799.858698,8.957462000005762,166.11848311486477,0
"147.32.84.165",2420,"205.188.186.167",587,47,13366,22,10984,25,2382,88800.487104,23.197020000006887,3788.0727783126413,821.4848286544712
"147.32.84.165",2403,"184.82.147.251",80,10,1905,5,990,5,915,88800.604397,0.3621270000003278,21870.780140649083,20213.902857266577
"147.32.84.165",2914,"64.12.90.33",25,3,186,3,186,0,0,88800.724119,8.9951449999935,165.42256961961985,0
"147.32.84.165",2423,"74.125.232.218",80,8,1908,5,1034,3,874,88801.188469,16.687000000005355,495.7152274223854,419.00880925257724
"147.32.84.165",2425,"46.4.36.120",443,6,366,3,186,3,180,88801.196673,1.025110999995377,1451.550124822298,1404.725927247385
"147.32.84.165",2416,"217.163.21.39",80,11,4124,6,2496,5,1628,88801.289147,0.26381399999081623,75689.6904663707,49368.11541636678
"147.32.84.165",2916,"205.188.190.2",25,3,186,3,186,0,0,88801.335146,8.985799000001862,165.59462324938403,0
"147.32.84.165",2429,"50.22.198.84",80,8,2195,5,1164,3,1031,88802.222008,0.413711000001058,22508.466054748813,19936.62242478181
"147.32.84.165",2421,"217.163.21.39",80,13,5398,7,3062,6,2336,88802.342942,0.20659499999601394,118570.14932826365,90457.17466715345
"147.32.84.165",2919,"207.115.21.22",25,3,186,3,186,0,0,88802.389595,8.935050000000047,166.53516208638925,0
"147.32.84.165",2430,"195.113.232.88",80,8,1362,5,774,3,588,88802.389655,15.486011000000872,399.84473729223436,303.75801747782145
"147.32.84.165",2427,"184.82.147.252",80,10,1474,5,587,5,887,88802.464141,0.335358999989694,14002.904350693776,21159.414240315808
"147.32.84.165",2920,"213.198.91.195",25,3,186,3,186,0,0,88802.574601,8.951723000005586,166.22498260938943,0
"147.32.84.165",2431,"67.214.158.5",80,10,1695,5,849,5,846,88807.109164,0.32907300000078976,20639.797248585266,20566.865102830547
"147.32.84.165",2439,"180.222.136.3",6667,1,62,1,62,0,0,88807.21298,0,0,0
"147.32.84.165",2445,"46.4.36.120",443,6,366,3,186,3,180,88809.51831,1.0305369999987306,1443.9073997360917,1397.3297416800888
"147.32.84.165",2433,"217.163.21.39",80,11,4106,6,2486,5,1620,88810.549148,0.24277599999913946,81919.13533491982,53382.54193184638
"147.32.84.165",2922,"74.6.136.65",25,3,186,3,186,0,0,88810.597255,8.95614999999816,166.14281806359938,0
"147.32.84.165",2432,"94.127.76.180",80,4,242,3,182,1,60,88810.597294,0.04878499999176711,29845.23932039997,9839.089885846144
"147.32.84.165",2434,"217.163.21.37",80,10,2274,5,1154,5,1120,88810.639682,0.14180000001215376,65105.782787085474,63187.588146911374
"147.32.84.165",2929,"64.12.90.33",25,3,186,3,186,0,0,88810.685849,8.967833000002429,165.92637262531505,0
"147.32.84.165",2437,"50.22.198.84",80,8,1736,5,1216,3,520,88810.68588,0.3863719999935711,25177.807916106412,10766.825753598136
"147.32.84.165",2438,"74.125.232.220",80,8,1517,5,1207,3,310,88810.806913,60.66810200001055,159.16106951884404,40.87815372894917
"147.32.84.165",2931,"216.32.180.22",25,3,186,3,186,0,0,88810.815221,8.939511000004131,166.45205761247033,0
"147.32.84.165",2459,"67.214.158.5",80,10,1760,5,871,5,889,88811.425428,0.3301329999958398,21106.644897928436,21542.832737380457
"147.32.84.165",2441,"217.163.21.39",80,16,7974,8,2610,8,5364,88811.528838,0.19080500000563916,109431.09456975918,224899.76677095334
"147.32.84.165",2939,"65.55.92.136",25,3,186,3,186,0,0,88811.574867,8.981828000003588,165.66783509987116,0
"147.32.84.165",2477,"68.67.185.205",80,8,1457,5,575,3,882,88813.73367,4.142192999992403,1110.52285589021,1703.445493730722
"147.32.84.165",2487,"89.162.236.14",6667,2,124,2,124,0,0,88813.762897,2.9806180000014137,332.8168856255748,0
"147.32.84.165",2472,"46.4.36.120",443,6,366,3,186,3,180,88819.553257,1.0312049999920418,1442.9720569736214,1396.424571264795
"147.32.84.165",2460,"184.82.147.251",80,10,1925,5,990,5,935,88820.055048,0.4417270000121789,17929.626216603552,16933.535871236687
"147.32.84.165",2949,"64.12.90.33",25,3,186,3,186,0,0,88820.165399,9.021354999989853,164.94196270977847,0
"147.32.84.165",2464,"217.163.21.39",80,14,6401,7,3031,7,3370,88820.16549,0.4194779999961611,57805.1769108795,64270.355060925074
"147.32.84.165",2950,"74.6.136.65",25,3,186,3,186,0,0,88820.211414,8.9754469999898,165.78561491162404,0
"147.32.84.165",2465,"74.125.232.218",80,10,2118,7,1936,3,182,88820.211488,0.3243369999981951,47752.80032831959,4489.157882104424
"147.32.84.165",2952,"65.55.92.136",25,3,186,3,186,0,0,88820.282206,8.904696999990847,167.10282225229332,0
"147.32.84.165",2474,"217.163.21.39",80,14,6562,7,3021,7,3541,88820.285407,0.353728999994928,68323.49058275271,80083.90604221362
"147.32.84.165",2956,"68.6.19.3",25,3,186,3,186,0,0,88820.288613,8.898331999997026,167.2223513351151,0
"147.32.84.165",2530,"184.82.147.252",80,10,1515,5,603,5,912,88820.584592,0.4401570000045467,10959.72573411344,16575.90359786311
"147.32.84.165",2957,"68.6.19.3",25,3,186,3,186,0,0,88820.69918,8.989375000004657,165.52874921774085,0
"147.32.84.165",2566,"173.192.170.88",80,16,3093,9,726,7,2367,88820.699218,50.01549000000523,116.1240247771119,378.60270888074916
"147.32.84.165",2532,"173.241.240.4",80,9,2194,5,1164,4,1030,88820.699253,0.07200499999453314,129324.35248534128,114436.49747414219
"147.32.84.165",2961,"64.12.90.97",25,3,186,3,186,0,0,88820.71561,8.97313500000746,165.82833090093519,0
"147.32.84.165",2538,"217.163.21.39",80,13,5594,7,2552,6,3042,88820.759415,0.24178900000697467,84437.25727560425,100649.74005971322
"147.32.84.165",2962,"74.6.136.65",25,3,186,3,186,0,0,88820.805225,8.883570999998483,167.5002090938716,0
"147.32.84.165",2539,"92.240.244.181",80,10,1758,6,1364,4,394,88820.805307,5.508505999998306,1980.9363918280847,572.2059665544467
"147.32.84.165",2967,"205.188.59.193",25,3,186,3,186,0,0,88820.847645,8.841201000002911,168.3029262652789,0
"147.32.84.165",2560,"74.121.137.122",80,10,3641,6,1632,4,2009,88820.913645,11.598376000009011,1125.6748358554557,1385.711240951967
"147.32.84.165",2968,"65.55.37.88",25,3,186,3,186,0,0,88821.016424,8.873009999995702,167.69957432716978,0
"147.32.84.165",2617,"46.4.36.120",443,6,366,3,186,3,180,88821.762499,1.0311129999900004,1443.1008046784693,1396.5491658178735
"147.32.84.165",2568,"217.163.21.37",80,13,6081,6,750,7,5331,88822.364179,0.18635299999732524,32196.959534250156,228855.9883694501
"147.32.84.165",2969,"65.54.188.110",25,3,186,3,186,0,0,88822.410041,8.883698000005097,167.4978145361477,0
"147.32.84.165",2626,"221.204.246.113",6667,6,366,3,186,3,180,88822.793831,2.4896310000040103,597.6789331421417,578.3989675569112
"147.32.84.165",2584,"195.113.232.96",80,17,15513,11,1358,6,14155,88823.589266,61.83443800000532,175.69497437656125,1831.3419457291786
"147.32.84.165",2976,"74.6.136.65",25,3,186,3,186,0,0,88823.598898,8.898681000006036,167.2157929921289,0
"147.32.84.165",2645,"46.4.36.120",443,6,366,3,186,3,180,88825.2837,1.0214839999971446,1456.7041676660226,1409.7137106445382
"147.32.84.165",2594,"74.125.232.219",80,9,3980,5,1301,4,2679,88826.305422,65.13573199999519,159.78940714139466,329.0359890328949
"147.32.84.165",2977,"216.240.32.91",25,3,186,3,186,0,0,88826.313474,8.89280700001109,167.32624468271317,0
"147.32.84.165",2674,"82.103.123.207",6667,2,124,2,124,0,0,88829.588112,3.01006500000949,329.5609895456983,0
"147.32.84.165",2655,"46.4.36.120",443,6,366,3,186,3,180,88831.695047,1.031025000003865,1443.2239761348385,1396.6683640014567
"147.32.84.165",2599,"94.127.76.145",80,10,1800,5,1158,5,642,88832.497687,0.053909000009298325,171845.14642085973,95271.6614872124
"147.32.84.165",2978,"64.12.90.34",25,3,186,3,186,0,0,88832.511862,9.018011000007391,165.00312541188745,0
"147.32.84.165",2622,"217.163.21.37",80,10,1451,5,701,5,750,88832.726355,0.14114300000073854,39732.75330672195,42510.07843087227
"147.32.84.165",2980,"77.238.177.9",25,3,186,3,186,0,0,88832.774216,8.955996999997296,166.14565636862642,0
"147.32.84.165",2717,"46.175.169.64",6667,2,124,2,124,0,0,88841.1285,3.0100509999901988,329.562522363651,0
"147.32.84.165",2706,"46.4.36.120",443,6,366,3,186,3,180,88841.730323,1.030748000004678,1443.611823639965,1397.0437002967403
"147.32.84.165",2665,"184.82.147.251",80,10,1925,5,990,5,935,88841.730361,0.3658080000022892,21650.70200747506,20447.885229282
"147.32.84.165",2981,"98.139.175.225",25,3,186,3,186,0,0,88841.850998,9.009425000011106,165.1603737195399,0
"147.32.84.165",2689,"217.163.21.39",80,11,4148,6,2518,5,1630,88841.930796,0.2510270000057062,80246.348000582,51946.60335224331
"147.32.84.165",2983,"65.55.88.22",25,3,186,3,186,0,0,88841.976645,8.983976000003167,165.6282251866518,0
"147.32.84.165",2749,"184.82.147.252",80,10,1514,5,603,5,911,88842.761314,0.35182899999199435,13711.206296552493,20714.60851767715
"147.32.84.165",2985,"205.188.156.193",25,3,186,3,186,0,0,88842.877753,8.986194000011892,165.58734431930034,0
"147.32.84.165",2752,"217.163.21.37",80,10,2277,5,1156,5,1121,88843.335303,0.14174000000639353,65246.22548033615,63270.77747703878
"147.32.84.165",2988,"64.12.90.1",25,3,186,3,186,0,0,88843.381174,8.98388800000248,165.62984756706553,0
"147.32.84.165",2776,"46.4.36.120",443,6,366,3,186,3,180,88844.538944,1.0318120000010822,1442.1231774765552,1395.6030749773115
"147.32.84.165",2753,"217.163.21.37",80,14,6137,7,809,7,5328,88845.142208,0.1886439999943832,34308.0087370534,225949.4073560204
"147.32.84.165",2989,"98.139.175.224",25,3,186,3,186,0,0,88845.188064,8.982669999997597,165.65230605158578,0
"147.32.84.165",2762,"217.163.21.39",80,14,6405,7,3033,7,3372,88845.571,0.20668600000499282,117395.46945324726,130516.8226166666
"147.32.84.165",2990,"74.125.113.27",25,3,186,3,186,0,0,88845.61711,8.955087999987882,166.16252123954712,0
"147.32.84.165",2811,"46.4.36.120",443,6,366,3,186,3,180,88847.249058,1.0302360000059707,1444.3292604717524,1397.7379940049218
"147.32.84.165",2816,"98.126.71.122",80,11,4200,7,767,4,3433,88848.279536,16.909228000004077,362.8787783805695,1624.2018855026013
"147.32.84.165",2796,"217.163.21.37",80,10,1448,5,699,5,749,88848.454814,0.13940800000273157,40112.47561036978,42981.75140510295
"147.32.84.165",2992,"200.61.224.170",25,3,186,3,186,0,0,88848.500764,8.98141300000134,165.67549003701066,0
"147.32.84.165",2817,"190.122.143.202",6667,1,62,1,62,0,0,88853.569167,0,0,0
"147.32.84.165",2824,"46.4.36.120",443,6,366,3,186,3,180,88853.769639,1.0305369999987306,1443.9073997360917,1397.3297416800888
"147.32.84.165",2823,"195.113.232.88",80,11,4502,6,1384,5,3118,88854.800435,12.771684999999707,866.917716808726,1953.070405353763
"147.32.84.165",2797,"173.241.240.4",80,9,2195,5,1165,4,1030,88854.801363,0.06578799999260809,141667.17336060057,125250.80563211897
"147.32.84.165",2993,"207.214.111.53",25,3,186,3,186,0,0,88854.817962,8.884766000002855,167.4776803350276,0
"147.32.84.165",2868,"195.113.232.83",80,12,9128,8,936,4,8192,88855.174594,12.397716000006767,603.9822173693858,5286.134962275651
"147.32.84.165",2802,"92.240.244.181",80,10,1760,6,1366,4,394,88855.175684,8.673406000001705,1259.943325609092,363.4097147071612
"147.32.84.165",2994,"125.206.180.223",25,3,186,3,186,0,0,88855.184141,8.918869999994058,166.83727871367014,0
"147.32.84.165",2877,"84.25.41.150",6667,1,62,1,62,0,0,88862.799337,0,0,0
"147.32.84.165",2872,"46.4.36.120",443,6,366,3,186,3,180,88862.899666,1.0307319999992615,1443.6342327598893,1397.0653865418283
"147.32.84.165",2821,"217.163.21.39",80,11,4149,6,2521,5,1628,88863.803029,0.23868500000389758,84496.30265693557,54565.64090658117
"147.32.84.165",2996,"64.12.90.1",25,3,186,3,186,0,0,88863.848816,8.986168999996153,165.58780499238742,0
"147.32.84.165",2838,"184.82.147.251",80,10,1929,5,994,5,935,88863.848847,0.3429420000029495,23187.594403518986,21811.268377555585
"147.32.84.165",2997,"64.12.138.161",25,3,186,3,186,0,0,88863.930601,9.004549999997835,165.24979038379018,0
"147.32.84.165",2998,"209.85.227.27",25,3,186,3,186,0,0,88863.962148,8.973124999989523,165.82851570681757,0
"147.32.84.165",2930,"217.163.21.37",80,10,2274,5,1154,5,1120,88864.304573,0.13956799999868963,66146.96778693309,64198.09698558497
"147.32.84.165",2999,"207.115.21.22",25,3,186,3,186,0,0,88864.350534,8.986613000000943,165.5796238248875,0
"147.32.84.165",2941,"46.4.36.120",443,6,366,3,186,3,180,88865.206833,1.032005000000936,1441.8534793907495,1395.3420768297576
"147.32.84.165",2935,"184.82.147.252",80,10,1514,5,603,5,911,88866.111461,0.3633900000131689,13274.993807824054,20055.58765991329
"147.32.84.165",3000,"64.12.90.97",25,3,186,3,186,0,0,88866.231495,9.013535000005504,165.08506374015204,0
"147.32.84.165",2940,"217.163.21.39",80,14,6406,7,3036,7,3370,88866.239174,0.20589100000506733,117965.33116747322,130943.07181633227
"147.32.84.165",3002,"74.6.136.65",25,3,186,3,186,0,0,88866.285087,8.959992000003695,166.0715768495537,0
"147.32.84.165",2942,"217.163.21.37",80,13,6077,6,749,7,5328,88866.51227,0.1878839999990305,31892.01847965191,226863.38379116872
"147.32.84.165",3003,"98.139.175.224",25,3,186,3,186,0,0,88866.558234,8.986713999998756,165.57776290646459,0
"147.32.84.165",2973,"89.117.75.85",6667,6,366,3,186,3,180,88869.425178,1.0675939999928232,1393.7882753275148,1348.8273632201756
"147.32.84.165",2953,"46.4.36.120",443,6,366,3,186,3,180,88870.493207,0.9650689999980386,1541.85866503123,1492.1212887399001
"147.32.84.165",2943,"173.241.240.4",80,9,2194,5,1164,4,1030,88871.458519,0.0693289999908302,134316.08708089907,118853.5822107612
"147.32.84.165",3004,"195.38.96.39",25,3,186,3,186,0,0,88871.474844,8.985981000005268,165.59126933376865,0
"147.32.84.165",3026,"173.192.170.88",80,14,2974,7,603,7,2371,88875.244906,36.72445899999002,131.35659806455723,516.4950149437233
"147.32.84.165",3063,"71.224.19.142",6667,2,124,2,124,0,0,88875.446108,3.008155000003171,329.7702412272487,0
"147.32.84.165",3035,"46.4.36.120",443,6,366,3,186,3,180,88875.745692,1.03037600000971,1444.1330155069388,1397.5480795228439
"147.32.84.165",2944,"217.163.21.37",80,10,1448,5,699,5,749,88876.146715,0.13949900001171045,40086.30885906402,42953.71292623598
"147.32.84.165",3005,"74.6.140.64",25,3,186,3,186,0,0,88876.192642,8.983932000002824,165.62903637288576,0
"147.32.84.165",3031,"184.82.147.251",80,10,1929,5,994,5,935,88876.776303,0.3621219999913592,21959.45013059065,20656.02200412702
"147.32.84.165",3007,"94.245.120.86",25,3,186,3,186,0,0,88876.895728,8.983292999997502,165.64081790501697,0
"147.32.84.165",3172,"119.154.70.142",6667,2,124,2,124,0,0,88884.976269,3.0092299999960233,329.6524360056596,0
"147.32.84.165",3098,"46.4.36.120",443,6,366,3,186,3,180,88884.976419,1.0302260000025854,1444.3432800145463,1397.7515613043995
"147.32.84.165",3080,"217.163.21.39",80,11,4159,6,2521,5,1638,88885.377591,0.26478500000666827,76167.45661382667,49489.20822429516
"147.32.84.165",3008,"205.188.146.193",25,3,186,3,186,0,0,88885.423514,8.883505000005243,167.5014535365401,0
"147.32.84.165",3094,"184.82.147.252",80,10,1515,5,603,5,912,88886.006892,0.3434889999916777,14044.117861465373,21240.854875052104
"147.32.84.165",3010,"212.115.192.99",25,3,186,3,186,0,0,88886.120032,8.889021999988472,167.39749322275608,0
"147.32.84.165",3205,"46.4.36.120",443,6,366,3,186,3,180,88887.283502,1.030185999989044,1444.399360907472,1397.8058331362631
"147.32.84.165",3173,"184.82.147.251",80,10,1926,5,998,5,928,88887.28365,0.3431799999962095,23264.75901884779,21632.96229407891
"147.32.84.165",3011,"209.85.227.27",25,3,186,3,186,0,0,88887.396973,8.919412000002922,166.8271406231165,0
"147.32.84.165",3186,"217.163.21.37",80,10,2274,5,1154,5,1120,88887.584603,0.13954200000443961,66159.29254064208,64210.05861830081
"147.32.84.165",3012,"74.125.113.27",25,3,186,3,186,0,0,88887.63048,8.886593999995966,167.4432296558924,0
"147.32.84.165",3187,"217.163.21.37",80,14,6141,7,810,7,5331,88888.313911,0.1899310000007972,34117.65325288026,224544.70307543786
"147.32.84.165",3015,"205.188.59.193",25,3,186,3,186,0,0,88888.359774,8.859534000002895,167.954657660269,0
"147.32.84.165",3238,"46.4.36.120",443,6,366,3,186,3,180,88890.292761,1.0313809999934165,1442.7258210200675,1396.186278406517
"147.32.84.165",3226,"173.192.170.88",80,10,1267,6,738,4,529,88891.324309,7.296447999993688,809.1608410016911,580.0082451082583
"147.32.84.165",3209,"184.82.147.252",80,10,1508,5,596,5,912,88891.32434,0.35261799998988863,13521.714717163399,20690.946010156073
"147.32.84.165",3016,"64.71.138.88",25,3,186,3,186,0,0,88891.440849,8.88942799999495,167.38984780582567,0
"147.32.84.165",3259,"46.4.36.120",443,6,366,3,186,3,180,88892.399551,1.0318640000041341,1442.0505027736585,1395.5327446196695
"147.32.84.165",3258,"50.23.235.4",80,22,12351,11,2225,11,10126,88893.431631,15.288020000007236,1164.3103554280785,5298.789509692011
"147.32.84.165",3210,"217.163.21.39",80,14,6406,7,3036,7,3370,88893.585012,0.20630800000799354,117726.89376591769,130678.40315913787
"147.32.84.165",3018,"66.94.238.147",25,3,186,3,186,0,0,88893.630907,9.005986000003759,165.2234413865821,0
"147.32.84.165",3284,"46.4.36.120",443,6,366,3,186,3,180,88897.118437,1.0307290000055218,1443.6384345371368,1397.0694527778744
"147.32.84.165",3279,"87.248.203.253",80,87,53644,41,2910,46,50734,88897.82079,0.9410020000068471,24739.586100593417,431318.955748284
"147.32.84.165",3223,"217.163.21.37",80,10,1451,5,701,5,750,88897.837217,0.13923700001032557,40276.650599941975,43091.994222477144
"147.32.84.165",3019,"65.55.37.120",25,3,186,3,186,0,0,88897.883207,8.970026999988477,165.88578830386035,0
"147.32.84.165",3273,"212.117.171.138",65500,102,66129,52,3879,50,62250,88898.149406,199.44095200000447,155.59492515859685,2496.979657417544
"147.32.84.165",3280,"87.248.203.253",80,87,49764,39,2771,48,46993,88898.149463,1.10831500000495,20001.533859869254,339203.2048635279
"147.32.84.165",3250,"217.163.21.37",80,14,6141,7,810,7,5331,88898.14953,0.1891520000062883,34258.16274628117,225469.46370422826
"147.32.84.165",3020,"207.115.37.22",25,3,186,3,186,0,0,88898.195444,8.958887000000686,166.09206031953366,0
"147.32.84.165",3275,"117.224.41.27",6667,2,122,1,62,1,60,88900.330151,0.47188299999106675,1051.1080077251984,1017.2012977985792
"147.32.84.165",3329,"46.4.36.120",443,6,366,3,186,3,180,88906.351344,1.0309200000046985,1443.3709696127908,1396.8106157543136
"147.32.84.165",3300,"68.67.185.210",80,8,1598,5,634,3,964,88907.053629,1.6662579999974696,3043.946375655932,4628.334867716591
"147.32.84.165",3276,"173.241.240.4",80,9,2194,5,1164,4,1030,88907.082766,0.07043399999383837,132208.87640648865,116988.95420849082
"147.32.84.165",3021,"98.139.175.224",25,3,186,3,186,0,0,88907.099582,8.98448900000949,165.61876807890002,0
"147.32.84.165",3308,"64.12.168.40",587,45,13228,21,10906,24,2322,88907.382492,15.738553000002867,5543.584597642751,1180.286396087151
"147.32.84.165",3328,"87.248.203.253",80,62,34670,27,2047,35,32623,88907.500544,0.575752000004286,28442.801761657964,453292.38977555826
"147.32.84.165",3278,"92.240.244.181",80,10,1758,6,1364,4,394,88907.517154,9.217749999996158,1183.8029887992784,341.9489571751581
"147.32.84.165",3022,"212.44.160.11",25,3,186,3,186,0,0,88907.525727,8.96002800000133,166.07090959981142,0
"147.32.84.165",3362,"119.152.220.218",6667,1,62,1,62,0,0,88908.357581,0,0,0
"147.32.84.165",3390,"46.4.36.120",443,6,366,3,186,3,180,88908.558071,1.0307389999943553,1443.6244286945084,1397.055898736621
"147.32.84.165",3304,"184.82.147.251",80,10,1910,5,982,5,928,88909.26072,0.3486879999982193,22530.170238264924,21291.240306629174
"147.32.84.165",3023,"209.85.227.27",25,3,186,3,186,0,0,88909.374755,9.017152000000351,165.01884408735066,0
"147.32.84.165",3315,"217.163.21.39",80,14,6641,7,2583,7,4058,88909.589086,0.2874359999987064,71890.78612314741,112943.40305370971
"147.32.84.165",3024,"205.188.146.193",25,3,186,3,186,0,0,88909.635123,8.95776200000546,166.11291972248125,0
"147.32.84.165",3318,"217.163.21.37",80,10,1451,5,701,5,750,88910.364223,0.13992400000279304,40078.89997347173,42880.42079900684
"147.32.84.165",3025,"212.115.192.99",25,3,186,3,186,0,0,88910.41012,8.984893000000739,165.61132113647628,0
"147.32.84.165",3414,"173.192.170.88",80,8,922,5,485,3,437,88912.370886,35.17048999998951,110.31975954844977,99.40151530447947
"147.32.84.165",3420,"82.206.239.241",6667,2,124,2,124,0,0,88914.678404,3.0107019999995828,329.4912615064983,0
"147.32.84.165",3410,"46.4.36.120",443,6,366,3,186,3,180,88915.58277,1.0307510000129696,1443.60762199724,1397.0396341908772
"147.32.84.165",3396,"184.82.147.252",80,10,1507,5,596,5,911,88916.613743,0.3690200000128243,12920.708904217388,19749.607066681278
"147.32.84.165",3027,"64.12.138.161",25,3,186,3,186,0,0,88916.734581,8.884124000003794,167.489782898051,0
"147.32.84.165",3449,"94.100.176.20",25,3,186,3,186,0,0,88918.893075,8.932606000002124,166.58072683376454,0
"147.32.84.165",3401,"195.113.232.96",80,20,20917,14,1573,6,19344,88919.194494,63.409780000001774,198.4551909815749,2440.5068114097803
"147.32.84.165",3028,"211.23.95.50",25,3,186,3,186,0,0,88919.195494,8.930919000005815,166.6121929892132,0
"147.32.84.165",3461,"46.4.36.120",443,6,366,3,186,3,180,88920.401241,1.0306080000009388,1443.8079269699483,1397.2334777128533
"147.32.84.165",3402,"217.163.21.39",80,11,4250,6,2620,5,1630,88921.43206,0.227880999998888,91977.83053480668,57222.84876783774
"147.32.84.165",3030,"74.6.136.65",25,3,186,3,186,0,0,88921.478002,8.856287999995402,168.01621627489672,0
"147.32.84.165",3516,"61.17.216.29",6667,1,62,1,62,0,0,88928.026228,0,0,0
"147.32.84.165",3502,"46.4.36.120",443,6,366,3,186,3,180,88928.428081,1.0299539999978151,1444.7247158641615,1398.1206927717692
"147.32.84.165",3453,"217.163.21.37",80,13,6077,6,749,7,5328,88929.45828,0.18647699999564793,32132.64906739085,228575.10578245454
"147.32.84.165",3032,"205.188.59.193",25,3,186,3,186,0,0,88929.504161,8.957677999991574,166.11447743504507,0
"147.32.84.165",3459,"184.82.147.251",80,10,1910,5,982,5,928,88930.334431,0.36302200000500306,21640.56172874297,20450.551205981137
"147.32.84.165",3033,"74.125.43.27",25,3,186,3,186,0,0,88930.434885,9.029753000009805,164.78856066144712,0
"147.32.84.165",3485,"217.163.21.37",80,10,2277,5,1156,5,1121,88930.454068,0.13966699999582488,66214.63910785264,64209.87062275329
"147.32.84.165",3038,"124.108.110.37",25,3,186,3,186,0,0,88930.500063,8.964680000004591,165.9847311894276,0
"147.32.84.165",3556,"46.4.36.120",443,6,366,3,186,3,180,88930.53573,1.0304119999927934,1444.0825611603968,1397.499252735868
"147.32.84.165",3553,"217.163.21.37",80,10,1448,5,699,5,749,88931.337593,0.14005200000246987,39928.026732223625,42784.10875884906
"147.32.84.165",3039,"65.55.92.136",25,3,186,3,186,0,0,88931.383535,9.004077999998117,165.25845289215744,0
"147.32.84.165",3557,"217.163.21.39",80,14,6604,7,3135,7,3469,88931.566379,0.21273100000689737,117895.37020550287,130455.83388927893
"147.32.84.165",3041,"209.85.227.27",25,3,186,3,186,0,0,88931.61254,8.956762000001618,166.13146581317346,0
"147.32.84.165",3598,"202.112.126.217",6667,6,366,3,186,3,180,88937.659347,1.6150720000005094,921.3211547222234,891.6011174731193
"147.32.84.165",3597,"46.4.36.120",443,6,366,3,186,3,180,88939.274657,1.0212230000033742,1457.0764661538994,1410.0739995037736
"147.32.84.165",3558,"184.82.147.252",80,10,1508,5,596,5,912,88939.867253,0.36121999999159016,13199.712087124211,20198.217153451813
"147.32.84.165",3044,"98.139.175.224",25,3,186,3,186,0,0,88939.986425,9.010490000000573,165.1408524952478,0
"147.32.84.165",3650,"74.125.93.27",25,3,186,3,186,0,0,88940.168144,9.029819000003044,164.78735620276535,0
"147.32.84.165",3589,"217.163.21.39",80,11,4246,6,2618,5,1628,88940.296123,0.22640100000717212,92508.42531321204,57526.24767376211
"147.32.84.165",3045,"205.188.103.2",25,3,186,3,186,0,0,88940.34199,8.955975999997463,166.14604594746808,0
"147.32.84.165",3594,"173.241.240.4",80,9,2195,5,1165,4,1030,88940.469127,0.06671400000050198,139700.81242212837,123512.30626162422
"147.32.84.165",3046,"195.238.5.129",25,3,186,3,186,0,0,88940.485437,9.013309000001755,165.08920308842295,0
"147.32.84.165",3706,"112.110.99.104",6667,2,124,2,124,0,0,88942.375033,3.009873000002699,329.5820122640093,0
"147.32.84.165",3697,"46.4.36.120",443,6,366,3,186,3,180,88950.502488,1.0297859999991488,1444.9604092512716,1398.348783146392
"147.32.84.165",3595,"92.240.244.181",80,10,1760,6,1366,4,394,88951.505113,9.682305999987875,1128.65674768115,325.54228300612965
"147.32.84.165",3048,"65.55.92.168",25,3,186,3,186,0,0,88951.505175,8.932421999998041,166.58415824961318,0
"147.32.84.165",3638,"184.82.147.251",80,10,1925,5,990,5,935,88951.513641,0.34234400000423193,23134.62482153067,21849.36788700119
"147.32.84.165",3049,"64.12.90.33",25,3,186,3,186,0,0,88951.532394,8.905296000011731,167.09158235706482,0
"147.32.84.165",3660,"217.163.21.37",80,13,6081,6,750,7,5331,88951.626701,0.18857699999352917,31817.241764403316,226156.95446137877
"147.32.84.165",3050,"24.113.32.75",25,3,186,3,186,0,0,88951.672649,8.865466999995988,167.84225805596856,0
"147.32.84.165",3862,"61.17.216.22",6667,10,1172,5,614,5,558,88952.409085,1.0484209999995073,4685.1407974490285,4257.831539049769
"147.32.84.165",3870,"46.4.36.120",443,6,366,3,186,3,180,88952.597774,1.0430100000085076,1426.6402047802635,1380.6195530131583
"147.32.84.165",3667,"217.163.21.37",80,10,2274,5,1154,5,1120,88952.609429,0.14058700000168756,65667.52260087477,63732.77756757344
"147.32.84.165",3051,"64.12.90.1",25,3,186,3,186,0,0,88952.656063,8.899989999990794,167.19119909140787,0
"147.32.84.165",3848,"184.82.147.252",80,10,1515,5,603,5,912,88953.641026,0.3435529999987921,14041.50160242222,21236.897945952016
"147.32.84.165",3052,"74.6.136.65",25,3,186,3,186,0,0,88953.754277,8.891566999998759,167.34957966354048,0
"147.32.84.165",3960,"180.241.97.224",6667,2,124,2,124,0,0,88959.033094,3.010812000007718,329.47922354416585,0
"147.32.84.165",3898,"46.4.36.120",443,6,366,3,186,3,180,88960.941265,1.029861000002711,1444.8551794815833,1398.2469478854032
"147.32.84.165",3850,"217.163.21.37",80,10,1451,5,701,5,750,88961.141203,0.1395219999976689,40194.377948235386,43003.9707006798
"147.32.84.165",3054,"65.55.92.152",25,3,186,3,186,0,0,88961.187104,8.983347000001231,165.63982221768748,0
"147.32.84.165",4062,"74.125.39.27",25,3,186,3,186,0,0,88961.241143,9.03011300000071,164.78199110020915,0
"147.32.84.165",3887,"217.163.21.39",80,14,6590,7,3133,7,3457,88961.441663,0.21375099998840597,117257.93096340832,129384.19002250322
"147.32.84.165",3055,"209.85.227.27",25,3,186,3,186,0,0,88961.487631,8.983845000009751,165.6306403325508,0
"147.32.84.165",3897,"217.163.21.37",80,14,6141,7,810,7,5331,88961.97134,0.18998799999826588,34107.4173108783,224477.33541270645
"147.32.84.165",3056,"64.12.90.1",25,3,186,3,186,0,0,88962.017405,8.95612999999139,166.14318907847814,0
"147.32.84.165",4006,"184.82.147.251",80,10,1929,5,994,5,935,88962.017436,0.36127800001122523,22010.750723135436,20704.277591681723
"147.32.84.165",3059,"98.139.175.224",25,3,186,3,186,0,0,88962.136833,8.937801000007312,166.48390359091488,0
"147.32.84.165",4214,"31.192.109.161",80,10,1035,5,540,5,495,88972.479538,0.34527600000728853,12511.72974637336,11469.085600842245
"147.32.84.165",4217,"89.117.75.85",6667,4,244,2,124,2,120,88972.479668,0.6654310000012629,1490.7631294576258,1442.6739962493152
"147.32.84.165",4137,"46.4.36.120",443,6,366,3,186,3,180,88972.565799,1.045390999992378,1423.3908652464474,1377.475030883659
"147.32.84.165",4066,"217.163.21.39",80,14,6023,7,2680,7,3343,88972.580076,0.33007300000463147,64955.32806288052,81024.50063963044
"147.32.84.165",3060,"66.94.238.147",25,3,186,3,186,0,0,88972.628569,8.980596000008518,165.69056218524793,0
"147.32.84.165",4078,"173.241.240.4",80,9,2194,5,1164,4,1030,88973.080701,0.06847600000037346,135989.25170788617,120334.13166591302
"147.32.84.165",3061,"205.188.190.2",25,3,186,3,186,0,0,88973.097248,9.013448999990942,165.08663886615383,0
"147.32.84.165",4084,"217.163.21.37",80,10,1451,5,701,5,750,88973.583868,0.13927899999544024,40264.50505951074,43078.99970703717
"147.32.84.165",3062,"66.175.58.43",25,3,186,3,186,0,0,88973.611422,9.00160400000459,165.3038725097484,0
"147.32.84.165",4104,"184.82.147.252",80,10,1515,5,603,5,912,88973.629733,0.36248900000646245,13307.990035322446,20127.507317104595
"147.32.84.165",3064,"132.72.23.17",25,3,186,3,186,0,0,88973.749144,8.963485000000219,166.0068600549857,0
"147.32.84.165",4388,"46.4.36.120",443,6,366,3,186,3,180,88974.687935,1.0299310000118567,1444.7569788489423,1398.1519150151055
"147.32.84.165",4263,"184.82.147.251",80,10,1926,5,998,5,928,88975.718094,0.3659299999999348,21818.380564592742,20288.03323040287
"147.32.84.165",3066,"203.183.218.25",25,3,186,3,186,0,0,88975.83884,8.980793000009726,165.68692764641034,0
"147.32.84.165",4440,"114.27.11.170",6667,4,244,2,124,2,120,88982.211181,1.160305999990669,854.94688470798,827.3679529432064
"147.32.84.165",4441,"46.4.36.120",443,6,366,3,186,3,180,88982.311661,1.0306089999940014,1443.8065260527135,1397.2321219864968
"147.32.84.165",4344,"217.163.21.39",80,11,4250,6,2620,5,1630,88982.512557,0.2834070000099018,73957.24170280794,46011.56640289196
"147.32.84.165",3072,"209.85.227.27",25,3,186,3,186,0,0,88982.558622,8.982868999999482,165.64863630985667,0
"147.32.84.165",4480,"66.111.4.71",25,3,186,3,186,0,0,88983.113851,8.929808999993838,166.6329033466479,0
"147.32.84.165",4383,"217.163.21.37",80,14,6138,7,810,7,5328,88983.113986,0.18882599999778904,34317.3079982411,225731.6259439859
"147.32.84.165",3074,"50.22.179.232",25,3,186,3,186,0,0,88983.159977,8.883805999998003,167.49577827344885,0
"147.32.84.165",4439,"184.82.147.252",80,10,1508,5,596,5,912,88983.342551,0.3352280000108294,14223.155583202988,21764.291764901216
"147.32.84.165",3075,"64.12.138.161",25,3,186,3,186,0,0,88983.453142,8.892671000008704,167.32880368547802,0
"147.32.84.165",4506,"80.98.191.57",6667,1,62,1,62,0,0,88993.148734,0,0,0
"147.32.84.165",4503,"46.4.36.120",443,6,366,3,186,3,180,88993.549566,1.0301199999958044,1444.4919038617447,1397.8953908339465
"147.32.84.165",4482,"217.163.21.37",80,10,2277,5,1156,5,1121,88994.051487,0.14073699999426026,65711.22022195418,63721.69365814069
"147.32.84.165",3077,"74.6.136.65",25,3,186,3,186,0,0,88994.097451,8.984465000001364,165.6192104927532,0
"147.32.84.165",4487,"217.163.21.37",80,10,1449,5,700,5,749,88994.55221,0.13921900000423193,40224.39465755229,43040.102283580956
"147.32.84.165",3078,"64.12.90.98",25,3,186,3,186,0,0,88994.579922,9.003308999992441,165.27256811926028,0
"147.32.84.165",4502,"184.82.147.251",80,10,1898,5,982,5,916,88994.598091,0.35383599999477156,22202.376242428934,20710.15950923106
"147.32.84.165",3079,"65.54.188.126",25,3,186,3,186,0,0,88994.65263,9.031125000008615,164.76352613861292,0
"147.32.84.165",4553,"217.163.21.39",80,14,6594,7,3135,7,3459,88994.714705,0.21299899999576155,117747.0316785481,129916.10289508704
"147.32.84.165",3081,"65.54.188.72",25,3,186,3,186,0,0,88994.760607,9.023212000000058,164.90801723377334,0
"147.32.84.165",4571,"182.0.125.28",6667,6,366,3,186,3,180,88996.76078,3.433820000005653,433.3366338356554,419.35803274418265
"147.32.84.165",4570,"46.4.36.120",443,6,366,3,186,3,180,89000.194812,1.0083770000055665,1475.6385756436193,1428.0373312680185
"147.32.84.165",4554,"217.163.21.37",80,14,6141,7,810,7,5331,89001.203427,0.18823499999416526,34425.05379021362,226567.85401929484
"147.32.84.165",3083,"64.12.90.97",25,3,186,3,186,0,0,89001.249251,8.959050999997999,166.08901991966923,0
"147.32.84.165",4603,"46.4.36.120",443,6,366,3,186,3,180,89003.182193,1.0308439999935217,1443.4773835899043,1396.913597022488
"147.32.84.165",4561,"217.163.21.39",80,14,6028,7,2679,7,3349,89003.583355,0.33762900000147056,63477.95953518996,79353.37308075819
"147.32.84.165",3084,"209.85.227.27",25,3,186,3,186,0,0,89003.629552,8.986369999998715,165.58410125559183,0
"147.32.84.165",4612,"117.204.66.49",6667,2,124,2,124,0,0,89004.084742,3.012156999990111,329.33210320818495,0
"147.32.84.165",4563,"184.82.147.252",80,10,1496,5,589,5,907,89004.084877,0.35211700000218116,13381.915669992679,20606.786948528625
"147.32.84.165",3085,"216.32.180.22",25,3,186,3,186,0,0,89004.201253,9.017173999993247,165.0184414763555,0
"147.32.84.165",4615,"216.157.130.15",25,3,186,3,186,0,0,89004.213236,9.005314000009093,165.23577079027976,0
"147.32.84.165",4565,"173.241.240.4",80,9,2195,5,1165,4,1030,89004.385886,0.0661790000012843,140830.1727106655,124510.79647380728
"147.32.84.165",3086,"67.195.168.230",25,3,186,3,186,0,0,89004.402282,9.016608000005363,165.0288001872894,0
"147.32.84.165",4711,"123.194.145.64",6667,2,124,2,124,0,0,89015.125145,2.910556999995606,340.8282332218533,0
"147.32.84.165",4636,"46.4.36.120",443,6,366,3,186,3,180,89015.628048,1.0305840000073658,1443.8415500234478,1397.2660161517238
"147.32.84.165",4568,"92.240.244.181",80,10,1760,6,1366,4,394,89015.728204,5.662893999993685,1929.7553512412887,556.6058626567115
"147.32.84.165",3087,"74.125.77.27",25,3,186,3,186,0,0,89015.73669,8.920042999990983,166.81533934326373,0
"147.32.84.165",4597,"217.163.21.37",80,10,1451,5,701,5,750,89015.828231,0.13889299999573268,40376.40485965671,43198.72131917622
"147.32.84.165",3088,"64.12.90.98",25,3,186,3,186,0,0,89015.874136,8.883281000002171,167.50567723790752,0
"147.32.84.165",4611,"184.82.147.251",80,10,1925,5,990,5,935,89016.658877,0.34591300001193304,22895.930478839426,21623.934341126125
"147.32.84.165",3089,"65.54.188.126",25,3,186,3,186,0,0,89016.772663,8.988217999998596,165.55005675209839,0
"147.32.84.165",4780,"46.4.36.120",443,6,366,3,186,3,180,89020.242559,1.0304069999983767,1444.0895684931722,1397.5060340256507
"147.32.84.165",4618,"70.32.97.26",80,8,2620,5,810,3,1810,89021.273204,0.3794650000054389,17076.673737781144,38158.98699430107
"147.32.84.165",3091,"195.50.106.142",25,3,186,3,186,0,0,89021.390947,8.986644999997225,165.57903422250013,0
"147.32.84.165",4745,"217.163.21.39",80,14,6027,7,2680,7,3347,89022.148626,0.2889419999992242,74201.7429105411,92669.11698566457
"147.32.84.165",3092,"64.12.138.161",25,3,186,3,186,0,0,89022.194727,8.985778000002028,165.59501024837962,0
"147.32.84.165",4871,"61.153.193.110",6667,2,124,2,124,0,0,89024.556386,3.0101600000052713,329.55058867245026,0
"147.32.84.165",4863,"46.4.36.120",443,6,366,3,186,3,180,89025.158258,1.031769000008353,1442.183279385166,1395.6612381146767
"147.32.84.165",4764,"184.82.147.252",80,10,1515,5,603,5,912,89025.158317,0.36192700000538025,13328.654673258112,20158.76129686799
"147.32.84.165",3093,"74.6.136.65",25,3,186,3,186,0,0,89025.277576,9.012974000012036,165.0953392296497,0
"147.32.84.165",4853,"195.113.232.96",80,8,2207,5,776,3,1431,89025.358809,64.07075199999963,96.89288491572623,178.67747205464462
"147.32.84.165",3100,"98.139.175.224",25,3,186,3,186,0,0,89025.35972,9.03066000000399,164.77201001912843,0
"147.32.84.165",4889,"184.82.147.251",80,10,1930,5,1002,5,928,89026.190269,0.3525000000081491,22740.42553138918,21060.992907314532
"147.32.84.165",3103,"114.147.58.71",25,3,186,3,186,0,0,89026.306838,8.986634000000777,165.57923689780526,0
"147.32.84.165",4922,"46.4.36.120",443,6,366,3,186,3,180,89029.775931,1.0306459999992512,1443.7546936592012,1397.1819616056785
"147.32.84.165",4904,"217.163.21.37",80,14,6141,7,810,7,5331,89030.806805,0.18951799999922514,34192.00287057954,225034.03370748094
"147.32.84.165",3104,"205.188.156.193",25,3,186,3,186,0,0,89030.852792,8.95536500000162,166.1573816365643,0
"147.32.84.165",4975,"31.192.109.161",80,10,1035,5,540,5,495,89036.698093,0.25946400000248104,16649.708629939767,15262.232910778119
"147.32.84.165",1029,"117.224.216.244",6667,2,124,2,124,0,0,89036.781965,2.9259000000020023,339.0409788438843,0
"147.32.84.165",4971,"46.4.36.120",443,6,366,3,186,3,180,89036.797935,1.0309019999986049,1443.3961715100113,1396.8350046871078
"147.32.84.165",4907,"173.201.33.10",80,12,4146,6,922,6,3224,89037.801668,0.5802560000010999,12711.630728481943,44449.34649525573
"147.32.84.165",3105,"208.65.144.13",25,3,186,3,186,0,0,89037.829158,9.004118000011658,165.2577187458087,0
"147.32.84.165",4908,"70.32.97.26",80,8,1499,5,846,3,653,89037.982697,0.35802800000237767,18903.549442934782,14591.037572383466
"147.32.84.165",3110,"124.108.116.109",25,3,186,3,186,0,0,89038.095273,8.937436000007438,166.49070270251576,0
"147.32.84.165",1082,"46.4.36.120",443,6,366,3,186,3,180,89039.808015,1.030734999993001,1443.6300310071006,1397.0613203294522
"147.32.84.165",4916,"184.82.147.252",80,10,1507,5,596,5,911,89040.839046,0.3637950000120327,13106.282383876349,20033.26048944858
"147.32.84.165",3112,"64.12.90.98",25,3,186,3,186,0,0,89040.958644,8.883652999997139,167.4986629937571,0
"147.32.84.165",1122,"46.4.36.120",443,6,366,3,186,3,180,89042.41636,1.0306219999911264,1443.788314253734,1397.2144976649038
"147.32.84.165",4964,"217.163.21.37",80,10,1451,5,701,5,750,89043.218821,0.14195099999778904,39506.59030290275,42268.106600823194
"147.32.84.165",3114,"193.17.222.131",25,3,186,3,186,0,0,89043.264719,8.884428000004846,167.48405187134034,0
"147.32.84.165",1123,"61.17.216.66",6667,2,124,2,124,0,0,89043.447214,2.9833530000032624,332.51177450302237,0
"147.32.84.165",1150,"46.4.36.120",443,6,366,3,186,3,180,89046.330432,1.030908000000636,1443.3877707798192,1396.8268749482122
"147.32.84.165",1031,"184.82.147.251",80,10,1925,5,990,5,935,89046.430703,0.34864399999787565,22716.58195766529,21454.549626683885
"147.32.84.165",3116,"68.142.202.129",25,3,186,3,186,0,0,89046.54555,8.914004999998724,166.92833356052785,0
"147.32.84.165",1045,"173.241.240.6",80,12,2818,6,793,6,2025,89047.333961,0.05349700000078883,118586.08893781812,302820.7189143527
"147.32.84.165",3118,"128.121.85.2",25,3,186,3,186,0,0,89047.350371,8.91177800000878,166.9700479521072,0
"147.32.84.165",1098,"217.163.21.37",80,14,6134,7,809,7,5325,89047.361572,0.18872499999997672,34293.28387866366,225725.261624084
"147.32.84.165",3119,"98.139.175.224",25,3,186,3,186,0,0,89047.407485,8.854800000000978,168.04445046752446,0
"147.32.84.165",1208,"46.4.36.120",443,6,366,3,186,3,180,89049.842172,1.0310590000008233,1443.1763846674262,1396.6223077426705
"147.32.84.165",1124,"217.163.21.39",80,11,4250,6,2620,5,1630,89050.873527,0.2819409999938216,74341.79491616797,46250.81134097473
"147.32.84.165",3120,"74.6.136.65",25,3,186,3,186,0,0,89050.919296,8.956195000006119,166.14198328631562,0
"147.32.84.165",1172,"184.82.147.252",80,10,1515,5,603,5,912,89051.748996,0.34377500000118744,14032.434004751181,21223.183768379895
"147.32.84.165",3121,"85.233.160.20",25,3,186,3,186,0,0,89051.862232,9.017932000002475,165.00457089270486,0
"147.32.84.165",1273,"91.214.162.182",6667,1,62,1,62,0,0,89058.771463,0,0,0
"147.32.84.165",1261,"46.4.36.120",443,6,366,3,186,3,180,89058.973148,1.0307209999882616,1443.6496394435992,1397.0802962357413
"147.32.84.165",1200,"173.241.240.6",80,10,1569,5,945,5,624,89059.875431,0.06953400000929832,108723.78978613413,71792.21674766952
"147.32.84.165",3123,"64.12.90.98",25,3,186,3,186,0,0,89059.891884,9.015760000009323,165.04432238640572,0
"147.32.84.165",1202,"173.241.240.6",80,9,1304,5,771,4,533,89059.891913,0.05746999999973923,107325.56116283256,74195.23229544716
"147.32.84.165",3125,"91.209.164.25",25,3,186,3,186,0,0,89059.891938,9.015883999993093,165.04205244889351,0
"147.32.84.165",1206,"217.163.21.37",80,10,1446,5,698,5,748,89060.00411,0.1393250000110129,40078.95208726801,42949.93719380583
"147.32.84.165",3126,"64.98.36.4",25,3,186,3,186,0,0,89060.050076,8.957915999999386,166.11006399257394,0
"147.32.84.165",1357,"46.4.36.120",443,6,366,3,186,3,180,89061.88446,1.0318160000024363,1442.1175868531661,1395.5976646966124
"147.32.84.165",1254,"217.163.21.37",80,10,2277,5,1156,5,1121,89062.916507,0.13965599999937695,66219.85449992308,64214.92810935448
"147.32.84.165",3129,"209.85.227.27",25,3,186,3,186,0,0,89062.962354,8.959745999993174,166.0761365334613,0
"147.32.84.165",1364,"119.154.117.193",6667,2,124,2,124,0,0,89064.19272,3.009519999992335,329.6206704067514,0
"147.32.84.165",1397,"46.4.36.120",443,6,366,3,186,3,180,89067.503424,1.0305030000017723,1443.9550394297162,1397.3758446094027
"147.32.84.165",1274,"184.82.147.251",80,10,1929,5,994,5,935,89068.30587,0.35280100000090897,22539.618651816498,21201.75396322779
"147.32.84.165",3130,"128.121.125.217",25,3,186,3,186,0,0,89068.306003,9.035527999993064,164.6832371059159,0
"147.32.84.165",1324,"74.121.138.200",80,10,1644,6,908,4,736,89068.422546,11.099700999999186,654.432042809129,530.4647395457257
"147.32.84.165",3132,"216.117.176.60",25,3,186,3,186,0,0,89068.447271,8.99469200000749,165.43090080224658,0
"147.32.84.165",1326,"173.201.33.10",80,3,184,2,122,1,62,89068.534213,0.18220099998870865,5356.721423375748,2722.2682643384946
"147.32.84.165",3133,"205.188.156.193",25,3,186,3,186,0,0,89069.913182,9.033825999998953,164.71426392318963,0
"147.32.84.165",1484,"46.4.36.120",443,6,366,3,186,3,180,89071.922254,1.0303949999943143,1444.106386393772,1397.5223094133278
"147.32.84.165",1328,"217.163.21.34",80,4,244,3,182,1,62,89072.925307,0.04616500000702217,31539.044726059295,10744.070181404815
"147.32.84.165",3136,"209.85.143.27",25,3,186,3,186,0,0,89072.952906,8.9032739999966,167.12953010325958,0
"147.32.84.165",1331,"217.163.21.37",80,14,6141,7,810,7,5331,89072.971188,0.19090100000903476,33944.295732831786,223403.7537675633
"147.32.84.165",3137,"64.12.138.161",25,3,186,3,186,0,0,89073.018674,8.837555999998585,168.37234185562593,0
"147.32.84.165",1529,"217.34.4.225",6667,10,1141,5,583,5,558,89078.445139,0.544540999995661,8565.011633719341,8197.729831244242
"147.32.84.165",1542,"46.4.36.120",443,6,366,3,186,3,180,89078.529675,0.9460709999984829,1572.8206445418855,1522.0844947179537
"147.32.84.165",1332,"217.163.21.39",80,11,4244,6,2617,5,1627,89079.475997,0.2708049999928335,77310.24168886854,48064.10516919722
"147.32.84.165",1580,"173.192.170.88",80,22,5001,12,1385,10,3616,89079.521948,49.123025000008056,225.55614195172595,588.8888153772137
"147.32.84.165",3138,"74.6.136.65",25,3,186,3,186,0,0,89079.724125,8.954654000001028,166.17057454144282,0
"147.32.84.165",1363,"217.163.21.39",80,15,6654,7,3135,8,3519,89079.949913,0.20985400000063237,119511.66048740756,134150.40933179815
"147.32.84.165",3139,"98.139.175.224",25,3,186,3,186,0,0,89079.995791,8.9863800000021,165.58391699434614,0
"147.32.84.165",1593,"212.117.171.138",65500,48,4832,23,2204,25,2628,89080.853175,76.30493300000671,231.07287178927803,275.52609213349484
"147.32.84.165",1629,"46.4.36.120",443,6,366,3,186,3,180,89080.853304,1.0301289999915753,1444.479283674345,1397.8831777493663
"147.32.84.165",1465,"184.82.147.252",80,10,1515,5,603,5,912,89080.95282,0.342263999991701,14094.38328342148,21316.878199801642
"147.32.84.165",3140,"200.147.36.13",25,3,186,3,186,0,0,89081.066056,9.018995999998879,164.98510477221467,0
"147.32.84.165",1621,"64.12.168.40",587,48,14491,22,12049,26,2442,89081.88369,15.66264599999704,6154.260269945335,1247.2988280526606
"147.32.84.165",1466,"173.241.240.7",80,4,242,3,182,1,60,89082.001885,0.017399999996996485,83678.1609339844,27586.20690131354
"147.32.84.165",3141,"209.86.93.229",25,3,186,3,186,0,0,89082.019137,8.968980000005104,165.9051530942374,0
"147.32.84.165",1643,"198.41.9.32",6667,2,124,2,124,0,0,89083.86198,3.0112709999957588,329.4290019069679,0
"147.32.84.165",1671,"46.4.36.120",443,6,366,3,186,3,180,89089.282561,1.0310800000006566,1443.146991503135,1396.5938627449693
"147.32.84.165",1525,"217.163.21.37",80,10,1451,5,701,5,750,89089.383277,0.13940899999579415,40226.95808856809,43038.828197469426
"147.32.84.165",3142,"209.85.227.27",25,3,186,3,186,0,0,89089.429249,8.98280200001318,165.64987183262159,0
"147.32.84.165",1577,"184.82.147.251",80,10,1930,5,1002,5,928,89090.313931,0.3613880000048084,22181.146025582875,20543.017476787332
"147.32.84.165",3143,"216.120.251.187",25,3,186,3,186,0,0,89090.433412,8.981639000005089,165.67132123648668,0
"147.32.84.165",1597,"217.163.21.37",80,10,2272,5,1153,5,1119,89090.988232,0.13922599999932572,66251.99316251758,64298.335081402576
"147.32.84.165",3144,"66.7.198.148",25,3,186,3,186,0,0,89091.034179,8.982412000012118,165.6570640489428,0
"147.32.84.165",1738,"60.249.39.108",6667,6,366,3,186,3,180,89093.89708,2.571676000006846,578.6109914297286,559.946120738447
"147.32.84.165",1729,"46.4.36.120",443,6,366,3,186,3,180,89093.897214,1.031345000010333,1442.7761806040576,1396.2350134877977
"147.32.84.165",1620,"173.241.240.4",80,4,242,3,182,1,60,89094.928812,0.017982999997911975,80965.35617911682,26691.875663445106
"147.32.84.165",3145,"205.188.59.193",25,3,186,3,186,0,0,89094.945151,8.985186999998405,165.60590224780677,0
"147.32.84.165",1769,"46.4.36.120",443,6,366,3,186,3,180,89096.469048,1.0782659999968018,1379.9934339063027,1335.4775166835188
"147.32.84.165",1705,"217.163.21.39",80,11,4250,6,2620,5,1630,89097.547577,0.3248989999992773,64512.35614774629,40135.549817109335
"147.32.84.165",3146,"208.43.37.100",25,3,186,3,186,0,0,89097.593662,8.945158999995328,166.34695928834546,0
"147.32.84.165",1782,"31.192.109.161",80,10,1035,5,540,5,495,89098.511834,0.24109599999792408,17918.173673711703,16424.992534235727
"147.32.84.165",1795,"46.4.36.120",443,6,366,3,186,3,180,89098.591177,1.0522930000006454,1414.054830735439,1368.4401587762313
"147.32.84.165",1714,"217.163.21.37",80,14,6138,7,810,7,5328,89099.64372,0.18865000001096632,34349.324143245765,225942.22103112773
"147.32.84.165",3147,"209.85.143.27",25,3,186,3,186,0,0,89099.689613,8.956942000004346,166.12812721119306,0
"147.32.84.165",1808,"41.223.57.75",6667,2,124,2,124,0,0,89100.719216,3.011035000003176,329.45482201268123,0
"147.32.84.165",1820,"46.4.36.120",443,6,366,3,186,3,180,89101.020345,1.0324970000074245,1441.1664150010122,1394.677175807431
"147.32.84.165",1718,"184.82.147.252",80,10,1507,5,596,5,911,89102.053154,0.3554150000127265,13415.303236580532,20505.606121686014
"147.32.84.165",3148,"74.6.136.65",25,3,186,3,186,0,0,89102.124814,8.93023600000015,166.62493577996986,0
"147.32.84.165",1720,"217.163.21.39",80,14,6599,7,3132,7,3467,89102.167228,0.16669299999193754,150312.25067166518,166389.71043380053
"147.32.84.165",3149,"64.12.138.161",25,3,186,3,186,0,0,89102.213466,8.84170499999891,168.29333256427165,0
"147.32.84.165",1789,"217.163.21.37",80,10,2277,5,1156,5,1121,89103.02774,0.1455219999916153,63550.52844609648,61626.420750929195
"147.32.84.165",3150,"98.139.175.224",25,3,186,3,186,0,0,89103.073526,8.884163000009721,167.48904764561073,0
"147.32.84.165",1871,"27.255.59.59",6667,6,366,3,186,3,180,89110.351676,1.36031199998979,1093.8667011767657,1058.5806785581603
"147.32.84.165",1831,"46.4.36.120",443,6,366,3,186,3,180,89111.356009,1.0306590000109281,1443.7364831474063,1397.164338529748
"147.32.84.165",1840,"208.73.210.29",80,50,35852,22,3317,28,32535,89111.712223,12.959805000005872,2047.5616724162112,20083.63551765494
"147.32.84.165",1800,"184.82.147.251",80,10,1921,5,990,5,931,89111.893747,0.3339410000044154,23716.764338297126,22303.341009045078
"147.32.84.165",3151,"218.102.53.137",25,3,186,3,186,0,0,89111.957825,9.032098999989103,164.74575843353747,0
"147.32.84.165",1816,"217.163.21.37",80,10,1449,5,700,5,749,89112.004002,0.13984000000345986,40045.76658939822,42848.97025065609
"147.32.84.165",3152,"72.167.238.201",25,3,186,3,186,0,0,89112.050016,8.940048000004026,166.44205937141834,0
"147.32.84.165",1823,"173.241.240.4",80,9,2193,5,1163,4,1030,89112.38691,0.06549300000187941,142060.9836124931,125814.97258888037
"147.32.84.165",3154,"64.12.90.1",25,3,186,3,186,0,0,89112.403367,8.987953999996535,165.55491939551246,0
"147.32.84.165",1923,"196.192.41.18",6667,2,124,2,124,0,0,89115.871817,3.0115069999883417,329.4031858480954,0
"147.32.84.165",1907,"46.4.36.120",443,6,366,3,186,3,180,89116.072736,1.031845000004978,1442.0770561400418,1395.558441425847
"147.32.84.165",1904,"74.125.232.218",80,8,1905,5,1031,3,874,89117.104817,7.567645000002813,1089.9031336693165,923.9334033239404
"147.32.84.165",1836,"217.163.21.37",80,14,6137,7,809,7,5328,89117.112931,0.18897200000355951,34248.460088680295,225557.22540480667
"147.32.84.165",3155,"205.188.156.193",25,3,186,3,186,0,0,89117.15885,8.949712999994517,166.26231478047526,0
"147.32.84.165",1945,"46.4.36.120",443,6,366,3,186,3,180,89118.480782,1.0324950000067474,1441.1692066211224,1394.6798773752798
"147.32.84.165",1938,"94.127.76.180",80,15,4658,9,2653,6,2005,89119.513495,5.158746999994037,4114.177338028892,3109.2821570855367
"147.32.84.165",1837,"217.163.21.39",80,4,244,3,182,1,62,89119.528052,0.04687000000558328,31064.64689196837,10582.462128033181
"147.32.84.165",3162,"209.85.227.27",25,3,186,3,186,0,0,89119.574598,8.942038999986835,166.4050000231704,0
"147.32.84.165",1956,"46.4.36.120",443,6,366,3,186,3,180,89120.588749,1.0302839999931166,1444.261970495457,1397.672874673023
"147.32.84.165",1939,"94.127.76.180",80,14,4600,8,2593,6,2007,89121.619281,3.0534259999985807,6793.680279138791,5258.355696194198
"147.32.84.165",1894,"217.163.21.39",80,14,6026,7,2679,7,3347,89121.619358,0.3112390000023879,68860.26494056197,86030.34966631613
"147.32.84.165",3163,"65.55.37.104",25,3,186,3,186,0,0,89121.665267,8.959573000000091,166.07934329013054,0
"147.32.84.165",1981,"46.4.36.120",443,6,366,3,186,3,180,89123.096618,1.03052500000922,1443.924213373462,1397.34601294206
"147.32.84.165",1961,"67.214.158.5",80,10,1692,5,846,5,846,89123.096768,0.32890999999654014,20577.057553954557,20577.057553954557
"147.32.84.165",1901,"184.82.147.252",80,10,1498,5,599,5,899,89123.200275,0.34569800000463147,13861.81001896395,20804.285821450067
"147.32.84.165",3164,"64.12.90.66",25,3,186,3,186,0,0,89123.313736,9.016987000009976,165.02186373323525,0
"147.32.84.165",1965,"195.113.232.88",80,8,1359,5,771,3,588,89123.999243,0.6736760000057984,9155.736585460832,6982.585100195809
"147.32.84.165",1940,"217.163.21.37",80,10,1448,5,699,5,749,89124.000119,0.13914299999305513,40188.870444644046,43063.61081979741
"147.32.84.165",3165,"65.55.37.88",25,3,186,3,186,0,0,89124.045979,8.98786399999517,165.556577180162,0
"147.32.84.165",1966,"50.22.198.84",80,8,2186,5,1158,3,1028,89124.127365,0.38229400001000613,24232.658633819847,21512.239270783077
"147.32.84.165",1949,"184.82.147.251",80,10,1930,5,1002,5,928,89124.248267,0.36190599999099504,22149.397910505642,20513.614032883466
"147.32.84.165",3166,"205.188.146.193",25,3,186,3,186,0,0,89124.36796,8.965926999997464,165.96164568375593,0
"147.32.84.165",1995,"220.134.142.48",6667,1,62,1,62,0,0,89131.628815,0,0,0
"147.32.84.165",1996,"46.4.36.120",443,6,366,3,186,3,180,89133.033979,1.0296139999991283,1445.2017940716228,1398.5823813596348
"147.32.84.165",1987,"217.163.21.39",80,15,8022,7,2664,8,5358,89133.034039,0.18891499999153893,112812.64061061597,226895.69384072084
"147.32.84.165",2008,"173.192.170.88",80,11,1099,6,542,5,557,89133.079885,70.70829599999706,61.32236590739197,63.01947935501352
"147.32.84.165",3168,"98.139.175.224",25,3,186,3,186,0,0,89133.280804,8.881653000004007,167.53638089658858,0
"147.32.84.165",1992,"217.163.21.39",80,14,6020,7,2678,7,3342,89133.434299,0.3226659999927506,66396.83139990373,82859.67533176934
"147.32.84.165",3170,"205.188.190.2",25,3,186,3,186,0,0,89133.480274,8.882253000003402,167.52506374220934,0
"147.32.84.165",1994,"184.82.147.252",80,10,1507,5,596,5,911,89134.063832,0.34698699999717064,13741.148803957723,21003.66872551256
"147.32.84.165",3194,"212.27.48.6",25,3,186,3,186,0,0,89134.178668,8.886982000010903,167.43591919035893,0
"147.32.84.165",2039,"117.207.7.56",6667,6,366,3,186,3,180,89138.149343,1.6132539999962319,922.3594052786948,892.6058760761563
"147.32.84.165",2040,"46.4.36.120",443,6,366,3,186,3,180,89139.762858,1.0231729999941308,1454.2995172942753,1407.3866296396213
"147.32.84.165",2029,"184.82.147.251",80,10,1925,5,990,5,935,89140.557763,0.3463939999928698,22864.13737005556,21593.907516163585
"147.32.84.165",3292,"65.55.92.136",25,3,186,3,186,0,0,89140.67208,8.91672799999651,166.87735680628393,0
"147.32.84.165",2034,"217.163.21.39",80,13,5769,7,2664,6,3105,89140.786244,0.2243670000025304,94987.2307414176,110711.46826280093
"147.32.84.165",3293,"209.85.227.27",25,3,186,3,186,0,0,89140.833824,8.855335000000196,168.03429796839612,0
"147.32.84.165",2036,"217.163.21.37",80,13,6077,6,749,7,5328,89141.660362,0.1898970000038389,31553.947665728618,224458.52224699876
"147.32.84.165",3382,"195.156.147.12",25,3,186,3,186,0,0,89141.709296,8.98287999999593,165.64843346462095,0
"147.32.84.165",2050,"46.4.36.120",443,6,366,3,186,3,180,89142.563659,1.0302049999882001,1444.3727219505276,1397.7800535005106
"147.32.84.165",2047,"184.82.147.252",80,10,1515,5,603,5,912,89143.5941,0.36189400000148453,13329.870072397474,20160.599512481753
"147.32.84.165",3473,"66.210.204.5",25,3,186,3,186,0,0,89143.71349,8.985557000007248,165.5990830617178,0
"147.32.84.165",2063,"58.215.78.1",6667,10,1129,5,571,5,558,89144.270049,1.5472270000027493,2952.378674875686,2885.161647251546
"147.32.84.165",2082,"46.4.36.120",443,6,366,3,186,3,180,89144.611737,0.9918330000073183,1500.252562668333,1451.85731871129
"147.32.84.165",2048,"195.113.232.96",80,16,15483,11,1382,5,14101,89144.973276,63.06813400000101,175.30247525636042,1788.6687435527772
"147.32.84.165",3475,"94.245.120.86",25,3,186,3,186,0,0,89144.974293,9.028931999986526,164.80354487133368,0
"147.32.84.165",2053,"217.163.21.37",80,10,1448,5,699,5,749,89145.274337,0.14121600000362378,39598.91230353857,42431.45252553703
"147.32.84.165",3479,"64.12.90.98",25,3,186,3,186,0,0,89145.322333,8.982606999998097,165.653467862984,0
"147.32.84.165",2078,"212.117.171.138",65500,128,92432,68,4839,60,87593,89145.603822,115.91554999999062,333.96727186303417,6045.2976326304515
"147.32.84.165",2083,"94.100.176.20",25,3,186,3,186,0,0,89145.603881,9.000887000001967,165.31704042053576,0
"147.32.84.165",2075,"217.163.21.37",80,13,6081,6,750,7,5331,89154.203697,0.18625400000019,32214.073254769723,228977.63269490318
"147.32.84.165",3481,"98.139.175.224",25,3,186,3,186,0,0,89154.249587,8.989031000004616,165.53508381484454,0
"147.32.84.165",2104,"205.188.186.137",587,27,3555,13,1895,14,1660,89154.404313,2.8496029999951134,5320.039317766719,4660.298294191427
"147.32.84.165",2109,"46.4.36.120",443,6,366,3,186,3,180,89154.521736,1.013542000000598,1468.118736075192,1420.7600671695407
"147.32.84.165",2101,"217.163.21.39",80,14,6015,7,2673,7,3342,89155.106713,0.28988399999798276,73767.43801019997,92229.99544709625
"147.32.84.165",3483,"65.54.188.110",25,3,186,3,186,0,0,89155.152716,8.988807000001543,165.5392089294769,0
"147.32.84.165",2136,"122.55.28.99",6667,3,186,3,186,0,0,89155.53557,9.009424000003492,165.16039205163653,0
"147.32.84.165",2208,"46.4.36.120",443,6,366,3,186,3,180,89161.633407,1.033597000001464,1439.632661470469,1393.192898197228
"147.32.84.165",2139,"184.82.147.251",80,10,1925,5,990,5,935,89161.734103,0.3472170000022743,22809.94306139424,21542.724002427894
"147.32.84.165",3487,"74.6.136.65",25,3,186,3,186,0,0,89161.848706,9.017057999997633,165.02056435706533,0
"147.32.84.165",2227,"31.192.109.161",80,10,1035,5,540,5,495,89162.667243,0.2427319999987958,17797.406192926486,16314.289010182612
"147.32.84.165",2224,"221.130.69.202",6667,6,366,3,186,3,180,89162.737129,1.989025999995647,748.1048513208257,723.9724367620893
"147.32.84.165",2198,"217.163.21.37",80,10,1451,5,701,5,750,89162.748198,0.1392070000001695,40285.330479021686,43101.28082634274
"147.32.84.165",3490,"205.188.103.2",25,3,186,3,186,0,0,89162.794122,8.97511799998756,165.79169209831696,0
"147.32.84.165",2275,"46.4.36.120",443,6,366,3,186,3,180,89164.726435,1.049992000000202,1417.1536545037616,1371.4390204875112
"147.32.84.165",2251,"184.82.147.252",80,10,1515,5,603,5,912,89164.745194,0.3618179999903077,13332.670016774246,20164.834254225723
"147.32.84.165",3493,"209.85.227.27",25,3,186,3,186,0,0,89164.864587,8.913438999996288,166.93893344652045,0
"147.32.84.165",2259,"217.163.21.39",80,11,4250,6,2620,5,1630,89165.776554,0.23765100000309758,88196.55713515535,54870.37714897069
"147.32.84.165",3494,"205.188.190.2",25,3,186,3,186,0,0,89165.822464,8.85850100000971,167.97424304612812,0
"147.32.84.165",2286,"217.163.21.37",80,13,6081,6,750,7,5331,89166.049233,0.18698900000890717,32087.448992797392,228077.58744080388
"147.32.84.165",3495,"189.21.116.60",25,3,186,3,186,0,0,89166.095093,8.886976000008872,167.43603223396963,0
"147.32.84.165",2287,"217.163.21.37",80,10,2277,5,1156,5,1121,89166.350687,0.14191200000641402,65167.14583391127,63194.09211056621
"147.32.84.165",3497,"65.55.92.184",25,3,186,3,186,0,0,89166.396871,8.885788999992656,167.45839902356784,0
"147.32.84.165",2289,"217.163.21.37",80,10,1451,5,701,5,750,89166.651968,0.13987999998789746,40091.5070094739,42893.909068624
"147.32.84.165",3500,"65.55.88.22",25,3,186,3,186,0,0,89166.698004,8.885784999991301,167.4584744061956,0
"147.32.84.165",2327,"182.72.80.42",6667,3,186,3,186,0,0,89175.182535,9.031237999995938,164.76146459662223,0
"147.32.84.165",2296,"74.125.93.27",25,3,186,3,186,0,0,89176.085777,9.031057000000146,164.76476673771143,0
"147.32.84.165",2294,"217.163.21.39",80,14,6594,7,3135,7,3459,89176.487038,0.21292899998661596,117785.74079423868,129958.81257010259
"147.32.84.165",3501,"64.12.90.1",25,3,186,3,186,0,0,89176.533025,8.984395999999833,165.62048244534498,0
"147.32.84.165",2416,"98.126.71.122",80,12,4257,7,770,5,3487,89182.809804,16.761854999989737,367.50109101908896,1664.2549407578745
"147.32.84.165",2401,"220.164.82.72",6667,1,62,1,62,0,0,89182.984376,0,0,0
"147.32.84.165",2309,"46.4.36.120",443,6,366,3,186,3,180,89183.712086,1.0303439999988768,1444.1778668111058,1397.5914840107475
"147.32.84.165",2307,"217.163.21.39",80,11,4250,6,2620,5,1630,89184.742691,0.2283129999996163,91803.7956666297,57114.57516664366
"147.32.84.165",3503,"216.32.181.178",25,3,186,3,186,0,0,89184.789454,8.956743000002461,166.13181822896905,0
"147.32.84.165",2429,"95.100.248.96",80,15,6026,8,2169,7,3857,89185.818981,13.75279299999238,1261.7073491915144,2243.6169874742604
"147.32.84.165",2439,"46.4.36.120",443,6,366,3,186,3,180,89185.819923,1.0306350000028033,1443.770102893801,1397.1968737681946
"147.32.84.165",2351,"184.82.147.251",80,10,1913,5,994,5,919,89186.723002,0.34396199999901,23118.832894397892,21374.454154880947
"147.32.84.165",3505,"74.125.113.27",25,3,186,3,186,0,0,89186.83635,9.016912999999477,165.02321803482926,0
"147.32.84.165",2441,"195.113.232.96",80,8,1968,5,945,3,1023,89186.85082,12.721040999997058,594.2909860916059,643.3435754198019
"147.32.84.165",2388,"173.241.240.4",80,9,2195,5,1165,4,1030,89186.85088,0.09961000000475906,93564.90311770624,82722.61820707076
"147.32.84.165",3507,"64.12.138.161",25,3,186,3,186,0,0,89186.867138,8.986227000001236,165.5867362353294,0
"147.32.84.165",2437,"217.163.21.37",80,10,2277,5,1156,5,1121,89187.023661,0.14037700000335462,65879.73813216551,63885.10938248922
"147.32.84.165",3508,"64.12.138.152",25,3,186,3,186,0,0,89187.069625,8.984826999992947,165.61253767058264,0
"147.32.84.165",2445,"184.82.147.252",80,10,1315,5,593,5,722,89187.324702,0.3364129999972647,14101.71426204865,17169.372170656196
"147.32.84.165",3511,"217.119.50.249",25,3,186,3,186,0,0,89187.434988,9.020413000005647,164.9591875670292,0
"147.32.84.165",2459,"217.163.21.39",80,14,6594,7,3135,7,3459,89187.625022,0.21739600000728387,115365.5081011596,127288.45056520289
"147.32.84.165",3514,"64.12.90.97",25,3,186,3,186,0,0,89187.670964,8.985092000002624,165.6076532104029,0
"147.32.84.165",2472,"119.154.75.69",6667,1,62,1,62,0,0,89194.347851,0,0,0
"147.32.84.165",2477,"46.4.36.120",443,6,366,3,186,3,180,89196.254559,1.0306970000092406,1443.6832551047103,1397.1128275206872
"147.32.84.165",2465,"217.163.21.39",80,15,7643,7,2571,8,5072,89197.157553,0.19565700000384822,105122.74030367156,207383.3289849172
"147.32.84.165",3515,"65.55.92.136",25,3,186,3,186,0,0,89197.207647,8.881517000001622,167.5389463308721,0
"147.32.84.165",2514,"74.125.39.27",25,3,186,3,186,0,0,89197.285479,8.904292999999598,167.11040393662554,0
"147.32.84.165",2474,"173.241.240.4",80,9,2195,5,1165,4,1030,89197.55986,0.06534500000998378,142627.59198983913,126099.93111548008
"147.32.84.165",3518,"207.115.21.22",25,3,186,3,186,0,0,89197.575994,8.914636000001337,166.9165179598782,0
"147.32.84.165",2517,"190.107.110.169",6667,1,62,1,62,0,0,89204.38347,0,0,0
"147.32.84.165",2519,"46.4.36.120",443,6,366,3,186,3,180,89205.688019,1.0301319999998668,1444.4750769806126,1397.8791067554314
"147.32.84.165",2509,"184.82.147.251",80,10,1925,5,990,5,935,89206.718393,0.3486339999944903,22717.233546140553,21455.16501579941
"147.32.84.165",2525,"173.192.170.88",80,11,1100,6,543,5,557,89206.832901,52.560723000002326,82.64726495485627,84.7781336645579
"147.32.84.165",3519,"205.188.146.193",25,3,186,3,186,0,0,89207.033879,8.990214000004926,165.51330146303354,0
"147.32.84.165",2537,"133.6.157.199",6667,2,124,2,124,0,0,89207.79524,3.0105059999914374,329.5127131461693,0
"147.32.84.165",2536,"46.4.36.120",443,6,366,3,186,3,180,89207.795384,1.0302300000039395,1444.3376721647692,1397.7461343530024
"147.32.84.165",2515,"217.163.21.39",80,13,5694,7,2611,6,3083,89207.995196,0.2364240000024438,88349.74452586917,104321.05031530243
"147.32.84.165",3520,"209.85.227.27",25,3,186,3,186,0,0,89208.04109,8.986250000001746,165.58631242172328,0
"147.32.84.165",2535,"184.82.147.252",80,10,1515,5,603,5,912,89208.396729,0.3479170000064187,13865.37593710857,20970.518830253757
"147.32.84.165",3529,"203.131.74.12",25,3,186,3,186,0,0,89208.510506,9.01824599999236,164.99882571414227,0
"147.32.84.165",2538,"195.113.232.96",80,22,19585,15,1558,7,18027,89208.598083,60.218385000000126,206.97997795855824,2394.883223786219
"147.32.84.165",3532,"65.55.92.184",25,3,186,3,186,0,0,89208.59888,9.029832999993232,164.78710071394624,0
"147.32.84.165",2539,"217.163.21.37",80,14,6138,7,810,7,5328,89208.825788,0.18812099999922793,34445.915129233814,226577.57507229355
"147.32.84.165",3533,"98.139.175.224",25,3,186,3,186,0,0,89208.871811,8.957853999992949,166.11121369037397,0
"147.32.84.165",2542,"46.4.36.120",443,6,366,3,186,3,180,89214.416664,1.0310449999960838,1443.1959807822664,1396.641271724774
"147.32.84.165",2540,"217.163.21.37",80,10,1449,5,700,5,749,89215.447913,0.1406669999996666,39810.33220309862,42597.055457315524
"147.32.84.165",3534,"195.29.149.180",25,3,186,3,186,0,0,89215.493795,8.958799999993062,166.0936732599402,0
"147.32.84.165",2554,"117.204.76.152",6667,2,124,2,124,0,0,89218.130946,3.009597999989637,329.61212760090075,0
"147.32.84.165",2552,"46.4.36.120",443,6,366,3,186,3,180,89218.230959,1.0308310000109486,1443.495587525206,1396.9312137340703
"147.32.84.165",2548,"184.82.147.251",80,10,1929,5,994,5,935,89218.531889,0.3465659999928903,22945.1244500705,21583.190503838952
"147.32.84.165",3535,"12.102.252.75",25,3,186,3,186,0,0,89218.645755,9.016997999991872,165.02166242039104,0
"147.32.84.165",2557,"66.111.4.71",25,3,186,3,186,0,0,89219.261994,9.00255499999912,165.28641035796454,0
"147.32.84.165",2551,"217.163.21.39",80,14,6113,7,2679,7,3434,89224.452475,0.34395799999765586,62309.93318994198,79870.21671304993
"147.32.84.165",3536,"194.1.150.66",25,3,186,3,186,0,0,89224.498412,8.903665000005276,167.12219069328398,0
"147.32.84.165",2578,"31.192.109.161",80,10,1035,5,540,5,495,89228.064399,0.24132000000099652,17901.541521557105,16409.74639476068
"147.32.84.165",2592,"124.123.147.161",6667,6,366,3,186,3,180,89228.143336,1.3105890000006184,1135.3673806199333,1098.7426264063872
"147.32.84.165",2573,"46.4.36.120",443,6,366,3,186,3,180,89228.987287,1.0312600000033854,1442.8950991943013,1396.3500959944852
"147.32.84.165",2563,"184.82.147.252",80,10,1514,5,603,5,911,89229.454163,0.3625800000008894,13304.6500082414,20100.391637658235
"147.32.84.165",3537,"74.6.136.65",25,3,186,3,186,0,0,89229.489234,9.030720000009751,164.7709152756805,0
"147.32.84.165",2589,"184.82.147.251",80,10,1926,5,998,5,928,89229.573718,0.3618600000045262,22063.78157270805,20516.221742958987
"147.32.84.165",3538,"200.213.30.210",25,3,186,3,186,0,0,89229.589466,9.030128999991575,164.7816991320266,0
"147.32.84.165",3539,"205.188.156.193",25,3,186,3,186,0,0,89229.693225,9.026911000008113,164.84044209571388,0
"147.32.84.165",2597,"217.163.21.37",80,14,6137,7,809,7,5328,89229.791076,0.18852600001264364,34329.482403307506,226090.83095775326
"147.32.84.165",3541,"64.12.138.152",25,3,186,3,186,0,0,89229.836991,8.983882000000449,165.62995818510592,0
"147.32.84.165",2599,"184.82.147.252",80,10,1507,5,596,5,911,89230.018753,0.3422510000091279,13931.296036747406,21294.313237377326
"147.32.84.165",3544,"64.12.138.161",25,3,186,3,186,0,0,89230.132034,8.989587000003667,165.5248455796015,0
"147.32.84.165",2605,"46.4.36.120",443,6,366,3,186,3,180,89234.505675,1.0315250000130618,1442.5244177127631,1395.9913719800934
"147.32.84.165",2600,"217.163.21.37",80,10,1448,5,699,5,749,89235.537522,0.13893600000301376,40248.7476239326,43127.77105912091
"147.32.84.165",3545,"65.55.37.72",25,3,186,3,186,0,0,89235.583387,8.956818999999086,166.1304085747576,0
"147.32.84.165",2625,"173.192.170.88",80,10,1277,6,748,4,529,89236.411882,9.060639999996056,660.4389976869851,467.07517349788117
"147.32.84.165",2615,"212.117.171.138",65500,214,169797,128,163261,86,6536,89236.412023,89.47599900000205,14597.076474105308,584.3801755149871
"147.32.84.165",2601,"217.163.21.37",80,15,6197,7,809,8,5388,89236.412078,0.19125600000552367,33839.46124468295,225373.32161477345
"147.32.84.165",3546,"98.139.175.224",25,3,186,3,186,0,0,89236.457975,8.984789000009187,165.61323810703607,0
"147.32.84.165",2638,"50.23.235.4",80,22,12295,11,2283,11,10012,89239.623672,15.359396999992896,1189.1091818258521,5214.788054507417
"147.32.84.165",2617,"118.136.111.104",6667,3,186,3,186,0,0,89239.776944,8.977848000009544,165.74127786507614,0
"147.32.84.165",2633,"46.4.36.120",443,6,366,3,186,3,180,89240.225306,1.0316260000108741,1442.3831892413677,1395.8546992658398
"147.32.84.165",2628,"217.163.21.39",80,11,4241,6,2613,5,1628,89241.25717,0.25483900000108406,82028.26098011323,51106.77721990982
"147.32.84.165",3547,"66.94.238.147",25,3,186,3,186,0,0,89241.303032,8.957187000007252,166.12358321857022,0
"147.32.84.165",2652,"67.201.31.224",80,8,2329,5,615,3,1714,89245.442882,9.540399999998044,515.7016477297607,1437.25629952652
"147.32.84.165",2622,"205.188.186.167",587,45,14306,21,11984,24,2322,89245.472208,15.964472999999998,6005.3344698569135,1163.5836648037177
"147.32.84.165",2651,"216.157.130.15",25,3,186,3,186,0,0,89245.589664,8.984171000003698,165.62463025240586,0
"147.32.84.165",2634,"217.163.21.37",80,10,1448,5,699,5,749,89250.560742,0.14002099999925122,39936.86661307878,42793.580963084416
"147.32.84.165",3548,"216.32.181.178",25,3,186,3,186,0,0,89250.606652,8.883178999996744,167.50760060115252,0
"147.32.84.165",2654,"68.67.185.206",80,8,1608,5,644,3,964,89250.661381,4.322090000001481,1192.0158997147757,1784.32193684013
"147.32.84.165",2665,"27.255.59.65",6667,6,366,3,186,3,180,89250.685419,1.4367899999924703,1035.6419518564287,1002.2341469578341
"147.32.84.165",2655,"46.4.36.120",443,6,366,3,186,3,180,89250.761929,1.030769999997574,1443.5810122563737,1397.0138828287486
"147.32.84.165",2641,"184.82.147.251",80,10,1910,5,982,5,928,89250.861662,0.34601500000280794,22704.218025045873,21455.717237517892
"147.32.84.165",3549,"64.29.151.237",25,3,186,3,186,0,0,89250.975042,8.916774999990594,166.8764772018549,0
"147.32.84.165",2713,"68.67.185.212",80,8,1646,5,828,3,818,89251.16327,3.8195770000020275,1734.2234493496228,1713.2787217004727
"147.32.84.165",2653,"217.163.21.37",80,10,2274,5,1154,5,1120,89251.192374,0.1398239999980433,66025.86108342769,64080.55841719152
"147.32.84.165",3551,"207.115.21.22",25,3,186,3,186,0,0,89251.238356,8.853212999994867,168.07457360405346,0
"147.32.84.165",2710,"217.163.21.39",80,14,6015,7,2673,7,3342,89251.792945,0.28706900001270697,74490.80185966945,93134.40322297617
"147.32.84.165",3552,"68.6.19.3",25,3,186,3,186,0,0,89251.838923,8.85532799999055,168.03443079709615,0
"147.32.84.165",2715,"184.82.147.252",80,10,1508,5,596,5,912,89252.122447,0.3349179999931948,14236.320532479236,21784.436787954804
"147.32.84.165",3555,"64.12.90.97",25,3,186,3,186,0,0,89252.232792,9.161776000008103,162.41392498557963,0
"147.32.84.165",2728,"196.0.35.154",6667,1,62,1,62,0,0,89256.580453,0,0,0
"147.32.84.165",2734,"46.4.36.120",443,6,366,3,186,3,180,89257.4832,1.031036000000313,1443.2085785554998,1396.6534631182258
"147.32.84.165",2721,"217.163.21.39",80,14,6585,7,3128,7,3457,89258.514481,0.21247299999231473,117774.96435267132,130162.4206416831
"147.32.84.165",3565,"74.6.136.65",25,3,186,3,186,0,0,89258.560484,8.959067999996478,166.08870476265892,0
"147.32.84.165",2762,"46.4.36.120",443,6,366,3,186,3,180,89260.69439,1.230664999995497,1209.1023958635733,1170.0990927712
"147.32.84.165",2724,"217.163.21.37",80,13,6081,6,750,7,5331,89261.925298,0.18702499999199063,32081.272558518653,228033.68534595057
"147.32.84.165",2760,"173.192.170.88",80,7,860,4,423,3,437,89261.971389,7.422395999994478,455.9174692380355,471.00693630501536
"147.32.84.165",3567,"205.188.59.194",25,3,186,3,186,0,0,89262.172193,8.958514999991166,166.09895724921677,0
"147.32.84.165",2755,"173.241.240.4",80,9,2194,5,1164,4,1030,89262.19821,0.0705349999916507,132019.56477071342,116821.43618027048
"147.32.84.165",3568,"65.55.37.104",25,3,186,3,186,0,0,89262.214505,9.016234000009717,165.03564570289507,0
"147.32.84.165",2776,"178.124.94.49",6667,6,366,3,186,3,180,89266.515193,1.0802960000000894,1377.4002680745618,1332.9680013624793
"147.32.84.165",2782,"46.4.36.120",443,6,366,3,186,3,180,89267.59582,1.0546789999934845,1410.85581490595,1365.344337005758
"147.32.84.165",2758,"184.82.147.251",80,10,1910,5,982,5,928,89268.650703,0.36106399999698624,21757.915494387624,20561.451709563866
"147.32.84.165",3571,"68.6.19.3",25,3,186,3,186,0,0,89268.769963,8.983869000003324,165.63019785789947,0
"147.32.84.165",2774,"217.163.21.37",80,10,1451,5,701,5,750,89268.770028,0.1390629999950761,40327.04601654334,43145.91228588802
"147.32.84.165",3572,"67.231.144.184",25,3,186,3,186,0,0,89268.815914,8.938031999990926,166.47960087875168,0
"147.32.84.165",2799,"217.163.21.39",80,14,6022,7,2675,7,3347,89269.124543,0.28791300000739284,74328.00880630783,93000.316065313
"147.32.84.165",3573,"64.12.90.34",25,3,186,3,186,0,0,89269.170578,8.98453599998902,165.61790169262144,0
"147.32.84.165",2811,"59.113.54.127",6667,2,124,2,124,0,0,89271.531616,3.0119590000103926,329.3537528221922,0
"147.32.84.165",2806,"46.4.36.120",443,6,366,3,186,3,180,89271.933029,1.032359999997425,1441.3576659340847,1394.8622573555658
"147.32.84.165",2800,"184.82.147.252",80,10,1508,5,596,5,912,89272.13413,0.36633199999050703,13015.515980377242,19916.360023664503
"147.32.84.165",3575,"205.188.156.193",25,3,186,3,186,0,0,89272.254956,9.009957000002032,165.15062169549358,0
"147.32.84.165",2816,"217.163.21.37",80,13,6081,6,750,7,5331,89272.737153,0.18911099999968428,31727.39819476401,225518.3463683826
"147.32.84.165",3578,"98.139.175.224",25,3,186,3,186,0,0,89272.783092,8.984660999994958,165.6155975167939,0
"147.32.84.165",2817,"217.163.21.37",80,10,1451,5,701,5,750,89272.965621,0.13944400000036694,40216.86124885433,43028.02558721932
"147.32.84.165",3579,"205.188.59.194",25,3,186,3,186,0,0,89273.011525,8.955664000008255,166.1518341910358,0
"147.32.84.165",3580,"209.85.227.27",25,3,186,3,186,0,0,89273.011585,8.955726999993203,166.15066537882734,0
"147.32.84.165",2821,"217.163.21.39",80,14,6032,7,2675,7,3357,89273.138214,0.27944499999284744,76580.36465332264,96104.77911820714
"147.32.84.165",3581,"65.254.254.55",25,3,186,3,186,0,0,89273.183981,8.983863000001293,165.63030847640775,0
"147.32.84.165",2823,"46.4.36.120",443,6,366,3,186,3,180,89279.559145,1.0317069999873638,1442.269946814575,1395.7451098205565
"147.32.84.165",2837,"184.82.147.251",80,10,1910,5,982,5,928,89280.591083,0.3655529999959981,21490.7277469642,20308.9565673959
"147.32.84.165",3583,"65.55.37.120",25,3,186,3,186,0,0,89280.711839,8.98017300000356,165.69836683540618,0
"147.32.84.165",2861,"79.135.138.210",6667,2,124,2,124,0,0,89283.17135,3.009379999988596,329.6360047597044,0
"147.32.84.165",2865,"46.4.36.120",443,6,366,3,186,3,180,89283.271742,1.0307600000087405,1443.5950172565701,1397.0274360547453
"147.32.84.165",2862,"184.82.147.252",80,10,1507,5,596,5,911,89284.302747,0.36818900000071153,12949.870854345963,19794.181792465053
"147.32.84.165",3584,"61.9.168.122",25,3,186,3,186,0,0,89284.422173,8.8808779999963,167.55100115108212,0
"147.32.84.165",2872,"46.4.36.120",443,6,366,3,186,3,180,89287.184644,1.030043000006117,1444.5998856272636,1397.9998893167067
"147.32.84.165",2871,"217.163.21.37",80,14,6137,7,809,7,5328,89288.214895,0.19259299999976065,33604.54429812113,221316.45490777428
"147.32.84.165",3585,"207.115.21.22",25,3,186,3,186,0,0,89288.262318,8.853973000004771,168.0601465578445,0
"147.32.84.165",2883,"31.192.109.161",80,10,1035,5,540,5,495,89289.791757,0.23799300000246149,18151.79438031925,16639.14484862598
"147.32.84.165",2904,"46.4.36.120",443,6,366,3,186,3,180,89289.869441,1.0555069999973057,1409.7490589866275,1364.2732828902847
"147.32.84.165",2892,"217.163.21.37",80,10,1448,5,699,5,749,89290.093077,0.13969500000530388,40030.06549831909,42893.44643525178
"147.32.84.165",3587,"68.1.17.3",25,3,186,3,186,0,0,89290.139087,8.985126999992644,165.60700811476767,0
"147.32.84.165",2908,"78.249.161.87",6667,2,124,2,124,0,0,89290.925213,2.9803740000061225,332.8441329839685,0
"147.32.84.165",2919,"46.4.36.120",443,6,366,3,186,3,180,89293.202974,1.0306050000071991,1443.8121297583514,1397.2375449274368
"147.32.84.165",2903,"184.82.147.251",80,10,1906,5,982,5,924,89293.70551,0.3630730000004405,21637.521930825118,20359.54202045052
"147.32.84.165",3588,"193.252.22.143",25,3,186,3,186,0,0,89293.825412,9.01262599999609,165.10171397333536,0
"147.32.84.165",2907,"217.163.21.39",80,11,4241,6,2613,5,1628,89293.905725,0.2536790000012843,82403.35226760658,51340.47359038022
"147.32.84.165",3590,"98.139.175.224",25,3,186,3,186,0,0,89293.951431,8.986492000010912,165.5818532969476,0
"147.32.84.165",2929,"184.82.147.252",80,10,1508,5,595,5,913,89294.105847,0.33321199999772944,14285.199812829176,21919.978872458887
"147.32.84.165",3591,"74.6.136.65",25,3,186,3,186,0,0,89294.216057,9.023008000003756,164.91174561735738,0
"147.32.84.165",2930,"217.163.21.37",80,10,2274,5,1154,5,1120,89294.233813,0.13955200000782497,66154.55170461435,64205.4574602843
"147.32.84.165",3592,"74.208.5.21",25,3,186,3,186,0,0,89294.27973,8.959442999999737,166.0817530732707,0
"147.32.84.165",2941,"46.4.36.120",443,6,366,3,186,3,180,89297.217163,1.03073700000823,1443.627229824988,1397.058609508053
"147.32.84.165",2931,"217.163.21.39",80,14,6585,7,3128,7,3457,89298.248132,0.21129400000791065,118432.1372072237,130888.71429839269
"147.32.84.165",3600,"205.188.103.2",25,3,186,3,186,0,0,89298.293948,8.959098999999696,166.08813006754926,0
"147.32.84.165",2967,"210.212.182.243",6667,2,124,2,124,0,0,89301.632958,3.0118689999944763,329.36359449956797,0
"147.32.84.165",2952,"46.4.36.120",443,6,366,3,186,3,180,89305.347155,1.0301830000098562,1444.403567119399,1397.8099036639344
"147.32.84.165",2935,"70.32.97.26",80,10,2746,6,876,4,1870,89306.377591,0.5473800000036135,12802.806094401945,27330.191091931094
"147.32.84.165",3606,"205.188.190.2",25,3,186,3,186,0,0,89306.499579,8.983868000010261,165.63021629417312,0
"147.32.84.165",2949,"173.241.240.4",80,9,2194,5,1164,4,1030,89307.252991,0.07002299999294337,132984.8764111567,117675.62087928814
"147.32.84.165",3608,"64.12.90.1",25,3,186,3,186,0,0,89307.269824,9.015545000002021,165.04825831379762,0
"147.32.84.165",2988,"46.4.36.120",443,6,366,3,186,3,180,89309.158646,1.0311000000074273,1443.1189991167505,1396.5667733387909
"147.32.84.165",2973,"184.82.147.251",80,10,1910,5,982,5,928,89310.189998,0.3619380000018282,21705.37495361172,20511.800363494578
"147.32.84.165",3610,"87.85.78.99",25,3,186,3,186,0,0,89310.309452,10.358707999999751,143.64725793989325,0
"147.32.84.165",2985,"195.113.232.96",80,8,2213,5,782,3,1431,89311.168601,65.79886300000362,95.07763074872062,173.98476931127777
"147.32.84.165",3611,"68.1.17.3",25,3,186,3,186,0,0,89311.169423,10.385957999998936,143.27036562252152,0
"147.32.84.165",2997,"212.117.171.138",65500,222,170287,129,163327,93,6960,89314.880498,22.41899099999864,58281.659509122386,2483.6086512547945
"147.32.84.165",3002,"46.4.36.120",443,6,366,3,186,3,180,89314.880627,1.0314289999951143,1442.658680342562,1396.121303557318
"147.32.84.165",2998,"184.82.147.252",80,10,1508,5,596,5,912,89314.980824,0.3458600000012666,13785.924940676976,21095.240848821144
"147.32.84.165",3614,"74.125.159.27",25,3,186,3,186,0,0,89315.094724,10.03827600000659,148.23262480519793,0
"147.32.84.165",2999,"109.200.239.148",6667,1,62,1,62,0,0,89315.283051,0,0,0
"147.32.84.165",3005,"173.201.33.10",80,12,4152,6,928,6,3224,89315.283223,0.5842609999963315,12706.649939062532,44144.65452967414
"147.32.84.165",3617,"209.85.227.27",25,3,186,3,186,0,0,89315.464233,10.099546999990707,147.33334079254934,0
"147.32.84.165",3004,"65.55.16.187",443,126,164905,68,5452,58,159453,89315.912279,10.115809000009904,4311.667015456431,126102.02505788229
"147.32.84.165",3007,"70.32.97.26",80,9,1565,5,852,4,713,89316.074287,0.36270900000818074,18791.924104023525,15726.10550019809
"147.32.84.165",3618,"66.94.236.34",25,3,186,3,186,0,0,89316.187498,9.503911000007065,156.5671227349345,0
"147.32.84.165",3025,"46.4.36.120",443,6,366,3,186,3,180,89317.289045,2.9149800000013784,510.46662412753994,493.99995883310316
"147.32.84.165",3018,"217.163.21.37",80,13,6081,6,750,7,5331,89320.671378,4.066936000002897,1475.3121268679236,10486.5185977772
"147.32.84.165",3619,"98.139.175.224",25,3,186,3,186,0,0,89321.558577,8.165460999996867,182.23098487649025,0
"147.32.84.165",3024,"212.117.171.138",65500,46,4599,21,2077,25,2522,89322.02142,47.436933999997564,350.27558905895677,425.3225977884877
"147.32.84.165",3020,"173.241.240.6",80,10,1569,5,945,5,624,89322.02458,2.6778230000054464,2823.188836597723,1864.200882578814
"147.32.84.165",3620,"68.6.19.3",25,3,186,3,186,0,0,89323.342605,8.20582000000286,181.33471121709732,0
"147.32.84.165",3027,"65.55.16.187",443,156,166697,81,6344,75,160353,89327.322919,10.116758999996819,5016.6263721430905,126801.87399941063
"147.32.84.165",3038,"46.4.36.120",443,6,366,3,186,3,180,89327.423339,1.0306629999977304,1443.730880028949,1397.1589161570475
"147.32.84.165",3021,"173.241.240.6",80,9,1178,5,771,4,407,89327.485085,0.05485000000044238,112452.14220510946,59361.896079740014
"147.32.84.165",3622,"66.94.238.147",25,3,186,3,186,0,0,89327.501423,9.61779899999965,154.7131521463543,0
"147.32.84.165",3033,"212.12.200.158",6667,6,366,3,186,3,180,89328.22582,1.9895619999879273,747.903307365656,723.7773942248284
"147.32.84.165",3030,"184.82.147.251",80,10,1910,5,982,5,928,89328.454258,0.3344829999987269,23486.993359991095,22195.44790027672
"147.32.84.165",3623,"205.188.59.194",25,3,186,3,186,0,0,89328.564625,8.993726000000606,165.44866943910674,0
"147.32.84.165",3066,"46.4.36.120",443,6,366,3,186,3,180,89331.108022,2.7084369999938644,549.3943554911452,531.6719569269147
"147.32.84.165",3044,"173.201.33.10",80,11,1698,6,987,5,711,89331.982818,1.9977859999926295,3952.3752794489155,2847.1517970498267
"147.32.84.165",3624,"206.71.177.151",25,3,186,3,186,0,0,89332.850836,8.318859999999404,178.87066256675874,0
"147.32.84.165",3052,"212.117.171.138",65500,79,32875,39,3226,40,29649,89332.854096,118.51315900000918,217.764847530543,2001.3980050939458
"147.32.84.165",3045,"217.163.21.34",80,13,6132,6,825,7,5307,89332.85722,2.716711999994004,2429.407312963084,15627.714678660712
"147.32.84.165",3626,"64.12.90.66",25,3,186,3,186,0,0,89333.756019,8.116403000007267,183.33244418724252,0
"147.32.84.165",3078,"111.92.129.242",6667,2,124,2,124,0,0,89334.663638,2.458784000002197,403.45146218582585,0
"147.32.84.165",3084,"46.4.36.120",443,6,366,3,186,3,180,89336.824039,0.9618840000039199,1546.9640829808334,1497.0620157879034
"147.32.84.165",3046,"217.163.21.37",80,10,1451,5,701,5,750,89336.830439,0.3945630000089295,14213.192823131118,15206.697029027586
"147.32.84.165",3627,"209.85.227.27",25,3,186,3,186,0,0,89337.125642,8.760639000000083,169.8506239099666,0
"147.32.84.165",3079,"64.12.175.136",587,31,3682,15,1909,16,1773,89337.156394,32.39624199998798,471.4127027451415,437.8285604856657
"147.32.84.165",3061,"50.22.198.84",80,8,1438,5,634,3,804,89337.274122,0.3715189999929862,13652.060863901315,17312.70809870135
"147.32.84.165",3630,"205.188.59.193",25,3,186,3,186,0,0,89337.394993,8.99285600001167,165.46467551555023,0
"147.32.84.165",3063,"184.82.147.252",80,10,1508,5,596,5,912,89337.78616,0.35382999999274034,13475.397790175584,20620.07178630895
"147.32.84.165",3634,"98.139.175.224",25,3,186,3,186,0,0,89337.902412,8.986962000009953,165.57319369975662,0
"147.32.84.165",3083,"217.163.21.34",80,10,1637,5,786,5,851,89337.902473,0.139790000001085,44981.758351464305,48701.62386398998
"147.32.84.165",3639,"216.200.145.235",25,3,186,3,186,0,0,89337.948443,8.941061000004993,166.4232018995474,0
"147.32.84.165",3223,"84.16.230.244",6667,2,124,2,124,0,0,89341.169848,3.009859999991022,329.5834357754045,0
"147.32.84.165",3187,"46.4.36.120",443,6,366,3,186,3,180,89343.075851,1.0307759999996051,1443.5726093744615,1397.0057510075435
"147.32.84.165",3094,"184.82.147.251",80,10,1925,5,990,5,935,89344.106888,0.34302900001057424,23088.426925291616,21805.736540553193
"147.32.84.165",3642,"65.55.88.22",25,3,186,3,186,0,0,89344.220186,8.889551999993273,167.38751289166495,0
"147.32.84.165",3258,"46.4.36.120",443,6,366,3,186,3,180,89347.391049,1.0307949999987613,1443.546000903951,1396.9800008747911
"147.32.84.165",3106,"217.163.21.39",80,15,6074,7,2675,8,3399,89348.422102,0.287718000006862,74378.38438849713,94509.20692953336
"147.32.84.165",3643,"209.85.143.27",25,3,186,3,186,0,0,89348.46815,8.859274000002188,167.9595867561645,0
"147.32.84.165",3172,"173.241.240.7",80,9,1488,5,811,4,677,89348.513801,0.05699500000628177,113834.54687753167,95025.87945263741
"147.32.84.165",3644,"65.55.92.152",25,3,186,3,186,0,0,89348.53018,8.898180999996839,167.22518905836245,0
"147.32.84.165",3279,"46.4.36.120",443,6,366,3,186,3,180,89349.598725,1.0298550000006799,1444.8635973015791,1398.2550941628185
"147.32.84.165",3173,"217.163.21.39",80,14,5207,7,2768,7,2439,89350.628878,0.22770799999125302,97247.3518754309,85688.68902607514
"147.32.84.165",3645,"204.232.236.140",25,3,186,3,186,0,0,89350.674818,8.860885999994935,167.92903102475876,0
"147.32.84.165",3280,"31.192.109.161",80,10,1035,5,540,5,495,89353.109876,0.23834899999201298,18124.682713771665,16614.292487624025
"147.32.84.165",3284,"109.200.239.148",6667,2,124,2,124,0,0,89353.188554,2.9353680000058375,337.9474055716446,0
"147.32.84.165",3315,"46.4.36.120",443,6,366,3,186,3,180,89353.813641,1.0312949999934062,1442.8461303599006,1396.302706799904
"147.32.84.165",3186,"217.163.21.37",80,14,6141,7,810,7,5331,89354.845176,0.18883699999423698,34315.308971217295,225845.57052538198
"147.32.84.165",3647,"64.18.4.11",25,3,186,3,186,0,0,89354.891045,8.958784000002197,166.09396989587373,0
"147.32.84.165",3420,"46.4.36.120",443,6,366,3,186,3,180,89357.428264,1.0305280000029597,1443.920009932507,1397.3419450959743
"147.32.84.165",3238,"184.82.147.252",80,10,1515,5,603,5,912,89357.82917,0.3681150000047637,13104.600464359164,19819.89323962779
"147.32.84.165",3651,"208.65.145.12",25,3,186,3,186,0,0,89357.950153,9.01074100000551,165.13625239024074,0
"147.32.84.165",3300,"195.113.232.96",80,31,37282,21,1619,10,35663,89358.331046,58.193888999987394,222.5663247906117,4902.645361956507
"147.32.84.165",3654,"98.139.175.224",25,3,186,3,186,0,0,89358.331173,9.030194999999367,164.78049477338024,0
"147.32.84.165",3328,"184.82.147.251",80,10,1926,5,998,5,928,89358.459122,0.344161000000895,23198.44491380266,21571.2994789668
"147.32.84.165",3655,"64.12.90.1",25,3,186,3,186,0,0,89358.572767,8.989665000000969,165.52340938175556,0
"147.32.84.165",3410,"217.163.21.37",80,10,1451,5,701,5,750,89358.833496,0.13924999999289867,40272.890486793476,43087.971276883174
"147.32.84.165",3656,"64.12.138.161",25,3,186,3,186,0,0,89358.879516,8.983370000001742,165.63939813229462,0
"147.32.84.165",3595,"93.123.109.154",6667,1,62,1,62,0,0,89365.153566,0,0,0
"147.32.84.165",3594,"46.4.36.120",443,6,366,3,186,3,180,89367.461846,1.0313459999888437,1442.7747817086565,1396.2336597180547
"147.32.84.165",3485,"217.163.21.37",80,14,6141,7,810,7,5331,89368.493459,0.18821599999500904,34428.52892512768,226590.72555537734
"147.32.84.165",3657,"209.85.227.27",25,3,186,3,186,0,0,89368.539412,8.955623000001651,166.15259485573765,0
"147.32.84.165",3557,"184.82.147.252",80,10,1507,5,596,5,911,89369.368635,0.33506800000031944,14229.947353956373,21750.80879103063
"147.32.84.165",3658,"204.232.236.140",25,3,186,3,186,0,0,89369.468488,9.030264000000898,164.77923569010298,0
"147.32.84.165",3558,"217.163.21.39",80,11,4270,6,2630,5,1640,89369.468613,0.24960299998929258,84293.8586511483,52563.470793871944
"147.32.84.165",3662,"207.115.37.23",25,3,186,3,186,0,0,89369.479156,9.019719000003533,164.9718799443106,0
"147.32.84.165",3823,"46.4.36.120",443,6,366,3,186,3,180,89369.514555,0.9844779999984894,1511.4608960304681,1462.704092932711
"147.32.84.165",3760,"184.82.147.251",80,10,1925,5,990,5,935,89370.499356,0.3527780000003986,22450.37955879066,21203.136249968957
"147.32.84.165",3663,"98.139.175.224",25,3,186,3,186,0,0,89370.615952,8.98571800001082,165.59611596960957,0
"147.32.84.165",3783,"217.163.21.37",80,10,1451,5,701,5,750,89370.616012,0.13925599999492988,40271.15528382389,43086.11478297848
"147.32.84.165",3664,"65.55.37.88",25,3,186,3,186,0,0,89370.661864,8.93992900000012,166.44427489300867,0
"147.32.84.165",3832,"87.101.19.76",6667,2,124,2,124,0,0,89371.575623,3.009038000003784,329.6734703911192,0
"147.32.84.165",3887,"46.4.36.120",443,6,366,3,186,3,180,89375.890103,1.0306019999989076,1443.816332591609,1397.241612185428
"147.32.84.165",3825,"217.163.21.37",80,13,6077,6,749,7,5328,89376.920963,0.18738200000370853,31977.457812817724,227471.15517582488
"147.32.84.165",3670,"64.12.90.1",25,3,186,3,186,0,0,89376.967015,8.854342999999062,168.05312376086601,0
"147.32.84.165",3848,"217.163.21.37",80,10,2277,5,1156,5,1121,89376.967073,0.139391999997315,66345.27089200339,64336.54729233201
"147.32.84.165",3671,"142.20.63.50",25,3,186,3,186,0,0,89376.967138,8.854324999992969,168.05346539698755,0
"147.32.84.165",3960,"173.192.170.88",80,17,4118,9,763,8,3355,89377.494912,37.50464500000817,162.75317364018966,715.6446888110568
"147.32.84.165",3850,"217.163.21.39",80,11,4260,6,2630,5,1630,89377.69579,0.22506199999770615,93485.35070431455,57939.58998024058
"147.32.84.165",3675,"208.65.144.13",25,3,186,3,186,0,0,89377.741731,8.884076999995159,167.49066898011023,0
"147.32.84.165",4011,"46.4.36.120",443,6,366,3,186,3,180,89379.00004,1.0311800000054063,1443.0070404703335,1396.458426261613
"147.32.84.165",3862,"184.82.147.252",80,10,1515,5,603,5,912,89379.400846,0.3434629999974277,14045.180994855715,21242.46279818974
"147.32.84.165",3676,"124.108.110.37",25,3,186,3,186,0,0,89379.51423,8.918940999996266,166.8359505910649,0
"147.32.84.165",3982,"217.163.21.39",80,14,6619,7,3145,7,3474,89379.601856,0.2448280000098748,102766.02348989986,113516.42785498001
"147.32.84.165",3677,"209.85.227.27",25,3,186,3,186,0,0,89379.647854,8.886181000008946,167.4510118574562,0
"147.32.84.165",3994,"217.163.21.37",80,10,1448,5,699,5,749,89379.647916,0.17468599999847356,32011.72389343659,34301.54677565666
"147.32.84.165",3680,"216.163.188.57",25,3,186,3,186,0,0,89379.720259,8.813898000007612,168.82428183293192,0
"147.32.84.165",4009,"217.163.21.37",80,10,2277,5,1156,5,1121,89379.902979,0.13964399999531452,66225.54495939889,64220.446279832315
"147.32.84.165",3681,"205.188.156.193",25,3,186,3,186,0,0,89379.948904,8.885387000002083,167.4659753142605,0
"147.32.84.165",4049,"184.82.147.251",80,10,1926,5,998,5,928,89380.031456,0.3345380000100704,23865.74918173619,22191.798838327843
"147.32.84.165",3683,"209.86.93.228",25,3,186,3,186,0,0,89380.142034,8.89299399999436,167.32272618208714,0
"147.32.84.165",4084,"178.121.31.113",6667,1,62,1,62,0,0,89387.530243,0,0,0
"147.32.84.165",4086,"46.4.36.120",443,6,366,3,186,3,180,89389.436187,1.0308610000065528,1443.4535790863572,1396.8905604061522
"147.32.84.165",4066,"217.163.21.37",80,13,6081,6,750,7,5331,89390.439688,0.18654999999853317,32162.95899248018,228614.31251854912
"147.32.84.165",3684,"64.12.90.34",25,3,186,3,186,0,0,89390.467166,9.002441000004183,165.28850341805168,0
"147.32.84.165",4182,"94.100.176.20",25,3,186,3,186,0,0,89390.48551,8.984217000004719,165.62378223936693,0
"147.32.84.165",4067,"217.163.21.39",80,11,4256,6,2628,5,1628,89391.543017,0.22448399999120738,93654.78163621225,58017.497908582016
"147.32.84.165",3685,"209.59.1.34",25,3,186,3,186,0,0,89391.58894,8.984737999999197,165.61417817638454,0
"147.32.84.165",4221,"27.255.59.65",6667,2,122,1,62,1,60,89397.562754,0.16606899999896996,2986.7103433095667,2890.364848364097
"147.32.84.165",4227,"46.4.36.120",443,6,366,3,186,3,180,89397.86423,1.031991999989259,1441.8716424308395,1395.3596539653288
"147.32.84.165",4263,"208.73.210.29",80,50,36035,22,3329,28,32706,89398.667297,14.183479999992414,1877.677410622375,18447.37680739423
"147.32.84.165",4069,"173.241.240.4",80,9,2195,5,1165,4,1030,89398.853343,0.06669000000692904,139751.08710498814,123556.75512286506
"147.32.84.165",3687,"74.6.136.65",25,3,186,3,186,0,0,89398.869684,9.028254999997444,164.81590296246853,0
"147.32.84.165",4070,"217.163.21.39",80,14,6619,7,3145,7,3474,89398.896439,0.2242019999976037,112220.22997238612,123959.64353706499
"147.32.84.165",3688,"98.139.175.224",25,3,186,3,186,0,0,89398.942287,8.955774999994901,166.14977486603306,0
"147.32.84.165",4350,"46.4.36.120",443,6,366,3,186,3,180,89400.472979,1.0311670000082813,1443.0252325647057,1396.4760315142312
"147.32.84.165",4345,"74.125.232.217",80,8,1910,5,1036,3,874,89400.573817,12.277100000006612,675.0779907303464,569.5156022184583
"147.32.84.165",4078,"184.82.147.252",80,10,1508,5,596,5,912,89400.582026,0.366039999993518,13025.898809104016,19932.247842118897
"147.32.84.165",3691,"74.125.43.27",25,3,186,3,186,0,0,89400.702936,9.000943999999436,165.31599352246758,0
"147.32.84.165",4383,"111.88.77.58",6667,2,124,2,124,0,0,89400.874729,3.009489999996731,329.62395621885355,0
"147.32.84.165",4387,"67.214.158.5",80,10,1697,5,851,5,846,89401.075071,0.3306880000018282,20587.381459146876,20466.421521079035
"147.32.84.165",4212,"184.82.147.251",80,10,1925,5,990,5,935,89401.178522,0.35261699999682605,22460.630088938677,21212.81730621986
"147.32.84.165",3692,"64.12.90.98",25,3,186,3,186,0,0,89401.295039,9.010257999994792,165.1451046130821,0
"147.32.84.165",4388,"50.22.198.84",80,8,2201,5,1168,3,1033,89401.504409,0.38142799999332055,24497.414977829707,21665.950061727814
"147.32.84.165",4217,"217.163.21.37",80,10,1451,5,701,5,750,89401.625249,0.13935399999900255,40242.834795127084,43055.81468808176
"147.32.84.165",3693,"93.62.191.197",25,3,186,3,186,0,0,89401.671115,8.935427999997046,166.52811706394948,0
"147.32.84.165",4439,"46.4.36.120",443,6,366,3,186,3,180,89407.59613,1.0325969999976223,1441.0268478442474,1394.5421108170135
"147.32.84.165",4393,"195.113.232.83",80,8,1364,5,776,3,588,89408.629108,4.2219260000129,1470.4189509671728,1114.1834319184247
"147.32.84.165",4256,"217.163.21.37",80,10,2274,5,1154,5,1120,89408.630035,0.14077199999883305,65581.22353931556,63649.02111268061
"147.32.84.165",3695,"209.85.227.27",25,3,186,3,186,0,0,89408.67606,8.870781999998144,167.74169402430488,0
"147.32.84.165",4503,"208.81.160.62",6667,2,124,2,124,0,0,89411.51019,3.0097660000028554,329.5937292131876,0
"147.32.84.165",4497,"46.4.36.120",443,6,366,3,186,3,180,89411.510298,1.0308179999992717,1443.5137919604151,1396.948830929434
"147.32.84.165",4400,"94.127.76.180",80,4,242,3,182,1,60,89412.541422,0.01449000000138767,100483.0917778166,33126.29399268679
"147.32.84.165",4333,"173.241.240.4",80,9,2195,5,1165,4,1030,89412.555628,0.06723000000056345,138628.58842662338,122564.33139864556
"147.32.84.165",4535,"184.82.147.251",80,10,1897,5,962,5,935,89412.572109,0.3464349999994738,22214.845497746155,21591.35191309008
"147.32.84.165",3696,"64.12.90.97",25,3,186,3,186,0,0,89412.614049,8.933190000010654,166.5698367546448,0
"147.32.84.165",4541,"74.125.93.27",25,3,186,3,186,0,0,89412.687347,8.860014000005322,167.9455585509353,0
"147.32.84.165",4553,"184.82.147.252",80,10,1515,5,603,5,912,89417.847828,0.34221899999829475,14096.236620479978,21319.68125684534
"147.32.84.165",3699,"194.232.133.220",25,3,186,3,186,0,0,89417.961166,9.007743000009214,165.19121382553632,0
"147.32.84.165",4554,"31.192.109.161",80,10,1035,5,540,5,495,89419.850696,0.26116100000217557,16541.520364694625,15163.060334303405
"147.32.84.165",4563,"173.192.170.88",80,11,1099,6,542,5,557,89419.850828,51.317342000009376,84.49385394900632,86.83224474095299
"147.32.84.165",4561,"46.4.36.120",443,6,366,3,186,3,180,89419.930593,1.0424400000047171,1427.4202831753066,1381.3744675890064
"147.32.84.165",4597,"217.163.21.37",80,13,6078,6,750,7,5328,89420.051559,0.19644400000106543,30543.055527109296,216977.86646458443
"147.32.84.165",3700,"98.139.175.224",25,3,186,3,186,0,0,89420.097436,8.977559999999357,165.7465948431541,0
"147.32.84.165",4618,"218.93.203.210",6667,2,124,2,124,0,0,89420.973273,2.9845860000059474,332.37440636591583,0
"147.32.84.165",4612,"217.163.21.37",80,10,1449,5,700,5,749,89421.647514,0.1397280000091996,40077.865564749365,42883.31615428182
"147.32.84.165",3702,"98.139.175.225",25,3,186,3,186,0,0,89421.693422,8.987886000002618,165.55617194071738,0
"147.32.84.165",4660,"46.4.36.120",443,6,366,3,186,3,180,89422.249851,1.0301949999993667,1444.386742316663,1397.7936215967707
"147.32.84.165",4629,"184.82.147.251",80,10,1925,5,990,5,935,89422.550107,0.3471969999955036,22811.257010004607,21543.96495389324
"147.32.84.165",3703,"74.6.136.65",25,3,186,3,186,0,0,89422.664793,9.020374999992782,164.95988248838776,0
"147.32.84.165",4636,"217.163.21.36",80,12,4318,6,2629,6,1689,89423.280268,0.27642399999604095,76086.01279303254,48881.42853078432
"147.32.84.165",3708,"98.129.185.3",25,3,186,3,186,0,0,89423.326373,8.961066999996547,166.0516543398876,0
"147.32.84.165",4716,"46.4.36.120",443,6,366,3,186,3,180,89427.771564,1.0302930000034394,1444.2493543050691,1397.6606654565187
"147.32.84.165",4679,"184.82.147.252",80,10,1514,5,603,5,911,89428.802098,0.36050199999590404,13381.34046428261,20216.254001594458
"147.32.84.165",3709,"64.18.7.11",25,3,186,3,186,0,0,89428.921831,8.983259000000544,165.64144482530338,0
"147.32.84.165",4683,"217.163.21.37",80,10,2275,5,1155,5,1120,89429.577032,0.14004399999976158,65979.2636601049,63979.89203404111
"147.32.84.165",3714,"64.12.90.66",25,3,186,3,186,0,0,89429.623055,8.984846999999718,165.6121690219151,0
"147.32.84.165",4790,"77.89.69.181",6667,2,124,2,124,0,0,89433.59177,3.0094090000056894,329.6328282390744,0
"147.32.84.165",4780,"46.4.36.120",443,6,366,3,186,3,180,89433.591878,1.0302389999997104,1444.325054672186,1397.733923876309
"147.32.84.165",4776,"217.163.21.37",80,13,6077,6,749,7,5328,89434.622352,0.18643699999665841,32139.54311701753,228624.14649862403
"147.32.84.165",3716,"64.12.90.97",25,3,186,3,186,0,0,89434.668308,8.956105000004754,166.14365284900188,0
"147.32.84.165",4834,"74.125.39.27",25,3,186,3,186,0,0,89437.303402,8.929792999988422,166.63320191206327,0
"147.32.84.165",4778,"217.163.21.36",80,14,6618,7,3144,7,3474,89439.008877,0.21392300000297837,117575.01530760984,129915.90431890475
"147.32.84.165",3718,"64.12.90.98",25,3,186,3,186,0,0,89439.054883,8.882968999998411,167.5115606054987,0
"147.32.84.165",4826,"212.117.171.138",65500,200,169589,102,6879,98,162710,89441.11547,101.03670099998999,544.6733657703793,12883.23932904469
"147.32.84.165",4850,"46.4.36.120",443,6,366,3,186,3,180,89441.115612,1.0308420000073966,1443.4801841497758,1396.9163072417186
"147.32.84.165",4794,"184.82.147.251",80,10,1925,5,990,5,935,89442.146677,0.34319800000230316,23077.057558455614,21794.99880520808
"147.32.84.165",3719,"67.231.144.15",25,3,186,3,186,0,0,89442.260109,9.097564000010607,163.56026734170433,0
"147.32.84.165",4868,"205.188.186.167",587,49,13580,22,11078,27,2502,89442.720929,8.699721999990288,10186.992182060409,2300.763173814329
"147.32.84.165",4835,"217.163.21.37",80,10,1448,5,699,5,749,89442.83846,0.1399820000078762,39947.99331117831,42805.50356233555
"147.32.84.165",3720,"98.139.175.224",25,3,186,3,186,0,0,89442.885404,8.867343999998411,167.80672995208786,0
"147.32.84.165",4904,"80.98.120.34",6667,3,184,2,124,1,60,89443.725537,0.5010999999940395,1979.6447815042898,957.8926362117531
"147.32.84.165",4984,"46.4.36.120",443,6,366,3,186,3,180,89444.327009,1.030880000005709,1443.426975003647,1396.8648145196582
"147.32.84.165",4878,"92.240.244.181",80,10,1759,6,1365,4,394,89445.358168,3.026050000000396,3608.6647609915804,1041.6219163594744
"147.32.84.165",3721,"142.20.63.50",25,3,186,3,186,0,0,89445.366696,8.995143000007374,165.42260639978488,0
"147.32.84.165",4987,"46.4.36.120",443,6,366,3,186,3,180,89447.33627,1.030960000003688,1443.3149685678175,1396.756421194662
"147.32.84.165",4879,"173.241.240.4",80,9,2194,5,1164,4,1030,89448.367505,0.0666029999993043,139813.52191488774,123718.1508353388
"147.32.84.165",3722,"98.139.175.224",25,3,186,3,186,0,0,89448.383802,8.987708000000566,165.55945075206117,0
"147.32.84.165",4929,"184.82.147.252",80,10,1515,5,603,5,912,89448.383877,0.33497799999895506,14400.945733794602,21780.534841161985
"147.32.84.165",3723,"205.188.156.193",25,3,186,3,186,0,0,89448.494346,8.977209999997285,165.75305690748573,0
"147.32.84.165",1122,"46.4.36.120",443,6,366,3,186,3,180,89449.845506,1.3749150000076042,1082.2487208240293,1047.3374717651898
"147.32.84.165",1082,"98.126.71.122",80,11,4148,7,715,4,3433,89450.547573,18.29077999999572,312.7258651627398,1501.5215316135466
"147.32.84.165",4974,"217.163.21.36",80,12,4316,6,2628,6,1688,89450.72414,0.6407619999954477,32810.93448136651,21074.907688183663
"147.32.84.165",3724,"65.55.92.136",25,3,186,3,186,0,0,89450.770052,9.009072999993805,165.1668268201427,0
"147.32.84.165",1124,"82.99.253.2",6667,2,124,2,124,0,0,89451.354455,2.8069570000079693,353.40762255965575,0
"147.32.84.165",1206,"46.4.36.120",443,6,366,3,186,3,180,89455.566015,1.030531999989762,1443.9144053894327,1397.3365213446123
"147.32.84.165",1200,"95.100.248.96",80,11,4337,6,1289,5,3048,89456.596803,12.241771000000881,842.3617791902216,1991.8686601798256
"147.32.84.165",1045,"217.163.21.37",80,14,6138,7,810,7,5328,89456.597733,0.1958909999957541,33079.62081024882,217590.39466297007
"147.32.84.165",3725,"194.90.181.145",25,3,186,3,186,0,0,89456.64363,8.95591799999238,166.14712193672005,0
"147.32.84.165",1328,"195.113.232.83",80,8,1170,5,797,3,373,89457.371386,11.467373000006774,556.0122619187703,260.21652910376577
"147.32.84.165",1123,"184.82.147.251",80,10,1925,5,994,5,931,89457.372223,0.3612529999954859,22012.273946789,20617.129823400963
"147.32.84.165",3726,"68.6.19.3",25,3,186,3,186,0,0,89457.49149,9.025622999994084,164.86396562331214,0
"147.32.84.165",1331,"46.4.36.120",443,6,366,3,186,3,180,89458.274105,1.0314919999946142,1442.5705676900736,1396.0360332484584
"147.32.84.165",1150,"217.163.21.37",80,10,2274,5,1154,5,1120,89459.305827,0.14010799999232404,65892.02615486471,63950.666632104396
"147.32.84.165",3728,"74.6.136.65",25,3,186,3,186,0,0,89459.351801,8.956684000004316,166.13291258229978,0
"147.32.84.165",1363,"66.111.4.71",25,3,186,3,186,0,0,89459.979903,9.030733999999939,164.77065983783933,0
"147.32.84.165",1326,"217.163.21.37",80,10,1449,5,700,5,749,89463.29247,0.13916799999424256,40239.13543509768,43055.87491555452
"147.32.84.165",3731,"64.12.138.161",25,3,186,3,186,0,0,89463.338364,8.983645000000251,165.63432771441418,0
"147.32.84.165",1577,"94.95.56.138",6667,6,366,3,186,3,180,89463.794116,1.2004460000025574,1239.5393045558317,1199.554165699192
"147.32.84.165",1525,"46.4.36.120",443,6,366,3,186,3,180,89464.994775,1.033809000000474,1439.3374404743213,1392.9072004590207
"147.32.84.165",1332,"184.82.147.252",80,10,1319,5,599,5,720,89466.028852,0.34601399999519344,13849.150612595347,16646.725277243157
"147.32.84.165",3732,"98.129.185.3",25,3,186,3,186,0,0,89466.142539,8.989758000010625,165.52169702435165,0
"147.32.84.165",1466,"217.163.21.36",80,14,6615,7,3143,7,3472,89466.402407,0.21682099999452475,115966.62685180377,128105.6724242643
"147.32.84.165",3733,"64.12.90.1",25,3,186,3,186,0,0,89466.448293,8.985051000010571,165.60840890032225,0
"147.32.84.165",1714,"46.4.36.120",443,6,366,3,186,3,180,89467.40574,1.0306229999987409,1443.786913354173,1397.2131419556513
"147.32.84.165",1597,"217.163.21.36",80,11,4258,6,2629,5,1629,89468.436604,0.27719799999613315,75873.56330238094,47013.32621513068
"147.32.84.165",3745,"209.85.227.27",25,3,186,3,186,0,0,89468.482456,8.858231000005617,167.9793629223551,0
"147.32.84.165",1720,"208.84.201.167",6667,2,124,2,124,0,0,89469.512391,3.0105340000009164,329.5096484542935,0
"147.32.84.165",1769,"46.4.36.120",443,6,366,3,186,3,180,89471.820416,1.0312200000043958,1442.9510676612722,1396.4042590270376
"147.32.84.165",1620,"184.82.147.251",80,10,1926,5,998,5,928,89472.851903,0.3451130000030389,23134.45161419505,21511.7946873477
"147.32.84.165",3747,"74.6.140.64",25,3,186,3,186,0,0,89472.966015,8.889381000000867,167.39073283053733,0
"147.32.84.165",1795,"173.192.170.88",80,11,1100,6,543,5,557,89477.540584,61.24010399999679,70.93390958317491,72.76277649692159
"147.32.84.165",1820,"46.4.36.120",443,6,366,3,186,3,180,89477.742016,1.0310889999964274,1443.1343948050612,1396.5816723919947
"147.32.84.165",1629,"93.184.220.20",80,13,4072,9,922,4,3150,89478.444254,69.79172199999448,105.68588635770563,361.074340593029
"147.32.84.165",3748,"205.188.156.193",25,3,186,3,186,0,0,89478.773386,9.001717000006465,165.30179742363944,0
"147.32.84.165",1939,"31.192.109.161",80,10,1035,5,540,5,495,89480.25105,0.2461499999917578,17550.274223622397,16087.751371653863
"147.32.84.165",1904,"178.137.128.94",6667,2,124,2,124,0,0,89480.32791,2.9320069999957923,338.3347993375949,0
"147.32.84.165",1923,"46.4.36.120",443,6,366,3,186,3,180,89480.952434,1.0310349999926984,1443.2099783329738,1396.6548177415875
"147.32.84.165",1643,"173.241.240.4",80,9,2194,5,1164,4,1030,89481.983731,0.06797099999675993,136999.60277830088,121228.17084334184
"147.32.84.165",3752,"98.139.175.224",25,3,186,3,186,0,0,89482.000099,8.98582100000931,165.59421782366445,0
"147.32.84.165",1940,"216.157.130.15",25,3,186,3,186,0,0,89484.262821,9.031230000007781,164.76161054460113,0
"147.32.84.165",1671,"92.240.244.181",80,10,1758,6,1364,4,394,89484.965414,2.4541489999974146,4446.347797143326,1284.3555953625148
"147.32.84.165",3754,"205.188.190.1",25,3,186,3,186,0,0,89484.973954,9.022263000006205,164.92536296037665,0
"147.32.84.165",1965,"46.4.36.120",443,6,366,3,186,3,180,89487.072113,1.1241960000043036,1323.6126084724583,1280.9154275539918
"147.32.84.165",1738,"217.163.21.37",80,10,2275,5,1155,5,1120,89487.373221,0.14080799999646842,65621.27152030954,63632.748140906224
"147.32.84.165",3758,"66.94.238.147",25,3,186,3,186,0,0,89487.419261,8.984721000000718,165.61449153511623,0
"147.32.84.165",1816,"184.82.147.252",80,10,1508,5,596,5,912,89487.506792,0.35350100000505336,13487.939213557644,20639.2626892023
"147.32.84.165",3759,"205.188.59.194",25,3,186,3,186,0,0,89487.62349,8.981297999998787,165.67761140986536,0
"147.32.84.165",2008,"202.109.187.132",6667,2,124,2,124,0,0,89488.196428,2.989902000001166,331.7834497584246,0
"147.32.84.165",2039,"46.4.36.120",443,6,366,3,186,3,180,89489.380592,1.3175590000028023,1129.3611898949764,1092.930183769332
"147.32.84.165",1945,"184.82.147.251",80,10,1925,5,990,5,935,89490.698395,0.34520799999882,22942.689624884337,21668.095756835206
"147.32.84.165",3761,"98.139.175.225",25,3,186,3,186,0,0,89490.811859,9.002546000003349,165.2865755975528,0
"147.32.84.165",2075,"46.4.36.120",443,6,366,3,186,3,180,89493.895568,1.3417959999933373,1108.9614218609897,1073.1884727686997
"147.32.84.165",1995,"217.163.21.36",80,14,6618,7,3144,7,3474,89495.000426,0.2132149999961257,117965.43395378858,130347.30202145723
"147.32.84.165",3764,"65.55.37.104",25,3,186,3,186,0,0,89495.046249,8.982571000000462,165.6541317624902,0
"147.32.84.165",1996,"217.163.21.37",80,14,6141,7,810,7,5331,89495.237514,0.18894700000237208,34295.331494644786,225714.0891332733
"147.32.84.165",3766,"74.6.136.65",25,3,186,3,186,0,0,89495.283437,8.945435000001453,166.34182686473696,0
"147.32.84.165",2208,"202.80.173.5",6667,2,124,2,124,0,0,89499.814543,3.0100579999998445,329.5617559528924,0
"147.32.84.165",2109,"46.4.36.120",443,6,366,3,186,3,180,89503.025523,1.030973000000813,1443.2967691674046,1396.7388088716818
"147.32.84.165",2047,"184.82.147.252",80,10,1515,5,603,5,912,89504.05672,0.361973000006401,13326.960850435515,20156.19949518605
"147.32.84.165",3767,"193.252.22.186",25,3,186,3,186,0,0,89504.176131,8.893028999998933,167.3220676554837,0
"147.32.84.165",2083,"173.241.240.4",80,9,2194,5,1164,4,1030,89505.042214,0.07040799999958836,132257.69798963817,117032.15543756641
"147.32.84.165",3768,"98.129.185.3",25,3,186,3,186,0,0,89505.059033,9.013827999995556,165.0796975492248,0
"147.32.84.165",2327,"46.4.36.120",443,6,366,3,186,3,180,89505.243097,1.0309430000052089,1443.338768479423,1396.7794533671836
"147.32.84.165",2101,"92.240.244.181",80,10,1759,6,1365,4,394,89505.945096,7.073722000000998,1543.7417529270247,445.5928576214269
"147.32.84.165",3769,"205.188.190.2",25,3,186,3,186,0,0,89505.953631,9.02229900000384,164.92470488944852,0
"147.32.84.165",2104,"217.163.21.37",80,10,1451,5,701,5,750,89506.274288,0.14103299999260344,39763.743239483774,42543.23456435496
"147.32.84.165",3770,"98.139.175.224",25,3,186,3,186,0,0,89506.320343,8.95570299999963,166.15111063866917,0
"147.32.84.165",2439,"61.17.216.16",6667,2,124,2,124,0,0,89508.353277,3.0103629999939585,329.52836584889957,0
"147.32.84.165",2437,"46.4.36.120",443,6,366,3,186,3,180,89508.553922,1.0305869999865536,1443.8373470841516,1397.2619487911143
"147.32.84.165",2259,"184.82.147.251",80,10,1926,5,998,5,928,89509.584698,0.3428929999936372,23284.231524551837,21651.068992769644
"147.32.84.165",3771,"209.85.227.27",25,3,186,3,186,0,0,89509.697966,8.99116399999184,165.49581344543935,0
"147.32.84.165",2472,"46.4.36.120",443,6,366,3,186,3,180,89511.765645,1.2067869999882532,1233.026209276769,1193.2511702678407
"147.32.84.165",2307,"217.163.21.37",80,13,6081,6,750,7,5331,89512.972674,0.1869929999957094,32086.762606823097,228072.70860929857
"147.32.84.165",3772,"68.1.17.3",25,3,186,3,186,0,0,89513.018515,8.981981999997515,165.66499465267373,0
"147.32.84.165",2525,"46.4.36.120",443,6,366,3,186,3,180,89514.573966,1.0318310000002384,1442.0966224116703,1395.577376527423
"147.32.84.165",2416,"217.163.21.36",80,11,4260,6,2630,5,1630,89515.606044,0.2443079999939073,86120.79833867376,53375.24763955826
"147.32.84.165",3773,"205.188.59.194",25,3,186,3,186,0,0,89515.652108,8.95797100001073,166.1090441125806,0
"147.32.84.165",2445,"184.82.147.252",80,10,1507,5,596,5,911,89515.978459,0.3358919999882346,14195.038882042472,21697.45037171257
"147.32.84.165",3774,"64.12.90.66",25,3,186,3,186,0,0,89516.088914,9.022789999988163,164.91573005710563,0
"147.32.84.165",2542,"173.192.170.88",80,10,1289,6,760,4,529,89516.178894,18.48890100000426,328.84593843617847,228.89408083255054
"147.32.84.165",2515,"217.163.21.37",80,10,1451,5,701,5,750,89516.179054,0.1394060000020545,40227.82376595951,43039.754385834
"147.32.84.165",3778,"66.250.143.7",25,3,186,3,186,0,0,89516.224883,8.987072000003536,165.57116711643286,0
"147.32.84.165",2578,"186.110.109.63",6667,2,122,1,62,1,60,89524.609953,0.4345519999915268,1141.4054014471717,1104.5858723682306
"147.32.84.165",2552,"46.4.36.120",443,6,366,3,186,3,180,89525.111839,1.0302689999953145,1444.282997942059,1397.6932238148959
"147.32.84.165",2563,"50.23.235.4",80,22,12477,11,2341,11,10136,89526.114598,10.118092000004253,1850.9418574166086,8014.159191274986
"147.32.84.165",2539,"217.163.21.37",80,10,2277,5,1156,5,1121,89526.142342,0.14019799999368843,65963.85112780736,63966.675704387584
"147.32.84.165",3787,"64.12.90.97",25,3,186,3,186,0,0,89526.188509,8.957485000006272,166.1180565749156,0
"147.32.84.165",2548,"217.163.21.37",80,14,6137,7,809,7,5328,89526.270258,0.18947599999955855,34157.36029900926,224957.25052301772
"147.32.84.165",3790,"65.55.37.88",25,3,186,3,186,0,0,89526.270317,8.975445000003674,165.7856518534057,0
"147.32.84.165",2551,"217.163.21.36",80,14,6052,7,2690,7,3362,89527.017708,0.2824359999940498,76194.25285888971,95228.65357308074
"147.32.84.165",3792,"74.6.136.65",25,3,186,3,186,0,0,89527.063651,8.88401999999769,167.49174360260184,0
"147.32.84.165",2638,"46.4.36.120",443,6,366,3,186,3,180,89527.318269,1.03186000000278,1442.056092876932,1395.538154397031
"147.32.84.165",2634,"87.248.203.253",80,44,33837,21,1638,23,32199,89528.350346,0.332431999995606,39418.58786209873,774871.2518752851
"147.32.84.165",2573,"184.82.147.251",80,10,1910,5,982,5,928,89528.366945,0.3439809999981662,22838.47072960972,21582.58741046621
"147.32.84.165",3794,"32.97.110.149",25,3,186,3,186,0,0,89528.480322,8.873250999997254,167.69501955939944,0
"147.32.84.165",2651,"188.173.49.47",6667,2,124,2,124,0,0,89530.731547,3.0094410000019707,329.6293231863826,0
"147.32.84.165",2653,"46.4.36.120",443,6,366,3,186,3,180,89534.042457,1.029830999992555,1444.89726956244,1398.2876802217163
"147.32.84.165",2641,"68.67.179.211",80,8,1620,5,656,3,964,89534.643676,1.589204999996582,3302.280070860139,4852.740835837155
"147.32.84.165",2623,"217.163.21.36",80,14,6619,7,3145,7,3474,89534.667472,0.2109550000022864,119267.14228023659,131743.7368144807
"147.32.84.165",3795,"209.85.227.27",25,3,186,3,186,0,0,89534.713441,8.861086000004434,167.9252407661155,0
"147.32.84.165",2760,"68.67.185.212",80,8,1657,5,840,3,817,89535.072488,1.159996999995201,5793.118430502666,5634.497330619855
"147.32.84.165",2625,"217.163.21.37",80,10,1448,5,699,5,749,89535.101762,0.13943399999698158,40104.995912912585,42973.73667921535
"147.32.84.165",3797,"115.178.17.183",25,3,186,3,186,0,0,89535.147849,8.928199999994831,166.6629331781167,0
"147.32.84.165",2734,"212.117.171.138",65500,220,170163,128,163267,92,6896,89536.55108,63.65994299999147,20517.391917868586,866.6046088041171
"147.32.84.165",2782,"46.4.36.120",443,6,366,3,186,3,180,89536.551206,1.0314320000034058,1442.654484246258,1396.1172428189595
"147.32.84.165",2652,"184.82.147.252",80,10,1508,5,596,5,912,89537.052849,0.3484100000059698,13685.026261927911,20940.84555516486
"147.32.84.165",3798,"205.188.146.193",25,3,186,3,186,0,0,89537.152929,9.029708000001847,164.78938189360008,0
"147.32.84.165",2776,"205.188.186.137",587,49,13575,23,11133,26,2442,89537.167758,4.867866000000504,18296.313004505624,4013.257554747394
"147.32.84.165",2758,"173.241.240.4",80,9,2195,5,1165,4,1030,89537.286085,0.0667539999994915,139617.1015979716,123438.29583339978
"147.32.84.165",3799,"64.12.138.161",25,3,186,3,186,0,0,89537.302435,8.980588999998872,165.6906913344088,0
"147.32.84.165",2762,"92.240.244.181",80,10,1760,6,1366,4,394,89537.582879,10.352037000004202,1055.6376488990104,304.48113738375554
"147.32.84.165",3800,"98.139.175.224",25,3,186,3,186,0,0,89537.591395,8.992639000003692,165.46866831854243,0
"147.32.84.165",2871,"31.192.109.161",80,10,1035,5,540,5,495,89544.678165,0.23593399999663234,18310.20539668578,16784.354946961965
"147.32.84.165",2861,"173.192.170.88",80,8,922,5,485,3,437,89544.756843,50.6175210000074,76.65329955608519,69.06699362063759
"147.32.84.165",2823,"116.72.72.149",6667,3,186,3,186,0,0,89547.085298,9.030245000001742,164.77958239225103,0
"147.32.84.165",2862,"46.4.36.120",443,6,366,3,186,3,180,89547.185786,1.0307789999933448,1443.568407980379,1397.0016851423024
"147.32.84.165",2774,"217.163.21.36",80,11,4266,6,2628,5,1638,89547.888013,0.2332440000027418,90137.366876545,56181.50949154516
"147.32.84.165",3802,"132.156.37.17",25,3,186,3,186,0,0,89547.934534,8.984614999993937,165.61644544602123,0
"147.32.84.165",2800,"184.82.147.251",80,10,1925,5,990,5,935,89547.988051,0.36208400000759866,21873.377447867875,20658.189811875214
"147.32.84.165",3803,"64.12.90.97",25,3,186,3,186,0,0,89548.10828,9.010874999992666,165.1337966625007,0
"147.32.84.165",2930,"83.148.82.159",6667,2,124,2,124,0,0,89548.216801,2.981516999992891,332.71653322867695,0
"147.32.84.165",2949,"46.4.36.120",443,6,366,3,186,3,180,89549.392696,1.030679000003147,1443.7084679084921,1397.1372270082181
"147.32.84.165",2811,"217.163.21.37",80,13,6081,6,750,7,5331,89550.423612,0.18704900000011548,32077.1562531545,228004.42664742217
"147.32.84.165",3805,"64.136.164.4",25,3,186,3,186,0,0,89550.469505,8.999756000004709,165.33781582514254,0
"147.32.84.165",2985,"46.4.36.120",443,6,366,3,186,3,180,89555.613649,1.030838999999105,1443.484385050713,1396.9203726297224
"147.32.84.165",2931,"217.163.21.37",80,10,2274,5,1154,5,1120,89556.115608,0.13953400000173133,66163.08569872181,64213.7400195567
"147.32.84.165",3806,"74.6.136.65",25,3,186,3,186,0,0,89556.161489,8.987834999992629,165.55711136232702,0
"147.32.84.165",2935,"184.82.147.252",80,10,1515,5,603,5,912,89556.644687,0.3640669999876991,13250.308322816929,20040.267314111177
"147.32.84.165",3807,"62.121.128.13",25,3,186,3,186,0,0,89556.764704,8.986699999994016,165.57802085314862,0
"147.32.84.165",3030,"80.191.187.36",6667,2,124,2,124,0,0,89558.223026,3.0104149999970105,329.5226737845065,0
"147.32.84.165",3021,"46.4.36.120",443,6,366,3,186,3,180,89558.323654,1.030574999997043,1443.85415909009,1397.2782184742805
"147.32.84.165",2973,"217.163.21.37",80,10,1451,5,701,5,750,89558.625041,0.13976499999989755,40124.49468754059,42929.20259009336
"147.32.84.165",3808,"74.125.113.27",25,3,186,3,186,0,0,89558.670994,8.886939000003622,167.4367293394715,0
"147.32.84.165",3005,"217.163.21.36",80,14,6625,7,3143,7,3482,89559.354434,0.21723500000371132,115745.62109959459,128229.79722201348
"147.32.84.165",3811,"195.14.4.101",25,3,186,3,186,0,0,89559.400457,8.85953500001051,167.95463870262208,0
"147.32.84.165",3046,"46.4.36.120",443,6,366,3,186,3,180,89564.747874,1.0308180000138236,1443.5137919400374,1396.9488309097135
"147.32.84.165",3007,"184.82.147.251",80,10,1930,5,1002,5,928,89565.778923,0.3657939999975497,21913.973438748846,20295.57619876141
"147.32.84.165",3812,"209.85.227.27",25,3,186,3,186,0,0,89565.899817,8.881309999997029,167.5428512235805,0
"147.32.84.165",3092,"217.34.4.226",6667,10,1173,5,615,5,558,89568.059125,0.5499779999954626,8945.812378023467,8116.688303962756
"147.32.84.165",3084,"46.4.36.120",443,6,366,3,186,3,180,89568.146134,1.044185999999172,1425.0334710493914,1379.0646494026369
"147.32.84.165",3020,"217.163.21.37",80,14,6141,7,810,7,5331,89568.862055,0.1901849999994738,34072.08770417188,224244.8142604201
"147.32.84.165",3814,"65.248.165.249",25,3,186,3,186,0,0,89568.908859,8.983875999998418,165.63006880329405,0
"147.32.84.165",3038,"217.163.21.36",80,11,4260,6,2630,5,1630,89569.063114,0.2949989999906393,71322.27567099423,44203.539674418476
"147.32.84.165",3815,"205.188.146.193",25,3,186,3,186,0,0,89569.109213,8.984488999994937,165.61876807916826,0
"147.32.84.165",3044,"92.240.244.181",80,10,1758,6,1364,4,394,89569.190557,8.623229000004358,1265.419253042507,365.5243296911641
"147.32.84.165",3818,"98.139.175.224",25,3,186,3,186,0,0,89569.199624,8.994047000000137,165.44276453080326,0
"147.32.84.165",3105,"46.4.36.120",443,6,366,3,186,3,180,89571.369862,1.031327999997302,1442.799962770227,1396.2580284873166
"147.32.84.165",3045,"173.241.240.4",80,9,2194,5,1164,4,1030,89572.401469,0.06735599999956321,138250.48993497813,122335.0555266559
"147.32.84.165",3819,"76.96.62.116",25,3,186,3,186,0,0,89572.418044,8.985869999989518,165.59331483782157,0
"147.32.84.165",3110,"213.111.249.148",6667,2,124,2,124,0,0,89574.780991,3.0115329999971436,329.4003419524013,0
"147.32.84.165",3116,"46.4.36.120",443,6,366,3,186,3,180,89577.09046,1.032108999992488,1441.708191684047,1395.2014758232715
"147.32.84.165",3083,"184.82.147.252",80,10,1507,5,596,5,911,89577.693286,0.3630059999995865,13134.769122288422,20076.80313826301
"147.32.84.165",3822,"205.188.59.193",25,3,186,3,186,0,0,89577.813628,9.009676000001491,165.15577252719785,0
"147.32.84.165",3094,"217.163.21.37",80,10,1451,5,701,5,750,89578.12276,0.13982599999872036,40106.99011665443,42910.47444720517
"147.32.84.165",3834,"74.6.136.65",25,3,186,3,186,0,0,89578.16912,8.95534799998859,166.15769705453053,0
"147.32.84.165",3133,"46.4.36.120",443,6,366,3,186,3,180,89579.598013,1.0306100000016158,1443.8051251178108,1397.2307662430428
"147.32.84.165",3103,"217.163.21.37",80,10,2277,5,1156,5,1121,89580.30075,0.13965800000005402,66218.90618508373,64214.0085064696
"147.32.84.165",3836,"66.94.238.147",25,3,186,3,186,0,0,89580.346744,8.984597000002395,165.61677724661476,0
"147.32.84.165",3118,"184.82.147.251",80,10,1925,5,990,5,935,89580.628858,0.352498000007472,22468.212585127058,21219.97855262
"147.32.84.165",3837,"205.188.159.42",25,3,186,3,186,0,0,89580.745253,8.987592999998014,165.56156915431404,0
"147.32.84.165",3141,"212.12.200.158",6667,6,366,3,186,3,180,89586.823442,1.059772000007797,1404.0755936079197,1358.7828325237933
"147.32.84.165",3142,"46.4.36.120",443,6,366,3,186,3,180,89587.883443,0.9744880000071134,1526.95569364542,1477.6990583665356
"147.32.84.165",3130,"217.163.21.37",80,14,6137,7,809,7,5328,89588.327839,0.18882599999778904,34274.94095132969,225731.6259439859
"147.32.84.165",3841,"204.232.236.212",25,3,186,3,186,0,0,89588.373723,9.601462000005995,154.97639838589905,0
"147.32.84.165",3132,"217.163.21.36",80,14,6052,7,2690,7,3362,89588.858201,0.3372440000093775,63811.3650632824,79752.34548057822
"147.32.84.165",3842,"209.86.93.229",25,3,186,3,186,0,0,89588.9046,9.534169999998994,156.070219012264,0
"147.32.84.165",3146,"212.117.171.138",65500,61,28144,31,25256,30,2888,89589.933233,22.518624999996973,8972.483888338083,1025.995148460579
"147.32.84.165",3166,"46.4.36.120",443,6,366,3,186,3,180,89589.933359,1.0303359999961685,1444.1890800724555,1397.602335553989
"147.32.84.165",3138,"217.163.21.36",80,14,6619,7,3145,7,3474,89590.133791,0.21637799999734852,116277.9949916734,128441.89335487231
"147.32.84.165",3843,"64.12.90.33",25,3,186,3,186,0,0,89590.179897,9.560851000002003,155.63468147340527,0
"147.32.84.165",3165,"65.55.16.187",443,169,173167,81,6292,88,166875,89590.249101,10.102057000010973,4982.74757308787,132151.30344231377
"147.32.84.165",3140,"184.82.147.252",80,10,1515,5,603,5,912,89590.411247,0.3663910000032047,13166.262271610947,19913.152888406607
"147.32.84.165",3845,"209.85.227.27",25,3,186,3,186,0,0,89590.532381,9.503615000008722,156.57199918122046,0
"147.32.84.165",3172,"86.101.54.123",6667,2,124,2,124,0,0,89590.963926,3.5456209999974817,279.781736401241,0
"147.32.84.165",3194,"46.4.36.120",443,6,366,3,186,3,180,89594.059568,2.6442620000016177,562.7278991261417,544.5753862511049
"147.32.84.165",3163,"217.163.21.37",80,10,1448,5,699,5,749,89597.541323,1.8111950000020443,3087.4643536414846,3308.3130198533217
"147.32.84.165",3846,"65.55.92.168",25,3,186,3,186,0,0,89598.409168,8.07950599999458,184.16967572039653,0
"147.32.84.165",3293,"46.4.36.120",443,6,366,3,186,3,180,89599.309965,1.1861920000083046,1254.4343580040857,1213.968733552341
"147.32.84.165",3164,"184.82.147.251",80,10,1926,5,998,5,928,89599.743949,0.5350760000001173,14921.244832506502,13874.6645336333
"147.32.84.165",3847,"68.1.17.3",25,3,186,3,186,0,0,89600.0424,8.754718999989564,169.9654780469566,0
"147.32.84.165",3168,"173.241.240.4",80,4,242,3,182,1,60,89600.496408,0.018014999994193204,80821.53763360057,26644.462956132054
"147.32.84.165",3849,"64.94.38.226",25,3,186,3,186,0,0,89600.514134,8.984831000008853,165.6124639404496,0
"147.32.84.165",3170,"217.163.21.37",80,13,6081,6,750,7,5331,89601.271375,0.18751899999915622,31996.757662034237,227432.95346173935
"147.32.84.165",3852,"74.6.136.65",25,3,186,3,186,0,0,89601.317625,8.984139000007417,165.62522017955996,0
"147.32.84.165",3479,"222.85.179.42",6667,2,124,2,124,0,0,89601.672366,3.01009100000374,329.55814292616645,0
"147.32.84.165",3487,"46.4.36.120",443,6,366,3,186,3,180,89607.894503,1.0293410000012955,1445.5850879330826,1398.9533109029833
"147.32.84.165",3315,"217.163.21.36",80,11,4266,6,2628,5,1638,89608.92409,0.24218600000313018,86809.31185009981,54107.17382437728
"147.32.84.165",3853,"98.139.175.225",25,3,186,3,186,0,0,89608.96996,8.957943999994313,166.10954477957716,0
"147.32.84.165",3500,"31.192.109.161",80,10,1035,5,540,5,495,89609.298126,0.23815400000603404,18139.523165223112,16627.896234787855
"147.32.84.165",3481,"212.117.171.138",65500,30,5298,16,3556,14,1742,89609.375414,13.631119000012404,2086.9893366769165,1022.3665423203566
"147.32.84.165",3410,"184.82.147.252",80,10,1508,5,596,5,912,89609.375474,0.3613150000019232,13196.241506648274,20192.906466549037
"147.32.84.165",3854,"205.188.146.194",25,3,186,3,186,0,0,89609.495653,8.934238000001642,166.55029785413447,0
"147.32.84.165",3485,"65.54.234.75",443,38,30696,22,2404,16,28292,89609.799463,2.8059289999946486,6854.057960852423,80663.48079385888
"147.32.84.165",3519,"46.4.36.120",443,6,366,3,186,3,180,89609.9631,0.968845000010333,1535.8493876565706,1486.3058590224875
"147.32.84.165",3483,"217.163.21.37",80,10,1451,5,701,5,750,89610.932184,0.14143599999079015,39650.4426055967,42422.01419999647
"147.32.84.165",3856,"98.139.175.224",25,3,186,3,186,0,0,89610.978408,8.95565699999861,166.15196406028403,0
"147.32.84.165",3529,"119.63.45.53",6667,2,124,2,124,0,0,89611.104813,3.0111270000052173,329.4447560658455,0
"147.32.84.165",3511,"184.82.147.251",80,10,1925,5,990,5,935,89611.52672,1.0289730000076815,7696.994964825,7269.384133445834
"147.32.84.165",3859,"64.12.90.1",25,3,186,3,186,0,0,89612.083893,8.552525999999489,173.9836862232385,0
"147.32.84.165",3535,"46.4.36.120",443,6,366,3,186,3,180,89617.927781,1.030201000001398,1444.3783300520781,1397.7854806955595
"147.32.84.165",3514,"217.163.21.37",80,10,2274,5,1154,5,1120,89618.529272,0.1391940000030445,66324.6979021946,64370.59068497223
"147.32.84.165",3867,"194.79.77.130",25,3,186,3,186,0,0,89618.575118,8.995846000005258,165.40967908956316,0
"147.32.84.165",3538,"212.117.171.138",65500,86,50561,44,3399,42,47162,89618.958236,29.793058999988716,912.695806093973,12663.889263608107
"147.32.84.165",3532,"217.163.21.37",80,13,6081,6,750,7,5331,89618.958296,0.1932939999969676,31040.797955933074,220637.9918707723
"147.32.84.165",3868,"65.55.37.72",25,3,186,3,186,0,0,89619.004148,8.967803999999887,165.92690919650101,0
"147.32.84.165",3565,"184.82.155.107",80,10,1865,5,957,5,908,89620.837048,0.3343440000026021,22898.571530939436,21726.126384632193
"147.32.84.165",3551,"74.125.235.48",443,18,4570,9,1438,9,3132,89620.947303,2.3763330000074347,4841.072358109746,10543.976791098557
"147.32.84.165",3557,"46.4.36.120",443,6,366,3,186,3,180,89621.287585,0.9821709999960149,1515.0111335053036,1466.1398066180357
"147.32.84.165",3533,"217.163.21.36",80,14,6048,7,2690,7,3358,89621.539126,0.2987460000003921,72034.43728107408,89922.54289585381
"147.32.84.165",3869,"64.12.90.33",25,3,186,3,186,0,0,89621.585001,8.982636999993701,165.65291461750525,0
"147.32.84.165",3575,"184.82.155.108",80,10,1469,5,581,5,888,89622.269944,0.435274000003119,10678.331349831817,16320.75428339183
"147.32.84.165",3552,"217.163.21.36",80,14,6615,7,3143,7,3472,89622.342479,0.24383300000044983,103119.75819496793,113914.03132450799
"147.32.84.165",3871,"81.246.116.94",25,3,186,3,186,0,0,89622.388419,8.880755000005593,167.55332176138887,0
"147.32.84.165",3571,"117.197.182.9",6667,2,124,2,124,0,0,89622.457242,2.8957359999913024,342.57266546500773,0
"147.32.84.165",3587,"46.4.36.120",443,6,366,3,186,3,180,89627.470748,1.0285319999966305,1446.7221243528395,1400.0536687285544
"147.32.84.165",3873,"66.94.238.147",25,3,186,3,186,0,0,89628.499557,8.890182999995886,167.37563220022452,0
"147.32.84.165",3594,"217.163.21.37",80,16,8087,8,2723,8,5364,89629.9744,0.1957330000004731,111294.46746306114,219237.43058092543
"147.32.84.165",3572,"212.117.171.138",65500,34,8801,18,6873,16,1928,89630.021657,15.643405999988317,3514.8355799268434,985.9745377708358
"147.32.84.165",3591,"94.100.176.20",25,3,186,3,186,0,0,89630.021689,8.873621999999159,167.68800834655127,0
"147.32.84.165",3875,"68.1.17.3",25,3,186,3,186,0,0,89630.467024,8.930468999998993,166.62058845959464,0
"147.32.84.165",3608,"184.82.155.107",80,10,1905,5,977,5,928,89631.87079,0.3661169999977574,21348.36677905663,20277.670799349595
"147.32.84.165",3581,"64.12.168.40",587,48,15447,23,13065,25,2382,89631.991804,16.79708999999275,6222.506398432414,1134.4822228140843
"147.32.84.165",3611,"46.4.36.120",443,6,366,3,186,3,180,89632.109808,0.9927109999989625,1498.925669204386,1450.573228262309
"147.32.84.165",3877,"98.139.175.224",25,3,186,3,186,0,0,89632.57378,9.030736000000616,164.77062334674588,0
"147.32.84.165",3617,"217.163.21.37",80,13,5742,7,2665,6,3077,89633.102714,0.27100600000994746,78669.8449451947,90831.93729694713
"147.32.84.165",3619,"58.143.125.236",6667,6,366,3,186,3,180,89633.148694,1.8517739999952028,803.5537814030517,777.6326916803727
"147.32.84.165",3643,"46.4.36.120",443,6,366,3,186,3,180,89635.000656,1.0123849999945378,1469.7965694948348,1422.3837769304853
"147.32.84.165",3878,"194.78.113.90",25,3,186,3,186,0,0,89636.013276,9.00174400000833,165.30130161428974,0
"147.32.84.165",3626,"184.82.155.108",80,10,1507,5,596,5,911,89637.891546,0.343271999998251,13889.859936214703,21230.97718438187
"147.32.84.165",3647,"46.4.36.120",443,6,366,3,186,3,180,89638.004806,1.018674999999348,1460.7210346783345,1413.601001301614
"147.32.84.165",3880,"64.12.90.98",25,3,186,3,186,0,0,89639.023712,9.010666000001947,165.13762689679967,0
"147.32.84.165",3634,"195.113.232.96",80,27,30486,17,1714,10,28772,89639.497927,64.18609999999171,213.62880748326774,3586.0723739256587
"147.32.84.165",3623,"212.117.171.138",65500,86,82310,39,2342,47,79968,89639.498784,10.078951000003144,1858.9236121888237,63473.27216887952
"147.32.84.165",3882,"209.85.227.27",25,3,186,3,186,0,0,89639.498867,9.242828999995254,160.9896710196374,0
"147.32.84.165",3655,"217.163.21.36",80,13,6074,6,749,7,5325,89639.8987,0.18735300000116695,31982.40754064615,227378.26455799834
"147.32.84.165",3654,"61.167.116.133",6667,11,1225,6,667,5,558,89639.944787,4.903158999994048,1088.2779856836128,910.4334572885397
"147.32.84.165",3663,"46.4.36.120",443,6,366,3,186,3,180,89642.607668,1.030655000009574,1443.7420863297395,1397.169760964264
"147.32.84.165",3883,"75.180.132.243",25,3,186,3,186,0,0,89643.309323,9.041334000008646,164.57748380920083,0
"147.32.84.165",3664,"217.163.21.36",80,10,1446,5,698,5,748,89643.355406,0.13878500000282656,40234.89570116564,43117.05155368467
"147.32.84.165",3657,"74.125.235.50",443,24,8187,11,1624,13,6563,89643.401215,2.5551919999998063,5084.549419378655,20547.966649865833
"147.32.84.165",3884,"74.6.136.65",25,3,186,3,186,0,0,89643.638611,9.012975000005099,165.09532091225796,0
"147.32.84.165",3670,"184.82.155.107",80,10,1909,5,981,5,928,89643.741269,0.3472309999924619,22601.668630307704,21380.579499414423
"147.32.84.165",3885,"205.188.156.193",25,3,186,3,186,0,0,89643.85598,8.99597800000629,165.40725199627653,0
"147.32.84.165",3681,"217.163.21.37",80,11,4249,6,2622,5,1627,89649.439416,0.22913400000834372,91544.68563912896,56805.188228399245
"147.32.84.165",3685,"46.4.36.120",443,6,366,3,186,3,180,89649.485909,0.9837950000073761,1512.5102282374312,1463.719575713643
"147.32.84.165",3886,"74.125.157.27",25,3,186,3,186,0,0,89650.469948,9.007748999996693,165.19110379302825,0
"147.32.84.165",3683,"184.82.155.108",80,10,1508,5,596,5,912,89650.944916,0.36347500000556465,13117.821032882603,20072.907352330425
"147.32.84.165",3691,"212.117.171.138",65500,30,5227,16,3452,14,1775,89651.064879,33.42918999999529,826.1043716585383,424.77846456949754
"147.32.84.165",3702,"74.125.93.27",25,3,186,3,186,0,0,89651.087436,8.891342000002624,167.3538145309854,0
"147.32.84.165",3891,"216.82.254.19",25,3,186,3,186,0,0,89651.447203,8.933078000001842,166.57192515275173,0
"147.32.84.165",3699,"217.163.21.36",80,10,2272,5,1153,5,1119,89653.654557,0.13997699999890756,65896.54014639539,63953.36376740368
"147.32.84.165",3693,"87.120.166.58",6667,4,244,2,124,2,120,89653.700542,0.5089729999890551,1949.0228362237915,1886.1511318294756
"147.32.84.165",3708,"46.4.36.120",443,6,366,3,186,3,180,89657.065823,1.0315200000040932,1442.531409952396,1395.998138663609
"147.32.84.165",3901,"209.85.227.27",25,3,186,3,186,0,0,89658.097569,8.90966199999093,167.0097025006689,0
"147.32.84.165",3703,"217.163.21.36",80,13,6081,6,750,7,5331,89658.097634,0.18714499998895917,32060.70159691136,227887.46695084596
"147.32.84.165",3960,"202.80.173.5",6667,2,124,2,124,0,0,89658.143584,2.8393769999966025,349.37241514641664,0
"147.32.84.165",4049,"46.4.36.120",443,6,366,3,186,3,180,89659.978916,1.0313490000116872,1442.770584916588,1396.2295983063755
"147.32.84.165",3902,"65.55.92.168",25,3,186,3,186,0,0,89660.480678,9.03466199999093,164.69902249818463,0
"147.32.84.165",3783,"184.82.155.107",80,10,1909,5,981,5,928,89661.0105,0.3346869999950286,23448.774526995592,22181.91922635261
"147.32.84.165",3903,"205.188.59.194",25,3,186,3,186,0,0,89661.120982,8.996045000007143,165.40602008980818,0
"147.32.84.165",3825,"217.163.21.37",80,14,6609,7,3137,7,3472,89663.992292,0.20331199999782257,123435.90147295178,136617.61234111845
"147.32.84.165",4078,"46.4.36.120",443,6,366,3,186,3,180,89664.038208,0.986296000002767,1508.6748805590062,1460.0079489280704
"147.32.84.165",3905,"98.139.175.224",25,3,186,3,186,0,0,89664.293693,9.034855999998399,164.69548601552296,0
"147.32.84.165",3982,"217.163.21.36",80,10,1451,5,701,5,750,89664.594258,0.13958000000275206,40177.675884005075,42986.10115977719
"147.32.84.165",3907,"64.12.90.97",25,3,186,3,186,0,0,89664.640117,8.989327999996021,165.52961467204875,0
"147.32.84.165",4067,"184.82.155.108",80,10,1507,5,596,5,911,89664.79647,0.36646099999779835,13010.934315053022,19887.518726532388
"147.32.84.165",3908,"68.6.19.3",25,3,186,3,186,0,0,89664.91732,9.013578000012785,165.08427618842256,0
"147.32.84.165",4137,"92.240.244.181",80,10,1757,6,1363,4,394,89665.024742,6.514623000010033,1673.7729873214776,483.8345979491285
"147.32.84.165",3909,"71.74.56.243",25,3,186,3,186,0,0,89665.033412,8.998362999991514,165.36341110059723,0
"147.32.84.165",4182,"173.241.240.4",80,9,2193,5,1163,4,1030,89671.522635,0.081542999992962,114099.30957657962,101050.97924666983
"147.32.84.165",4388,"31.192.109.161",80,10,1035,5,540,5,495,89671.539189,0.2346770000003744,18408.280317172575,16874.256957408194
"147.32.84.165",4256,"46.4.36.120",443,6,366,3,186,3,180,89671.616188,1.0389580000046408,1432.2041891908561,1386.0040540556672
"147.32.84.165",3910,"165.212.65.113",25,3,186,3,186,0,0,89672.024419,9.031914999999572,164.74911466727383,0
"147.32.84.165",4212,"217.163.21.37",80,14,6052,7,2690,7,3362,89672.425499,0.28175199999532197,76379.22712299222,95459.83702137541
"147.32.84.165",4227,"212.117.171.138",65500,33,9952,15,5252,18,4700,89672.471675,15.559735000002547,2700.303057860119,2416.4935970949277
"147.32.84.165",4426,"74.125.39.27",25,3,186,3,186,0,0,89672.471739,8.986504999993485,165.58161376431423,0
"147.32.84.165",3911,"74.6.136.65",25,3,186,3,186,0,0,89672.655414,9.002872000011848,165.28059046024887,0
"147.32.84.165",4217,"217.163.21.36",80,13,6074,6,749,7,5325,89674.031651,0.1872799999982817,31994.873985769846,227466.89449162138
"147.32.84.165",4350,"83.99.172.192",6667,1,62,1,62,0,0,89674.077492,0,0,0
"147.32.84.165",4439,"46.4.36.120",443,6,366,3,186,3,180,89681.557898,1.0304750000068452,1443.9942744754753,1397.4138140085247
"147.32.84.165",4553,"173.192.170.88",80,11,4133,6,583,5,3550,89682.160154,1.4837079999997513,3143.47567041546,19141.232641466355
"147.32.84.165",3915,"98.139.175.224",25,3,186,3,186,0,0,89682.361052,8.929356000007829,166.6413568905412,0
"147.32.84.165",4387,"184.82.155.107",80,10,1909,5,981,5,928,89682.361125,0.33468500000890344,23448.91465046603,22182.051779441874
"147.32.84.165",4422,"74.125.235.51",443,18,4499,9,1471,9,3028,89682.472009,2.3379599999898346,5033.447963203463,10361.169566675788
"147.32.84.165",3917,"91.142.218.33",25,3,186,3,186,0,0,89682.588487,8.903690999999526,167.1217026736529,0
"147.32.84.165",4480,"217.163.21.36",80,10,1446,5,698,5,748,89682.811531,0.13969900000665803,39971.653338491094,42834.95228823974
"147.32.84.165",4554,"61.177.120.254",6667,10,1198,5,640,5,558,89682.857586,1.4698650000063935,3483.3130933641723,3037.013603276888
"147.32.84.165",3918,"205.178.149.7",25,3,186,3,186,0,0,89683.153643,8.839533999998821,168.33466560569804,0
"147.32.84.165",4636,"184.82.155.108",80,10,1507,5,596,5,911,89684.066943,0.3631560000067111,13129.343863000715,20068.51050200277
"147.32.84.165",4683,"46.4.36.120",443,6,366,3,186,3,180,89684.18656,1.0133119999954943,1468.4519674163698,1421.0825491126159
"147.32.84.165",3919,"205.188.59.193",25,3,186,3,186,0,0,89685.200094,8.9065649999975,167.06777528715253,0
"147.32.84.165",4679,"217.163.21.37",80,15,6108,7,2687,8,3421,89685.372098,0.3135889999975916,68548.32280521668,87273.46941445711
"147.32.84.165",3920,"209.86.93.226",25,3,186,3,186,0,0,89685.418086,8.889547999991919,167.38758821048637,0
"147.32.84.165",4716,"217.163.21.36",80,13,6077,6,749,7,5328,89685.672755,0.18772999999055173,31918.18036702483,227049.4859753115
"147.32.84.165",3921,"62.149.128.154",25,3,186,3,186,0,0,89685.718692,8.88990300000296,167.38090393106702,0
"147.32.84.165",4794,"217.163.21.36",80,10,1448,5,699,5,749,89685.97398,0.13908800001081545,40204.762449421716,43080.63959172656
"147.32.84.165",4790,"212.117.171.138",65500,35,10088,17,5372,18,4716,89686.019787,22.69245299999602,1893.8455000879603,1662.5791843661245
"147.32.84.165",3923,"64.12.90.98",25,3,186,3,186,0,0,89686.019818,8.889494999995804,167.38858619085812,0
"147.32.84.165",4850,"217.163.21.37",80,14,6045,7,2688,7,3357,89686.074051,0.2923339999979362,73559.69541740548,91867.52139740706
"147.32.84.165",4835,"65.55.16.187",443,23,9344,13,4396,10,4948,89686.119992,2.053318999998737,17127.39228537876,19278.056648783917
"147.32.84.165",4904,"46.4.36.120",443,6,366,3,186,3,180,89686.282065,1.0241749999986496,1452.8767056430415,1406.0097151384273
"147.32.84.165",3924,"146.141.15.6",25,3,186,3,186,0,0,89687.306477,8.907651000001351,167.0474067742185,0
"147.32.84.165",4964,"184.82.155.107",80,10,1909,5,981,5,928,89693.001993,0.3463670000055572,22658.04767738868,21433.91258370713
"147.32.84.165",4907,"81.214.131.58",6667,1,62,1,62,0,0,89693.11691,0,0,0
"147.32.84.165",4908,"46.4.36.120",443,6,366,3,186,3,180,89693.403456,1.0318779999943217,1442.030937773834,1395.5138107488715
"147.32.84.165",3926,"209.85.227.27",25,3,186,3,186,0,0,89693.604546,9.031256000002031,164.76113621401777,0
"147.32.84.165",1082,"184.82.155.108",80,10,1508,5,596,5,912,89694.435574,0.3619909999979427,13171.598188980106,20155.197228774927
"147.32.84.165",1122,"66.111.4.71",25,3,186,3,186,0,0,89694.552457,8.985379000005196,165.60236357299337,0
"147.32.84.165",3927,"67.231.144.228",25,3,186,3,186,0,0,89703.537974,9.029662000000826,164.79022138368677,0
"147.32.84.165",1150,"217.163.21.36",80,13,6081,6,750,7,5331,89703.637852,0.18874599999981,31788.75313917137,225954.45731323012
"147.32.84.165",1206,"46.4.36.120",443,6,366,3,186,3,180,89703.683865,0.9843649999966146,1511.6344039102542,1462.872003784117
"147.32.84.165",3928,"74.6.136.65",25,3,186,3,186,0,0,89704.039261,9.036001000000397,164.674616569867,0
"147.32.84.165",1671,"184.82.155.107",80,10,1909,5,981,5,928,89704.668471,0.33489600000029895,23434.140748151647,22168.076059413586
"147.32.84.165",1328,"212.117.171.138",65500,47,4785,22,2137,25,2648,89704.778863,55.83711000000767,306.17630461171166,379.389262803843
"147.32.84.165",3933,"205.188.156.193",25,3,186,3,186,0,0,89704.778928,8.997770999994827,165.37429103284086,0
"147.32.84.165",1738,"217.163.21.36",80,10,1451,5,701,5,750,89706.146157,0.13957300000765827,40179.69091222725,42988.25703875953
"147.32.84.165",1466,"89.103.213.96",6667,4,244,3,182,1,62,89706.192155,0.009390000006533228,155058.5728420625,52822.151187955365
"147.32.84.165",1904,"46.4.36.120",443,6,366,3,186,3,180,89706.201267,0.975549000009778,1525.2949877300737,1476.0919236097488
"147.32.84.165",3935,"130.126.121.163",25,3,186,3,186,0,0,89706.347076,9.034488999997848,164.70217629357393,0
"147.32.84.165",1816,"184.82.155.108",80,10,1508,5,596,5,912,89706.648177,0.3666959999973187,13002.596156038962,19896.590091120022
"147.32.84.165",1769,"65.55.16.187",443,23,9360,13,4412,10,4948,89706.768902,2.0838110000040615,16938.196410294026,18995.964605198285
"147.32.84.165",3936,"205.178.149.7",25,3,186,3,186,0,0,89706.930731,8.95242899999721,166.211873894835,0
"147.32.84.165",1923,"217.163.21.37",80,11,4260,6,2630,5,1630,89706.94838,0.2792020000051707,75357.62637663895,46704.53649958992
"147.32.84.165",3937,"76.96.30.116",25,3,186,3,186,0,0,89706.994353,8.989268999997876,165.5307011059911,0
"147.32.84.165",1939,"217.163.21.36",80,14,6141,7,810,7,5331,89707.177069,0.2508749999979045,25829.5964127718,169997.0104647981
"147.32.84.165",1965,"61.17.216.21",6667,2,124,2,124,0,0,89707.222976,2.9362489999912214,337.8460069302589,0
"147.32.84.165",2039,"46.4.36.120",443,6,366,3,186,3,180,89708.2528,1.0307880000036675,1443.5558039041061,1396.9894876491348
"147.32.84.165",3938,"65.55.37.120",25,3,186,3,186,0,0,89709.283841,8.906719000005978,167.0648866321034,0
"147.32.84.165",1995,"217.163.21.36",80,10,2277,5,1156,5,1121,89714.679168,0.14064399999915622,65754.67136924065,63763.82924300932
"147.32.84.165",2083,"46.4.36.120",443,6,366,3,186,3,180,89714.725189,0.9848159999964992,1510.9421455432177,1462.2020763321461
"147.32.84.165",3940,"98.139.175.224",25,3,186,3,186,0,0,89715.582445,8.928951000008965,166.6489154211403,0
"147.32.84.165",1996,"217.163.21.36",80,10,1451,5,701,5,750,89715.710209,0.1418919999996433,39523.01750637173,42285.68206815806
"147.32.84.165",2401,"216.157.130.15",25,3,186,3,186,0,0,89715.756176,8.85567400000582,168.027865524298,0
"147.32.84.165",3941,"205.188.146.193",25,3,186,3,186,0,0,89723.709082,9.044437000004109,164.5210199373741,0
"147.32.84.165",2259,"184.82.155.107",80,10,1909,5,981,5,928,89724.511533,0.3430510000034701,22877.064925974897,21641.097096131198
"147.32.84.165",2472,"41.240.106.5",6667,3,186,3,186,0,0,89724.624801,9.031067000003532,164.76458429545679,0
"147.32.84.165",2439,"46.4.36.120",443,6,366,3,186,3,180,89725.022712,1.0299379999923985,1444.7471595484215,1398.1424124662144
"147.32.84.165",3942,"209.85.227.27",25,3,186,3,186,0,0,89725.725893,9.03363000000536,164.71783767977183,0
"147.32.84.165",2307,"217.163.21.37",80,14,6619,7,3145,7,3474,89726.052889,0.21711599999980535,115882.75391966762,128005.3059195311
"147.32.84.165",3943,"203.188.197.119",25,3,186,3,186,0,0,89726.098925,8.961169999995036,166.04974573641883,0
"147.32.84.165",2416,"217.163.21.37",80,14,6048,7,2690,7,3358,89727.329274,0.28539900000032503,75403.20743932351,94127.8701045533
"147.32.84.165",2573,"212.117.171.138",65500,131,100051,69,4899,62,95152,89727.375248,27.877573000005214,1405.8612634605124,27305.676860746007
"147.32.84.165",2653,"46.4.36.120",443,6,366,3,186,3,180,89727.37531,0.9936929999967106,1497.4443817204365,1449.1397242455837
"147.32.84.165",3944,"66.94.236.34",25,3,186,3,186,0,0,89727.833544,9.033787000007578,164.71497501532323,0
"147.32.84.165",2623,"184.82.155.108",80,10,1507,5,596,5,911,89727.934435,0.36603099999774713,13026.219090812927,19910.88186531976
"147.32.84.165",2651,"64.12.168.40",587,34,3982,15,2029,19,1953,89728.05444,32.65632999999798,497.05524166374494,478.4371054555416
"147.32.84.165",3945,"205.188.190.2",25,3,186,3,186,0,0,89728.17305,8.99512500000128,165.4229374244147,0
"147.32.84.165",2638,"173.241.240.4",80,9,2195,5,1165,4,1030,89728.369282,0.06456400000024587,144352.8901549549,127625.30202541077
"147.32.84.165",2652,"50.90.246.189",6667,6,366,3,186,3,180,89728.385799,1.411524000010104,1054.1797376377226,1020.1739396494089
"147.32.84.165",2776,"46.4.36.120",443,6,366,3,186,3,180,89729.797586,0.9764560000039637,1523.8781880534912,1474.72082714854
"147.32.84.165",3946,"213.165.64.100",25,3,186,3,186,0,0,89730.245315,9.033689000003505,164.71676188979083,0
"147.32.84.165",2641,"92.240.244.181",80,10,1760,6,1366,4,394,89730.774281,5.8378649999940535,1871.9172163130067,539.9234137828146
"147.32.84.165",3947,"209.104.5.188",25,3,186,3,186,0,0,89730.782826,8.9987880000117,165.35560122074943,0
"147.32.84.165",2762,"217.163.21.36",80,13,6077,6,749,7,5328,89736.566131,0.18643299999530427,32140.23268493733,228629.05172943405
"147.32.84.165",2823,"31.192.109.161",80,10,1035,5,540,5,495,89736.611962,0.2676860000065062,16138.31130464425,14793.452029257229
"147.32.84.165",2871,"61.17.216.87",6667,2,124,2,124,0,0,89736.66639,3.01368000000366,329.16567120556766,0
"147.32.84.165",2861,"46.4.36.120",443,6,366,3,186,3,180,89736.692256,1.0069000000075903,1477.8031581972223,1430.132088577957
"147.32.84.165",3952,"74.6.136.65",25,3,186,3,186,0,0,89737.699393,8.903796999991755,167.11971308435918,0
"147.32.84.165",2862,"184.82.155.107",80,10,1909,5,981,5,928,89744.696844,0.36248699999123346,21650.431602208628,20480.734482007756
"147.32.84.165",3021,"46.4.36.120",443,6,366,3,186,3,180,89744.816688,1.0117590000008931,1470.7059685149195,1423.2638404983093
"147.32.84.165",3956,"98.139.175.224",25,3,186,3,186,0,0,89745.600037,9.03036499999871,164.7773927189225,0
"147.32.84.165",3007,"217.163.21.36",80,10,1448,5,699,5,749,89745.828729,0.13938300000154413,40119.670260634724,42989.46069415652
"147.32.84.165",3044,"212.117.171.138",65500,190,160330,96,6519,94,153811,89745.874686,115.52105900000606,451.4501550751648,10651.633655816257
"147.32.84.165",3957,"69.36.172.66",25,3,186,3,186,0,0,89745.874717,9.246905000007246,160.91870739440213,0
"147.32.84.165",3110,"184.82.155.108",80,10,1508,5,596,5,912,89746.703716,0.3614899999956833,13189.853108127296,20183.130930557207
"147.32.84.165",3092,"84.229.67.56",6667,6,366,3,186,3,180,89746.823053,1.2970369999966351,1147.2301869598634,1110.2227615740612
"147.32.84.165",3132,"46.4.36.120",443,6,366,3,186,3,180,89747.005099,1.0307539999921573,1443.6034204197333,1397.035568148129
"147.32.84.165",3959,"66.94.236.34",25,3,186,3,186,0,0,89748.036096,9.00259200000437,165.28573104271277,0
"147.32.84.165",3130,"217.163.21.37",80,14,6045,7,2688,7,3357,89748.036157,0.3100940000003902,69346.71422205183,86605.99689115625
"147.32.84.165",3105,"64.12.168.40",587,45,14445,21,12123,24,2322,89748.082082,7.081656000009389,13695.101823623094,2623.115271339835
"147.32.84.165",3963,"205.188.190.2",25,3,186,3,186,0,0,89748.082141,8.956677999987733,166.13302387358775,0
"147.32.84.165",3133,"217.163.21.36",80,13,6078,6,750,7,5328,89748.082208,0.2053369999921415,29220.25743158626,207580.70879398877
"147.32.84.165",3965,"199.217.10.203",25,3,186,3,186,0,0,89748.134486,9.004532000006293,165.2501207168746,0
"147.32.84.165",3966,"209.85.227.27",25,3,186,3,186,0,0,89748.137707,9.001443000001018,165.30682913837612,0
"147.32.84.165",3138,"217.163.21.36",80,10,1449,5,700,5,749,89748.810869,0.1390100000135135,40284.87158805561,43104.812599219506
"147.32.84.165",3968,"24.248.74.41",25,3,186,3,186,0,0,89748.856807,8.98487099999329,165.61172664594864,0
"147.32.84.165",3140,"217.163.21.37",80,11,4258,6,2629,5,1629,89749.112228,0.23042100000020582,91276.4027583476,56557.34503360527
"147.32.84.165",3142,"46.4.36.120",443,6,366,3,186,3,180,89749.158697,0.9849279999907594,1510.7703304342656,1462.0358036460636
"147.32.84.165",3969,"205.188.146.193",25,3,186,3,186,0,0,89749.816173,9.027942999993684,164.82159889589923,0
"147.32.84.165",3145,"217.163.21.36",80,10,2275,5,1155,5,1120,89750.143885,0.13892100000521168,66512.62227923321,64497.0882707716
"147.32.84.165",3970,"64.12.90.34",25,3,186,3,186,0,0,89750.189667,8.955170999994152,166.16098118070238,0
"147.32.84.165",3164,"217.163.21.37",80,15,6678,7,3144,8,3534,89751.22068,0.2220190000080038,113287.60150749833,127340.45283953533
"147.32.84.165",3168,"111.92.142.42",6667,2,124,2,124,0,0,89751.27225,2.9575330000079703,335.4146851437758,0
"147.32.84.165",3170,"46.4.36.120",443,6,366,3,186,3,180,89751.723787,1.0285540000040783,1446.691180039259,1400.0237226186377
"147.32.84.165",3972,"74.6.136.65",25,3,186,3,186,0,0,89752.752474,9.001198000012664,165.31132855847704,0
"147.32.84.165",3172,"173.241.240.4",80,9,2194,5,1164,4,1030,89752.752519,0.06874099999549799,135465.00633697305,119870.23756622187
"147.32.84.165",3973,"98.139.175.224",25,3,186,3,186,0,0,89752.768789,8.985016999999061,165.60903557557603,0
"147.32.84.165",3194,"92.240.244.181",80,10,1759,6,1365,4,394,89752.768826,5.0333580000005895,2169.525791727654,626.2220966598503
"147.32.84.165",3974,"130.126.121.163",25,3,186,3,186,0,0,89752.777155,8.976701999999932,165.7624370286561,0
"147.32.84.165",3293,"184.82.155.107",80,10,1909,5,981,5,928,89758.643527,0.3634100000053877,21595.443163049036,20428.716875952607
"147.32.84.165",3410,"46.4.36.120",443,6,366,3,186,3,180,89758.763644,1.0108579999941867,1472.016841147379,1424.5324269168184
"147.32.84.165",3976,"82.94.250.60",25,3,186,3,186,0,0,89759.774758,9.005403999995906,165.23411942436746,0
"147.32.84.165",3511,"184.82.155.108",80,10,1508,5,596,5,912,89766.671369,0.3618080000014743,13178.260292698258,20165.391588826864
"147.32.84.165",3535,"61.17.216.26",6667,1,62,1,62,0,0,89766.790853,0,0,0
"147.32.84.165",3533,"46.4.36.120",443,6,366,3,186,3,180,89766.872111,1.0306489999929909,1443.750491205172,1397.1778947146827
"147.32.84.165",3977,"209.85.227.27",25,3,186,3,186,0,0,89767.875157,8.9313589999947,166.60398490318025,0
"147.32.84.165",3557,"184.82.155.107",80,10,1920,5,989,5,931,89767.875288,0.3429770000075223,23068.6022672846,21715.74187142767
"147.32.84.165",3978,"205.188.103.2",25,3,186,3,186,0,0,89767.902965,8.903682000003755,167.12187160316063,0
"147.32.84.165",3565,"217.163.21.36",80,14,6141,7,810,7,5331,89767.988471,0.18860699998913333,34357.15535676485,226120.98173693015
"147.32.84.165",3980,"74.6.136.65",25,3,186,3,186,0,0,89768.034348,8.872376999992412,167.71153885833218,0
"147.32.84.165",3571,"184.82.155.108",80,10,1510,5,599,5,911,89769.181394,0.346071000007214,13846.86957271805,21059.262405252328
"147.32.84.165",3581,"46.4.36.120",443,6,366,3,186,3,180,89769.181537,1.0303209999983665,1444.210105396628,1397.622682641898
"147.32.84.165",3981,"64.12.90.97",25,3,186,3,186,0,0,89769.295423,8.915800999995554,166.89470749748025,0
"147.32.84.165",3572,"217.163.21.36",80,10,1451,5,701,5,750,89769.883484,0.13934799999697134,40244.567558356684,43057.668571708295
"147.32.84.165",3983,"208.65.144.3",25,3,186,3,186,0,0,89769.929381,8.883387000008952,167.50367849543204,0
"147.32.84.165",3587,"217.163.21.36",80,13,6077,6,749,7,5328,89770.21212,0.18647100000816863,32133.682984150415,228582.46053344914
"147.32.84.165",3984,"205.188.159.42",25,3,186,3,186,0,0,89770.257997,8.855497000011383,168.03122399545586,0
"147.32.84.165",3591,"217.163.21.37",80,11,4260,6,2630,5,1630,89770.887164,0.23452300000644755,89714.01525403293,55602.222381777065
"147.32.84.165",3985,"68.1.17.3",25,3,186,3,186,0,0,89770.933021,8.984486000001198,165.61882338063654,0
"147.32.84.165",3608,"217.163.21.36",80,10,1448,5,699,5,749,89771.1876,0.13925999999628402,40155.105559020645,43027.43070630396
"147.32.84.165",3622,"59.99.153.96",6667,2,124,2,124,0,0,89771.23346,2.8640489999961574,346.3627891845883,0
"147.32.84.165",3623,"46.4.36.120",443,6,366,3,186,3,180,89773.796663,1.0311689999944065,1443.0224337698976,1396.4733230031268
"147.32.84.165",3986,"67.195.168.31",25,3,186,3,186,0,0,89774.828079,9.002321000007214,165.29070669650721,0
"147.32.84.165",3619,"217.163.21.36",80,10,2277,5,1156,5,1121,89777.909583,0.14003399999637622,66041.10430494964,64041.58990125307
"147.32.84.165",3670,"46.4.36.120",443,6,366,3,186,3,180,89777.955736,0.9850020000012591,1510.6568311517112,1461.9259656306883
"147.32.84.165",3987,"66.234.224.28",25,3,186,3,186,0,0,89778.941003,9.004379999998491,165.2529102503725,0
"147.32.84.165",3626,"217.163.21.37",80,14,6055,7,2688,7,3367,89780.720142,0.2750779999914812,78174.19059563451,97921.31686588594
"147.32.84.165",3693,"46.4.36.120",443,6,366,3,186,3,180,89780.766026,0.9850420000002487,1510.5954872986374,1461.8666006115845
"147.32.84.165",3988,"209.85.227.27",25,3,186,3,186,0,0,89781.751618,9.003638000009232,165.26652892958094,0
"147.32.84.165",3681,"184.82.155.107",80,10,1916,5,985,5,931,89787.945259,0.36372199999459554,21664.89791686257,20477.177624973658
"147.32.84.165",3702,"79.113.153.241",6667,1,62,1,62,0,0,89788.064837,0,0,0
"147.32.84.165",3718,"46.4.36.120",443,6,366,3,186,3,180,89788.847808,1.03045399999246,1444.0237021845594,1397.4422924366704
"147.32.84.165",3989,"118.23.178.141",25,3,186,3,186,0,0,89788.948374,9.03042500000447,164.77629790394843,0
"147.32.84.165",3685,"217.163.21.37",80,14,6619,7,3145,7,3474,89789.878503,0.21012200000404846,119739.96059201434,132266.01688288007
"147.32.84.165",3990,"74.6.136.65",25,3,186,3,186,0,0,89789.924447,8.957399999999325,166.11963292921072,0
"147.32.84.165",3726,"184.82.155.108",80,10,1511,5,599,5,912,89790.253181,0.3531570000050124,13569.035867707526,20659.36679691029
"147.32.84.165",3991,"98.139.175.224",25,3,186,3,186,0,0,89790.36969,9.013875999997254,165.07881847947024,0
"147.32.84.165",3732,"173.241.240.4",80,9,2195,5,1165,4,1030,89790.85502,0.06716099999903236,138771.01294105628,122690.25178479654
"147.32.84.165",3992,"161.58.16.34",25,3,186,3,186,0,0,89790.871493,9.014853000000585,165.06092778217277,0
"147.32.84.165",3745,"217.163.21.36",80,13,6078,6,750,7,5328,89791.156354,0.18662699998822063,32149.68895378859,228391.39032771415
"147.32.84.165",3748,"117.207.5.248",6667,2,124,2,124,0,0,89791.202183,2.963369999997667,334.75401316770467,0
"147.32.84.165",3747,"46.4.36.120",443,6,366,3,186,3,180,89791.959279,1.030547000002116,1443.893388653739,1397.3161825681345
"147.32.84.165",3993,"64.12.90.98",25,3,186,3,186,0,0,89792.990079,9.00390399999742,165.2616465036085,0
"147.32.84.165",3752,"217.163.21.36",80,10,1449,5,700,5,749,89795.871354,0.1394469999941066,40158.62657666835,42969.730437035134
"147.32.84.165",3764,"46.4.36.120",443,6,366,3,186,3,180,89795.917185,0.9849680000043008,1510.708977340891,1461.9764296847331
"147.32.84.165",3995,"65.55.88.22",25,3,186,3,186,0,0,89796.902384,8.903195999999298,167.13099430812457,0
"147.32.84.165",3768,"217.163.21.37",80,11,4258,6,2629,5,1629,89797.978704,0.2872430000134045,73220.23512850972,45369.2518160298
"147.32.84.165",3771,"31.192.109.161",80,10,1035,5,540,5,495,89798.02471,0.2526190000062343,17100.85147947458,15675.780522851697
"147.32.84.165",3773,"46.4.36.120",443,6,366,3,186,3,180,89798.104721,1.0057490000035614,1479.4943867652178,1431.7687613856945
"147.32.84.165",3996,"67.195.168.230",25,3,186,3,186,0,0,89799.110713,8.902619999993476,167.14180769268938,0
"147.32.84.165",3770,"184.82.155.107",80,10,1916,5,985,5,931,89799.98657,0.36309100000653416,21702.54839656778,20512.7640174666
"147.32.84.165",4003,"192.52.233.80",25,3,186,3,186,0,0,89800.10594,8.910381000008783,166.9962260871374,0
"147.32.84.165",3783,"217.163.21.36",80,10,2275,5,1155,5,1120,89802.796003,0.13981900000362657,66085.43903017713,64082.849968656614
"147.32.84.165",3798,"202.95.154.126",6667,2,124,2,124,0,0,89802.842183,2.8641780000034487,346.3471893153308,0
"147.32.84.165",3794,"46.4.36.120",443,6,366,3,186,3,180,89808.013233,1.0306259999924805,1443.7827107125734,1397.2090748831354
"147.32.84.165",4005,"209.85.227.27",25,3,186,3,186,0,0,89809.044099,9.005151999997906,165.23874333274395,0
"147.32.84.165",3795,"184.82.155.108",80,10,1511,5,599,5,912,89809.919408,0.34893199999351054,13733.334862062298,20909.518187313548
"147.32.84.165",4010,"98.139.175.224",25,3,186,3,186,0,0,89810.033444,9.018570000000182,164.99289798714986,0
"147.32.84.165",3802,"217.163.21.37",80,14,6618,7,3144,7,3474,89810.033507,0.21121799999673385,119080.76016432754,131579.69491440008
"147.32.84.165",3825,"46.4.36.120",443,6,366,3,186,3,180,89810.079439,0.9717310000123689,1531.2879798844122,1481.891593436528
"147.32.84.165",4013,"66.94.236.34",25,3,186,3,186,0,0,89810.822855,9.031552999993437,164.75571809201378,0
"147.32.84.165",3815,"184.82.155.107",80,10,1921,5,993,5,928,89811.051406,0.3430919999955222,23154.13941480326,21638.510953612713
"147.32.84.165",3837,"89.37.108.104",6667,2,124,2,124,0,0,89811.164621,2.9684889999916777,334.17674783459904,0
"147.32.84.165",4014,"205.188.59.193",25,3,186,3,186,0,0,89811.324697,9.031917000000249,164.74907818572282,0
"147.32.84.165",3834,"217.163.21.36",80,13,6081,6,750,7,5331,89811.82595,0.18692000000737607,32099.293814269382,228161.78043182677
"147.32.84.165",4018,"74.6.136.65",25,3,186,3,186,0,0,89811.871882,8.985979999997653,165.59128776164522,0
"147.32.84.165",3836,"173.241.240.4",80,9,2194,5,1164,4,1030,89813.932513,0.06880999999702908,135329.16727804174,119750.03633709879
"147.32.84.165",3845,"46.4.36.120",443,6,366,3,186,3,180,89813.949056,1.0144339999969816,1466.8278074319546,1419.5107813857626
"147.32.84.165",4020,"64.12.139.193",25,3,186,3,186,0,0,89814.963708,9.005201000007219,165.23784421900268,0
"147.32.84.165",3841,"184.82.155.108",80,10,1507,5,596,5,911,89817.84851,0.36165900000196416,13183.689608095208,20151.57924995761
"147.32.84.165",3867,"46.4.36.120",443,6,366,3,186,3,180,89817.967814,1.0116060000000289,1470.928404932313,1423.4791015473998
"147.32.84.165",3849,"174.133.57.141",80,9,1177,5,654,4,523,89818.049128,0.57375100000354,9118.938354735275,7292.362017624693
"147.32.84.165",4022,"66.94.238.147",25,3,186,3,186,0,0,89818.216199,8.9628720000037,166.01821380461374,0
"147.32.84.165",3843,"217.163.21.36",80,10,1451,5,701,5,750,89818.979529,0.13916500000050291,40297.48859253213,43114.288793721964
"147.32.84.165",4023,"98.139.175.224",25,3,186,3,186,0,0,89819.025523,8.956208000003244,166.14174213009133,0
"147.32.84.165",3869,"217.163.21.36",80,14,6134,7,809,7,5325,89820.055149,0.18872099999862257,34294.01073567455,225730.04594248085
"147.32.84.165",3883,"46.4.36.120",443,6,366,3,186,3,180,89820.101125,0.9852430000028107,1510.2873098268701,1461.568364348584
"147.32.84.165",4024,"209.85.227.27",25,3,186,3,186,0,0,89821.059157,9.029552000007243,164.7922288945018,0
"147.32.84.165",3875,"217.163.21.37",80,12,4330,6,2630,6,1700,89821.059213,0.2471430000005057,85132.89876693634,55028.86992539611
"147.32.84.165",4025,"193.252.22.186",25,3,186,3,186,0,0,89821.086603,9.002166999998735,165.2935343234811,0
"147.32.84.165",3877,"184.82.155.107",80,10,1909,5,981,5,928,89821.105052,0.3357030000042869,23377.80716853821,22114.78598614012
"147.32.84.165",3886,"119.154.183.214",6667,6,366,3,186,3,180,89821.215584,9.155320999998366,162.5284356496365,157.28558288674498
"147.32.84.165",3905,"46.4.36.120",443,6,366,3,186,3,180,89828.081883,1.0311059999949066,1443.1106016329556,1396.5586467415699
"147.32.84.165",4026,"65.54.188.94",25,3,186,3,186,0,0,89829.113248,8.902398000005633,167.14597572463717,0
"147.32.84.165",3884,"217.163.21.36",80,10,1446,5,698,5,748,89830.088803,0.13933900000120047,40074.92518212339,42945.621828407304
"147.32.84.165",4212,"46.4.36.120",443,6,366,3,186,3,180,89830.13459,0.9854400000040187,1509.9853872320302,1461.2761811922874
"147.32.84.165",4029,"205.188.59.194",25,3,186,3,186,0,0,89831.120272,8.902220000003581,167.1493178105463,0
"147.32.84.165",3891,"217.163.21.36",80,10,2277,5,1156,5,1121,89831.895306,0.14026399998692796,65932.81241702702,63936.57674696131
"147.32.84.165",3909,"212.117.171.138",65500,119,84737,61,4419,58,80318,89831.9411,126.30403400000068,279.8960482924861,5087.28011015069
"147.32.84.165",4030,"64.12.90.33",25,3,186,3,186,0,0,89831.941159,8.883325000002515,167.50484756547564,0
"147.32.84.165",3902,"184.82.155.108",80,10,1508,5,596,5,912,89832.398077,0.3351949999923818,14224.555855870063,21766.434464015936
"147.32.84.165",4221,"64.12.175.136",587,52,15875,25,13373,27,2502,89832.508521,28.75207100000989,3720.91457342197,696.1585480222665
"147.32.84.165",4388,"46.4.36.120",443,6,366,3,186,3,180,89832.626757,1.0022469999967143,1484.6639600865637,1436.7715742773196
"147.32.84.165",4031,"4.78.154.138",25,3,186,3,186,0,0,89832.899104,9.028627000006963,164.809112171635,0
"147.32.84.165",4182,"184.82.155.107",80,10,1920,5,989,5,931,89833.629265,0.3652040000015404,21664.60389252754,20394.081116221576
"147.32.84.165",4256,"94.248.9.208",6667,2,124,2,124,0,0,89833.749993,2.861848000000464,346.62917108100754,0
"147.32.84.165",4553,"46.4.36.120",443,6,366,3,186,3,180,89836.009123,1.0310830000089481,1443.142792565765,1396.5897992571918
"147.32.84.165",4033,"64.12.90.66",25,3,186,3,186,0,0,89837.040408,9.001485000000685,165.3060578337782,0
"147.32.84.165",4217,"217.163.21.37",80,14,6048,7,2687,7,3361,89838.116136,0.3075600000011036,69892.05358278991,87423.59214430848
"147.32.84.165",4716,"46.4.36.120",443,6,366,3,186,3,180,89838.161956,0.9847480000025826,1511.0464809231373,1462.303046054649
"147.32.84.165",4035,"68.1.17.3",25,3,186,3,186,0,0,89839.11921,9.029956999991555,164.7848378460043,0
"147.32.84.165",4387,"217.163.21.37",80,14,6619,7,3145,7,3474,89839.146922,0.21276700000453275,118251.42056552,130621.75995059349
"147.32.84.165",4038,"74.6.136.65",25,3,186,3,186,0,0,89839.19293,8.956269000002067,166.14061056000625,0
"147.32.84.165",4439,"217.163.21.36",80,13,6078,6,750,7,5328,89839.921905,0.18624300000374205,32215.975901802733,228862.2928064066
"147.32.84.165",4039,"205.188.190.2",25,3,186,3,186,0,0,89839.967738,8.984371999991708,165.62092486835732,0
"147.32.84.165",4480,"184.82.155.108",80,10,1511,5,599,5,912,89842.028791,0.3536630000016885,13549.622097808144,20629.808603006724
"147.32.84.165",4879,"200.53.110.7",6667,2,124,2,124,0,0,89842.145199,2.9933359999995446,331.40282280377176,0
"147.32.84.165",4850,"46.4.36.120",443,6,366,3,186,3,180,89848.149074,1.0309120000019902,1443.38217034735,1396.821455174855
"147.32.84.165",4042,"68.232.1.54",25,3,186,3,186,0,0,89849.180207,9.003416000006837,165.27060395730578,0
"147.32.84.165",4797,"173.241.240.4",80,9,2195,5,1165,4,1030,89850.054848,0.06721999999717809,138649.2115500038,122582.56471802911
"147.32.84.165",4045,"205.188.103.2",25,3,186,3,186,0,0,89850.071383,9.014205999992555,165.07277512863905,0
"147.32.84.165",4826,"92.240.244.181",80,10,1760,6,1366,4,394,89852.062705,7.198441000000457,1518.1064900023916,437.8725893564731
"147.32.84.165",1816,"222.23.80.7",6667,2,124,2,124,0,0,89852.071234,3.0010550000006333,330.55042310113964,0
"147.32.84.165",1671,"46.4.36.120",443,6,366,3,186,3,180,89852.865061,1.0310299999982817,1443.216977199965,1396.6615908386757
"147.32.84.165",4046,"194.116.198.18",25,3,186,3,186,0,0,89853.896349,9.003205999993952,165.27445889841903,0
"147.32.84.165",4835,"217.163.21.36",80,10,1449,5,700,5,749,89853.968181,0.13942399999359623,40165.2513215602,42976.818914069416
"147.32.84.165",4048,"64.12.90.97",25,3,186,3,186,0,0,89854.014116,8.985003999987384,165.60927518808998,0
"147.32.84.165",4904,"184.82.155.107",80,10,1921,5,993,5,928,89858.082797,0.361562000005506,21971.335482929695,20533.131246886966
"147.32.84.165",2401,"31.192.109.161",80,10,1273,5,540,5,733,89858.183499,0.24389099999098107,17712.83073241633,24043.5276423355
"147.32.84.165",1996,"46.4.36.120",443,6,366,3,186,3,180,89858.202366,1.0113839999976335,1471.251275483379,1423.791556919399
"147.32.84.165",4051,"202.162.96.13",25,3,186,3,186,0,0,89858.263262,8.949630000002799,166.26385671804698,0
"147.32.84.165",4974,"217.163.21.36",80,13,6081,6,750,7,5331,89859.213989,0.187528000009479,31995.222045223738,227422.03829745034
"147.32.84.165",2259,"94.100.176.20",25,3,186,3,186,0,0,89859.260848,8.85464299999876,168.04743003192883,0
"147.32.84.165",4053,"216.163.188.54",25,3,186,3,186,0,0,89860.190105,8.928923999992548,166.64941934786788,0
"147.32.84.165",1965,"217.163.21.37",80,14,6039,7,2689,7,3350,89860.190238,0.33429199999955017,64350.92673479756,80169.43271162955
"147.32.84.165",2573,"46.4.36.120",443,6,366,3,186,3,180,89860.236441,1.1899209999974119,1250.5031846679203,1210.1643722592778
"147.32.84.165",4054,"64.12.90.1",25,3,186,3,186,0,0,89861.203745,8.717467999988003,170.69176508615206,0
"147.32.84.165",2416,"184.82.155.108",80,10,1507,5,596,5,911,89861.42661,0.36342200000945013,13119.734082900917,20053.821727387138
"147.32.84.165",2638,"121.130.190.26",6667,2,124,2,124,0,0,89861.546552,2.958637000003364,335.28952690001245,0
"147.32.84.165",2762,"46.4.36.120",443,6,366,3,186,3,180,89867.714688,1.0305200000002515,1443.9312191899594,1397.3527927644768
"147.32.84.165",4055,"203.127.83.175",25,3,186,3,186,0,0,89868.745464,9.00398999999743,165.260068036551,0
"147.32.84.165",2563,"217.163.21.36",80,10,1451,5,701,5,750,89870.122149,0.14069000000017695,39860.68661591404,42646.95429662701
"147.32.84.165",3092,"46.4.36.120",443,6,366,3,186,3,180,89870.168156,0.9841489999962505,1511.9661758592135,1463.1930734121422
"147.32.84.165",4057,"74.6.136.65",25,3,186,3,186,0,0,89871.025103,9.031643999987864,164.75405806539757,0
"147.32.84.165",2641,"217.163.21.36",80,15,6197,7,809,8,5388,89871.152581,0.18845600000349805,34342.23373031301,228721.82365751115
"147.32.84.165",3132,"94.248.9.208",6667,2,124,2,124,0,0,89871.198678,2.9369799999985844,337.76191870577196,0
"147.32.84.165",3142,"46.4.36.120",443,6,366,3,186,3,180,89874.839868,1.029714000003878,1445.0614442402414,1398.446558942169
"147.32.84.165",4058,"98.139.175.224",25,3,186,3,186,0,0,89874.939116,9.031380000000354,164.75887405910743,0
"147.32.84.165",2862,"184.82.155.107",80,10,1893,5,981,5,912,89875.869696,0.3632170000055339,21606.918178060027,20087.165523334093
"147.32.84.165",4059,"209.85.227.27",25,3,186,3,186,0,0,89875.989899,8.983833000005689,165.63086157089717,0
"147.32.84.165",3105,"217.163.21.37",80,11,4260,6,2630,5,1630,89877.749323,0.23045200000342447,91298.83880238552,56584.451425052626
"147.32.84.165",3194,"46.4.36.120",443,6,366,3,186,3,180,89877.795329,0.9849779999931343,1510.6936398684763,1461.961586969493
"147.32.84.165",4061,"124.108.96.211",25,3,186,3,186,0,0,89878.780551,9.003111999991233,165.27618450169774,0
"147.32.84.165",3133,"217.163.21.36",80,10,1448,5,699,5,749,89879.25447,0.13971699999819975,40023.76232006164,42886.692385874354
"147.32.84.165",4063,"198.170.105.119",25,3,186,3,186,0,0,89879.300373,8.98452699999325,165.61806759566952,0
"147.32.84.165",3168,"184.82.155.108",80,10,1305,5,584,5,721,89880.157448,0.34373999999661464,13591.668121388295,16780.12451287836
"147.32.84.165",3572,"46.4.36.120",443,6,366,3,186,3,180,89880.270621,1.0176059999939753,1462.255529162377,1415.0859959635904
"147.32.84.165",4064,"205.188.156.193",25,3,186,3,186,0,0,89881.160369,9.030659999989439,164.77201001939395,0
"147.32.84.165",3511,"217.163.21.36",80,10,2277,5,1156,5,1121,89881.288469,0.14046199999575038,65839.8712839045,63846.44957548179
"147.32.84.165",3622,"62.209.146.67",6667,2,124,2,124,0,0,89881.334607,2.937512999997125,337.70063315497526,0
"147.32.84.165",3581,"74.125.93.27",25,3,186,3,186,0,0,89881.962771,9.030630999986897,164.7725391506041,0
"147.32.84.165",4072,"64.12.90.66",25,3,186,3,186,0,0,89887.78356,9.029387000002316,164.79524025270135,0
"147.32.84.165",3571,"217.163.21.37",80,11,4256,6,2628,5,1628,89889.789765,0.2894090000045253,72644.59640049639,45002.0559132451
"147.32.84.165",3626,"46.4.36.120",443,6,366,3,186,3,180,89889.835724,0.9847569999983534,1511.0326710066422,1462.2896816193313
"147.32.84.165",4073,"209.85.143.27",25,3,186,3,186,0,0,89890.820729,8.90581199999724,167.08190112259962,0
"147.32.84.165",3591,"217.163.21.37",80,15,7649,7,2578,8,5071,89892.098119,0.18956499999330845,108796.4550456467,214005.75001414833
"147.32.84.165",3747,"84.16.230.244",6667,2,124,2,124,0,0,89892.144096,2.9622830000007525,334.87685005104106,0
"147.32.84.165",3752,"46.4.36.120",443,6,366,3,186,3,180,89896.009939,1.0315510000073118,1442.4880592326049,1395.9561863541337
"147.32.84.165",4074,"64.12.90.98",25,3,186,3,186,0,0,89897.014009,8.935913999986951,166.519060053865,0
"147.32.84.165",3670,"184.82.155.107",80,10,1909,5,981,5,928,89897.041693,0.347221999996691,22602.254465658254,21381.133684129316
"147.32.84.165",4075,"74.6.136.65",25,3,186,3,186,0,0,89897.156335,8.893510999987484,167.31299933199543,0
"147.32.84.165",3732,"217.163.21.37",80,14,6619,7,3145,7,3474,89897.81733,0.21454899999662302,117269.24851850167,129536.8424016772
"147.32.84.165",4076,"65.55.37.120",25,3,186,3,186,0,0,89897.863255,8.890111000000616,167.37698775638424,0
"147.32.84.165",3745,"217.163.21.36",80,10,2274,5,1154,5,1120,89899.726659,0.14306499999656808,64530.10869340134,62628.87498839645
"147.32.84.165",3802,"46.4.36.120",443,6,366,3,186,3,180,89899.775963,0.9811780000018189,1516.5443986689893,1467.623611615151
"147.32.84.165",4079,"64.12.90.33",25,3,186,3,186,0,0,89900.228155,9.033425000001444,164.72157570354125,0
"147.32.84.165",4080,"98.139.175.225",25,3,186,3,186,0,0,89900.757388,9.006231999999727,165.21892840424775,0
"147.32.84.165",3794,"184.82.155.108",80,10,1508,5,596,5,912,89902.13397,0.3613210000039544,13196.022373312975,20192.571148425224
"147.32.84.165",3845,"80.98.191.57",6667,2,124,2,124,0,0,89902.253188,2.994065999999293,331.32202162552,0
"147.32.84.165",3849,"46.4.36.120",443,6,366,3,186,3,180,89902.937912,1.0340720000094734,1438.9713675511648,1392.5529363398368
"147.32.84.165",4081,"212.27.48.7",25,3,186,3,186,0,0,89903.972192,9.004654999997001,165.24786346622892,0
"147.32.84.165",3798,"173.241.240.4",80,9,2195,5,1165,4,1030,89907.856674,0.06738100000075065,138317.92344868986,122289.66622502195
"147.32.84.165",3883,"74.125.39.27",25,3,186,3,186,0,0,89907.873234,9.016652000005706,165.02799486983176,0
"147.32.84.165",4082,"98.139.175.224",25,3,186,3,186,0,0,89908.760273,9.032718999995268,164.7344503909376,0
"147.32.84.165",3837,"217.163.21.37",80,14,6615,7,3143,7,3472,89911.773243,0.21425999999337364,117352.7490001756,129636.88976411379
"147.32.84.165",3920,"61.17.216.84",6667,2,124,2,124,0,0,89911.819215,2.9645500000042375,334.6207687502596,0
"147.32.84.165",3902,"46.4.36.120",443,6,366,3,186,3,180,89917.893467,1.0313210000022082,1442.8097556404011,1396.2675054584527
"147.32.84.165",4085,"203.127.83.175",25,3,186,3,186,0,0,89917.993708,9.032183000002988,164.74422628499752,0
"147.32.84.165",3843,"217.163.21.38",80,13,4932,7,2616,6,2316,89918.094204,0.24104400000942405,86822.32289201052,76865.63448696343
"147.32.84.165",4088,"76.96.30.116",25,3,186,3,186,0,0,89918.140124,8.985937999997986,165.59206173026493,0
"147.32.84.165",3875,"217.163.21.36",80,14,6141,7,810,7,5331,89918.797511,0.18956700000853743,34183.16478980077,224975.86604250362
"147.32.84.165",3940,"31.192.109.161",80,10,1273,5,540,5,733,89918.843464,0.24337399999785703,17750.45814276808,24094.603367868523
"147.32.84.165",4090,"125.206.187.30",25,3,186,3,186,0,0,89918.922479,9.006263999996008,165.21834136781462,0
"147.32.84.165",3910,"184.82.155.107",80,10,1909,5,981,5,928,89918.924922,0.36330299999099225,21601.803453851422,20434.733542481266
"147.32.84.165",4091,"205.188.103.2",25,3,186,3,186,0,0,89919.044185,8.984473999997135,165.6190445874154,0
"147.32.84.165",3924,"173.241.240.4",80,4,242,3,182,1,60,89921.306649,0.016654999999445863,87421.1948392941,28820.17412284421
"147.32.84.165",3946,"121.31.253.12",6667,2,124,2,124,0,0,89921.323021,2.9929249999986496,331.44833231719724,0
"147.32.84.165",3944,"46.4.36.120",443,6,366,3,186,3,180,89921.808177,1.0306750000017928,1443.7140708733712,1397.1426492322946
"147.32.84.165",4092,"208.65.145.1",25,3,186,3,186,0,0,89922.839106,8.901844000007259,167.15637793683945,0
"147.32.84.165",3926,"92.240.244.181",80,4,244,3,182,1,62,89925.018115,0.009025000006658956,161329.6397701621,54958.448712912366
"147.32.84.165",3957,"46.4.36.120",443,6,366,3,186,3,180,89925.026852,1.0222750000102678,1455.5770218239263,1408.6229243457353
"147.32.84.165",4094,"74.6.136.65",25,3,186,3,186,0,0,89926.049342,8.901486000002478,167.1631006328141,0
"147.32.84.165",3938,"195.113.232.96",80,86,98796,54,5688,32,93108,89927.928617,123.15281700000924,369.49215704904736,6048.290393551811
"147.32.84.165",3969,"46.4.36.120",443,6,366,3,186,3,180,89927.929506,1.0295769999938784,1445.2537304240939,1398.6326423458972
"147.32.84.165",4095,"205.188.159.42",25,3,186,3,186,0,0,89928.931643,8.9302619999944,166.62445066011873,0
"147.32.84.165",3941,"217.163.21.36",80,10,1451,5,701,5,750,89928.959305,0.13974500000767875,40130.23721558446,42935.34652166668
"147.32.84.165",3974,"66.111.4.71",25,3,186,3,186,0,0,89929.005309,8.856721000003745,168.0080020584786,0
"147.32.84.165",4098,"216.32.180.22",25,3,186,3,186,0,0,89929.734357,9.030772000012803,164.76996650982778,0
"147.32.84.165",3942,"184.82.155.108",80,10,1508,5,596,5,912,89937.962263,0.3617310000117868,13181.065487460673,20169.684101617677
"147.32.84.165",3973,"212.117.171.138",65500,47,4734,22,2137,25,2597,89938.081508,131.24478599999566,130.26041278318337,158.29962189888965
"147.32.84.165",3983,"46.4.36.120",443,6,366,3,186,3,180,89938.081568,1.0122670000127982,1469.9679037064204,1422.5495842320197
"147.32.84.165",4099,"205.188.190.2",25,3,186,3,186,0,0,89938.965698,9.031799000003957,164.75123062408144,0
"147.32.84.165",3970,"184.82.155.107",80,10,1924,5,989,5,935,89939.066273,0.35509799999999814,22281.17308461338,21064.60751679829
"147.32.84.165",3978,"64.12.175.136",587,49,15679,23,13237,26,2442,89939.094041,19.121322999999393,5538.1105167254045,1021.6866270184663
"147.32.84.165",4100,"207.115.36.23",25,3,186,3,186,0,0,89939.179642,9.018460999999661,164.99489214402058,0
"147.32.84.165",3976,"217.163.21.38",80,11,4270,6,2640,5,1630,89939.212206,0.28285600000526756,74666.96834999678,46101.19636761164
"147.32.84.165",3985,"93.116.154.250",6667,3,186,3,186,0,0,89939.258264,8.93997199999285,166.4434743197395,0
"147.32.84.165",4101,"201.2.114.148",25,3,186,3,186,0,0,89939.868718,9.032860000006622,164.73187893966133,0
"147.32.84.165",3991,"217.163.21.36",80,14,6141,7,810,7,5331,89939.969072,0.18777099999715574,34510.121371767505,227127.72473196613
"147.32.84.165",4102,"98.139.175.224",25,3,186,3,186,0,0,89940.015114,8.987019000007422,165.57214355491752,0
"147.32.84.165",3995,"184.82.155.108",80,10,1510,5,599,5,911,89943.781673,0.34804899999289773,13768.176320281871,20939.580346872764
"147.32.84.165",4013,"221.209.60.2",6667,2,124,2,124,0,0,89943.896513,2.9974550000042655,330.94742039449744,0
"147.32.84.165",4005,"46.4.36.120",443,6,366,3,186,3,180,89946.993938,1.030798000007053,1443.5417996443714,1396.9759351397142
"147.32.84.165",4105,"204.13.78.130",25,3,186,3,186,0,0,89948.02497,9.003605999998399,165.2671163087617,0
"147.32.84.165",4003,"217.163.21.36",80,10,2277,5,1156,5,1121,89949.905277,0.14073100000678096,65714.02178307832,63724.41039691246
"147.32.84.165",4212,"46.4.36.120",443,6,366,3,186,3,180,89949.905415,1.0300750000023982,1444.5550081271128,1397.956459477851
"147.32.84.165",4106,"213.123.26.151",25,3,186,3,186,0,0,89949.951255,8.985975999996299,165.59136147265616,0
"147.32.84.165",4010,"217.163.21.36",80,10,1451,5,701,5,750,89950.807609,0.13951400000951253,40196.68276744719,43006.436627083305
"147.32.84.165",4387,"216.157.130.15",25,3,186,3,186,0,0,89950.853712,8.986646999997902,165.57899737247357,0
"147.32.84.165",4108,"74.125.159.27",25,3,186,3,186,0,0,89950.935738,9.004690000001574,165.24722117027238,0
"147.32.84.165",4182,"184.82.155.107",80,10,1916,5,985,5,931,89958.161915,0.36542599998938385,21563.87339770275,20381.691505848994
"147.32.84.165",4553,"178.150.146.54",6667,3,186,3,186,0,0,89958.28264,8.883990999995149,167.49229034572554,0
"147.32.84.165",4907,"46.4.36.120",443,6,366,3,186,3,180,89960.040972,1.0310480000043754,1443.1917815598163,1396.6372079611126
"147.32.84.165",4109,"64.12.90.98",25,3,186,3,186,0,0,89960.241476,8.931815000003553,166.59547919425202,0
"147.32.84.165",4388,"217.163.21.36",80,14,6137,7,809,7,5328,89960.241609,0.19032999999762978,34004.098145749995,223947.88000068726
"147.32.84.165",4110,"209.86.93.228",25,3,186,3,186,0,0,89960.287853,8.885574999992969,167.4624320880953,0
"147.32.84.165",4426,"217.163.21.38",80,4,244,3,182,1,62,89960.843167,0.046123000007355586,31567.764450877017,10753.853823925137
"147.32.84.165",4113,"205.188.103.2",25,3,186,3,186,0,0,89960.889151,8.98601000000781,165.59073493115486,0
"147.32.84.165",4480,"217.163.21.38",80,14,6802,7,2700,7,4102,89960.944062,0.28802700000233017,74992.9694085112,113933.763153227
"147.32.84.165",4115,"98.139.175.224",25,3,186,3,186,0,0,89960.990221,8.985220999995363,165.60527559653434,0
"147.32.84.165",1965,"184.82.155.108",80,10,1510,5,599,5,911,89961.072224,0.34023099999467377,14084.548439369186,21420.740614800216
"147.32.84.165",4117,"64.29.145.47",25,3,186,3,186,0,0,89961.1828,8.994485000002896,165.43470804604385,0
"147.32.84.165",2401,"217.163.21.36",80,10,1448,5,699,5,749,89968.972378,0.14043499999388587,39819.13340864784,42667.42621327215
"147.32.84.165",2563,"61.17.216.15",6667,4,244,3,182,1,62,89969.018216,0.1888570000010077,7709.536845296871,2626.3257385077254
"147.32.84.165",2638,"46.4.36.120",443,6,366,3,186,3,180,89969.206795,0.9981549999938579,1490.7504345609211,1442.6617108654077
"147.32.84.165",4118,"205.188.156.193",25,3,186,3,186,0,0,89970.205191,9.001602999996976,165.30389087371438,0
"147.32.84.165",2573,"217.163.21.36",80,13,6077,6,749,7,5328,89970.879847,0.18696300000010524,32049.12201877712,227980.9374045988
"147.32.84.165",4121,"71.87.21.66",25,3,186,3,186,0,0,89970.925664,8.983268000010867,165.64127887514877,0
"147.32.84.165",3092,"184.82.155.107",80,10,1896,5,985,5,911,89971.78353,0.34341000000131316,22946.33237229512,21222.44547325975
"147.32.84.165",3571,"178.137.7.22",6667,6,366,3,186,3,180,89971.884555,1.0610900000028778,1402.3315647079553,1357.095062620602
"147.32.84.165",3511,"46.4.36.120",443,6,366,3,186,3,180,89971.896983,1.0171730000001844,1462.8779961714774,1415.6883833917523
"147.32.84.165",4122,"194.90.9.19",25,3,186,3,186,0,0,89972.914371,9.001514999996289,165.30550690640558,0
"147.32.84.165",3133,"217.163.21.38",80,14,6081,7,2713,7,3368,89972.945828,0.2894830000004731,74975.04171217146,93076.27736328547
"147.32.84.165",4123,"74.6.136.65",25,3,186,3,186,0,0,89972.991696,9.024520000006305,164.88411572016688,0
"147.32.84.165",3194,"217.163.21.36",80,10,1448,5,699,5,749,89979.20692,0.13981799999601208,39994.85044958086,42855.71242737634
"147.32.84.165",3798,"31.192.109.161",80,10,1273,5,540,5,733,89979.253161,0.23983000000589527,18012.759037208896,24450.652544952078
"147.32.84.165",3747,"109.87.192.82",6667,2,124,2,124,0,0,89979.333219,2.985052000003634,332.32251900428946,0
"147.32.84.165",3622,"46.4.36.120",443,6,366,3,186,3,180,89981.213295,1.0306500000006054,1443.7490903790094,1397.1765390764606
"147.32.84.165",3752,"173.192.170.88",80,41,7192,18,1305,23,5887,89981.213382,40.71236599999247,256.4331436792922,1156.798403708807
"147.32.84.165",4124,"212.170.236.87",25,3,186,3,186,0,0,89981.916012,9.03556099999696,164.68263564381897,0
"147.32.84.165",3572,"184.82.155.108",80,10,1472,5,584,5,888,89982.016397,0.3477640000055544,13434.398039835578,20427.646334544508
"147.32.84.165",4125,"80.179.55.150",25,3,186,3,186,0,0,89982.130068,9.022188000002643,164.9267339584992,0
"147.32.84.165",3802,"217.163.21.38",80,11,4281,6,2653,5,1628,89982.21644,0.2674390000029234,79360.15315555321,48698.95564916722
"147.32.84.165",4127,"207.115.20.23",25,3,186,3,186,0,0,89982.244182,9.008834000007482,165.1712086157614,0
"147.32.84.165",3845,"184.82.155.107",80,10,1901,5,993,5,908,89982.262534,0.3348950000072364,23720.867734150546,21690.380566574717
"147.32.84.165",4128,"64.12.90.66",25,3,186,3,186,0,0,89982.373252,8.879953999989084,167.5684356024625,0
"147.32.84.165",3875,"217.163.21.38",80,15,8052,7,2688,8,5364,89984.429898,0.18972799999755807,113341.20425175394,226176.42098452683
"147.32.84.165",3907,"46.4.36.120",443,6,366,3,186,3,180,89984.476017,0.9842120000103023,1511.8693939765258,1463.0994135256701
"147.32.84.165",4129,"66.175.58.41",25,3,186,3,186,0,0,89985.460472,8.90167599999404,167.15953265441206,0
"147.32.84.165",3883,"217.163.21.36",80,10,2274,5,1154,5,1120,89991.253155,0.14837500000430737,62220.72451377923,60387.5315904963
"147.32.84.165",3924,"201.249.127.77",6667,1,62,1,62,0,0,89991.299113,0,0,0
"147.32.84.165",3926,"46.4.36.120",443,6,366,3,186,3,180,89991.854433,1.0310339999996359,1443.2113780927937,1396.6561723478649
"147.32.84.165",4130,"205.188.159.42",25,3,186,3,186,0,0,89992.656623,9.029383999994025,164.79529500583703,0
"147.32.84.165",3902,"184.82.155.108",80,10,1470,5,581,5,889,89992.885702,0.3360629999951925,13830.740069768142,21162.69866097053
"147.32.84.165",4133,"205.188.190.2",25,3,186,3,186,0,0,89992.996557,8.991159999990487,165.49588707147626,0
"147.32.84.165",3920,"217.163.21.38",80,13,5799,7,2690,6,3109,89993.860832,0.2348329999949783,91639.59068981014,105913.56410952407
"147.32.84.165",3946,"46.4.36.120",443,6,366,3,186,3,180,89993.907041,0.9847969999973429,1510.9712966266293,1462.2302870580284
"147.32.84.165",4134,"209.86.93.228",25,3,186,3,186,0,0,89993.961124,9.02858600000036,164.80986059167412,0
"147.32.84.165",3942,"184.82.155.107",80,10,1920,5,989,5,931,89994.892053,0.35480899999674875,22299.321607040692,20991.575749398264
"147.32.84.165",4138,"74.125.159.27",25,3,186,3,186,0,0,89995.008928,8.98447200001101,165.6190814550011,0
"147.32.84.165",3944,"217.163.21.38",80,14,6655,7,3168,7,3487,90002.689192,0.21707499999320135,116752.27456314066,128508.57998790135
"147.32.84.165",3983,"208.73.210.29",80,46,33911,20,2030,26,31881,90002.735302,15.066693999993731,1077.8741507597324,16927.93389180839
"147.32.84.165",3976,"183.83.68.80",6667,1,62,1,62,0,0,90002.889342,0,0,0
"147.32.84.165",3974,"46.4.36.120",443,6,366,3,186,3,180,90002.928587,0.9920839999977034,1499.8729946289272,1451.4899948021878
"147.32.84.165",4139,"68.6.19.3",25,3,186,3,186,0,0,90003.190395,9.030116000009002,164.78193635591356,0
"147.32.84.165",3969,"217.163.21.38",80,16,8116,8,2749,8,5367,90003.290941,0.19228000000293832,114374.86997952948,223299.3551037231
"147.32.84.165",4141,"67.231.152.94",25,3,186,3,186,0,0,90003.291051,9.029676000005566,164.78996588571758,0
"147.32.84.165",3970,"184.82.155.108",80,10,1511,5,599,5,912,90003.337023,0.3334049999975832,14372.909824491942,21883.295091713942
"147.32.84.165",4143,"84.96.93.164",25,3,186,3,186,0,0,90003.447272,8.973959999988438,165.81308586197366,0
"147.32.84.165",3995,"173.241.240.4",80,9,2194,5,1164,4,1030,90003.920902,0.06798500000149943,136971.39074493817,121203.20658701572
"147.32.84.165",4026,"74.125.232.217",80,8,1912,5,1038,3,874,90003.937505,13.864707000000635,598.930796013188,504.302038261586
"147.32.84.165",4145,"69.175.13.98",7691,7,424,4,242,3,182,90003.9462,0.3787809999921592,5111.132818277779,3843.9098054816354
"147.32.84.165",4003,"92.240.244.181",80,10,1758,6,1364,4,394,90004.071058,9.730941000001621,1121.3715097027289,323.9152308085595
"147.32.84.165",4030,"208.73.210.29",80,8,2455,5,1485,3,970,90004.079867,13.722526000012294,865.7298226280902,565.4935541745774
"147.32.84.165",4146,"184.154.10.50",8339,7,424,4,242,3,182,90004.079928,0.5829959999973653,3320.777501061327,2497.444236335378
"147.32.84.165",4005,"184.82.155.107",80,10,1921,5,993,5,928,90004.218195,0.33581400000548456,23655.952401836308,22107.47616203836
"147.32.84.165",4031,"67.214.158.5",80,10,1717,5,862,5,855,90004.329248,0.3357990000076825,20536.094508447706,20369.328079724815
"147.32.84.165",4147,"207.115.21.22",25,3,186,3,186,0,0,90004.433095,8.993310000005295,165.45632253298552,0
"147.32.84.165",4010,"217.163.21.38",80,13,5810,7,2697,6,3113,90006.400677,0.2695019999955548,80058.77507534593,92407.47749705297
"147.32.84.165",4033,"50.22.198.84",80,8,2207,5,1172,3,1035,90006.446823,0.37985299999127164,24683.23272480524,21797.90603257118
"147.32.84.165",4046,"115.240.73.24",6667,2,124,2,124,0,0,90006.567917,2.9428250000055414,337.0910604599771,0
"147.32.84.165",4045,"46.4.36.120",443,6,366,3,186,3,180,90012.723407,1.0315070000069682,1442.549590056052,1396.0157323123085
"147.32.84.165",4150,"207.115.20.23",25,3,186,3,186,0,0,90013.727354,8.929011000000173,166.647795595724,0
"147.32.84.165",4013,"217.163.21.36",80,14,6141,7,810,7,5331,90013.75513,0.1894389999943087,34206.26164725679,225127.87758213078
"147.32.84.165",4035,"195.113.232.88",80,8,1366,5,778,3,588,90013.801669,4.0009550000104355,1555.6285936692032,1175.7192970147705
"147.32.84.165",4151,"74.6.136.65",25,3,186,3,186,0,0,90013.802776,8.853685000009136,168.0656133574285,0
"147.32.84.165",4039,"184.82.155.108",80,10,1508,5,596,5,912,90014.028242,0.34265700000105426,13914.789424950695,21292.42945562925
"147.32.84.165",4038,"94.127.76.180",80,4,242,3,182,1,60,90014.141599,0.014560000010533258,99999.99992765619,32967.03294318336
"147.32.84.165",4152,"193.198.2.3",25,3,186,3,186,0,0,90014.156013,8.901574999996228,167.16142929769512,0
"147.32.84.165",4053,"184.82.155.107",80,10,1920,5,989,5,931,90015.031149,0.36172899999655783,21872.7279263628,20589.999696100876
"147.32.84.165",4042,"67.214.158.5",80,11,1846,6,950,5,896,90015.150814,0.33874600000854116,22435.68927694607,21160.397465414397
"147.32.84.165",4057,"46.4.36.120",443,6,366,3,186,3,180,90015.254502,1.009411999999429,1474.1255305077032,1426.5730940397127
"147.32.84.165",4154,"205.188.146.193",25,3,186,3,186,0,0,90016.035098,8.92993500000739,166.63055218193287,0
"147.32.84.165",4054,"217.163.21.36",80,10,1451,5,701,5,750,90016.264129,0.13968199999362696,40148.33693858813,42954.71141789029
"147.32.84.165",4048,"50.22.198.84",80,8,1744,5,1224,3,520,90016.310289,0.3765750000020489,26002.788289043943,11046.936201227818
"147.32.84.165",4064,"221.207.141.60",6667,10,1186,5,628,5,558,90016.431423,1.9277920000022277,2606.0902835960487,2315.6025131315214
"147.32.84.165",4155,"98.139.175.224",25,3,186,3,186,0,0,90016.876254,8.892550999997184,167.33106169427325,0
"147.32.84.165",4055,"217.163.21.36",80,14,6141,7,810,7,5331,90022.756993,0.18972199999552686,34155.23766433403,224792.06418341325
"147.32.84.165",4076,"61.17.216.2",6667,2,124,2,124,0,0,90022.803201,2.965494000003673,334.51424956475086,0
"147.32.84.165",4074,"46.4.36.120",443,6,366,3,186,3,180,90024.16155,1.0318029999907594,1442.1357565478354,1395.6152482720988
"147.32.84.165",4080,"173.192.170.88",80,3,186,3,186,0,0,90024.261876,9.035300999996252,164.68737455460723,0
"147.32.84.165",4156,"65.55.37.104",25,3,186,3,186,0,0,90024.362596,9.034534999998868,164.7013377003007,0
"147.32.84.165",4059,"184.82.155.108",80,10,1511,5,599,5,912,90025.193592,0.38475900000776164,12454.5494709762,18962.519394875286
"147.32.84.165",4157,"202.137.234.30",25,3,186,3,186,0,0,90025.306952,8.993531000000075,165.45225673875896,0
"147.32.84.165",4073,"217.163.21.38",80,14,6128,7,2730,7,3398,90025.367208,0.2703310000069905,80789.84651939747,100558.20456883246
"147.32.84.165",4158,"64.12.138.161",25,3,186,3,186,0,0,90025.413262,8.988043000004836,165.55328006321278,0
"147.32.84.165",4081,"217.163.21.36",80,10,1451,5,701,5,750,90034.702309,0.14655799999309238,38264.714312861244,40939.42330192002
"147.32.84.165",4098,"84.40.69.185",6667,6,366,3,186,3,180,90034.702445,1.025653999997303,1450.7816476159728,1403.9822396283607
"147.32.84.165",4090,"46.4.36.120",443,6,366,3,186,3,180,90034.748465,0.9846459999971557,1511.203011035741,1462.4545268087816
"147.32.84.165",4159,"205.188.190.1",25,3,186,3,186,0,0,90035.103242,9.028684999997495,164.80805344304434,0
"147.32.84.165",4082,"184.82.155.107",80,10,1921,5,993,5,928,90035.728421,0.3657909999892581,21717.31945354939,20295.742651454013
"147.32.84.165",4160,"65.54.188.126",25,3,186,3,186,0,0,90035.733354,9.000935000003665,165.3161588212107,0
"147.32.84.165",4088,"217.163.21.36",80,13,6081,6,750,7,5331,90035.849223,0.1892740000039339,31700.07502285203,225324.1332624322
"147.32.84.165",4797,"212.117.171.138",65500,213,179035,99,6699,114,172336,90035.895439,42.253727999996045,1268.3377902182979,32628.78958278259
"147.32.84.165",4163,"165.21.74.116",25,3,186,3,186,0,0,90035.895501,8.939180999994278,166.4582023790493,0
"147.32.84.165",4850,"217.163.21.38",80,11,4305,6,2675,5,1630,90037.010049,0.2827839999954449,75676.13443598192,46112.934254448795
"147.32.84.165",4904,"205.188.186.137",587,31,3757,15,1984,16,1773,90037.057399,32.363446999996086,490.4298358577787,438.27222730637175
"147.32.84.165",2401,"46.4.36.120",443,6,366,3,186,3,180,90037.175218,0.9663219999929424,1539.8593843572512,1490.1865009908881
"147.32.84.165",4164,"98.174.234.233",25,3,186,3,186,0,0,90037.812297,9.029525000005378,164.7927216546954,0
"147.32.84.165",4974,"217.163.21.36",80,10,1451,5,701,5,750,90037.812368,0.13941000000340864,40226.66953491774,43038.51947387775
"147.32.84.165",4167,"66.162.172.40",25,3,186,3,186,0,0,90037.858434,8.983508000004804,165.6368536655396,0
"147.32.84.165",2563,"217.163.21.36",80,10,2277,5,1156,5,1121,90038.141662,0.139606000011554,66243.57118773278,64237.92673135679
"147.32.84.165",2638,"212.117.171.138",65500,9,544,5,302,4,242,90038.18748,101.95015200000489,23.697855791327157,18.989672521527062
"147.32.84.165",4168,"64.12.90.33",25,3,186,3,186,0,0,90038.187511,8.956420000002254,166.13780952653244,0
"147.32.84.165",3092,"217.163.21.38",80,11,4305,6,2675,5,1630,90045.336096,0.2486429999989923,86067.17261329187,52444.669667164766
"147.32.84.165",3572,"31.192.109.161",80,10,1273,5,540,5,733,90045.382082,0.246383000005153,17533.677241975496,23800.34336734822
"147.32.84.165",3133,"205.188.186.137",587,46,13403,22,11081,24,2322,90045.435926,32.606511999998474,2718.7207267064978,569.7021502944218
"147.32.84.165",3571,"46.4.36.120",443,6,366,3,186,3,180,90045.436018,1.0312030000059167,1442.9748555730175,1396.4272795867912
"147.32.84.165",3875,"173.192.170.88",80,11,1101,7,604,4,497,90045.46282,105.39396699999634,45.84702651908119,37.72511950328369
"147.32.84.165",3802,"184.82.148.43",80,10,1899,5,959,5,940,90046.339147,0.35947299998952076,21342.353946537434,20919.51273174681
"147.32.84.165",4170,"74.6.136.65",25,3,186,3,186,0,0,90046.439712,8.938451999987592,166.47177833500314,0
"147.32.84.165",3194,"217.163.21.38",80,14,6704,7,3190,7,3514,90046.449715,0.22896000000764616,111460.51711717223,122781.2718337753
"147.32.84.165",3511,"112.110.99.104",6667,3,186,3,186,0,0,90046.46737,8.910900000002584,166.98649968011856,0
"147.32.84.165",4172,"216.19.250.52",25,3,186,3,186,0,0,90046.496316,8.88197799999034,167.5302505817531,0
"147.32.84.165",3883,"217.163.21.36",80,10,2277,5,1156,5,1121,90048.649498,0.1401380000024801,65992.0935066601,63994.06299391519
"147.32.84.165",3942,"46.4.36.120",443,6,366,3,186,3,180,90048.695445,0.9852419999951962,1510.288842748538,1461.5698478211657
"147.32.84.165",3920,"184.82.148.44",80,10,1513,5,596,5,917,90049.680954,0.3526680000068154,13519.79765645836,20801.433642571
"147.32.84.165",4173,"205.188.146.193",25,3,186,3,186,0,0,90049.796142,8.881967999986955,167.53043920020716,0
"147.32.84.165",3969,"119.63.45.53",6667,3,186,3,186,0,0,90056.079185,9.019490999999107,164.97605020063187,0
"147.32.84.165",3978,"46.4.36.120",443,6,366,3,186,3,180,90056.680393,1.0225340000033611,1455.208335365972,1408.2661309993277
"147.32.84.165",4010,"217.163.21.39",80,13,6077,6,749,7,5328,90056.781545,0.1883549999911338,31812.269386435473,226296.08984102565
"147.32.84.165",4174,"216.146.33.3",25,3,186,3,186,0,0,90056.8289,8.972007000003941,165.84917956476698,0
"147.32.84.165",4031,"184.82.148.43",80,10,1923,5,983,5,940,90057.703177,0.34887200000230223,22541.21855565395,21555.183562883736
"147.32.84.165",4175,"74.125.157.27",25,3,186,3,186,0,0,90057.818797,8.98553799999354,165.59943322270408,0
"147.32.84.165",4057,"116.228.139.242",6667,2,124,2,124,0,0,90058.778366,3.0100340000062715,329.56438365743816,0
"147.32.84.165",4055,"46.4.36.120",443,6,366,3,186,3,180,90058.778466,1.0311919999949168,1442.9902481859197,1396.4421756637933
"147.32.84.165",4045,"217.163.21.39",80,10,1448,5,699,5,749,90059.079994,0.1422140000067884,39321.023244779506,42133.68585170222
"147.32.84.165",4178,"65.55.88.22",25,3,186,3,186,0,0,90059.128434,8.981790000005276,165.66853600441848,0
"147.32.84.165",4048,"184.82.148.44",80,10,1513,5,596,5,917,90059.809921,0.3345160000026226,14253.428834383463,21930.191679747713
"147.32.84.165",4179,"208.185.174.190",25,3,186,3,186,0,0,90059.920596,8.991711000009673,165.48574570494975,0
"147.32.84.165",4074,"46.4.36.120",443,6,366,3,186,3,180,90067.406102,1.031765000006999,1442.1888705179051,1395.6666488882952
"147.32.84.165",4059,"217.163.21.38",80,11,4301,6,2673,5,1628,90067.406239,0.2534190000005765,84381.99187886999,51393.147317171846
"147.32.84.165",4180,"98.139.175.224",25,3,186,3,186,0,0,90067.4063,9.02965499999118,164.79034913310124,0
"147.32.84.165",4064,"217.163.21.39",80,14,6134,7,809,7,5325,90067.452332,0.19711900000402238,32832.95877042768,216113.10933563334
"147.32.84.165",4181,"67.15.185.102",25,3,186,3,186,0,0,90067.500737,8.93534300000465,166.52970121004034,0
"147.32.84.165",4106,"184.82.148.43",80,10,1923,5,983,5,940,90068.438094,0.3448999999964144,22800.811829752838,21803.421281757546
"147.32.84.165",4183,"205.188.146.193",25,3,186,3,186,0,0,90068.551758,9.250209999998333,160.86121288060144,0
"147.32.84.165",4110,"217.163.21.39",80,10,2274,5,1154,5,1120,90068.551801,0.1406730000016978,65627.37696564784,63693.81473269114
"147.32.84.165",4189,"68.1.17.3",25,3,186,3,186,0,0,90068.598136,9.207032999998773,161.6155823488629,0
"147.32.84.165",4123,"210.211.186.4",6667,2,124,2,124,0,0,90070.717641,3.0100510000047507,329.5625223620578,0
"147.32.84.165",4125,"46.4.36.120",443,6,366,3,186,3,180,90075.332446,1.031048999997438,1443.1903818380092,1396.6358533916218
"147.32.84.165",4113,"217.163.21.39",80,10,1446,5,698,5,748,90076.363778,0.14001899999857415,39880.30195942596,42737.057114112635
"147.32.84.165",4191,"64.12.90.97",25,3,186,3,186,0,0,90076.410055,8.955860000001849,166.14819793963872,0
"147.32.84.165",4117,"217.163.21.38",80,14,6690,7,3188,7,3502,90077.138542,0.18144800000300165,140558.17644492138,154402.36320894436
"147.32.84.165",4196,"98.139.175.224",25,3,186,3,186,0,0,90077.184594,8.984203999993042,165.62402189455543,0
"147.32.84.165",4118,"184.82.148.44",80,10,1513,5,596,5,917,90077.184627,0.3456750000041211,13793.30295781632,21222.246329391888
"147.32.84.165",4199,"194.109.24.138",25,3,186,3,186,0,0,90077.298807,8.970637000005809,165.87450813125494,0
"147.32.84.165",4480,"46.4.36.120",443,6,366,3,186,3,180,90077.953967,1.0185940000083065,1460.8371932171854,1413.7134127908243
"147.32.84.165",4182,"217.163.21.38",80,11,4299,6,2672,5,1627,90078.84455,0.25919100000464823,82471.99941208087,50217.793055185466
"147.32.84.165",4201,"66.94.238.147",25,3,186,3,186,0,0,90078.890572,8.883249999998952,167.5062617848395,0
"147.32.84.165",3092,"120.63.27.163",6667,2,124,2,124,0,0,90078.97281,2.981480999995256,332.7205506262084,0
"147.32.84.165",3511,"46.4.36.120",443,6,366,3,186,3,180,90080.149083,1.030599000005168,1443.820535428948,1397.2456794473692
"147.32.84.165",4387,"184.82.148.43",80,10,1929,5,991,5,938,90080.951529,0.3619520000065677,21903.456811555523,20732.03076613429
"147.32.84.165",4203,"64.12.90.98",25,3,186,3,186,0,0,90081.071199,8.909996999995201,167.0034232335658,0
"147.32.84.165",4426,"92.240.244.181",80,10,1758,6,1364,4,394,90081.179898,5.464579999999842,1996.8597769637038,576.8055367475802
"147.32.84.165",4205,"65.54.188.110",25,3,186,3,186,0,0,90081.18856,8.892558999999892,167.33091115842112,0
"147.32.84.165",3973,"98.126.71.122",80,12,4202,7,715,5,3487,90085.365778,17.80451999999059,321.2667345147762,1566.7931514028317
"147.32.84.165",3926,"46.4.36.120",443,6,366,3,186,3,180,90085.549218,1.0486430000019027,1418.9767156194246,1373.2032731800882
"147.32.84.165",4553,"217.163.21.39",80,14,6137,7,809,7,5328,90086.598104,0.1872060000023339,34571.541509990675,227685.01009299172
"147.32.84.165",4206,"195.50.106.142",25,3,186,3,186,0,0,90086.644168,8.855716999998549,168.02704964490664,0
"147.32.84.165",4048,"195.113.232.98",80,11,4444,6,1289,5,3155,90088.376973,15.964008999988437,645.953030971573,1581.0564877543154
"147.32.84.165",4064,"46.4.36.120",443,6,366,3,186,3,180,90088.377045,1.029739999998128,1445.0249577589536,1398.4112494441488
"147.32.84.165",4907,"173.241.240.4",80,9,2194,5,1164,4,1030,90088.377078,0.06683799999882467,139321.94260994866,123283.1622751264
"147.32.84.165",4207,"65.55.37.72",25,3,186,3,186,0,0,90088.393884,9.01222799999232,165.10900523169943,0
"147.32.84.165",4110,"195.113.232.81",80,8,2617,5,762,3,1855,90089.407053,14.934135000003153,408.19237270847714,993.6966553467521
"147.32.84.165",4113,"61.17.216.26",6667,2,124,2,124,0,0,90089.408022,2.9819290000014007,332.6705632493376,0
"147.32.84.165",3133,"217.163.21.39",80,10,2272,5,1153,5,1119,90089.47992,0.14006099999824073,65857.01944235626,63915.00846140213
"147.32.84.165",4208,"74.6.140.64",25,3,186,3,186,0,0,90089.525934,8.98368799999298,165.63353491363043,0
"147.32.84.165",4118,"77.238.175.247",80,9,1636,5,638,4,998,90095.39979,0.15244400000665337,33481.147173894926,52373.33053220554
"147.32.84.165",4158,"46.4.36.120",443,6,366,3,186,3,180,90095.445803,0.9844390000071144,1511.5207747653703,1462.7620400955198
"147.32.84.165",3802,"184.82.148.44",80,10,1512,5,594,5,918,90096.430479,0.34539000000222586,13758.360114564335,21262.920177053973
"147.32.84.165",4209,"205.188.190.2",25,3,186,3,186,0,0,90096.544084,8.987750000000233,165.55867708825474,0
"147.32.84.165",4123,"74.125.232.217",80,8,1293,5,578,3,715,90097.30521,7.036160999996355,657.1765484050742,812.9433081481454
"147.32.84.165",4167,"94.100.176.20",25,3,186,3,186,0,0,90097.313945,9.020466000001761,164.95821834478502,0
"147.32.84.165",4057,"217.163.21.39",80,10,1448,5,699,5,749,90098.20854,0.13987599998654332,39978.266468429,42837.94218147828
"147.32.84.165",4210,"150.70.88.129",25,3,186,3,186,0,0,90098.254737,8.982652999999118,165.6526195546178,0
"147.32.84.165",4125,"64.236.79.229",80,9,1769,5,1055,4,714,90099.81385,0.36512499999662396,23115.37144834793,15643.957548929311
"147.32.84.165",4181,"221.208.241.38",6667,2,124,2,124,0,0,90099.931613,2.9920560000027763,331.5445967585766,0
"147.32.84.165",3926,"46.4.36.120",443,6,366,3,186,3,180,90102.020732,1.0314089999883436,1442.6866548738828,1396.1483756844027
"147.32.84.165",4117,"184.82.148.43",80,10,1931,5,991,5,940,90102.121015,0.37103700000443496,21367.1412821504,20267.520489628027
"147.32.84.165",4213,"209.85.227.27",25,3,186,3,186,0,0,90102.241908,9.007782000000589,165.19049861551963,0
"147.32.84.165",4154,"64.236.79.229",80,9,1664,5,964,4,700,90103.05236,0.36244799999985844,21277.534984337097,15450.492208543536
"147.32.84.165",4156,"217.163.21.38",80,14,6689,7,3187,7,3502,90103.170137,0.22234100000059698,114670.7085059955,126004.6505139618
"147.32.84.165",4218,"64.12.138.161",25,3,186,3,186,0,0,90103.21641,8.936797000002116,166.50260714209438,0
"147.32.84.165",4196,"46.4.36.120",443,6,366,3,186,3,180,90105.431513,1.0309439999982715,1443.3373684724825,1396.778098521757
"147.32.84.165",3092,"217.163.21.39",80,13,6081,6,750,7,5331,90106.462706,0.18690000000060536,32102.728731838237,228186.19582590618
"147.32.84.165",4224,"68.6.19.3",25,3,186,3,186,0,0,90106.508839,8.95477499999106,166.16832918766644,0
"147.32.84.165",4205,"31.192.109.161",80,10,1273,5,540,5,733,90107.537905,0.24090399999113288,17932.454422338396,24341.64646587786
"147.32.84.165",3973,"46.4.36.120",443,6,366,3,186,3,180,90107.620151,1.0490990000107558,1418.3599450430745,1372.6063984287816
"147.32.84.165",4156,"173.192.170.88",80,14,1463,9,908,5,555,90108.669494,91.19009899999946,79.65777074109813,48.68949643316021
"147.32.84.165",4179,"217.163.21.38",80,15,6184,7,2733,8,3451,90108.669525,0.302107999988948,72371.46980814758,91384.53798313842
"147.32.84.165",4225,"98.139.175.224",25,3,186,3,186,0,0,90108.715611,8.955308999997214,166.15842066426328,0
"147.32.84.165",4158,"190.107.110.169",6667,2,124,2,124,0,0,90109.444362,3.010345000002417,329.5303362236566,0
"147.32.84.165",3092,"46.4.36.120",443,6,366,3,186,3,180,90110.54793,1.0306879999989178,1443.6958614067132,1397.1250271677868
"147.32.84.165",4480,"184.82.148.44",80,10,1513,5,596,5,917,90111.578842,0.3431750000017928,13893.785969185084,21376.84854654819
"147.32.84.165",4228,"209.212.246.20",25,3,186,3,186,0,0,90111.692503,8.888367000006838,167.4098290494593,0
"147.32.84.165",4480,"46.4.36.120",443,6,366,3,186,3,180,90115.463491,1.030600999991293,1443.817733548261,1397.2429679499298
"147.32.84.165",4117,"173.241.240.4",80,9,2193,5,1163,4,1030,90116.494341,0.06377400000928901,145890.17465808676,129206.25958540787
"147.32.84.165",4229,"216.33.127.20",25,3,186,3,186,0,0,90116.510736,8.886140000002342,167.45178446430145,0
"147.32.84.165",4125,"92.240.244.181",80,10,1757,6,1363,4,394,90117.570265,7.599457999996957,1434.839168793928,414.76642150022565
"147.32.84.165",4230,"205.188.159.42",25,3,186,3,186,0,0,90117.579173,8.92404099999112,166.74060551733015,0
"147.32.84.165",3133,"217.163.21.39",80,10,1451,5,701,5,750,90118.274202,0.13964199999463744,40159.83729977628,42967.01565596606
"147.32.84.165",4231,"24.225.8.70",25,3,186,3,186,0,0,90118.320293,8.984974000006332,165.60982814184564,0
"147.32.84.165",4167,"74.125.93.27",25,3,186,3,186,0,0,90119.176733,9.032439999995404,164.73953881794478,0
"147.32.84.165",4179,"184.82.148.43",80,10,1933,5,995,5,938,90123.190013,0.3446890000050189,23093.28118937389,21770.349503148453
"147.32.84.165",4233,"216.32.181.178",25,3,186,3,186,0,0,90123.303457,9.018735000005108,164.98987940095336,0
"147.32.84.165",3133,"46.4.36.120",443,6,366,3,186,3,180,90124.092619,1.0302669999946374,1444.2858016492278,1397.695937079898
"147.32.84.165",4207,"217.163.21.39",80,14,6137,7,809,7,5328,90125.123077,0.18801199999870732,34423.33468100173,226708.9334738903
"147.32.84.165",4240,"216.200.145.235",25,3,186,3,186,0,0,90125.169173,8.961056999993161,166.05183964359736,0
"147.32.84.165",4218,"217.163.21.39",80,10,1448,5,699,5,749,90125.497323,0.1393229999957839,40136.94795668498,43007.97427690565
"147.32.84.165",4242,"98.139.175.224",25,3,186,3,186,0,0,90125.543345,8.987969000008889,165.55464310107527,0
"147.32.84.165",4244,"205.188.190.2",25,3,186,3,186,0,0,90125.54338,8.988060999996378,165.55294851699378,0
"147.32.84.165",3133,"46.4.36.120",443,6,366,3,186,3,180,90127.406958,1.0307449999963865,1443.6160253071482,1397.0477664262726
"147.32.84.165",4207,"217.163.21.35",80,14,6124,7,2733,7,3391,90128.437911,0.3142870000010589,69566.98813481415,86316.01052512067
"147.32.84.165",4246,"74.125.159.27",25,3,186,3,186,0,0,90128.484021,8.95762200000172,166.11551592595828,0
"147.32.84.165",4224,"119.152.220.218",6667,2,124,2,124,0,0,90129.613595,3.010748999993666,329.4861179069019,0
"147.32.84.165",3133,"46.4.36.120",443,6,366,3,186,3,180,90132.624503,1.0320380000048317,1441.8073753030737,1395.2974599707165
"147.32.84.165",4247,"64.12.90.98",25,3,186,3,186,0,0,90133.656738,9.00173599999107,165.30144852076046,0
"147.32.84.165",3133,"46.4.36.120",443,6,366,3,186,3,180,90137.441786,1.0305970000044908,1443.8233373408966,1397.2483909750613
"147.32.84.165",4248,"212.68.215.40",25,3,186,3,186,0,0,90138.472511,9.001021999996738,165.31456094658355,0
"147.32.84.165",4249,"212.27.48.7",25,3,186,3,186,0,0,90138.544753,9.029397000005702,164.79505774295453,0
"147.32.84.165",4250,"209.85.227.27",25,3,186,3,186,0,0,90139.347569,9.02873499999987,164.8071407567086,0
"147.32.84.165",2638,"212.117.171.138",65500,15,912,8,486,7,426,90140.250577,70.5342740000051,55.122138210421205,48.31693596222106
"147.32.84.165",3133,"46.4.36.120",443,6,366,3,186,3,180,90140.273409,1.0095149999979185,1473.9751266727767,1426.4275419413968
"147.32.84.165",4252,"130.164.80.5",25,3,186,3,186,0,0,90141.283211,8.899175999991712,167.20649192704872,0
"147.32.84.165",4167,"66.111.4.71",25,3,186,3,186,0,0,90144.363618,8.928455000001122,166.65817322255788,0
"147.32.84.165",4254,"58.185.204.84",25,3,186,3,186,0,0,90144.564317,8.928283000001102,166.66138382932266,0
"147.32.84.165",3133,"46.4.36.120",443,6,366,3,186,3,180,90146.169011,1.0316159999929368,1442.3971710502628,1395.8682300486414
"147.32.84.165",4257,"98.139.175.224",25,3,186,3,186,0,0,90146.570601,9.029697999998461,164.78956439077515,0
"147.32.84.165",4240,"201.132.220.14",6667,8,482,7,422,1,60,90147.200899,93.18029299999762,36.230836921709255,5.151303827731174
"147.32.84.165",4260,"205.188.156.193",25,3,186,3,186,0,0,90147.367858,8.83337200000824,168.4520928133234,0
"147.32.84.165",4244,"46.4.36.120",443,6,366,3,186,3,180,90149.480179,0.9302039999893168,1599.6491092460249,1548.0475250767984
"147.32.84.165",4242,"184.82.148.43",80,10,1917,5,979,5,938,90150.410609,0.35305499999958556,22183.512483916653,21254.478763956915
"147.32.84.165",4261,"68.6.19.3",25,3,186,3,186,0,0,90150.527164,8.984771000003093,165.6135698950466,0
"147.32.84.165",4244,"46.4.36.120",443,6,366,3,186,3,180,90154.596588,1.0319710000039777,1441.9009836461146,1395.3880486897883
"147.32.84.165",4264,"202.162.229.17",25,3,186,3,186,0,0,90155.628821,8.999142999993637,165.34907824012265,0
"147.32.84.165",4244,"46.4.36.120",443,6,366,3,186,3,180,90159.41144,1.031954999998561,1441.9233396825198,1395.4096835637288
"147.32.84.165",4265,"122.155.7.8",25,3,186,3,186,0,0,90159.512042,9.029169000001275,164.79921906432253,0
"147.32.84.165",4266,"64.18.6.11",25,3,186,3,186,0,0,90160.314253,9.029077999992296,164.80088000139878,0
"147.32.84.165",4275,"76.96.62.116",25,3,186,3,186,0,0,90160.443646,8.999800000005052,165.33700748896248,0
"147.32.84.165",4249,"200.161.192.230",6667,2,124,2,124,0,0,90162.220641,3.0092029999941587,329.6553938042484,0
"147.32.84.165",4244,"46.4.36.120",443,6,366,3,186,3,180,90165.330175,1.0310719999979483,1443.1581887617556,1396.604698801699
"147.32.84.165",4279,"65.54.188.72",25,3,186,3,186,0,0,90165.531366,9.030517000006512,164.77461921603458,0
"147.32.84.165",4167,"216.157.130.15",25,3,186,3,186,0,0,90166.361484,9.002799000008963,165.28193065273572,0
"147.32.84.165",4281,"67.231.144.128",25,3,186,3,186,0,0,90167.637733,9.031209000007948,164.76199365984007,0
"147.32.84.165",4244,"46.4.36.120",443,6,366,3,186,3,180,90168.240546,1.0301429999963148,1444.459652694163,1397.8641800266093
"147.32.84.165",4283,"205.188.190.2",25,3,186,3,186,0,0,90169.270916,9.002564000009443,165.2862451184395,0
"147.32.84.165",4244,"86.101.54.123",6667,2,124,2,124,0,0,90171.551581,3.010173999995459,329.54905596869037,0
"147.32.84.165",4260,"46.4.36.120",443,6,366,3,186,3,180,90176.669128,1.0308860000077402,1443.4185739148922,1396.8566844337668
"147.32.84.165",4294,"205.188.59.194",25,3,186,3,186,0,0,90177.672241,8.9287980000081,166.65177104450677,0
"147.32.84.165",4295,"130.164.80.5",25,3,186,3,186,0,0,90177.700206,8.90095100000326,167.1731481275939,0
"147.32.84.165",4264,"46.4.36.120",443,6,366,3,186,3,180,90180.581176,0.9302679999964312,1599.5390575680433,1547.941023452945
"147.32.84.165",4299,"208.81.192.129",25,3,186,3,186,0,0,90181.283815,9.029324999995879,164.79637182188912,0
"147.32.84.165",4265,"89.200.164.105",6667,2,124,2,124,0,0,90181.383675,3.0106899999955203,329.4925747923154,0
"147.32.84.165",4302,"98.139.54.60",25,3,186,3,186,0,0,90181.511649,9.001958000008017,165.29737197159494,0
"147.32.84.165",4264,"46.4.36.120",443,6,366,3,186,3,180,90186.500889,1.0307599999941885,1443.5950172769503,1397.0274360744681
"147.32.84.165",4303,"64.12.90.66",25,3,186,3,186,0,0,90187.303668,9.029260000010254,164.79755816072526,0
"147.32.84.165",4304,"209.85.227.27",25,3,186,3,186,0,0,90187.531927,9.001250000001164,165.3103735592065,0
"147.32.84.165",4305,"81.169.145.102",25,3,186,3,186,0,0,90187.705148,9.029028000004473,164.80179261812708,0
"147.32.84.165",4167,"46.4.36.120",443,6,366,3,186,3,180,90188.60796,1.0310800000006566,1443.146991503135,1396.5938627449693
"147.32.84.165",4306,"98.139.175.224",25,3,186,3,186,0,0,90189.639278,9.000474999993457,165.32460786803827,0
"147.32.84.165",4307,"173.193.193.4",25,3,186,3,186,0,0,90190.212575,9.029215000002296,164.79837948255985,0
"147.32.84.165",4283,"79.113.153.241",6667,1,62,1,62,0,0,90197.736496,0,0,0
"147.32.84.165",4279,"46.4.36.120",443,6,366,3,186,3,180,90198.639893,1.030786999996053,1443.5572043552136,1396.9908429244003
"147.32.84.165",4308,"98.139.175.225",25,3,186,3,186,0,0,90198.639955,9.03043699999398,164.77607894291182,0
"147.32.84.165",4294,"173.192.170.88",80,3,186,3,186,0,0,90199.670918,9.002716000002692,165.28345445969362,0
"147.32.84.165",4309,"65.54.188.110",25,3,186,3,186,0,0,90199.670978,9.00277800000913,165.28231619156787,0
"147.32.84.165",4310,"64.12.90.33",25,3,186,3,186,0,0,90202.351418,9.030912999995053,164.76739395018146,0
"147.32.84.165",4311,"205.188.159.42",25,3,186,3,186,0,0,90202.551905,9.03123300000152,164.76155581411192,0
"147.32.84.165",4313,"216.99.131.32",25,3,186,3,186,0,0,90207.770574,8.930559000000358,166.61890929783235,0
"147.32.84.165",4315,"209.85.227.27",25,3,186,3,186,0,0,90208.373099,8.930351000002702,166.62279007841346,0
"147.32.84.165",4317,"81.169.145.102",25,3,186,3,186,0,0,90208.37323,8.930332999996608,166.62312592381105,0
"147.32.84.165",4318,"72.249.30.78",25,3,186,3,186,0,0,90208.373285,8.930307000002358,166.6236110359484,0
"147.32.84.165",4321,"64.12.90.34",25,3,186,3,186,0,0,90208.573681,8.930330000002868,166.62318189803983,0
"147.32.84.165",4323,"205.188.159.42",25,3,186,3,186,0,0,90208.774008,8.930996000010055,166.61075651565903,0
"147.32.84.165",4324,"68.6.19.3",25,3,186,3,186,0,0,90208.774109,8.931018999996013,166.61032744423278,0
"147.32.84.165",4304,"46.4.36.120",443,6,366,3,186,3,180,90210.680257,1.0310599999938859,1443.1749849754851,1396.6209532020825
"147.32.84.165",4326,"98.139.175.225",25,3,186,3,186,0,0,90211.282248,8.930414999995264,166.6215959729519,0
"147.32.84.165",4306,"212.117.171.138",65500,9,544,5,302,4,242,90211.282374,35.72052999999141,67.6361744912682,54.198523930089095
"147.32.84.165",4327,"98.139.175.224",25,3,186,3,186,0,0,90211.305483,8.907316999990144,167.0536705948207,0
"147.32.84.165",4328,"216.32.181.178",25,3,186,3,186,0,0,90211.711529,8.902984000000288,167.13497407160924,0
"147.32.84.165",4304,"46.4.36.120",443,6,366,3,186,3,180,90219.610874,1.0311639999999898,1443.0294308180025,1396.4800943400026
"147.32.84.165",4329,"64.12.90.97",25,3,186,3,186,0,0,90220.614568,9.03002999999444,164.7835057027403,0
"147.32.84.165",4294,"173.192.170.88",80,3,186,3,186,0,0,90220.642333,9.002374000003329,165.2897335746604,0
"147.32.84.165",4330,"66.94.236.34",25,3,186,3,186,0,0,90223.32252,9.030744999996386,164.77045913715816,0
"147.32.84.165",4308,"46.4.36.120",443,6,366,3,186,3,180,90223.523981,1.0295479999913368,1445.294439902288,1398.6720386151173
"147.32.84.165",4331,"66.175.58.41",25,3,186,3,186,0,0,90224.553785,9.00376099999994,165.26427123065682,0
"147.32.84.165",4308,"46.4.36.120",443,6,366,3,186,3,180,90228.741266,1.0311400000064168,1443.0630176219913,1396.5125976987013
"147.32.84.165",4335,"64.12.90.98",25,3,186,3,186,0,0,90229.342558,9.031544999990729,164.75586403007765,0
"147.32.84.165",4336,"66.218.245.15",25,3,186,3,186,0,0,90229.54407,9.031394999998156,164.75860041558406,0
"147.32.84.165",4337,"65.55.88.22",25,3,186,3,186,0,0,90229.744821,9.03116100000625,164.76286935854318,0
"147.32.84.165",4338,"205.188.146.194",25,3,186,3,186,0,0,90229.772662,9.003448000003118,165.27001655360087,0
"147.32.84.165",4317,"221.204.246.113",6667,6,366,3,186,3,180,90232.253239,2.2509480000007898,661.0548089069486,639.7304602325308
"147.32.84.165",4315,"46.4.36.120",443,6,366,3,186,3,180,90232.654048,1.0309720000077505,1443.2981690955853,1396.740163640889
"147.32.84.165",4341,"209.85.227.27",25,3,186,3,186,0,0,90233.68526,9.004247000004398,165.2553511692064,0
"147.32.84.165",4342,"205.166.218.186",25,3,186,3,186,0,0,90234.504496,8.886805000001914,167.43925404008297,0
"147.32.84.165",4327,"46.4.36.120",443,6,366,3,186,3,180,90241.685885,1.031356000006781,1442.7607925781367,1396.2201218498096
"147.32.84.165",4346,"205.188.59.193",25,3,186,3,186,0,0,90241.686021,8.929778999998234,166.63346315740785,0
"147.32.84.165",4351,"67.195.168.31",25,3,186,3,186,0,0,90242.717458,8.9014060000045,167.16460298510682,0
"147.32.84.165",4352,"66.97.46.122",25,3,186,3,186,0,0,90244.29556,9.029190000001108,164.7988357759464,0
"147.32.84.165",4353,"12.102.252.75",25,3,186,3,186,0,0,90245.4996,9.031209000007948,164.76199365984007,0
"147.32.84.165",4306,"212.117.171.138",65500,9,544,5,302,4,242,90250.315101,20.795593000002555,116.17846146535486,93.09664792919165
"147.32.84.165",4356,"66.218.245.15",25,3,186,3,186,0,0,90250.337817,9.008831999992253,165.17124528476938,0
"147.32.84.165",4357,"98.139.175.224",25,3,186,3,186,0,0,90250.337879,9.008887000003597,165.1702369004524,0
"147.32.84.165",4360,"65.55.37.88",25,3,186,3,186,0,0,90250.515519,9.032448000012664,164.73939290853528,0
"147.32.84.165",4361,"187.32.102.6",25,3,186,3,186,0,0,90250.715831,9.03154500000528,164.7558640298122,0
"147.32.84.165",4362,"205.188.159.42",25,3,186,3,186,0,0,90250.715964,9.031535000001895,164.75604645275556,0
"147.32.84.165",4338,"173.192.170.88",80,11,1796,8,1610,3,186,90254.631238,17.092218000005232,753.5593098564539,87.05716250515553
"147.32.84.165",4337,"46.4.36.120",443,6,366,3,186,3,180,90254.832082,1.0312460000131978,1442.9146876506254,1396.3690525651214
"147.32.84.165",4363,"209.85.227.27",25,3,186,3,186,0,0,90255.433811,9.029013000006671,164.80206640514314,0
"147.32.84.165",4364,"212.27.48.7",25,3,186,3,186,0,0,90255.863564,9.000396999996156,165.32604061805668,0
"147.32.84.165",4337,"46.4.36.120",443,6,366,3,186,3,180,90262.656575,1.0310570000001462,1443.1791840798219,1396.6250168514407
"147.32.84.165",4365,"74.125.113.27",25,3,186,3,186,0,0,90263.660312,9.02950299999793,164.7931231652884,0
"147.32.84.165",4367,"98.139.175.225",25,3,186,3,186,0,0,90263.687878,9.002059999998892,165.29549903024233,0
"147.32.84.165",4351,"70.45.60.8",6667,2,124,2,124,0,0,90265.365725,3.0096230000053765,329.6093896139908,0
"147.32.84.165",4337,"46.4.36.120",443,6,366,3,186,3,180,90266.569361,1.0302499999961583,1444.3096335894672,1397.7190002478715
"147.32.84.165",4368,"205.188.146.194",25,3,186,3,186,0,0,90267.599862,8.902061999993748,167.1522844933056,0
"147.32.84.165",4306,"212.117.171.138",65500,9,544,5,302,4,242,90271.386195,19.678618000005372,122.77284919090053,98.38089239800638
"147.32.84.165",4337,"46.4.36.120",443,6,366,3,186,3,180,90271.40868,1.008140000005369,1475.9854781995311,1428.373043418901
"147.32.84.165",4370,"98.139.175.224",25,3,186,3,186,0,0,90271.586435,8.929290000000037,166.64258860446841,0
"147.32.84.165",4371,"72.4.117.21",25,3,186,3,186,0,0,90271.78685,8.930246999996598,166.62473053663206,0
"147.32.84.165",4372,"61.8.238.61",25,3,186,3,186,0,0,90271.786943,8.93027599999914,166.62418944276115,0
"147.32.84.165",4374,"205.188.146.193",25,3,186,3,186,0,0,90272.41706,8.901392999992822,167.1648471201305,0
"147.32.84.165",4361,"117.204.65.177",6667,2,124,2,124,0,0,90276.402211,3.0103650000091875,329.5281469180556,0
"147.32.84.165",4357,"46.4.36.120",443,6,366,3,186,3,180,90276.803344,1.0313610000011977,1442.7537981349615,1396.2133530338338
"147.32.84.165",4363,"173.192.170.88",80,27,5559,15,1786,12,3773,90277.834933,60.45164799998747,236.35418508363844,499.30814127691366
"147.32.84.165",4375,"205.188.59.193",25,3,186,3,186,0,0,90278.035851,9.001264000005904,165.31011644575963,0
"147.32.84.165",4357,"46.4.36.120",443,6,366,3,186,3,180,90281.51903,1.0304719999985537,1443.9984783692216,1397.4178822927952
"147.32.84.165",4376,"209.85.227.27",25,3,186,3,186,0,0,90282.549821,9.003109000012046,165.2762395743525,0
"147.32.84.165",4357,"46.4.36.120",443,6,366,3,186,3,180,90284.629105,1.0306589999963762,1443.7364831677905,1397.1643385494747
"147.32.84.165",4377,"76.96.62.116",25,3,186,3,186,0,0,90284.629285,9.030283000000054,164.77888898941384,0
"147.32.84.165",4379,"170.224.49.13",25,3,186,3,186,0,0,90285.660034,9.002707999999984,165.28360133417664,0
"147.32.84.165",4357,"46.4.36.120",443,6,366,3,186,3,180,90288.542224,1.0311910000018543,1442.9916475195423,1396.4435298576216
"147.32.84.165",4380,"65.55.37.72",25,3,186,3,186,0,0,90289.57362,9.001713000005111,165.30187087714918,0
"147.32.84.165",4368,"202.106.32.73",6667,2,124,2,124,0,0,90291.552808,3.009858000004897,329.583654776533,0
"147.32.84.165",4357,"46.4.36.120",443,6,366,3,186,3,180,90292.556151,1.0307820000016363,1443.564206590373,1396.997619281006
"147.32.84.165",4381,"212.27.48.6",25,3,186,3,186,0,0,90292.756911,9.028724999996484,164.80732329322018,0
"147.32.84.165",4306,"212.117.171.138",65500,14,852,8,486,6,366,90292.757049,6.382233999989694,609.1910763544988,458.7735266373386
"147.32.84.165",4384,"209.85.227.27",25,3,186,3,186,0,0,90292.77956,9.0062040000048,165.21944206451542,0
"147.32.84.165",4385,"209.85.227.27",25,3,186,3,186,0,0,90292.779617,9.006196000002092,165.2195888252548,0
"147.32.84.165",4390,"64.12.90.98",25,3,186,3,186,0,0,90292.779667,9.006194000001415,165.21962551548037,0
"147.32.84.165",4392,"165.21.74.122",25,3,186,3,186,0,0,90293.359071,9.029309000005014,164.79666384206962,0
"147.32.84.165",4394,"171.67.219.73",25,3,186,3,186,0,0,90293.587173,9.0038099999947,165.26337183935198,0
"147.32.84.165",4372,"46.4.36.120",443,6,366,3,186,3,180,90299.0771,1.0305700000026263,1443.8611642064177,1397.284997619114
"147.32.84.165",4395,"213.75.3.134",25,3,186,3,186,0,0,90300.107905,8.904732000009972,167.10216545521345,0
"147.32.84.165",4374,"212.117.171.138",65500,128,85041,62,4479,66,80562,90303.595041,61.664976000000024,581.0753903479989,10451.573029072448
"147.32.84.165",4396,"64.12.90.66",25,3,186,3,186,0,0,90303.617999,8.90790299999935,167.0426810889284,0
"147.32.84.165",4357,"117.204.64.121",6667,1,62,1,62,0,0,90305.602045,0,0,0
"147.32.84.165",4376,"46.4.36.120",443,6,366,3,186,3,180,90306.604927,1.0309850000048755,1443.2799701188314,1396.7225517279012
"147.32.84.165",4398,"64.12.90.33",25,3,186,3,186,0,0,90307.106647,9.031203000005917,164.76210312170207,0
"147.32.84.165",4401,"66.94.238.147",25,3,186,3,186,0,0,90307.636151,9.002779999995255,165.2822794737608,0
"147.32.84.165",4376,"46.4.36.120",443,6,366,3,186,3,180,90310.519341,1.0311919999949168,1442.9902481859197,1396.4421756637933
"147.32.84.165",4405,"209.85.227.27",25,3,186,3,186,0,0,90311.550844,9.00181000000157,165.30008964860852,0
"147.32.84.165",4376,"46.4.36.120",443,6,366,3,186,3,180,90313.729952,1.030387000006158,1444.1175985247362,1397.5331598626478
"147.32.84.165",4408,"65.55.88.22",25,3,186,3,186,0,0,90313.730094,9.029888999997638,164.78607876579537,0
"147.32.84.165",4410,"94.245.120.86",25,3,186,3,186,0,0,90314.331782,9.029420999999274,164.79461972147712,0
"147.32.84.165",4411,"216.32.181.178",25,3,186,3,186,0,0,90314.532648,9.02971700001217,164.78921764635533,0
"147.32.84.165",4412,"98.139.175.224",25,3,186,3,186,0,0,90314.760589,9.00250099999539,165.28740180098418,0
"147.32.84.165",4392,"221.226.242.228",6667,2,124,2,124,0,0,90317.140648,3.010018000000855,329.56613548481045,0
"147.32.84.165",4390,"46.4.36.120",443,6,366,3,186,3,180,90321.054379,1.0334940000029746,1439.7761380285876,1393.3317464792783
"147.32.84.165",4385,"173.192.170.88",80,9,984,6,547,3,437,90322.088096,36.64786299999105,119.40668955243227,95.39437538283894
"147.32.84.165",4413,"74.208.5.3",25,3,186,3,186,0,0,90322.088156,8.999534999995376,165.34187599701147,0
"147.32.84.165",4390,"46.4.36.120",443,6,366,3,186,3,180,90324.565219,1.0307430000102613,1443.6188264050172,1397.0504771661456
"147.32.84.165",4418,"205.188.156.193",25,3,186,3,186,0,0,90325.596123,9.002548999997089,165.2865205177424,0
"147.32.84.165",4390,"46.4.36.120",443,6,366,3,186,3,180,90328.17809,1.030492999998387,1443.9690517085794,1397.3894048792704
"147.32.84.165",4419,"65.55.88.22",25,3,186,3,186,0,0,90328.679647,8.929092000005767,166.64628385495848,0
"147.32.84.165",4420,"205.188.59.194",25,3,186,3,186,0,0,90328.679702,8.92915900000662,166.6450334235169,0
"147.32.84.165",4421,"207.115.21.22",25,3,186,3,186,0,0,90329.208817,8.902095999990706,167.15164608442254,0
"147.32.84.165",4390,"46.4.36.120",443,6,366,3,186,3,180,90332.591764,1.0306520000012824,1443.7462887552233,1397.1738278276355
"147.32.84.165",4427,"68.6.19.3",25,3,186,3,186,0,0,90333.194013,8.929529999993974,166.63810973265157,0
"147.32.84.165",4405,"205.188.186.137",587,50,15569,24,13127,26,2442,90333.622657,31.617047000007005,3321.499316491408,617.8945174733008
"147.32.84.165",4428,"209.85.227.27",25,3,186,3,186,0,0,90333.740211,8.884508000002825,167.48254377164463,0
"147.32.84.165",4390,"46.4.36.120",443,6,366,3,186,3,180,90334.798828,1.0308450000011362,1443.4759832936668,1396.912241897097
"147.32.84.165",4431,"98.139.175.224",25,3,186,3,186,0,0,90335.400682,8.929444999987027,166.63969597238818,0
"147.32.84.165",4432,"68.1.17.3",25,3,186,3,186,0,0,90335.400809,8.929421000008006,166.6401438568823,0
"147.32.84.165",4433,"203.231.153.200",25,3,186,3,186,0,0,90335.601471,8.929495000003953,166.63876288629325,0
"147.32.84.165",4434,"74.125.113.27",25,3,186,3,186,0,0,90335.802386,9.029278000001796,164.79722963449615,0
"147.32.84.165",4436,"205.188.146.193",25,3,186,3,186,0,0,90335.829896,9.001891000007163,165.29860226021577,0
"147.32.84.165",4411,"212.117.171.138",65500,9,544,5,302,4,242,90343.026086,50.44239500000549,47.89621904351959,38.38041393553556
"147.32.84.165",4240,"46.4.36.120",443,6,366,3,186,3,180,90343.026214,1.0307100000063656,1443.6650464153936,1397.0952062084452
"147.32.84.165",4390,"173.192.170.88",80,15,3209,8,842,7,2367,90344.057157,60.97223600000143,110.47651262125014,310.56758358016515
"147.32.84.165",4443,"209.85.227.27",25,3,186,3,186,0,0,90344.057186,9.000948999993852,165.3159016900347,0
"147.32.84.165",4363,"196.205.12.237",6667,1,62,1,62,0,0,90344.05721,0,0,0
"147.32.84.165",4240,"46.4.36.120",443,6,366,3,186,3,180,90346.537042,1.0310860000026878,1443.138593673196,1396.5857358127705
"147.32.84.165",4448,"74.6.140.64",25,3,186,3,186,0,0,90347.568365,9.001069999998435,165.3136793737032,0
"147.32.84.165",4418,"31.192.109.161",80,10,1273,5,540,5,733,90349.647213,0.23639099999854807,18274.807416638254,24806.358956288594
"147.32.84.165",4240,"46.4.36.120",443,6,366,3,186,3,180,90349.725163,1.0539879999996629,1411.7807792882613,1366.2394638273497
"147.32.84.165",4450,"65.55.92.152",25,3,186,3,186,0,0,90350.149056,9.028783000001567,164.80626458734713,0
"147.32.84.165",4451,"65.54.188.72",25,3,186,3,186,0,0,90350.77937,9.00010299999849,165.33144120686728,0
"147.32.84.165",4240,"46.4.36.120",443,6,366,3,186,3,180,90354.161937,1.0307270000048447,1443.6412357423508,1397.0721636216297
"147.32.84.165",4456,"205.188.190.2",25,3,186,3,186,0,0,90354.66357,9.028691999992589,164.80792566644442,0
"147.32.84.165",4469,"193.251.214.113",25,3,186,3,186,0,0,90355.192891,9.00099400000181,165.31507520166113,0
"147.32.84.165",4483,"94.245.120.86",25,3,186,3,186,0,0,90355.265347,9.028637000010349,164.80892963116077,0
"147.32.84.165",4240,"46.4.36.120",443,6,366,3,186,3,180,90356.368884,1.0310240000108024,1443.2253759218115,1396.6697186340111
"147.32.84.165",4486,"205.188.146.193",25,3,186,3,186,0,0,90356.569599,9.02879799999937,164.80599078638195,0
"147.32.84.165",4498,"68.6.19.3",25,3,186,3,186,0,0,90356.569667,9.028836999990745,164.80527890818334,0
"147.32.84.165",4500,"72.52.166.118",25,3,186,3,186,0,0,90356.870664,9.028496999992058,164.81148523406597,0
"147.32.84.165",4501,"98.139.175.224",25,3,186,3,186,0,0,90356.870737,9.028528999988339,164.81090108941578,0
"147.32.84.165",4508,"165.21.74.122",25,3,186,3,186,0,0,90357.400102,9.000767000004998,165.31924445985254,0
"147.32.84.165",4431,"210.72.66.210",6667,3,186,3,186,0,0,90368.508094,9.031095999991521,164.76405521560142,0
"147.32.84.165",4432,"46.4.36.120",443,6,366,3,186,3,180,90371.115944,1.0307519999914803,1443.6062214890674,1397.0382788603877
"147.32.84.165",4516,"216.136.51.62",25,3,186,3,186,0,0,90371.71804,9.031494999988354,164.75677614856883,0
"147.32.84.165",4405,"217.34.4.225",6667,10,1184,5,626,5,558,90372.146938,0.5421269999933429,9237.6878481638,8234.232938139618
"147.32.84.165",4518,"205.188.159.42",25,3,186,3,186,0,0,90372.232574,9.018554000009317,164.99319070423738,0
"147.32.84.165",4405,"46.4.36.120",443,6,366,3,186,3,180,90375.633281,1.0308349999977509,1443.4899862764134,1396.9257931707227
"147.32.84.165",4522,"65.54.188.94",25,3,186,3,186,0,0,90376.135305,9.028451999998651,164.81230669446128,0
"147.32.84.165",4529,"208.67.179.142",25,3,186,3,186,0,0,90376.23573,9.028537999998662,164.81073679927144,0
"147.32.84.165",4532,"65.54.188.72",25,3,186,3,186,0,0,90376.664367,9.001120999993873,165.31274271293685,0
"147.32.84.165",4545,"4.59.182.109",25,3,186,3,186,0,0,90377.539333,9.028939000010723,164.80341710119347,0
"147.32.84.165",4469,"46.4.36.120",443,6,366,3,186,3,180,90377.840341,1.0311930000025313,1442.988848834648,1396.4408214528853
"147.32.84.165",4548,"68.6.19.3",25,3,186,3,186,0,0,90377.840449,9.028850000002421,164.80504161655148,0
"147.32.84.165",4550,"64.12.90.66",25,3,186,3,186,0,0,90378.342195,9.0285259999946,164.8109558526929,0
"147.32.84.165",4405,"93.115.96.73",6667,2,124,2,124,0,0,90378.871827,2.98093499999959,332.78149305507714,0
"147.32.84.165",4469,"46.4.36.120",443,6,366,3,186,3,180,90389.578146,1.0306339999951888,1443.7715037607397,1397.1982294458771
"147.32.84.165",4552,"65.55.37.104",25,3,186,3,186,0,0,90390.60908,8.903713000006974,167.1212897359601,0
"147.32.84.165",4555,"68.1.17.3",25,3,186,3,186,0,0,90392.788158,8.93223200000648,166.58770170758223,0
"147.32.84.165",4567,"200.147.36.13",25,3,186,3,186,0,0,90393.289657,8.932805999997072,166.57699719444122,0
"147.32.84.165",4518,"212.117.171.138",65500,9,544,5,302,4,242,90395.396334,29.366010999990976,82.27198443808872,65.92655706628302
"147.32.84.165",4411,"46.4.36.120",443,6,366,3,186,3,180,90395.418897,1.008589999997639,1475.326941575351,1427.73574991163
"147.32.84.165",4577,"205.188.159.42",25,3,186,3,186,0,0,90396.427741,8.905327000000398,167.0910007010336,0
"147.32.84.165",4580,"65.254.39.86",25,3,186,3,186,0,0,90397.201969,8.93347299999732,166.56456005412971,0
"147.32.84.165",4581,"205.188.190.2",25,3,186,3,186,0,0,90397.302235,8.93339800000831,166.56595844029516,0
"147.32.84.165",4529,"61.17.216.23",6667,2,124,2,124,0,0,90397.704028,2.912785000007716,340.5675324465665,0
"147.32.84.165",4411,"46.4.36.120",443,6,366,3,186,3,180,90398.508015,1.0322630000009667,1441.493107859728,1394.9933301868336
"147.32.84.165",4545,"184.82.155.107",80,10,1912,5,981,5,931,90398.808914,0.30513300000166055,25719.931963954376,24409.028194129995
"147.32.84.165",4582,"216.251.32.71",25,3,186,3,186,0,0,90398.90955,8.931148000003304,166.60792095254155,0
"147.32.84.165",4583,"98.139.175.224",25,3,186,3,186,0,0,90399.312358,9.029911999998149,164.78565904078636,0
"147.32.84.165",4587,"209.85.227.27",25,3,186,3,186,0,0,90399.540562,9.002686000007088,165.28400524008373,0
"147.32.84.165",4550,"46.4.36.120",443,6,366,3,186,3,180,90411.553148,1.0309909999923548,1443.2715707615625,1396.7144233176411
"147.32.84.165",4529,"173.192.170.88",80,3,186,3,186,0,0,90412.584376,9.000633999996353,165.32168733898112,0
"147.32.84.165",4588,"207.121.52.205",25,3,186,3,186,0,0,90413.759845,9.028998000008869,164.80234019306886,0
"147.32.84.165",4550,"46.4.36.120",443,6,366,3,186,3,180,90414.261634,1.030905999999959,1443.3905710123513,1396.8295848506627
"147.32.84.165",4594,"64.12.90.66",25,3,186,3,186,0,0,90414.461993,9.029226999991806,164.79816046283366,0
"147.32.84.165",4596,"65.54.188.126",25,3,186,3,186,0,0,90415.292763,9.001598999995622,165.3039643290846,0
"147.32.84.165",4567,"178.123.195.112",6667,2,124,2,124,0,0,90417.371465,3.0096749999938766,329.603694751765,0
"147.32.84.165",4555,"46.4.36.120",443,6,366,3,186,3,180,90418.174136,1.03085199999623,1443.4661813775808,1396.9027561718524
"147.32.84.165",4598,"193.120.142.92",25,3,186,3,186,0,0,90418.274341,9.02898400000413,164.8025957294109,0
"147.32.84.165",4601,"64.12.90.98",25,3,186,3,186,0,0,90419.205237,9.000453999993624,165.32499360599522,0
"147.32.84.165",4605,"217.19.237.57",25,3,186,3,186,0,0,90419.879195,9.029192999994848,164.79878102072345,0
"147.32.84.165",4581,"46.4.36.120",443,6,366,3,186,3,180,90420.381275,1.0310069999977713,1443.249172899133,1396.692747966903
"147.32.84.165",4607,"207.115.21.22",25,3,186,3,186,0,0,90420.582076,9.028735999992932,164.8071225032125,0
"147.32.84.165",4610,"209.85.227.27",25,3,186,3,186,0,0,90421.412511,8.900313999998616,167.1851127949229,0
"147.32.84.165",4518,"212.117.171.138",65500,14,861,8,486,6,375,90433.522962,1.2062259999947855,3223.2765667601325,2487.0961163272627
"147.32.84.165",4581,"46.4.36.120",443,6,366,3,186,3,180,90433.523099,1.0305740000039805,1443.8555600997627,1397.2795742900928
"147.32.84.165",4587,"184.82.148.43",80,10,1925,5,983,5,942,90433.545753,0.32238800000050105,24392.96748014125,23375.559884326613
"147.32.84.165",4620,"205.178.149.7",25,3,186,3,186,0,0,90433.652265,9.000142000004416,165.33072478181677,0
"147.32.84.165",4624,"98.139.175.224",25,3,186,3,186,0,0,90434.553928,9.00109400000656,165.31323859065526,0
"147.32.84.165",4627,"205.188.103.2",25,3,186,3,186,0,0,90434.726637,9.028929000007338,164.80359962945667,0
"147.32.84.165",4587,"212.117.171.138",65500,9,544,5,302,4,242,90435.429443,75.2882879999961,32.08998456705677,25.714490944462707
"147.32.84.165",4628,"205.188.159.42",25,3,186,3,186,0,0,90435.452082,9.005833999995957,165.22623001941497,0
"147.32.84.165",4594,"112.205.182.117",6667,6,366,3,186,3,180,90436.231632,2.3238189999974566,640.3252576907361,619.6696042168413
"147.32.84.165",4581,"46.4.36.120",443,6,366,3,186,3,180,90438.55567,1.0142369999957737,1467.1127162647394,1419.7864996110382
"147.32.84.165",4639,"64.12.90.97",25,3,186,3,186,0,0,90439.24156,9.028228000010131,164.81639586398686,0
"147.32.84.165",4642,"216.33.127.20",25,3,186,3,186,0,0,90439.570159,9.00090500000806,165.31670981958675,0
"147.32.84.165",4647,"62.149.128.160",25,3,186,3,186,0,0,90440.144365,9.028560999999172,164.8103169486407,0
"147.32.84.165",4581,"46.4.36.120",443,6,366,3,186,3,180,90440.846447,1.0306109999946784,1443.8037242060132,1397.229410521948
"147.32.84.165",4651,"207.115.21.22",25,3,186,3,186,0,0,90441.648762,9.029177999997046,164.79905479773316,0
"147.32.84.165",4605,"184.82.148.43",80,10,1917,5,979,5,938,90441.877307,0.3242840000020806,24151.669524089226,23140.210432682015
"147.32.84.165",4652,"198.66.164.253",25,3,186,3,186,0,0,90441.984066,8.994318999990355,165.43776132485357,0
"147.32.84.165",4607,"184.82.148.44",80,10,1511,5,594,5,917,90442.350758,0.34106799999426585,13932.705501776456,21508.907315032004
"147.32.84.165",4657,"65.54.188.94",25,3,186,3,186,0,0,90442.463306,9.017246999996132,165.01710555346196,0
"147.32.84.165",4581,"46.4.36.120",443,6,366,3,186,3,180,90454.690571,1.0309419999975944,1443.3401685094527,1396.780808234954
"147.32.84.165",4610,"217.163.21.40",80,13,6077,6,749,7,5328,90455.592975,0.1866840000002412,32097.019562427726,228321.65584594783
"147.32.84.165",4681,"205.188.159.42",25,3,186,3,186,0,0,90455.63884,8.883191999993869,167.50735546423257,0
"147.32.84.165",4684,"69.63.169.161",25,3,186,3,186,0,0,90455.638899,8.883254000000306,167.50618635918198,0
"147.32.84.165",4687,"205.188.59.193",25,3,186,3,186,0,0,90455.722081,8.900393000003533,167.1836288576706,0
"147.32.84.165",4624,"217.163.21.40",80,10,1448,5,699,5,749,90455.793981,0.13909599999897182,40202.4501066985,43078.16184537508
"147.32.84.165",4693,"205.188.190.2",25,3,186,3,186,0,0,90455.839923,8.882569999987027,167.5190851298862,0
"147.32.84.165",4610,"217.163.21.38",80,11,4392,6,2673,5,1719,90456.496402,0.23795999999856576,89863.842663174,57791.22541638463
"147.32.84.165",4694,"64.6.245.203",25,3,186,3,186,0,0,90456.542273,8.882784999994328,167.51503047759797,0
"147.32.84.165",4581,"46.4.36.120",443,6,366,3,186,3,180,90460.308196,0.9474590000027092,1570.516507833843,1519.8546850004932
"147.32.84.165",4627,"217.163.21.40",80,10,2274,5,1154,5,1120,90460.609223,0.13981699998839758,66029.16670194682,64083.76664313729
"147.32.84.165",4698,"205.188.103.2",25,3,186,3,186,0,0,90460.655121,8.886884999999893,167.4377467470343,0
"147.32.84.165",4639,"217.163.21.39",80,14,6680,7,3178,7,3502,90461.111078,0.21348999999463558,119087.54508707122,131228.62897889345
"147.32.84.165",4701,"209.85.227.27",25,3,186,3,186,0,0,90461.157314,8.986073000007309,165.58957399954238,0
"147.32.84.165",4704,"207.115.20.23",25,3,186,3,186,0,0,90461.255896,8.987785999997868,165.55801395364253,0
"147.32.84.165",4581,"46.4.36.120",443,6,366,3,186,3,180,90462.61613,1.0304719999985537,1443.9984783692216,1397.4178822927952
"147.32.84.165",4647,"92.240.244.181",80,10,1758,6,1364,4,394,90462.917062,5.020935000007739,2173.300391258437,627.7715206420999
"147.32.84.165",4705,"205.188.159.42",25,3,186,3,186,0,0,90462.925616,9.023927000002004,164.89495094537773,0
"147.32.84.165",4709,"98.139.214.154",25,3,186,3,186,0,0,90463.418392,9.032898999997997,164.73116770156847,0
"147.32.84.165",4710,"216.72.94.42",25,3,186,3,186,0,0,90463.646877,9.005076999994344,165.24011954599996,0
"147.32.84.165",4651,"46.4.36.120",443,6,366,3,186,3,180,90476.564377,1.0306540000019595,1443.7434871423106,1397.1711165893328
"147.32.84.165",4712,"67.231.144.220",25,3,186,3,186,0,0,90476.665325,9.028181000001496,164.81725388533454,0
"147.32.84.165",4713,"203.167.0.18",25,3,186,3,186,0,0,90476.764534,9.028825000001234,164.80549794683103,0
"147.32.84.165",4714,"98.139.175.224",25,3,186,3,186,0,0,90477.4673,9.0283369999961,164.81440601969587,0
"147.32.84.165",4718,"64.12.90.33",25,3,186,3,186,0,0,90477.595315,9.001178000005893,165.31169586903243,0
"147.32.84.165",4681,"46.4.36.120",443,6,366,3,186,3,180,90481.58023,1.0307099999918137,1443.6650464357756,1397.09520622817
"147.32.84.165",4719,"165.21.74.122",25,3,186,3,186,0,0,90482.181888,9.029011999999057,164.80208465778486,0
"147.32.84.165",4724,"205.188.159.42",25,3,186,3,186,0,0,90482.282541,9.028442000009818,164.81248924215075,0
"147.32.84.165",4725,"209.85.227.27",25,3,186,3,186,0,0,90482.282668,9.02843700000085,164.81258051641277,0
"147.32.84.165",4731,"218.102.53.147",25,3,186,3,186,0,0,90482.611178,9.00118899998779,165.31149384842587,0
"147.32.84.165",4681,"46.4.36.120",443,6,366,3,186,3,180,90483.987771,1.030509999996866,1443.9452310065165,1397.3663525869513
"147.32.84.165",4732,"203.167.0.18",25,3,186,3,186,0,0,90484.489984,8.927922000002582,166.66812277252978,0
"147.32.84.165",4744,"64.12.90.33",25,3,186,3,186,0,0,90484.490046,8.927997999999207,166.66670400241267,0
"147.32.84.165",4746,"205.188.146.194",25,3,186,3,186,0,0,90484.490106,8.927987999995821,166.66689068138268,0
"147.32.84.165",4747,"208.65.145.3",25,3,186,3,186,0,0,90484.690333,8.928751999992528,166.6526296173581,0
"147.32.84.165",4751,"64.12.90.98",25,3,186,3,186,0,0,90485.018685,8.901232000003802,167.16787069468188,0
"147.32.84.165",4681,"46.4.36.120",443,6,366,3,186,3,180,90497.632761,1.0316239999956451,1442.3859855977385,1395.8574054171663
"147.32.84.165",4760,"207.126.147.10",25,3,186,3,186,0,0,90497.732962,9.030856000012136,164.7684339112483,0
"147.32.84.165",4712,"184.82.155.107",80,10,1908,5,977,5,931,90498.435593,0.3224820000032196,24237.011677929208,23095.86271458761
"147.32.84.165",4768,"205.188.190.2",25,3,186,3,186,0,0,90498.536445,9.0294969999959,164.79323266851694,0
"147.32.84.165",4769,"98.139.175.224",25,3,186,3,186,0,0,90498.542192,9.023873000012827,164.89593769747034,0
"147.32.84.165",4773,"207.115.11.16",25,3,186,3,186,0,0,90498.664622,9.001491000002716,165.30594764795643,0
"147.32.84.165",4681,"46.4.36.120",443,6,366,3,186,3,180,90503.151283,1.0299559999984922,1444.7219104526584,1398.1179778574115
"147.32.84.165",4775,"216.200.145.235",25,3,186,3,186,0,0,90503.251613,9.031560000003083,164.75559039628726,0
"147.32.84.165",4779,"64.12.90.34",25,3,186,3,186,0,0,90503.55266,9.031619999994291,164.75449587127676,0
"147.32.84.165",4719,"221.130.69.202",6667,6,366,3,186,3,180,90504.181475,2.0593559999979334,722.555983521787,699.2477259888261
"147.32.84.165",4731,"46.4.36.120",443,6,366,3,186,3,180,90505.458567,1.0305270000098972,1443.921411069976,1397.3433010354609
"147.32.84.165",4784,"130.56.66.57",25,3,186,3,186,0,0,90505.658829,9.033198999997694,164.72569684343054,0
"147.32.84.165",4786,"68.6.19.3",25,3,186,3,186,0,0,90505.960478,9.03234100001282,164.74134446406396,0
"147.32.84.165",4788,"209.85.227.27",25,3,186,3,186,0,0,90506.241043,8.952693999992334,166.20695401867573,0
"147.32.84.165",4802,"74.125.113.27",25,3,186,3,186,0,0,90506.489331,9.005229999995208,165.23731209539255,0
"147.32.84.165",4587,"212.117.171.138",65500,9,544,5,302,4,242,90518.806992,310.7267450000072,7.775320402496876,6.230554759616702
"147.32.84.165",4747,"46.4.36.120",443,6,366,3,186,3,180,90518.829344,1.0098220000072615,1473.5270176222145,1425.993888021498
"147.32.84.165",4744,"184.82.147.251",80,10,1917,5,982,5,935,90519.610716,0.34043100000417326,23076.62933135847,21972.1470721183
"147.32.84.165",4803,"64.12.90.98",25,3,186,3,186,0,0,90519.61082,8.928062999999383,166.66549059970822,0
"147.32.84.165",4805,"98.139.175.224",25,3,186,3,186,0,0,90519.711232,8.927830999993603,166.66982159508464,0
"147.32.84.165",4806,"74.125.45.27",25,3,186,3,186,0,0,90519.723253,8.915932999996585,166.89223662858055,0
"147.32.84.165",4807,"68.1.17.3",25,3,186,3,186,0,0,90519.839411,8.900583000009647,167.18006000262986,0
"147.32.84.165",4744,"46.4.36.120",443,6,366,3,186,3,180,90524.225165,1.0307450000109384,1443.6160252867676,1397.0477664065493
"147.32.84.165",4809,"65.55.37.88",25,3,186,3,186,0,0,90524.525989,9.029744999992545,164.78870665796526,0
"147.32.84.165",4810,"62.133.192.11",25,3,186,3,186,0,0,90525.256152,9.001971999998204,165.29711489885736,0
"147.32.84.165",4744,"46.4.36.120",443,6,366,3,186,3,180,90526.633291,1.0302019999944605,1444.3769280277083,1397.7841238977821
"147.32.84.165",4812,"66.94.236.34",25,3,186,3,186,0,0,90526.934255,9.029980000006617,164.78441812705117,0
"147.32.84.165",4813,"205.188.159.42",25,3,186,3,186,0,0,90527.13465,9.029968999995617,164.7846188620052,0
"147.32.84.165",4816,"212.71.32.151",25,3,186,3,186,0,0,90527.435895,9.029578000001493,164.7917543876086,0
"147.32.84.165",4817,"98.139.175.224",25,3,186,3,186,0,0,90527.663733,9.00205100000312,165.29566428800328,0
"147.32.84.165",4818,"64.12.90.34",25,3,186,3,186,0,0,90527.663791,9.002116000003298,165.2944707665903,0
"147.32.84.165",4788,"46.4.36.120",443,6,366,3,186,3,180,90540.579529,1.0318330000009155,1442.0938271975017,1395.5746714814532
"147.32.84.165",4786,"184.82.155.107",80,10,1904,5,989,5,915,90540.680893,0.32281199999852106,24509.62169942954,22675.736961555136
"147.32.84.165",4830,"204.127.208.75",25,3,186,3,186,0,0,90540.681026,9.030111000000034,164.7820275963379,0
"147.32.84.165",4831,"161.58.18.5",25,3,186,3,186,0,0,90540.780963,9.030549999995856,164.77401708652107,0
"147.32.84.165",4836,"208.84.244.133",25,3,186,3,186,0,0,90540.787505,9.024132999998983,164.8911867766319,0
"147.32.84.165",4803,"184.82.155.108",80,10,1491,5,588,5,903,90541.611574,0.3454500000079861,13617.021276280948,20911.854102860027
"147.32.84.165",4840,"205.188.159.42",25,3,186,3,186,0,0,90541.724054,8.990766999995685,165.5031211464733,0
"147.32.84.165",4845,"204.127.208.75",25,3,186,3,186,0,0,90541.724114,8.9908310000028,165.50194303502496,0
"147.32.84.165",4867,"205.188.156.193",25,3,186,3,186,0,0,90541.724169,8.990827000001445,165.50201666651586,0
"147.32.84.165",4807,"46.4.36.120",443,6,366,3,186,3,180,90545.596598,1.0307389999943553,1443.6244286945084,1397.055898736621
"147.32.84.165",4806,"70.32.97.26",80,10,2770,6,788,4,1982,90546.298994,0.35337199999776203,17839.557180647942,44870.5613350815
"147.32.84.165",4876,"203.188.197.119",25,3,186,3,186,0,0,90546.411286,8.920105999990483,166.8141611771864,0
"147.32.84.165",4809,"114.57.53.106",6667,3,186,3,186,0,0,90546.62756,8.904208000007202,167.11199918047697,0
"147.32.84.165",4810,"195.113.232.82",80,8,1796,5,772,3,1024,90548.003971,62.231064999999944,99.24303882634831,131.63843491992316
"147.32.84.165",4883,"76.96.30.116",25,3,186,3,186,0,0,90548.0048,8.932170000000042,166.58885802666015,0
"147.32.84.165",4884,"65.54.188.72",25,3,186,3,186,0,0,90548.205115,8.932235000000219,166.58764575718882,0
"147.32.84.165",4812,"68.67.179.209",80,10,1728,6,702,4,1026,90548.506786,13.342984999995679,420.8953243971884,615.1547048881985
"147.32.84.165",4885,"205.188.103.2",25,3,186,3,186,0,0,90548.536223,8.903388999999152,167.12737138634984,0
"147.32.84.165",4813,"68.67.185.205",80,10,2825,6,1255,4,1570,90548.708194,13.1383569999889,764.1746985569415,955.9795033740224
"147.32.84.165",4887,"12.44.217.140",25,3,186,3,186,0,0,90548.732178,8.907657999996445,167.04727550166317,0
"147.32.84.165",4809,"46.4.36.120",443,6,366,3,186,3,180,90561.652954,1.0316059999895515,1442.4111531098802,1395.8817610740775
"147.32.84.165",4816,"217.163.21.39",80,16,7851,8,2758,8,5093,90561.753604,0.19408800000383053,113680.39239708042,209925.3946621938
"147.32.84.165",4888,"98.139.175.224",25,3,186,3,186,0,0,90561.753685,9.031988000002457,164.74778310152706,0
"147.32.84.165",4817,"184.82.155.107",80,10,1916,5,985,5,931,90561.799747,0.34117200000036974,23096.854372549507,21830.63088410517
"147.32.84.165",4890,"65.55.37.104",25,3,186,3,186,0,0,90561.912761,8.972536000001128,165.83940148022955,0
"147.32.84.165",4818,"65.55.8.8",80,7,1247,5,780,2,467,90562.657225,63.24481899999955,98.66420836780392,59.07203244585183
"147.32.84.165",4892,"65.55.92.168",25,3,186,3,186,0,0,90562.684833,9.003457999991952,165.26983299098305,0
"147.32.84.165",4812,"217.163.21.40",80,14,6064,7,2702,7,3362,90562.81891,0.2730109999974957,79176.29692649118,98516.17700476067
"147.32.84.165",4893,"161.58.16.34",25,3,186,3,186,0,0,90562.864993,9.023530999998911,164.9021874031551,0
"147.32.84.165",4809,"46.4.36.120",443,6,366,3,186,3,180,90566.970935,1.03148799999326,1442.5761618261413,1396.041446928524
"147.32.84.165",4813,"184.82.155.108",80,10,1510,5,599,5,911,90567.373125,0.3432360000006156,13961.239496997418,21233.203976234803
"147.32.84.165",4895,"64.12.90.33",25,3,186,3,186,0,0,90567.486856,9.01730900000257,165.0159709509318,0
"147.32.84.165",4817,"178.165.97.227",6667,3,186,3,186,0,0,90568.00266,9.00295599999663,165.27904834818222,0
"147.32.84.165",4831,"195.113.232.88",80,14,14375,10,1394,4,12981,90568.978429,63.16764100000728,176.5460894763937,1644.006303797035
"147.32.84.165",4900,"209.85.227.27",25,3,186,3,186,0,0,90568.979384,9.029337999993004,164.79613455617155,0
"147.32.84.165",4845,"46.4.36.120",443,6,366,3,186,3,180,90569.17907,1.0315110000083223,1442.5439961260663,1396.010318831677
"147.32.84.165",4836,"70.32.97.26",80,8,1498,5,843,3,655,90569.480005,0.3494849999988219,19296.965535066553,14993.490421670927
"147.32.84.165",4909,"74.125.157.27",25,3,186,3,186,0,0,90569.592214,9.01873299998988,164.98991598949317,0
"147.32.84.165",4840,"217.163.21.40",80,14,6137,7,809,7,5328,90569.681664,0.19018199999118224,34030.56020180708,224122.15668136973
"147.32.84.165",4910,"208.67.174.100",25,3,186,3,186,0,0,90569.727612,8.983297999991919,165.64072571135216,0
"147.32.84.165",4867,"217.163.21.40",80,10,1448,5,699,5,749,90570.210794,0.1401789999945322,39891.85256149723,42745.34702226242
"147.32.84.165",4911,"64.12.90.1",25,3,186,3,186,0,0,90570.257718,8.955767999999807,166.14990473179208,0
"147.32.84.165",4883,"46.4.36.120",443,6,366,3,186,3,180,90582.826267,1.030309000008856,1444.2269260845144,1397.6389607269496
"147.32.84.165",4809,"184.82.155.107",80,10,1916,5,985,5,931,90582.926307,0.3050999999977648,25827.597509202653,24411.668305652456
"147.32.84.165",4912,"12.44.217.140",25,3,186,3,186,0,0,90583.026967,8.9301359999954,166.6268016523787,0
"147.32.84.165",4836,"217.163.21.40",80,11,4310,6,2683,5,1627,90583.729129,0.23919399999431334,89734.69234391452,54416.08067221354
"147.32.84.165",4920,"64.12.90.34",25,3,186,3,186,0,0,90583.775081,8.883791999993264,167.49604223074203,0
"147.32.84.165",4933,"203.188.197.119",25,3,186,3,186,0,0,90583.85681,8.902098999998998,167.15158975430037,0
"147.32.84.165",4890,"217.163.21.40",80,10,2274,5,1154,5,1120,90583.929769,0.13960100000258535,66131.33143622916,64182.92132458983
"147.32.84.165",4938,"65.55.37.72",25,3,186,3,186,0,0,90583.929896,8.929437999991933,166.63982660513958,0
"147.32.84.165",4836,"46.4.36.120",443,6,366,3,186,3,180,90588.043924,1.030891000002157,1443.4115730924866,1396.8499094443418
"147.32.84.165",4809,"217.163.21.40",80,14,6717,7,3198,7,3519,90588.444841,0.22312399999646004,114662.69877021702,126171.99405015438
"147.32.84.165",4940,"209.85.227.27",25,3,186,3,186,0,0,90588.49074,8.984881000011228,165.6115423229468,0
"147.32.84.165",4883,"112.152.241.216",6667,3,186,3,186,0,0,90588.490799,8.984963999988395,165.61001246103177,0
"147.32.84.165",4890,"109.169.13.214",80,11,4245,6,1582,5,2663,90589.075056,0.08968799999274779,141111.40844955144,237534.56428644469
"147.32.84.165",4950,"200.72.136.190",25,3,186,3,186,0,0,90589.101322,8.976857000001473,165.75957487122227,0
"147.32.84.165",4890,"31.192.109.161",80,10,1273,5,540,5,733,90589.949796,0.24210699999821372,17843.350254358087,24220.695808230514
"147.32.84.165",4809,"109.169.13.214",80,10,2346,5,1600,5,746,90590.028885,0.0977559999882942,130938.25444507484,61049.96113501614
"147.32.84.165",4955,"65.55.92.184",25,3,186,3,186,0,0,90590.057916,9.023369999995339,164.9051296800163,0
"147.32.84.165",4836,"46.4.36.120",443,6,366,3,186,3,180,90590.552156,1.0307489999977406,1443.6104231032596,1397.0423449386383
"147.32.84.165",4895,"109.169.13.214",80,35,40248,21,1941,14,38307,90590.652396,0.20978799999284092,74017.57965436488,1460788.9870271794
"147.32.84.165",4957,"65.55.37.88",25,3,186,3,186,0,0,90590.681882,9.002133000001777,165.2941586177083,0
"147.32.84.165",4890,"184.82.155.107",80,10,1912,5,981,5,931,90591.153709,0.3216939999983879,24395.854445651235,23152.436787870847
"147.32.84.165",4959,"98.139.175.224",25,3,186,3,186,0,0,90591.260222,9.026584999999614,164.84639539760204,0
"147.32.84.165",4895,"184.82.155.108",80,10,1510,5,599,5,911,90591.58318,0.32582699999329634,14707.191239825404,22367.698196128455
"147.32.84.165",4961,"64.12.90.1",25,3,186,3,186,0,0,90591.690811,8.99727000000712,165.38349966143312,0
"147.32.84.165",4910,"46.4.36.120",443,6,366,3,186,3,180,90604.000688,1.032015999997384,1441.838111040693,1395.3272042329288
"147.32.84.165",4909,"217.163.21.40",80,14,6137,7,809,7,5328,90604.703112,0.18935400000191294,34179.36774472478,225102.18954745817
"147.32.84.165",4963,"72.1.178.70",25,3,186,3,186,0,0,90604.74906,8.987173000001349,165.56930638809075,0
"147.32.84.165",4883,"184.82.155.107",80,10,1912,5,981,5,931,90604.804743,0.3415510000049835,22977.534833408456,21806.406656374384
"147.32.84.165",4965,"64.12.90.97",25,3,186,3,186,0,0,90604.904332,9.032336999996915,164.7414174205976,0
"147.32.84.165",4912,"217.163.21.41",80,10,1448,5,699,5,749,90604.917631,0.14402399999380577,38826.862191304936,41604.177083386836
"147.32.84.165",4968,"208.67.174.100",25,3,186,3,186,0,0,90604.963534,8.973259999998845,165.8260208664623,0
"147.32.84.165",4920,"217.163.21.40",80,11,4335,6,2698,5,1637,90605.03291,0.25488700000278186,84680.66241026192,51379.63097316485
"147.32.84.165",4981,"64.12.90.66",25,3,186,3,186,0,0,90605.078778,8.958215999999084,166.10450116408805,0
"147.32.84.165",4912,"46.4.36.120",443,6,366,3,186,3,180,90609.118077,1.0317599999980303,1442.1958595049632,1395.673412424158
"147.32.84.165",4933,"184.82.155.108",80,10,1511,5,599,5,912,90610.122238,0.33958100000745617,14111.508005143934,21485.301002823486
"147.32.84.165",4985,"98.139.175.225",25,3,186,3,186,0,0,90610.150078,8.904182999991463,167.11246837597866,0
"147.32.84.165",4883,"217.163.21.41",80,10,2274,5,1154,5,1120,90610.234726,0.13961600000038743,66124.22644950708,64176.02567023218
"147.32.84.165",4994,"65.54.188.126",25,3,186,3,186,0,0,90610.280613,8.87345600000117,167.69114536656335,0
"147.32.84.165",4810,"217.163.21.40",80,15,6792,7,3213,8,3579,90611.125111,0.21713699999963865,118376.87727122866,131861.45152621454
"147.32.84.165",1025,"165.21.74.122",25,3,186,3,186,0,0,90611.171028,8.885781999997562,167.4585309430738,0
"147.32.84.165",4883,"46.4.36.120",443,6,366,3,186,3,180,90611.727581,1.0312490000069374,1442.910490085314,1396.3649904051426
"147.32.84.165",4940,"217.163.21.41",80,14,6141,7,810,7,5331,90612.329907,0.18997699998726603,34109.39219186716,224490.33305536277
"147.32.84.165",1026,"209.85.227.27",25,3,186,3,186,0,0,90612.375925,8.885085999994772,167.4716485581429,0
"147.32.84.165",4912,"109.169.13.214",80,11,7383,7,1642,4,5741,90612.73159,0.09229000000050291,142333.9473391312,497648.7160011889
"147.32.84.165",1027,"65.55.92.168",25,3,186,3,186,0,0,90612.757385,9.004742999997688,165.24624856038446,0
"147.32.84.165",4933,"217.163.21.41",80,10,1451,5,701,5,750,90612.759066,0.14826499999617226,37824.16618989499,40468.08080231276
"147.32.84.165",1028,"64.12.90.1",25,3,186,3,186,0,0,90612.805279,8.95698300001095,166.1273667705053,0
"147.32.84.165",4959,"46.4.36.120",443,6,366,3,186,3,180,90625.674445,1.0333260000043083,1440.0102194213598,1393.5582768593804
"147.32.84.165",4955,"109.169.13.214",80,28,30224,17,1701,11,28523,90625.875669,0.13542299999971874,100485.1465410474,1684972.2720695445
"147.32.84.165",1034,"94.232.160.42",25,3,186,3,186,0,0,90625.875851,9.034106999999494,164.70914059353993,0
"147.32.84.165",4810,"109.169.13.214",80,10,2444,5,1615,5,829,90625.901644,0.11570300000312272,111665.21178924748,57319.17063361372
"147.32.84.165",1037,"119.252.147.10",25,3,186,3,186,0,0,90625.901716,9.008369000002858,165.17973453346858,0
"147.32.84.165",4940,"217.163.21.40",80,11,4330,6,2700,5,1630,90625.994867,0.2843600000051083,75960.0506386692,45857.363904085476
"147.32.84.165",1042,"98.139.175.224",25,3,186,3,186,0,0,90626.040939,8.969599999996717,165.89368533719949,0
"147.32.84.165",4957,"184.82.155.107",80,10,1916,5,985,5,931,90626.708057,0.3082520000025397,25563.499993301182,24162.049232247107
"147.32.84.165",1043,"64.12.90.97",25,3,186,3,186,0,0,90626.809801,9.003033000000869,165.27763477039974,0
"147.32.84.165",4968,"59.94.194.59",6667,3,186,3,186,0,0,90631.096385,9.034184000003734,164.7077367473792,0
"147.32.84.165",4965,"46.4.36.120",443,6,366,3,186,3,180,90631.196693,1.0314450000005309,1442.6363014986105,1396.0996466115585
"147.32.84.165",4810,"217.163.21.41",80,10,2277,5,1156,5,1121,90632.09978,0.14020999999775086,65958.20554987768,63961.20105658554
"147.32.84.165",1046,"216.32.180.22",25,3,186,3,186,0,0,90632.145727,8.990394000007655,165.5099876600217,0
"147.32.84.165",4818,"184.82.155.108",80,10,1510,5,599,5,911,90632.228373,0.3426340000005439,13985.769071348417,21270.510223703517
"147.32.84.165",1047,"64.12.90.1",25,3,186,3,186,0,0,90632.336489,9.000555000005988,165.32313840635493,0
"147.32.84.165",1025,"217.163.21.40",80,14,6749,7,3215,7,3534,90632.336547,0.23003000000608154,111811.50284449861,122905.70794788742
"147.32.84.165",1048,"209.85.227.27",25,3,186,3,186,0,0,90632.382439,8.95472600001085,166.16923845555934,0
"147.32.84.165",1049,"64.12.90.66",25,3,186,3,186,0,0,90632.382497,8.954718000008143,166.16938690851538,0
"147.32.84.165",4994,"46.4.36.120",443,6,366,3,186,3,180,90633.304344,1.0303940000012517,1444.1077878929734,1397.5236657028775
"147.32.84.165",1051,"155.70.32.98",25,3,186,3,186,0,0,90633.806346,9.036164000004646,164.67164606565737,0
"147.32.84.165",4957,"173.241.240.4",80,9,2195,5,1165,4,1030,90633.806422,0.06805700001132209,136944.03218551373,121074.98124556149
"147.32.84.165",1052,"65.54.188.110",25,3,186,3,186,0,0,90633.822593,9.020039999988512,164.96600902012577,0
"147.32.84.165",4959,"92.240.244.181",80,10,1760,6,1366,4,394,90634.33496,12.667483000011998,862.6812445684474,248.8260690775756
"147.32.84.165",1053,"74.84.86.134",25,3,186,3,186,0,0,90634.343478,9.000539000000572,165.32343229665528,0
"147.32.84.165",1026,"46.4.36.120",443,6,366,3,186,3,180,90646.956088,1.0311799999908544,1443.0070404906971,1396.4584262813198
"147.32.84.165",4810,"217.163.21.34",80,15,6197,7,809,8,5388,90646.956226,0.1887130000104662,34295.464539491484,228410.33737797296
"147.32.84.165",1054,"205.188.159.42",25,3,186,3,186,0,0,90646.956285,9.032598000005237,164.73665716100032,0
"147.32.84.165",4965,"184.82.155.107",80,10,1916,5,985,5,931,90647.002087,0.3444619999936549,22876.25340428016,21622.123776025208
"147.32.84.165",1060,"205.188.190.2",25,3,186,3,186,0,0,90647.1146,8.974346000002697,165.8059539937008,0
"147.32.84.165",1034,"217.163.21.34",80,10,1448,5,699,5,749,90647.759172,0.13911299999745097,40197.53725462368,43072.897573266295
"147.32.84.165",1062,"67.231.144.184",25,3,186,3,186,0,0,90647.805037,8.986052000007476,165.58996097493784,0
"147.32.84.165",1037,"184.82.155.108",80,10,1510,5,599,5,911,90647.987507,0.32143700000597164,14908.053521875125,22673.183236107245
"147.32.84.165",1064,"207.115.20.21",25,3,186,3,186,0,0,90648.09391,8.998154000000795,165.36725199411663,0
"147.32.84.165",1043,"31.192.109.161",80,10,1273,5,540,5,733,90650.267033,0.2366489999985788,18254.883815380348,24779.31451235888
"147.32.84.165",4965,"124.123.147.161",6667,3,186,3,186,0,0,90650.345323,8.954117999994196,166.18052163272412,0
"147.32.84.165",1037,"46.4.36.120",443,6,366,3,186,3,180,90653.077083,1.030895000003511,1443.4059724753074,1396.844489492233
"147.32.84.165",1042,"217.163.21.40",80,11,4326,6,2698,5,1628,90653.278089,0.2280579999933252,94642.59092262371,57108.27947443714
"147.32.84.165",1066,"209.85.227.27",25,3,186,3,186,0,0,90653.324063,8.985873000012361,165.5932595528507,0
"147.32.84.165",4959,"217.163.21.34",80,14,6137,7,809,7,5328,90654.108212,0.18906599999172613,34231.43241134433,225445.08267940985
"147.32.84.165",1067,"207.115.21.22",25,3,186,3,186,0,0,90654.154213,8.957976000005146,166.10895139696123,0
"147.32.84.165",1026,"217.163.21.34",80,10,2274,5,1154,5,1120,90654.78402,0.1402339999913238,65832.822286829,63893.20707213907
"147.32.84.165",1068,"216.99.131.26",25,3,186,3,186,0,0,90654.784156,9.030392000000575,164.77690005039707,0
"147.32.84.165",1047,"217.163.21.34",80,10,1448,5,699,5,749,90654.830002,0.13988200000312645,39976.551664081264,42836.10471587534
"147.32.84.165",1069,"98.139.175.224",25,3,186,3,186,0,0,90654.830064,8.98460999999952,165.6165376126598,0
"147.32.84.165",1026,"46.4.36.120",443,6,366,3,186,3,180,90655.286597,1.030536000005668,1443.908800849088,1397.3310975958918
"147.32.84.165",1048,"217.163.21.40",80,14,6745,7,3213,7,3532,90656.317377,0.2343970000074478,109660.10656784548,120547.6179264333
"147.32.84.165",1071,"212.227.15.150",25,3,186,3,186,0,0,90656.363902,8.955899000007776,166.14747441867178,0
"147.32.84.165",1052,"46.4.36.120",443,6,366,3,186,3,180,90668.031095,1.0291640000068583,1445.8337057942992,1399.1939088331928
"147.32.84.165",1049,"217.163.21.40",80,12,4386,6,2698,6,1688,90668.130317,0.2444370000011986,88300.8709806378,55245.318834439066
"147.32.84.165",1072,"64.12.90.66",25,3,186,3,186,0,0,90668.176183,8.984769000002416,165.61360676046317,0
"147.32.84.165",1060,"94.100.176.20",25,3,186,3,186,0,0,90668.833319,9.02935900000739,164.79575128187753,0
"147.32.84.165",1037,"184.82.155.107",80,10,1916,5,985,5,931,90669.0605,0.32279299999936484,24411.92962677476,23073.6106421597
"147.32.84.165",1073,"143.166.83.183",25,3,186,3,186,0,0,90669.133607,8.929702000008547,166.63490002226007,0
"147.32.84.165",1042,"173.241.240.4",80,9,2194,5,1164,4,1030,90669.166993,0.06789899998693727,137144.87697597148,121356.72103543866
"147.32.84.165",1074,"205.188.190.2",25,3,186,3,186,0,0,90669.183585,8.879847999996855,167.57043589040342,0
"147.32.84.165",1054,"217.163.21.34",80,10,2274,5,1154,5,1120,90670.840065,0.13996400000178255,65959.81823813569,64016.461374967046
"147.32.84.165",1075,"209.85.227.27",25,3,186,3,186,0,0,90670.88602,8.882112999999663,167.5277042748788,0
"147.32.84.165",1042,"184.82.155.108",80,10,1511,5,599,5,912,90670.886079,0.34136900000157766,14037.595680855184,21372.76671275447
"147.32.84.165",1076,"216.99.131.32",25,3,186,3,186,0,0,90670.99867,8.870221999997739,167.75228399022924,0
"147.32.84.165",1042,"89.215.49.24",6667,2,124,2,124,0,0,90674.35102,3.0093789999955334,329.636114295166,0
"147.32.84.165",1066,"46.4.36.120",443,6,366,3,186,3,180,90675.153869,1.0303410000051372,1444.182071753508,1397.5955533098463
"147.32.84.165",1054,"217.163.21.34",80,13,6081,6,750,7,5331,90675.856202,0.18705100000079256,32076.813275387874,228001.988761457
"147.32.84.165",1078,"207.115.21.22",25,3,186,3,186,0,0,90675.856338,8.929868999999599,166.63178373614068,0
"147.32.84.165",1079,"184.172.33.106",25,3,186,3,186,0,0,90675.902186,8.884124999996857,167.48976404547736,0
"147.32.84.165",1067,"217.163.21.34",80,10,1451,5,701,5,750,90676.184436,0.14218799999798648,39440.74042872405,42197.6538110457
"147.32.84.165",1081,"205.188.146.193",25,3,186,3,186,0,0,90676.230239,8.857375999999931,167.9955779228534,0
"147.32.84.165",1066,"46.4.36.120",443,6,366,3,186,3,180,90677.360626,1.0305670000088867,1443.865367304764,1397.2890651336427
"147.32.84.165",1068,"217.163.21.34",80,11,4329,6,2700,5,1629,90678.391444,0.23430200001166668,92188.71370677359,55620.52393642006
"147.32.84.165",1092,"98.139.175.224",25,3,186,3,186,0,0,90678.437484,8.95685100000992,166.12981504307174,0
"147.32.84.165",1066,"46.4.36.120",443,6,366,3,186,3,180,90689.101291,1.03188599999703,1442.0197580006734,1395.5029916135547
"147.32.84.165",1067,"184.82.155.107",80,10,1916,5,985,5,931,90689.904685,0.3430309999966994,22971.684775066453,21712.323376230324
"147.32.84.165",1094,"65.55.88.22",25,3,186,3,186,0,0,90690.017532,9.018358000001172,164.9967765750491,0
"147.32.84.165",1072,"74.125.93.27",25,3,186,3,186,0,0,90690.106121,9.030306000000564,164.77846930103,0
"147.32.84.165",1095,"209.85.227.27",25,3,186,3,186,0,0,90690.106255,9.030308999994304,164.77841455933995,0
"147.32.84.165",1096,"74.125.159.27",25,3,186,3,186,0,0,90690.133391,9.003253000002587,165.27359611015845,0
"147.32.84.165",1066,"46.4.36.120",443,6,366,3,186,3,180,90691.911926,1.0304769999929704,1443.9914719204316,1397.4111018584822
"147.32.84.165",1097,"205.188.156.193",25,3,186,3,186,0,0,90691.912072,9.029935999991721,164.7852210692705,0
"147.32.84.165",1075,"60.249.196.250",6667,3,186,3,186,0,0,90692.942656,9.002697999996599,165.28378492764747,0
"147.32.84.165",1066,"46.4.36.120",443,6,366,3,186,3,180,90696.828956,1.0307080000056885,1443.6678477238827,1397.0979171521444
"147.32.84.165",1099,"192.85.154.103",25,3,186,3,186,0,0,90696.82909,9.028292999995756,164.81520925391982,0
"147.32.84.165",1100,"205.188.146.194",25,3,186,3,186,0,0,90697.130018,9.028730999998515,164.8072137712647,0
"147.32.84.165",1103,"217.31.49.69",25,3,186,3,186,0,0,90697.859899,9.001024999990477,165.31450584811998,0
"147.32.84.165",1066,"46.4.36.120",443,6,366,3,186,3,180,90699.437279,1.0303029999922728,1444.2353366059886,1397.6470999412793
"147.32.84.165",1081,"184.82.155.107",80,10,1912,5,981,5,931,90700.467765,0.305038999998942,25727.857749426203,24416.550015000812
"147.32.84.165",1104,"209.85.143.27",25,3,186,3,186,0,0,90700.568439,8.901926000005915,167.15483817760463,0
"147.32.84.165",1066,"46.4.36.120",443,6,366,3,186,3,180,90710.975746,1.0307299999985844,1443.6370339487971,1397.0680973698036
"147.32.84.165",1105,"98.139.214.154",25,3,186,3,186,0,0,90711.076118,9.034276000005775,164.70605945612562,0
"147.32.84.165",1110,"205.188.146.193",25,3,186,3,186,0,0,90711.076252,9.03426600000239,164.7062417687952,0
"147.32.84.165",1112,"207.115.21.24",25,3,186,3,186,0,0,90711.076311,9.034255000005942,164.70644231306525,0
"147.32.84.165",1072,"74.125.39.27",25,3,186,3,186,0,0,90712.006718,9.006821000002674,165.20812393180216,0
"147.32.84.165",1113,"65.55.37.88",25,3,186,3,186,0,0,90712.883191,9.032957999996142,164.73009173746135,0
"147.32.84.165",1115,"98.139.175.224",25,3,186,3,186,0,0,90712.982956,9.033491999987746,164.72035398957775,0
"147.32.84.165",1096,"202.95.154.126",6667,2,124,2,124,0,0,90717.800906,3.0110679999925196,329.45121133181465,0
"147.32.84.165",1095,"46.4.36.120",443,6,366,3,186,3,180,90718.1015,1.0317869999998948,1442.15811984465,1395.636890172242
"147.32.84.165",1116,"216.32.181.178",25,3,186,3,186,0,0,90718.804938,9.031149000002188,164.7630882847398,0
"147.32.84.165",1118,"64.12.90.33",25,3,186,3,186,0,0,90719.133533,9.003893000000971,165.26184840266754,0
"147.32.84.165",1095,"46.4.36.120",443,6,366,3,186,3,180,90721.514454,1.0310440000030212,1443.1973805149341,1396.642626304775
"147.32.84.165",1120,"209.85.227.27",25,3,186,3,186,0,0,90722.545792,9.002095999996527,165.2948380022357,0
"147.32.84.165",1095,"46.4.36.120",443,6,366,3,186,3,180,90732.150614,1.0317240000003949,1442.2461821179215,1395.7221117270208
"147.32.84.165",1096,"184.82.155.107",80,10,1912,5,981,5,931,90732.150746,0.32271000000764616,24319.048061151043,23079.545101867094
"147.32.84.165",1125,"65.54.188.78",25,3,186,3,186,0,0,90732.150806,8.931935999993584,166.59322234295777,0
"147.32.84.165",1127,"65.55.37.120",25,3,186,3,186,0,0,90732.257339,8.926074999995762,166.70261004984906,0
"147.32.84.165",1128,"64.12.90.34",25,3,186,3,186,0,0,90733.054461,8.93210399999225,166.59008896462592,0
"147.32.84.165",1072,"66.111.4.71",25,3,186,3,186,0,0,90733.182598,8.904951000004075,167.09805590163484,0
"147.32.84.165",1129,"64.12.138.152",25,3,186,3,186,0,0,90733.957047,8.933791000003112,166.55863115663684,0
"147.32.84.165",1130,"205.188.159.42",25,3,186,3,186,0,0,90734.057696,8.933282999991206,166.56810267865293,0
"147.32.84.165",1134,"64.12.90.97",25,3,186,3,186,0,0,90734.057831,8.933273000002373,166.56828913653536,0
"147.32.84.165",1095,"178.123.10.51",6667,2,124,2,124,0,0,90739.877802,2.9118519999901764,340.6766552707166,0
"147.32.84.165",1115,"46.4.36.120",443,6,366,3,186,3,180,90740.179478,0.9320999999908963,1596.3952365781922,1544.898616043412
"147.32.84.165",1118,"184.82.147.251",80,10,1905,5,982,5,923,90741.111853,0.3224820000032196,24361.049608727208,22897.402025310806
"147.32.84.165",1135,"98.139.175.224",25,3,186,3,186,0,0,90741.218514,9.0009710000013,165.31549762795427,0
"147.32.84.165",1115,"46.4.36.120",443,6,366,3,186,3,180,90743.492607,1.0308490000024904,1443.4703821766382,1396.9068214612628
"147.32.84.165",1136,"216.33.127.20",25,3,186,3,186,0,0,90744.523762,9.007093000007444,165.2031349069861,0
"147.32.84.165",1137,"129.121.213.2",25,3,186,3,186,0,0,90753.129808,9.035321000003023,164.68701001320287,0
"147.32.84.165",1139,"209.85.227.27",25,3,186,3,186,0,0,90753.229704,9.035442000007606,164.68480457278653,0
"147.32.84.165",1125,"46.4.36.120",443,6,366,3,186,3,180,90754.035048,1.0331630000000587,1440.2374068756967,1393.778135686158
"147.32.84.165",1141,"64.12.90.33",25,3,186,3,186,0,0,90754.134849,9.033414000004996,164.72177628515388,0
"147.32.84.165",1127,"216.157.130.15",25,3,186,3,186,0,0,90754.9394,9.031298000001698,164.76036999329668,0
"147.32.84.165",1142,"64.136.44.37",25,3,186,3,186,0,0,90755.040957,9.03024199999345,164.77963713498258,0
"147.32.84.165",1143,"68.6.19.3",25,3,186,3,186,0,0,90755.041034,9.030265000008512,164.77921744252217,0
"147.32.84.165",1148,"98.139.175.224",25,3,186,3,186,0,0,90755.068433,9.00289000000339,165.28026000533603,0
"147.32.84.165",1153,"64.12.138.152",25,3,186,3,186,0,0,90755.068504,9.002840000001015,165.28117793938716,0
"147.32.84.165",1156,"65.54.188.110",25,3,186,3,186,0,0,90755.14066,9.030813999997918,164.7692002072397,0
"147.32.84.165",1072,"117.204.73.9",6667,2,124,2,124,0,0,90762.265282,3.0096210000046995,329.6096086512059,0
"147.32.84.165",1128,"46.4.36.120",443,6,366,3,186,3,180,90765.576749,1.0300229999993462,1444.6279354936196,1398.027034348664
"147.32.84.165",1157,"65.200.108.44",25,3,186,3,186,0,0,90766.606923,8.903642999997828,167.1226036354291,0
"147.32.84.165",1072,"46.4.36.120",443,6,366,3,186,3,180,90774.105446,1.030415000001085,1444.0783567770588,1397.495183977799
"147.32.84.165",1165,"216.32.180.22",25,3,186,3,186,0,0,90774.206078,9.030285999993794,164.77883424744496,0
"147.32.84.165",1166,"201.193.44.200",25,3,186,3,186,0,0,90775.108572,9.030477000007522,164.77534907610755,0
"147.32.84.165",1167,"216.163.188.54",25,3,186,3,186,0,0,90775.136094,9.003083999996306,165.2766985180423,0
"147.32.84.165",1168,"64.12.90.97",25,3,186,3,186,0,0,90775.91137,9.03056800000195,164.77368865387857,0
"147.32.84.165",1169,"74.125.43.27",25,3,186,3,186,0,0,90776.01106,9.031262999997125,164.76100851015784,0
"147.32.84.165",1170,"98.139.175.224",25,3,186,3,186,0,0,90776.011191,9.031256000002031,164.76113621401777,0
"147.32.84.165",1171,"212.82.111.207",25,3,186,3,186,0,0,90776.011255,9.031240999989677,164.76140986623,0
"147.32.84.165",1174,"209.85.227.27",25,3,186,3,186,0,0,90776.111618,9.030685000005178,164.7715538742794,0
"147.32.84.165",1139,"46.4.36.120",443,6,366,3,186,3,180,90776.211832,1.0305139999982202,1443.939626247261,1397.3609286263816
"147.32.84.165",1175,"65.55.37.88",25,3,186,3,186,0,0,90777.242569,9.003191000010702,165.27473425791268,0
"147.32.84.165",1127,"178.90.6.143",6667,6,366,3,186,3,180,90787.551048,1.6712560000014491,890.3483368189611,861.6274227280269
"147.32.84.165",1143,"46.4.36.120",443,6,366,3,186,3,180,90789.222547,0.9651259999955073,1541.7676034081837,1492.033164588565
"147.32.84.165",1177,"205.188.159.42",25,3,186,3,186,0,0,90790.187966,9.006709000008414,165.21017832358189,0
"147.32.84.165",1178,"202.153.104.23",25,3,186,3,186,0,0,90795.279074,8.930843999987701,166.61359217584018,0
"147.32.84.165",1180,"65.55.37.88",25,3,186,3,186,0,0,90796.182907,8.930426000006264,166.6213907375702,0
"147.32.84.165",1182,"205.188.146.194",25,3,186,3,186,0,0,90796.183034,8.930425999991712,166.62139073784172,0
"147.32.84.165",1183,"202.134.61.252",25,3,186,3,186,0,0,90796.183094,8.930416999995941,166.62155865741502,0
"147.32.84.165",1165,"46.4.36.120",443,6,366,3,186,3,180,90796.985466,1.0333790000004228,1439.9363641020295,1393.486803969706
"147.32.84.165",1184,"74.125.113.27",25,3,186,3,186,0,0,90797.086895,8.929036999994423,166.64731034275357,0
"147.32.84.165",1188,"65.54.188.72",25,3,186,3,186,0,0,90797.087041,8.929016999987653,166.6476836142274,0
"147.32.84.165",1189,"65.117.131.163",25,3,186,3,186,0,0,90797.087117,8.928994999994757,166.64809421450832,0
"147.32.84.165",1190,"64.12.90.1",25,3,186,3,186,0,0,90797.18741,8.929025000004913,166.6475343051656,0
"147.32.84.165",1166,"184.82.148.43",80,10,1913,5,991,5,922,90798.019173,0.30757300001278054,25775.99464085134,23981.298747593275
"147.32.84.165",1195,"85.158.139.179",25,3,186,3,186,0,0,90798.120744,8.89874800000689,167.21453399948487,0
"147.32.84.165",1169,"184.82.148.44",80,10,1311,5,584,5,727,90798.292191,0.32635299999674316,14315.786893476157,17821.19361568008
"147.32.84.165",1197,"207.115.21.22",25,3,186,3,186,0,0,90798.399,8.921541999996407,166.78731098285468,0
"147.32.84.165",1169,"46.4.36.120",443,6,366,3,186,3,180,90811.133513,1.0317530000029365,1442.205644176237,1395.6828814608746
"147.32.84.165",1174,"217.163.21.34",80,16,7780,8,2710,8,5070,90812.16553,0.19403400000010151,111732.99524819701,209035.52985548295
"147.32.84.165",1199,"205.188.146.194",25,3,186,3,186,0,0,90812.211374,8.956881999998586,166.12924006370017,0
"147.32.84.165",1207,"207.115.20.22",25,3,186,3,186,0,0,90812.211457,8.956849000009242,166.12985213867785,0
"147.32.84.165",1169,"46.4.36.120",443,6,366,3,186,3,180,90816.249862,1.0330090000061318,1440.4521160911158,1393.9859187978539
"147.32.84.165",1177,"217.163.21.35",80,14,5344,7,2689,7,2655,90817.153421,0.24266899999929592,88647.49926880818,87526.63092550605
"147.32.84.165",1212,"98.139.175.224",25,3,186,3,186,0,0,90817.153528,9.031948000003467,164.74851272388068,0
"147.32.84.165",1213,"209.85.227.27",25,3,186,3,186,0,0,90817.199341,8.986258000004455,165.58616500875698,0
"147.32.84.165",1214,"66.220.20.53",25,3,186,3,186,0,0,90817.283097,9.002648999987287,165.2846845414168,0
"147.32.84.165",1180,"178.133.29.206",6667,3,186,3,186,0,0,90818.058818,9.030687999998918,164.77149913718404,0
"147.32.84.165",1215,"205.188.159.42",25,3,186,3,186,0,0,90818.058957,9.030675999994855,164.77171808631465,0
"147.32.84.165",1217,"205.178.149.7",25,3,186,3,186,0,0,90818.059076,9.030606999993324,164.7729770547096,0
"147.32.84.165",1218,"64.12.90.97",25,3,186,3,186,0,0,90818.158386,9.030966999998782,164.76640873565376,0
"147.32.84.165",1182,"46.4.36.120",443,6,366,3,186,3,180,90819.061889,1.0315739999932703,1442.4558975019797,1395.9250620986902
"147.32.84.165",1219,"74.125.159.27",25,3,186,3,186,0,0,90819.362294,9.033474999989267,164.7206639750227,0
"147.32.84.165",1221,"98.139.175.225",25,3,186,3,186,0,0,90820.093701,9.004265999989002,165.2550024623681,0
"147.32.84.165",1177,"212.117.171.138",65500,33,2805,16,1725,17,1080,90833.212519,185.8867930000124,74.23873303360007,46.47990242103657
"147.32.84.165",1184,"46.4.36.120",443,6,366,3,186,3,180,90833.235003,1.0085840000101598,1475.3357181801525,1427.7442434001475
"147.32.84.165",1190,"184.82.148.43",80,10,1917,5,979,5,938,90834.243848,0.331808999995701,23603.940821681972,22615.420317403154
"147.32.84.165",1222,"209.223.88.11",25,3,186,3,186,0,0,90834.351654,8.997140000006766,165.3858892935845,0
"147.32.84.165",1184,"46.4.36.120",443,6,366,3,186,3,180,90837.928168,1.030534000004991,1443.9116031036274,1397.3338094551232
"147.32.84.165",1230,"98.139.175.224",25,3,186,3,186,0,0,90838.129031,9.0322840000008,164.74238409685393,0
"147.32.84.165",1231,"66.220.20.53",25,3,186,3,186,0,0,90838.129161,9.032273999997415,164.7425664899477,0
"147.32.84.165",1232,"205.188.59.194",25,3,186,3,186,0,0,90838.129215,9.032270000010612,164.74263944703287,0
"147.32.84.165",1233,"148.123.15.75",25,3,186,3,186,0,0,90838.228647,9.033223000005819,164.725259190329,0
"147.32.84.165",1212,"213.33.174.74",6667,6,366,3,186,3,180,90838.959042,1.0411670000030426,1429.1655421230712,1383.0634278610366
"147.32.84.165",1234,"204.93.183.38",25,3,186,3,186,0,0,90839.031518,9.032754999992903,164.73379384265033,0
"147.32.84.165",1237,"68.6.19.3",25,3,186,3,186,0,0,90839.031625,9.032783999995445,164.73326496025481,0
"147.32.84.165",1238,"74.125.157.27",25,3,186,3,186,0,0,90839.131691,9.032972999993945,164.7298181895371,0
"147.32.84.165",1184,"46.4.36.120",443,6,366,3,186,3,180,90840.000447,0.9652199999982258,1541.6174550907929,1491.8878597652833
"147.32.84.165",1239,"64.12.90.1",25,3,186,3,186,0,0,90840.336875,9.03269900000305,164.73481514212946,0
"147.32.84.165",1243,"216.32.180.22",25,3,186,3,186,0,0,90840.965909,9.005544999992708,165.23153235048017,0
"147.32.84.165",1244,"205.188.59.193",25,3,186,3,186,0,0,90841.038603,9.03312600000936,164.72702805191227,0
"147.32.84.165",1218,"46.4.36.120",443,6,366,3,186,3,180,90855.390026,1.0300740000093356,1444.556410497221,1397.9578166102137
"147.32.84.165",1212,"184.82.148.43",80,10,1917,5,979,5,938,90856.420329,0.33965100000204984,23058.96346530036,22093.26632323977
"147.32.84.165",1245,"203.188.197.119",25,3,186,3,186,0,0,90856.532581,8.892962999991141,167.3233094528204,0
"147.32.84.165",1212,"46.4.36.120",443,6,366,3,186,3,180,90859.202617,1.0323760000028415,1441.335327434873,1394.840639453103
"147.32.84.165",1246,"64.12.138.161",25,3,186,3,186,0,0,90859.202726,8.931561999997939,166.6001982632314,0
"147.32.84.165",1247,"209.85.227.27",25,3,186,3,186,0,0,90859.303271,8.931974999999511,166.59249494093763,0
"147.32.84.165",1230,"61.17.216.2",6667,3,186,3,186,0,0,90860.10579,8.931434999991325,166.60256722480153,0
"147.32.84.165",1248,"65.55.37.88",25,3,186,3,186,0,0,90860.1059,8.931448000003002,166.602324729372,0
"147.32.84.165",1255,"209.59.172.38",25,3,186,3,186,0,0,90860.205706,8.931827000007615,166.59525537146334,0
"147.32.84.165",1256,"204.11.209.99",25,3,186,3,186,0,0,90860.235222,8.902432000002591,167.14533736394358,0
"147.32.84.165",1233,"46.4.36.120",443,6,366,3,186,3,180,90861.410866,1.030319999990752,1444.211507117552,1397.624039146018
"147.32.84.165",1258,"65.54.188.94",25,3,186,3,186,0,0,90862.013227,8.930191999999806,166.6257567586489,0
"147.32.84.165",1260,"64.12.90.34",25,3,186,3,186,0,0,90862.112794,8.930370000001858,166.62243557654278,0
"147.32.84.165",1262,"216.32.180.22",25,3,186,3,186,0,0,90862.441424,8.90321399999084,167.13065641256415,0
"147.32.84.165",1212,"46.4.36.120",443,6,366,3,186,3,180,90877.465104,1.0305769999977201,1443.8513570585137,1397.2755068308197
"147.32.84.165",1244,"184.82.148.43",80,10,1917,5,979,5,938,90878.495957,0.34154799999669194,22930.891119479125,21970.557579235363
"147.32.84.165",1263,"205.188.159.42",25,3,186,3,186,0,0,90878.608957,8.992476999992505,165.4716492465024,0
"147.32.84.165",1245,"173.192.170.88",80,11,4301,6,583,5,3718,90880.175799,1.488404999996419,3133.555719049063,19983.80817053931
"147.32.84.165",1212,"46.4.36.120",443,6,366,3,186,3,180,90880.27593,1.0306339999951888,1443.7715037607397,1397.1982294458771
"147.32.84.165",1264,"67.69.240.18",25,3,186,3,186,0,0,90880.376799,9.03129600000102,164.7604064798487,0
"147.32.84.165",1265,"98.139.175.224",25,3,186,3,186,0,0,90880.577042,9.031959999992978,164.74829383668182,0
"147.32.84.165",1267,"203.188.197.119",25,3,186,3,186,0,0,90881.078909,9.031374999991385,164.7589652739942,0
"147.32.84.165",1268,"205.188.59.193",25,3,186,3,186,0,0,90881.178762,9.03183400000853,164.75059218300456,0
"147.32.84.165",1269,"63.209.10.244",25,3,186,3,186,0,0,90881.178895,9.031823999990593,164.75077459453925,0
"147.32.84.165",1270,"209.85.227.27",25,3,186,3,186,0,0,90881.306816,9.004314000005252,165.25412152431957,0
"147.32.84.165",1255,"46.4.36.120",443,6,366,3,186,3,180,90882.986593,1.030579000012949,1443.8485550174255,1397.2727951781537
"147.32.84.165",1272,"64.12.90.1",25,3,186,3,186,0,0,90883.087834,9.028798999992432,164.8059725331406,0
"147.32.84.165",1276,"68.1.17.3",25,3,186,3,186,0,0,90883.387985,9.030236999999033,164.77972837259523,0
"147.32.84.165",1284,"98.139.175.225",25,3,186,3,186,0,0,90884.017429,9.002326999994693,165.2905965314165,0
"147.32.84.165",1258,"46.4.36.120",443,6,366,3,186,3,180,90899.545935,1.0305389999994077,1443.9045974978678,1397.3270298366463
"147.32.84.165",1289,"98.139.175.224",25,3,186,3,186,0,0,90900.576708,9.002677000011317,165.28417047486315,0
"147.32.84.165",1290,"207.130.95.53",25,3,186,3,186,0,0,90900.576769,9.002737999995588,165.2830505564784,0
"147.32.84.165",1292,"202.128.0.48",25,3,186,3,186,0,0,90901.352341,9.029878999994253,164.78626125565438,0
"147.32.84.165",1293,"205.188.146.194",25,3,186,3,186,0,0,90901.55287,9.029964999994263,164.7846918566069,0
"147.32.84.165",1258,"46.4.36.120",443,6,366,3,186,3,180,90902.054038,1.0312419999972917,1442.9202844762992,1396.3744688480315
"147.32.84.165",1296,"205.188.156.193",25,3,186,3,186,0,0,90902.154562,9.03019000000495,164.78058601194263,0
"147.32.84.165",1298,"64.12.90.1",25,3,186,3,186,0,0,90902.154693,9.030180999994627,164.78075024198134,0
"147.32.84.165",1300,"216.32.181.178",25,3,186,3,186,0,0,90902.154748,9.030174999992596,164.78085972876715,0
"147.32.84.165",1301,"200.91.27.32",25,3,186,3,186,0,0,90902.254773,9.030320000005304,164.77821383950138,0
"147.32.84.165",1265,"184.82.148.43",80,10,1917,5,979,5,938,90903.085556,0.3225559999991674,24281.055072670224,23264.177383212125
"147.32.84.165",1302,"124.108.110.37",25,3,186,3,186,0,0,90903.192215,8.995555000001332,165.41502997867053,0
"147.32.84.165",1303,"80.82.234.160",25,3,186,3,186,0,0,90904.060465,9.030098000002909,164.78226482143612,0
"147.32.84.165",1269,"46.4.36.120",443,6,366,3,186,3,180,90904.361993,1.0306839999975637,1443.7014642737417,1397.1304492971694
"147.32.84.165",1304,"98.139.175.224",25,3,186,3,186,0,0,90904.963733,9.030097000009846,164.78228306942634,0
"147.32.84.165",1305,"68.1.17.3",25,3,186,3,186,0,0,90905.392917,9.001971999998204,165.29711489885736,0
"147.32.84.165",1276,"46.4.36.120",443,6,366,3,186,3,180,90921.61762,1.0308139999979176,1443.5193934143367,1396.9542516912936
"147.32.84.165",1306,"68.6.19.3",25,3,186,3,186,0,0,90922.420762,8.92887500001234,166.65033388841746,0
"147.32.84.165",1307,"64.126.190.250",25,3,186,3,186,0,0,90922.621093,8.929499000005308,166.6386882398571,0
"147.32.84.165",1308,"65.55.92.184",25,3,186,3,186,0,0,90922.648673,8.90204200000153,167.1526600301082,0
"147.32.84.165",1309,"64.12.90.97",25,3,186,3,186,0,0,90923.22293,8.929128999996465,166.64559331605457,0
"147.32.84.165",1313,"205.188.159.42",25,3,186,3,186,0,0,90923.223037,8.92912499999511,166.6456679686772,0
"147.32.84.165",1314,"65.55.37.120",25,3,186,3,186,0,0,90923.323343,8.929675999999745,166.6353852032305,0
"147.32.84.165",1292,"46.4.36.120",443,6,366,3,186,3,180,90924.226002,1.0312680000060936,1442.8839060178418,1396.339263888234
"147.32.84.165",1319,"98.139.175.224",25,3,186,3,186,0,0,90925.129163,8.929111999997986,166.64591059002683,0
"147.32.84.165",1320,"209.85.227.27",25,3,186,3,186,0,0,90925.12929,8.929109999997308,166.64594791647193,0
"147.32.84.165",1321,"65.54.188.72",25,3,186,3,186,0,0,90925.257555,8.90158999999403,167.16114761531344,0
"147.32.84.165",1323,"202.238.83.11",25,3,186,3,186,0,0,90926.031848,8.929757000005338,166.63387368761664,0
"147.32.84.165",1300,"46.4.36.120",443,6,366,3,186,3,180,90926.433494,1.0315249999985099,1442.524417733113,1395.991371999787
"147.32.84.165",1301,"184.82.148.43",80,10,1917,5,979,5,938,90927.465256,0.33997900001122616,23036.71697293476,22071.951502158125
"147.32.84.165",1325,"205.188.190.2",25,3,186,3,186,0,0,90927.577752,8.988838999997824,165.53861961487576,0
"147.32.84.165",1304,"198.41.9.32",6667,3,186,3,186,0,0,90943.389029,9.03078600000299,164.76971107492827,0
"147.32.84.165",1292,"46.4.36.120",443,6,366,3,186,3,180,90943.589883,1.0318510000070091,1442.0686707575924,1395.5503265396055
"147.32.84.165",1302,"184.82.148.44",80,10,1512,5,594,5,918,90943.59004,0.3228090000047814,14720.779160214288,22750.295065785718
"147.32.84.165",1329,"64.12.90.34",25,3,186,3,186,0,0,90943.696622,9.024676999993972,164.88124727355827,0
"147.32.84.165",1306,"217.163.21.39",80,14,6141,7,810,7,5331,90944.193022,0.18942199999582954,34209.33154619141,225148.082065119
"147.32.84.165",1333,"65.55.37.104",25,3,186,3,186,0,0,90944.193171,9.029765999992378,164.7883234184868,0
"147.32.84.165",1335,"68.6.19.3",25,3,186,3,186,0,0,90944.23916,8.983898999998928,165.62964476784273,0
"147.32.84.165",1337,"98.139.175.224",25,3,186,3,186,0,0,90944.292919,9.029674000004889,164.79000238537895,0
"147.32.84.165",1302,"217.163.21.39",80,10,1451,5,701,5,750,90944.621952,0.13916500000050291,40297.48859253213,43114.288793721964
"147.32.84.165",1338,"67.195.168.31",25,3,186,3,186,0,0,90944.667818,8.956046999999671,166.1447288072578,0
"147.32.84.165",1292,"46.4.36.120",443,6,366,3,186,3,180,90946.09984,1.031068000011146,1443.163787435857,1396.61011687341
"147.32.84.165",1309,"217.163.21.38",80,11,4329,6,2700,5,1629,90946.200281,0.22734800000034738,95008.53317366766,57321.81501477949
"147.32.84.165",1339,"205.188.159.42",25,3,186,3,186,0,0,90946.246103,8.98437200000626,165.62092486808908,0
"147.32.84.165",1342,"199.228.142.101",25,3,186,3,186,0,0,90947.002557,9.03024199999345,164.77963713498258,0
"147.32.84.165",1306,"217.163.21.40",80,10,2277,5,1156,5,1121,90947.131133,0.14014099999621976,65990.68081610279,63992.69307513082
"147.32.84.165",1343,"205.188.59.193",25,3,186,3,186,0,0,90947.177198,8.955909999989672,166.14727035016162,0
"147.32.84.165",1292,"46.4.36.120",443,6,366,3,186,3,180,90948.608024,1.0301259999978356,1444.4834903721744,1397.8872487472654
"147.32.84.165",1319,"217.163.21.38",80,14,6747,7,3215,7,3532,90949.638392,0.2208600000012666,116453.86217446573,127936.24920690915
"147.32.84.165",1344,"74.125.43.27",25,3,186,3,186,0,0,90949.684278,8.864446999999927,167.86157106021528,0
"147.32.84.165",1292,"46.4.36.120",443,6,366,3,186,3,180,90964.370408,1.030637999996543,1443.765900350066,1397.1928067903864
"147.32.84.165",1325,"109.169.13.214",80,11,7811,7,1663,4,6148,90964.671286,0.10170100000686944,130814.83956992926,483613.7304124625
"147.32.84.165",1345,"64.12.90.34",25,3,186,3,186,0,0,90964.697485,9.003630000006524,165.2666757739847,0
"147.32.84.165",1304,"109.169.13.214",80,10,2463,5,1634,5,829,90965.172673,0.10628700000233948,122987.75955396495,62397.09465742775
"147.32.84.165",1348,"74.125.159.27",25,3,186,3,186,0,0,90965.172804,9.029951000004075,164.7849473379566,0
"147.32.84.165",1329,"109.169.13.223",80,31,28317,17,1697,14,26620,90965.202069,0.11626299998897593,116769.73758880535,1831709.1423771353
"147.32.84.165",1349,"65.54.188.110",25,3,186,3,186,0,0,90965.231661,8.971226000008755,165.8636177484045,0
"147.32.84.165",1366,"209.85.227.27",25,3,186,3,186,0,0,90965.292519,9.009967000005418,165.15043839773278,0
"147.32.84.165",1367,"98.139.175.224",25,3,186,3,186,0,0,90965.401257,9.002097999997204,165.29480127859773,0
"147.32.84.165",1368,"65.55.37.104",25,3,186,3,186,0,0,90965.574119,9.03005000000121,164.78314073563274,0
"147.32.84.165",1333,"46.4.36.120",443,6,366,3,186,3,180,90967.179075,1.030389000006835,1444.1147954705743,1397.530447229588
"147.32.84.165",1370,"195.50.106.142",25,3,186,3,186,0,0,90967.981794,9.02945999999065,164.79390794150933,0
"147.32.84.165",1371,"65.55.92.184",25,3,186,3,186,0,0,90968.082208,9.02977199999441,164.78821392178244,0
"147.32.84.165",1373,"64.12.90.98",25,3,186,3,186,0,0,90968.209702,9.002115000010235,165.2944891282002,0
"147.32.84.165",1292,"46.4.36.120",443,6,366,3,186,3,180,90970.590247,1.0314800000051036,1442.587350208087,1396.052274394923
"147.32.84.165",1374,"208.83.68.171",25,3,186,3,186,0,0,90971.621978,9.001178000005893,165.31169586903243,0
"147.32.84.165",1338,"212.117.171.138",65500,18,2841,9,1914,9,927,90985.739558,21.931878000003053,698.1618263606002,338.1379378454945
"147.32.84.165",1292,"46.4.36.120",443,6,366,3,186,3,180,90985.739705,1.0312560000020312,1442.9006958476548,1396.3555121106338
"147.32.84.165",1375,"74.208.5.3",25,3,186,3,186,0,0,90986.241375,8.930145999998786,166.62661506320305,0
"147.32.84.165",1343,"205.188.186.167",587,23,2188,13,827,10,1361,90986.241435,32.95223399999668,200.77546183972433,330.4176584810941
"147.32.84.165",1376,"202.108.67.233",25,3,186,3,186,0,0,90986.341479,8.930111000008765,166.6272681267388,0
"147.32.84.165",1377,"207.115.20.23",25,3,186,3,186,0,0,90986.358816,8.912894999986747,166.94912259172946,0
"147.32.84.165",1378,"64.12.138.161",25,3,186,3,186,0,0,90986.442231,8.929628000012599,166.63628092882487,0
"147.32.84.165",1380,"64.207.35.180",25,3,186,3,186,0,0,90986.643322,8.929493000003276,166.6388002095364,0
"147.32.84.165",1382,"76.96.62.116",25,3,186,3,186,0,0,90986.771225,8.901384999990114,167.1649973573385,0
"147.32.84.165",1366,"46.4.36.120",443,6,366,3,186,3,180,90988.9507,1.0318949999928009,1442.0071809732397,1395.4908202966835
"147.32.84.165",1384,"217.19.237.56",25,3,186,3,186,0,0,90989.051783,9.030077999996138,164.7826297846637,0
"147.32.84.165",1386,"98.139.175.224",25,3,186,3,186,0,0,90989.150952,9.031362000008812,164.75920243242913,0
"147.32.84.165",1388,"65.55.92.184",25,3,186,3,186,0,0,90989.982837,9.00146699999459,165.30638839212477,0
"147.32.84.165",1371,"212.117.171.138",65500,18,2480,9,1224,9,1256,90992.563331,19.7334669999982,496.2128550447265,509.185740143935
"147.32.84.165",1366,"46.4.36.120",443,6,366,3,186,3,180,90992.563459,1.0310210000025108,1443.2295753397616,1396.673782586866
"147.32.84.165",1389,"168.95.5.63",25,3,186,3,186,0,0,90993.594721,9.001986999996006,165.296839464516,0
"147.32.84.165",1373,"64.12.75.1",80,8,2231,5,683,3,1548,91007.212593,0.5528760000015609,9882.867044300303,22399.235994988092
"147.32.84.165",1374,"46.4.36.120",443,6,366,3,186,3,180,91007.313462,1.031580999988364,1442.4461094347262,1395.9155897755413
"147.32.84.165",1391,"64.12.90.1",25,3,186,3,186,0,0,91007.313571,9.030321999991429,164.77817734532746,0
"147.32.84.165",1392,"193.49.37.67",25,3,186,3,186,0,0,91007.330255,9.013761000009254,165.08092459945104,0
"147.32.84.165",1395,"207.115.21.24",25,3,186,3,186,0,0,91007.413647,9.030856000012136,164.7684339112483,0
"147.32.84.165",1398,"174.120.23.67",25,3,186,3,186,0,0,91007.614407,9.030641999997897,164.77233844507916,0
"147.32.84.165",1399,"210.22.89.136",25,3,186,3,186,0,0,91007.71426,9.032207000011113,164.74378853343035,0
"147.32.84.165",1402,"65.55.37.104",25,3,186,3,186,0,0,91008.345318,9.002141999997548,165.293993362958,0
"147.32.84.165",1375,"212.117.171.138",65500,15,912,8,486,7,426,91010.124267,18.579048999992665,209.2679770639248,183.43242433998347
"147.32.84.165",1378,"46.4.36.120",443,6,366,3,186,3,180,91010.124394,1.0312830000038957,1442.8629192902229,1396.3189541518286
"147.32.84.165",1403,"64.12.90.66",25,3,186,3,186,0,0,91010.225196,8.928052999995998,166.66567727596006,0
"147.32.84.165",1380,"206.222.227.2",80,8,1870,5,1012,3,858,91011.027293,1.2663859999884153,6392.995500640453,5420.148359238645
"147.32.84.165",1409,"209.85.227.27",25,3,186,3,186,0,0,91011.047286,8.907923999999184,167.04228729388984,0
"147.32.84.165",1410,"65.54.188.110",25,3,186,3,186,0,0,91011.155941,8.899860999998054,167.19362246223005,0
"147.32.84.165",1374,"80.191.187.36",6667,2,124,2,124,0,0,91014.638402,3.00987900000473,329.5813552632651,0
"147.32.84.165",1382,"46.4.36.120",443,6,366,3,186,3,180,91028.284834,1.0309389999893028,1443.3443685954646,1396.7848728343206
"147.32.84.165",1337,"174.133.57.141",80,17,12629,9,894,8,11735,91028.284985,3.384779999993043,2112.9881410356656,27735.923752856303
"147.32.84.165",1411,"64.12.90.98",25,3,186,3,186,0,0,91028.385246,9.032202999995206,164.74386149212873,0
"147.32.84.165",1371,"94.100.176.20",25,3,186,3,186,0,0,91028.444472,8.97310099999595,165.82895924170157,0
"147.32.84.165",1414,"74.125.113.27",25,3,186,3,186,0,0,91028.586297,9.032580999992206,164.7369672080753,0
"147.32.84.165",1386,"212.117.171.138",65500,32,8756,16,6604,16,2152,91028.686415,4.43074599999818,11923.951406833454,3885.5759278476066
"147.32.84.165",1415,"98.139.175.224",25,3,186,3,186,0,0,91028.686566,9.031644000002416,164.7540580651321,0
"147.32.84.165",1420,"193.25.197.210",25,3,186,3,186,0,0,91029.288587,9.032597999990685,164.73665716126573,0
"147.32.84.165",1421,"207.115.21.24",25,3,186,3,186,0,0,91029.316,9.005306999999448,165.23589923143,0
"147.32.84.165",1375,"46.4.36.120",443,6,366,3,186,3,180,91031.19614,1.0318660000048112,1442.047707738274,1395.530039746717
"147.32.84.165",1403,"50.56.83.42",80,8,1185,5,621,3,564,91031.999809,63.170782000001054,78.64395283249647,71.42542576091466
"147.32.84.165",1422,"202.214.41.103",25,3,186,3,186,0,0,91032.100391,9.029819000003044,164.78735620276535,0
"147.32.84.165",1395,"212.117.171.138",65500,15,912,8,486,7,426,91032.13002,17.642982999997912,220.37089759710477,193.1646139431412
"147.32.84.165",1426,"205.188.159.42",25,3,186,3,186,0,0,91032.130093,9.000218000001041,165.32932868957482,0
"147.32.84.165",1384,"206.222.227.2",443,21,8092,11,1848,10,6244,91032.228232,0.874154000004637,16912.351828077863,57143.249358505505
"147.32.84.165",1429,"64.12.90.97",25,3,186,3,186,0,0,91032.248067,8.982385000010254,165.6575619947599,0
"147.32.84.165",1392,"98.154.67.160",6667,3,186,3,186,0,0,91033.113973,9.019367000000784,164.97831832321165,0
"147.32.84.165",1375,"46.4.36.120",443,6,366,3,186,3,180,91049.459399,0.9312230000068666,1597.8986773189963,1546.353558695803
"147.32.84.165",1392,"184.82.148.43",80,10,1923,5,983,5,940,91049.459532,0.30406600001151673,25862.80610032738,24731.472771421908
"147.32.84.165",1337,"174.129.193.6",80,37,43372,24,1765,13,41607,91049.55998,0.8838529999920866,15975.50723946903,376596.5607436759
"147.32.84.165",1430,"98.139.175.225",25,3,186,3,186,0,0,91049.659948,8.930791999999201,166.61456229191467,0
"147.32.84.165",1371,"74.125.93.27",25,3,186,3,186,0,0,91049.680918,8.909949000008055,167.0043229202159,0
"147.32.84.165",1411,"184.82.148.44",80,10,1513,5,596,5,917,91049.761862,0.3241330000018934,14710.011013911415,22632.684731135516
"147.32.84.165",1431,"209.202.252.61",25,3,186,3,186,0,0,91049.868802,9.02415199999814,164.89083960468605,0
"147.32.84.165",1414,"217.163.21.40",80,14,6137,7,809,7,5328,91050.263002,0.18718999999691732,34574.496501450834,227704.47139645249
"147.32.84.165",1384,"174.129.193.6",80,41,52785,29,2108,12,50677,91050.263131,0.8568979999981821,19680.28866917157,473120.4880871003
"147.32.84.165",1432,"130.164.80.6",25,3,186,3,186,0,0,91050.263185,9.030394000001252,164.77686355653958,0
"147.32.84.165",1392,"209.85.148.147",80,37,25471,16,1237,21,24234,91050.308897,0.056593000001157634,174862.61551424334,3425724.029403535
"147.32.84.165",1433,"64.12.138.152",25,3,186,3,186,0,0,91050.317997,8.975703999996767,165.78086799659792,0
"147.32.84.165",1395,"216.137.61.37",443,19,15911,12,1220,7,14691,91050.390796,69.79025799999363,139.84759878665145,1684.0172735858166
"147.32.84.165",1434,"195.7.102.21",25,3,186,3,186,0,0,91050.410382,8.983861999993678,165.63032691297428,0
"147.32.84.165",1411,"212.117.171.138",65500,14,852,8,486,6,366,91053.072006,17.941133000000264,216.7087217958834,163.20039542652947
"147.32.84.165",1420,"46.4.36.120",443,6,366,3,186,3,180,91053.072138,1.0308579999982612,1443.4577798324403,1396.894625644297
"147.32.84.165",1386,"217.163.21.40",80,10,1448,5,699,5,749,91053.094505,0.14014800000586547,39900.67642610643,42754.80206459759
"147.32.84.165",1392,"74.125.232.220",80,17,6847,8,699,9,6148,91053.140621,0.027486999999382533,203441.62695549236,1789354.9678431575
"147.32.84.165",1436,"64.12.90.1",25,3,186,3,186,0,0,91053.148782,8.954824000000372,166.16741992918435,0
"147.32.84.165",1438,"205.188.59.193",25,3,186,3,186,0,0,91053.172631,9.031337000007625,164.7596585088945,0
"147.32.84.165",1337,"217.163.21.38",80,10,1497,5,691,5,806,91053.67391,0.1444540000084089,38268.23763743618,44637.047085055805
"147.32.84.165",1421,"74.125.232.220",80,65,50460,28,1895,37,48565,91053.719895,0.0545200000051409,278063.0960852991,7126192.222365461
"147.32.84.165",1439,"64.12.90.34",25,3,186,3,186,0,0,91053.728352,8.977421999996295,165.74914268267818,0
"147.32.84.165",1392,"187.106.81.34",6667,3,186,3,186,0,0,91054.103215,9.00390700000571,165.2615914401444,0
"147.32.84.165",1429,"46.4.36.120",443,6,366,3,186,3,180,91070.633543,1.0305439999938244,1443.897591960088,1397.320250283956
"147.32.84.165",1384,"77.238.167.32",80,8,1719,5,748,3,971,91070.633676,0.14053400000557303,42580.44316508957,55274.88009799729
"147.32.84.165",1375,"74.125.232.202",443,19,7308,9,1034,10,6274,91070.679724,0.08382600000186358,98680.60028888533,598764.1065884589
"147.32.84.165",1440,"170.64.0.111",25,3,186,3,186,0,0,91070.688094,8.975722999995924,165.7805170681711,0
"147.32.84.165",1371,"74.125.39.27",25,3,186,3,186,0,0,91070.933676,9.032051000001957,164.74663395940496,0
"147.32.84.165",1337,"184.82.148.43",80,10,1923,5,983,5,940,91071.33551,0.32214099999691825,24411.670666184156,23343.815286076406
"147.32.84.165",1375,"74.125.232.223",443,18,4898,9,1077,9,3821,91071.335643,0.051015999997616746,168888.19194767336,599184.5695748002
"147.32.84.165",1443,"64.12.90.1",25,3,186,3,186,0,0,91071.34381,9.022048999991966,164.9292749353639,0
"147.32.84.165",1426,"212.117.171.138",65500,14,852,7,426,7,426,91071.343869,0.5142649999907007,6626.933584944777,6626.933584944777
"147.32.84.165",1430,"217.163.21.38",80,11,2608,6,797,5,1811,91071.366497,0.24398400000063702,26132.86117115611,59380.94301250153
"147.32.84.165",1384,"72.21.214.199",80,36,36361,22,1952,14,34409,91071.412542,63.77578499999072,244.85782495663946,4316.246362158303
"147.32.84.165",1444,"174.143.82.64",25,3,186,3,186,0,0,91071.436331,9.030421999996179,164.77635264449765,0
"147.32.84.165",1431,"72.21.214.199",80,50,47562,28,2532,22,45030,91071.442096,63.74647700000787,317.7587366906174,5651.135826689771
"147.32.84.165",1446,"67.212.76.149",25,3,186,3,186,0,0,91071.442127,9.024764999994659,164.8796395253373,0
"147.32.84.165",1411,"94.127.76.60",80,12,5373,8,710,4,4663,91071.533627,63.654473000002326,89.2317496682408,586.0389418352208
"147.32.84.165",1447,"98.139.175.224",25,3,186,3,186,0,0,91071.548136,9.018756999998004,164.98947693128102,0
"147.32.84.165",1432,"184.82.148.44",80,10,1514,5,596,5,918,91071.664331,0.3041779999912251,15675.032382807261,24143.75793190783
"147.32.84.165",1422,"94.127.76.60",80,11,4352,7,651,4,3701,91071.764698,63.423165000000154,82.11510731134258,466.832583962026
"147.32.84.165",1448,"200.37.120.19",25,3,186,3,186,0,0,91071.764762,8.90313399999286,167.13215818173614,0
"147.32.84.165",1434,"212.117.171.138",65500,9,544,5,302,4,242,91074.145545,3.005309000000125,803.9106794009866,644.1933258776118
"147.32.84.165",1430,"46.4.36.120",443,6,366,3,186,3,180,91074.168269,1.0079160000022966,1476.3135023123052,1428.6904861086825
"147.32.84.165",1433,"217.163.21.40",80,10,2274,5,1154,5,1120,91074.24555,0.13984199998958502,66017.36245682677,64072.31018340206
"147.32.84.165",1375,"2.21.100.16",80,8,3194,5,535,3,2659,91074.291501,60.89614100000472,70.28359974402431,349.31605928852457
"147.32.84.165",1450,"207.115.21.24",25,3,186,3,186,0,0,91074.298954,8.87710500000685,167.62221467458724,0
"147.32.84.165",1426,"217.163.21.34",80,13,6081,6,750,7,5331,91074.747214,0.18692300000111572,32098.778641281096,228158.11858222604
"147.32.84.165",1429,"204.93.223.146",80,8,923,5,574,3,349,91074.747525,60.43988900000113,75.9763142516677,46.19465796834848
"147.32.84.165",1451,"195.50.106.142",25,3,186,3,186,0,0,91074.793078,8.885202999998,167.46944329806925,0
"147.32.84.165",1436,"217.163.21.39",80,11,3169,6,1376,5,1793,91074.876341,0.1528519999992568,72017.37628590743,93842.40965162212
"147.32.84.165",1432,"74.217.252.32",80,7,1196,5,530,2,666,91074.922221,60.26495699999214,70.35597818481067,88.40958768129039
"147.32.84.165",1453,"205.188.159.42",25,3,186,3,186,0,0,91075.042297,8.83705899999768,168.38181118858554,0
"147.32.84.165",1426,"61.17.216.92",6667,10,1153,5,595,5,558,91075.176394,1.0655830000032438,4467.038231639872,4189.256022277393
"147.32.84.165",1433,"217.163.21.34",80,10,1451,5,701,5,750,91075.376292,0.13978399999905378,40119.04080608626,42923.36748154735
"147.32.84.165",1454,"65.54.188.72",25,3,186,3,186,0,0,91075.422359,8.85838099999819,167.97651850832608,0
"147.32.84.165",1434,"212.117.171.138",65500,15,929,9,546,6,383,91091.605899,43.17136999999639,101.17816506634757,70.9729619421449
"147.32.84.165",1430,"46.4.36.120",443,6,366,3,186,3,180,91091.629063,1.0080610000004526,1476.1011486401437,1428.4849825549777
"147.32.84.165",1439,"195.113.232.90",80,56,67137,39,5556,17,61581,91091.907248,61.26588399999309,725.4934899822063,8041.147337399972
"147.32.84.165",1455,"64.12.90.66",25,3,186,3,186,0,0,91091.908254,9.027618000007351,164.827532578227,0
"147.32.84.165",1371,"66.111.4.71",25,3,186,3,186,0,0,91092.408523,9.029066999995848,164.80108077619585,0
"147.32.84.165",1456,"67.195.168.31",25,3,186,3,186,0,0,91092.408662,9.029026000003796,164.80182912302772,0
"147.32.84.165",1440,"195.113.232.99",80,11,2010,6,685,5,1325,91092.609488,0.026148999997531064,209568.24354726417,405369.2302191606
"147.32.84.165",1458,"74.125.159.27",25,3,186,3,186,0,0,91092.610346,9.02802499999234,164.82010184965844,0
"147.32.84.165",1443,"217.163.21.41",80,11,2951,6,1027,5,1924,91092.63739,0.25957399999606423,31651.860356293677,59297.15611052486
"147.32.84.165",1459,"205.188.190.2",25,3,186,3,186,0,0,91092.683316,8.955155000003288,166.16127805710272,0
"147.32.84.165",1460,"207.115.21.22",25,3,186,3,186,0,0,91092.709816,9.028871000002255,164.80465830109085,0
"147.32.84.165",1446,"46.4.36.120",443,6,366,3,186,3,180,91095.217653,1.0302599999995437,1444.295614699842,1397.7054335804921
"147.32.84.165",1440,"217.163.21.41",80,14,6151,7,1141,7,5010,91095.718795,0.18941400000767317,48190.73563532909,211599.98732077016
"147.32.84.165",1461,"65.55.37.72",25,3,186,3,186,0,0,91095.764699,8.985075999997207,165.60794811312255,0
"147.32.84.165",1444,"195.113.232.97",80,8,1425,5,851,3,574,91095.91944,63.06210799999826,107.95706353489147,72.81710278381634
"147.32.84.165",1462,"64.12.90.65",25,3,186,3,186,0,0,91095.920232,9.030022999999346,164.78363344147715,0
"147.32.84.165",1443,"180.242.10.201",6667,3,186,3,186,0,0,91096.248029,9.003595000001951,165.26731822118583,0
"147.32.84.165",1448,"184.82.148.43",80,10,1927,5,987,5,940,91096.321176,0.322931000002427,24451.043721230406,23286.70830593372
"147.32.84.165",1463,"98.139.175.224",25,3,186,3,186,0,0,91096.427785,9.024229999995441,164.88941438779284,0
"147.32.84.165",1440,"46.4.36.120",443,6,366,3,186,3,180,91112.877209,1.0308689999947092,1443.4423772638784,1396.8797199327855
"147.32.84.165",1430,"217.163.21.41",80,11,3544,6,1084,5,2460,91113.378566,0.24279499999829568,35717.37474025772,81056.03492715313
"147.32.84.165",1464,"206.46.232.11",25,3,186,3,186,0,0,91113.378599,9.032877999998163,164.73155067524465,0
"147.32.84.165",1453,"212.117.171.138",65500,9,544,5,302,4,242,91113.426161,252.24852700000338,9.57785573114553,7.674970486547079
"147.32.84.165",1371,"216.157.130.15",25,3,186,3,186,0,0,91113.426227,8.98530899999605,165.60365369745816,0
"147.32.84.165",1450,"184.82.148.44",80,10,1514,5,596,5,918,91113.579256,0.34656200000608806,13758.000011300259,21191.013440224226
"147.32.84.165",1467,"205.188.146.193",25,3,186,3,186,0,0,91113.579312,9.032976000002236,164.72976347990203,0
"147.32.84.165",1455,"67.195.168.230",25,3,186,3,186,0,0,91113.679802,9.032271999996738,164.74260296861493,0
"147.32.84.165",1456,"195.113.232.88",80,33,37944,22,2700,11,35244,91113.692034,84.51897599999211,255.5639102868688,3335.960908944594
"147.32.84.165",1472,"207.115.21.24",25,3,186,3,186,0,0,91113.693217,9.01899600001343,164.98510477194847,0
"147.32.84.165",1430,"217.163.21.34",80,13,6078,6,750,7,5328,91113.908311,0.19214599998667836,31226.255037398565,221831.3157856794
"147.32.84.165",1473,"66.94.236.34",25,3,186,3,186,0,0,91113.954405,8.958657000010135,166.09632448237684,0
"147.32.84.165",1460,"46.4.36.120",443,6,366,3,186,3,180,91116.691081,1.0311579999979585,1443.0378273775173,1396.4882200427587
"147.32.84.165",1458,"217.163.21.34",80,10,1449,5,700,5,749,91116.891517,0.13956000001053326,40126.11063039081,42934.93837451816
"147.32.84.165",1475,"209.85.227.27",25,3,186,3,186,0,0,91116.891704,9.032004000007873,164.74749125428895,0
"147.32.84.165",1476,"205.188.146.193",25,3,186,3,186,0,0,91116.937431,8.986375000007683,165.58400912478365,0
"147.32.84.165",1478,"205.188.59.193",25,3,186,3,186,0,0,91116.937491,8.986338999995496,165.58467246792557,0
"147.32.84.165",1440,"82.232.103.247",6667,3,186,3,186,0,0,91117.393421,9.031994000004488,164.7476736586916,0
"147.32.84.165",1479,"74.208.5.90",25,3,186,3,186,0,0,91117.724244,9.002057999998215,165.29553575419033,0
"147.32.84.165",1430,"46.4.36.120",443,6,366,3,186,3,180,91134.45203,1.0299450000020443,1444.7373403405488,1398.1329100069827
"147.32.84.165",1461,"217.163.21.34",80,11,3225,6,1172,5,2053,91134.452181,0.23661999999603722,39624.71473314607,69410.86975012704
"147.32.84.165",1480,"76.96.30.116",25,3,186,3,186,0,0,91134.498201,8.883203999997932,167.50712918450893,0
"147.32.84.165",1460,"184.82.148.43",80,10,1905,5,987,5,918,91134.653354,0.3263300000107847,24196.365641341738,22504.82640197742
"147.32.84.165",1482,"74.125.113.27",25,3,186,3,186,0,0,91134.75275,8.929252999994787,166.64327911874247,0
"147.32.84.165",1483,"65.55.92.152",25,3,186,3,186,0,0,91134.752889,8.929237999996985,166.6435590585112,0
"147.32.84.165",1485,"64.12.90.66",25,3,186,3,186,0,0,91134.76108,8.921096000005491,166.79564932370238,0
"147.32.84.165",1461,"184.82.148.44",80,10,1306,5,579,5,727,91134.953273,0.32312599998840597,14334.965308165236,17999.17060282578
"147.32.84.165",1491,"68.1.17.3",25,3,186,3,186,0,0,91135.059912,8.923227000006591,166.7558160292124,0
"147.32.84.165",1467,"217.163.21.34",80,13,5961,6,950,7,5011,91135.482122,0.18701500000315718,40638.45146042669,214357.1371244191
"147.32.84.165",1492,"98.139.175.224",25,3,186,3,186,0,0,91135.527936,8.856461000003037,168.01293428599638,0
"147.32.84.165",1411,"46.4.36.120",443,6,366,3,186,3,180,91137.964,1.0308839999925112,1443.4213742873198,1396.8593944716
"147.32.84.165",1384,"217.163.21.34",80,11,3504,6,985,5,2519,91137.964135,0.24638199999753851,31982.855890766066,81791.68932877129
"147.32.84.165",1493,"128.121.85.2",25,3,186,3,186,0,0,91137.964199,8.928260000000591,166.6618131640321,0
"147.32.84.165",1494,"65.55.37.120",25,3,186,3,186,0,0,91138.010019,8.882577000011224,167.5189531144081,0
"147.32.84.165",1431,"202.106.32.73",6667,3,186,3,186,0,0,91138.766647,8.92856300000858,166.65615732325236,0
"147.32.84.165",1495,"189.42.60.60",25,3,186,3,186,0,0,91138.995102,8.901419999994687,167.16434007168385,0
"147.32.84.165",1432,"46.4.36.120",443,6,366,3,186,3,180,91155.421897,1.0307320000138134,1443.634232739508,1397.0653865221045
"147.32.84.165",1448,"184.82.148.43",80,10,1921,5,983,5,938,91155.723138,0.3243419999926118,24246.011926235682,23136.0724179136
"147.32.84.165",1439,"74.117.116.92",80,11,3376,6,586,5,2790,91155.723237,0.8955969999951776,5234.4972125020995,24921.923588533886
"147.32.84.165",1497,"64.12.90.33",25,3,186,3,186,0,0,91155.723268,9.033702999993693,164.71650661982565,0
"147.32.84.165",1500,"94.245.120.86",25,3,186,3,186,0,0,91155.82968,9.027216000002227,164.83487267831333,0
"147.32.84.165",1501,"213.188.129.249",25,3,186,3,186,0,0,91155.861943,8.995076999999583,165.42382016297015,0
"147.32.84.165",1467,"184.82.148.44",80,10,1511,5,594,5,917,91156.023691,0.3229819999978645,14712.894217112469,22713.340062444673
"147.32.84.165",1502,"64.12.90.66",25,3,186,3,186,0,0,91156.130236,9.027176000003237,164.83560307226384,0
"147.32.84.165",1475,"217.163.21.34",80,14,6137,7,809,7,5328,91156.42524,0.1925350000092294,33614.6674614473,221383.12513546506
"147.32.84.165",1503,"205.188.190.2",25,3,186,3,186,0,0,91156.452878,9.006164999998873,165.22015752544908,0
"147.32.84.165",1505,"85.17.178.157",25,3,186,3,186,0,0,91156.471167,8.987997999996878,165.55410893510623,0
"147.32.84.165",1432,"46.4.36.120",443,6,366,3,186,3,180,91158.934914,1.0309879999986151,1443.2757704279766,1396.7184875109451
"147.32.84.165",1478,"217.163.21.34",80,10,1448,5,699,5,749,91158.935048,0.14045500000065658,39813.46338666377,42661.350610316396
"147.32.84.165",1476,"74.117.116.92",80,15,12210,10,1241,5,10969,91158.980994,1.1247030000085942,8827.219274709978,78022.37568436241
"147.32.84.165",1507,"209.85.227.27",25,3,186,3,186,0,0,91159.035954,9.030885999993188,164.76788656186363,0
"147.32.84.165",1448,"111.253.202.95",6667,3,186,3,186,0,0,91159.127344,8.93961900001159,166.45004669640517,0
"147.32.84.165",1439,"217.163.21.34",80,10,1497,5,691,5,806,91159.938224,0.14189800000167452,38957.561064530615,45441.09148771588
"147.32.84.165",1475,"74.117.116.92",80,11,7313,7,995,4,6318,91159.966159,0.44800399999076035,17767.698503058382,112820.42124856569
"147.32.84.165",1508,"205.188.159.42",25,3,186,3,186,0,0,91159.966191,9.003547000000253,165.26819929967135,0
"147.32.84.165",1480,"74.117.116.92",80,10,1553,5,874,5,679,91159.984432,0.4260340000037104,16411.83567494403,12750.156090717388
"147.32.84.165",1510,"77.238.177.9",25,3,186,3,186,0,0,91159.984462,8.98539700001129,165.60203182988246,0
"147.32.84.165",1444,"46.4.36.120",443,6,366,3,186,3,180,91176.695754,1.0304739999992307,1443.9956757774683,1397.4151701072274
"147.32.84.165",1482,"77.238.167.32",80,8,1719,5,748,3,971,91176.795388,0.14032000000588596,42645.38198224766,55359.17901706213
"147.32.84.165",1483,"74.117.116.92",80,4,244,3,182,1,62,91176.795506,0.1362070000031963,10689.61213422095,3641.516221547796
"147.32.84.165",1511,"64.235.144.69",25,3,186,3,186,0,0,91176.841371,8.984364000003552,165.62107234295178,0
"147.32.84.165",1478,"184.82.148.43",80,10,1921,5,983,5,938,91176.931441,0.3234950000041863,24309.494736852914,23196.649097831163
"147.32.84.165",1485,"74.117.116.92",80,4,244,3,182,1,62,91177.038285,0.144295999998576,10090.369795520102,3437.378721550804
"147.32.84.165",1512,"65.55.37.104",25,3,186,3,186,0,0,91177.096232,9.030209000004106,164.78023930557126,0
"147.32.84.165",1497,"217.163.21.34",80,11,2964,6,797,5,2167,91177.182307,0.22466300000087358,28380.285138074392,77164.46410816463
"147.32.84.165",1492,"195.113.232.91",80,4,244,3,182,1,62,91177.22829,0.0011599999997997656,0,0
"147.32.84.165",1513,"98.139.175.224",25,3,186,3,186,0,0,91177.229173,8.997308000005432,165.38280116664913,0
"147.32.84.165",1482,"184.82.148.44",80,10,1511,5,594,5,917,91177.397651,0.33951999999408145,13996.229971968773,21606.9745526858
"147.32.84.165",1439,"74.117.116.92",80,15,12189,10,1208,5,10981,91177.397785,0.8322630000038771,11611.714085517415,105553.17249426054
"147.32.84.165",1517,"68.1.17.3",25,3,186,3,186,0,0,91177.509938,9.018074999999953,165.001954408231,0
"147.32.84.165",1521,"216.163.188.57",25,3,186,3,186,0,0,91177.536619,8.99151599999459,165.4893346128612,0
"147.32.84.165",1500,"173.192.170.88",80,11,4306,6,583,5,3723,91177.726512,2.7382980000111274,1703.2477838354507,10876.829329707347
"147.32.84.165",1483,"173.192.170.88",80,23,5064,11,1104,12,3960,91177.927395,54.76643499999773,161.26665904034772,578.456494383856
"147.32.84.165",1501,"217.163.21.34",80,13,6074,6,749,7,5325,91177.927458,0.1865889999899082,32113.361453912512,228309.27869437134
"147.32.84.165",1522,"196.2.147.247",25,3,186,3,186,0,0,91177.973311,8.956159000008483,166.14265110730958,0
"147.32.84.165",1505,"46.4.36.120",443,6,366,3,186,3,180,91179.604999,1.0310829999943962,1443.1427925861324,1396.589799276902
"147.32.84.165",1492,"217.163.21.34",80,10,1446,5,698,5,748,91180.006575,0.1389739999867743,40180.1775909984,43058.413808118625
"147.32.84.165",1497,"74.117.116.92",80,12,7367,7,995,5,6372,91180.052408,0.41260999999940395,19291.825210274834,123545.23642198114
"147.32.84.165",1524,"209.191.88.254",25,3,186,3,186,0,0,91180.188373,8.947939999998198,166.29525902054547,0
"147.32.84.165",1439,"200.161.192.230",6667,3,186,3,186,0,0,91180.636336,9.000973000001977,165.3154608951358,0
"147.32.84.165",1444,"217.163.21.34",80,9,2627,5,1050,4,1577,91180.909095,0.2242240000050515,37462.53746169348,56265.16340675297
"147.32.84.165",1503,"74.117.116.92",80,19,12782,11,1247,8,11535,91180.909171,0.4345679999969434,22956.131146495296,212348.81537676282
"147.32.84.165",1533,"209.85.227.27",25,3,186,3,186,0,0,91180.955133,8.983896999998251,165.62968164041615,0
"147.32.84.165",1501,"74.117.116.92",80,10,1731,5,929,5,802,91181.052983,0.4172289999987697,17812.75989929251,15377.64632856038
"147.32.84.165",1534,"205.188.146.193",25,3,186,3,186,0,0,91181.053057,8.985851000004914,165.59366497387796,0
"147.32.84.165",1508,"46.4.36.120",443,6,366,3,186,3,180,91197.864033,1.0309750000014901,1443.2939692988184,1396.7360993214372
"147.32.84.165",1492,"217.163.21.34",80,10,2272,5,1153,5,1119,91198.164769,0.1400629999989178,65856.07905065056,63914.09580024109
"147.32.84.165",1507,"195.113.232.91",80,8,2554,5,839,3,1715,91198.210713,63.676852000004146,105.40722082177622,215.46291264522793
"147.32.84.165",1535,"98.139.175.224",25,3,186,3,186,0,0,91198.211767,8.883623999994597,167.49920978205571,0
"147.32.84.165",1503,"184.82.148.43",80,10,1921,5,983,5,938,91198.211823,0.32256599998800084,24379.50683051696,23263.456161775084
"147.32.84.165",1497,"74.117.116.92",80,10,1686,5,884,5,802,91198.265257,0.41179600000032224,17173.551952895283,15580.530165409522
"147.32.84.165",1537,"67.195.168.230",25,3,186,3,186,0,0,91198.318209,8.877120999997715,167.6219125548005,0
"147.32.84.165",1511,"217.163.21.34",80,11,3679,6,1565,5,2114,91198.401019,2.23887200000172,5592.101736941809,7553.803879805101
"147.32.84.165",1456,"50.22.198.84",80,8,2574,5,1407,3,1167,91198.446907,0.3674079999909736,30636.240910041517,25410.442887006717
"147.32.84.165",1538,"64.12.90.66",25,3,186,3,186,0,0,91198.566256,8.930629999988014,166.6175846499068,0
"147.32.84.165",1512,"184.82.148.44",80,10,1512,5,594,5,918,91198.56639,0.32217599998693913,14749.70202681964,22794.99404144853
"147.32.84.165",1539,"205.188.103.1",25,3,186,3,186,0,0,91198.567959,8.929048999998486,166.64708638067194,0
"147.32.84.165",1540,"64.12.90.97",25,3,186,3,186,0,0,91198.672932,8.92373100000259,166.74639789114755,0
"147.32.84.165",1513,"217.163.21.34",80,13,6081,6,750,7,5331,91198.895226,0.1880150000069989,31912.34741790096,226832.96544644004
"147.32.84.165",1503,"50.22.198.84",80,8,1967,5,1466,3,501,91198.895288,0.36962100000528153,31729.79890166527,10843.539733788744
"147.32.84.165",1541,"206.46.232.11",25,3,186,3,186,0,0,91198.967797,8.93019600000116,166.62568212386455,0
"147.32.84.165",1546,"68.1.17.3",25,3,186,3,186,0,0,91199.015999,8.882097000008798,167.52800605516086,0
"147.32.84.165",1521,"46.4.36.120",443,6,366,3,186,3,180,91200.67296,1.030670000007376,1443.7210746304356,1397.1494270617118
"147.32.84.165",1517,"217.163.21.34",80,10,1451,5,701,5,750,91201.174455,0.13913500000489876,40306.177452133175,43123.585005848625
"147.32.84.165",1547,"64.12.138.161",25,3,186,3,186,0,0,91201.220344,8.88597600000503,167.45487496243044,0
"147.32.84.165",1513,"187.106.81.34",6667,3,186,3,186,0,0,91201.703737,8.903747999996995,167.120632794246,0
"147.32.84.165",1508,"173.241.240.4",80,9,2146,5,1116,4,1030,91201.977327,0.0651990000042133,136934.61555273936,126382.30646892611
"147.32.84.165",1548,"210.63.177.6",25,3,186,3,186,0,0,91201.993555,8.914566000006744,166.91782864122317,0
"147.32.84.165",1512,"92.240.244.181",80,10,1757,6,1363,4,394,91202.07736,17.505002999998396,622.9076338919222,180.06280832972658
"147.32.84.165",1549,"209.85.227.27",25,3,186,3,186,0,0,91202.085989,8.922774999999092,166.76426335979014,0
"147.32.84.165",1511,"46.4.36.120",443,6,366,3,186,3,180,91219.234804,1.0310849999950733,1443.1399933149157,1396.587090304757
"147.32.84.165",1522,"217.163.21.34",80,9,2741,5,1160,4,1581,91219.536216,0.2610850000055507,35543.979929152214,48443.99333447384
"147.32.84.165",1550,"216.129.105.37",25,3,186,3,186,0,0,91219.536349,9.028500999993412,164.81141221572506,0
"147.32.84.165",1551,"205.188.59.194",25,3,186,3,186,0,0,91219.582062,8.982881999996607,165.64839658369797,0
"147.32.84.165",1552,"128.250.158.190",25,3,186,3,186,0,0,91219.636104,9.028831999996328,164.80537017419365,0
"147.32.84.165",1512,"217.163.21.34",80,10,2277,5,1156,5,1121,91219.937584,0.14134499999636319,65428.5613232725,63447.5927710973
"147.32.84.165",1554,"208.65.46.65",25,3,186,3,186,0,0,91219.937716,9.028460999994422,164.81214240178025,0
"147.32.84.165",1556,"98.139.175.224",25,3,186,3,186,0,0,91219.983568,8.982732000004034,165.6511626974212,0
"147.32.84.165",1537,"217.163.21.34",80,11,3549,6,1675,5,1874,91220.266162,0.15565699999569915,86086.71630810208,96314.33215604973
"147.32.84.165",1557,"65.55.37.88",25,3,186,3,186,0,0,91220.31224,8.956793000004836,166.13089082210524,0
"147.32.84.165",1539,"46.4.36.120",443,6,366,3,186,3,180,91221.743153,1.030828000002657,1443.4997885157995,1396.9352792088382
"147.32.84.165",1538,"195.113.232.90",80,63,67396,40,5489,23,61907,91222.144581,63.42015299999912,692.3982034543595,7809.126540580986
"147.32.84.165",1560,"78.67.172.123",25,3,186,3,186,0,0,91222.145449,9.028590000001714,164.80978757477277,0
"147.32.84.165",1540,"210.211.186.4",6667,3,186,3,186,0,0,91222.774218,9.00215699999535,165.29371793901936,0
"147.32.84.165",1511,"195.113.232.99",80,11,2010,6,685,5,1325,91222.94701,0.02502499999536667,218981.01902156288,423576.4236548479
"147.32.84.165",1561,"68.1.17.3",25,3,186,3,186,0,0,91222.947852,9.028982000003452,164.80263223466733,0
"147.32.84.165",1512,"184.82.148.43",80,10,1921,5,983,5,938,91223.069229,0.3228689999959897,24356.62761088143,23241.62431231616
"147.32.84.165",1562,"65.55.88.22",25,3,186,3,186,0,0,91223.175846,9.001877999995486,165.29884097526607,0
"147.32.84.165",1548,"46.4.36.120",443,6,366,3,186,3,180,91240.509981,1.0306590000109281,1443.7364831474063,1397.164338529748
"147.32.84.165",1541,"195.113.232.97",80,8,1383,5,809,3,574,91240.510128,60.060356000001775,107.75826903190199,76.45642326861773
"147.32.84.165",1563,"207.115.21.24",25,3,186,3,186,0,0,91240.511031,9.030819999999949,164.7690907359474,0
"147.32.84.165",1546,"38.102.130.89",80,8,1364,5,659,3,705,91240.610473,0.5675270000065211,9289.425877428603,9937.853176915272
"147.32.84.165",1566,"209.85.227.27",25,3,186,3,186,0,0,91240.797443,8.945307000001776,166.344207079724,0
"147.32.84.165",1547,"217.163.21.34",80,14,6261,7,1249,7,5012,91240.911178,0.18954200000735,52716.54830914802,211541.50530460358
"147.32.84.165",1567,"64.235.144.69",25,3,186,3,186,0,0,91240.911348,9.031581000002916,164.75520731082625,0
"147.32.84.165",1511,"184.82.148.44",80,10,1512,5,594,5,918,91240.957136,0.32367599999997765,14681.348014682362,22689.35602269092
"147.32.84.165",1568,"205.188.59.194",25,3,186,3,186,0,0,91241.064026,8.979481000002124,165.7111363117365,0
"147.32.84.165",1552,"217.163.21.35",80,11,3658,6,1193,5,2465,91241.212523,0.24775000000954606,38522.70433756714,79596.36730268484
"147.32.84.165",1570,"205.188.190.2",25,3,186,3,186,0,0,91241.258619,8.985486999998102,165.60037313506928,0
"147.32.84.165",1554,"217.163.21.34",80,14,6138,7,810,7,5328,91241.540905,0.19153199999709614,33832.466637941674,222542.4472184608
"147.32.84.165",1571,"98.139.175.224",25,3,186,3,186,0,0,91241.586899,8.95808300000499,166.10696730530083,0
"147.32.84.165",1557,"46.4.36.120",443,6,366,3,186,3,180,91242.818087,1.02944599998591,1445.4376431793082,1398.8106224315886
"147.32.84.165",1548,"173.192.170.88",80,12,1401,8,872,4,529,91243.118034,15.451209999999264,451.4856765263259,273.89440697525964
"147.32.84.165",1511,"195.113.232.88",80,18,19175,12,1463,6,17712,91243.847654,66.72769700000936,175.39942971504558,2123.4960349370385
"147.32.84.165",1572,"202.131.27.71",25,3,186,3,186,0,0,91243.848382,9.005352000007406,165.23507354279724,0
"147.32.84.165",1554,"210.75.13.174",6667,3,186,3,186,0,0,91243.92065,9.032840999992914,164.73222544282217,0
"147.32.84.165",1547,"217.163.21.34",80,10,1449,5,700,5,749,91244.121373,0.13927400000102352,40208.50984360933,43023.10553266198
"147.32.84.165",1573,"65.55.37.88",25,3,186,3,186,0,0,91244.167311,8.98709300000337,165.5707802288729,0
"147.32.84.165",1547,"46.4.36.120",443,6,366,3,186,3,180,91252.352231,1.031447000001208,1442.6335041919338,1396.096939540581
"147.32.84.165",1560,"217.163.21.35",80,11,3348,6,1279,5,2069,91253.383933,2.2252840000001015,4598.064786337174,7438.15171456733
"147.32.84.165",1562,"209.59.195.20",80,27,19885,14,1076,13,18809,91253.430858,331.78582099999767,25.944448060063603,453.5214902990115
"147.32.84.165",1574,"64.12.90.66",25,3,186,3,186,0,0,91253.534841,8.95128300000215,166.23315339260782,0
"147.32.84.165",1547,"46.4.36.120",443,6,366,3,186,3,180,91261.582487,1.0323709999938728,1441.3423081516542,1394.8473949854717
"147.32.84.165",1562,"67.214.158.5",80,10,1354,5,508,5,846,91261.783406,0.31627100000332575,12849.739621897881,21399.369527806313
"147.32.84.165",1581,"64.12.90.97",25,3,186,3,186,0,0,91261.887229,8.927379999993718,166.678241544669,0
"147.32.84.165",1554,"94.100.176.20",25,3,186,3,186,0,0,91261.984042,8.93074599999818,166.61542048114492,0
"147.32.84.165",1563,"67.214.158.5",80,10,1489,5,530,5,959,91262.084702,0.31902400001126807,13290.53613474297,24048.347458902845
"147.32.84.165",1583,"65.54.188.126",25,3,186,3,186,0,0,91262.084757,8.930561999994097,166.61885332647412,0
"147.32.84.165",1584,"12.168.25.160",25,3,186,3,186,0,0,91262.285598,8.930299999992712,166.62374164375376,0
"147.32.84.165",1566,"68.67.185.205",80,10,1576,6,624,4,952,91262.587054,17.709050999998,281.8897523080466,430.0625708289428
"147.32.84.165",1585,"41.203.208.3",25,3,186,3,186,0,0,91262.615093,8.901532999996562,167.1622180135236,0
"147.32.84.165",1562,"68.67.185.205",80,10,1552,6,624,4,928,91262.616275,17.68009000000893,282.35150386663634,419.9073647247412
"147.32.84.165",1587,"207.115.21.24",25,3,186,3,186,0,0,91262.616314,8.900435000003199,167.18283993978554,0
"147.32.84.165",1547,"46.4.36.120",443,6,366,3,186,3,180,91263.890388,1.0326499999937369,1440.952888209001,1394.4705369764526
"147.32.84.165",1567,"217.163.21.41",80,10,1503,5,573,5,930,91264.895583,0.14453900000080466,31714.623734593988,51473.99663729914
"147.32.84.165",1590,"64.12.90.34",25,3,186,3,186,0,0,91264.923229,8.90196499999729,167.1541058631946,0
"147.32.84.165",1568,"94.245.121.179",80,8,1592,5,586,3,1006,91264.941528,0.11737100000027567,39941.723253520795,68568.89691645378
"147.32.84.165",1591,"64.98.36.4",25,3,186,3,186,0,0,91264.97835,8.846905999991577,168.1943947411012,0
"147.32.84.165",1572,"217.163.21.34",80,10,1502,5,737,5,765,91265.195562,0.14156000000366475,41650.183666624485,43232.5515671204
"147.32.84.165",1595,"159.134.198.135",25,3,186,3,186,0,0,91265.241475,8.88470700000471,167.4787924913237,0
"147.32.84.165",1572,"46.4.36.120",443,6,366,3,186,3,180,91274.427041,1.0316800000000512,1442.3076923076208,1395.7816377170523
"147.32.84.165",1596,"208.65.144.3",25,3,186,3,186,0,0,91275.458998,9.002500000002328,165.28742016102362,0
"147.32.84.165",1572,"46.4.36.120",443,6,366,3,186,3,180,91282.855812,1.0309100000013132,1443.3849705581522,1396.8241650562763
"147.32.84.165",1598,"209.85.227.27",25,3,186,3,186,0,0,91282.956593,9.029808000006597,164.787556944612,0
"147.32.84.165",1554,"74.125.93.27",25,3,186,3,186,0,0,91283.056632,9.029846999997972,164.7868452256538,0
"147.32.84.165",1605,"205.188.156.193",25,3,186,3,186,0,0,91283.257393,9.029772999987472,164.78819567247865,0
"147.32.84.165",1608,"207.115.21.24",25,3,186,3,186,0,0,91283.558352,9.029825000005076,164.78724670734633,0
"147.32.84.165",1611,"205.252.14.32",25,3,186,3,186,0,0,91283.558439,9.029861000002711,164.7865897381536,0
"147.32.84.165",1612,"64.12.90.34",25,3,186,3,186,0,0,91283.55847,9.02987800000119,164.78627950452972,0
"147.32.84.165",1613,"64.12.90.97",25,3,186,3,186,0,0,91283.558498,9.029898000007961,164.78591452513507,0
"147.32.84.165",1614,"76.96.62.116",25,3,186,3,186,0,0,91283.886971,9.002129000000423,165.29423206442945,0
"147.32.84.165",1584,"189.212.138.52",6667,3,186,3,186,0,0,91285.865702,9.029863000003388,164.78655324000394,0
"147.32.84.165",1587,"46.4.36.120",443,6,366,3,186,3,180,91285.865835,1.0307809999940218,1443.5656070577843,1396.9989745720493
"147.32.84.165",1615,"65.55.92.136",25,3,186,3,186,0,0,91286.16655,9.030645000006189,164.77228370719703,0
"147.32.84.165",1622,"65.54.188.94",25,3,186,3,186,0,0,91286.896897,9.003026999998838,165.27774491848044,0
"147.32.84.165",1590,"46.4.36.120",443,6,366,3,186,3,180,91296.501226,1.031103000001167,1443.114800362637,1396.5627100283582
"147.32.84.165",1624,"205.188.59.194",25,3,186,3,186,0,0,91297.53263,8.903881999998703,167.11811769295875,0
"147.32.84.165",1590,"46.4.36.120",443,6,366,3,186,3,180,91303.927408,1.0322359999991022,1441.5308127223757,1395.0298187635894
"147.32.84.165",1628,"65.55.37.72",25,3,186,3,186,0,0,91304.028259,9.031405000001541,164.75841798698497,0
"147.32.84.165",1554,"66.111.4.71",25,3,186,3,186,0,0,91304.228212,9.03168800000276,164.75325542684217,0
"147.32.84.165",1630,"216.33.127.20",25,3,186,3,186,0,0,91304.53053,9.030469999997877,164.7754768024643,0
"147.32.84.165",1631,"205.188.146.194",25,3,186,3,186,0,0,91304.530663,9.030459000001429,164.77567751536932,0
"147.32.84.165",1632,"74.125.45.27",25,3,186,3,186,0,0,91304.831379,9.030162000010023,164.78109695023727,0
"147.32.84.165",1633,"98.139.175.224",25,3,186,3,186,0,0,91304.959883,9.00234599999385,165.2902476755522,0
"147.32.84.165",1636,"74.6.140.64",25,3,186,3,186,0,0,91305.031996,9.030469999997877,164.7754768024643,0
"147.32.84.165",1611,"46.4.36.120",443,6,366,3,186,3,180,91307.138657,1.030836999998428,1443.4871856581294,1396.923082894964
"147.32.84.165",1638,"64.12.90.97",25,3,186,3,186,0,0,91307.841081,9.030617999989772,164.7727763483834,0
"147.32.84.165",1639,"77.238.177.9",25,3,186,3,186,0,0,91308.169734,9.002619000006234,165.2852353297379,0
"147.32.84.165",1622,"46.4.36.120",443,6,366,3,186,3,180,91318.476574,1.0310219999955734,1443.2281755446427,1396.6724279464283
"147.32.84.165",1641,"208.65.145.3",25,3,186,3,186,0,0,91319.50784,9.000894999990123,165.31689348688468,0
"147.32.84.165",1622,"46.4.36.120",443,6,366,3,186,3,180,91325.097959,1.030719999995199,1443.6510400563984,1397.0816516674822
"147.32.84.165",1645,"63.251.204.102",25,3,186,3,186,0,0,91325.298788,8.929189000002225,166.644473535013,0
"147.32.84.165",1554,"216.157.130.15",25,3,186,3,186,0,0,91325.599814,8.9290500000061,166.6470677170565,0
"147.32.84.165",1646,"209.85.227.27",25,3,186,3,186,0,0,91325.599873,8.929143999994267,166.64531336945126,0
"147.32.84.165",1648,"66.94.238.147",25,3,186,3,186,0,0,91325.900521,8.92911599999934,166.64583593718683,0
"147.32.84.165",1649,"64.12.90.98",25,3,186,3,186,0,0,91326.000323,8.929768999994849,166.63364976192088,0
"147.32.84.165",1650,"76.96.30.116",25,3,186,3,186,0,0,91326.101314,8.928874000004726,166.6503525527645,0
"147.32.84.165",1651,"216.32.180.22",25,3,186,3,186,0,0,91326.128923,8.90136600000551,167.16535417137987,0
"147.32.84.165",1633,"46.4.36.120",443,6,366,3,186,3,180,91328.910199,1.0306229999987409,1443.786913354173,1397.2131419556513
"147.32.84.165",1652,"98.139.175.224",25,3,186,3,186,0,0,91329.211106,8.930529000004753,166.61946901456878,0
"147.32.84.165",1659,"207.115.21.24",25,3,186,3,186,0,0,91329.941021,8.902907999989111,167.1364008256426,0
"147.32.84.165",1633,"46.4.36.120",443,6,366,3,186,3,180,91340.448994,1.0301529999997001,1444.4456308921424,1397.850610540783
"147.32.84.165",1658,"207.126.147.13",25,3,186,3,186,0,0,91341.479427,9.00441999999748,165.2521761535353,0
"147.32.84.165",1633,"46.4.36.120",443,6,366,3,186,3,180,91346.267945,1.031289000005927,1442.8545247660436,1396.3108304187517
"147.32.84.165",1660,"205.188.190.2",25,3,186,3,186,0,0,91346.56921,9.031111000003875,164.76378155460182,0
"147.32.84.165",1662,"66.94.9.228",25,3,186,3,186,0,0,91346.569345,9.031098999999813,164.76400048322256,0
"147.32.84.165",1663,"61.111.244.129",25,3,186,3,186,0,0,91346.870449,9.03061100000923,164.77290407022062,0
"147.32.84.165",1664,"195.88.117.3",25,3,186,3,186,0,0,91346.970481,9.030637999996543,164.77241142880155,0
"147.32.84.165",1665,"64.12.90.66",25,3,186,3,186,0,0,91347.07064,9.031242999990354,164.76137337923353,0
"147.32.84.165",1666,"208.65.144.3",25,3,186,3,186,0,0,91347.070771,9.031237000002875,164.7614828400059,0
"147.32.84.165",1667,"216.146.33.1",25,3,186,3,186,0,0,91347.299502,9.003284999998868,165.273008685184,0
"147.32.84.165",1633,"46.4.36.120",443,6,366,3,186,3,180,91350.182507,1.0309359999955632,1443.3485686855477,1396.7889374376268
"147.32.84.165",1651,"74.117.116.87",80,11,3367,6,583,5,2784,91350.884844,0.856962999998359,5442.475346087207,25989.453453699458
"147.32.84.165",1669,"207.115.21.24",25,3,186,3,186,0,0,91351.026609,8.987653000003775,165.56046389411952,0
"147.32.84.165",1672,"64.12.90.33",25,3,186,3,186,0,0,91351.21372,9.001166999994894,165.3118978906673,0
"147.32.84.165",1633,"46.4.36.120",443,6,366,3,186,3,180,91362.421492,1.0318420000112383,1442.0812488576676,1395.5624988945171
"147.32.84.165",1681,"64.12.90.66",25,3,186,3,186,0,0,91363.453572,9.006399999998393,165.21584650917853,0
"147.32.84.165",1684,"208.89.132.27",25,3,186,3,186,0,0,91363.453632,9.006389000001946,165.21604829634592,0
"147.32.84.165",1453,"212.117.171.138",65500,9,544,5,302,4,242,91367.540271,107.72007099998882,22.4285035979994,17.97250950568164
"147.32.84.165",1633,"46.4.36.120",443,6,366,3,186,3,180,91367.540384,1.0315649999974994,1442.4684823579776,1395.9372409915911
"147.32.84.165",1685,"209.85.227.27",25,3,186,3,186,0,0,91367.563034,9.010831999999937,165.13458468652067,0
"147.32.84.165",1686,"207.115.20.21",25,3,186,3,186,0,0,91367.842049,9.032500000001164,164.7384445059295,0
"147.32.84.165",1687,"64.12.90.98",25,3,186,3,186,0,0,91367.94227,9.032852000003913,164.7320248354955,0
"147.32.84.165",1688,"203.131.74.12",25,3,186,3,186,0,0,91368.042812,9.032991000000038,164.72948993306798,0
"147.32.84.165",1689,"66.94.238.147",25,3,186,3,186,0,0,91368.042872,9.033049999998184,164.72841399087784,0
"147.32.84.165",1690,"98.139.175.224",25,3,186,3,186,0,0,91368.243741,9.032053000002634,164.7465974789526,0
"147.32.84.165",1691,"124.108.116.109",25,3,186,3,186,0,0,91368.572182,9.005234999989625,165.23722035035337,0
"147.32.84.165",1663,"46.4.36.120",443,6,366,3,186,3,180,91371.95823,1.0306069999933243,1443.8093279102882,1397.2348334615692
"147.32.84.165",1667,"74.117.114.70",80,11,3344,6,587,5,2757,91372.159065,0.747017000001506,6286.3361877849275,29525.432486751353
"147.32.84.165",1692,"205.188.190.2",25,3,186,3,186,0,0,91372.305171,8.985067000001436,165.60811399622978,0
"147.32.84.165",1633,"74.117.114.70",80,12,8055,7,1052,5,7003,91372.9891,0.8827689999889117,9533.637905392818,63463.94130367481
"147.32.84.165",1693,"76.9.124.68",25,3,186,3,186,0,0,91373.133679,8.959094999998342,166.08820422155088,0
"147.32.84.165",1633,"46.4.36.120",443,6,366,3,186,3,180,91384.500261,1.0309000000124797,1443.3989717547645,1396.837714601385
"147.32.84.165",1681,"69.170.135.92",80,11,2370,6,586,5,1784,91385.531444,0.39315600000554696,11924.019981721907,36301.11202626601
"147.32.84.165",1694,"195.50.106.142",25,3,186,3,186,0,0,91385.659807,8.875568999996176,167.65122326249067,0
"147.32.84.165",1633,"46.4.36.120",443,6,366,3,186,3,180,91388.615627,1.0305279999884078,1443.9200099528962,1397.341945115706
"147.32.84.165",1684,"195.113.232.73",80,15,9826,9,987,6,8839,91388.916081,61.521475999994436,128.34542526256544,1149.3872481213941
"147.32.84.165",1695,"216.32.180.22",25,3,186,3,186,0,0,91388.916945,8.929752999989432,166.63394833001104,0
"147.32.84.165",1696,"208.89.132.27",25,3,186,3,186,0,0,91389.01681,8.930376999996952,166.62230497105642,0
"147.32.84.165",1700,"66.94.238.147",25,3,186,3,186,0,0,91389.117111,8.930118000003858,166.62713751367642,0
"147.32.84.165",1701,"64.12.90.1",25,3,186,3,186,0,0,91389.117166,8.930185999997775,166.62586871095078,0
"147.32.84.165",1702,"209.85.227.27",25,3,186,3,186,0,0,91389.11722,8.930181000003358,166.62596200451486,0
"147.32.84.165",1703,"205.188.156.193",25,3,186,3,186,0,0,91389.317603,8.930626000001212,166.6176592771658,0
"147.32.84.165",1706,"98.139.175.224",25,3,186,3,186,0,0,91389.618797,8.930349999995087,166.62280873659134,0
"147.32.84.165",1708,"203.131.74.12",25,3,186,3,186,0,0,91389.646392,8.902877000000444,167.13698279779962,0
"147.32.84.165",1686,"46.4.36.120",443,6,366,3,186,3,180,91393.229819,1.0322670000023209,1441.4875221203956,1394.987924632641
"147.32.84.165",1685,"74.117.116.126",80,11,3440,6,644,5,2796,91394.033441,0.8285269999905722,6218.264462182433,26997.309683636773
"147.32.84.165",1711,"74.109.203.154",25,3,186,3,186,0,0,91394.169489,8.998239999986254,165.36567150934775,0
"147.32.84.165",1687,"65.55.13.243",80,9,1926,6,1230,3,696,91394.262364,66.1811740000121,148.68276588744408,84.13268703874884
"147.32.84.165",1712,"98.139.175.225",25,3,186,3,186,0,0,91394.424146,8.944218999997247,166.36444165784155,0
"147.32.84.165",1692,"74.117.116.126",80,4,244,3,182,1,62,91406.579794,0.1397889999934705,10415.697945246116,3548.204794534391
"147.32.84.165",1716,"64.12.90.98",25,3,186,3,186,0,0,91406.719257,8.99262199999066,165.46898112714462,0
"147.32.84.165",1694,"46.4.36.120",443,6,366,3,186,3,180,91409.891296,1.0319880000024568,1441.8772311271618,1395.3650623811245
"147.32.84.165",1693,"69.170.135.92",80,4,244,3,182,1,62,91409.991587,0.12270300000091083,11866.050544723374,4042.280954795874
"147.32.84.165",1717,"216.32.180.22",25,3,186,3,186,0,0,91410.091708,9.032590999995591,164.7367848273797,0
"147.32.84.165",1685,"64.4.52.169",80,7,1112,5,733,2,379,91410.091843,65.36016100000415,89.71826125091135,46.38911461677408
"147.32.84.165",1719,"195.50.106.142",25,3,186,3,186,0,0,91410.114028,9.010395000004792,165.142593637594,0
"147.32.84.165",1721,"65.54.188.94",25,3,186,3,186,0,0,91410.256728,8.967258000004222,165.93701218357936,0
"147.32.84.165",1723,"65.54.188.110",25,3,186,3,186,0,0,91410.293286,9.030603000006522,164.77305003873224,0
"147.32.84.165",1724,"65.55.37.72",25,3,186,3,186,0,0,91410.593453,9.031940000000759,164.74865864918002,0
"147.32.84.165",1725,"98.139.54.60",25,3,186,3,186,0,0,91410.593586,9.03193199999805,164.74880457473785,0
"147.32.84.165",1726,"209.85.227.27",25,3,186,3,186,0,0,91410.92352,9.002672000002349,165.28426227231336,0
"147.32.84.165",1694,"46.4.36.120",443,6,366,3,186,3,180,91415.210684,1.0306559999880847,1443.7406855606553,1397.1684053812792
"147.32.84.165",1727,"74.55.28.130",25,3,186,3,186,0,0,91415.410677,9.029716999997618,164.78921764662087,0
"147.32.84.165",1728,"205.188.59.194",25,3,186,3,186,0,0,91416.24158,8.901442000002135,167.16392692326065,0
"147.32.84.165",1694,"46.4.36.120",443,6,366,3,186,3,180,91427.651176,1.0305769999977201,1443.8513570585137,1397.2755068308197
"147.32.84.165",1730,"12.151.21.99",25,3,186,3,186,0,0,91428.681984,9.005171000011615,165.23839469545675,0
"147.32.84.165",1716,"46.4.36.120",443,6,366,3,186,3,180,91431.062592,1.0316639999946347,1442.3300609575779,1395.803284797656
"147.32.84.165",1732,"65.55.37.120",25,3,186,3,186,0,0,91431.062723,9.032141000003321,164.7449923555725,0
"147.32.84.165",1733,"209.85.227.27",25,3,186,3,186,0,0,91431.163252,9.031721000006655,164.75265345319053,0
"147.32.84.165",1734,"200.27.124.197",25,3,186,3,186,0,0,91431.16338,9.03172500000801,164.75258048697015,0
"147.32.84.165",1735,"98.139.175.224",25,3,186,3,186,0,0,91431.263242,9.03186299999652,164.75006319300607,0
"147.32.84.165",1740,"74.125.157.27",25,3,186,3,186,0,0,91431.564514,9.032229999997071,164.74336902409289,0
"147.32.84.165",1742,"66.94.238.147",25,3,186,3,186,0,0,91431.564575,9.032290000002831,164.74227466119152,0
"147.32.84.165",1744,"65.55.37.104",25,3,186,3,186,0,0,91431.866635,9.030178000000888,164.78080498522328,0
"147.32.84.165",1747,"205.188.103.2",25,3,186,3,186,0,0,91432.094504,9.003358000001754,165.27166863738066,0
"147.32.84.165",1716,"88.154.52.66",6667,6,366,3,186,3,180,91436.380348,4.22257399999944,352.39169283953277,341.0242188769672
"147.32.84.165",1719,"46.4.36.120",443,6,366,3,186,3,180,91437.18489,1.0312599999888334,1442.8950992146617,1396.350096014189
"147.32.84.165",1748,"74.125.157.27",25,3,186,3,186,0,0,91438.216353,9.001771000010194,165.30080580791434,0
"147.32.84.165",1749,"64.12.90.98",25,3,186,3,186,0,0,91438.216414,9.001831000001403,165.299704026855,0
"147.32.84.165",1728,"46.4.36.120",443,6,366,3,186,3,180,91440.603146,1.0237750000087544,1453.4443603206523,1406.5590583748249
"147.32.84.165",1750,"209.85.227.27",25,3,186,3,186,0,0,91441.62718,9.001964000010048,165.29726179735212,0
"147.32.84.165",1751,"15.192.0.85",25,3,186,3,186,0,0,91449.726476,8.932190999999875,166.5884663684443,0
"147.32.84.165",1684,"86.126.40.27",6667,3,186,3,186,0,0,91452.133947,8.932494000007864,166.58281550468323,0
"147.32.84.165",1752,"65.55.92.136",25,3,186,3,186,0,0,91452.234257,8.932858000000124,166.5760275154916,0
"147.32.84.165",1753,"205.188.59.193",25,3,186,3,186,0,0,91452.33469,8.93220100000326,166.58827986511463,0
"147.32.84.165",1732,"46.4.36.120",443,6,366,3,186,3,180,91452.63573,1.0309229999984382,1443.366769392335,1396.8065510248405
"147.32.84.165",1754,"65.54.188.72",25,3,186,3,186,0,0,91452.635862,8.932096000004094,166.59023817022543,0
"147.32.84.165",1755,"98.139.175.224",25,3,186,3,186,0,0,91452.936374,9.033582000003662,164.7187129091646,0
"147.32.84.165",1756,"168.95.5.14",25,3,186,3,186,0,0,91453.137012,8.933800999991945,166.5584447203762,0
"147.32.84.165",1757,"12.151.21.99",25,3,186,3,186,0,0,91453.666896,8.90559999999823,167.08587854836233,0
"147.32.84.165",1734,"46.4.36.120",443,6,366,3,186,3,180,91459.159374,1.031542000011541,1442.500644649808,1395.9683657901367
"147.32.84.165",1758,"64.136.44.37",25,3,186,3,186,0,0,91460.191163,9.007618000003276,165.1935062076854,0
"147.32.84.165",1684,"46.4.36.120",443,6,366,3,186,3,180,91462.572656,1.0302430000010645,1444.3194469639323,1397.72849706187
"147.32.84.165",1760,"168.95.5.74",25,3,186,3,186,0,0,91463.603146,9.007047000006423,165.20397861795757,0
"147.32.84.165",1684,"46.4.36.120",443,6,366,3,186,3,180,91470.703368,1.03194899999653,1441.931723374899,1395.4177968144184
"147.32.84.165",1751,"184.82.148.43",80,10,1923,5,983,5,940,91471.606854,0.32486700000299606,24206.829256057015,23147.934385242723
"147.32.84.165",1761,"64.12.90.98",25,3,186,3,186,0,0,91471.713302,9.023138999997173,164.909351390959,0
"147.32.84.165",1762,"66.94.238.147",25,3,186,3,186,0,0,91471.735537,9.001029000006383,165.31443238311363,0
"147.32.84.165",1684,"46.4.36.120",443,6,366,3,186,3,180,91473.211982,1.0311990000045625,1442.980452845102,1396.4326963017115
"147.32.84.165",1763,"64.12.90.66",25,3,186,3,186,0,0,91473.312764,9.028798999992432,164.8059725331406,0
"147.32.84.165",1773,"77.238.177.9",25,3,186,3,186,0,0,91473.613582,9.028423999989172,164.8128178297546,0
"147.32.84.165",1774,"209.85.227.27",25,3,186,3,186,0,0,91474.014649,9.029209000000264,164.79848899277405,0
"147.32.84.165",1777,"207.115.21.24",25,3,186,3,186,0,0,91474.114869,9.029393000004347,164.79513074680474,0
"147.32.84.165",1778,"98.139.175.225",25,3,186,3,186,0,0,91474.243414,9.000555000005988,165.32313840635493,0
"147.32.84.165",1780,"64.12.90.33",25,3,186,3,186,0,0,91474.617111,9.028304999999818,164.81499018919166,0
"147.32.84.165",1756,"212.117.171.138",65500,14,869,8,486,6,383,91481.237467,43.13089800000307,90.14419314895143,71.03955962149877
"147.32.84.165",1754,"46.4.36.120",443,6,366,3,186,3,180,91481.260318,1.0087260000000242,1475.1280327858747,1427.5432575347174
"147.32.84.165",1684,"173.192.170.88",80,12,4587,7,864,5,3723,91482.269257,4.383608999996795,1576.7829658176752,6794.401599235191
"147.32.84.165",1786,"98.139.175.224",25,3,186,3,186,0,0,91482.470128,8.900060999993002,167.18986532802077,0
"147.32.84.165",1758,"121.245.3.131",6667,2,124,2,124,0,0,91484.648623,2.909339000005275,340.97092157297635,0
"147.32.84.165",1754,"46.4.36.120",443,6,366,3,186,3,180,91492.674072,1.031594000000041,1442.4279319188954,1395.897998631189
"147.32.84.165",1788,"64.12.90.1",25,3,186,3,186,0,0,91492.674204,9.030014000003575,164.78379767732486,0
"147.32.84.165",1791,"208.65.144.2",25,3,186,3,186,0,0,91493.705886,9.001736000005621,165.30144852049324,0
"147.32.84.165",1796,"74.125.159.27",25,3,186,3,186,0,0,91494.280418,9.02891800001089,164.80380041088037,0
"147.32.84.165",1802,"208.254.9.199",25,3,186,3,186,0,0,91494.581483,9.028861999991932,164.8048225791168,0
"147.32.84.165",1754,"46.4.36.120",443,6,366,3,186,3,180,91494.982938,1.0309390000038547,1443.3443685750915,1396.7848728146048
"147.32.84.165",1803,"98.139.175.225",25,3,186,3,186,0,0,91495.083084,9.028688999998849,164.80798042774424,0
"147.32.84.165",1805,"85.158.176.233",25,3,186,3,186,0,0,91495.08321,9.028700000009849,164.8077796358697,0
"147.32.84.165",1809,"65.55.92.184",25,3,186,3,186,0,0,91495.183212,9.029483999998774,164.79346992587858,0
"147.32.84.165",1811,"205.188.59.194",25,3,186,3,186,0,0,91495.58467,9.028766000003088,164.80657489622513,0
"147.32.84.165",1774,"184.82.155.107",80,10,1908,5,977,5,931,91496.014117,0.34445899999991525,22690.65404010905,21622.31208939767
"147.32.84.165",1813,"98.139.175.224",25,3,186,3,186,0,0,91496.126864,8.988323999990826,165.54810440762023,0
"147.32.84.165",1814,"194.105.190.18",25,3,186,3,186,0,0,91496.126924,8.988391999999294,165.54685198421663,0
"147.32.84.165",1754,"46.4.36.120",443,6,366,3,186,3,180,91502.206567,1.0303149999963352,1444.218515701793,1397.6308216468963
"147.32.84.165",1777,"184.82.155.108",80,10,1511,5,599,5,912,91503.237124,0.3246579999977257,14760.147601579412,22472.879152989022
"147.32.84.165",1815,"216.69.186.201",25,3,186,3,186,0,0,91503.343703,8.994064999991679,165.44243342708515,0
"147.32.84.165",1825,"168.95.5.56",25,3,186,3,186,0,0,91503.409731,9.028854999996838,164.80495035090507,0
"147.32.84.165",1754,"46.4.36.120",443,6,366,3,186,3,180,91513.743674,1.0315899999986868,1442.4335249487629,1395.903411240738
"147.32.84.165",1786,"217.163.21.38",80,13,6081,6,750,7,5331,91514.747996,0.1863409999932628,32199.03295687439,228870.72625746316
"147.32.84.165",1830,"209.85.227.27",25,3,186,3,186,0,0,91514.775498,8.903573000003234,167.12391755528478,0
"147.32.84.165",1777,"184.82.147.251",80,10,1910,5,982,5,928,91514.793865,0.3226299999951152,24349.874469574883,23010.87933581007
"147.32.84.165",1832,"74.125.77.27",25,3,186,3,186,0,0,91514.900425,8.879226000004564,167.5821743921413,0
"147.32.84.165",1788,"217.163.21.39",80,10,1451,5,701,5,750,91515.349301,0.14219300000695512,39439.35355274658,42196.169992239564
"147.32.84.165",1835,"74.125.244.11",25,3,186,3,186,0,0,91515.397373,8.984897999995155,165.6112289756436,0
"147.32.84.165",1786,"184.82.147.252",80,10,1507,5,596,5,911,91515.650305,0.32520500000100583,14661.521194278233,22410.479543603138
"147.32.84.165",1841,"205.188.159.42",25,3,186,3,186,0,0,91515.756805,8.927672999998322,166.6727712809687,0
"147.32.84.165",1754,"46.4.36.120",443,6,366,3,186,3,180,91516.152259,1.030789000011282,1443.5544034557158,1396.9881323764992
"147.32.84.165",1796,"217.163.21.39",80,10,1500,5,693,5,807,91516.253234,0.13999299998977222,39601.98010189824,46116.59154723215
"147.32.84.165",1843,"98.139.175.224",25,3,186,3,186,0,0,91516.299133,8.886918000003789,167.43712499646847,0
"147.32.84.165",1788,"217.163.21.39",80,14,6134,7,809,7,5325,91516.654019,0.19178600001032464,33745.94600049839,222122.57410711242
"147.32.84.165",1846,"128.121.85.2",25,3,186,3,186,0,0,91516.699807,8.888094000009005,167.41497108361955,0
"147.32.84.165",1802,"77.238.167.32",80,8,1722,5,750,3,972,91517.155817,0.1404340000008233,42724.696298366674,55371.20640268321
"147.32.84.165",1853,"62.242.235.202",25,3,186,3,186,0,0,91517.183285,8.906628999990062,167.06657479520706,0
"147.32.84.165",1796,"217.163.21.39",80,10,1446,5,698,5,748,91517.201666,0.14827300001343247,37660.261810944205,40357.988301699515
"147.32.84.165",1858,"65.55.92.184",25,3,186,3,186,0,0,91517.247549,8.842485999994096,168.27846829511446,0
"147.32.84.165",1813,"46.4.36.120",443,6,366,3,186,3,180,91524.282018,1.0320230000070296,1441.8283313355075,1395.317740002104
"147.32.84.165",1805,"217.163.21.39",80,11,2612,6,799,5,1813,91524.382404,0.26328499999362975,24277.873787548306,55088.59221129547
"147.32.84.165",1862,"124.108.110.37",25,3,186,3,186,0,0,91524.428243,8.990065999998478,165.51602624499662,0
"147.32.84.165",1796,"212.117.171.138",65500,15,921,9,546,6,375,91525.314248,58.71389700000873,74.39465310911572,51.09522878373333
"147.32.84.165",1809,"217.163.21.39",80,10,1495,5,690,5,805,91525.336801,0.14004600000043865,39415.620581685376,45984.89067863294
"147.32.84.165",1863,"65.55.92.136",25,3,186,3,186,0,0,91525.382867,8.93838200000755,166.47308204088202,0
"147.32.84.165",1809,"46.4.36.120",443,6,366,3,186,3,180,91535.72579,1.0304029999970226,1444.0951744165145,1397.5114591127558
"147.32.84.165",1756,"217.163.21.39",80,10,2277,5,1156,5,1121,91535.825858,0.14011300000129268,66003.86830568669,64005.48128951105
"147.32.84.165",1865,"98.139.175.224",25,3,186,3,186,0,0,91535.871785,8.985603000008268,165.59823531026586,0
"147.32.84.165",1788,"77.238.167.32",80,8,1647,5,781,3,866,91535.871845,0.13894999999320135,44965.81504358191,49859.66175127009
"147.32.84.165",1870,"209.85.227.27",25,3,186,3,186,0,0,91535.917623,8.939887999993516,166.4450382377362,0
"147.32.84.165",1832,"217.163.21.39",80,11,3182,6,1378,5,1804,91536.428004,0.16078099999867845,68565.31555401828,89761.84997057254
"147.32.84.165",1873,"67.231.152.184",25,3,186,3,186,0,0,91536.473893,8.98562999999558,165.59773772130967,0
"147.32.84.165",1756,"195.113.232.90",80,59,67304,40,5612,19,61692,91536.729023,68.01809999998659,660.0596017825968,7255.950989517457
"147.32.84.165",1874,"206.46.232.11",25,3,186,3,186,0,0,91536.729858,9.030903999999282,164.76755815365973,0
"147.32.84.165",1788,"195.113.232.99",80,11,2010,6,685,5,1325,91536.756461,0.025747000006958842,212840.33085481328,411698.45019361697
"147.32.84.165",1875,"65.55.37.120",25,3,186,3,186,0,0,91536.757271,9.003618000002461,165.26689604107963,0
"147.32.84.165",1835,"195.113.232.97",80,8,1423,5,849,3,574,91537.230199,67.51680700000725,100.5971742709822,68.01269497237195
"147.32.84.165",1876,"64.184.32.11",25,3,186,3,186,0,0,91537.231051,9.031409000002895,164.75834501565845,0
"147.32.84.165",1788,"217.163.21.36",80,14,6033,7,1021,7,5012,91537.631673,0.18832200000179,43372.52153185694,212911.92744139765
"147.32.84.165",1880,"124.108.110.37",25,3,186,3,186,0,0,91537.677537,8.986109999998007,165.58889219031707,0
"147.32.84.165",1882,"66.94.238.147",25,3,186,3,186,0,0,91537.677599,8.986172000004444,165.58774971136364,0
"147.32.84.165",1841,"46.4.36.120",443,6,366,3,186,3,180,91538.135582,1.03042799999821,1444.0601381198733,1397.4775530192323
"147.32.84.165",1809,"217.163.21.36",80,11,3405,6,965,5,2440,91538.135712,0.23971300000266638,32205.178692495312,81430.71089086897
"147.32.84.165",1884,"98.139.175.224",25,3,186,3,186,0,0,91538.18166,8.984685000003083,165.61515512224295,0
"147.32.84.165",1846,"195.113.232.88",80,18,19175,12,1463,6,17712,91539.16625,65.58062200000859,178.46735274939093,2160.6382446324073
"147.32.84.165",1885,"209.85.227.27",25,3,186,3,186,0,0,91539.16715,9.002965000006952,165.2788831233767,0
"147.32.84.165",1788,"184.82.148.43",80,10,1923,5,983,5,940,91539.167208,0.3283519999968121,23949.907416663675,22902.251242791306
"147.32.84.165",1886,"66.76.67.68",25,3,186,3,186,0,0,91539.275111,8.995408000002499,165.41773313668338,0
"147.32.84.165",1809,"184.82.148.44",80,10,1513,5,596,5,917,91545.459664,0.3228150000068126,14770.069544164233,22725.090221474165
"147.32.84.165",1887,"64.184.32.12",25,3,186,3,186,0,0,91545.566158,8.926412999993772,166.69629782993889,0
"147.32.84.165",1809,"46.4.36.120",443,6,366,3,186,3,180,91546.362793,1.0315020000125514,1442.5565825193687,1396.0224992122924
"147.32.84.165",1862,"217.163.21.40",80,13,6077,6,749,7,5328,91547.394507,0.18817300000227988,31843.038055020654,226514.96229259018
"147.32.84.165",1888,"205.188.159.42",25,3,186,3,186,0,0,91547.44036,8.85749000000942,167.99341574175273,0
"147.32.84.165",1809,"46.4.36.120",443,6,366,3,186,3,180,91556.800047,1.0309870000055525,1443.2771703154222,1396.7198422407312
"147.32.84.165",1863,"184.82.148.43",80,10,1923,5,983,5,940,91557.401483,0.32456600001023617,24229.278481886537,23169.40160017634
"147.32.84.165",1891,"213.188.129.251",25,3,186,3,186,0,0,91557.50788,9.027760999990278,164.82492170557046,0
"147.32.84.165",1892,"212.82.111.207",25,3,186,3,186,0,0,91557.70238,9.034325000000536,164.70516613027667,0
"147.32.84.165",1895,"216.2.23.3",25,3,186,3,186,0,0,91557.702512,9.03432900000189,164.7050932061129,0
"147.32.84.165",1897,"64.12.138.161",25,3,186,3,186,0,0,91557.831371,9.006716000003507,165.2100499226822,0
"147.32.84.165",1899,"194.224.239.225",25,3,186,3,186,0,0,91558.204874,9.034224999995786,164.7069892548275,0
"147.32.84.165",1900,"74.125.77.27",25,3,186,3,186,0,0,91558.605485,9.035327000005054,164.68690065109627,0
"147.32.84.165",1874,"46.4.36.120",443,6,366,3,186,3,180,91559.107438,1.0301919999910751,1444.3909484959026,1397.797692092809
"147.32.84.165",1902,"205.188.59.194",25,3,186,3,186,0,0,91560.137873,9.008184000005713,165.183126809916,0
"147.32.84.165",1905,"98.139.54.60",25,3,186,3,186,0,0,91560.210773,9.035952000005636,164.67550956435713,0
"147.32.84.165",1874,"83.229.4.202",6667,2,124,2,124,0,0,91566.535792,3.0123180000082357,329.314501323329,0
"147.32.84.165",1882,"46.4.36.120",443,6,366,3,186,3,180,91568.342872,1.0315400000108639,1442.5034414412712,1395.9710723625205
"147.32.84.165",1876,"74.117.116.123",80,11,3393,6,615,5,2778,91569.374649,0.9149780000007013,5377.178467674883,24289.108590570446
"147.32.84.165",1906,"65.55.92.168",25,3,186,3,186,0,0,91569.521473,8.956411000006483,166.13797647282186,0
"147.32.84.165",1876,"46.4.36.120",443,6,366,3,186,3,180,91578.578645,1.0303779999958351,1444.1302124133226,1397.5453668516027
"147.32.84.165",1908,"213.171.216.114",25,3,186,3,186,0,0,91578.779136,8.929423000008683,166.64010653303725,0
"147.32.84.165",1909,"81.19.46.25",25,3,186,3,186,0,0,91578.779273,8.929381000009016,166.64089033702308,0
"147.32.84.165",1910,"98.139.175.224",25,3,186,3,186,0,0,91578.879555,8.92929399998684,166.64251395487628,0
"147.32.84.165",1911,"209.85.227.27",25,3,186,3,186,0,0,91579.281274,8.928694000001997,166.65371217780196,0
"147.32.84.165",1920,"203.188.197.119",25,3,186,3,186,0,0,91579.609243,8.901559000005363,167.1617297598211,0
"147.32.84.165",1922,"207.115.20.23",25,3,186,3,186,0,0,91579.68165,8.929585000005318,166.63708335819794,0
"147.32.84.165",1895,"46.4.36.120",443,6,366,3,186,3,180,91581.086016,1.0319000000017695,1442.0001938147575,1395.4840585304105
"147.32.84.165",1925,"213.188.129.251",25,3,186,3,186,0,0,91581.18655,9.02968000000692,164.78989288644334,0
"147.32.84.165",1897,"184.82.148.43",80,10,1919,5,983,5,936,91582.118174,0.32607300000381656,24117.29888677675,22964.18286675792
"147.32.84.165",1929,"205.188.59.194",25,3,186,3,186,0,0,91582.225945,8.993459999997867,165.4535629224295,0
"147.32.84.165",1895,"46.4.36.120",443,6,366,3,186,3,180,91583.495323,1.0309950000082608,1443.2659712104107,1396.7090043971716
"147.32.84.165",1876,"184.82.148.44",80,10,1497,5,592,5,905,91584.526559,0.32533500000135973,14557.30247277485,22253.984354495336
"147.32.84.165",1932,"205.188.103.2",25,3,186,3,186,0,0,91584.633195,8.996297999998205,165.40136842958034,0
"147.32.84.165",1905,"212.117.171.138",65500,16,981,9,546,7,435,91590.417118,195.55629500000214,22.336279177307752,17.795387256646286
"147.32.84.165",1934,"98.139.175.224",25,3,186,3,186,0,0,91590.439616,9.008533999993233,165.17670910728847,0
"147.32.84.165",1935,"209.85.227.27",25,3,186,3,186,0,0,91590.439673,9.008596999992733,165.17555397374312,0
"147.32.84.165",1941,"65.55.37.104",25,3,186,3,186,0,0,91590.439722,9.00859599999967,165.17557230894298,0
"147.32.84.165",1943,"196.8.104.18",25,3,186,3,186,0,0,91599.749079,9.02863499999512,164.8089661394889,0
"147.32.84.165",1944,"204.255.212.244",25,3,186,3,186,0,0,91599.749215,9.02863200000138,164.80902090148015,0
"147.32.84.165",1947,"76.96.30.116",25,3,186,3,186,0,0,91599.849587,9.028454999992391,164.8122519302864,0
"147.32.84.165",1950,"205.188.190.2",25,3,186,3,186,0,0,91600.250542,9.02896400001191,164.80296078243717,0
"147.32.84.165",1910,"46.4.36.120",443,6,366,3,186,3,180,91600.551655,1.0301449999969918,1444.4568483119806,1397.8614661083682
"147.32.84.165",1953,"64.12.90.98",25,3,186,3,186,0,0,91600.652514,9.02793300000485,164.82178146417354,0
"147.32.84.165",1911,"74.117.116.125",80,11,3380,6,614,5,2766,91601.582061,0.9378010000073118,5237.784988458855,23595.62423139608
"147.32.84.165",1957,"209.85.227.27",25,3,186,3,186,0,0,91601.725911,8.957612999991397,166.11568282771637,0
"147.32.84.165",1964,"65.55.37.72",25,3,186,3,186,0,0,91602.256865,9.028625999999349,164.80913042583748,0
"147.32.84.165",1922,"46.4.36.120",443,6,366,3,186,3,180,91603.260293,1.0303640000056475,1444.1498344195295,1397.5643558898673
"147.32.84.165",1920,"74.117.116.125",80,15,12074,10,1264,5,10810,91604.290966,1.0115130000049248,9996.905625484564,85495.6881420001
"147.32.84.165",1967,"205.188.59.194",25,3,186,3,186,0,0,91604.426934,8.864875999992364,167.8534476964237,0
"147.32.84.165",1925,"109.200.239.148",6667,3,186,3,186,0,0,91605.667406,8.928991000007954,166.64816886910003,0
"147.32.84.165",1932,"46.4.36.120",443,6,366,3,186,3,180,91611.486431,1.0365299999975832,1435.559028685585,1389.2506729215338
"147.32.84.165",1835,"74.117.116.125",80,4,244,3,182,1,62,91612.523209,0.1436109999922337,10138.499140586297,3453.7744325074195
"147.32.84.165",1969,"74.125.157.27",25,3,186,3,186,0,0,91612.666681,8.953158000003896,166.19834029505037,0
"147.32.84.165",1846,"74.117.116.125",80,4,244,3,182,1,62,91620.716749,0.14559499999450054,10000.343418764356,3406.7103954032423
"147.32.84.165",1970,"194.242.61.28",25,3,186,3,186,0,0,91620.716883,9.0297750000027,164.78815917335203,0
"147.32.84.165",1973,"205.188.146.194",25,3,186,3,186,0,0,91620.817309,9.029743999999482,164.78872490738223,0
"147.32.84.165",1975,"200.155.87.21",25,3,186,3,186,0,0,91620.862074,8.98509999999078,165.60750575970516,0
"147.32.84.165",1977,"65.55.92.136",25,3,186,3,186,0,0,91621.218443,9.029895999992732,164.78595102326733,0
"147.32.84.165",1944,"46.4.36.120",443,5,306,3,186,2,120,91621.619943,3.538283000001684,420.5429582651506,271.31803759041975
"147.32.84.165",1982,"65.55.88.22",25,3,186,3,186,0,0,91622.622956,9.02949199998693,164.79332392145136,0
"147.32.84.165",1983,"98.139.175.224",25,3,186,3,186,0,0,91623.224328,9.030100999996648,164.7822100772242,0
"147.32.84.165",1998,"173.212.188.85",25,3,186,3,186,0,0,91624.629268,9.030226999995648,164.77991084838922,0
"147.32.84.165",1957,"117.204.73.246",6667,3,186,3,186,0,0,91625.158468,9.004353000011179,165.25340576920436,0
"147.32.84.165",1999,"202.75.53.173",25,3,186,3,186,0,0,91625.331304,9.031652999998187,164.75389388856047,0
"147.32.84.165",1967,"46.4.36.120",443,6,366,3,186,3,180,91633.659565,1.0322280000109458,1441.5419848950244,1395.040630543572
"147.32.84.165",2000,"209.85.227.27",25,3,186,3,186,0,0,91634.692034,8.901681999996072,167.1594199838476,0
"147.32.84.165",1957,"46.4.36.120",443,6,366,3,186,3,180,91641.788236,1.0364390000031563,1435.6850716689246,1389.372650002185
"147.32.84.165",2006,"205.188.159.42",25,3,186,3,186,0,0,91641.888916,8.928044000000227,166.66584528480843,0
"147.32.84.165",2007,"66.94.238.147",25,3,186,3,186,0,0,91641.889146,8.927945000003092,166.6676934053116,0
"147.32.84.165",2021,"212.27.48.7",25,3,186,3,186,0,0,91642.289082,8.928533999991487,166.65669862503955,0
"147.32.84.165",2023,"98.139.175.224",25,3,186,3,186,0,0,91642.824921,8.99497899999551,165.4256224501183,0
"147.32.84.165",2025,"65.55.88.22",25,3,186,3,186,0,0,91642.825026,8.995010999991791,165.42503394396715,0
"147.32.84.165",2031,"65.55.92.136",25,3,186,3,186,0,0,91642.825082,8.995020000002114,165.4248684271575,0
"147.32.84.165",2038,"74.125.67.27",25,3,186,3,186,0,0,91643.593851,9.028621000004932,164.80922169611364,0
"147.32.84.165",1973,"46.4.36.120",443,6,366,3,186,3,180,91644.195382,1.0368229999876348,1435.1533482742434,1388.8580789750742
"147.32.84.165",2042,"209.86.93.229",25,3,186,3,186,0,0,91645.232455,8.994833999997354,165.42828917136634,0
"147.32.84.165",2043,"205.188.146.194",25,3,186,3,186,0,0,91645.600174,9.028894999995828,164.80422022857587,0
"147.32.84.165",2049,"64.204.118.35",25,3,186,3,186,0,0,91645.700979,9.028198999993037,164.8169252805734,0
"147.32.84.165",1998,"46.4.36.120",443,6,366,3,186,3,180,91646.302424,1.0306220000056783,1443.7883142333483,1397.2144976451757
"147.32.84.165",2054,"209.85.227.27",25,3,186,3,186,0,0,91647.333279,9.001598999995622,165.3039643290846,0
"147.32.84.165",2062,"65.54.188.110",25,3,186,3,186,0,0,91647.333339,9.001674999992247,165.30256868874756,0
"147.32.84.165",1998,"46.4.36.120",443,6,366,3,186,3,180,91655.632064,1.030903999999282,1443.3933712557487,1396.832294763628
"147.32.84.165",2069,"98.139.175.224",25,3,186,3,186,0,0,91656.6632,9.00388100001146,165.26206865662772,0
"147.32.84.165",1998,"46.4.36.120",443,6,366,3,186,3,180,91662.858071,1.0302640000008978,1444.2900072201915,1397.700006987282
"147.32.84.165",2070,"64.12.90.98",25,3,186,3,186,0,0,91662.858206,9.031753999995999,164.75205148420332,0
"147.32.84.165",2088,"173.212.188.85",25,3,186,3,186,0,0,91663.258078,9.032854999997653,164.7319701246601,0
"147.32.84.165",2090,"74.125.67.27",25,3,186,3,186,0,0,91663.860908,9.033324999996694,164.72339919138795,0
"147.32.84.165",2093,"184.191.34.121",25,3,186,3,186,0,0,91663.860939,9.033398999992642,164.7220498066356,0
"147.32.84.165",2096,"148.177.3.75",25,3,186,3,186,0,0,91663.888576,9.005785000001197,165.22712900649995,0
"147.32.84.165",2097,"59.160.18.195",25,3,186,3,186,0,0,91664.663004,9.03503099999216,164.6922960199352,0
"147.32.84.165",1998,"77.239.2.219",6667,3,186,3,186,0,0,91666.26921,8.935398000001442,166.5286761708611,0
"147.32.84.165",2007,"46.4.36.120",443,6,366,3,186,3,180,91666.670443,1.0303669999993872,1444.1456296648523,1397.5602867724378
"147.32.84.165",2113,"209.85.227.27",25,3,186,3,186,0,0,91666.770728,8.935700999994879,166.5230293628729,0
"147.32.84.165",2116,"80.67.18.126",25,3,186,3,186,0,0,91667.701052,8.907723999989685,167.04603779840093,0
"147.32.84.165",2124,"65.55.37.104",25,3,186,3,186,0,0,91668.376634,8.934318999992684,166.54878788201077,0
"147.32.84.165",2049,"46.4.36.120",443,6,366,3,186,3,180,91677.61198,1.0316619999939576,1442.3328570876074,1395.8059907299426
"147.32.84.165",2125,"65.55.92.136",25,3,186,3,186,0,0,91678.643884,9.003880999996909,165.26206865689483,0
"147.32.84.165",2049,"46.4.36.120",443,6,366,3,186,3,180,91683.835197,1.0361480000137817,1436.0882808056458,1389.7628523925605
"147.32.84.165",2126,"64.12.90.34",25,3,186,3,186,0,0,91684.236466,9.030945999998949,164.7667918732072,0
"147.32.84.165",2128,"64.12.90.98",25,3,186,3,186,0,0,91684.838098,9.030829000010272,164.76892652914893,0
"147.32.84.165",2130,"98.139.175.224",25,3,186,3,186,0,0,91684.838134,9.030973999993876,164.7662810236204,0
"147.32.84.165",2131,"207.115.37.23",25,3,186,3,186,0,0,91684.871585,8.99758500000462,165.37770968534736,0
"147.32.84.165",2135,"94.245.120.86",25,3,186,3,186,0,0,91685.640986,9.030241000000387,164.7796553823908,0
"147.32.84.165",2070,"46.4.36.120",443,6,366,3,186,3,180,91686.343651,1.0313869999954477,1442.717428091073,1396.1781562171675
"147.32.84.165",2137,"209.155.69.5",25,3,186,3,186,0,0,91687.375268,9.001915000000736,165.2981615578328,0
"147.32.84.165",2049,"58.143.125.236",6667,6,366,3,186,3,180,91687.748778,1.9220320000022184,774.1806588018735,749.2070891631034
"147.32.84.165",2097,"46.4.36.120",443,5,306,3,186,2,120,91688.651341,1.0028199999942444,1483.8156399040108,957.3004128412973
"147.32.84.165",2142,"65.55.88.22",25,3,186,3,186,0,0,91689.353793,9.029452999995556,164.79403569637412,0
"147.32.84.165",2149,"209.85.227.27",25,3,186,3,186,0,0,91689.671018,9.01345399999991,165.08654728808898,0
"147.32.84.165",2152,"205.188.146.194",25,3,186,3,186,0,0,91699.687349,8.929455999998027,166.63949069241497,0
"147.32.84.165",2155,"205.188.159.42",25,3,186,3,186,0,0,91701.694102,8.930191999999806,166.6257567586489,0
"147.32.84.165",2097,"46.4.36.120",443,5,306,3,186,2,120,91705.306248,3.4444750000111526,431.9961677745323,278.7072050158273
"147.32.84.165",2156,"98.139.175.224",25,3,186,3,186,0,0,91705.808541,9.029123000000254,164.80005865463988,0
"147.32.84.165",2157,"65.55.37.104",25,3,186,3,186,0,0,91705.808667,9.0291189999989,164.80013166292096,0
"147.32.84.165",2160,"205.188.190.1",25,3,186,3,186,0,0,91705.80873,9.02910499999416,164.80038719241412,0
"147.32.84.165",2172,"69.174.249.99",25,3,186,3,186,0,0,91705.808787,9.029096999991452,164.80053320962313,0
"147.32.84.165",2169,"124.108.110.37",25,3,186,3,186,0,0,91706.610477,9.029552000007243,164.7922288945018,0
"147.32.84.165",2128,"74.125.93.27",25,3,186,3,186,0,0,91708.316371,9.03179400000954,164.75132183023973,0
"147.32.84.165",2187,"205.188.190.2",25,3,186,3,186,0,0,91708.750994,8.99822999999742,165.3658552849201,0
"147.32.84.165",2137,"46.148.34.36",6667,3,186,3,186,0,0,91710.323287,9.03172599998652,164.75256224582333,0
"147.32.84.165",2097,"46.4.36.120",443,6,366,3,186,3,180,91710.624428,1.0362310000055004,1435.9732530604679,1389.6515352198076
"147.32.84.165",2193,"98.139.175.224",25,3,186,3,186,0,0,91711.660895,8.997212000002037,165.3845657965671,0
"147.32.84.165",2097,"46.4.36.120",443,6,366,3,186,3,180,91720.658245,1.031197999996948,1442.9818521800894,1396.4340504968607
"147.32.84.165",2196,"74.125.113.27",25,3,186,3,186,0,0,91721.68966,9.002861000000848,165.28079240586518,0
"147.32.84.165",2197,"66.94.238.147",25,3,186,3,186,0,0,91722.66487,9.031721999999718,164.7526352117621,0
"147.32.84.165",2097,"46.4.36.120",443,6,366,3,186,3,180,91726.878925,1.0311579999979585,1443.0378273775173,1396.4882200427587
"147.32.84.165",2202,"65.55.88.22",25,3,186,3,186,0,0,91726.879086,9.030811000004178,164.76925494280763,0
"147.32.84.165",2222,"205.188.59.194",25,3,186,3,186,0,0,91726.879147,9.030872999996063,164.76812374624785,0
"147.32.84.165",2226,"212.27.48.7",25,3,186,3,186,0,0,91727.681924,8.930637999990722,166.61743539504633,0
"147.32.84.165",2229,"207.25.182.22",25,3,186,3,186,0,0,91727.910359,8.902266999997664,167.14843533679573,0
"147.32.84.165",2160,"46.4.36.120",443,6,366,3,186,3,180,91729.386883,1.031887999997707,1442.016963084469,1395.5002868559377
"147.32.84.165",2235,"199.239.254.18",25,3,186,3,186,0,0,91729.789461,8.930735000001732,166.61562570154769,0
"147.32.84.165",2172,"74.125.39.27",25,3,186,3,186,0,0,91730.419031,8.904194999995525,167.11224316187457,0
"147.32.84.165",2254,"119.205.212.218",25,3,186,3,186,0,0,91730.491974,8.931177999998908,166.60736131338797,0
"147.32.84.165",2160,"46.4.36.120",443,6,366,3,186,3,180,91732.699844,1.0309719999931986,1443.298169115957,1396.7401636606037
"147.32.84.165",2255,"209.85.227.27",25,3,186,3,186,0,0,91733.731054,8.902319999993779,167.14744021794766,0
"147.32.84.165",2160,"46.4.36.120",443,6,366,3,186,3,180,91742.633511,1.0321539999858942,1441.6453358901244,1395.1406476356044
"147.32.84.165",2256,"118.82.64.32",25,3,186,3,186,0,0,91743.638365,9.029111999989254,164.8002594277013,0
"147.32.84.165",2258,"78.67.169.66",25,3,186,3,186,0,0,91743.665873,9.001724999994622,165.301650517083,0
"147.32.84.165",2160,"46.4.36.120",443,6,366,3,186,3,180,91747.852,1.0317869999998948,1442.15811984465,1395.636890172242
"147.32.84.165",2260,"64.12.90.98",25,3,186,3,186,0,0,91747.852133,9.029460000005201,164.79390794124376,0
"147.32.84.165",2262,"61.196.224.4",25,3,186,3,186,0,0,91748.655078,9.02955400000792,164.7921923938541,0
"147.32.84.165",2263,"64.12.138.161",25,3,186,3,186,0,0,91748.856353,9.028589000008651,164.80980582885923,0
"147.32.84.165",2277,"202.172.28.162",25,3,186,3,186,0,0,91748.884033,9.001032000000123,165.31437728473577,0
"147.32.84.165",2160,"46.4.36.120",443,6,366,3,186,3,180,91750.761628,1.0307030000112718,1443.6748510324771,1397.1046945475584
"147.32.84.165",2280,"205.188.59.193",25,3,186,3,186,0,0,91751.363391,9.029500999997254,164.7931596663484,0
"147.32.84.165",2172,"66.111.4.71",25,3,186,3,186,0,0,91751.463658,9.030160000009346,164.78113344596994,0
"147.32.84.165",2284,"65.55.92.152",25,3,186,3,186,0,0,91751.792809,9.001780999999028,165.30062217689596,0
"147.32.84.165",2160,"46.4.36.120",443,6,366,3,186,3,180,91754.674963,1.0308999999979278,1443.3989717751392,1396.8377146211024
"147.32.84.165",2290,"216.33.127.20",25,3,186,3,186,0,0,91755.706086,9.002129999993485,165.29421370287665,0
"147.32.84.165",2255,"46.4.36.120",443,6,366,3,186,3,180,91764.708352,1.031306000004406,1442.8307408214853,1396.2878136982117
"147.32.84.165",2298,"196.13.158.33",25,3,186,3,186,0,0,91764.708415,8.931786999994074,166.59600144976446,0
"147.32.84.165",2299,"74.125.148.11",25,3,186,3,186,0,0,91765.739944,8.903680000003078,167.12190914312797,0
"147.32.84.165",2256,"46.4.36.120",443,6,366,3,186,3,180,91768.825035,1.029991000003065,1444.6728175251747,1398.0704685727496
"147.32.84.165",2306,"64.12.90.97",25,3,186,3,186,0,0,91769.626387,9.03126400000474,164.76099026661373,0
"147.32.84.165",2312,"64.12.138.161",25,3,186,3,186,0,0,91769.827654,9.031415000004927,164.7582355587899,0
"147.32.84.165",2314,"64.12.90.98",25,3,186,3,186,0,0,91769.827713,9.03145099998801,164.75757882116343,0
"147.32.84.165",2317,"205.188.156.193",25,3,186,3,186,0,0,91769.855254,9.003935000000638,165.26107751776246,0
"147.32.84.165",2260,"110.36.112.54",6667,3,186,3,186,0,0,91772.336361,9.03006400000595,164.78288525961938,0
"147.32.84.165",2256,"46.4.36.120",443,6,366,3,186,3,180,91772.43666,1.0309899999992922,1443.2729706408613,1396.7157780395432
"147.32.84.165",2322,"209.85.227.27",25,3,186,3,186,0,0,91772.737996,9.029533000008087,164.79257565132852,0
"147.32.84.165",2277,"216.157.130.15",25,3,186,3,186,0,0,91773.467896,9.002019999999902,165.29623351203577,0
"147.32.84.165",2334,"98.139.175.224",25,3,186,3,186,0,0,91776.650889,9.029672999997274,164.7900206353485,0
"147.32.84.165",2256,"46.4.36.120",443,6,366,3,186,3,180,91785.680706,1.0310580000077607,1443.1777843620823,1396.6236622858862
"147.32.84.165",2290,"173.192.170.88",80,30,4822,14,1063,16,3759,91786.684361,36.7731819999899,231.25548395573534,817.769862831241
"147.32.84.165",2336,"76.96.30.116",25,3,186,3,186,0,0,91786.712012,9.001499999998487,165.30578236963285,0
"147.32.84.165",2298,"212.117.171.138",65500,15,929,9,546,6,383,91786.885374,45.9795049999957,94.99884785624397,66.6383859504422
"147.32.84.165",2343,"94.245.120.86",25,3,186,3,186,0,0,91786.907897,9.006261000002269,165.21839640219457,0
"147.32.84.165",2299,"31.192.109.161",80,10,1273,5,540,5,733,91790.69796,0.24494999999296851,17636.25229689328,23939.57950670884
"147.32.84.165",1905,"46.4.36.120",443,6,366,3,186,3,180,91790.77747,1.0530189999990398,1413.079915938228,1367.4966928434465
"147.32.84.165",2345,"65.55.92.184",25,3,186,3,186,0,0,91790.898659,8.928394999995362,166.65929318771995,0
"147.32.84.165",2349,"205.188.190.2",25,3,186,3,186,0,0,91790.898724,8.92842599999858,166.65871453716886,0
"147.32.84.165",2361,"118.143.56.171",25,3,186,3,186,0,0,91790.898751,8.928434000001289,166.65856520861163,0
"147.32.84.165",2365,"98.139.175.224",25,3,186,3,186,0,0,91791.701416,8.927835000009509,166.6697469205485,0
"147.32.84.165",2366,"193.180.251.59",25,3,186,3,186,0,0,91791.701543,8.92783299999428,166.66978425794406,0
"147.32.84.165",2299,"41.223.57.75",6667,3,186,3,186,0,0,91791.830594,8.899294999995618,167.20425606755734,0
"147.32.84.165",2306,"46.4.36.120",443,6,366,3,186,3,180,91793.807916,1.030306999993627,1444.229729594387,1397.6416738010198
"147.32.84.165",2376,"85.158.140.115",25,3,186,3,186,0,0,91794.510178,8.928404999998747,166.65910652576903,0
"147.32.84.165",2391,"205.188.146.193",25,3,186,3,186,0,0,91794.838438,8.901136999993469,167.16965484309384,0
"147.32.84.165",2314,"46.4.36.120",443,6,366,3,186,3,180,91797.720344,1.0313779999996768,1442.7300175110058,1396.19033952678
"147.32.84.165",2394,"64.12.90.66",25,3,186,3,186,0,0,91798.752181,8.90048399999796,167.1819195450878,0
"147.32.84.165",1905,"208.73.210.29",80,46,33854,20,2023,26,31831,91807.652804,11.800000999995973,1371.5253074983234,21580.337154216082
"147.32.84.165",2277,"46.4.36.120",443,6,366,3,186,3,180,91807.838525,1.0468760000076145,1421.3717765897557,1375.5210741191183
"147.32.84.165",2397,"209.85.225.27",25,3,186,3,186,0,0,91807.854685,9.030563000007533,164.77377988490406,0
"147.32.84.165",2314,"74.125.232.217",80,8,1905,5,1031,3,874,91808.885635,10.567366000002949,780.5161664692695,661.6596794317571
"147.32.84.165",2334,"212.117.171.138",65500,9,544,5,302,4,242,91808.893832,313.4514099999942,7.707733712220483,6.17639588860052
"147.32.84.165",2407,"216.17.3.48",25,3,186,3,186,0,0,91808.893893,8.994307999993907,165.4379636544588,0
"147.32.84.165",2343,"94.127.76.180",80,16,5664,9,3186,7,2478,91811.867835,7.585252000004402,3360.204776319258,2613.4926038038675
"147.32.84.165",2299,"67.195.168.31",25,3,186,3,186,0,0,91811.867905,9.03115299998899,164.76301530954177,0
"147.32.84.165",2277,"46.4.36.120",443,6,366,3,186,3,180,91811.867965,1.030362999998033,1444.1512360234603,1397.565712280768
"147.32.84.165",2409,"205.188.156.193",25,3,186,3,186,0,0,91811.881875,9.017309999995632,165.0159526511477,0
"147.32.84.165",2345,"94.127.76.180",80,8,1421,5,830,3,591,91812.268317,7.184586000003037,924.2007820627651,658.0754966254146
"147.32.84.165",2417,"65.55.88.22",25,3,186,3,186,0,0,91812.268452,9.031991999989259,164.74771013988604,0
"147.32.84.165",2349,"67.214.158.5",80,10,1710,5,855,5,855,91812.670005,0.33240299999306444,20577.4316120574,20577.4316120574
"147.32.84.165",2419,"82.94.214.131",25,3,186,3,186,0,0,91812.773443,9.02846000000136,164.81216065638833,0
"147.32.84.165",2361,"195.113.232.83",80,8,1359,5,771,3,588,91812.898568,6.554686999996193,941.0060312572641,717.654405161182
"147.32.84.165",2424,"66.94.238.147",25,3,186,3,186,0,0,91812.899267,9.003207000001566,165.2744405409918,0
"147.32.84.165",2365,"67.214.158.5",80,10,1773,5,877,5,896,91815.481197,0.3388059999997495,20708.015796665903,21156.65011837246
"147.32.84.165",2366,"46.4.36.120",443,6,366,3,186,3,180,91815.585626,1.026270000002114,1449.9108421730486,1403.1395246835955
"147.32.84.165",2426,"98.139.175.224",25,3,186,3,186,0,0,91815.782204,9.031542999990052,164.755900514634,0
"147.32.84.165",2365,"68.67.185.215",80,8,1494,5,584,3,910,91816.612133,2.8410389999917243,1644.4688017354247,2562.4428246219804
"147.32.84.165",2440,"64.12.90.34",25,3,186,3,186,0,0,91816.64152,8.974676999991061,165.7998388133057,0
"147.32.84.165",2366,"46.4.36.120",443,6,366,3,186,3,180,91819.694318,1.0319740000122692,1441.8967919562983,1395.3839922157727
"147.32.84.165",2442,"65.55.37.88",25,3,186,3,186,0,0,91820.726585,9.004020000007586,165.25951741541516,0
"147.32.84.165",2345,"95.111.183.113",6667,2,124,2,124,0,0,91828.926867,2.9107959999964805,340.80024845478675,0
"147.32.84.165",2343,"46.4.36.120",443,6,366,3,186,3,180,91829.931361,0.9305920000042534,1598.982153288658,1547.4020838277338
"147.32.84.165",2361,"173.192.170.88",80,11,1099,6,542,5,557,91830.862177,75.29322500000126,57.588182734899824,59.181951629777124
"147.32.84.165",2397,"184.82.155.107",80,10,1913,5,985,5,928,91831.063202,0.3446819999953732,22861.65218986131,21538.693636742435
"147.32.84.165",2443,"203.188.197.119",25,3,186,3,186,0,0,91831.17706,8.990781000000425,165.50286343310216,0
"147.32.84.165",2343,"46.4.36.120",443,6,366,3,186,3,180,91832.841488,1.031422999993083,1442.6670725880447,1396.1294250852045
"147.32.84.165",2407,"184.82.155.108",80,10,1508,5,596,5,912,91832.841621,0.3230840000032913,14757.771972463594,22582.362481353688
"147.32.84.165",2446,"205.188.159.42",25,3,186,3,186,0,0,91832.948116,9.02523199999996,164.87110802248702,0
"147.32.84.165",2298,"217.163.21.37",80,13,6081,6,750,7,5331,91833.242354,0.193782000002102,30962.628107537937,220082.36058837967
"147.32.84.165",2449,"68.6.19.3",25,3,186,3,186,0,0,91833.288285,8.986082999996142,165.58938972638455,0
"147.32.84.165",2299,"217.163.21.37",80,10,1451,5,701,5,750,91833.745006,0.13943500000459608,40219.4570933779,43030.8028816454
"147.32.84.165",2450,"205.188.59.193",25,3,186,3,186,0,0,91833.791001,8.98625699999684,165.58618343549747,0
"147.32.84.165",2322,"217.163.21.38",80,10,1500,5,693,5,807,91833.845408,0.14064100000541657,39419.51493367142,45904.11046388576
"147.32.84.165",2452,"77.238.177.9",25,3,186,3,186,0,0,91833.873146,9.004463000004762,165.25138700655586,0
"147.32.84.165",2455,"98.139.54.60",25,3,186,3,186,0,0,91833.891582,8.986187000002246,165.5874733076029,0
"147.32.84.165",2299,"46.4.36.120",443,6,366,3,186,3,180,91836.755868,1.030692000000272,1443.6902585831726,1397.1196050804897
"147.32.84.165",2298,"77.238.167.32",80,8,1722,5,750,3,972,91837.558602,0.1402069999894593,42793.86906824251,55460.854312442294
"147.32.84.165",2463,"64.12.90.34",25,3,186,3,186,0,0,91837.60444,8.985402000005706,165.6019396793883,0
"147.32.84.165",2407,"217.163.21.38",80,11,2977,6,799,5,2178,91837.786804,0.2342999999964377,27281.26333801615,74366.19718422926
"147.32.84.165",2467,"212.82.111.207",25,3,186,3,186,0,0,91837.832858,8.958134000000427,166.1060216335153,0
"147.32.84.165",2419,"46.4.36.120",443,6,366,3,186,3,180,91841.672558,1.0306899999995949,1443.693059989507,1397.1223161188777
"147.32.84.165",2298,"184.82.147.251",80,10,1906,5,978,5,928,91842.703491,0.34168000001227483,22898.618589671398,21727.932567704556
"147.32.84.165",2469,"65.55.92.136",25,3,186,3,186,0,0,91842.81644,8.989994000003207,165.51735184689434,0
"147.32.84.165",2426,"184.82.147.252",80,10,1508,5,596,5,912,91843.379193,0.32162899999821093,14824.53385741498,22684.521607319566
"147.32.84.165",2470,"212.50.160.72",25,3,186,3,186,0,0,91843.485634,9.023454000009224,164.90359456572605,0
"147.32.84.165",2419,"58.143.125.236",6667,6,366,3,186,3,180,91852.2083,1.9236859999946319,773.5150123274549,748.5629151556014
"147.32.84.165",2298,"46.4.36.120",443,6,366,3,186,3,180,91854.015345,1.0300749999878462,1444.55500814752,1397.9564594976
"147.32.84.165",2440,"217.163.21.37",80,14,6141,7,810,7,5331,91854.132197,0.2021600000007311,32053.818757303947,210961.61456195966
"147.32.84.165",2471,"98.139.175.224",25,3,186,3,186,0,0,91854.178141,8.865386999998009,167.8437726407583,0
"147.32.84.165",2419,"217.163.21.37",80,10,1451,5,701,5,750,91854.31572,0.1474210000014864,38040.71333082435,40699.76461928426
"147.32.84.165",2475,"209.85.225.27",25,3,186,3,186,0,0,91854.31585,8.928872000004048,166.6503898811995,0
"147.32.84.165",2446,"217.163.21.38",80,11,3018,6,1113,5,1905,91854.817565,0.23692599999776576,37581.35451611037,64323.88171894902
"147.32.84.165",2476,"64.12.90.33",25,3,186,3,186,0,0,91854.863519,8.882637999995495,167.51780270689346,0
"147.32.84.165",2479,"122.1.236.75",25,3,186,3,186,0,0,91854.918224,8.927883000011207,166.66885083486557,0
"147.32.84.165",2480,"65.55.37.88",25,3,186,3,186,0,0,91854.918356,8.927873000007821,166.66903751864487,0
"147.32.84.165",2497,"68.1.17.3",25,3,186,3,186,0,0,91855.045674,8.901132000013604,167.16974874630844,0
"147.32.84.165",2452,"46.4.36.120",443,6,366,3,186,3,180,91858.629673,1.0304889999970328,1443.974656696272,1397.3948290609083
"147.32.84.165",2499,"205.188.59.194",25,3,186,3,186,0,0,91858.830396,8.928436999995029,166.65850921060746,0
"147.32.84.165",2501,"213.33.87.13",25,3,186,3,186,0,0,91859.660398,8.901243999993312,167.16764533149725,0
"147.32.84.165",2452,"46.4.36.120",443,6,366,3,186,3,180,91863.746303,1.0301709999912418,1444.4203923549105,1397.8261861499134
"147.32.84.165",2506,"64.12.138.161",25,3,186,3,186,0,0,91864.447785,9.030225000009523,164.77994734333097,0
"147.32.84.165",2523,"65.55.88.22",25,3,186,3,186,0,0,91864.776682,9.001927000004798,165.2979412073889,0
"147.32.84.165",2452,"46.4.36.120",443,6,366,3,186,3,180,91875.082901,1.0308229999936884,1443.5067902143344,1396.94205504613
"147.32.84.165",2528,"76.162.254.117",25,3,186,3,186,0,0,91875.283603,9.030782999994699,164.76976581110114,0
"147.32.84.165",2529,"209.85.225.27",25,3,186,3,186,0,0,91875.785232,9.03086600000097,164.76825146113785,0
"147.32.84.165",2531,"64.12.90.33",25,3,186,3,186,0,0,91875.885752,9.030986999991,164.76604384454134,0
"147.32.84.165",2533,"65.54.188.126",25,3,186,3,186,0,0,91875.885884,9.030977000002167,164.76622628976278,0
"147.32.84.165",2549,"194.109.24.138",25,3,186,3,186,0,0,91875.985953,9.03108900001098,164.7641829239188,0
"147.32.84.165",2550,"207.115.21.24",25,3,186,3,186,0,0,91876.113964,9.002886999995098,165.28031508124118,0
"147.32.84.165",2497,"46.4.36.120",443,6,366,3,186,3,180,91879.799075,1.0307000000029802,1443.6790530665544,1397.1087610321492
"147.32.84.165",2559,"209.85.229.27",25,3,186,3,186,0,0,91880.601494,9.032886999993934,164.73138654352692,0
"147.32.84.165",2561,"212.103.213.179",25,3,186,3,186,0,0,91880.830057,9.00591500000155,165.22474395991344,0
"147.32.84.165",2497,"46.4.36.120",443,6,366,3,186,3,180,91885.518561,1.0309520000009798,1443.3261684332404,1396.7672597741034
"147.32.84.165",2562,"98.139.175.224",25,3,186,3,186,0,0,91885.819564,8.934494999994058,166.5455070489143,0
"147.32.84.165",2564,"64.12.138.161",25,3,186,3,186,0,0,91886.549655,8.90642700000899,167.07036390670447,0
"147.32.84.165",2497,"46.4.36.120",443,6,366,3,186,3,180,91896.258829,1.0327309999993304,1440.8398702091492,1394.3611647185314
"147.32.84.165",2576,"210.172.136.101",25,3,186,3,186,0,0,91896.76204,9.033880999995745,164.7132611112213,0
"147.32.84.165",2582,"209.85.225.27",25,3,186,3,186,0,0,91896.862633,9.03332699999737,164.72336272122476,0
"147.32.84.165",2586,"65.54.188.94",25,3,186,3,186,0,0,91896.862764,9.0333180000016,164.72352683695365,0
"147.32.84.165",2591,"216.32.180.22",25,3,186,3,186,0,0,91896.963143,9.033857000002172,164.71369870030512,0
"147.32.84.165",2593,"195.145.27.145",25,3,186,3,186,0,0,91897.062994,9.034388999993098,164.7039993519359,0
"147.32.84.165",2596,"98.139.175.224",25,3,186,3,186,0,0,91897.291808,9.00580600000103,165.22674372508467,0
"147.32.84.165",2598,"69.89.22.116",25,3,186,3,186,0,0,91897.291868,9.005841999998665,165.22608324687693,0
"147.32.84.165",2533,"46.4.36.120",443,6,366,3,186,3,180,91901.579458,1.031620000008843,1442.3915782819693,1395.8628176922282
"147.32.84.165",2549,"184.82.148.43",80,10,1921,5,983,5,938,91901.780506,0.3220010000077309,24422.284402257115,23304.275452001195
"147.32.84.165",2606,"64.12.90.66",25,3,186,3,186,0,0,91901.886745,9.026433999999426,164.84915305425093,0
"147.32.84.165",2559,"184.82.148.44",80,10,1512,5,594,5,918,91902.611324,0.3232260000077076,14701.78760336942,22720.944477934558
"147.32.84.165",2608,"173.203.27.138",25,3,186,3,186,0,0,91902.717938,8.996603999999934,165.3957426602317,0
"147.32.84.165",2533,"46.4.36.120",443,6,366,3,186,3,180,91906.799139,1.0309919999999693,1443.2701708646084,1396.7130685786533
"147.32.84.165",2549,"217.163.21.37",80,13,6081,6,750,7,5331,91907.501213,0.18689399999857415,32103.759350464836,228193.52146310406
"147.32.84.165",2612,"209.85.225.27",25,3,186,3,186,0,0,91907.547369,8.98257099998591,165.65413176275857,0
"147.32.84.165",2614,"199.239.254.18",25,3,186,3,186,0,0,91907.547427,8.982633999999962,165.65296994177947,0
"147.32.84.165",2562,"217.163.21.37",80,10,1451,5,701,5,750,91907.830408,0.1469950000027893,38150.95751483782,40817.71488748697
"147.32.84.165",2630,"64.12.90.66",25,3,186,3,186,0,0,91907.876454,8.954826000001049,166.1673828167991,0
"147.32.84.165",2639,"68.1.17.3",25,3,186,3,186,0,0,91907.876514,8.954889999993611,166.16619522976404,0
"147.32.84.165",2533,"46.4.36.120",443,6,366,3,186,3,180,91917.834726,1.0300540000025649,1444.5844586752683,1397.9849600083242
"147.32.84.165",2564,"217.163.21.38",80,9,2649,5,1069,4,1580,91917.934639,0.231725000005099,36905.815081721084,54547.41611704332
"147.32.84.165",2640,"205.188.156.193",25,3,186,3,186,0,0,91917.93477,8.930492999992566,166.62014067994215,0
"147.32.84.165",2656,"74.6.140.31",25,3,186,3,186,0,0,91917.980686,8.884639000010793,167.48007431682845,0
"147.32.84.165",2657,"66.94.238.147",25,3,186,3,186,0,0,91918.034742,8.930640999999014,166.61737942440686,0
"147.32.84.165",2576,"217.163.21.37",80,10,2277,5,1156,5,1121,91918.135644,0.14038900000741705,65874.1069422206,63879.648687049565
"147.32.84.165",2658,"98.139.175.224",25,3,186,3,186,0,0,91918.181699,8.883746000006795,167.49690952429998,0
"147.32.84.165",2582,"217.163.21.38",80,11,3464,6,1584,5,1880,91918.336297,0.15630299999611452,81073.29993867685,96223.36103832858
"147.32.84.165",2659,"209.85.225.27",25,3,186,3,186,0,0,91918.382263,8.884378999995533,167.484975596015,0
"147.32.84.165",2591,"217.70.144.134",80,7,1636,5,1024,2,612,91918.865036,64.95849399999133,126.11129808522182,75.37120549624585
"147.32.84.165",2660,"68.1.17.3",25,3,186,3,186,0,0,91918.883171,8.884551000010106,167.48173317912267,0
"147.32.84.165",2664,"205.188.190.2",25,3,186,3,186,0,0,91918.88323,8.884642999997595,167.47999891502707,0
"147.32.84.165",2576,"46.4.36.120",443,6,366,3,186,3,180,91922.951975,0.9311900000029709,1597.9553044977422,1546.4083591913634
"147.32.84.165",2564,"217.110.110.231",80,8,1757,5,1023,3,734,91923.754623,0.07155700000294019,114370.3620842647,82060.45529799638
"147.32.84.165",2666,"118.23.109.24",25,3,186,3,186,0,0,91923.777576,9.006596000006539,165.2122511100664,0
"147.32.84.165",2668,"208.81.237.241",25,3,186,3,186,0,0,91923.883401,9.001902999996673,165.29838190886414,0
"147.32.84.165",2608,"221.226.242.228",6667,2,124,2,124,0,0,91928.469894,3.009877000004053,329.5815742632221,0
"147.32.84.165",2669,"216.31.209.17",25,3,186,3,186,0,0,91928.771491,9.029504999998608,164.79308666424456,0
"147.32.84.165",2612,"46.4.36.120",443,6,366,3,186,3,180,91938.90467,1.0308149999909801,1443.5179930569698,1396.952896506745
"147.32.84.165",2670,"64.12.90.34",25,3,186,3,186,0,0,91938.904775,9.03182000000379,164.7508475588946,0
"147.32.84.165",2671,"205.188.190.2",25,3,186,3,186,0,0,91939.005125,9.031203000005917,164.76210312170207,0
"147.32.84.165",2687,"77.238.177.9",25,3,186,3,186,0,0,91939.005251,9.031220000004396,164.7617929802702,0
"147.32.84.165",2688,"165.21.74.122",25,3,186,3,186,0,0,91939.105026,9.032324999992852,164.74163628979002,0
"147.32.84.165",2690,"68.1.17.3",25,3,186,3,186,0,0,91939.306031,9.031392999997479,164.75863690135236,0
"147.32.84.165",2695,"208.104.244.55",25,3,186,3,186,0,0,91939.808122,9.030996000001323,164.7658796438158,0
"147.32.84.165",2697,"203.138.181.112",25,3,186,3,186,0,0,91939.93571,9.00366099999519,165.26610675377435,0
"147.32.84.165",2659,"46.4.36.120",443,6,366,3,186,3,180,91944.724778,1.029882999995607,1444.8243150011674,1398.2170790333878
"147.32.84.165",2657,"173.192.170.88",80,7,860,4,423,3,437,91944.823284,35.49508399999468,95.33714584252026,98.49251237158713
"147.32.84.165",2700,"64.12.90.33",25,3,186,3,186,0,0,91944.924479,9.032770000005257,164.73352028216527,0
"147.32.84.165",2702,"65.254.254.52",25,3,186,3,186,0,0,91945.024471,8.93283700000029,166.5764191152208,0
"147.32.84.165",2703,"64.12.90.34",25,3,186,3,186,0,0,91945.754904,8.905432999992627,167.08901184268436,0
"147.32.84.165",2705,"66.94.238.147",25,3,186,3,186,0,0,91945.755074,8.905383999997866,167.089931214685,0
"147.32.84.165",2659,"46.4.36.120",443,6,366,3,186,3,180,91949.843665,1.0314700000017183,1442.6013359550168,1396.0658089887258
"147.32.84.165",2718,"80.232.168.198",25,3,186,3,186,0,0,91950.875366,8.904913000005763,167.09876896035223,0
"147.32.84.165",2659,"46.4.36.120",443,6,366,3,186,3,180,91959.881326,1.0299870000017108,1444.6784279777594,1398.0758980429928
"147.32.84.165",2720,"67.32.158.217",25,3,186,3,186,0,0,91959.98099,9.028407999998308,164.8131099082229,0
"147.32.84.165",2723,"98.139.175.224",25,3,186,3,186,0,0,91960.081458,9.028542000000016,164.8106637815937,0
"147.32.84.165",2726,"165.21.74.122",25,3,186,3,186,0,0,91960.282081,9.028843000007328,164.80516938867942,0
"147.32.84.165",2727,"209.85.225.27",25,3,186,3,186,0,0,91960.784198,9.028087000013329,164.81896995429963,0
"147.32.84.165",2729,"66.94.237.64",25,3,186,3,186,0,0,91960.884037,9.028870000009192,164.8046765540411,0
"147.32.84.165",2730,"147.187.10.115",25,3,186,3,186,0,0,91960.911556,9.00137499999255,165.3080779326749,0
"147.32.84.165",2671,"46.4.36.120",443,6,366,3,186,3,180,91965.899516,1.0309719999931986,1443.298169115957,1396.7401636606037
"147.32.84.165",2731,"64.12.90.34",25,3,186,3,186,0,0,91965.899649,9.03163100000529,164.75429520970556,0
"147.32.84.165",2732,"65.55.92.168",25,3,186,3,186,0,0,91966.70187,9.032288000002154,164.7423111397295,0
"147.32.84.165",2737,"205.188.156.193",25,3,186,3,186,0,0,91966.930763,9.00387500000943,165.26217878396153,0
"147.32.84.165",2702,"46.4.36.120",443,6,366,3,186,3,180,91971.819242,1.0325230000016745,1441.130124944032,1394.6420563974505
"147.32.84.165",2742,"207.115.11.16",25,3,186,3,186,0,0,91972.851965,9.002821000001859,165.28152675696793,0
"147.32.84.165",2702,"46.4.36.120",443,6,366,3,186,3,180,91981.052199,1.0308090000035008,1443.5263952826822,1396.9610276929184
"147.32.84.165",2744,"205.188.59.194",25,3,186,3,186,0,0,91981.152609,8.928255000006175,166.66190649785102,0
"147.32.84.165",2745,"205.188.103.2",25,3,186,3,186,0,0,91981.353306,8.927825999999186,166.66991493787353,0
"147.32.84.165",2747,"80.12.242.15",25,3,186,3,186,0,0,91981.85493,8.927737000005436,166.67157645874806,0
"147.32.84.165",2754,"68.1.17.3",25,3,186,3,186,0,0,91981.954583,8.928807000003872,166.65160306403249,0
"147.32.84.165",2756,"216.99.131.14",25,3,186,3,186,0,0,91981.954715,8.928719000003184,166.65324555509804,0
"147.32.84.165",2759,"98.139.175.224",25,3,186,3,186,0,0,91982.083234,8.900442999991355,167.18268967077765,0
"147.32.84.165",2723,"46.4.36.120",443,6,366,3,186,3,180,91986.870254,1.0311630000069272,1443.0308302276205,1396.4814486073747
"147.32.84.165",2761,"209.85.225.27",25,3,186,3,186,0,0,91987.672766,9.029211000000942,164.79845248935314,0
"147.32.84.165",2764,"205.188.190.2",25,3,186,3,186,0,0,91987.874094,9.02823399999761,164.81628633023843,0
"147.32.84.165",2765,"65.55.37.72",25,3,186,3,186,0,0,91987.901692,9.000759999995353,165.3193730308072,0
"147.32.84.165",2731,"46.4.36.120",443,6,366,3,186,3,180,91993.792799,1.0307929999980843,1443.5488017504633,1396.9827113714161
"147.32.84.165",2770,"216.32.181.178",25,3,186,3,186,0,0,91994.823812,9.002666000000318,165.28437242922791,0
"147.32.84.165",2731,"46.4.36.120",443,6,366,3,186,3,180,92002.121225,1.0305090000038035,1443.9466321929337,1397.3677085738068
"147.32.84.165",2771,"64.12.90.33",25,3,186,3,186,0,0,92002.321442,9.029536000001826,164.79252090026543,0
"147.32.84.165",2780,"65.54.188.110",25,3,186,3,186,0,0,92002.823681,9.029538000002503,164.7924843994884,0
"147.32.84.165",2781,"205.188.146.193",25,3,186,3,186,0,0,92002.924479,9.029088000010233,164.80069747889416,0
"147.32.84.165",2788,"131.114.68.99",25,3,186,3,186,0,0,92002.924609,9.029019000008702,164.80195689017444,0
"147.32.84.165",2789,"82.94.250.60",25,3,186,3,186,0,0,92003.024363,9.02964899998915,164.7904586326432,0
"147.32.84.165",2790,"98.139.175.224",25,3,186,3,186,0,0,92003.151966,9.00236600000062,165.28988046030315,0
"147.32.84.165",2756,"202.164.57.158",6667,2,124,2,124,0,0,92008.742128,3.0107310000021243,329.48808777645695,0
"147.32.84.165",2731,"46.4.36.120",443,6,366,3,186,3,180,92008.943153,1.0301110000000335,1444.5045242696676,1397.9076041319363
"147.32.84.165",2791,"216.32.180.22",25,3,186,3,186,0,0,92008.943287,8.93291699999827,166.57492731660759,0
"147.32.84.165",2793,"205.188.103.2",25,3,186,3,186,0,0,92009.97351,8.905345999999554,167.09064420406287,0
"147.32.84.165",2731,"46.4.36.120",443,6,366,3,186,3,180,92015.866986,0.9331100000126753,1594.6672953668776,1543.2264148711718
"147.32.84.165",2795,"85.119.248.7",25,3,186,3,186,0,0,92016.800347,9.00370300000941,165.26533582887453,0
"147.32.84.165",2731,"46.4.36.120",443,6,366,3,186,3,180,92023.294778,1.0308290000102716,1443.4983881760922,1396.9339240413797
"147.32.84.165",2803,"65.54.188.72",25,3,186,3,186,0,0,92023.796606,9.029508999999962,164.79301366220537,0
"147.32.84.165",2804,"80.72.0.17",25,3,186,3,186,0,0,92023.897077,9.029479000004358,164.7935611788102,0
"147.32.84.165",2805,"216.82.242.131",25,3,186,3,186,0,0,92023.89721,9.029410000002827,164.79482048102082,0
"147.32.84.165",2807,"64.12.90.33",25,3,186,3,186,0,0,92023.99737,9.02964599999541,164.79051338233597,0
"147.32.84.165",2808,"64.12.90.97",25,3,186,3,186,0,0,92024.097471,9.029620999994222,164.7909696321642,0
"147.32.84.165",2809,"98.139.175.224",25,3,186,3,186,0,0,92024.325827,9.001719000007142,165.30176069690904,0
"147.32.84.165",2788,"46.4.36.120",443,6,366,3,186,3,180,92026.004119,1.0312399999966146,1442.9230828952375,1396.3771769953912
"147.32.84.165",2810,"205.178.149.7",25,3,186,3,186,0,0,92027.035598,9.002037999991444,165.29590299456794,0
"147.32.84.165",2731,"83.99.172.192",6667,2,124,2,124,0,0,92029.91714,3.009267000001273,329.64838281202043,0
"147.32.84.165",2815,"65.55.92.184",25,3,186,3,186,0,0,92030.91993,9.031247999999323,164.76128216168038,0
"147.32.84.165",2793,"46.4.36.120",443,6,366,3,186,3,180,92037.844815,1.031036000000313,1443.2085785554998,1396.6534631182258
"147.32.84.165",2819,"209.85.225.27",25,3,186,3,186,0,0,92038.876102,9.000867000009748,165.3174077562071,0
"147.32.84.165",2793,"46.4.36.120",443,6,366,3,186,3,180,92044.867,1.030259000006481,1444.297016566358,1397.7067902255078
"147.32.84.165",2820,"65.54.188.126",25,3,186,3,186,0,0,92044.966984,9.03099500000826,164.7658978881772,0
"147.32.84.165",2828,"64.12.138.161",25,3,186,3,186,0,0,92044.967115,9.030986999991,164.76604384454134,0
"147.32.84.165",2832,"64.12.90.98",25,3,186,3,186,0,0,92045.066894,8.931257999996888,166.60586896051134,0
"147.32.84.165",2833,"205.188.156.193",25,3,186,3,186,0,0,92045.167721,8.93047099999967,166.62055114450905,0
"147.32.84.165",2834,"168.95.5.38",25,3,186,3,186,0,0,92045.368065,8.931003999998211,166.61060727330297,0
"147.32.84.165",2835,"77.238.177.9",25,3,186,3,186,0,0,92045.897473,8.902768999992986,167.1390103462386,0
"147.32.84.165",2803,"46.4.36.120",443,6,366,3,186,3,180,92047.073318,0.9316120000003139,1597.2314654593315,1545.707869799353
"147.32.84.165",2836,"66.135.59.76",25,3,186,3,186,0,0,92047.977514,9.0305939999962,164.77321425374967,0
"147.32.84.165",2804,"218.93.203.210",6667,3,186,3,186,0,0,92048.005177,9.003054999993765,165.27723089562716,0
"147.32.84.165",2805,"46.4.36.120",443,6,366,3,186,3,180,92051.891196,1.0307509999984177,1443.6076220176203,1397.0396342106003
"147.32.84.165",2841,"67.231.144.15",25,3,186,3,186,0,0,92052.922223,9.002546999996412,165.28655723770098,0
"147.32.84.165",2805,"46.4.36.120",443,6,366,3,186,3,180,92059.917318,1.0306039999995846,1443.8135307068474,1397.2389006840458
"147.32.84.165",2843,"209.85.225.27",25,3,186,3,186,0,0,92060.948145,9.003671999991639,165.2659048443104,0
"147.32.84.165",2805,"46.4.36.120",443,6,366,3,186,3,180,92066.037981,1.0310570000001462,1443.1791840798219,1396.6250168514407
"147.32.84.165",2844,"65.55.37.88",25,3,186,3,186,0,0,92066.038091,9.030968000006396,164.76639049091372,0
"147.32.84.165",2846,"98.139.175.224",25,3,186,3,186,0,0,92066.038122,9.031067000003532,164.76458429545679,0
"147.32.84.165",2850,"65.55.92.168",25,3,186,3,186,0,0,92066.138399,9.03078899999673,164.7696563390573,0
"147.32.84.165",2853,"205.188.190.2",25,3,186,3,186,0,0,92066.339256,9.030398999995668,164.77677232209936,0
"147.32.84.165",2855,"210.143.100.95",25,3,186,3,186,0,0,92066.840279,9.03154799999902,164.75580930314067,0
"147.32.84.165",2856,"64.98.36.4",25,3,186,3,186,0,0,92067.069301,9.003085999996983,165.27666180246402,0
"147.32.84.165",2820,"46.4.36.120",443,6,366,3,186,3,180,92068.145659,1.0304739999992307,1443.9956757774683,1397.4151701072274
"147.32.84.165",2858,"205.188.103.2",25,3,186,3,186,0,0,92069.0491,9.029488999993191,164.79337867304807,0
"147.32.84.165",2828,"155.97.153.147",6667,3,186,3,186,0,0,92069.176405,9.002710999993724,165.2835462563485,0
"147.32.84.165",2835,"46.4.36.120",443,6,366,3,186,3,180,92073.965914,1.030572999996366,1443.8569611325418,1397.2809301282662
"147.32.84.165",2874,"97.65.6.83",25,3,186,3,186,0,0,92074.99671,8.906064999988303,167.077154725679,0
"147.32.84.165",2835,"46.4.36.120",443,6,366,3,186,3,180,92081.894375,1.0323669999925187,1441.3478927656379,1394.852799450617
"147.32.84.165",2876,"76.96.62.116",25,3,186,3,186,0,0,92082.926983,9.002353000003495,165.29011914989584,0
"147.32.84.165",2835,"46.4.36.120",443,6,366,3,186,3,180,92087.013408,1.031717000005301,1442.2559674720437,1395.7315814245585
"147.32.84.165",2882,"68.6.19.3",25,3,186,3,186,0,0,92087.013538,9.030377000002773,164.7771737547107,0
"147.32.84.165",2884,"66.94.237.64",25,3,186,3,186,0,0,92087.113681,9.030662000004668,164.77197352743696,0
"147.32.84.165",2885,"98.139.175.224",25,3,186,3,186,0,0,92087.314164,9.031300000002375,164.7603335067608,0
"147.32.84.165",2886,"82.57.200.133",25,3,186,3,186,0,0,92087.816794,9.030838000006042,164.76876232294327,0
"147.32.84.165",2887,"64.12.90.97",25,3,186,3,186,0,0,92088.017554,9.030161999995471,164.7810969505028,0
"147.32.84.165",2889,"64.12.138.161",25,3,186,3,186,0,0,92088.045359,9.002477000001818,165.28784244599564,0
"147.32.84.165",2855,"218.201.21.157",6667,3,186,3,186,0,0,92089.221639,9.03038500000548,164.7770277788928,0
"147.32.84.165",2853,"46.4.36.120",443,6,366,3,186,3,180,92090.023844,1.0302320000046166,1444.3348682562105,1397.7434208931068
"147.32.84.165",2891,"65.55.92.152",25,3,186,3,186,0,0,92091.054324,9.004058000005898,165.2588199675108,0
"147.32.84.165",2853,"46.4.36.120",443,6,366,3,186,3,180,92095.943221,1.0320800000044983,1441.748701644751,1395.2406790110495
"147.32.84.165",2893,"65.55.37.120",25,3,186,3,186,0,0,92096.975539,9.000853999998071,165.31764652557624,0
"147.32.84.165",2853,"46.4.36.120",443,6,366,3,186,3,180,92103.97002,1.0308870000008028,1443.4171737531283,1396.8553294385113
"147.32.84.165",2894,"66.175.58.41",25,3,186,3,186,0,0,92105.001147,8.902860999995028,167.13728317232304,0
"147.32.84.165",2853,"46.4.36.120",443,6,366,3,186,3,180,92108.082829,1.0320139999967068,1441.8409052636382,1395.3299083196498
"147.32.84.165",2895,"186.195.32.2",25,3,186,3,186,0,0,92108.183629,8.932366999986698,166.58518397220087,0
"147.32.84.165",2896,"64.12.90.1",25,3,186,3,186,0,0,92108.384131,8.933841000005486,166.55769897842217,0
"147.32.84.165",2897,"64.18.7.13",25,3,186,3,186,0,0,92108.887699,8.931815999996616,166.5954605424657,0
"147.32.84.165",2898,"209.85.225.27",25,3,186,3,186,0,0,92109.087607,8.932360999999219,166.585295869718,0
"147.32.84.165",2901,"74.125.77.27",25,3,186,3,186,0,0,92109.087666,8.932423999998719,166.58412095084307,0
"147.32.84.165",2902,"208.65.144.3",25,3,186,3,186,0,0,92109.115051,8.905087999999523,167.09548518780272,0
"147.32.84.165",2906,"64.12.90.33",25,3,186,3,186,0,0,92109.789408,8.934195000008913,166.55109945535278,0
"147.32.84.165",2884,"27.255.33.216",6667,3,186,3,186,0,0,92111.996566,9.034096999996109,164.70932291303058,0
"147.32.84.165",2882,"46.4.36.120",443,6,366,3,186,3,180,92117.919599,1.0318180000031134,1442.1147915577264,1395.5949595719933
"147.32.84.165",2910,"204.232.236.136",25,3,186,3,186,0,0,92118.951642,9.005873000001884,165.2255145058884,0
"147.32.84.165",2886,"212.117.171.138",65500,9,544,5,302,4,242,92125.949951,37.149476999999024,65.0345629361098,52.11378884284295
"147.32.84.165",2882,"46.4.36.120",443,6,366,3,186,3,180,92125.972516,1.0088329999998678,1474.9715760687795,1427.3918478084963
"147.32.84.165",2911,"98.139.175.224",25,3,186,3,186,0,0,92126.981587,9.00290700000187,165.27994791012404,0
"147.32.84.165",2882,"46.4.36.120",443,6,366,3,186,3,180,92129.161519,1.0306850000051782,1443.700063542716,1397.1290937510155
"147.32.84.165",2913,"207.115.21.24",25,3,186,3,186,0,0,92129.361892,9.031210999994073,164.76195717285052,0
"147.32.84.165",2917,"64.12.138.161",25,3,186,3,186,0,0,92129.864053,9.030408999999054,164.77658985325647,0
"147.32.84.165",2921,"64.12.90.1",25,3,186,3,186,0,0,92130.064869,9.03059700000449,164.77315951528564,0
"147.32.84.165",2924,"64.12.90.33",25,3,186,3,186,0,0,92130.065012,9.030575999990106,164.773542684501,0
"147.32.84.165",2925,"145.253.153.250",25,3,186,3,186,0,0,92130.065082,9.030555000004824,164.7739258549674,0
"147.32.84.165",2926,"65.55.92.136",25,3,186,3,186,0,0,92130.065156,9.03052500000922,164.77447324474278,0
"147.32.84.165",2927,"76.96.30.116",25,3,186,3,186,0,0,92130.192428,9.003618000002461,165.26689604107963,0
"147.32.84.165",2928,"98.139.175.224",25,3,186,3,186,0,0,92130.766477,9.031279999995604,164.76069837284683,0
"147.32.84.165",2932,"65.55.37.88",25,3,186,3,186,0,0,92130.766622,9.031256000002031,164.76113621401777,0
"147.32.84.165",2934,"150.217.5.100",25,3,186,3,186,0,0,92130.867211,9.030442999996012,164.775969462479,0
"147.32.84.165",2898,"213.33.174.74",6667,6,366,3,186,3,180,92139.998242,1.0611009999993257,1402.3170273149733,1357.0809941757807
"147.32.84.165",2897,"46.4.36.120",443,6,366,3,186,3,180,92141.059622,0.9720809999998892,1530.7366361446934,1481.3580349787355
"147.32.84.165",2936,"64.12.90.34",25,3,186,3,186,0,0,92142.031943,9.008167000007234,165.1834385395836,0
"147.32.84.165",2897,"46.4.36.120",443,6,366,3,186,3,180,92147.929448,1.0312600000033854,1442.8950991943013,1396.3500959944852
"147.32.84.165",2938,"69.56.128.163",25,3,186,3,186,0,0,92148.960944,9.003666999997222,165.26599662120546,0
"147.32.84.165",2911,"46.4.36.120",443,6,366,3,186,3,180,92150.338295,1.0307319999992615,1443.6342327598893,1397.0653865418283
"147.32.84.165",2897,"184.82.148.43",80,10,1921,5,983,5,938,92150.839501,0.3235160000040196,24307.916764247493,23195.14336201846
"147.32.84.165",2945,"168.95.5.17",25,3,186,3,186,0,0,92150.946172,9.026013000009698,164.85684210718523,0
"147.32.84.165",2946,"64.12.90.33",25,3,186,3,186,0,0,92151.040226,9.032787000003736,164.73321024833027,0
"147.32.84.165",2951,"168.95.5.2",25,3,186,3,186,0,0,92151.04026,9.032876000012038,164.73158714876823,0
"147.32.84.165",2954,"98.139.175.224",25,3,186,3,186,0,0,92151.04029,9.032894999996643,164.73124064882333,0
"147.32.84.165",2913,"117.196.25.55",6667,3,186,3,186,0,0,92151.140891,9.03171999999904,164.75267169488848,0
"147.32.84.165",2958,"208.65.145.3",25,3,186,3,186,0,0,92151.369258,9.004014999998617,165.2596091854832,0
"147.32.84.165",2963,"209.12.101.219",25,3,186,3,186,0,0,92151.742742,9.031482999998843,164.75699505830775,0
"147.32.84.165",2965,"68.1.17.3",25,3,186,3,186,0,0,92151.842924,9.031216999996104,164.76184771118244,0
"147.32.84.165",2924,"46.4.36.120",443,6,366,3,186,3,180,92163.081716,1.0873049999936484,1368.5212520945754,1324.375405252815
"147.32.84.165",2966,"65.54.188.126",25,3,186,3,186,0,0,92164.169265,8.846271999995224,168.206448999172,0
"147.32.84.165",2886,"212.117.171.138",65500,9,544,5,302,4,242,92170.003817,75.11261699999159,32.16503560247769,25.77463117814437
"147.32.84.165",2927,"94.100.176.20",25,3,186,3,186,0,0,92170.02639,8.919670999996015,166.82229647266865,0
"147.32.84.165",2970,"205.188.159.42",25,3,186,3,186,0,0,92171.911609,9.042315999991843,164.55961061318166,0
"147.32.84.165",2924,"46.4.36.120",443,6,366,3,186,3,180,92172.012167,1.0307410000095842,1443.6216275341371,1397.0531879362618
"147.32.84.165",2971,"64.12.138.161",25,3,186,3,186,0,0,92172.012301,9.041385000004084,164.57655547234498,0
"147.32.84.165",2972,"207.115.20.21",25,3,186,3,186,0,0,92172.012362,9.041459000000032,164.57520849234564,0
"147.32.84.165",2974,"207.115.21.24",25,3,186,3,186,0,0,92172.012416,9.041464000009,164.5751174808105,0
"147.32.84.165",2982,"66.94.237.64",25,3,186,3,186,0,0,92172.312874,9.042153000002145,164.56257707646034,0
"147.32.84.165",2987,"76.96.30.116",25,3,186,3,186,0,0,92172.714434,9.041926000005333,164.5667084644491,0
"147.32.84.165",2991,"65.54.188.110",25,3,186,3,186,0,0,92172.814415,9.043342000004486,164.54094072736183,0
"147.32.84.165",2995,"205.188.156.193",25,3,186,3,186,0,0,92173.043109,9.014239999989513,165.07215250556132,0
"147.32.84.165",2951,"46.4.36.120",443,6,366,3,186,3,180,92185.066784,1.0308829999994487,1443.4227744572331,1396.8607494747416
"147.32.84.165",2958,"184.82.148.43",80,10,1917,5,979,5,938,92186.097914,0.3216990000073565,24345.739339633943,23326.152707432728
"147.32.84.165",3001,"163.247.62.61",25,3,186,3,186,0,0,92186.204278,8.99622799998906,165.40265542422998,0
"147.32.84.165",2951,"46.4.36.120",443,6,366,3,186,3,180,92190.985489,1.3130600000004051,1133.2307739170647,1096.6749425003852
"147.32.84.165",3006,"205.188.103.2",25,3,186,3,186,0,0,92192.298787,8.920310999994399,166.81032757724864,0
"147.32.84.165",2927,"74.125.93.27",25,3,186,3,186,0,0,92192.992138,8.930523999995785,166.61956230123812,0
"147.32.84.165",3009,"98.139.175.224",25,3,186,3,186,0,0,92193.092925,8.929779999991297,166.6334444971153,0
"147.32.84.165",3013,"207.115.21.24",25,3,186,3,186,0,0,92193.093056,8.92977200000314,166.63359378038732,0
"147.32.84.165",3014,"93.17.128.25",25,3,186,3,186,0,0,92193.093109,8.929758000012953,166.6338550269606,0
"147.32.84.165",3017,"64.26.60.153",25,3,186,3,186,0,0,92193.093166,8.929749999995693,166.63400431151126,0
"147.32.84.165",3029,"209.85.225.27",25,3,186,3,186,0,0,92193.392894,8.93072599999141,166.61579360977274,0
"147.32.84.165",3036,"98.139.54.60",25,3,186,3,186,0,0,92193.795655,8.929836000010255,166.63239951979983,0
"147.32.84.165",3037,"64.12.90.97",25,3,186,3,186,0,0,92193.896168,8.929174999997485,166.64473481597338,0
"147.32.84.165",3040,"98.139.175.224",25,3,186,3,186,0,0,92194.09677,8.92895000000135,166.64893408516957,0
"147.32.84.165",3042,"205.188.59.194",25,3,186,3,186,0,0,92194.096867,8.928954999995767,166.6488407658797,0
"147.32.84.165",2970,"46.4.36.120",443,5,306,3,186,2,120,92207.139399,6.7457849999918835,220.58218576515415,142.31108759042203
"147.32.84.165",2971,"184.82.148.43",80,10,1917,5,979,5,938,92213.259471,0.3408460000064224,22978.119150151168,22015.80772506823
"147.32.84.165",3043,"64.12.90.97",25,3,186,3,186,0,0,92213.372027,9.019165999998222,164.98199500932716,0
"147.32.84.165",3047,"64.12.90.34",25,3,186,3,186,0,0,92213.372088,9.019228999997722,164.98084259756303,0
"147.32.84.165",3006,"184.82.148.44",80,10,1511,5,594,5,917,92213.885431,0.3421379999927012,13889.132455621339,21441.640508088836
"147.32.84.165",3053,"209.85.225.27",25,3,186,3,186,0,0,92213.96195,9.031104000008781,164.76390926276048,0
"147.32.84.165",3069,"65.54.188.94",25,3,186,3,186,0,0,92213.962076,9.031104000008781,164.76390926276048,0
"147.32.84.165",2927,"74.125.39.27",25,3,186,3,186,0,0,92213.998357,8.994871999995667,165.42759029819624,0
"147.32.84.165",3071,"64.12.90.97",25,3,186,3,186,0,0,92214.062003,9.030813000004855,164.76921845233647,0
"147.32.84.165",3073,"65.55.92.168",25,3,186,3,186,0,0,92214.062129,9.03078899999673,164.7696563390573,0
"147.32.84.165",3076,"212.27.48.7",25,3,186,3,186,0,0,92214.062193,9.03074899999774,164.77038615516523,0
"147.32.84.165",3090,"65.54.188.72",25,3,186,3,186,0,0,92214.062246,9.03071700000146,164.77097001265344,0
"147.32.84.165",2971,"217.163.21.37",80,14,6134,7,809,7,5325,92214.363497,0.18966899999941234,34122.603061227994,224601.8063053635
"147.32.84.165",3096,"205.188.146.193",25,3,186,3,186,0,0,92214.409499,8.984637999994447,165.61602148032225,0
"147.32.84.165",3006,"217.163.21.37",80,10,1446,5,698,5,748,92214.764947,0.13942300000053365,40050.78071751882,42919.74781762762
"147.32.84.165",3097,"74.125.93.27",25,3,186,3,186,0,0,92214.811116,8.985087000008207,165.60774536725586,0
"147.32.84.165",3102,"74.125.113.27",25,3,186,3,186,0,0,92214.865002,9.031480999998166,164.75703154336506,0
"147.32.84.165",3017,"46.4.36.120",443,5,306,3,186,2,120,92215.065697,3.737330000003567,398.1451999150677,256.8678709129469
"147.32.84.165",3014,"217.163.21.34",80,9,2668,5,1101,4,1567,92218.803298,0.2273319999949308,38745.09528001516,55144.01844122048
"147.32.84.165",3107,"64.12.90.33",25,3,186,3,186,0,0,92218.849437,8.960076000003028,166.07001994173902,0
"147.32.84.165",3042,"217.163.21.37",80,10,2272,5,1153,5,1119,92234.330864,0.13997299999755342,65898.42326849625,63955.191359451266
"147.32.84.165",3108,"207.115.21.24",25,3,186,3,186,0,0,92234.376766,8.98587000000407,165.5933148375534,0
"147.32.84.165",3047,"46.4.36.120",443,6,366,3,186,3,180,92234.933882,1.3205810000072233,1126.7767747619123,1090.4291368663667
"147.32.84.165",3043,"217.163.21.35",80,11,3781,6,1616,5,2165,92234.93402,0.1560159999935422,82863.29607562759,111014.25495280552
"147.32.84.165",3109,"205.188.103.2",25,3,186,3,186,0,0,92234.980021,8.985251999998582,165.60470424204405,0
"147.32.84.165",2927,"66.111.4.71",25,3,186,3,186,0,0,92235.034216,9.030830000003334,164.7689082841168,0
"147.32.84.165",3111,"98.139.54.60",25,3,186,3,186,0,0,92235.034349,9.030819000006886,164.7691089810199,0
"147.32.84.165",3115,"98.139.175.224",25,3,186,3,186,0,0,92235.034411,9.03080599999521,164.76934616918905,0
"147.32.84.165",3053,"92.240.244.181",80,10,1757,6,1363,4,394,92235.335265,5.451359999991837,2000.2348037950765,578.2043380009245
"147.32.84.165",3122,"66.206.23.60",25,3,186,3,186,0,0,92235.343822,9.022125000003143,164.9278856144735,0
"147.32.84.165",3069,"173.241.240.4",80,9,2146,5,1116,4,1030,92235.736343,0.06669099999999162,133871.13703499906,123554.9024606174
"147.32.84.165",3124,"65.54.188.110",25,3,186,3,186,0,0,92235.752735,9.014217999996617,165.07255537868713,0
"147.32.84.165",3127,"65.55.92.184",25,3,186,3,186,0,0,92235.836757,9.030996000001323,164.7658796438158,0
"147.32.84.165",3135,"65.55.37.72",25,3,186,3,186,0,0,92236.254711,9.01372899999842,165.08151066004544,0
"147.32.84.165",3043,"46.4.36.120",443,6,366,3,186,3,180,92239.752017,1.0419049999909475,1428.1532385514306,1382.08377924332
"147.32.84.165",3047,"184.82.148.43",80,10,1921,5,983,5,938,92240.794147,0.3410300000105053,23059.55487715964,22003.929272406654
"147.32.84.165",3156,"64.12.90.33",25,3,186,3,186,0,0,92240.906871,8.979630999994697,165.7083681947375,0
"147.32.84.165",3047,"116.228.139.242",6667,3,186,3,186,0,0,92255.407458,8.931408000004012,166.60307087072178,0
"147.32.84.165",3043,"46.4.36.120",443,6,366,3,186,3,180,92256.009126,1.0985859999927925,1354.468380272243,1310.7758518763642
"147.32.84.165",3102,"184.82.148.44",80,10,1512,5,594,5,918,92256.109061,0.3226670000003651,14727.257513147064,22760.307065772733
"147.32.84.165",3159,"98.139.175.224",25,3,186,3,186,0,0,92256.109197,8.931878000003053,166.5943041317281,0
"147.32.84.165",2886,"212.117.171.138",65500,32,2732,15,1665,17,1067,92256.109251,328.4056009999913,40.559600565400686,25.99224853050002
"147.32.84.165",3160,"209.85.225.27",25,3,186,3,186,0,0,92256.109304,8.931897000002209,166.59394975105872,0
"147.32.84.165",3108,"216.157.130.15",25,3,186,3,186,0,0,92256.131984,8.909265999987838,167.01712576569508,0
"147.32.84.165",3161,"216.163.188.57",25,3,186,3,186,0,0,92256.21578,8.925285999997868,166.71734664865141,0
"147.32.84.165",2927,"217.163.21.37",80,13,6081,6,750,7,5331,92256.410726,0.18789400000241585,31932.89833588542,226979.04137147355
"147.32.84.165",3171,"64.12.90.34",25,3,186,3,186,0,0,92256.45683,8.885015000007115,167.47298682093484,0
"147.32.84.165",3111,"217.163.21.37",80,10,1451,5,701,5,750,92256.811226,0.13956099998904392,40183.145724380374,42991.953342775014
"147.32.84.165",3174,"207.115.21.24",25,3,186,3,186,0,0,92256.857076,8.886119999995572,167.45216134834342,0
"147.32.84.165",3115,"217.163.21.35",80,12,3382,6,1266,6,2116,92256.912256,0.2545130000071367,39793.64511720817,66511.33733650277
"147.32.84.165",3175,"64.26.60.153",25,3,186,3,186,0,0,92256.958187,8.884999000001699,167.47328840438985,0
"147.32.84.165",3176,"205.188.146.193",25,3,186,3,186,0,0,92257.107899,8.836144000000786,168.3992474545308,0
"147.32.84.165",3177,"174.143.82.68",25,3,186,3,186,0,0,92257.314368,8.930147999999463,166.62657774541805,0
"147.32.84.165",3111,"46.4.36.120",443,6,366,3,186,3,180,92261.829453,1.0319060000038007,1441.991809326159,1395.475944509186
"147.32.84.165",3178,"98.139.175.224",25,3,186,3,186,0,0,92262.861606,9.002966999993077,165.27884640709493,0
"147.32.84.165",3156,"210.211.247.235",6667,3,186,3,186,0,0,92276.378788,9.029804999998305,164.78761169264223,0
"147.32.84.165",3111,"46.4.36.120",443,6,366,3,186,3,180,92277.081465,1.0311619999993127,1443.032229660317,1396.482802897081
"147.32.84.165",3179,"209.85.225.27",25,3,186,3,186,0,0,92277.0816,9.030956999995396,164.76659118194877,0
"147.32.84.165",3181,"205.188.103.2",25,3,186,3,186,0,0,92277.181635,9.029798000003211,164.787739437745,0
"147.32.84.165",3182,"207.115.21.24",25,3,186,3,186,0,0,92277.382161,9.029838999995263,164.78699121886675,0
"147.32.84.165",3183,"68.1.17.3",25,3,186,3,186,0,0,92277.382287,9.029836000001524,164.78704596625553,0
"147.32.84.165",3184,"207.115.20.21",25,3,186,3,186,0,0,92277.783108,9.030100999996648,164.7822100772242,0
"147.32.84.165",3185,"205.188.146.193",25,3,186,3,186,0,0,92277.883856,9.029725999993389,164.7890533999691,0
"147.32.84.165",3188,"209.85.225.27",25,3,186,3,186,0,0,92277.883955,9.029737000004388,164.78885265421096,0
"147.32.84.165",3190,"203.188.197.119",25,3,186,3,186,0,0,92277.883981,9.02973499998916,164.78888915364476,0
"147.32.84.165",3192,"98.139.175.224",25,3,186,3,186,0,0,92277.98371,9.030327000000398,164.77808610916685,0
"147.32.84.165",3193,"64.12.90.33",25,3,186,3,186,0,0,92277.983837,9.030320999998366,164.7781955924124,0
"147.32.84.165",3195,"205.188.146.193",25,3,186,3,186,0,0,92278.112874,9.00157200000831,165.30446015414046,0
"147.32.84.165",3196,"205.188.103.2",25,3,186,3,186,0,0,92278.285164,9.029781000004732,164.78804967686594,0
"147.32.84.165",3197,"207.115.21.20",25,3,186,3,186,0,0,92278.285291,9.0297750000027,164.78815917335203,0
"147.32.84.165",3159,"46.4.36.120",443,6,366,3,186,3,180,92283.904313,1.0305850000004284,1443.8401490409635,1397.264660362223
"147.32.84.165",3198,"195.76.55.75",25,3,186,3,186,0,0,92284.935118,8.901568000001134,167.16156074972525,0
"147.32.84.165",3176,"116.193.128.2",6667,6,366,3,186,3,180,92297.349153,1.6237379999947734,916.4040011410644,886.8425817494171
"147.32.84.165",3159,"46.4.36.120",443,6,366,3,186,3,180,92298.051615,1.0307939999911468,1443.547401336038,1396.9813561316496
"147.32.84.165",3200,"98.139.54.60",25,3,186,3,186,0,0,92298.151474,9.031784999999218,164.75148600195075,0
"147.32.84.165",3201,"203.188.197.119",25,3,186,3,186,0,0,92298.352017,9.032179000001634,164.74429924381823,0
"147.32.84.165",3202,"110.45.215.57",25,3,186,3,186,0,0,92298.352144,9.032102999990457,164.74568547342432,0
"147.32.84.165",3203,"76.162.254.118",25,3,186,3,186,0,0,92298.753443,9.031724000000395,164.75259872865192,0
"147.32.84.165",3204,"205.188.159.42",25,3,186,3,186,0,0,92298.853531,9.03165699999954,164.75382092124133,0
"147.32.84.165",3206,"65.54.188.72",25,3,186,3,186,0,0,92298.953913,9.032107999999425,164.74559427324104,0
"147.32.84.165",3207,"205.188.146.194",25,3,186,3,186,0,0,92298.97313,9.013013000003411,165.09462484958547,0
"147.32.84.165",3208,"65.55.92.184",25,3,186,3,186,0,0,92299.054782,9.031059999993886,164.76471200512535,0
"147.32.84.165",3211,"98.139.175.224",25,3,186,3,186,0,0,92299.082697,9.003282999998191,165.27304539913928,0
"147.32.84.165",3212,"64.191.223.39",25,3,186,3,186,0,0,92299.254961,9.031879999994999,164.7497530968994,0
"147.32.84.165",3185,"89.228.163.103",6667,6,366,3,186,3,180,92305.87946,1.0514390000025742,1415.2033546371754,1369.5516335198472
"147.32.84.165",3182,"46.4.36.120",443,6,366,3,186,3,180,92306.931107,0.9814540000079433,1516.1179229876868,1467.2108932138904
"147.32.84.165",3213,"64.12.90.97",25,3,186,3,186,0,0,92307.912841,9.003462000007858,165.2697595656761,0
"147.32.84.165",3193,"46.4.36.120",443,6,366,3,186,3,180,92319.225036,1.0313999999925727,1442.6992437567533,1396.1605584742774
"147.32.84.165",3214,"98.139.175.225",25,3,186,3,186,0,0,92319.425962,8.929796000011265,166.6331459305591,0
"147.32.84.165",3215,"68.1.17.3",25,3,186,3,186,0,0,92319.827691,8.929506000000401,166.63855760889047,0
"147.32.84.165",3216,"205.188.146.193",25,3,186,3,186,0,0,92319.927641,8.92998699999589,166.62958187964716,0
"147.32.84.165",3217,"64.12.138.161",25,3,186,3,186,0,0,92320.028171,8.92930499999784,166.64230866796018,0
"147.32.84.165",3218,"98.139.175.224",25,3,186,3,186,0,0,92320.028303,8.929270000007818,166.64296185451857,0
"147.32.84.165",3220,"64.12.90.33",25,3,186,3,186,0,0,92320.028359,8.92923699998937,166.64357772134073,0
"147.32.84.165",3221,"208.65.145.12",25,3,186,3,186,0,0,92320.12881,8.929275000002235,166.64286854191718,0
"147.32.84.165",3224,"98.139.54.60",25,3,186,3,186,0,0,92320.128941,8.929210000002058,166.64408161524446,0
"147.32.84.165",3225,"64.12.90.66",25,3,186,3,186,0,0,92320.256663,8.902273000014247,167.1483226809174,0
"147.32.84.165",3227,"212.4.22.148",25,3,186,3,186,0,0,92320.329121,8.929965999996057,166.62997373121655,0
"147.32.84.165",3202,"46.4.36.120",443,6,366,3,186,3,180,92328.857733,1.0298889999976382,1444.8158976388838,1398.2089331989198
"147.32.84.165",3228,"209.85.143.27",25,3,186,3,186,0,0,92329.887828,9.00168199998734,165.30244014419668,0
"147.32.84.165",3202,"46.4.36.120",443,6,366,3,186,3,180,92340.396203,1.0305640000005951,1443.869570447969,1397.293132691583
"147.32.84.165",3230,"205.188.156.193",25,3,186,3,186,0,0,92340.797429,9.03055100000347,164.77399884009606,0
"147.32.84.165",3231,"98.139.175.224",25,3,186,3,186,0,0,92340.897715,9.031249000006937,164.76126391807568,0
"147.32.84.165",3232,"64.12.90.98",25,3,186,3,186,0,0,92340.99782,9.031147999994573,164.76310652874852,0
"147.32.84.165",3233,"209.85.225.27",25,3,186,3,186,0,0,92340.997918,9.031193000002531,164.76228555846197,0
"147.32.84.165",3234,"64.12.90.34",25,3,186,3,186,0,0,92341.098634,9.030738000001293,164.7705868556686,0
"147.32.84.165",3235,"64.136.44.37",25,3,186,3,186,0,0,92341.098766,9.030727000004845,164.7707875566609,0
"147.32.84.165",3236,"94.245.120.86",25,3,186,3,186,0,0,92341.199861,9.030377000002773,164.7771737547107,0
"147.32.84.165",3239,"200.54.151.131",25,3,186,3,186,0,0,92341.298787,9.03137899999274,164.7588923021829,0
"147.32.84.165",3240,"160.15.14.8",25,3,186,3,186,0,0,92341.426991,9.003114999999525,165.2761294285454,0
"147.32.84.165",3217,"46.4.36.120",443,6,366,3,186,3,180,92350.932972,1.0306760000094073,1443.7126701178825,1397.1412936624668
"147.32.84.165",3241,"98.139.175.224",25,3,186,3,186,0,0,92351.963886,8.901590000008582,167.16114761504016,0
"147.32.84.165",3242,"205.188.103.2",25,3,186,3,186,0,0,92351.963948,8.901650999992853,167.16000211659554,0
"147.32.84.165",3217,"46.4.36.120",443,6,366,3,186,3,180,92361.770162,1.0318850000039674,1442.0211554526704,1395.5043439864553
"147.32.84.165",3245,"64.12.90.33",25,3,186,3,186,0,0,92361.870898,9.03360700000485,164.71825705935638,0
"147.32.84.165",3246,"71.6.145.17",25,3,186,3,186,0,0,92361.970779,9.032747000004747,164.73393974161107,0
"147.32.84.165",3247,"65.55.37.88",25,3,186,3,186,0,0,92361.970878,9.032771000012872,164.73350204470805,0
"147.32.84.165",3248,"207.115.20.21",25,3,186,3,186,0,0,92362.07136,9.032756000000518,164.73377560513256,0
"147.32.84.165",3249,"64.136.44.37",25,3,186,3,186,0,0,92362.071491,9.032749000005424,164.7339032667803,0
"147.32.84.165",3251,"205.188.159.42",25,3,186,3,186,0,0,92362.171785,9.032521000000997,164.73806150019863,0
"147.32.84.165",3252,"98.139.175.224",25,3,186,3,186,0,0,92362.272017,9.032856000005268,164.7319518875461,0
"147.32.84.165",3253,"65.54.188.110",25,3,186,3,186,0,0,92362.373038,9.03210099998978,164.7457219534728,0
"147.32.84.165",3254,"24.173.24.142",25,3,186,3,186,0,0,92362.802278,9.004527999990387,165.25019412473242,0
"147.32.84.165",3240,"123.194.145.64",6667,2,124,2,124,0,0,92372.910076,3.0125019999977667,329.2943871906925,0
"147.32.84.165",3231,"46.4.36.120",443,6,366,3,186,3,180,92382.944765,1.0306950000085635,1443.6860564838648,1397.1155385327722
"147.32.84.165",3255,"205.188.103.2",25,3,186,3,186,0,0,92383.044838,8.932113000002573,166.5899211082049,0
"147.32.84.165",3240,"173.192.170.88",80,20,4728,12,1168,8,3560,92383.044986,60.33567700001004,154.86691232450156,472.0258629068712
"147.32.84.165",3257,"205.188.190.2",25,3,186,3,186,0,0,92383.145511,8.931766000008793,166.59639314314046,0
"147.32.84.165",3260,"207.166.192.59",25,3,186,3,186,0,0,92383.14568,8.931719000000157,166.59726979766984,0
"147.32.84.165",3262,"165.21.74.122",25,3,186,3,186,0,0,92383.245791,8.93126700000721,166.60570107228892,0
"147.32.84.165",3263,"209.85.225.27",25,3,186,3,186,0,0,92383.346301,8.931236000003992,166.60627935476512,0
"147.32.84.165",3264,"98.139.175.224",25,3,186,3,186,0,0,92383.446686,8.931408000004012,166.60307087072178,0
"147.32.84.165",3265,"64.12.90.1",25,3,186,3,186,0,0,92383.848287,8.931326000005356,166.60460048139635,0
"147.32.84.165",3266,"64.12.90.66",25,3,186,3,186,0,0,92383.97569,8.903781999993953,167.11999462711583,0
"147.32.84.165",3246,"46.4.36.120",443,6,366,3,186,3,180,92387.762444,1.0315569999947911,1442.4796690900394,1395.9480668613285
"147.32.84.165",3267,"64.166.203.34",25,3,186,3,186,0,0,92388.794267,9.00301600000239,165.27794685687607,0
"147.32.84.165",3254,"210.211.186.4",6667,2,124,2,124,0,0,92392.177873,3.0092700000095647,329.64805417820503,0
"147.32.84.165",3246,"46.4.36.120",443,6,366,3,186,3,180,92404.019946,1.0308550000045216,1443.4619805825973,1396.8986908863844
"147.32.84.165",3268,"76.96.30.116",25,3,186,3,186,0,0,92404.120362,9.032638999997289,164.7359094059274,0
"147.32.84.165",3269,"165.21.74.122",25,3,186,3,186,0,0,92404.120478,9.03264499999932,164.73579997886688,0
"147.32.84.165",3274,"64.12.138.161",25,3,186,3,186,0,0,92404.120537,9.032635000010487,164.73598235711643,0
"147.32.84.165",3277,"65.55.92.152",25,3,186,3,186,0,0,92404.220622,9.03309400001308,164.7276116021648,0
"147.32.84.165",3281,"64.12.90.98",25,3,186,3,186,0,0,92404.321449,9.032476000007591,164.73888222883176,0
"147.32.84.165",3282,"205.188.146.194",25,3,186,3,186,0,0,92404.421769,9.03274200001033,164.7340309286259,0
"147.32.84.165",3283,"64.12.90.66",25,3,186,3,186,0,0,92404.82297,9.03257000001031,164.7371678269088,0
"147.32.84.165",3287,"205.188.159.42",25,3,186,3,186,0,0,92404.823099,9.032563999993727,164.73727725605193,0
"147.32.84.165",3288,"65.55.88.22",25,3,186,3,186,0,0,92404.922947,9.032940999997663,164.73040175955813,0
"147.32.84.165",3290,"64.12.90.66",25,3,186,3,186,0,0,92405.051041,9.005266000007396,165.23665153242314,0
"147.32.84.165",3260,"46.4.36.120",443,6,366,3,186,3,180,92408.836499,1.0305070000031264,1443.9494345943167,1397.3704205751453
"147.32.84.165",3291,"165.21.74.121",25,3,186,3,186,0,0,92409.839463,8.933883000005153,166.55691595682882,0
"147.32.84.165",3294,"203.188.197.119",25,3,186,3,186,0,0,92409.867258,8.906214999995427,167.0743407834601,0
"147.32.84.165",3260,"46.4.36.120",443,6,366,3,186,3,180,92425.095387,1.03052500000922,1443.924213373462,1397.34601294206
"147.32.84.165",3295,"74.6.136.244",25,3,186,3,186,0,0,92425.095535,9.03110999999626,164.76379979876407,0
"147.32.84.165",3296,"205.188.190.1",25,3,186,3,186,0,0,92425.196017,9.03063700000348,164.7724296746095,0
"147.32.84.165",3297,"64.12.90.33",25,3,186,3,186,0,0,92425.296256,9.030348999993294,164.77768467211013,0
"147.32.84.165",3298,"64.12.138.161",25,3,186,3,186,0,0,92425.396474,9.0302159999992,164.7801115720966,0
"147.32.84.165",3299,"209.85.225.27",25,3,186,3,186,0,0,92425.797952,9.030278000005637,164.77898022619803,0
"147.32.84.165",3301,"212.64.225.220",25,3,186,3,186,0,0,92425.897824,9.031212000001688,164.76193892909635,0
"147.32.84.165",3302,"200.75.0.70",25,3,186,3,186,0,0,92425.997861,9.03117500001099,164.76261394538244,0
"147.32.84.165",3303,"151.151.26.142",25,3,186,3,186,0,0,92426.126152,9.003643000003649,165.26643715209465,0
"147.32.84.165",3281,"122.218.153.19",6667,6,366,3,186,3,180,92430.814793,1.9190709999966202,775.375168507377,750.3630662974616
"147.32.84.165",3274,"46.4.36.120",443,6,366,3,186,3,180,92430.814928,1.0301649999892106,1444.4288051094577,1397.8343275252817
"147.32.84.165",3305,"220.109.216.226",25,3,186,3,186,0,0,92431.845313,9.003832999995211,165.2629496794078,0
"147.32.84.165",3306,"67.231.144.57",25,3,186,3,186,0,0,92432.734139,9.019435000009253,164.9770745061607,0
"147.32.84.165",3240,"173.192.170.88",80,10,1039,6,542,4,497,92446.168848,75.38862199999858,57.51531046687764,52.74005406280108
"147.32.84.165",3291,"46.4.36.120",443,6,366,3,186,3,180,92446.268824,0.9308670000027632,1598.5097763650263,1546.9449448693804
"147.32.84.165",3309,"203.188.197.119",25,3,186,3,186,0,0,92446.369671,8.930393000002368,166.622006444689,0
"147.32.84.165",3310,"68.6.19.3",25,3,186,3,186,0,0,92446.369764,8.930420999997295,166.62148402639144,0
"147.32.84.165",3311,"205.188.159.42",25,3,186,3,186,0,0,92446.469786,8.929801999998745,166.63303396874971,0
"147.32.84.165",3312,"64.12.90.97",25,3,186,3,186,0,0,92446.871096,8.931236999997054,166.60626070056037,0
"147.32.84.165",3314,"205.200.74.75",25,3,186,3,186,0,0,92446.97132,8.931296000009752,166.6051601020026,0
"147.32.84.165",3316,"205.188.103.2",25,3,186,3,186,0,0,92447.071138,9.032091999994009,164.74588611375825,0
"147.32.84.165",3317,"207.115.20.23",25,3,186,3,186,0,0,92447.17199,9.031839000002947,164.7505009776541,0
"147.32.84.165",3319,"203.188.197.119",25,3,186,3,186,0,0,92447.199926,9.003996999992523,165.25993955809133,0
"147.32.84.165",3320,"151.151.26.152",25,3,186,3,186,0,0,92447.199984,9.003962999995565,165.26056359857685,0
"147.32.84.165",3303,"202.109.187.132",6667,3,186,3,186,0,0,92452.792024,9.030370000007679,164.77730148363077,0
"147.32.84.165",3296,"46.4.36.120",443,6,366,3,186,3,180,92453.69466,1.030865000007907,1443.447978143197,1396.8851401385778
"147.32.84.165",3321,"65.168.16.5",25,3,186,3,186,0,0,92454.725745,9.003983000002336,165.26019651521042,0
"147.32.84.165",3296,"46.4.36.120",443,6,366,3,186,3,180,92467.342003,1.0304529999993974,1444.025103523276,1397.443648570912
"147.32.84.165",3322,"205.188.59.193",25,3,186,3,186,0,0,92467.342135,9.033104000001913,164.7274292424492,0
"147.32.84.165",3323,"205.188.159.42",25,3,186,3,186,0,0,92467.442792,9.032215999992331,164.74362437759055,0
"147.32.84.165",3324,"205.188.103.2",25,3,186,3,186,0,0,92467.844068,9.032728999998653,164.7342680158147,0
"147.32.84.165",3325,"68.6.19.3",25,3,186,3,186,0,0,92467.844125,9.032764999996289,164.73361146898114,0
"147.32.84.165",3331,"209.85.225.27",25,3,186,3,186,0,0,92467.944388,9.033402000000933,164.72199510216043,0
"147.32.84.165",3332,"216.32.181.178",25,3,186,3,186,0,0,92468.1446,9.032506000003195,164.73833507550103,0
"147.32.84.165",3333,"65.54.188.94",25,3,186,3,186,0,0,92468.245123,9.032902000006288,164.731112991037,0
"147.32.84.165",3334,"65.55.92.136",25,3,186,3,186,0,0,92468.245258,9.032889000009163,164.73135006956142,0
"147.32.84.165",3335,"64.12.90.34",25,3,186,3,186,0,0,92468.372696,9.00517599999148,165.23830294948237,0
"147.32.84.165",3309,"46.4.36.120",443,6,366,3,186,3,180,92473.56398,1.0319259999960195,1441.9638617553387,1395.4488984729085
"147.32.84.165",3336,"38.113.116.194",25,3,186,3,186,0,0,92474.596155,8.902186999999685,167.14993742549473,0
"147.32.84.165",3320,"195.70.198.9",6667,3,186,3,186,0,0,92475.772205,8.930248000004212,166.6247118780238,0
"147.32.84.165",3309,"46.4.36.120",443,6,366,3,186,3,180,92488.313613,1.0308339999901364,1443.4913865998192,1396.9271483224056
"147.32.84.165",3337,"205.188.146.193",25,3,186,3,186,0,0,92488.41444,9.029773000002024,164.78819567221308,0
"147.32.84.165",3338,"66.205.82.138",25,3,186,3,186,0,0,92488.815907,9.029670000003534,164.79007538475022,0
"147.32.84.165",3339,"209.85.225.27",25,3,186,3,186,0,0,92488.916184,9.029634999998962,164.79071413187478,0
"147.32.84.165",3322,"184.82.155.107",80,10,1916,5,985,5,931,92489.116428,0.3235030000068946,24358.35216313932,23022.970420185487
"147.32.84.165",3340,"201.91.126.75",25,3,186,3,186,0,0,92489.217053,9.0298380000022,164.78700946790377,0
"147.32.84.165",3341,"202.153.32.135",25,3,186,3,186,0,0,92489.217185,9.029827000005753,164.78721020890566,0
"147.32.84.165",3342,"65.54.188.126",25,3,186,3,186,0,0,92489.22322,9.023841000001994,164.8965224453391,0
"147.32.84.165",3346,"64.12.90.34",25,3,186,3,186,0,0,92489.317001,9.031784999999218,164.75148600195075,0
"147.32.84.165",3347,"65.54.188.94",25,3,186,3,186,0,0,92489.344693,9.004212999992887,165.25597517530687,0
"147.32.84.165",3331,"46.4.36.120",443,6,366,3,186,3,180,92494.635293,1.030360999997356,1444.1540392190877,1397.56842505073
"147.32.84.165",3323,"184.82.155.108",80,10,1511,5,599,5,912,92495.538061,0.3231610000075307,14828.522005713348,22576.981751603627
"147.32.84.165",3350,"208.70.229.65",25,3,186,3,186,0,0,92495.64459,9.026874000002863,164.84111775566248,0
"147.32.84.165",3351,"205.188.190.2",25,3,186,3,186,0,0,92495.665876,9.005711000005249,165.2284866790787,0
"147.32.84.165",3323,"46.4.36.120",443,6,366,3,186,3,180,92509.385872,1.033370000004652,1439.9489050323712,1393.4989403539075
"147.32.84.165",3336,"217.163.21.37",80,14,6141,7,810,7,5331,92509.789939,0.18941000000631902,34211.4988637549,225162.34622552767
"147.32.84.165",3352,"65.55.37.104",25,3,186,3,186,0,0,92509.836062,8.987664000000223,165.56026126476948,0
"147.32.84.165",3353,"209.85.225.27",25,3,186,3,186,0,0,92509.889991,9.034163999996963,164.70810138054836,0
"147.32.84.165",3337,"217.163.21.37",80,10,1451,5,701,5,750,92510.190834,0.13919600000372157,40288.51403668254,43104.68691513824
"147.32.84.165",3354,"12.130.194.63",25,3,186,3,186,0,0,92510.190971,9.033836999995401,164.71406335987217,0
"147.32.84.165",3355,"205.188.146.193",25,3,186,3,186,0,0,92510.19103,9.033914999992703,164.712641197222,0
"147.32.84.165",3356,"193.203.96.3",25,3,186,3,186,0,0,92510.236714,8.988280999998096,165.548896390791,0
"147.32.84.165",3339,"217.163.21.34",80,9,2805,5,1225,4,1580,92510.291275,0.2380600000033155,41166.09258112877,53095.8581862722
"147.32.84.165",3357,"98.139.54.60",25,3,186,3,186,0,0,92510.291405,9.03312600000936,164.72702805191227,0
"147.32.84.165",3359,"64.12.90.66",25,3,186,3,186,0,0,92510.337301,8.987350999988848,165.5660271866367,0
"147.32.84.165",3361,"205.188.156.193",25,3,186,3,186,0,0,92510.419484,9.005543999999645,165.2315506981098,0
"147.32.84.165",3323,"46.4.36.120",443,6,366,3,186,3,180,92516.616387,1.0306299999938346,1443.7771072149087,1397.20365214346
"147.32.84.165",3340,"217.163.21.37",80,10,2277,5,1156,5,1121,92516.616518,0.13992200000211596,66093.96663755627,64092.85173070984
"147.32.84.165",3363,"205.188.103.2",25,3,186,3,186,0,0,92516.662603,8.98270799999591,165.65160528436164,0
"147.32.84.165",3340,"94.100.176.20",25,3,186,3,186,0,0,92517.647251,9.001132999997935,165.31252232361652,0
"147.32.84.165",3341,"195.113.232.88",80,8,1205,5,661,3,544,92530.86256,68.50841200001014,77.18760142913862,63.52504565423814
"147.32.84.165",3364,"65.55.92.136",25,3,186,3,186,0,0,92530.863463,9.029886999996961,164.78611526373484,0
"147.32.84.165",3240,"173.192.170.88",80,17,1649,11,1028,6,621,92530.962861,74.9681309999869,109.69994703484655,66.26815866599193
"147.32.84.165",3323,"46.4.36.120",443,6,366,3,186,3,180,92531.263898,1.0306229999987409,1443.786913354173,1397.2131419556513
"147.32.84.165",3347,"184.82.148.43",80,10,1927,5,987,5,940,92531.26403,0.3402019999921322,23209.740096127036,22104.514377263844
"147.32.84.165",3366,"65.54.188.72",25,3,186,3,186,0,0,92531.264089,8.930838999993284,166.61368545565753,0
"147.32.84.165",3350,"217.163.21.34",80,11,3931,6,1740,5,2191,92531.364527,0.15866000000096392,87734.7787716843,110475.23005101166
"147.32.84.165",3367,"205.188.190.2",25,3,186,3,186,0,0,92531.364658,8.93003599999065,166.6286675665762,0
"147.32.84.165",3369,"205.188.59.194",25,3,186,3,186,0,0,92531.376347,8.91847200000484,166.84472407371942,0
"147.32.84.165",3370,"205.188.59.193",25,3,186,3,186,0,0,92531.410504,8.884363999997731,167.4852583708164,0
"147.32.84.165",3371,"200.252.60.27",25,3,186,3,186,0,0,92531.464425,8.93034500000067,166.6229020267289,0
"147.32.84.165",3352,"173.241.240.4",80,9,2195,5,1165,4,1030,92532.294765,0.06904400000348687,134986.38548649152,119344.18630994529
"147.32.84.165",3374,"205.188.146.194",25,3,186,3,186,0,0,92532.311074,8.887975999998162,167.41719374583232,0
"147.32.84.165",3347,"217.199.111.74",6667,2,124,2,124,0,0,92537.685681,2.910428999995929,340.84322276935376,0
"147.32.84.165",3361,"46.4.36.120",443,6,366,3,186,3,180,92538.689035,1.030663999990793,1443.7294792612263,1397.1575605753803
"147.32.84.165",3353,"92.240.244.181",80,10,1172,6,778,4,394,92539.719989,12.324265999995987,505.0199338445005,255.7555963171378
"147.32.84.165",3375,"68.1.17.3",25,3,186,3,186,0,0,92539.728532,8.896550000004936,167.2558463673193,0
"147.32.84.165",3340,"74.125.93.27",25,3,186,3,186,0,0,92540.195036,9.0325359999988,164.73778792580487,0
"147.32.84.165",3354,"184.82.148.44",80,10,1514,5,596,5,918,92551.936894,0.3242339999997057,14705.42879526616,22650.30811082942
"147.32.84.165",3377,"64.12.90.65",25,3,186,3,186,0,0,92552.043958,9.02341300000262,164.90434384412728,0
"147.32.84.165",3361,"46.4.36.120",443,6,366,3,186,3,180,92552.238178,1.0316080000047805,1442.408356655924,1395.8790548283137
"147.32.84.165",3363,"184.82.148.43",80,10,1929,5,995,5,934,92552.338366,0.32168400000955444,24744.780591398943,23227.76389182574
"147.32.84.165",3379,"64.12.90.33",25,3,186,3,186,0,0,92552.3385,9.029609999997774,164.79117038281464,0
"147.32.84.165",3364,"217.163.21.37",80,13,6075,6,750,7,5325,92552.338558,0.18750600000203121,31998.976032420313,227192.72983018422
"147.32.84.165",3380,"207.193.249.2",25,3,186,3,186,0,0,92552.384513,8.983718000003137,165.6329818010183,0
"147.32.84.165",3381,"64.12.90.98",25,3,186,3,186,0,0,92552.438681,9.02940299999318,164.79494823756608,0
"147.32.84.165",3383,"205.188.103.2",25,3,186,3,186,0,0,92552.444506,9.023700000005192,164.8990990391019,0
"147.32.84.165",3366,"212.117.171.138",65500,14,870,8,486,6,384,92553.242314,2.2421679999970365,1734.0359866009767,1370.102507931636
"147.32.84.165",3353,"217.163.21.37",80,10,1447,5,699,5,748,92553.242368,0.14391699999396224,38855.729345627005,41579.52153151502
"147.32.84.165",3384,"91.199.63.28",25,3,186,3,186,0,0,92553.270016,9.00045800000953,165.3249201316671,0
"147.32.84.165",3367,"64.12.168.40",587,21,2055,11,694,10,1361,92553.292309,31.316176000007545,177.28856805500973,347.67974225197156
"147.32.84.165",3354,"184.82.148.44",80,10,1495,5,590,5,905,92553.410248,0.32410600000002887,14563.136751555292,22338.370779928035
"147.32.84.165",3387,"98.139.54.60",25,3,186,3,186,0,0,92553.517274,8.954198000006727,166.1790369164142,0
"147.32.84.165",3374,"46.4.36.120",443,6,366,3,186,3,180,92555.348188,1.0306129999953555,1443.8009223701872,1397.2266990679232
"147.32.84.165",3371,"217.163.21.34",80,9,2806,5,1238,4,1568,92556.379064,0.23753900000883732,41694.20600251552,52808.170445835494
"147.32.84.165",3388,"208.84.244.133",25,3,186,3,186,0,0,92556.428712,8.953917999999248,166.18423353889602,0
"147.32.84.165",3353,"212.117.171.138",65500,9,544,5,302,4,242,92560.665762,1.9676659999968251,1227.8506616488257,983.9068215861452
"147.32.84.165",3371,"46.4.36.120",443,6,366,3,186,3,180,92560.665889,1.0308090000035008,1443.5263952826822,1396.9610276929184
"147.32.84.165",3364,"217.163.21.34",80,13,6588,6,1284,7,5304,92561.267923,0.18714699998963624,54887.334558228766,226730.85864240295
"147.32.84.165",3391,"217.72.192.149",25,3,186,3,186,0,0,92561.314,8.985526999997091,165.5996359479507,0
"147.32.84.165",3340,"74.125.39.27",25,3,186,3,186,0,0,92561.696905,9.003974999999627,165.26034334836132,0
"147.32.84.165",3370,"217.163.21.37",80,10,2273,5,1154,5,1119,92573.010488,0.14031099999556318,65796.69448790136,63801.127497367095
"147.32.84.165",3394,"98.139.175.224",25,3,186,3,186,0,0,92573.057115,8.985132000001613,165.60691595846703,0
"147.32.84.165",3353,"212.117.171.138",65500,15,912,8,486,7,426,92573.311093,4.164147999996203,933.6843935430597,818.4147153278672
"147.32.84.165",3364,"46.4.36.120",443,6,366,3,186,3,180,92573.311233,1.0300920000008773,1444.5311680886102,1397.9333884728487
"147.32.84.165",3377,"217.163.21.40",80,11,3974,6,1753,5,2221,92573.311306,0.15674099999887403,89472.4417995339,113358.98073974033
"147.32.84.165",3395,"64.12.90.34",25,3,186,3,186,0,0,92573.357119,8.986143000001903,165.58828409470948,0
"147.32.84.165",3397,"98.139.54.60",25,3,186,3,186,0,0,92573.411378,9.032351999994717,164.7411438350576,0
"147.32.84.165",3398,"64.12.90.97",25,3,186,3,186,0,0,92573.411518,9.03226100000029,164.7428036014407,0
"147.32.84.165",3400,"64.12.138.161",25,3,186,3,186,0,0,92573.411593,9.032229999997071,164.74336902409289,0
"147.32.84.165",3370,"173.241.240.4",80,9,2193,5,1163,4,1030,92574.214251,0.06747900000482332,137879.93300634212,122112.06448541049
"147.32.84.165",3403,"68.1.17.3",25,3,186,3,186,0,0,92574.230449,9.01560199999949,165.04721481716743,0
"147.32.84.165",3379,"92.240.244.181",80,10,1758,6,1364,4,394,92574.341561,5.019948000001023,2173.727695983659,627.8949503061302
"147.32.84.165",3404,"205.188.156.193",25,3,186,3,186,0,0,92574.350163,8.99570900000981,165.412198193425,0
"147.32.84.165",3405,"98.139.54.60",25,3,186,3,186,0,0,92574.414464,9.032139999995707,164.74501059557394,0
"147.32.84.165",3377,"46.4.36.120",443,6,366,3,186,3,180,92577.325769,1.0306019999989076,1443.816332591609,1397.241612185428
"147.32.84.165",3406,"74.6.136.244",25,3,186,3,186,0,0,92578.356604,9.003045000004931,165.27741447467884,0
"147.32.84.165",3377,"173.192.170.88",80,10,1328,6,799,4,529,92582.242559,6.853129999988596,932.7124977945314,617.528049228169
"147.32.84.165",3384,"212.117.171.138",65500,14,852,8,486,6,366,92582.242685,11.90127199998824,326.6877691732314,246.02412246379154
"147.32.84.165",3407,"205.188.146.194",25,3,186,3,186,0,0,92582.242739,9.03075400000671,164.77029492763222,0
"147.32.84.165",3409,"207.115.20.22",25,3,186,3,186,0,0,92582.744147,9.03101500000048,164.76553299932743,0
"147.32.84.165",3391,"66.111.4.71",25,3,186,3,186,0,0,92594.083076,8.932738000003155,166.57826525299123,0
"147.32.84.165",3411,"98.139.175.224",25,3,186,3,186,0,0,92594.384055,8.932975000003353,166.57384577919916,0
"147.32.84.165",3367,"212.117.171.138",65500,14,871,8,486,6,385,92594.484316,296.12601300000097,13.129545630292153,10.400977505478352
"147.32.84.165",3340,"46.4.36.120",443,6,366,3,186,3,180,92594.484446,1.0323459999926854,1441.3772126889078,1394.8811735699107
"147.32.84.165",3413,"211.43.197.191",25,3,186,3,186,0,0,92594.50677,8.911581999986083,166.9737202667634,0
"147.32.84.165",3415,"205.188.146.194",25,3,186,3,186,0,0,92595.288103,8.934370999995735,166.5478185314568,0
"147.32.84.165",3416,"64.12.90.97",25,3,186,3,186,0,0,92595.288229,8.93429499999911,166.54923527823382,0
"147.32.84.165",3417,"165.21.74.121",25,3,186,3,186,0,0,92595.388572,8.934501000010641,166.5453952043016,0
"147.32.84.165",3418,"209.66.101.140",25,3,186,3,186,0,0,92595.489397,8.934084000007715,166.55316874105,0
"147.32.84.165",3419,"212.108.161.22",25,3,186,3,186,0,0,92595.517105,8.906479999990552,167.06936971750665,0
"147.32.84.165",3395,"178.95.10.210",6667,2,124,2,124,0,0,92599.403026,2.910527000000002,340.8317462782511,0
"147.32.84.165",3397,"46.4.36.120",443,6,366,3,186,3,180,92603.216222,1.0336109999916516,1439.6131620232547,1393.17402776444
"147.32.84.165",3421,"98.139.175.224",25,3,186,3,186,0,0,92603.719896,9.034066000007442,164.7098881056187,0
"147.32.84.165",3422,"65.54.188.110",25,3,186,3,186,0,0,92603.719972,9.034115999995265,164.7089765064761,0
"147.32.84.165",3423,"64.12.90.66",25,3,186,3,186,0,0,92604.250119,9.006299000000581,165.21769930133388,0
"147.32.84.165",3240,"173.192.170.88",80,9,984,6,547,3,437,92615.06247,59.600493999998434,73.42221022530644,58.657231935025436
"147.32.84.165",3397,"46.4.36.120",443,6,366,3,186,3,180,92615.363246,1.030417000001762,1444.0755538752326,1397.4924714921606
"147.32.84.165",3424,"211.108.79.150",25,3,186,3,186,0,0,92615.463767,9.029403000007733,164.79494823730047,0
"147.32.84.165",3391,"216.157.130.15",25,3,186,3,186,0,0,92616.266394,9.02998099999968,164.7843998785881,0
"147.32.84.165",3425,"68.6.19.3",25,3,186,3,186,0,0,92616.366323,9.02968300000066,164.7898381371629,0
"147.32.84.165",3426,"205.188.59.193",25,3,186,3,186,0,0,92616.393896,9.002210999999079,165.29272642022636,0
"147.32.84.165",3427,"195.75.94.104",25,3,186,3,186,0,0,92616.466813,9.030042999991565,164.78326847406927,0
"147.32.84.165",3429,"195.50.106.142",25,3,186,3,186,0,0,92616.466949,9.030007000008482,164.78392541651434,0
"147.32.84.165",3430,"65.55.88.22",25,3,186,3,186,0,0,92616.567282,9.029484999991837,164.79345167541064,0
"147.32.84.165",3413,"133.6.157.199",6667,2,124,2,124,0,0,92624.292466,3.010706000000937,329.4908237468857,0
"147.32.84.165",3397,"46.4.36.120",443,6,366,3,186,3,180,92624.794664,1.0306520000012824,1443.7462887552233,1397.1738278276355
"147.32.84.165",3431,"207.115.20.22",25,3,186,3,186,0,0,92625.296452,8.929979000007734,166.6297311559984,0
"147.32.84.165",3433,"205.188.103.2",25,3,186,3,186,0,0,92625.825498,8.902436999997008,167.14524348787867,0
"147.32.84.165",3397,"46.4.36.120",443,6,366,3,186,3,180,92636.433208,1.0309509999933653,1443.327568438826,1396.7686146182186
"147.32.84.165",3434,"98.139.175.224",25,3,186,3,186,0,0,92637.236049,9.030345000006491,164.77775766030317,0
"147.32.84.165",3435,"194.109.24.139",25,3,186,3,186,0,0,92637.336296,9.030036000011023,164.78339621217276,0
"147.32.84.165",3436,"64.12.90.33",25,3,186,3,186,0,0,92637.336426,9.0300270000007,164.78356044781313,0
"147.32.84.165",3437,"65.55.88.22",25,3,186,3,186,0,0,92637.436662,9.029799000010826,164.78772118828073,0
"147.32.84.165",3438,"74.6.136.244",25,3,186,3,186,0,0,92637.436681,9.029900999987149,164.78585977876367,0
"147.32.84.165",3439,"207.115.20.22",25,3,186,3,186,0,0,92637.436716,9.029913999998826,164.785622543049,0
"147.32.84.165",3441,"68.1.17.3",25,3,186,3,186,0,0,92637.43674,9.029947999995784,164.78500208425285,0
"147.32.84.165",3442,"205.188.103.2",25,3,186,3,186,0,0,92637.46443,9.00228299999435,165.29140441385078,0
"147.32.84.165",3443,"98.139.175.224",25,3,186,3,186,0,0,92637.464487,9.002271999997902,165.29160638562652,0
"147.32.84.165",3445,"64.12.90.33",25,3,186,3,186,0,0,92637.464536,9.002269999997225,165.2916431078449,0
"147.32.84.165",3450,"167.230.202.15",25,3,186,3,186,0,0,92637.464589,9.002265000002808,165.29173491332858,0
"147.32.84.165",3452,"94.245.120.86",25,3,186,3,186,0,0,92637.537163,9.02933099999791,164.79626231448867,0
"147.32.84.165",3454,"68.1.17.3",25,3,186,3,186,0,0,92637.638036,9.029045999996015,164.80146407501488,0
"147.32.84.165",3455,"64.12.90.66",25,3,186,3,186,0,0,92637.638162,9.029045999996015,164.80146407501488,0
"147.32.84.165",3424,"117.204.74.3",6667,1,62,1,62,0,0,92646.26653,0,0,0
"147.32.84.165",3425,"46.4.36.120",443,6,366,3,186,3,180,92646.767653,1.0320280000014463,1441.821345930454,1395.3109799326974
"147.32.84.165",3456,"63.68.14.34",25,3,186,3,186,0,0,92647.799952,9.001629000005778,165.30341341539904,0
"147.32.84.165",3433,"46.4.36.120",443,6,366,3,186,3,180,92658.306471,1.0306779999955324,1443.7098686558263,1397.1385825701545
"147.32.84.165",3458,"65.55.92.136",25,3,186,3,186,0,0,92658.407108,8.929564999998547,166.63745658385847,0
"147.32.84.165",3460,"98.139.175.224",25,3,186,3,186,0,0,92658.407238,8.929556999995839,166.6376058745908,0
"147.32.84.165",3463,"64.136.44.37",25,3,186,3,186,0,0,92658.506703,8.930612999989535,166.61790181723737,0
"147.32.84.165",3464,"205.188.146.194",25,3,186,3,186,0,0,92658.506838,8.93053699999291,166.6193197566038,0
"147.32.84.165",3466,"212.27.48.7",25,3,186,3,186,0,0,92658.506904,8.930493000007118,166.62014067967064,0
"147.32.84.165",3467,"209.85.225.27",25,3,186,3,186,0,0,92658.606994,8.93080600000394,166.61430110556017,0
"147.32.84.165",3468,"205.188.103.1",25,3,186,3,186,0,0,92658.707672,8.930982999998378,166.61099903563473,0
"147.32.84.165",3471,"65.55.92.136",25,3,186,3,186,0,0,92658.707807,8.93096900000819,166.61126021136513,0
"147.32.84.165",3472,"68.6.19.3",25,3,186,3,186,0,0,92658.707864,8.930974000002607,166.61116693426334,0
"147.32.84.165",3434,"88.135.194.91",6667,3,186,3,186,0,0,92659.337417,8.902113000003737,167.15132688153648,0
"147.32.84.165",3437,"46.4.36.120",443,6,366,3,186,3,180,92668.741352,1.032128000006196,1441.681651879483,1395.1757921414353
"147.32.84.165",3474,"98.139.175.224",25,3,186,3,186,0,0,92669.773686,9.000444999997853,165.32515892273713,0
"147.32.84.165",3477,"64.12.90.33",25,3,186,3,186,0,0,92669.773748,9.00050999999803,165.32396497535424,0
"147.32.84.165",3434,"46.4.36.120",443,6,366,3,186,3,180,92679.376714,1.0307380000012927,1443.6258292583896,1397.057254121022
"147.32.84.165",3478,"216.163.188.57",25,3,186,3,186,0,0,92679.37685,9.030366000006325,164.77737447174985,0
"147.32.84.165",3480,"72.4.117.21",25,3,186,3,186,0,0,92679.477581,9.030094999994617,164.78231956594996,0
"147.32.84.165",3482,"205.188.103.2",25,3,186,3,186,0,0,92679.47765,9.030148000005283,164.78135242070556,0
"147.32.84.165",3486,"205.188.103.1",25,3,186,3,186,0,0,92679.477708,9.03013899999496,164.78151665227196,0
"147.32.84.165",3488,"205.188.146.193",25,3,186,3,186,0,0,92679.47776,9.030136000001221,164.78157139602314,0
"147.32.84.165",3489,"194.151.221.83",25,3,186,3,186,0,0,92679.576641,9.032440999988467,164.73952057942034,0
"147.32.84.165",3491,"65.54.188.110",25,3,186,3,186,0,0,92679.677081,9.030939999996917,164.76690134144485,0
"147.32.84.165",3492,"65.55.37.72",25,3,186,3,186,0,0,92679.677217,9.030939999996917,164.76690134144485,0
"147.32.84.165",3496,"64.12.90.33",25,3,186,3,186,0,0,92679.777792,9.030585000000428,164.77337846882892,0
"147.32.84.165",3498,"74.125.148.10",25,3,186,3,186,0,0,92679.777926,9.030575000011595,164.77356093029397,0
"147.32.84.165",3458,"123.194.145.64",6667,3,186,3,186,0,0,92680.407674,9.002993999994942,165.2783507354149,0
"147.32.84.165",3434,"46.4.36.120",443,6,366,3,186,3,180,92690.814909,1.0310610000015004,1443.1735852658908,1396.6195986444106
"147.32.84.165",3504,"205.188.103.2",25,3,186,3,186,0,0,92691.846212,8.904624999995576,167.10417339312315,0
"147.32.84.165",3506,"98.139.175.224",25,3,186,3,186,0,0,92691.846286,8.904622000001837,167.1042296910181,0
"147.32.84.165",3434,"46.4.36.120",443,6,366,3,186,3,180,92700.348446,1.0317829999985406,1442.1637107823105,1395.6423007570747
"147.32.84.165",3509,"65.55.92.136",25,3,186,3,186,0,0,92700.449622,9.031468999994104,164.75725045404812,0
"147.32.84.165",3510,"205.188.59.194",25,3,186,3,186,0,0,92700.449755,9.031458000012208,164.75745112228708,0
"147.32.84.165",3522,"74.125.159.27",25,3,186,3,186,0,0,92700.449819,9.03144199999224,164.75774300507922,0
"147.32.84.165",3523,"68.1.17.3",25,3,186,3,186,0,0,92700.549813,9.030801000000793,164.76943739540596,0
"147.32.84.165",3524,"65.55.92.136",25,3,186,3,186,0,0,92700.649953,9.031071999997948,164.76449307461374,0
"147.32.84.165",3525,"98.139.175.224",25,3,186,3,186,0,0,92700.650079,9.031069000004209,164.76454780705436,0
"147.32.84.165",3526,"64.12.138.161",25,3,186,3,186,0,0,92700.650132,9.031064000009792,164.76463902795803,0
"147.32.84.165",3527,"216.32.180.22",25,3,186,3,186,0,0,92700.650188,9.03105200000573,164.7648579588575,0
"147.32.84.165",3528,"132.72.23.16",25,3,186,3,186,0,0,92700.750947,9.030421000003116,164.77637089117843,0
"147.32.84.165",3530,"68.1.17.3",25,3,186,3,186,0,0,92700.851248,9.03045399999246,164.77576874886273,0
"147.32.84.165",3554,"65.54.188.94",25,3,186,3,186,0,0,92700.851388,9.030437000008533,164.7760789426463,0
"147.32.84.165",3560,"64.12.90.33",25,3,186,3,186,0,0,92701.380505,9.00364000000991,165.26649221852077,0
"147.32.84.165",3496,"27.251.19.95",6667,3,186,3,186,0,0,92712.790817,9.030058000003919,164.7829947492424,0
"147.32.84.165",3480,"46.4.36.120",443,6,366,3,186,3,180,92721.519803,1.030956000002334,1443.3205684788018,1396.7618404633565
"147.32.84.165",3561,"98.139.175.224",25,3,186,3,186,0,0,92721.519935,8.930735999994795,166.61560704524993,0
"147.32.84.165",3562,"205.188.59.194",25,3,186,3,186,0,0,92721.519994,8.930773000000045,166.61491676028407,0
"147.32.84.165",3563,"143.166.224.193",25,3,186,3,186,0,0,92721.620367,8.929864999998244,166.6318583763912,0
"147.32.84.165",3564,"132.72.23.16",25,3,186,3,186,0,0,92721.720826,8.930712999994284,166.61603614414128,0
"147.32.84.165",3569,"207.115.21.24",25,3,186,3,186,0,0,92721.720953,8.930709000007482,166.61611077001314,0
"147.32.84.165",3570,"205.188.103.2",25,3,186,3,186,0,0,92721.721011,8.93069999999716,166.6162786792159,0
"147.32.84.165",3574,"216.117.176.60",25,3,186,3,186,0,0,92721.821016,8.930276999992202,166.62417078454558,0
"147.32.84.165",3576,"98.139.175.224",25,3,186,3,186,0,0,92721.921125,8.930231000005733,166.62502907248924,0
"147.32.84.165",3577,"64.29.145.47",25,3,186,3,186,0,0,92721.921251,8.930225999996765,166.6251223653846,0
"147.32.84.165",3582,"64.12.90.98",25,3,186,3,186,0,0,92722.422548,8.930506000004243,166.61989813335248,0
"147.32.84.165",3586,"65.55.92.184",25,3,186,3,186,0,0,92722.551064,9.002911000003223,165.27987447609638,0
"147.32.84.165",3510,"46.4.36.120",443,6,366,3,186,3,180,92731.453726,1.0304579999938142,1444.0180968161076,1397.4368678865555
"147.32.84.165",3593,"207.172.157.50",25,3,186,3,186,0,0,92732.484408,9.001968999989913,165.2971699859961,0
"147.32.84.165",3526,"80.191.187.36",6667,1,62,1,62,0,0,92742.489499,0,0,0
"147.32.84.165",3528,"46.4.36.120",443,6,366,3,186,3,180,92742.489631,1.031803999998374,1442.1343588533723,1395.6138956645539
"147.32.84.165",3599,"209.85.225.27",25,3,186,3,186,0,0,92742.590369,9.032325000007404,164.7416362895246,0
"147.32.84.165",3601,"65.54.188.72",25,3,186,3,186,0,0,92742.690567,9.033898000008776,164.71295115337304,0
"147.32.84.165",3602,"64.12.90.97",25,3,186,3,186,0,0,92742.690697,9.03389099999913,164.71307878301204,0
"147.32.84.165",3603,"155.212.33.146",25,3,186,3,186,0,0,92742.791253,9.032532999990508,164.73784264077017,0
"147.32.84.165",3604,"65.55.92.184",25,3,186,3,186,0,0,92742.890915,9.032768999997643,164.7335385196265,0
"147.32.84.165",3609,"65.55.88.22",25,3,186,3,186,0,0,92742.891042,9.032764999996289,164.73361146898114,0
"147.32.84.165",3613,"65.55.92.184",25,3,186,3,186,0,0,92743.393203,9.032676999995601,164.73521637059807,0
"147.32.84.165",3615,"64.12.90.66",25,3,186,3,186,0,0,92743.393343,9.032659999997122,164.7355264119843,0
"147.32.84.165",3616,"68.6.19.3",25,3,186,3,186,0,0,92743.521667,9.0038840000052,165.26201359314942,0
"147.32.84.165",3625,"98.139.175.224",25,3,186,3,186,0,0,92743.594229,9.031977999999071,164.74796550657595,0
"147.32.84.165",3526,"31.192.109.161",80,10,1273,5,540,5,733,92752.525428,0.25171500000578817,17162.266849018382,23296.188148760135
"147.32.84.165",3561,"46.4.36.120",443,6,366,3,186,3,180,92752.611003,1.0461429999995744,1422.367687783224,1376.4848591450555
"147.32.84.165",3632,"205.188.146.193",25,3,186,3,186,0,0,92753.528792,8.929946000003838,166.6303469247586,0
"147.32.84.165",3528,"202.141.255.46",6667,3,186,3,186,0,0,92753.657398,8.901652000000468,167.15998333791546,0
"147.32.84.165",3569,"46.4.36.120",443,6,366,3,186,3,180,92763.562205,1.0324000000109663,1441.3018209843028,1394.808213855777
"147.32.84.165",3635,"65.54.188.72",25,3,186,3,186,0,0,92763.662886,9.03090099999099,164.76761288840223,0
"147.32.84.165",3574,"94.100.176.20",25,3,186,3,186,0,0,92763.663029,9.030880999998772,164.7679777864643,0
"147.32.84.165",3636,"205.188.103.2",25,3,186,3,186,0,0,92763.763815,9.030958000003011,164.76657293716835,0
"147.32.84.165",3640,"205.188.59.193",25,3,186,3,186,0,0,92763.863937,9.030795999991824,164.76952862198937,0
"147.32.84.165",3641,"98.139.54.60",25,3,186,3,186,0,0,92764.365561,9.031220000004396,164.7617929802702,0
"147.32.84.165",3648,"205.188.59.194",25,3,186,3,186,0,0,92764.465931,9.030687999998918,164.77149913718404,0
"147.32.84.165",3649,"64.12.90.97",25,3,186,3,186,0,0,92764.566497,9.03041099999973,164.7765533595364,0
"147.32.84.165",3652,"193.53.188.112",25,3,186,3,186,0,0,92764.594808,9.002200000002631,165.29292839523285,0
"147.32.84.165",3602,"46.4.36.120",443,6,366,3,186,3,180,92773.596746,1.0315689999988535,1442.462889057013,1395.93182811969
"147.32.84.165",3653,"62.24.139.61",25,3,186,3,186,0,0,92774.500807,9.034849999996368,164.69559538903226,0
"147.32.84.165",3659,"209.85.143.27",25,3,186,3,186,0,0,92774.628521,9.007858999990276,165.1890865522658,0
"147.32.84.165",3602,"46.4.36.120",443,6,366,3,186,3,180,92784.740851,1.0307710000051884,1443.5796117590717,1397.0125275087792
"147.32.84.165",3661,"167.138.239.95",25,3,186,3,186,0,0,92784.740987,8.92887800000608,166.6502778959447,0
"147.32.84.165",3574,"74.125.93.27",25,3,186,3,186,0,0,92784.840796,8.9296059999906,166.63669147346104,0
"147.32.84.165",3666,"64.12.138.161",25,3,186,3,186,0,0,92784.941155,8.929566000006162,166.63743792239995,0
"147.32.84.165",3669,"98.139.175.224",25,3,186,3,186,0,0,92785.442945,8.929032000000007,166.64740366032947,0
"147.32.84.165",3673,"205.188.156.193",25,3,186,3,186,0,0,92785.543337,8.929096000007121,166.64620920178407,0
"147.32.84.165",3674,"65.54.188.72",25,3,186,3,186,0,0,92785.643179,8.929357999993954,166.64131956642433,0
"147.32.84.165",3678,"64.12.138.161",25,3,186,3,186,0,0,92785.64331,8.929352000006475,166.64143153936826,0
"147.32.84.165",3679,"205.188.159.42",25,3,186,3,186,0,0,92785.643364,8.929346999997506,166.64152485063192,0
"147.32.84.165",3682,"72.23.14.21",25,3,186,3,186,0,0,92785.771844,8.90154399999301,167.162011444438,0
"147.32.84.165",3641,"46.4.36.120",443,6,366,3,186,3,180,92795.475702,1.030769999997574,1443.5810122563737,1397.0138828287486
"147.32.84.165",3686,"198.189.24.40",25,3,186,3,186,0,0,92795.575775,9.033954999991693,164.71191189256183,0
"147.32.84.165",3689,"204.127.208.75",25,3,186,3,186,0,0,92796.506747,9.006506999998237,165.2138836954539,0
"147.32.84.165",3641,"46.4.36.120",443,6,366,3,186,3,180,92805.713271,1.0306109999946784,1443.8037242060132,1397.229410521948
"147.32.84.165",3690,"12.154.96.68",25,3,186,3,186,0,0,92805.813698,9.028717000008328,164.80746932245495,0
"147.32.84.165",3574,"74.125.39.27",25,3,186,3,186,0,0,92805.914169,9.028933000008692,164.8035266181029,0
"147.32.84.165",3694,"208.254.9.199",25,3,186,3,186,0,0,92806.415409,9.028714000000036,164.80752408371714,0
"147.32.84.165",3701,"98.139.175.224",25,3,186,3,186,0,0,92806.516013,9.028581999999005,164.8099336086402,0
"147.32.84.165",3705,"205.188.156.193",25,3,186,3,186,0,0,92806.616709,9.028100000010454,164.81873262350626,0
"147.32.84.165",3710,"204.127.208.75",25,3,186,3,186,0,0,92806.616844,9.028085999991163,164.81898821095152,0
"147.32.84.165",3712,"194.116.198.95",25,3,186,3,186,0,0,92806.616899,9.028080000003683,164.8190977482912,0
"147.32.84.165",3713,"78.67.174.155",25,3,186,3,186,0,0,92806.716428,9.0291819999984,164.79898179040623,0
"147.32.84.165",3715,"196.38.113.23",25,3,186,3,186,0,0,92806.744111,9.001620999988518,165.30356032562335,0
"147.32.84.165",3669,"46.4.36.120",443,6,366,3,186,3,180,92816.648634,1.0302709999959916,1444.2801942457754,1397.6905105604278
"147.32.84.165",3717,"65.54.188.126",25,3,186,3,186,0,0,92817.551037,8.930752000000211,166.61530854288247,0
"147.32.84.165",3729,"65.55.37.120",25,3,186,3,186,0,0,92817.679152,8.904183000006014,167.11246837570553,0
"147.32.84.165",3669,"46.4.36.120",443,6,366,3,186,3,180,92826.783607,1.031074999991688,1443.1539897795947,1396.6006352705756
"147.32.84.165",3730,"205.188.146.194",25,3,186,3,186,0,0,92826.884114,9.031973999997717,164.74803846870861,0
"147.32.84.165",3574,"66.111.4.71",25,3,186,3,186,0,0,92827.38539,9.033307999998215,164.7237091882945,0
"147.32.84.165",3734,"64.12.90.98",25,3,186,3,186,0,0,92827.485968,9.03264499999932,164.73579997886688,0
"147.32.84.165",3736,"65.55.92.152",25,3,186,3,186,0,0,92827.586361,9.032888000001549,164.73136830654215,0
"147.32.84.165",3737,"98.139.175.224",25,3,186,3,186,0,0,92827.586495,9.032875999997486,164.7315871490336,0
"147.32.84.165",3738,"65.55.37.120",25,3,186,3,186,0,0,92827.686874,9.032233999998425,164.7432960660961,0
"147.32.84.165",3740,"64.12.90.97",25,3,186,3,186,0,0,92827.687,9.032230999990134,164.74335078472035,0
"147.32.84.165",3742,"65.55.92.168",25,3,186,3,186,0,0,92827.687059,9.032223000001977,164.74349670061005,0
"147.32.84.165",3744,"209.85.225.27",25,3,186,3,186,0,0,92827.814974,9.004483000011533,165.2510199639551,0
"147.32.84.165",3694,"46.4.36.120",443,6,366,3,186,3,180,92838.526196,1.0308619999996154,1443.4521788566803,1396.8892053451746
"147.32.84.165",3749,"213.171.250.211",25,3,186,3,186,0,0,92838.627482,9.029664000001503,164.7901848839284,0
"147.32.84.165",3750,"65.55.37.120",25,3,186,3,186,0,0,92839.557291,9.003391999998712,165.27104451302498,0
"147.32.84.165",3694,"46.4.36.120",443,6,366,3,186,3,180,92847.958536,1.0314019999932498,1442.6964462059784,1396.157851167076
"147.32.84.165",3751,"64.136.44.37",25,3,186,3,186,0,0,92848.460148,8.93520300000091,166.53231045784278,0
"147.32.84.165",3574,"216.157.130.15",25,3,186,3,186,0,0,92848.560819,8.934890999997151,166.53812564702517,0
"147.32.84.165",3753,"74.6.136.244",25,3,186,3,186,0,0,92848.661274,8.934878000000026,166.5383679553314,0
"147.32.84.165",3756,"209.85.225.27",25,3,186,3,186,0,0,92848.661409,8.934865000002901,166.53861026434276,0
"147.32.84.165",3757,"94.245.120.86",25,3,186,3,186,0,0,92848.661462,8.934863000002224,166.53864754273565,0
"147.32.84.165",3765,"98.139.175.224",25,3,186,3,186,0,0,92848.761407,8.934802000003401,166.5397845413288,0
"147.32.84.165",3775,"207.115.21.20",25,3,186,3,186,0,0,92848.761545,8.934787000005599,166.5400641334894,0
"147.32.84.165",3776,"80.12.242.62",25,3,186,3,186,0,0,92848.861781,8.934494000000996,166.54552568951686,0
"147.32.84.165",3777,"209.85.225.27",25,3,186,3,186,0,0,92848.990161,8.906486000007135,167.06925716818148,0
"147.32.84.165",3737,"46.4.36.120",443,6,366,3,186,3,180,92859.602928,1.0321830000029877,1441.6048316971826,1395.1014500295314
"147.32.84.165",3781,"216.130.129.13",25,3,186,3,186,0,0,92860.506976,9.0325989999983,164.73663892311396,0
"147.32.84.165",3782,"74.6.136.244",25,3,186,3,186,0,0,92860.635316,9.004879000000074,165.2437528588655,0
"147.32.84.165",3784,"205.188.103.2",25,3,186,3,186,0,0,92860.635375,9.00494100000651,165.2426151375033,0
"147.32.84.165",3737,"46.4.36.120",443,6,366,3,186,3,180,92869.440194,1.0303960000019288,1444.1049848768964,1397.5209531066741
"147.32.84.165",3785,"205.188.59.194",25,3,186,3,186,0,0,92869.539709,9.033911999998963,164.71269589521913,0
"147.32.84.165",3786,"94.245.120.86",25,3,186,3,186,0,0,92869.640376,9.033990000010817,164.71127375591718,0
"147.32.84.165",3788,"207.172.157.50",25,3,186,3,186,0,0,92869.64043,9.034060000005411,164.70999749825756,0
"147.32.84.165",3789,"98.139.175.224",25,3,186,3,186,0,0,92869.64049,9.034048000001349,164.71021628397125,0
"147.32.84.165",3791,"98.139.54.60",25,3,186,3,186,0,0,92869.640543,9.034039000005578,164.71038037350527,0
"147.32.84.165",3793,"98.129.185.3",25,3,186,3,186,0,0,92869.740594,9.034184999996796,164.70771851589575,0
"147.32.84.165",3796,"64.12.90.97",25,3,186,3,186,0,0,92869.740737,9.034134000001359,164.70864833306393,0
"147.32.84.165",3801,"65.55.37.88",25,3,186,3,186,0,0,92869.841188,9.033300999988569,164.72383683460598,0
"147.32.84.165",3813,"80.12.242.15",25,3,186,3,186,0,0,92869.941264,9.03397699999914,164.71151077760567,0
"147.32.84.165",3817,"64.12.90.34",25,3,186,3,186,0,0,92870.470827,9.005593000008957,165.2306516626412,0
"147.32.84.165",3777,"201.160.226.207",6667,2,124,2,124,0,0,92881.483988,3.0095259999943664,329.6200132518732,0
"147.32.84.165",3756,"46.4.36.120",443,6,366,3,186,3,180,92881.584458,1.0308840000070632,1443.4213742669447,1396.8593944518818
"147.32.84.165",3821,"74.6.136.244",25,3,186,3,186,0,0,92882.615583,9.003960999994888,165.2606003070032,0
"147.32.84.165",3756,"46.4.36.120",443,6,366,3,186,3,180,92890.51648,1.0304139999934705,1444.0797582422495,1397.4965402344349
"147.32.84.165",3824,"64.12.90.98",25,3,186,3,186,0,0,92890.615956,9.030941000004532,164.76688309659573,0
"147.32.84.165",3777,"212.117.171.138",65500,9,544,5,302,4,242,92890.616088,179.22662800000398,13.480139792620248,10.801966323887749
"147.32.84.165",3826,"209.85.225.27",25,3,186,3,186,0,0,92890.638795,9.00822399999015,165.18239333320608,0
"147.32.84.165",3828,"98.139.175.224",25,3,186,3,186,0,0,92890.716766,9.031656000006478,164.7538391629323,0
"147.32.84.165",3829,"124.108.116.109",25,3,186,3,186,0,0,92890.716897,9.03165099999751,164.75393037224427,0
"147.32.84.165",3830,"64.12.90.33",25,3,186,3,186,0,0,92890.816775,9.031948000003467,164.74851272388068,0
"147.32.84.165",3831,"65.55.92.184",25,3,186,3,186,0,0,92890.917298,9.03205199999502,164.74661571930946,0
"147.32.84.165",3833,"218.102.53.148",25,3,186,3,186,0,0,92891.418881,9.031935999999405,164.74873161192662,0
"147.32.84.165",3835,"64.136.44.37",25,3,186,3,186,0,0,92891.547126,9.00337700000091,165.2713198614086,0
"147.32.84.165",3786,"46.4.36.120",443,6,366,3,186,3,180,92894.530574,1.0311910000018543,1442.9916475195423,1396.4435298576216
"147.32.84.165",3838,"64.12.90.66",25,3,186,3,186,0,0,92895.562039,9.002839000007953,165.28119629804394,0
"147.32.84.165",3813,"65.15.167.21",6667,1,62,1,62,0,0,92903.661956,0,0,0
"147.32.84.165",3817,"46.4.36.120",443,6,366,3,186,3,180,92911.590456,1.0302870000014082,1444.2577650673709,1397.6688049039071
"147.32.84.165",3839,"74.6.136.244",25,3,186,3,186,0,0,92911.590586,9.029255999994348,164.79763116705647,0
"147.32.84.165",3840,"66.96.142.52",25,3,186,3,186,0,0,92911.690009,9.02978900000744,164.7879036817775,0
"147.32.84.165",3844,"194.109.24.134",25,3,186,3,186,0,0,92911.69014,9.02978099999018,164.7880496771315,0
"147.32.84.165",3851,"65.55.92.136",25,3,186,3,186,0,0,92911.791045,9.029492999994545,164.79330567075016,0
"147.32.84.165",3855,"98.139.175.224",25,3,186,3,186,0,0,92911.891287,9.029876000000513,164.78631600255812,0
"147.32.84.165",3858,"205.188.190.1",25,3,186,3,186,0,0,92912.392981,9.030547000002116,164.77407182528935,0
"147.32.84.165",3860,"205.188.59.193",25,3,186,3,186,0,0,92912.494076,9.029366000002483,164.79562352435275,0
"147.32.84.165",3861,"209.85.225.27",25,3,186,3,186,0,0,92912.620993,9.003242999999202,165.2737796814028,0
"147.32.84.165",3826,"46.4.36.120",443,6,366,3,186,3,180,92915.603016,1.0305179999995744,1443.9340215315158,1397.3555047079185
"147.32.84.165",3865,"64.12.90.34",25,3,186,3,186,0,0,92916.505616,9.031988000002457,164.74778310152706,0
"147.32.84.165",3831,"61.177.181.139",6667,3,186,3,186,0,0,92916.633773,9.004521000009845,165.25032258777264,0
"147.32.84.165",3826,"46.4.36.120",443,6,366,3,186,3,180,92932.662624,1.030522999993991,1443.9270157082146,1397.3487248789174
"147.32.84.165",3866,"205.188.146.193",25,3,186,3,186,0,0,92932.763125,9.031585999997333,164.7551161003659,0
"147.32.84.165",3872,"209.85.225.27",25,3,186,3,186,0,0,92932.763258,9.03157699998701,164.7552802796389,0
"147.32.84.165",3874,"94.245.120.86",25,3,186,3,186,0,0,92932.763311,9.03158500000427,164.75513434234372,0
"147.32.84.165",3876,"68.6.19.3",25,3,186,3,186,0,0,92932.863362,9.031579000002239,164.75524379509176,0
"147.32.84.165",3879,"74.6.136.244",25,3,186,3,186,0,0,92932.963204,9.031965000001946,164.74820263361067,0
"147.32.84.165",3881,"209.191.88.254",25,3,186,3,186,0,0,92933.465235,8.931472000011127,166.6018770476072,0
"147.32.84.165",3888,"193.200.87.21",25,3,186,3,186,0,0,92933.565229,8.93169399999897,166.597736106966,0
"147.32.84.165",3889,"206.46.232.11",25,3,186,3,186,0,0,92933.665892,8.931228999994346,166.60640993540105,0
"147.32.84.165",3890,"205.188.59.193",25,3,186,3,186,0,0,92933.693392,8.903837000005296,167.11896230794824,0
"147.32.84.165",3840,"46.4.36.120",443,6,366,3,186,3,180,92936.675158,1.0306350000028033,1443.770102893801,1397.1968737681946
"147.32.84.165",3892,"64.12.90.66",25,3,186,3,186,0,0,92937.577719,8.931414000006043,166.60295894905255,0
"147.32.84.165",3851,"74.115.3.63",6667,3,186,3,186,0,0,92937.706053,8.903363000004902,167.12785943908844,0
"147.32.84.165",3861,"46.4.36.120",443,6,366,3,186,3,180,92953.735465,1.0314890000008745,1442.5747632778812,1396.0400934947238
"147.32.84.165",3893,"199.217.10.203",25,3,186,3,186,0,0,92953.735607,9.033542000004672,164.71944227405268,0
"147.32.84.165",3894,"98.139.175.224",25,3,186,3,186,0,0,92953.93596,9.03414000000339,164.70853894221716,0
"147.32.84.165",3896,"74.6.136.244",25,3,186,3,186,0,0,92954.036722,9.033375999992131,164.722469207669,0
"147.32.84.165",3899,"209.85.225.27",25,3,186,3,186,0,0,92954.43802,9.033423000000766,164.72161217291315,0
"147.32.84.165",3912,"65.55.92.136",25,3,186,3,186,0,0,92954.538774,9.033144000000902,164.7266998068282,0
"147.32.84.165",3913,"205.188.156.193",25,3,186,3,186,0,0,92954.638101,9.034492999999202,164.70210337205768,0
"147.32.84.165",3914,"64.12.90.33",25,3,186,3,186,0,0,92954.63824,9.034509999997681,164.7017934564666,0
"147.32.84.165",3922,"64.12.90.66",25,3,186,3,186,0,0,92954.767164,9.005485999994562,165.2326148750771,0
"147.32.84.165",3930,"65.55.92.184",25,3,186,3,186,0,0,92954.767238,9.005541000005906,165.2316057412902,0
"147.32.84.165",3876,"46.4.36.120",443,6,366,3,186,3,180,92957.751431,1.031663000001572,1442.3314590110651,1395.8046377526437
"147.32.84.165",3931,"65.55.92.136",25,3,186,3,186,0,0,92958.554264,9.033365999988746,164.7226515566682,0
"147.32.84.165",3889,"221.226.242.228",6667,3,186,3,186,0,0,92958.554351,9.033400000000256,164.72203157171805,0
"147.32.84.165",3932,"218.102.53.137",25,3,186,3,186,0,0,92958.783381,9.004130999994231,165.25748015005038,0
"147.32.84.165",3876,"46.4.36.120",443,6,366,3,186,3,180,92974.71214,1.0304449999966891,1444.0363144124926,1397.4544978185413
"147.32.84.165",3934,"98.139.175.224",25,3,186,3,186,0,0,92974.911766,9.032389999993029,164.74045075568574,0
"147.32.84.165",3939,"205.188.59.193",25,3,186,3,186,0,0,92975.012251,9.032121000011102,164.74535715344945,0
"147.32.84.165",3953,"199.239.254.18",25,3,186,3,186,0,0,92975.413946,9.03127599999425,164.76077134625797,0
"147.32.84.165",3954,"209.85.225.27",25,3,186,3,186,0,0,92975.514327,9.031553000007989,164.75571809174832,0
"147.32.84.165",3955,"199.191.107.186",25,3,186,3,186,0,0,92975.614406,9.0319690000033,164.7481296713326,0
"147.32.84.165",3958,"74.6.136.244",25,3,186,3,186,0,0,92975.614537,9.031959999992978,164.74829383668182,0
"147.32.84.165",3961,"64.12.90.34",25,3,186,3,186,0,0,92975.715339,9.031296999994083,164.76038823670342,0
"147.32.84.165",3962,"64.12.90.1",25,3,186,3,186,0,0,92975.742874,9.003914999993867,165.26144460504275,0
"147.32.84.165",3922,"173.192.170.88",80,9,3983,5,523,4,3460,92978.82771,0.7995930000033695,5232.662116829898,34617.61170981156
"147.32.84.165",3894,"46.4.36.120",443,6,366,3,186,3,180,92979.028419,1.0313390000083018,1442.784574216647,1396.2431363386904
"147.32.84.165",3964,"66.210.173.30",25,3,186,3,186,0,0,92979.730645,9.036593999990146,164.66381028091143,0
"147.32.84.165",3967,"204.127.208.75",25,3,186,3,186,0,0,92980.060007,9.008552000013879,165.17637906710286,0
"147.32.84.165",3931,"46.4.36.120",443,6,366,3,186,3,180,92995.992387,1.0309679999918444,1443.3037688965817,1396.7455828031436
"147.32.84.165",3975,"64.12.90.33",25,3,186,3,186,0,0,92996.09327,8.930521000002045,166.61961827307266,0
"147.32.84.165",3979,"94.245.120.86",25,3,186,3,186,0,0,92996.494254,8.930993999994826,166.61079382662916,0
"147.32.84.165",3997,"207.250.230.21",25,3,186,3,186,0,0,92996.594071,8.931429000003845,166.60267914567302,0
"147.32.84.165",4002,"74.6.136.244",25,3,186,3,186,0,0,92996.694427,8.931970000005094,166.59258819713358,0
"147.32.84.165",4004,"155.230.10.252",25,3,186,3,186,0,0,92996.694554,8.931979000000865,166.59242033594748,0
"147.32.84.165",4008,"205.188.146.194",25,3,186,3,186,0,0,92996.694613,8.931981999994605,166.59236438238443,0
"147.32.84.165",4012,"65.55.92.184",25,3,186,3,186,0,0,92996.795124,8.931530000001658,166.6007951604847,0
"147.32.84.165",4016,"207.115.36.21",25,3,186,3,186,0,0,92996.79526,8.931536000003689,166.600683241873,0
"147.32.84.165",4017,"204.127.208.75",25,3,186,3,186,0,0,92997.023606,8.903428999998141,167.1266205414016,0
"147.32.84.165",4027,"205.188.59.194",25,3,186,3,186,0,0,92997.023665,8.903504999994766,167.1251939546139,0
"147.32.84.165",3954,"68.41.173.2",6667,3,186,3,186,0,0,93000.808098,8.93141900000046,166.60286568124542,0
"147.32.84.165",3939,"46.4.36.120",443,6,366,3,186,3,180,93001.108392,1.031596000000718,1442.4251354202268,1395.895292342155
"147.32.84.165",4028,"65.54.188.126",25,3,186,3,186,0,0,93002.140247,9.004644000000553,165.24806533161205,0
"147.32.84.165",3967,"46.4.36.120",443,6,366,3,186,3,180,93017.063451,1.0308290000102716,1443.4983881760922,1396.9339240413797
"147.32.84.165",4032,"209.85.225.27",25,3,186,3,186,0,0,93017.464431,9.031216000003042,164.76186595465094,0
"147.32.84.165",4034,"78.67.174.222",25,3,186,3,186,0,0,93017.565184,9.03077499999199,164.7699117740526,0
"147.32.84.165",4036,"205.188.59.193",25,3,186,3,186,0,0,93017.665823,9.030151999992086,164.7812794293279,0
"147.32.84.165",4037,"205.188.146.194",25,3,186,3,186,0,0,93017.665929,9.03018100000918,164.7807502417158,0
"147.32.84.165",4041,"68.1.17.3",25,3,186,3,186,0,0,93017.76592,9.032000999999582,164.74754597570006,0
"147.32.84.165",4043,"74.6.136.244",25,3,186,3,186,0,0,93017.766058,9.032003000000259,164.74750949484377,0
"147.32.84.165",4044,"94.245.120.86",25,3,186,3,186,0,0,93017.966736,9.031864999997197,164.75002671103496,0
"147.32.84.165",4047,"76.96.62.116",25,3,186,3,186,0,0,93018.094478,9.004149000000325,165.25714978727544,0
"147.32.84.165",4002,"210.212.164.162",6667,6,366,3,186,3,180,93019.972899,4.002126999999746,371.80229413011995,359.80867173882575
"147.32.84.165",3997,"46.4.36.120",443,6,366,3,186,3,180,93023.184059,1.0331069999956526,1440.3154755569963,1393.8536860228996
"147.32.84.165",4068,"68.6.19.3",25,3,186,3,186,0,0,93023.975265,8.843588999996427,168.25748007970532,0
"147.32.84.165",4077,"205.188.146.193",25,3,186,3,186,0,0,93024.217407,8.902151999995112,167.1505945978924,0
"147.32.84.165",3997,"46.4.36.120",443,6,366,3,186,3,180,93038.437486,1.0308470000018133,1443.473182729719,1396.9095316739215
"147.32.84.165",4087,"205.188.59.193",25,3,186,3,186,0,0,93038.538119,9.029601000002003,164.79133463368646,0
"147.32.84.165",4089,"209.63.234.36",25,3,186,3,186,0,0,93038.53825,9.029592999999295,164.79148063485434,0
"147.32.84.165",4093,"72.14.213.27",25,3,186,3,186,0,0,93038.638591,9.029664000001503,164.7901848839284,0
"147.32.84.165",4096,"74.6.136.244",25,3,186,3,186,0,0,93038.638723,9.02965700000641,164.7903126330207,0
"147.32.84.165",4097,"66.94.237.64",25,3,186,3,186,0,0,93038.63878,9.029650000011316,164.7904403823111,0
"147.32.84.165",4107,"205.188.146.194",25,3,186,3,186,0,0,93038.738778,9.029676000005566,164.78996588571758,0
"147.32.84.165",4111,"192.217.192.252",25,3,186,3,186,0,0,93038.738859,9.029719999991357,164.7891628977891,0
"147.32.84.165",4112,"64.12.90.65",25,3,186,3,186,0,0,93038.940193,9.028951999993296,164.8031798154542,0
"147.32.84.165",4114,"209.85.225.27",25,3,186,3,186,0,0,93039.039796,9.02978900000744,164.7879036817775,0
"147.32.84.165",4116,"76.96.30.116",25,3,186,3,186,0,0,93039.46856,9.002183000004152,165.29324053946846,0
"147.32.84.165",4044,"115.97.135.112",6667,3,186,3,186,0,0,93044.858047,9.033624000003329,164.71794708297043,0
"147.32.84.165",4034,"46.4.36.120",443,6,366,3,186,3,180,93045.159034,1.0307230000034906,1443.646838185391,1397.077585340701
"147.32.84.165",4119,"68.6.19.3",25,3,186,3,186,0,0,93046.189994,9.007471999997506,165.19618379056988,0
"147.32.84.165",4034,"46.4.36.120",443,6,366,3,186,3,180,93059.610866,1.0312459999986459,1442.9146876709863,1396.3690525848253
"147.32.84.165",4044,"184.82.148.43",80,10,1925,5,987,5,938,93059.71159,0.3245609999867156,24328.246463140014,23120.4611777359
"147.32.84.165",4120,"74.6.136.244",25,3,186,3,186,0,0,93059.711724,8.929705000002286,166.634844040158,0
"147.32.84.165",4126,"65.55.92.184",25,3,186,3,186,0,0,93059.812089,8.929103000002215,166.64607855902557,0
"147.32.84.165",4132,"205.188.146.193",25,3,186,3,186,0,0,93059.812222,8.929048000005423,166.64710504401995,0
"147.32.84.165",4140,"85.158.140.195",25,3,186,3,186,0,0,93059.818477,8.922822000007727,166.76338494690484,0
"147.32.84.165",4087,"184.82.148.44",80,10,1512,5,594,5,918,93060.012871,0.30504400000791065,15578.080538796918,24075.215378140692
"147.32.84.165",4142,"98.139.175.224",25,3,186,3,186,0,0,93060.113284,8.929466999994474,166.63928541321903,0
"147.32.84.165",4144,"66.39.2.32",25,3,186,3,186,0,0,93060.11353,8.929342999996152,166.64159949960947,0
"147.32.84.165",4089,"217.163.21.37",80,13,6081,6,750,7,5331,93060.514422,0.1866590000136057,32144.17734779816,228480.8125881493
"147.32.84.165",4149,"205.188.146.194",25,3,186,3,186,0,0,93060.560355,8.88323200000741,167.5066012008646,0
"147.32.84.165",4161,"76.96.30.116",25,3,186,3,186,0,0,93060.642348,8.901474000012968,167.16332598374518,0
"147.32.84.165",4097,"46.4.36.120",443,6,366,3,186,3,180,93064.627264,1.0307450000109384,1443.6160252867676,1397.0477664065493
"147.32.84.165",4093,"217.163.21.37",80,10,1451,5,701,5,750,93065.658243,0.1390019999962533,40344.743242191915,43164.846550133996
"147.32.84.165",4162,"89.111.177.200",25,3,186,3,186,0,0,93065.704062,8.957840999995824,166.1114547579817,0
"147.32.84.165",4087,"41.239.162.145",6667,2,124,2,124,0,0,93067.135083,3.011704999997164,329.38152973180775,0
"147.32.84.165",4097,"46.4.36.120",443,6,366,3,186,3,180,93080.680712,1.0304749999922933,1443.9942744958669,1397.4138140282582
"147.32.84.165",4112,"217.163.21.34",80,11,3445,6,1330,5,2115,93080.780749,0.25655900000128895,41471.94212616414,65949.74255401289
"147.32.84.165",4165,"209.85.225.27",25,3,186,3,186,0,0,93080.780884,9.02973499998916,164.78888915364476,0
"147.32.84.165",3777,"212.117.171.138",65500,14,861,8,486,6,375,93080.780943,5.113132999991649,760.3948498907324,586.7244212119849
"147.32.84.165",4119,"184.82.155.107",80,10,1908,5,977,5,931,93080.803668,0.3221030000131577,24265.529969235682,23123.038281840756
"147.32.84.165",4171,"205.188.159.42",25,3,186,3,186,0,0,93080.829101,8.981639999998151,165.67130279106112,0
"147.32.84.165",4184,"205.188.59.193",25,3,186,3,186,0,0,93080.910109,9.000889999995707,165.3169853204194,0
"147.32.84.165",4120,"195.113.232.96",80,16,4855,10,2465,6,2390,93081.081565,81.52119899999525,241.9002694011057,234.54022063636617
"147.32.84.165",4185,"98.139.175.224",25,3,186,3,186,0,0,93081.081696,9.029558000009274,164.79211939260722,0
"147.32.84.165",4126,"184.82.155.108",80,10,1510,5,599,5,911,93081.082397,0.34184699998877477,14017.967102701954,21319.47918290731
"147.32.84.165",4186,"74.6.136.244",25,3,186,3,186,0,0,93081.195312,9.01662400001078,165.02850734357128,0
"147.32.84.165",4132,"195.113.232.89",80,11,3337,7,1601,4,1736,93081.484063,81.11849000000802,157.89248542470074,171.2063427215993
"147.32.84.165",4187,"94.245.120.86",25,3,186,3,186,0,0,93081.485159,9.027835000000778,164.82357065673796,0
"147.32.84.165",4140,"217.163.21.37",80,13,6077,6,749,7,5328,93081.582942,0.18765000000712462,31931.78790179855,227146.2829649969
"147.32.84.165",4188,"213.228.128.59",25,3,186,3,186,0,0,93081.628856,8.984923000010895,165.61076817221425,0
"147.32.84.165",4190,"65.55.92.136",25,3,186,3,186,0,0,93081.711432,9.002231999998912,165.29234083282677,0
"147.32.84.165",4119,"46.4.36.120",443,6,366,3,186,3,180,93085.696532,1.0302099999971688,1444.3657118491271,1397.7732695314135
"147.32.84.165",4112,"217.163.21.37",80,10,1448,5,699,5,749,93086.699413,0.13963400000648107,40047.552886406236,42912.1847094682
"147.32.84.165",4193,"216.99.131.21",25,3,186,3,186,0,0,93086.727031,8.901828999994905,167.15665960341988,0
"147.32.84.165",4149,"212.117.171.138",65500,9,544,5,302,4,242,93086.74523,26.482155999998213,91.23124265260589,73.1058302050683
"147.32.84.165",4194,"209.249.12.184",25,3,186,3,186,0,0,93086.768283,8.860729000007268,167.93200649729604,0
"147.32.84.165",3777,"109.86.117.4",6667,3,186,3,186,0,0,93101.751438,9.032353999995394,164.74110735703658,0
"147.32.84.165",4162,"217.163.21.34",80,9,2842,5,1264,4,1578,93101.751581,0.25851099999272265,39116.3238712653,48833.5119215638
"147.32.84.165",4195,"65.55.92.168",25,3,186,3,186,0,0,93101.797526,8.986390999998548,165.5837143075836,0
"147.32.84.165",4204,"193.109.255.147",25,3,186,3,186,0,0,93101.852044,9.03175700000429,164.75199675979914,0
"147.32.84.165",4165,"217.163.21.37",80,10,2274,5,1154,5,1120,93102.052564,0.1414199999999255,65280.724084322326,63357.37519448961
"147.32.84.165",4216,"216.195.70.217",25,3,186,3,186,0,0,93102.098626,8.985900999992737,165.59274356585976,0
"147.32.84.165",4171,"217.163.21.34",80,11,4019,6,1779,5,2240,93102.152901,0.15875900001265109,89645.3114397665,112875.49051437715
"147.32.84.165",4219,"205.188.156.193",25,3,186,3,186,0,0,93102.19899,8.98592199999257,165.59235657745865,0
"147.32.84.165",4162,"173.241.240.4",80,9,2194,5,1164,4,1030,93102.454449,0.06798600000911392,136969.37602964832,121201.42380630394
"147.32.84.165",4220,"74.6.136.244",25,3,186,3,186,0,0,93102.471009,9.01499799999874,165.0582728914868,0
"147.32.84.165",4165,"92.240.244.181",80,10,1758,6,1364,4,394,93102.554058,5.019056000004639,2174.114016657697,628.0065414685723
"147.32.84.165",4226,"64.12.90.66",25,3,186,3,186,0,0,93102.562637,9.023568000004161,164.90151124248345,0
"147.32.84.165",4235,"68.6.19.3",25,3,186,3,186,0,0,93102.654711,9.0323580000113,164.74103440077758,0
"147.32.84.165",4184,"46.4.36.120",443,6,366,3,186,3,180,93107.672778,1.0302190000074916,1444.35309384624,1397.7610585608775
"147.32.84.165",4236,"65.54.188.94",25,3,186,3,186,0,0,93107.67291,9.030590000009397,164.7732872379824,0
"147.32.84.165",4237,"209.85.143.27",25,3,186,3,186,0,0,93108.70325,9.002960999991046,165.27895655679058,0
"147.32.84.165",4149,"212.117.171.138",65500,9,544,5,302,4,242,93122.827201,51.672200000000885,46.7562828755106,37.46695515189922
"147.32.84.165",4193,"46.4.36.120",443,6,366,3,186,3,180,93122.827387,1.0303950000088662,1444.1063863733775,1397.522309393591
"147.32.84.165",4238,"216.82.250.179",25,3,186,3,186,0,0,93122.849765,8.907784999988507,167.04489387675162,0
"147.32.84.165",4194,"94.100.176.20",25,3,186,3,186,0,0,93122.927102,8.93095500000345,166.61152138818582,0
"147.32.84.165",4241,"199.217.10.203",25,3,186,3,186,0,0,93123.128052,8.930554999999003,166.61898392654948,0
"147.32.84.165",4243,"65.55.37.120",25,3,186,3,186,0,0,93123.228025,8.93091499998991,166.61226761218546,0
"147.32.84.165",4245,"74.6.136.244",25,3,186,3,186,0,0,93123.52913,8.930577999999514,166.61855481247474,0
"147.32.84.165",4251,"205.188.146.194",25,3,186,3,186,0,0,93123.629362,8.930719999989378,166.61590554868698,0
"147.32.84.165",4253,"205.188.59.194",25,3,186,3,186,0,0,93123.729884,8.930928000001586,166.61202508851665,0
"147.32.84.165",4258,"209.85.143.27",25,3,186,3,186,0,0,93123.858003,8.902734999996028,167.13964865860478,0
"147.32.84.165",4259,"65.55.92.168",25,3,186,3,186,0,0,93123.858076,8.902728999993997,167.13976130251785,0
"147.32.84.165",4219,"46.4.36.120",443,6,366,3,186,3,180,93128.646484,1.0312940000003437,1442.8475294140217,1396.304060723247
"147.32.84.165",4262,"205.188.59.193",25,3,186,3,186,0,0,93129.650508,9.028740999987349,164.80703123526138,0
"147.32.84.165",4268,"67.69.240.17",25,3,186,3,186,0,0,93129.678007,9.00135500000033,165.30844522851785,0
"147.32.84.165",4237,"46.4.36.120",443,6,366,3,186,3,180,93143.799844,1.0313440000027185,1442.7775795428856,1396.2363672995666
"147.32.84.165",4269,"98.139.175.224",25,3,186,3,186,0,0,93143.900503,9.032243000008748,164.7431319107069,0
"147.32.84.165",4238,"74.125.93.27",25,3,186,3,186,0,0,93144.100951,9.03274500000407,164.73397621645796,0
"147.32.84.165",4270,"74.6.136.244",25,3,186,3,186,0,0,93144.200644,9.033314000000246,164.72359977744154,0
"147.32.84.165",4271,"194.177.33.227",25,3,186,3,186,0,0,93144.200771,9.033307999998215,164.7237091882945,0
"147.32.84.165",4273,"68.6.19.3",25,3,186,3,186,0,0,93144.501926,9.032787000003736,164.73321024833027,0
"147.32.84.165",4274,"68.1.17.3",25,3,186,3,186,0,0,93144.602568,9.032685999991372,164.73505223157557,0
"147.32.84.165",4277,"64.12.90.98",25,3,186,3,186,0,0,93144.702738,9.033250999986194,164.72474859851388,0
"147.32.84.165",4278,"205.188.190.2",25,3,186,3,186,0,0,93144.803843,9.031604000003426,164.75478774306706,0
"147.32.84.165",4282,"98.139.175.224",25,3,186,3,186,0,0,93144.831412,9.004094000003533,165.2581592328352,0
"147.32.84.165",4284,"74.6.136.244",25,3,186,3,186,0,0,93144.831442,9.004088000001502,165.25826935495874,0
"147.32.84.165",4259,"84.25.41.150",6667,2,124,2,124,0,0,93150.725047,3.0108170000021346,329.4786763856112,0
"147.32.84.165",4251,"46.4.36.120",443,6,366,3,186,3,180,93150.725182,1.0307920000050217,1443.550202167606,1396.9840666138123
"147.32.84.165",4287,"205.188.146.194",25,3,186,3,186,0,0,93151.756206,8.904670999996597,167.10331016166333,0
"147.32.84.165",4251,"46.4.36.120",443,6,366,3,186,3,180,93164.876216,1.030388999992283,1444.114795490969,1397.5304472493249
"147.32.84.165",4289,"68.1.17.3",25,3,186,3,186,0,0,93165.076419,9.030856999990647,164.76841566659078,0
"147.32.84.165",4291,"64.251.10.158",25,3,186,3,186,0,0,93165.076546,9.030855000004522,164.7684521564409,0
"147.32.84.165",4269,"74.125.39.27",25,3,186,3,186,0,0,93165.177041,9.030570000002626,164.77365216144355,0
"147.32.84.165",4300,"205.188.146.194",25,3,186,3,186,0,0,93165.477593,9.030755999992834,164.77025843696592,0
"147.32.84.165",4312,"98.139.175.224",25,3,186,3,186,0,0,93165.47772,9.030750000005355,164.77036790954435,0
"147.32.84.165",4316,"207.115.21.20",25,3,186,3,186,0,0,93165.578353,9.031005999990157,164.76569719936205,0
"147.32.84.165",4322,"74.6.136.244",25,3,186,3,186,0,0,93165.679122,9.030104999998002,164.7821370848212,0
"147.32.84.165",4334,"74.6.136.244",25,3,186,3,186,0,0,93165.679246,9.03011599999445,164.7819363561791,0
"147.32.84.165",4340,"205.188.190.2",25,3,186,3,186,0,0,93165.679299,9.030112000007648,164.78200934813873,0
"147.32.84.165",4348,"76.96.62.116",25,3,186,3,186,0,0,93165.679348,9.03010699999868,164.7821005886439,0
"147.32.84.165",4349,"205.235.52.11",25,3,186,3,186,0,0,93165.779272,9.03066299999773,164.77195528173004,0
"147.32.84.165",4358,"67.215.65.132",25,3,186,3,186,0,0,93165.779409,9.030650000000605,164.77219247782833,0
"147.32.84.165",4359,"205.188.103.2",25,3,186,3,186,0,0,93165.906813,9.00346000000718,165.26979627818787,0
"147.32.84.165",4271,"46.4.36.120",443,6,366,3,186,3,180,93167.986831,1.0304769999929704,1443.9914719204316,1397.4111018584822
"147.32.84.165",4366,"98.139.175.224",25,3,186,3,186,0,0,93169.017552,9.002591999989818,165.28573104297996,0
"147.32.84.165",4251,"24.14.193.250",6667,3,186,3,186,0,0,93169.017612,9.00265500000387,165.28457438381903,0
"147.32.84.165",4277,"46.4.36.120",443,6,366,3,186,3,180,93172.70299,1.0309439999982715,1443.3373684724825,1396.778098521757
"147.32.84.165",4369,"74.6.136.244",25,3,186,3,186,0,0,93173.734212,9.001765000008163,165.30091598688153,0
"147.32.84.165",4149,"212.117.171.138",65500,9,544,5,302,4,242,93186.148069,99.86561999999685,24.19250989479739,19.38605097530122
"147.32.84.165",4277,"46.4.36.120",443,6,366,3,186,3,180,93186.170642,1.0081060000084108,1476.0352581847399,1428.4212175981354
"147.32.84.165",4373,"205.188.59.193",25,3,186,3,186,0,0,93186.248693,8.930984999999055,166.61096172484417,0
"147.32.84.165",4269,"216.157.130.15",25,3,186,3,186,0,0,93186.548802,8.931387999997241,166.60344394403867,0
"147.32.84.165",4378,"165.21.74.118",25,3,186,3,186,0,0,93186.649484,8.931713000012678,166.597381711424,0
"147.32.84.165",4382,"77.238.184.241",25,3,186,3,186,0,0,93186.749524,8.931767999994918,166.59635583916273,0
"147.32.84.165",4386,"205.188.159.42",25,3,186,3,186,0,0,93186.850149,8.931178999991971,166.60734265894095,0
"147.32.84.165",4389,"64.12.138.161",25,3,186,3,186,0,0,93186.850281,8.931170999989263,166.60749189571993,0
"147.32.84.165",4391,"205.188.156.193",25,3,186,3,186,0,0,93186.950575,8.931354000000283,166.6040781722405,0
"147.32.84.165",4399,"204.127.217.16",25,3,186,3,186,0,0,93187.179004,8.90365799999563,167.12232208388173,0
"147.32.84.165",4312,"122.127.64.127",6667,3,186,3,186,0,0,93189.058481,9.030627000000095,164.77261213423878,0
"147.32.84.165",4291,"46.4.36.120",443,6,366,3,186,3,180,93194.67793,1.0309389999893028,1443.3443685954646,1396.7848728343206
"147.32.84.165",4402,"68.1.17.3",25,3,186,3,186,0,0,93195.709214,9.002074999996694,165.29522360128598,0
"147.32.84.165",4291,"46.4.36.120",443,6,366,3,186,3,180,93207.219779,1.0305479999951785,1443.8919875706533,1397.3148266812775
"147.32.84.165",4312,"184.82.155.107",80,10,1916,5,985,5,931,93207.521122,0.30444599999464117,25883.079429976755,24464.10857797803
"147.32.84.165",4406,"74.6.136.244",25,3,186,3,186,0,0,93207.620987,9.03080599999521,164.76934616918905,0
"147.32.84.165",4407,"68.6.19.3",25,3,186,3,186,0,0,93207.621485,9.030435000007856,164.77611543615623,0
"147.32.84.165",4409,"64.18.5.10",25,3,186,3,186,0,0,93207.723501,9.02868099999614,164.80812645840916,0
"147.32.84.165",4269,"184.82.155.108",80,10,1510,5,599,5,911,93207.822277,0.3251659999950789,14737.08813366872,22413.16742866812
"147.32.84.165",4416,"74.125.93.27",25,3,186,3,186,0,0,93207.822451,9.030536000005668,164.7742725347716,0
"147.32.84.165",4417,"74.6.136.244",25,3,186,3,186,0,0,93207.922542,9.030400999996345,164.77673582829846,0
"147.32.84.165",4423,"204.127.217.16",25,3,186,3,186,0,0,93207.922709,9.030335999996169,164.7779218847041,0
"147.32.84.165",4424,"98.139.175.224",25,3,186,3,186,0,0,93207.922779,9.030289999995148,164.77876125803263,0
"147.32.84.165",4435,"65.55.37.88",25,3,186,3,186,0,0,93207.929006,9.02408399998967,164.89208212176473,0
"147.32.84.165",4373,"217.163.21.37",80,14,6134,7,809,7,5325,93208.123627,0.18888600000354927,34264.0534495854,225532.8610865788
"147.32.84.165",4437,"64.12.90.97",25,3,186,3,186,0,0,93208.169499,8.984349999998813,165.6213304245935,0
"147.32.84.165",4438,"66.94.238.147",25,3,186,3,186,0,0,93208.250576,9.003165999994962,165.27519319324253,0
"147.32.84.165",4269,"46.4.36.120",443,6,366,3,186,3,180,93209.627962,1.032271000003675,1441.4819364243522,1394.9825191203408
"147.32.84.165",4378,"217.163.21.37",80,10,1446,5,698,5,748,93210.660377,0.13904500000353437,40159.66054053048,43036.42705489513
"147.32.84.165",4442,"209.85.225.27",25,3,186,3,186,0,0,93210.706263,8.85753900000418,167.99248640048864,0
"147.32.84.165",4373,"80.98.191.57",6667,2,124,2,124,0,0,93216.752331,2.911321000006865,340.7387917710417,0
"147.32.84.165",4269,"46.4.36.120",443,6,366,3,186,3,180,93228.595593,1.0315669999981765,1442.465685702073,1395.9345345503932
"147.32.84.165",4391,"217.163.21.34",80,11,3491,6,1338,5,2153,93228.595727,0.23609299999952782,45338.06593173626,72954.30190659802
"147.32.84.165",4444,"205.188.146.193",25,3,186,3,186,0,0,93228.641714,8.989006000003428,165.53554419692594,0
"147.32.84.165",4445,"74.6.136.244",25,3,186,3,186,0,0,93228.695238,9.036638000005041,164.66300852144016,0
"147.32.84.165",4446,"67.231.144.94",25,3,186,3,186,0,0,93228.79599,9.035581999996793,164.6822528975475,0
"147.32.84.165",4406,"195.113.232.88",80,8,1261,5,815,3,446,93228.896555,62.13848300000245,104.92692587940621,57.42013367142965
"147.32.84.165",4447,"208.97.132.226",25,3,186,3,186,0,0,93228.896685,9.035510000001523,164.68356517780947,0
"147.32.84.165",4449,"207.115.21.24",25,3,186,3,186,0,0,93228.89736,9.034956000003149,164.69366314561813,0
"147.32.84.165",4453,"205.188.156.193",25,3,186,3,186,0,0,93229.097122,9.035482999999658,164.68405728836592,0
"147.32.84.165",4454,"205.188.146.194",25,3,186,3,186,0,0,93229.197543,9.035112999990815,164.690801321634,0
"147.32.84.165",4455,"65.55.88.22",25,3,186,3,186,0,0,93229.627458,9.006615999998758,165.21188424156256,0
"147.32.84.165",4416,"46.4.36.120",443,6,366,3,186,3,180,93230.704347,1.0300239999924088,1444.6265329846358,1398.0256770819055
"147.32.84.165",4457,"209.85.225.27",25,3,186,3,186,0,0,93231.606672,9.034840000007534,164.695777678272,0
"147.32.84.165",4423,"190.151.53.33",6667,6,366,3,186,3,180,93231.734638,1.9065249999985099,780.4775704494633,755.3008746285128
"147.32.84.165",4269,"46.4.36.120",443,6,366,3,186,3,180,93233.641397,1.005516000004718,1479.8372178990867,1432.100533450729
"147.32.84.165",4437,"184.82.148.43",80,10,1915,5,987,5,928,93234.647145,0.32461399999738205,24324.274369138977,22870.239731064812
"147.32.84.165",4458,"209.85.225.27",25,3,186,3,186,0,0,93234.753828,8.99659700000484,165.39587134993369,0
"147.32.84.165",4460,"64.71.138.82",25,3,186,3,186,0,0,93234.753893,8.996593999996549,165.39592650291553,0
"147.32.84.165",4269,"46.4.36.120",443,6,366,3,186,3,180,93249.669728,0.9302590000006603,1599.5545326612737,1547.9559993496198
"147.32.84.165",4423,"184.82.148.44",80,10,1315,5,588,5,727,93249.769901,0.3266289999883156,14401.660600155756,17806.134789648357
"147.32.84.165",4463,"205.188.159.42",25,3,186,3,186,0,0,93249.870142,9.031841999996686,164.7504462545454,0
"147.32.84.165",4464,"74.6.136.244",25,3,186,3,186,0,0,93249.870275,9.031832000007853,164.7506286652261,0
"147.32.84.165",4466,"205.188.103.2",25,3,186,3,186,0,0,93249.870333,9.03182299999753,164.75079283555567,0
"147.32.84.165",4467,"64.12.90.97",25,3,186,3,186,0,0,93249.877764,9.02443599999242,164.8856504718134,0
"147.32.84.165",4474,"208.89.132.27",25,3,186,3,186,0,0,93250.070946,9.031663999994635,164.7536932287211,0
"147.32.84.165",4475,"208.65.144.12",25,3,186,3,186,0,0,93250.171182,9.031359999993583,164.75923891872955,0
"147.32.84.165",4445,"93.184.220.20",80,13,6584,8,765,5,5819,93250.572647,6.332943000001251,966.3753487120903,7350.768828961638
"147.32.84.165",4476,"74.6.136.244",25,3,186,3,186,0,0,93250.589123,9.014926999996533,165.0595728618293,0
"147.32.84.165",4478,"209.85.225.27",25,3,186,3,186,0,0,93250.589162,9.015010999995866,165.05803487102594,0
"147.32.84.165",4479,"64.12.90.34",25,3,186,3,186,0,0,93250.58919,9.015033999996376,165.057613759482,0
"147.32.84.165",4481,"205.188.156.193",25,3,186,3,186,0,0,93250.600204,9.004069000002346,165.2586180758513,0
"147.32.84.165",4269,"46.4.36.120",443,6,366,3,186,3,180,93252.578547,1.0309870000055525,1443.2771703154222,1396.7198422407312
"147.32.84.165",4447,"195.113.232.73",80,8,3247,5,549,3,2698,93253.609752,62.43585399999574,70.34419678155278,345.69880312682955
"147.32.84.165",4484,"205.188.159.42",25,3,186,3,186,0,0,93253.6106,9.00495800000499,165.242303184443,0
"147.32.84.165",4449,"74.125.232.201",80,32,19844,16,4618,16,15226,93253.610676,62.43471699999645,591.7220702706493,1950.9658384454103
"147.32.84.165",4485,"74.6.136.244",25,3,186,3,186,0,0,93253.618878,8.996828000003006,165.39162469255862,0
"147.32.84.165",4423,"195.113.232.98",80,12,2399,7,1208,5,1191,93253.619011,62.426808999996865,154.80528565861,152.62673445314942
"147.32.84.165",4488,"205.188.103.2",25,3,186,3,186,0,0,93253.619128,8.996642999991309,165.39502567807097,0
"147.32.84.165",4453,"195.113.232.98",80,15,4066,9,1246,6,2820,93253.619198,67.42724400000589,147.83341878839258,334.58285793199605
"147.32.84.165",4489,"207.115.21.24",25,3,186,3,186,0,0,93253.619266,8.996572000003653,165.3963309579911,0
"147.32.84.165",4269,"46.4.36.120",443,6,366,3,186,3,180,93255.689893,1.0311320000037085,1443.074213577552,1396.5234324944051
"147.32.84.165",4454,"63.251.249.49",80,9,1324,5,563,4,761,93256.721247,0.5576670000009472,8076.504437222125,10916.909194895268
"147.32.84.165",4493,"205.188.190.2",25,3,186,3,186,0,0,93256.905017,9.020447000002605,164.95856580051634,0
"147.32.84.165",4269,"46.4.36.120",443,6,366,3,186,3,180,93270.943514,1.030480000001262,1443.987268067481,1397.4070336136913
"147.32.84.165",4457,"74.125.232.201",80,8,1457,5,951,3,506,93270.943622,60.107101999994484,126.57406108184517,67.34645100674412
"147.32.84.165",4494,"205.188.156.193",25,3,186,3,186,0,0,93270.943653,9.02947100000165,164.79370718392343,0
"147.32.84.165",4460,"46.137.9.143",80,8,1453,5,626,3,827,93270.94368,0.12568300000566524,39846.27992468561,52640.37299954473
"147.32.84.165",4496,"209.85.225.27",25,3,186,3,186,0,0,93270.943733,9.029519000003347,164.79283115739037,0
"147.32.84.165",4454,"95.172.94.64",80,8,1358,5,782,3,576,93270.943769,0.0548889999918174,113975.47779942458,83951.24707476798
"147.32.84.165",4499,"65.55.88.22",25,3,186,3,186,0,0,93270.96154,9.01176100000157,165.11756137338094,0
"147.32.84.165",4507,"65.55.88.22",25,3,186,3,186,0,0,93270.982268,8.991076999998768,165.497414825855,0
"147.32.84.165",4509,"207.115.21.24",25,3,186,3,186,0,0,93270.982299,8.991093999997247,165.49710191000736,0
"147.32.84.165",4510,"205.188.146.194",25,3,186,3,186,0,0,93270.982324,8.991116999997757,165.49667855510847,0
"147.32.84.165",4511,"205.188.159.42",25,3,186,3,186,0,0,93271.145073,9.028917999996338,164.803800411146,0
"147.32.84.165",4513,"64.12.90.97",25,3,186,3,186,0,0,93271.244399,9.029806999998982,164.78757519403987,0
"147.32.84.165",4514,"68.1.17.3",25,3,186,3,186,0,0,93271.645497,9.029641999994055,164.79058638215997,0
"147.32.84.165",4515,"207.115.21.24",25,3,186,3,186,0,0,93271.645627,9.029634999998962,164.79071413187478,0
"147.32.84.165",4517,"139.177.224.65",25,3,186,3,186,0,0,93271.645685,9.029627000010805,164.7908601316776,0
"147.32.84.165",4519,"68.1.17.3",25,3,186,3,186,0,0,93271.974104,9.002267000003485,165.29169819106943,0
"147.32.84.165",4521,"64.12.90.34",25,3,186,3,186,0,0,93271.974136,9.002334999997402,165.29044964450105,0
"147.32.84.165",4474,"89.37.108.104",6667,3,186,3,186,0,0,93274.655516,8.929329000005964,166.64186077128596,0
"147.32.84.165",4467,"46.4.36.120",443,6,366,3,186,3,180,93277.966704,1.0308959999965737,1443.404572337991,1396.8431345206366
"147.32.84.165",4484,"173.192.170.88",80,29,4787,14,1063,15,3724,93278.997813,58.50016000001051,145.36712378219943,509.26356440725374
"147.32.84.165",4527,"205.188.103.2",25,3,186,3,186,0,0,93279.198683,8.903040000004694,167.13392279482238,0
"147.32.84.165",4488,"173.192.170.88",80,17,4722,9,763,8,3959,93291.914274,40.0169220000098,152.53546986943437,791.4651706593587
"147.32.84.165",4485,"173.192.170.88",80,18,4310,9,763,9,3547,93291.914337,41.37841100001242,147.51653948234426,685.7682379343055
"147.32.84.165",4149,"212.117.171.138",65500,9,544,5,302,4,242,93291.914361,154.03197100000398,15.685055409697624,12.568819235585513
"147.32.84.165",4467,"46.4.36.120",443,6,366,3,186,3,180,93291.914391,1.030454000007012,1444.0237021641672,1397.442292416936
"147.32.84.165",4530,"98.136.59.15",25,3,186,3,186,0,0,93291.914422,9.028594000003068,164.80971455793608,0
"147.32.84.165",4538,"98.136.59.15",25,3,186,3,186,0,0,93291.937092,9.006045000001905,165.22235898218202,0
"147.32.84.165",4546,"98.139.214.154",25,3,186,3,186,0,0,93291.937123,9.006063000007998,165.22202875981196,0
"147.32.84.165",4549,"204.127.208.75",25,3,186,3,186,0,0,93292.114891,9.028639999989537,164.80887486949578,0
"147.32.84.165",4556,"204.127.208.75",25,3,186,3,186,0,0,93292.215371,9.028768000003765,164.80653838922203,0
"147.32.84.165",4560,"65.55.92.152",25,3,186,3,186,0,0,93292.215499,9.028760000001057,164.80668441733147,0
"147.32.84.165",4564,"67.195.168.31",25,3,186,3,186,0,0,93292.616294,9.02884999998787,164.8050416168171,0
"147.32.84.165",4566,"65.55.37.120",25,3,186,3,186,0,0,93292.616402,9.028791999997338,164.80610030671198,0
"147.32.84.165",4569,"67.195.168.31",25,3,186,3,186,0,0,93292.917532,9.028947999991942,164.8032528265007,0
"147.32.84.165",4572,"65.54.188.94",25,3,186,3,186,0,0,93292.917589,9.029014999992796,164.802029900403,0
"147.32.84.165",4573,"67.195.168.31",25,3,186,3,186,0,0,93292.945083,9.001569000000018,165.3045152461751,0
"147.32.84.165",4576,"128.121.85.2",25,3,186,3,186,0,0,93292.945143,9.001552999994601,165.30480907026737,0
"147.32.84.165",4510,"46.4.36.120",443,6,366,3,186,3,180,93294.421911,1.0309870000055525,1443.2771703154222,1396.7198422407312
"147.32.84.165",4509,"208.73.210.29",80,50,35658,22,3046,28,32612,93295.453136,18.519337999998243,1315.8137726090595,14087.760588419778
"147.32.84.165",4585,"207.115.21.24",25,3,186,3,186,0,0,93295.633024,9.023004000002402,164.91181872462917,0
"147.32.84.165",4511,"89.228.163.103",6667,6,366,3,186,3,180,93300.140724,1.0515180000074906,1415.0970311391723,1369.448739812102
"147.32.84.165",4514,"46.4.36.120",443,6,366,3,186,3,180,93301.192487,0.981686000013724,1515.759621690844,1466.8641500233973
"147.32.84.165",4515,"74.125.232.217",80,8,1906,5,1032,3,874,93302.174403,11.798309000005247,699.7612963007095,592.6272993864536
"147.32.84.165",4586,"67.195.168.31",25,3,186,3,186,0,0,93302.18262,8.995038999986718,165.4245190045532,0
"147.32.84.165",4589,"65.205.78.57",25,3,186,3,186,0,0,93302.182681,8.995100999993156,165.4233787926486,0
"147.32.84.165",4591,"207.115.21.24",25,3,186,3,186,0,0,93312.884505,9.030457000000752,164.77571400870147,0
"147.32.84.165",4593,"67.195.168.31",25,3,186,3,186,0,0,93312.884634,9.030457000000752,164.77571400870147,0
"147.32.84.165",4595,"168.61.70.72",25,3,186,3,186,0,0,93312.88469,9.03045099999872,164.77582348879483,0
"147.32.84.165",4602,"74.6.136.244",25,3,186,3,186,0,0,93312.884748,9.030436000000918,164.776097189532,0
"147.32.84.165",4604,"207.115.21.24",25,3,186,3,186,0,0,93313.084854,9.030388999992283,164.77695479134638,0
"147.32.84.165",4608,"67.195.168.31",25,3,186,3,186,0,0,93313.084982,9.03036200000497,164.7774474599336,0
"147.32.84.165",4609,"74.6.136.244",25,3,186,3,186,0,0,93313.085034,9.030333000002429,164.77797662606682,0
"147.32.84.165",4616,"67.195.168.31",25,3,186,3,186,0,0,93313.085084,9.030306000000564,164.77846930103,0
"147.32.84.165",4617,"74.6.136.244",25,3,186,3,186,0,0,93313.085136,9.030274000004283,164.77905321580434,0
"147.32.84.165",4619,"64.12.90.97",25,3,186,3,186,0,0,93313.085188,9.030249999996158,164.77949115480004,0
"147.32.84.165",4621,"205.188.59.193",25,3,186,3,186,0,0,93313.185357,9.030427000005147,164.77626141035765,0
"147.32.84.165",4622,"206.46.232.11",25,3,186,3,186,0,0,93313.587489,9.02949400000216,164.79328742005302,0
"147.32.84.165",4623,"161.58.16.34",25,3,186,3,186,0,0,93313.587621,9.029458999997587,164.79392619207835,0
"147.32.84.165",4625,"209.85.225.27",25,3,186,3,186,0,0,93313.887298,9.030818999992334,164.76910898128543,0
"147.32.84.165",4626,"67.195.168.31",25,3,186,3,186,0,0,93313.887399,9.030842000007397,164.76868934245348,0
"147.32.84.165",4530,"46.4.36.120",443,6,366,3,186,3,180,93316.598309,1.0304850000102306,1443.9802617070868,1397.4002532649226
"147.32.84.165",4449,"173.192.170.88",80,11,1099,6,542,5,557,93317.62905,68.88089400000172,62.949241047886105,64.69137871526303
"147.32.84.165",4630,"216.211.128.3",25,3,186,3,186,0,0,93317.62911,9.001399000000674,165.30763717949716,0
"147.32.84.165",4573,"118.86.12.94",6667,3,186,3,186,0,0,93323.118379,9.032370999993873,164.74079729464273,0
"147.32.84.165",4564,"46.4.36.120",443,6,366,3,186,3,180,93333.956331,1.0325970000121742,1441.0268478239395,1394.542110797361
"147.32.84.165",4631,"74.6.136.244",25,3,186,3,186,0,0,93333.95647,9.033305999997538,164.7237456586111,0
"147.32.84.165",4632,"205.178.149.7",25,3,186,3,186,0,0,93334.157334,9.033562999989954,164.71905935693977,0
"147.32.84.165",4633,"205.188.59.193",25,3,186,3,186,0,0,93334.257676,9.033546000006027,164.71936933724666,0
"147.32.84.165",4638,"206.46.232.11",25,3,186,3,186,0,0,93334.65938,9.033244000005652,164.72487624590556,0
"147.32.84.165",4640,"205.188.156.193",25,3,186,3,186,0,0,93334.659511,9.03323499999533,164.7250403649157,0
"147.32.84.165",4641,"209.85.225.27",25,3,186,3,186,0,0,93334.961657,9.0320209999918,164.74718116812957,0
"147.32.84.165",4643,"209.85.225.27",25,3,186,3,186,0,0,93334.961718,9.03208099999756,164.74608675458092,0
"147.32.84.165",4644,"64.12.90.33",25,3,186,3,186,0,0,93334.961765,9.032084999998915,164.74601379417695,0
"147.32.84.165",4646,"72.167.238.201",25,3,186,3,186,0,0,93334.989176,9.004730999993626,165.246468773032,0
"147.32.84.165",4602,"46.4.36.120",443,6,366,3,186,3,180,93338.673302,1.0304960000066785,1443.9648479861703,1397.3853367608099
"147.32.84.165",4648,"64.12.90.33",25,3,186,3,186,0,0,93339.704016,8.905843999993522,167.08130077296238,0
"147.32.84.165",4649,"67.195.168.31",25,3,186,3,186,0,0,93339.704051,8.905932000008761,167.0796498332276,0
"147.32.84.165",4625,"46.4.36.120",443,6,366,3,186,3,180,93342.086588,1.031463999999687,1442.6097275333423,1396.0739298709764
"147.32.84.165",4653,"77.238.177.9",25,3,186,3,186,0,0,93343.118287,8.904051999998046,167.11492700181068,0
"147.32.84.165",4564,"123.192.69.237",6667,3,186,3,186,0,0,93354.932058,9.030986999991,164.76604384454134,0
"147.32.84.165",4625,"46.4.36.120",443,6,366,3,186,3,180,93355.132922,1.031022999988636,1443.226775752239,1396.6710733086186
"147.32.84.165",4654,"65.55.92.136",25,3,186,3,186,0,0,93355.232945,9.030848000009428,164.76857987184002,0
"147.32.84.165",4655,"199.239.254.18",25,3,186,3,186,0,0,93355.634802,9.030496000006679,164.77500239177334,0
"147.32.84.165",4656,"74.6.136.244",25,3,186,3,186,0,0,93355.634882,9.03046500000346,164.77556803546992,0
"147.32.84.165",4659,"205.188.59.193",25,3,186,3,186,0,0,93356.035894,9.030947999999626,164.766755383827,0
"147.32.84.165",4661,"64.12.90.97",25,3,186,3,186,0,0,93356.036029,9.030861999999615,164.76832444123977,0
"147.32.84.165",4665,"81.169.145.102",25,3,186,3,186,0,0,93356.03609,9.030844000008074,164.76865285223283,0
"147.32.84.165",4667,"209.85.225.27",25,3,186,3,186,0,0,93356.164157,9.002330999996047,165.29052308792615,0
"147.32.84.165",4633,"46.4.36.120",443,6,366,3,186,3,180,93360.652766,1.0303509999939706,1444.168055360462,1397.5819890585117
"147.32.84.165",4668,"195.186.18.144",25,3,186,3,186,0,0,93361.683341,9.002894999997807,165.28016821259857,0
"147.32.84.165",4633,"46.4.36.120",443,6,366,3,186,3,180,93364.063484,1.0308479999948759,1443.4717824620086,1396.9081765761373
"147.32.84.165",4670,"64.12.90.33",25,3,186,3,186,0,0,93365.094563,9.005883999998332,165.22531269559718,0
"147.32.84.165",4633,"46.4.36.120",443,6,366,3,186,3,180,93375.90738,1.0306310000014491,1443.7757063370962,1397.2022964552543
"147.32.84.165",4671,"67.195.168.31",25,3,186,3,186,0,0,93376.208076,9.030396000001929,164.77682706269826,0
"147.32.84.165",4672,"207.115.21.24",25,3,186,3,186,0,0,93376.609587,9.03074899999774,164.77038615516523,0
"147.32.84.165",4674,"74.6.136.244",25,3,186,3,186,0,0,93376.609735,9.030722999988939,164.77086053927493,0
"147.32.84.165",4676,"205.188.59.193",25,3,186,3,186,0,0,93376.938262,9.002522000009776,165.28701623815905,0
"147.32.84.165",4680,"64.12.90.33",25,3,186,3,186,0,0,93376.93832,9.002592999997432,165.2857126830486,0
"147.32.84.165",4682,"204.232.236.252",25,3,186,3,186,0,0,93376.938375,9.002588000003016,165.2858044819447,0
"147.32.84.165",4685,"205.188.190.2",25,3,186,3,186,0,0,93377.010426,9.030994000000646,164.76591613280814,0
"147.32.84.165",4686,"67.195.168.31",25,3,186,3,186,0,0,93377.010558,9.030982000011136,164.76613506683606,0
"147.32.84.165",4688,"65.55.92.184",25,3,186,3,186,0,0,93377.010614,9.03097500000149,164.76626277890864,0
"147.32.84.165",4689,"158.93.190.116",25,3,186,3,186,0,0,93377.010669,9.030964000005042,164.76646346936707,0
"147.32.84.165",4690,"74.6.136.244",25,3,186,3,186,0,0,93377.110848,9.030878000005032,164.76803252122008,0
"147.32.84.165",4691,"64.12.90.33",25,3,186,3,186,0,0,93377.110975,9.030870999995386,164.76816023623417,0
"147.32.84.165",4692,"74.208.5.3",25,3,186,3,186,0,0,93377.111029,9.030865999986418,164.76825146140337,0
"147.32.84.165",4656,"46.4.36.120",443,6,366,3,186,3,180,93382.628313,1.0317360000044573,1442.229407516624,1395.7058782418942
"147.32.84.165",4665,"173.192.170.88",80,10,1277,6,748,4,529,93383.660331,8.615009999994072,694.6016313392691,491.23564569314624
"147.32.84.165",4695,"209.85.225.27",25,3,186,3,186,0,0,93383.660392,9.00207699999737,165.29518687747668,0
"147.32.84.165",4656,"46.4.36.120",443,6,366,3,186,3,180,93386.041698,1.0300869999919087,1444.538179796161,1397.940173996285
"147.32.84.165",4670,"68.67.179.213",80,13,3096,8,1172,5,1924,93387.072002,10.20447100000456,918.8129399354274,1508.3584440578177
"147.32.84.165",4696,"205.188.190.2",25,3,186,3,186,0,0,93387.096022,8.977740999995149,165.74325323049575,0
"147.32.84.165",4697,"216.237.221.34",25,3,186,3,186,0,0,93387.096082,8.977801999993972,165.74212708199616,0
"147.32.84.165",4699,"94.23.70.37",25,3,186,3,186,0,0,93397.277518,9.03158799999801,164.75507961615696,0
"147.32.84.165",4700,"64.12.90.33",25,3,186,3,186,0,0,93397.678764,8.930474000007962,166.62049517177627,0
"147.32.84.165",4706,"213.165.64.102",25,3,186,3,186,0,0,93397.678867,8.93049400000018,166.62012202236178,0
"147.32.84.165",4707,"67.195.168.31",25,3,186,3,186,0,0,93397.979719,8.930049000002327,166.62842499516097,0
"147.32.84.165",4715,"74.6.136.244",25,3,186,3,186,0,0,93398.079695,8.9302730000054,166.62424541770451,0
"147.32.84.165",4717,"205.188.156.193",25,3,186,3,186,0,0,93398.079831,8.930261000001337,166.624469318397,0
"147.32.84.165",4720,"209.85.225.27",25,3,186,3,186,0,0,93398.079926,8.930215000000317,166.6253276096877,0
"147.32.84.165",4721,"64.12.90.33",25,3,186,3,186,0,0,93398.07998,8.930206000004546,166.62549553719617,0
"147.32.84.165",4723,"150.135.40.105",25,3,186,3,186,0,0,93398.080034,8.930200000002515,166.62560748914706,0
"147.32.84.165",4670,"46.4.36.120",443,6,366,3,186,3,180,93398.179733,1.0309120000019902,1443.38217034735,1396.821455174855
"147.32.84.165",4729,"64.12.90.33",25,3,186,3,186,0,0,93399.210884,8.903189999997267,167.1311069403727,0
"147.32.84.165",4730,"65.54.188.126",25,3,186,3,186,0,0,93399.210944,8.903252999996766,167.12992430974842,0
"147.32.84.165",4685,"190.204.173.239",6667,3,186,3,186,0,0,93404.700792,8.93386499999906,166.55725153672645,0
"147.32.84.165",4672,"46.4.36.120",443,6,366,3,186,3,180,93408.013721,1.0325290000037057,1441.1217505703564,1394.633952164861
"147.32.84.165",4733,"216.32.180.22",25,3,186,3,186,0,0,93409.046475,9.004312999997637,165.2541398772333,0
"147.32.84.165",4690,"173.192.170.88",80,8,1101,5,664,3,437,93418.352593,40.33915899999556,131.683459241195,86.66516820542502
"147.32.84.165",4672,"46.4.36.120",443,6,366,3,186,3,180,93418.55337,1.0290680000034627,1445.9685851615181,1399.3244372530821
"147.32.84.165",4735,"74.6.136.244",25,3,186,3,186,0,0,93418.652733,9.030813999997918,164.7692002072397,0
"147.32.84.165",4736,"67.195.168.31",25,3,186,3,186,0,0,93418.652859,9.0308090000035,164.76929143329497,0
"147.32.84.165",4737,"209.85.225.27",25,3,186,3,186,0,0,93418.652911,9.030807999995886,164.76930967867744,0
"147.32.84.165",4739,"200.152.177.10",25,3,186,3,186,0,0,93418.652968,9.030799000000115,164.7694738859741,0
"147.32.84.165",4740,"64.12.90.33",25,3,186,3,186,0,0,93418.953109,9.030799000000115,164.7694738859741,0
"147.32.84.165",4742,"208.65.144.13",25,3,186,3,186,0,0,93419.053833,9.030343999998877,164.77777590756068,0
"147.32.84.165",4743,"66.175.58.42",25,3,186,3,186,0,0,93419.053863,9.03044800000498,164.77587822876333,0
"147.32.84.165",4748,"192.96.15.125",25,3,186,3,186,0,0,93419.053893,9.030468999990262,164.77549504921666,0
"147.32.84.165",4750,"205.188.190.2",25,3,186,3,186,0,0,93419.582698,9.00369800000044,165.2654276054047,0
"147.32.84.165",4752,"64.12.90.33",25,3,186,3,186,0,0,93420.157226,9.03086300000723,164.76830619607549,0
"147.32.84.165",4753,"205.188.159.42",25,3,186,3,186,0,0,93420.157326,9.030885999993188,164.76788656186363,0
"147.32.84.165",4672,"46.4.36.120",443,6,366,3,186,3,180,93423.869928,1.031831999993301,1442.0952248134004,1395.5760240129682
"147.32.84.165",4754,"61.58.37.38",25,3,186,3,186,0,0,93424.901969,9.001367000004393,165.30822485065588,0
"147.32.84.165",4720,"120.138.121.194",6667,2,124,2,124,0,0,93430.090789,3.0099740000005113,329.57095310452235,0
"147.32.84.165",4730,"46.4.36.120",443,6,366,3,186,3,180,93439.621613,1.0322960000048624,1441.4470268149746,1394.9487356273949
"147.32.84.165",4755,"74.6.136.244",25,3,186,3,186,0,0,93439.621714,9.03243000000657,164.73972120447294,0
"147.32.84.165",4757,"62.24.139.61",25,3,186,3,186,0,0,93439.924529,9.029504000005545,164.79310491463167,0
"147.32.84.165",4761,"67.195.168.31",25,3,186,3,186,0,0,93440.024285,9.029815999994753,164.78741095066218,0
"147.32.84.165",4762,"67.231.144.206",25,3,186,3,186,0,0,93440.024399,9.029823000004399,164.78728320580316,0
"147.32.84.165",4763,"64.12.90.33",25,3,186,3,186,0,0,93440.02443,9.02984099999594,164.78695472053926,0
"147.32.84.165",4765,"80.39.72.120",25,3,186,3,186,0,0,93440.526257,9.029975999990711,164.7844911217406,0
"147.32.84.165",4766,"209.85.225.27",25,3,186,3,186,0,0,93440.654116,9.003163000001223,165.2752482655038,0
"147.32.84.165",4767,"64.12.90.33",25,3,186,3,186,0,0,93441.128042,9.030095000009169,164.78231956568442,0
"147.32.84.165",4770,"65.55.37.120",25,3,186,3,186,0,0,93441.12817,9.030089000007138,164.7824290545557,0
"147.32.84.165",4730,"46.4.36.120",443,6,366,3,186,3,180,93444.940214,1.031883999996353,1442.022552927712,1395.5056963816567
"147.32.84.165",4772,"205.188.156.193",25,3,186,3,186,0,0,93445.844457,9.029404999993858,164.79491173571373,0
"147.32.84.165",4753,"116.72.72.149",6667,3,186,3,186,0,0,93445.972316,9.001757999998517,165.30104452932918,0
"147.32.84.165",4753,"46.4.36.120",443,6,366,3,186,3,180,93460.694391,1.0328330000047572,1440.6975764650688,1394.2234610952278
"147.32.84.165",4774,"186.202.4.42",25,3,186,3,186,0,0,93460.995828,9.856067000000621,150.9729996762305,0
"147.32.84.165",4754,"212.117.171.138",65500,213,169738,128,163262,85,6476,93461.096697,9.815915999992285,133059.00335750903,5277.958776342495
"147.32.84.165",4781,"204.136.80.100",25,3,186,3,186,0,0,93461.096842,9.758255000007921,152.48627956522884,0
"147.32.84.165",4782,"67.195.168.31",25,3,186,3,186,0,0,93461.096902,9.761423999996623,152.43677561803634,0
"147.32.84.165",4783,"64.88.163.230",25,3,186,3,186,0,0,93461.11962,9.741909000003943,152.74213709031747,0
"147.32.84.165",4787,"74.6.136.244",25,3,186,3,186,0,0,93461.599703,9.268221999998786,160.548592815342,0
"147.32.84.165",4757,"212.117.171.138",65500,9,544,5,302,4,242,93461.699982,38.31708299998718,63.05281641613503,50.52576679703535
"147.32.84.165",4789,"216.32.181.178",25,3,186,3,186,0,0,93461.700036,9.171092000004137,162.24894483659403,0
"147.32.84.165",4761,"65.55.16.187",443,123,164744,67,5392,56,159352,93461.727516,9.327988000004552,4624.362724306565,136665.6989695289
"147.32.84.165",4791,"205.188.156.193",25,3,186,3,186,0,0,93461.889536,8.98475899999903,165.61379108779218,0
"147.32.84.165",4792,"205.188.59.193",25,3,186,3,186,0,0,93461.889645,8.987834999992629,165.55711136232702,0
"147.32.84.165",4793,"64.12.90.33",25,3,186,3,186,0,0,93462.20308,8.936861999987741,166.50139612786245,0
"147.32.84.165",4753,"46.4.36.120",443,6,366,3,186,3,180,93467.271535,3.4802009999984875,427.5615115335714,413.7692047099078
"147.32.84.165",4796,"98.139.54.60",25,3,186,3,186,0,0,93468.136282,7.720824999996694,192.72551832228254,0
"147.32.84.165",4799,"67.195.168.31",25,3,186,3,186,0,0,93470.880697,8.889939999993658,167.3802072906073,0
"147.32.84.165",4801,"206.71.181.7",25,3,186,3,186,0,0,93470.883931,8.886838999998872,167.43861343726255,0
"147.32.84.165",4761,"46.4.36.120",443,6,366,3,186,3,180,93481.979731,1.030496999999741,1443.9634467644,1397.383980739742
"147.32.84.165",4804,"209.85.225.27",25,3,186,3,186,0,0,93482.079777,9.02870099998836,164.80776138249772,0
"147.32.84.165",4808,"207.115.37.23",25,3,186,3,186,0,0,93482.079883,9.028717000008328,164.80746932245495,0
"147.32.84.165",4811,"74.6.136.244",25,3,186,3,186,0,0,93482.079913,9.028736000007484,164.80712250294687,0
"147.32.84.165",4814,"209.85.143.27",25,3,186,3,186,0,0,93482.079936,9.028763000009349,164.8066296566273,0
"147.32.84.165",4815,"205.188.190.2",25,3,186,3,186,0,0,93482.58149,9.028843000007328,164.80516938867942,0
"147.32.84.165",4820,"165.21.74.122",25,3,186,3,186,0,0,93482.682441,9.028275999997277,164.8155195964821,0
"147.32.84.165",4821,"205.188.59.193",25,3,186,3,186,0,0,93482.781955,9.028458000000683,164.8121971658823,0
"147.32.84.165",4774,"184.82.155.107",80,10,1916,5,985,5,931,93483.010434,0.3064529999974184,25713.56782301489,24303.88999312372
"147.32.84.165",4822,"64.12.90.33",25,3,186,3,186,0,0,93483.110833,9.000786000004155,165.3188954830515,0
"147.32.84.165",4825,"64.207.35.180",25,3,186,3,186,0,0,93483.110893,9.000848999989103,165.31773836021486,0
"147.32.84.165",4828,"216.193.128.40",25,3,186,3,186,0,0,93483.183507,9.028763000009349,164.8066296566273,0
"147.32.84.165",4774,"124.123.111.216",6667,3,186,3,186,0,0,93487.898528,9.030362999998033,164.7774292130144,0
"147.32.84.165",4782,"46.4.36.120",443,6,366,3,186,3,180,93491.810526,1.031182999999146,1443.002842367681,1396.4543635816267
"147.32.84.165",4781,"184.82.155.108",80,10,1510,5,599,5,911,93492.841931,0.34154900000430644,14030.19771669535,21338.08033373867
"147.32.84.165",4832,"173.203.122.118",25,3,186,3,186,0,0,93492.954532,8.889668999996502,167.38530984681043,0
"147.32.84.165",4757,"212.117.171.138",65500,9,544,5,302,4,242,93503.047835,38.8742809999967,62.149059425696,49.80156417555773
"147.32.84.165",4801,"46.4.36.120",443,6,366,3,186,3,180,93503.047967,1.0301780000008876,1444.4105775882595,1397.8166879886383
"147.32.84.165",4799,"217.163.21.37",80,13,6077,6,749,7,5328,93503.048045,0.1869109999970533,32058.03831820741,228044.36336369705
"147.32.84.165",4833,"74.6.136.244",25,3,186,3,186,0,0,93503.070624,9.005858999997145,165.22577135623285,0
"147.32.84.165",4837,"205.188.156.193",25,3,186,3,186,0,0,93503.09401,8.982594999994035,165.6536891623176,0
"147.32.84.165",4804,"217.163.21.37",80,10,1448,5,699,5,749,93503.549407,0.13899900000251364,40230.50525470597,43108.223799391664
"147.32.84.165",4838,"209.85.225.27",25,3,186,3,186,0,0,93503.595334,8.982853000008618,165.6489313582859,0
"147.32.84.165",4808,"217.163.21.34",80,11,3439,6,1373,5,2066,93503.64916,0.23737099999561906,46273.5549001467,69629.3987062659
"147.32.84.165",4839,"216.32.181.178",25,3,186,3,186,0,0,93503.694985,8.98324900001171,165.64162921433663,0
"147.32.84.165",4842,"209.85.143.27",25,3,186,3,186,0,0,93503.750231,9.028327000007266,164.81458857203583,0
"147.32.84.165",4846,"64.12.90.33",25,3,186,3,186,0,0,93504.050606,9.029366999995545,164.79560527340777,0
"147.32.84.165",4847,"205.188.156.193",25,3,186,3,186,0,0,93504.078343,9.001728000002913,165.30159542695785,0
"147.32.84.165",4848,"211.41.82.134",25,3,186,3,186,0,0,93504.078403,9.001690999997663,165.30227487261962,0
"147.32.84.165",4849,"68.1.17.3",25,3,186,3,186,0,0,93504.151249,9.028764999995474,164.80659314986556,0
"147.32.84.165",4808,"46.4.36.120",443,6,366,3,186,3,180,93507.160661,1.0311220000003232,1443.0882087663085,1396.53697622546
"147.32.84.165",4822,"184.82.148.43",80,10,1927,5,987,5,940,93508.192028,0.3069659999891883,25722.71847787086,24497.827121781775
"147.32.84.165",4851,"67.139.134.251",25,3,186,3,186,0,0,93508.292648,9.001481999992393,165.30611292687777,0
"147.32.84.165",4828,"95.59.69.146",6667,2,124,2,124,0,0,93513.883238,3.0103410000010626,329.53077408826766,0
"147.32.84.165",4822,"46.4.36.120",443,6,366,3,186,3,180,93524.117092,1.0302479999954812,1444.31243740005,1397.7217136129514
"147.32.84.165",4854,"74.6.136.244",25,3,186,3,186,0,0,93524.117223,8.93379900000582,166.5584820073779,0
"147.32.84.165",4856,"167.127.98.30",25,3,186,3,186,0,0,93524.618474,8.934634999997797,166.54289738756725,0
"147.32.84.165",4859,"203.131.74.12",25,3,186,3,186,0,0,93524.719059,8.934308000010788,166.54899293803206,0
"147.32.84.165",4860,"74.125.67.27",25,3,186,3,186,0,0,93524.819199,8.935275999989244,166.53094991154063,0
"147.32.84.165",4862,"67.195.168.31",25,3,186,3,186,0,0,93525.120071,8.934703999999329,166.5416112274242,0
"147.32.84.165",4864,"64.12.90.33",25,3,186,3,186,0,0,93525.120133,8.93477300000086,166.54032508714624,0
"147.32.84.165",4865,"65.55.37.88",25,3,186,3,186,0,0,93525.147546,8.907419000010123,167.0517576413896,0
"147.32.84.165",4866,"65.54.188.94",25,3,186,3,186,0,0,93525.220503,8.934324999994715,166.54867603326275,0
"147.32.84.165",4822,"46.4.36.120",443,6,366,3,186,3,180,93528.232776,1.0306310000014491,1443.7757063370962,1397.2022964552543
"147.32.84.165",4869,"64.12.90.33",25,3,186,3,186,0,0,93529.263688,8.905544999986887,167.08691045884234,0
"147.32.84.165",4848,"83.238.197.86",6667,3,186,3,186,0,0,93529.26375,8.905603999999585,167.0858035008147,0
"147.32.84.165",4870,"67.139.134.251",25,3,186,3,186,0,0,93529.336169,8.933525999993435,166.56357187532598,0
"147.32.84.165",4757,"212.117.171.138",65500,216,169578,127,163406,89,6172,93545.09299,94.7321030000021,13799.41918950085,521.21718442162
"147.32.84.165",4851,"46.4.36.120",443,6,366,3,186,3,180,93545.115548,1.007912999994005,1476.3178964938943,1428.6947385424783
"147.32.84.165",4873,"74.6.136.244",25,3,186,3,186,0,0,93545.594287,9.031721000006655,164.75265345319053,0
"147.32.84.165",4874,"200.147.36.13",25,3,186,3,186,0,0,93545.694743,9.03183700000227,164.75053745983524,0
"147.32.84.165",4875,"98.139.175.225",25,3,186,3,186,0,0,93545.795815,9.031187999993563,164.76237677712618,0
"147.32.84.165",4877,"75.101.43.8",25,3,186,3,186,0,0,93546.095887,9.03193199999805,164.74880457473785,0
"147.32.84.165",4880,"205.188.59.193",25,3,186,3,186,0,0,93546.095946,9.031996000005165,164.74763717777876,0
"147.32.84.165",4881,"203.131.74.12",25,3,186,3,186,0,0,93546.096002,9.031989999988582,164.74774662083118,0
"147.32.84.165",4886,"64.12.90.33",25,3,186,3,186,0,0,93546.123667,9.004371999995783,165.25305707057603,0
"147.32.84.165",4891,"207.115.21.24",25,3,186,3,186,0,0,93546.196462,9.031406999987666,164.7583815015791,0
"147.32.84.165",4864,"42.201.161.145",6667,3,186,3,186,0,0,93549.307927,9.031178999997792,164.7625409706046,0
"147.32.84.165",4859,"46.4.36.120",443,6,366,3,186,3,180,93550.312128,1.0310859999881359,1443.1385936935635,1396.5857358324809
"147.32.84.165",4894,"209.85.225.27",25,3,186,3,186,0,0,93551.343457,9.002247000011266,165.29206541412802,0
"147.32.84.165",4859,"46.4.36.120",443,6,366,3,186,3,180,93566.566391,1.0318140000017593,1442.1203821594424,1395.6003698317186
"147.32.84.165",4896,"65.55.92.184",25,3,186,3,186,0,0,93566.666683,9.034220999994432,164.70706218067028,0
"147.32.84.165",4897,"205.188.190.2",25,3,186,3,186,0,0,93566.768162,9.032474000006914,164.7389187058674,0
"147.32.84.165",4899,"74.6.136.244",25,3,186,3,186,0,0,93567.068673,9.032911999995122,164.73093062356898,0
"147.32.84.165",4902,"67.195.168.31",25,3,186,3,186,0,0,93567.068733,9.032974000001559,164.72979995289958,0
"147.32.84.165",4903,"74.219.102.100",25,3,186,3,186,0,0,93567.068793,9.032961999997497,164.730018791224,0
"147.32.84.165",4906,"209.85.225.27",25,3,186,3,186,0,0,93567.068853,9.032944999999017,164.7303288130462,0
"147.32.84.165",4913,"65.55.92.184",25,3,186,3,186,0,0,93567.068907,9.032941000012215,164.73040175929276,0
"147.32.84.165",4914,"205.188.156.193",25,3,186,3,186,0,0,93567.068984,9.03291100000206,164.73094886019146,0
"147.32.84.165",4915,"199.81.10.62",25,3,186,3,186,0,0,93567.169468,9.032289000009769,164.7422929003258,0
"147.32.84.165",4917,"68.6.19.3",25,3,186,3,186,0,0,93567.598448,9.005192999989958,165.23799101270336,0
"147.32.84.165",4873,"74.125.93.27",25,3,186,3,186,0,0,93569.878181,9.032291000010446,164.74225642179587,0
"147.32.84.165",4919,"74.6.136.244",25,3,186,3,186,0,0,93572.288452,9.031163000006927,164.7628328709003,0
"147.32.84.165",4859,"222.23.80.7",6667,2,124,2,124,0,0,93572.288582,3.010756000003312,329.4853518514648,0
"147.32.84.165",4875,"46.4.36.120",443,6,366,3,186,3,180,93587.742033,1.0304190000024391,1444.0727509842866,1397.4897590170517
"147.32.84.165",4921,"64.12.90.33",25,3,186,3,186,0,0,93587.842763,8.930896000005305,166.6126220705197,0
"147.32.84.165",4923,"64.12.90.33",25,3,186,3,186,0,0,93588.142869,8.931677999993553,166.59803454637236,0
"147.32.84.165",4926,"65.55.88.22",25,3,186,3,186,0,0,93588.143009,8.931658999994397,166.59838894442046,0
"147.32.84.165",4927,"209.85.225.27",25,3,186,3,186,0,0,93588.143069,8.93164799999795,166.59859412286977,0
"147.32.84.165",4928,"67.195.168.31",25,3,186,3,186,0,0,93588.143124,8.931637000001501,166.5987993018245,0
"147.32.84.165",4930,"205.188.59.193",25,3,186,3,186,0,0,93588.143187,8.931624000004376,166.59904178671997,0
"147.32.84.165",4931,"209.85.225.27",25,3,186,3,186,0,0,93588.243281,8.931280000004335,166.60545856800792,0
"147.32.84.165",4932,"66.234.224.28",25,3,186,3,186,0,0,93588.243335,8.931360999995377,166.6039475955311,0
"147.32.84.165",4934,"64.12.90.33",25,3,186,3,186,0,0,93588.644951,8.931584000005387,166.59978789866418,0
"147.32.84.165",4941,"216.32.180.22",25,3,186,3,186,0,0,93588.645079,8.931577000010293,166.59991846885328,0
"147.32.84.165",4944,"205.188.59.193",25,3,186,3,186,0,0,93588.772702,8.904106000001775,167.11391351357491,0
"147.32.84.165",4943,"64.12.90.33",25,3,186,3,186,0,0,93588.772734,8.904194999995525,167.11224316187457,0
"147.32.84.165",4945,"207.115.21.24",25,3,186,3,186,0,0,93588.772766,8.904212000008556,167.11192410946305,0
"147.32.84.165",4896,"46.4.36.120",443,6,366,3,186,3,180,93590.952981,1.0308680000016466,1443.4437774745393,1396.8810749753604
"147.32.84.165",4947,"74.6.136.244",25,3,186,3,186,0,0,93590.953116,8.930500000002212,166.62001007778193,0
"147.32.84.165",4899,"218.241.209.6",6667,3,186,3,186,0,0,93591.984098,8.903032999995048,167.13405420386823,0
"147.32.84.165",4897,"74.125.39.27",25,3,186,3,186,0,0,93608.814518,9.03103800000099,164.76511337897557,0
"147.32.84.165",4948,"64.59.134.8",25,3,186,3,186,0,0,93609.114773,9.031784000006155,164.7515042431247,0
"147.32.84.165",4902,"46.4.36.120",443,6,366,3,186,3,180,93609.114905,1.0307680000114487,1443.5838132183699,1397.0165934371323
"147.32.84.165",4951,"209.85.225.27",25,3,186,3,186,0,0,93609.114963,9.031715999997687,164.75274466118964,0
"147.32.84.165",4952,"209.85.225.27",25,3,186,3,186,0,0,93609.115016,9.031712000010884,164.75281762729003,0
"147.32.84.165",4953,"65.54.188.94",25,3,186,3,186,0,0,93609.115069,9.03170299998601,164.75298180224758,0
"147.32.84.165",4954,"98.139.175.225",25,3,186,3,186,0,0,93609.215366,9.031436999997823,164.75783421844815,0
"147.32.84.165",4956,"67.195.168.31",25,3,186,3,186,0,0,93609.616938,9.031170999995084,164.7626869207559,0
"147.32.84.165",4958,"64.12.90.33",25,3,186,3,186,0,0,93609.717868,9.030784999995376,164.76972932040368,0
"147.32.84.165",4960,"216.32.180.22",25,3,186,3,186,0,0,93610.14591,9.004405999992741,165.25243308677992,0
"147.32.84.165",4917,"46.4.36.120",443,6,366,3,186,3,180,93611.924948,1.0314000000071246,1442.6992437363983,1396.1605584545791
"147.32.84.165",4962,"205.188.59.193",25,3,186,3,186,0,0,93612.024853,9.031356000006781,164.7593118905824,0
"147.32.84.165",4873,"175.100.132.205",6667,6,366,3,186,3,180,93612.956599,1.6314839999977266,912.0530756060577,882.6320086510236
"147.32.84.165",4896,"46.4.36.120",443,6,366,3,186,3,180,93614.588335,0.9765530000004219,1523.7268228138742,1474.5743446585877
"147.32.84.165",4966,"168.95.5.38",25,3,186,3,186,0,0,93615.56517,9.002727999992203,165.28323414872565,0
"147.32.84.165",4899,"46.4.36.120",443,6,366,3,186,3,180,93629.785872,1.0313440000027185,1442.7775795428856,1396.2363672995666
"147.32.84.165",4934,"184.82.148.43",80,10,1923,5,983,5,940,93630.086988,0.34125300000596326,23044.48605539755,22036.436309332345
"147.32.84.165",4967,"64.12.90.33",25,3,186,3,186,0,0,93630.087119,9.68693299998995,153.60899058572448,0
"147.32.84.165",4923,"212.117.171.138",65500,9,544,5,302,4,242,93630.087172,21.040273000005982,114.82740742001366,92.01401521736194
"147.32.84.165",4941,"66.111.4.71",25,3,186,3,186,0,0,93630.087219,9.690014000007068,153.56014965498653,0
"147.32.84.165",4969,"74.6.136.244",25,3,186,3,186,0,0,93630.087282,9.693173000006936,153.510104482705,0
"147.32.84.165",4928,"42.201.161.145",6667,2,124,2,124,0,0,93630.187176,3.636103999990155,272.81947931156145,0
"147.32.84.165",4970,"69.59.192.56",25,3,186,3,186,0,0,93630.20012,9.583514000012656,155.26663810352184,0
"147.32.84.165",4943,"65.55.16.187",443,145,165610,72,5166,73,160444,93630.588127,9.380896000002394,4405.5493206607825,136826.1624475607
"147.32.84.165",4944,"184.82.148.44",80,10,1514,5,596,5,918,93630.689022,0.34378599999763537,13869.092982357615,21362.126439268945
"147.32.84.165",4972,"122.1.235.147",25,3,186,3,186,0,0,93630.750173,9.043078000002424,164.54574426977197,0
"147.32.84.165",4976,"207.115.21.24",25,3,186,3,186,0,0,93630.801778,9.019499000001815,164.97590387223286,0
"147.32.84.165",4979,"205.188.190.2",25,3,186,3,186,0,0,93630.817454,9.00396699999692,165.26049018177312,0
"147.32.84.165",4945,"217.163.21.36",80,13,6081,6,750,7,5331,93631.090032,0.18709400000807364,32069.441028258967,227949.58682886473
"147.32.84.165",4980,"205.188.59.193",25,3,186,3,186,0,0,93631.135964,8.985587999995914,165.59851175022453,0
"147.32.84.165",4983,"209.85.225.27",25,3,186,3,186,0,0,93631.136023,8.985666000007768,165.59707427348332,0
"147.32.84.165",4896,"46.4.36.120",443,6,366,3,186,3,180,93633.807243,2.637843000004068,564.0972567350314,545.9005710339013
"147.32.84.165",4873,"217.163.21.36",80,10,1451,5,701,5,750,93637.279252,1.8080260000133421,3101.725307024687,3318.5363484572254
"147.32.84.165",4988,"94.245.120.86",25,3,186,3,186,0,0,93637.282481,8.256682999999612,180.21764914555519,0
"147.32.84.165",4989,"74.6.136.244",25,3,186,3,186,0,0,93638.14405,8.197455000001355,181.51975216695354,0
"147.32.84.165",4990,"67.195.168.31",25,3,186,3,186,0,0,93638.147258,8.194369000004372,181.58811251961026,0
"147.32.84.165",4944,"46.4.36.120",443,6,366,3,186,3,180,93645.137698,1.0303569999960018,1444.1596456429897,1397.573850622248
"147.32.84.165",4948,"217.163.21.34",80,11,3590,6,1410,5,2180,93646.168279,0.25734599999850616,43832.039355830195,67768.68496149633
"147.32.84.165",4991,"209.85.225.27",25,3,186,3,186,0,0,93646.214286,8.959021999995457,166.08955754330714,0
"147.32.84.165",4921,"59.103.193.24",6667,3,186,3,186,0,0,93646.214346,8.959012000006624,166.08974293135225,0
"147.32.84.165",4966,"46.4.36.120",443,6,366,3,186,3,180,93651.159129,1.0311989999900106,1442.9804528654647,1396.4326963214176
"147.32.84.165",4951,"184.82.148.43",80,10,1923,5,983,5,940,93651.15926,0.32468999999400694,24220.02525530553,23160.55314342543
"147.32.84.165",4992,"67.215.65.132",25,3,186,3,186,0,0,93651.259952,8.930488000012701,166.6202339668206,0
"147.32.84.165",4941,"212.117.171.138",65500,217,169974,128,163274,89,6700,93651.265834,24.221315999995568,53927.375374659205,2212.9268285839553
"147.32.84.165",4923,"216.157.130.15",25,3,186,3,186,0,0,93651.288623,8.90194199999678,167.15453774025244,0
"147.32.84.165",4969,"184.82.148.44",80,10,1514,5,596,5,918,93651.760975,0.344745000009425,13830.512407343536,21302.70199654592
"147.32.84.165",4993,"64.20.45.186",25,3,186,3,186,0,0,93651.860913,8.933130000004894,166.57095553285185,0
"147.32.84.165",4995,"66.196.94.104",25,3,186,3,186,0,0,93651.861046,8.933122999995248,166.5710860581223,0
"147.32.84.165",4996,"207.115.21.24",25,3,186,3,186,0,0,93651.873741,8.920478000000003,166.8072047260247,0
"147.32.84.165",4970,"217.163.21.36",80,14,6141,7,810,7,5331,93652.16307,0.1903020000027027,34051.139766833614,224106.94579875306
"147.32.84.165",4997,"64.12.90.33",25,3,186,3,186,0,0,93652.190565,8.904177999997046,167.1125622152313,0
"147.32.84.165",4998,"64.12.90.33",25,3,186,3,186,0,0,93652.209084,8.885779999996885,167.4585686344386,0
"147.32.84.165",4999,"205.188.59.193",25,3,186,3,186,0,0,93652.209143,8.885771000001114,167.4587382456529,0
"147.32.84.165",4966,"46.4.36.120",443,6,366,3,186,3,180,93657.48152,1.0313590000005206,1442.7565959081649,1396.2160605562885
"147.32.84.165",4976,"217.163.21.36",80,10,1451,5,701,5,750,93658.284472,0.13945699999749195,40213.11228623057,43024.01457157336
"147.32.84.165",5000,"67.195.168.31",25,3,186,3,186,0,0,93658.330441,9.70420799999556,153.33554268423356,0
"147.32.84.165",4980,"212.117.171.138",65500,15,912,8,486,7,426,93658.513092,85.01808700000402,45.731445357031106,40.08558790554578
"147.32.84.165",4989,"217.163.21.34",80,11,3597,6,1406,5,2191,93658.513151,0.23992100000032224,46882.098690756095,73057.3813879421
"147.32.84.165",1032,"209.85.225.27",25,3,186,3,186,0,0,93658.559071,9.504329000003054,156.5602369193577,0
"147.32.84.165",4921,"65.55.16.187",443,143,165832,70,5580,73,160252,93666.211738,9.418327000006684,4739.69527708778,136119.29167452882
"147.32.84.165",4966,"46.4.36.120",443,6,366,3,186,3,180,93666.373914,1.6849809999985155,883.0960111724173,854.6090430700813
"147.32.84.165",4976,"184.82.148.43",80,10,1907,5,983,5,924,93668.928224,1.981923999992432,3967.8615325461665,3729.70911095896
"147.32.84.165",1035,"64.12.90.33",25,3,186,3,186,0,0,93669.876201,8.177427999995416,181.9643046690028,0
"147.32.84.165",1036,"209.85.225.27",25,3,186,3,186,0,0,93669.879421,8.174337999997078,182.03308940742747,0
"147.32.84.165",1038,"205.188.59.193",25,3,186,3,186,0,0,93669.882627,8.171195999995689,182.10308503195677,0
"147.32.84.165",1041,"62.249.220.75",25,3,186,3,186,0,0,93669.885815,8.168069999999716,182.17277765739664,0
"147.32.84.165",4966,"46.4.36.120",443,6,366,3,186,3,180,93672.964217,2.50863300000492,593.1517284501485,574.0178017259502
"147.32.84.165",1050,"205.188.59.193",25,3,186,3,186,0,0,93672.967449,8.29652599999099,179.35217704393574,0
"147.32.84.165",1057,"207.126.147.10",25,3,186,3,186,0,0,93672.970615,8.293484000008903,179.41796234229218,0
"147.32.84.165",1058,"69.145.248.1",25,3,186,3,186,0,0,93673.404601,8.46125100000063,175.86051991601352,0
"147.32.84.165",1059,"67.195.168.31",25,3,186,3,186,0,0,93673.4078,8.458176000000094,175.9244546341887,0
"147.32.84.165",1061,"209.85.225.27",25,3,186,3,186,0,0,93673.410999,8.455025000002934,175.99001777043637,0
"147.32.84.165",1063,"64.12.90.33",25,3,186,3,186,0,0,93673.4142,8.451866999996128,176.05577560563623,0
"147.32.84.165",1065,"65.55.88.22",25,3,186,3,186,0,0,93673.4174,8.4487259999878,176.12122821856792,0
"147.32.84.165",1080,"64.12.90.33",25,3,186,3,186,0,0,93673.420618,8.445565000001807,176.1871467450291,0
"147.32.84.165",1086,"205.188.156.193",25,3,186,3,186,0,0,93673.423799,8.44243799999822,176.25240481485488,0
"147.32.84.165",1089,"74.125.93.27",25,3,186,3,186,0,0,93673.854654,8.312922000011895,178.9984315981638,0
"147.32.84.165",1091,"65.55.37.104",25,3,186,3,186,0,0,93673.857846,8.309850000005099,179.06460405411494,0
"147.32.84.165",1093,"67.195.168.31",25,3,186,3,186,0,0,93675.472964,9.003096000000369,165.27647822481723,0
"147.32.84.165",1101,"203.188.197.119",25,3,186,3,186,0,0,93675.474198,9.00196500000311,165.2972434351262,0
"147.32.84.165",4970,"61.17.216.90",6667,2,124,2,124,0,0,93679.357738,3.0105949999997392,329.5029720039015,0
"147.32.84.165",4941,"46.4.36.120",443,6,366,3,186,3,180,93679.558862,1.030721999995876,1443.6482388131362,1397.078940786906
"147.32.84.165",1111,"69.145.248.1",25,3,186,3,186,0,0,93680.589825,8.903361000004224,167.1278969817459,0
"147.32.84.165",1114,"64.12.90.33",25,3,186,3,186,0,0,93680.589885,8.903423000010662,167.12673316748155,0
"147.32.84.165",4941,"46.4.36.120",443,6,366,3,186,3,180,93689.994205,1.0299380000069505,1444.7471595280088,1398.1424124464602
"147.32.84.165",1117,"74.62.189.165",25,3,186,3,186,0,0,93691.024381,9.004687000007834,165.24727622389378,0
"147.32.84.165",1119,"98.139.175.225",25,3,186,3,186,0,0,93693.203826,9.033949000004213,164.7120212876236,0
"147.32.84.165",1121,"209.85.225.27",25,3,186,3,186,0,0,93693.806277,9.032328000001144,164.74158157230468,0
"147.32.84.165",1131,"67.195.168.31",25,3,186,3,186,0,0,93693.806356,9.032347999993362,164.74121679114816,0
"147.32.84.165",1132,"207.115.21.24",25,3,186,3,186,0,0,93693.806396,9.03233299999556,164.74149037693044,0
"147.32.84.165",1058,"46.4.36.120",443,6,366,3,186,3,180,93694.107632,1.0308890000014799,1443.4143734173747,1396.852619436169
"147.32.84.165",1059,"184.82.155.107",80,10,1909,5,981,5,928,93694.107697,0.3275969999958761,23956.263336046402,22661.990189450622
"147.32.84.165",1133,"64.12.90.33",25,3,186,3,186,0,0,93694.215493,9.024384999996983,164.88658229901512,0
"147.32.84.165",1138,"168.95.5.75",25,3,186,3,186,0,0,93694.215555,9.024445999995805,164.8854677617542,0
"147.32.84.165",1061,"184.82.155.108",80,10,1508,5,596,5,912,93695.138845,0.3073010000080103,15515.73213193486,23742.194134772806
"147.32.84.165",1140,"64.12.90.97",25,3,186,3,186,0,0,93695.239251,9.004282999987481,165.2546904625353,0
"147.32.84.165",1091,"46.4.36.120",443,6,366,3,186,3,180,93696.415686,1.0307770000072196,1443.5712088934638,1397.0043957033522
"147.32.84.165",1059,"217.163.21.36",80,13,6078,6,750,7,5328,93697.318131,0.1863559999910649,32196.441221574183,228723.518438063
"147.32.84.165",1144,"74.125.113.27",25,3,186,3,186,0,0,93697.36395,8.986155000005965,165.58806297009258,0
"147.32.84.165",1145,"74.6.136.244",25,3,186,3,186,0,0,93697.446701,9.003324000004795,165.2722927664502,0
"147.32.84.165",1101,"81.214.131.58",6667,2,124,2,124,0,0,93701.533407,3.0112480000098003,329.431518093751,0
"147.32.84.165",1114,"46.4.36.120",443,6,366,3,186,3,180,93712.071612,1.0305349999980535,1443.9102019851928,1397.3324535340573
"147.32.84.165",1093,"217.163.21.37",80,10,1449,5,700,5,749,93713.102343,0.13983799998823088,40046.339338887214,42849.58309260932
"147.32.84.165",1147,"24.113.32.75",25,3,186,3,186,0,0,93713.148316,8.857750999988639,167.98846569540152,0
"147.32.84.165",1111,"184.82.155.107",80,10,1905,5,977,5,928,93714.278633,0.34128700000292156,22901.546205783085,21752.952793210545
"147.32.84.165",1149,"98.139.175.225",25,3,186,3,186,0,0,93714.391401,8.91856099999859,166.84305909891015,0
"147.32.84.165",1151,"209.86.93.229",25,3,186,3,186,0,0,93714.881562,8.929979000007734,166.6297311559984,0
"147.32.84.165",1152,"207.126.147.10",25,3,186,3,186,0,0,93714.881695,8.92997299999115,166.6298431139125,0
"147.32.84.165",1154,"64.12.90.97",25,3,186,3,186,0,0,93714.881753,8.929965000002994,166.6299923907318,0
"147.32.84.165",1155,"67.195.168.31",25,3,186,3,186,0,0,93714.881802,8.929959999994026,166.6300856891851,0
"147.32.84.165",1119,"46.4.36.120",443,6,366,3,186,3,180,93715.282364,1.031184999999823,1443.0000436393618,1396.4516551348663
"147.32.84.165",1158,"205.188.103.1",25,3,186,3,186,0,0,93716.286258,8.929888000013307,166.63142919572817,0
"147.32.84.165",1173,"98.137.34.115",25,3,186,3,186,0,0,93716.313777,8.902489999993122,167.14424840703552,0
"147.32.84.165",1138,"46.4.36.120",443,6,366,3,186,3,180,93718.292891,1.032744999989518,1440.8203380457933,1394.3422626249612
"147.32.84.165",1176,"64.12.90.33",25,3,186,3,186,0,0,93718.393794,9.030377999995835,164.7771555078521,0
"147.32.84.165",1181,"64.12.90.97",25,3,186,3,186,0,0,93718.393927,9.030383000004804,164.77706427282303,0
"147.32.84.165",1140,"61.17.216.3",6667,3,186,3,186,0,0,93719.325871,9.001368000012008,165.30820648572694,0
"147.32.84.165",1138,"46.4.36.120",443,6,366,3,186,3,180,93734.0487,1.0305200000002515,1443.9312191899594,1397.3527927644768
"147.32.84.165",1185,"74.125.113.27",25,3,186,3,186,0,0,93735.079447,9.002919999998994,165.2797092499063,0
"147.32.84.165",1186,"74.6.136.244",25,3,186,3,186,0,0,93735.352893,9.030342999991262,164.77779415482223,0
"147.32.84.165",1187,"98.139.54.60",25,3,186,3,186,0,0,93735.85553,9.029790000000503,164.7878854325424,0
"147.32.84.165",1191,"65.55.37.120",25,3,186,3,186,0,0,93735.855683,9.029737000004388,164.78885265421096,0
"147.32.84.165",1193,"74.125.148.13",25,3,186,3,186,0,0,93735.85579,9.029660999993212,164.79023963370483,0
"147.32.84.165",1149,"46.4.36.120",443,6,366,3,186,3,180,93737.259849,1.0322339999984251,1441.5336057543834,1395.0325216977903
"147.32.84.165",1196,"64.12.90.97",25,3,186,3,186,0,0,93737.25998,9.029532999993535,164.7925756515941,0
"147.32.84.165",1198,"64.12.90.97",25,3,186,3,186,0,0,93737.260033,9.02958299999591,164.79166313667795,0
"147.32.84.165",1201,"205.188.190.2",25,3,186,3,186,0,0,93737.260081,9.029559000002337,164.7921011424384,0
"147.32.84.165",1203,"67.195.168.31",25,3,186,3,186,0,0,93738.292339,9.000230999998166,165.3290898867266,0
"147.32.84.165",1149,"46.4.36.120",443,6,366,3,186,3,180,93739.467774,1.0302069999888772,1444.3699179058824,1397.7773399089185
"147.32.84.165",1204,"218.102.53.148",25,3,186,3,186,0,0,93739.467908,9.028691999992589,164.80792566644442,0
"147.32.84.165",1205,"209.85.225.27",25,3,186,3,186,0,0,93739.467968,9.028753999999026,164.80679393858338,0
"147.32.84.165",1176,"217.34.4.225",6667,10,1118,5,560,5,558,93740.498235,0.5714649999863468,7839.500232047517,7811.502016933061
"147.32.84.165",1209,"74.6.136.244",25,3,186,3,186,0,0,93740.588068,8.912448999995831,166.95747712000326,0
"147.32.84.165",1181,"212.117.171.138",65500,216,169933,126,163141,90,6792,93740.588125,25.619060000011814,50943.63337294179,2120.9209081041595
"147.32.84.165",1216,"66.94.236.34",25,3,186,3,186,0,0,93740.588179,8.912460000006831,166.95727105634802,0
"147.32.84.165",1149,"46.4.36.120",443,6,366,3,186,3,180,93756.025256,1.0320630000060191,1441.7724499292406,1395.2636612218457
"147.32.84.165",1223,"74.125.148.13",25,3,186,3,186,0,0,93756.326911,9.615376000001561,154.75213865789112,0
"147.32.84.165",1185,"65.55.196.251",443,123,164753,67,5408,56,159345,93756.327036,9.957422999999835,4344.899277654541,128021.07533244506
"147.32.84.165",1225,"206.46.232.11",25,3,186,3,186,0,0,93756.42591,9.519619999991846,156.30876022375625,0
"147.32.84.165",1226,"205.188.190.2",25,3,186,3,186,0,0,93756.829151,9.125956000003498,163.05141072337295,0
"147.32.84.165",1227,"195.50.106.142",25,3,186,3,186,0,0,93756.82928,9.128979999994044,162.9973994905204,0
"147.32.84.165",1228,"74.6.136.244",25,3,186,3,186,0,0,93756.829339,9.132136999993236,162.9410509282879,0
"147.32.84.165",1229,"205.188.156.193",25,3,186,3,186,0,0,93756.829393,9.13526899999124,162.88518707018116,0
"147.32.84.165",1235,"67.195.168.31",25,3,186,3,186,0,0,93757.057567,9.000717000002624,165.32016282697992,0
"147.32.84.165",1236,"209.85.225.27",25,3,186,3,186,0,0,93757.057624,9.000791000013123,165.31880364712728,0
"147.32.84.165",1240,"67.231.152.94",25,3,186,3,186,0,0,93757.057677,9.000801000001957,165.31861997611952,0
"147.32.84.165",1193,"212.117.171.138",65500,14,861,8,486,6,375,93758.834317,7.742247000001953,502.17979354043075,387.48440859601135
"147.32.84.165",1149,"46.4.36.120",443,6,366,3,186,3,180,93758.83751,3.656306000004406,406.96812575266046,393.840121696123
"147.32.84.165",1241,"165.21.74.113",25,3,186,3,186,0,0,93760.203505,8.065323999995599,184.49351817742374,0
"147.32.84.165",1249,"208.185.174.190",25,3,186,3,186,0,0,93761.591909,7.881471000000602,188.79724356022962,0
"147.32.84.165",1250,"195.200.70.95",25,3,186,3,186,0,0,93761.595104,7.878374999985681,188.8714360515594,0
"147.32.84.165",1204,"150.186.92.225",6667,6,366,3,186,3,180,93762.897116,3.4945260000095004,425.80882213952754,412.0730536834138
"147.32.84.165",1252,"205.188.190.2",25,3,186,3,186,0,0,93763.76826,7.71115099999588,192.9673015093071,0
"147.32.84.165",1149,"46.4.36.120",443,6,366,3,186,3,180,93766.392114,0.9991889999946579,1489.2077474911707,1441.1687878946814
"147.32.84.165",1253,"74.125.113.27",25,3,186,3,186,0,0,93767.391531,9.007360000003246,165.19823788540302,0
"147.32.84.165",1185,"212.117.171.138",65500,7,424,4,242,3,182,93777.402562,301.7687389999919,6.415508797947596,4.824886781927531
"147.32.84.165",1149,"46.4.36.120",443,6,366,3,186,3,180,93777.425192,1.0079120000009425,1476.3193612126938,1428.6961560122843
"147.32.84.165",1257,"205.188.190.2",25,3,186,3,186,0,0,93777.904258,8.931842000005418,166.59497559395894,0
"147.32.84.165",1259,"166.70.74.114",25,3,186,3,186,0,0,93777.904314,8.93191499999375,166.59361402353707,0
"147.32.84.165",1280,"64.12.90.97",25,3,186,3,186,0,0,93777.904371,8.93190599999798,166.59378188712873,0
"147.32.84.165",1281,"209.86.93.229",25,3,186,3,186,0,0,93777.904429,8.93189199999324,166.59404300915486,0
"147.32.84.165",1282,"168.95.5.19",25,3,186,3,186,0,0,93778.105107,8.93126700000721,166.60570107228892,0
"147.32.84.165",1286,"209.85.225.27",25,3,186,3,186,0,0,93778.433371,8.904194999995525,167.11224316187457,0
"147.32.84.165",1228,"46.4.36.120",443,6,366,3,186,3,180,93780.212941,1.0302430000010645,1444.3194469639323,1397.72849706187
"147.32.84.165",1287,"205.188.190.2",25,3,186,3,186,0,0,93781.243411,9.0029649999924,165.27888312364382,0
"147.32.84.165",1291,"65.254.254.55",25,3,186,3,186,0,0,93781.243471,9.003028000006452,165.2777265603232,0
"147.32.84.165",1294,"67.195.168.31",25,3,186,3,186,0,0,93781.417263,9.030018999997992,164.78370643520583,0
"147.32.84.165",1295,"64.12.90.97",25,3,186,3,186,0,0,93781.417392,9.030010999995284,164.7838524228572,0
"147.32.84.165",1299,"74.125.45.27",25,3,186,3,186,0,0,93781.417445,9.03000699999393,164.78392541677988,0
"147.32.84.165",1249,"46.4.36.120",443,6,366,3,186,3,180,93783.424097,1.0307270000048447,1443.6412357423508,1397.0721636216297
"147.32.84.165",1310,"65.55.37.104",25,3,186,3,186,0,0,93784.455062,9.004084000000148,165.2583427697893,0
"147.32.84.165",1249,"46.4.36.120",443,6,366,3,186,3,180,93788.341431,1.0303160000039497,1444.2171139672641,1397.6294651296105
"147.32.84.165",1311,"64.136.52.37",25,3,186,3,186,0,0,93789.372034,9.0026610000059,165.2844642266353,0
"147.32.84.165",1249,"46.4.36.120",443,6,366,3,186,3,180,93798.876264,1.0308809999987716,1443.4255748255844,1396.8634595086298
"147.32.84.165",1312,"67.195.168.31",25,3,186,3,186,0,0,93798.876357,9.029399999999441,164.7950029902421,0
"147.32.84.165",1317,"65.55.37.120",25,3,186,3,186,0,0,93798.876384,9.029500000004191,164.7931779167517,0
"147.32.84.165",1318,"205.188.156.193",25,3,186,3,186,0,0,93798.87641,9.029525000005378,164.7927216546954,0
"147.32.84.165",1322,"209.85.225.27",25,3,186,3,186,0,0,93799.076917,9.029536999994889,164.79250265000766,0
"147.32.84.165",1327,"74.6.136.244",25,3,186,3,186,0,0,93799.077043,9.029533000008087,164.79257565132852,0
"147.32.84.165",1330,"205.188.156.193",25,3,186,3,186,0,0,93799.377879,9.030096999995294,164.78228306969189,0
"147.32.84.165",1334,"65.55.88.22",25,3,186,3,186,0,0,93799.377933,9.030163000003085,164.78107870250975,0
"147.32.84.165",1341,"209.85.225.27",25,3,186,3,186,0,0,93799.907387,9.002164999998058,165.29357104655614,0
"147.32.84.165",1280,"46.4.36.120",443,6,366,3,186,3,180,93802.287306,1.0306750000017928,1443.7140708733712,1397.1426492322946
"147.32.84.165",1346,"65.55.37.104",25,3,186,3,186,0,0,93802.487858,8.929421000008006,166.6401438568823,0
"147.32.84.165",1347,"64.12.90.33",25,3,186,3,186,0,0,93802.487957,8.929345999989891,166.64154351300581,0
"147.32.84.165",1351,"64.12.90.97",25,3,186,3,186,0,0,93802.487988,8.929336000001058,166.6417301353453,0
"147.32.84.165",1352,"64.12.90.97",25,3,186,3,186,0,0,93803.318297,8.902476999995997,167.14449248233598,0
"147.32.84.165",1353,"209.191.88.254",25,3,186,3,186,0,0,93803.318358,8.902539000002434,167.14332843693165,0
"147.32.84.165",1299,"46.4.36.120",443,6,366,3,186,3,180,93805.499014,1.0301550000003772,1444.4428265644056,1397.8478966752311
"147.32.84.165",1355,"67.195.168.31",25,3,186,3,186,0,0,93806.529417,8.902860000001965,167.13730194563,0
"147.32.84.165",1299,"46.4.36.120",443,6,366,3,186,3,180,93810.413953,1.0307259999972302,1443.642636359225,1397.0735190573146
"147.32.84.165",1358,"65.55.37.88",25,3,186,3,186,0,0,93811.444902,9.003270999994129,165.2732656832134,0
"147.32.84.165",1299,"46.4.36.120",443,6,366,3,186,3,180,93819.846238,1.0316770000063116,1442.3118863664663,1395.785696483677
"147.32.84.165",1360,"64.12.90.97",25,3,186,3,186,0,0,93819.846385,9.03171999999904,164.75267169488848,0
"147.32.84.165",1362,"205.188.156.193",25,3,186,3,186,0,0,93819.846439,9.031763999999384,164.7518690701065,0
"147.32.84.165",1369,"65.55.92.168",25,3,186,3,186,0,0,93820.046849,9.03170899998804,164.75287235250497,0
"147.32.84.165",1372,"65.55.92.184",25,3,186,3,186,0,0,93820.347494,9.032343999992008,164.7412897473033,0
"147.32.84.165",1379,"74.6.136.244",25,3,186,3,186,0,0,93820.85069,9.030594999989262,164.77319600776798,0
"147.32.84.165",1381,"67.195.168.31",25,3,186,3,186,0,0,93820.878151,9.003257000003941,165.2735226817749,0
"147.32.84.165",1383,"64.12.90.97",25,3,186,3,186,0,0,93820.878212,9.003246000007493,165.2737246098531,0
"147.32.84.165",1385,"65.54.188.126",25,3,186,3,186,0,0,93820.878267,9.003235000011045,165.27392653842475,0
"147.32.84.165",1327,"46.4.36.120",443,6,366,3,186,3,180,93823.458997,1.0305890000017826,1443.8345450974407,1397.2592371910716
"147.32.84.165",1390,"64.12.90.97",25,3,186,3,186,0,0,93823.45914,9.030401999989408,164.77671758153681,0
"147.32.84.165",1393,"205.188.59.193",25,3,186,3,186,0,0,93824.261118,9.032642999998643,164.73583645453758,0
"147.32.84.165",1394,"207.115.21.24",25,3,186,3,186,0,0,93824.489798,9.004734000001918,165.24641371968158,0
"147.32.84.165",1346,"79.132.91.208",6667,3,186,3,186,0,0,93827.473206,9.031222999998135,164.7617382496598,0
"147.32.84.165",1299,"46.4.36.120",443,6,366,3,186,3,180,93832.489683,1.032175999993342,1441.6146083706637,1395.1109113264488
"147.32.84.165",1396,"74.125.45.27",25,3,186,3,186,0,0,93833.522082,8.900760999997146,167.17671668753684,0
"147.32.84.165",1355,"46.4.36.120",443,6,366,3,186,3,180,93840.918458,1.0307630000024801,1443.5908157320546,1397.0233700632787
"147.32.84.165",1358,"184.82.148.43",80,10,1921,5,979,5,942,93841.120024,0.32261399998969864,24276.689791050863,23359.184661052004
"147.32.84.165",1400,"209.85.225.27",25,3,186,3,186,0,0,93841.226539,8.92263100000855,166.7669547242931,0
"147.32.84.165",1405,"65.254.254.50",25,3,186,3,186,0,0,93841.420013,8.929098000007798,166.64617187522194,0
"147.32.84.165",1406,"168.95.5.2",25,3,186,3,186,0,0,93841.921768,8.930435000002035,166.62122281833538,0
"147.32.84.165",1407,"65.55.92.136",25,3,186,3,186,0,0,93841.921853,8.93048799999815,166.6202339670921,0
"147.32.84.165",1408,"74.6.136.244",25,3,186,3,186,0,0,93841.949439,8.902951999989455,167.13557480729565,0
"147.32.84.165",1360,"46.4.36.120",443,6,366,3,186,3,180,93844.430855,1.0306710000004387,1443.71967388174,1397.148071498458
"147.32.84.165",1413,"67.195.168.31",25,3,186,3,186,0,0,93845.233321,9.029412999996566,164.79476572846605,0
"147.32.84.165",1416,"205.188.190.2",25,3,186,3,186,0,0,93845.434175,9.029636999999639,164.79067763189812,0
"147.32.84.165",1418,"64.136.44.37",25,3,186,3,186,0,0,93845.461781,9.002089999994496,165.29494817324752,0
"147.32.84.165",1381,"46.4.36.120",443,6,366,3,186,3,180,93847.339925,1.0304930000129389,1443.9690516881888,1397.3894048595375
"147.32.84.165",1425,"74.6.136.244",25,3,186,3,186,0,0,93848.370629,9.004205000004731,165.25612200068946,0
"147.32.84.165",1383,"111.88.4.78",6667,3,186,3,186,0,0,93848.37069,9.004267000011168,165.2549841089957,0
"147.32.84.165",1360,"46.4.36.120",443,6,366,3,186,3,180,93854.463903,1.0316549999988638,1442.3426436179138,1395.815461565723
"147.32.84.165",1385,"184.82.148.43",80,10,1917,5,979,5,938,93855.495781,0.30484599999908824,25691.6607074504,24615.70760325687
"147.32.84.165",1427,"74.125.45.27",25,3,186,3,186,0,0,93855.596408,9.002900000006775,165.2800764196959,0
"147.32.84.165",1396,"46.4.36.120",443,6,366,3,186,3,180,93862.191437,1.0308530000038445,1443.4647811030773,1396.9014010674941
"147.32.84.165",1394,"184.82.148.44",80,10,1511,5,594,5,917,93862.392272,0.32371599999896716,14679.533912488607,22661.839390154968
"147.32.84.165",1428,"209.85.225.27",25,3,186,3,186,0,0,93862.498906,9.022924000004423,164.91328088314503,0
"147.32.84.165",1405,"217.163.21.38",80,14,6137,7,809,7,5328,93862.89312,0.1894380000012461,34164.21203748682,225002.3754458959
"147.32.84.165",1435,"205.188.156.193",25,3,186,3,186,0,0,93862.893253,9.030744000003324,164.77047738253376,0
"147.32.84.165",1437,"205.188.156.193",25,3,186,3,186,0,0,93862.893326,9.030794999998761,164.76954686715888,0
"147.32.84.165",1441,"67.195.168.31",25,3,186,3,186,0,0,93862.893381,9.030788000003668,164.76967458425509,0
"147.32.84.165",1442,"209.85.225.27",25,3,186,3,186,0,0,93862.893431,9.030780999994022,164.76980230181476,0
"147.32.84.165",1445,"94.245.120.86",25,3,186,3,186,0,0,93862.893485,9.03077700000722,164.769875283025,0
"147.32.84.165",1449,"65.55.37.72",25,3,186,3,186,0,0,93862.939414,8.984895000001416,165.61128427207726,0
"147.32.84.165",1406,"217.163.21.39",80,10,1448,5,699,5,749,93863.222511,0.13967000000411645,40037.230613841115,42901.124076919885
"147.32.84.165",1452,"139.146.141.66",25,3,186,3,186,0,0,93863.268474,8.955675000004703,166.15163011154587,0
"147.32.84.165",1396,"46.4.36.120",443,6,366,3,186,3,180,93866.305429,1.0304349999933038,1444.0503282688085,1397.468059614976
"147.32.84.165",1408,"217.163.21.34",80,11,3628,6,1419,5,2209,93866.506083,0.259766999995918,43700.70101351744,68030.19629236084
"147.32.84.165",1468,"67.195.168.31",25,3,186,3,186,0,0,93866.506214,8.929308999999193,166.64223401834727,0
"147.32.84.165",1405,"184.82.148.43",80,10,1921,5,983,5,938,93866.552016,0.32365000000572763,24297.852618139445,23185.53993470478
"147.32.84.165",1469,"205.188.156.193",25,3,186,3,186,0,0,93866.658348,8.877546000003349,167.61388789192853,0
"147.32.84.165",1470,"216.32.181.178",25,3,186,3,186,0,0,93866.658411,8.877604000008432,167.61279282096686,0
"147.32.84.165",1471,"76.96.30.116",25,3,186,3,186,0,0,93867.336104,8.902117999998154,167.1512329987435,0
"147.32.84.165",1416,"46.4.36.120",443,6,366,3,186,3,180,93868.413018,1.0293079999973997,1445.6314339379069,1398.9981618753936
"147.32.84.165",1477,"65.54.188.110",25,3,186,3,186,0,0,93869.442606,8.902161999998498,167.15040683378388,0
"147.32.84.165",1418,"114.120.50.74",6667,1,62,1,62,0,0,93876.538863,0,0,0
"147.32.84.165",1416,"46.4.36.120",443,6,366,3,186,3,180,93883.462086,1.0309129999950528,1443.3807702562103,1396.8201002479457
"147.32.84.165",1487,"64.12.90.97",25,3,186,3,186,0,0,93883.862988,9.031205999999656,164.76204839088564,0
"147.32.84.165",1427,"173.192.170.88",80,21,5013,12,1385,9,3628,93883.863127,45.07310100000177,245.82289112966876,643.9317321432768
"147.32.84.165",1489,"209.85.225.27",25,3,186,3,186,0,0,93883.863189,9.031129000009969,164.76345316276155,0
"147.32.84.165",1490,"67.195.168.31",25,3,186,3,186,0,0,93884.064004,9.030048999993596,164.7831589840825,0
"147.32.84.165",1496,"207.171.184.25",25,3,186,3,186,0,0,93884.064061,9.030129000006127,164.78169913176106,0
"147.32.84.165",1498,"65.55.92.136",25,3,186,3,186,0,0,93884.164173,9.029565000004368,164.7919916407136,0
"147.32.84.165",1499,"64.12.90.33",25,3,186,3,186,0,0,93884.493215,9.00179000000935,165.30045690895415,0
"147.32.84.165",1442,"46.4.36.120",443,6,366,3,186,3,180,93887.474625,1.0305789999983972,1443.848555037813,1397.2727951978834
"147.32.84.165",1504,"193.26.47.132",25,3,186,3,186,0,0,93887.57532,9.030572000003303,164.7736156690247,0
"147.32.84.165",1506,"74.6.136.244",25,3,186,3,186,0,0,93888.277337,9.031837999995332,164.75051921887538,0
"147.32.84.165",1509,"64.12.90.97",25,3,186,3,186,0,0,93888.505441,9.004468999992241,165.2512768938715,0
"147.32.84.165",1516,"67.195.168.31",25,3,186,3,186,0,0,93888.5055,9.004547000004095,165.2498454391235,0
"147.32.84.165",1518,"205.188.190.2",25,3,186,3,186,0,0,93888.979752,9.031744000007166,164.7522338984386,0
"147.32.84.165",1471,"117.198.86.115",6667,3,186,3,186,0,0,93890.385157,9.03246100000979,164.73915580686008,0
"147.32.84.165",1442,"46.4.36.120",443,6,366,3,186,3,180,93904.834197,1.0304829999950016,1443.9830642593984,1397.402965412321
"147.32.84.165",1477,"184.82.148.43",80,10,1917,5,979,5,938,93904.83433,0.3407830000069225,22982.367077703126,22019.877751670614
"147.32.84.165",1523,"77.238.184.241",25,3,186,3,186,0,0,93904.946985,9.017139000003226,165.0190819947954,0
"147.32.84.165",1527,"205.188.59.193",25,3,186,3,186,0,0,93905.035475,9.028917999996338,164.803800411146,0
"147.32.84.165",1528,"209.85.225.27",25,3,186,3,186,0,0,93905.13557,9.029091000003973,164.8006427224341,0
"147.32.84.165",1531,"12.53.250.91",25,3,186,3,186,0,0,93905.436393,9.029674000004889,164.79000238537895,0
"147.32.84.165",1544,"74.6.136.244",25,3,186,3,186,0,0,93905.864919,9.002567000003182,165.28619003884936,0
"147.32.84.165",1545,"66.196.94.104",25,3,186,3,186,0,0,93905.86495,9.002660999991349,165.28446422690246,0
"147.32.84.165",1490,"46.4.36.120",443,6,366,3,186,3,180,93908.546332,1.030440999995335,1444.0419199223793,1397.4599225055283
"147.32.84.165",1553,"205.188.190.2",25,3,186,3,186,0,0,93909.248899,9.028974000000744,164.8027782558547,0
"147.32.84.165",1555,"195.90.96.67",25,3,186,3,186,0,0,93909.24915,9.028844999993453,164.8051328825646,0
"147.32.84.165",1558,"205.188.190.2",25,3,186,3,186,0,0,93909.448953,9.029353000005358,164.79586078859882,0
"147.32.84.165",1559,"209.85.225.27",25,3,186,3,186,0,0,93909.449101,9.029304999989108,164.79673684760843,0
"147.32.84.165",1565,"67.195.168.31",25,3,186,3,186,0,0,93909.449158,9.029271999999764,164.79733914318217,0
"147.32.84.165",1575,"74.6.136.244",25,3,186,3,186,0,0,93909.57695,9.002099000004819,165.2947829166513,0
"147.32.84.165",1576,"64.12.90.33",25,3,186,3,186,0,0,93909.950225,9.030794000005699,164.76956511233243,0
"147.32.84.165",1578,"205.188.190.2",25,3,186,3,186,0,0,93910.050958,9.029325999988941,164.79635357077842,0
"147.32.84.165",1499,"212.79.118.91",6667,3,186,3,186,0,0,93926.005421,9.031838000009884,164.75051921860995,0
"147.32.84.165",1504,"46.4.36.120",443,6,366,3,186,3,180,93926.106253,1.0314609999913955,1442.6139233692916,1396.0779903573791
"147.32.84.165",1582,"205.188.156.193",25,3,186,3,186,0,0,93926.206362,9.031723000007332,164.75261697007227,0
"147.32.84.165",1490,"94.100.176.20",25,3,186,3,186,0,0,93926.507044,9.03236700000707,164.74087025016092,0
"147.32.84.165",1586,"208.65.145.13",25,3,186,3,186,0,0,93926.909779,8.930023000008077,166.62891013815462,0
"147.32.84.165",1594,"67.195.168.31",25,3,186,3,186,0,0,93927.137943,8.902734000002965,167.13966743244316,0
"147.32.84.165",1599,"207.115.21.24",25,3,186,3,186,0,0,93927.138018,8.902782999997726,167.13874751303948,0
"147.32.84.165",1528,"173.192.170.88",80,3,186,3,186,0,0,93930.320589,8.930231999998796,166.6250104140856,0
"147.32.84.165",1527,"46.4.36.120",443,6,366,3,186,3,180,93930.521232,1.0305420000076992,1443.9003941507315,1397.322962081353
"147.32.84.165",1427,"184.82.148.43",80,10,1917,5,979,5,938,93930.621775,0.34118399998988025,22955.35546869813,21993.99737450342
"147.32.84.165",1600,"209.85.225.27",25,3,186,3,186,0,0,93930.734572,8.91762999999628,166.86047750362158,0
"147.32.84.165",1601,"64.12.90.97",25,3,186,3,186,0,0,93931.02279,8.930468999998993,166.62058845959464,0
"147.32.84.165",1602,"205.188.190.2",25,3,186,3,186,0,0,93931.123218,8.93023600000015,166.62493577996986,0
"147.32.84.165",1553,"218.189.208.34",6667,10,1198,5,640,5,558,93931.552064,1.4740829999936977,3473.3458021169026,3028.3233712206743
"147.32.84.165",1603,"76.96.30.116",25,3,186,3,186,0,0,93931.892719,8.863223000007565,167.88475253287996,0
"147.32.84.165",1555,"46.4.36.120",443,6,366,3,186,3,180,93946.977872,1.0312560000020312,1442.9006958476548,1396.3555121106338
"147.32.84.165",1604,"205.178.149.7",25,3,186,3,186,0,0,93947.178587,9.030323999992106,164.7781408509042,0
"147.32.84.165",1606,"205.188.59.193",25,3,186,3,186,0,0,93947.479721,9.031145000000834,164.76316126026796,0
"147.32.84.165",1490,"74.125.93.27",25,3,186,3,186,0,0,93947.881734,9.030813999997918,164.7692002072397,0
"147.32.84.165",1607,"65.55.37.120",25,3,186,3,186,0,0,93948.009367,9.003482999993139,165.26937408568816,0
"147.32.84.165",1609,"216.32.180.22",25,3,186,3,186,0,0,93948.081975,9.031082000001334,164.76431063296516,0
"147.32.84.165",1555,"46.4.36.120",443,6,366,3,186,3,180,93951.292458,1.0304520000063349,1444.026504864712,1397.445004707786
"147.32.84.165",1610,"205.188.190.2",25,3,186,3,186,0,0,93951.693787,9.031329999997979,164.7597862109272,0
"147.32.84.165",1528,"173.192.170.88",80,14,1641,9,1082,5,559,93951.693888,125.97287800000049,68.7132034881347,35.49970494442449
"147.32.84.165",1616,"206.183.28.116",25,3,186,3,186,0,0,93951.89465,9.03044200000295,164.77598770907494,0
"147.32.84.165",1617,"67.195.168.31",25,3,186,3,186,0,0,93951.994621,9.03068299998995,164.7715903660505,0
"147.32.84.165",1618,"64.12.90.33",25,3,186,3,186,0,0,93952.094833,9.030842000007397,164.76868934245348,0
"147.32.84.165",1619,"124.108.110.37",25,3,186,3,186,0,0,93952.323142,9.003562000012607,165.26792396141843,0
"147.32.84.165",1601,"88.250.200.14",6667,11,1193,6,635,5,558,93952.79891,7.177356000000145,707.781528462556,621.9560517828445
"147.32.84.165",1555,"46.4.36.120",443,6,366,3,186,3,180,93956.706201,1.0366510000021663,1435.3914673278573,1389.0885167688941
"147.32.84.165",1623,"211.236.185.10",25,3,186,3,186,0,0,93957.743115,9.0023719999881,165.2897702963138,0
"147.32.84.165",1555,"46.4.36.120",443,6,366,3,186,3,180,93968.150443,1.030306999993627,1444.229729594387,1397.6416738010198
"147.32.84.165",1626,"209.85.225.27",25,3,186,3,186,0,0,93968.451189,9.031132999996771,164.7633801872403,0
"147.32.84.165",1634,"205.188.190.2",25,3,186,3,186,0,0,93968.852426,9.030897000004188,164.76768586767292,0
"147.32.84.165",1490,"74.125.39.27",25,3,186,3,186,0,0,93968.952838,9.030945000005886,164.76681011777063,0
"147.32.84.165",1635,"205.188.59.193",25,3,186,3,186,0,0,93969.05284,9.031240999989677,164.76140986623,0
"147.32.84.165",1640,"98.139.54.60",25,3,186,3,186,0,0,93969.180988,9.00347400001192,165.26953929094813,0
"147.32.84.165",1607,"46.4.36.120",443,6,366,3,186,3,180,93972.866419,1.031459999998333,1442.6153219731302,1396.0793438449648
"147.32.84.165",1644,"64.12.90.33",25,3,186,3,186,0,0,93972.966294,9.03109800000675,164.7640187271678,0
"147.32.84.165",1656,"205.188.59.193",25,3,186,3,186,0,0,93972.96644,9.031074999991688,164.76443834220947,0
"147.32.84.165",1657,"85.158.138.179",25,3,186,3,186,0,0,93972.966511,9.031051999991178,164.764857959123,0
"147.32.84.165",1668,"216.163.188.53",25,3,186,3,186,0,0,93973.067033,9.030335999996169,164.7779218847041,0
"147.32.84.165",1670,"205.188.59.193",25,3,186,3,186,0,0,93973.26788,9.030769999997574,164.7700030008958,0
"147.32.84.165",1674,"64.12.90.33",25,3,186,3,186,0,0,93973.268017,9.030754999999772,164.77027668229707,0
"147.32.84.165",1677,"205.188.156.193",25,3,186,3,186,0,0,93973.898124,9.002433000001474,165.28865030150808,0
"147.32.84.165",1619,"46.4.36.120",443,6,366,3,186,3,180,93978.7858,1.031168000001344,1443.0238331659446,1396.4746772573658
"147.32.84.165",1680,"205.188.59.193",25,3,186,3,186,0,0,93979.817251,9.005774999997811,165.2273124745357,0
"147.32.84.165",1682,"205.188.59.193",25,3,186,3,186,0,0,93979.817324,9.005823999992572,165.22641348545423,0
"147.32.84.165",1699,"74.125.113.27",25,3,186,3,186,0,0,93979.81738,9.00581700001203,165.22654191152367,0
"147.32.84.165",1619,"46.4.36.120",443,6,366,3,186,3,180,93989.525451,1.0303100000019185,1444.2255243540578,1397.6376042136042
"147.32.84.165",1707,"74.6.136.244",25,3,186,3,186,0,0,93989.927421,8.929338999994798,166.6416741486539,0
"147.32.84.165",1709,"205.188.156.193",25,3,186,3,186,0,0,93990.026904,8.930301000000327,166.62372298536695,0
"147.32.84.165",1710,"68.6.19.3",25,3,186,3,186,0,0,93990.026983,8.930342999999993,166.62293934286745,0
"147.32.84.165",1490,"66.111.4.71",25,3,186,3,186,0,0,93990.127548,8.930467999991379,166.62060711727946,0
"147.32.84.165",1713,"74.6.136.244",25,3,186,3,186,0,0,93990.227352,8.931004999991274,166.61058861812907,0
"147.32.84.165",1722,"205.188.59.193",25,3,186,3,186,0,0,93990.227527,8.930950000009034,166.6116146656845,0
"147.32.84.165",1736,"205.188.59.193",25,3,186,3,186,0,0,93990.555997,8.90335700000287,167.12797206711136,0
"147.32.84.165",1741,"74.6.136.244",25,3,186,3,186,0,0,93990.556055,8.903366000013193,167.12780312499734,0
"147.32.84.165",1743,"64.12.90.33",25,3,186,3,186,0,0,93990.556112,8.903330999994068,167.1284601236314,0
"147.32.84.165",1746,"64.12.90.33",25,3,186,3,186,0,0,93990.556163,8.903302999999141,167.1289857258754,0
"147.32.84.165",1770,"74.6.136.244",25,3,186,3,186,0,0,93990.556214,8.903273000003537,167.1295488748249,0
"147.32.84.165",1771,"64.12.90.97",25,3,186,3,186,0,0,93990.556269,8.903246000001673,167.13005571223354,0
"147.32.84.165",1635,"46.4.36.120",443,6,366,3,186,3,180,93994.039959,1.030310999994981,1444.224122626322,1397.6362477028922
"147.32.84.165",1775,"212.77.101.4",25,3,186,3,186,0,0,93994.14008,8.930592000004253,166.6182936136027,0
"147.32.84.165",1776,"216.37.174.40",25,3,186,3,186,0,0,93994.34053,8.930615999997826,166.61784584628452,0
"147.32.84.165",1779,"205.188.59.193",25,3,186,3,186,0,0,93994.942261,8.930655999996816,166.61709957258802,0
"147.32.84.165",1781,"205.188.59.193",25,3,186,3,186,0,0,93994.942405,8.93063400000392,166.61751002217164,0
"147.32.84.165",1783,"74.6.136.244",25,3,186,3,186,0,0,93994.942472,8.930615999997826,166.61784584628452,0
"147.32.84.165",1787,"205.188.190.2",25,3,186,3,186,0,0,93994.942541,8.93059400000493,166.61825629954498,0
"147.32.84.165",1790,"205.188.156.193",25,3,186,3,186,0,0,93995.070487,9.004096999997273,165.258104171962,0
"147.32.84.165",1635,"46.4.36.120",443,6,366,3,186,3,180,94000.76433,1.0297019999998156,1445.0782847855655,1398.4628562440957
"147.32.84.165",1793,"74.6.136.244",25,3,186,3,186,0,0,94001.794272,9.001764999993611,165.30091598714876,0
"147.32.84.165",1794,"205.188.59.193",25,3,186,3,186,0,0,94001.794377,9.001785000000382,165.30054872449597,0
"147.32.84.165",1799,"205.188.156.193",25,3,186,3,186,0,0,94001.794426,9.001785000000382,165.30054872449597,0
"147.32.84.165",1801,"74.6.136.244",25,3,186,3,186,0,0,94001.79448,9.001774000003934,165.30075071861944,0
"147.32.84.165",1804,"64.12.90.97",25,3,186,3,186,0,0,94001.794528,9.001776999997674,165.30069562936123,0
"147.32.84.165",1806,"206.46.232.11",25,3,186,3,186,0,0,94001.794595,9.001757000005455,165.30106289239959,0
"147.32.84.165",1635,"46.4.36.120",443,6,366,3,186,3,180,94010.89529,1.0305970000044908,1443.8233373408966,1397.2483909750613
"147.32.84.165",1810,"205.188.59.193",25,3,186,3,186,0,0,94010.995753,9.030032000009669,164.78346920569126,0
"147.32.84.165",1812,"64.12.90.33",25,3,186,3,186,0,0,94010.995879,9.030028000008315,164.78354219927445,0
"147.32.84.165",1817,"74.6.136.244",25,3,186,3,186,0,0,94011.095881,9.030001999999513,164.7840166591414,0
"147.32.84.165",1490,"216.157.130.15",25,3,186,3,186,0,0,94011.196306,9.030354999995325,164.77757518954354,0
"147.32.84.165",1818,"79.170.244.140",25,3,186,3,186,0,0,94011.497251,9.029914000013378,164.78562254278341,0
"147.32.84.165",1824,"64.12.90.97",25,3,186,3,186,0,0,94011.926003,9.002722999997786,165.28332594486866,0
"147.32.84.165",1710,"46.4.36.120",443,6,366,3,186,3,180,94015.109459,1.0308550000045216,1443.4619805825973,1396.8986908863844
"147.32.84.165",1826,"74.6.136.244",25,3,186,3,186,0,0,94015.309605,9.031124999994063,164.7635261388784,0
"147.32.84.165",1827,"98.139.175.224",25,3,186,3,186,0,0,94015.309732,9.031117999998969,164.76365384664112,0
"147.32.84.165",1829,"205.188.190.2",25,3,186,3,186,0,0,94015.912845,9.030649000007543,164.77221072358776,0
"147.32.84.165",1833,"64.12.90.33",25,3,186,3,186,0,0,94016.11294,9.030713999993168,164.77102474966273,0
"147.32.84.165",1834,"74.6.136.244",25,3,186,3,186,0,0,94016.112993,9.030782999994699,164.76976581110114,0
"147.32.84.165",1844,"205.188.59.193",25,3,186,3,186,0,0,94016.113041,9.030784000002313,164.76974756561765,0
"147.32.84.165",1845,"205.188.156.193",25,3,186,3,186,0,0,94016.140514,9.003358000001754,165.27166863738066,0
"147.32.84.165",1775,"46.4.36.120",443,6,366,3,186,3,180,94022.834298,1.030730999991647,1443.635633363175,1397.066741964363
"147.32.84.165",1847,"66.94.237.64",25,3,186,3,186,0,0,94023.865271,8.906331999998656,167.07214597437246,0
"147.32.84.165",1801,"46.4.36.120",443,6,366,3,186,3,180,94031.968835,1.0313989999995101,1442.700642526032,1396.1619121219662
"147.32.84.165",1850,"64.12.90.33",25,3,186,3,186,0,0,94032.069437,9.029647000003024,164.7904951322573,0
"147.32.84.165",1851,"216.32.181.178",25,3,186,3,186,0,0,94032.169154,9.030173999999533,164.7808779764462,0
"147.32.84.165",1855,"205.188.156.193",25,3,186,3,186,0,0,94032.470461,9.029557999994722,164.7921193928728,0
"147.32.84.165",1859,"205.188.59.193",25,3,186,3,186,0,0,94032.470514,9.02960599999642,164.7912433832207,0
"147.32.84.165",1861,"139.78.133.14",25,3,186,3,186,0,0,94032.470563,9.029590999998618,164.79151713518672,0
"147.32.84.165",1867,"205.188.156.193",25,3,186,3,186,0,0,94032.8718,9.029762000005576,164.788396416105,0
"147.32.84.165",1877,"64.12.90.97",25,3,186,3,186,0,0,94032.871907,9.029798000003211,164.787739437745,0
"147.32.84.165",1879,"205.188.190.2",25,3,186,3,186,0,0,94033.000472,9.001155999998446,165.31209991252868,0
"147.32.84.165",1881,"74.6.136.244",25,3,186,3,186,0,0,94033.000531,9.001231000002008,165.31072250003007,0
"147.32.84.165",1824,"46.4.36.120",443,6,366,3,186,3,180,94036.283468,1.0310759999993024,1443.1525901107257,1396.5992807523153
"147.32.84.165",1883,"114.108.154.235",25,3,186,3,186,0,0,94036.885044,9.031103000001167,164.763927506951,0
"147.32.84.165",1890,"64.12.90.33",25,3,186,3,186,0,0,94037.085814,9.02979799998866,164.78773943801056,0
"147.32.84.165",1896,"74.6.136.244",25,3,186,3,186,0,0,94037.085918,9.029816000009305,164.78741095039663,0
"147.32.84.165",1898,"205.188.190.2",25,3,186,3,186,0,0,94037.085944,9.029837999987649,164.78700946816934,0
"147.32.84.165",1912,"209.80.41.20",25,3,186,3,186,0,0,94037.085971,9.029857000001357,164.78666273450136,0
"147.32.84.165",1913,"205.188.190.2",25,3,186,3,186,0,0,94037.314813,9.00156699999934,165.3045519741295,0
"147.32.84.165",1914,"205.188.59.193",25,3,186,3,186,0,0,94037.314871,9.001634000000195,165.30332159694206,0
"147.32.84.165",1833,"173.192.170.88",80,12,1341,7,784,5,557,94044.811721,68.49401999999827,91.57003779308263,65.05677429942223
"147.32.84.165",1824,"61.17.216.12",6667,2,124,2,124,0,0,94044.811853,3.0097469999891473,329.5958098815538,0
"147.32.84.165",1827,"46.4.36.120",443,6,366,3,186,3,180,94053.138415,1.0302270000101998,1444.3418780378188,1397.7502045527278
"147.32.84.165",1915,"208.65.145.3",25,3,186,3,186,0,0,94053.238586,8.930634999996983,166.61749136545194,0
"147.32.84.165",1916,"74.6.136.244",25,3,186,3,186,0,0,94053.539209,8.930908000009367,166.61239820166543,0
"147.32.84.165",1918,"205.188.156.193",25,3,186,3,186,0,0,94053.539335,8.930904000008013,166.61247282455,0
"147.32.84.165",1927,"64.12.90.97",25,3,186,3,186,0,0,94053.940985,8.930240000001504,166.624861145921,0
"147.32.84.165",1928,"205.188.190.2",25,3,186,3,186,0,0,94054.041251,8.930592000004253,166.6182936136027,0
"147.32.84.165",1930,"195.22.8.78",25,3,186,3,186,0,0,94054.041377,8.930586999995285,166.61838689895586,0
"147.32.84.165",1951,"216.32.181.178",25,3,186,3,186,0,0,94054.168868,8.903590000001714,167.12359845856713,0
"147.32.84.165",1827,"46.4.36.120",443,6,366,3,186,3,180,94057.953766,1.0316659999953117,1442.3272648383895,1395.800578875861
"147.32.84.165",1952,"64.12.90.97",25,3,186,3,186,0,0,94058.154181,8.931906999991043,166.5937632357225,0
"147.32.84.165",1954,"64.12.90.33",25,3,186,3,186,0,0,94058.154307,8.931879999989178,166.59426682868587,0
"147.32.84.165",1955,"64.18.6.14",25,3,186,3,186,0,0,94058.154365,8.931846000006772,166.59490098674695,0
"147.32.84.165",1958,"74.6.136.244",25,3,186,3,186,0,0,94058.35525,8.931250000008731,166.60601819437878,0
"147.32.84.165",1959,"64.12.90.97",25,3,186,3,186,0,0,94058.985672,8.902630000011413,167.1416199480482,0
"147.32.84.165",1962,"64.12.90.97",25,3,186,3,186,0,0,94058.98573,8.902700000006007,167.14030574982826,0
"147.32.84.165",1963,"64.71.138.82",25,3,186,3,186,0,0,94058.985782,8.902696999997715,167.14036207234525,0
"147.32.84.165",1827,"46.4.36.120",443,6,366,3,186,3,180,94060.061678,0.9297519999963697,1600.4267804810422,1548.800110142944
"147.32.84.165",1971,"74.6.136.244",25,3,186,3,186,0,0,94060.99169,9.00439400000323,165.25265331564412,0
"147.32.84.165",1913,"101.0.32.121",6667,3,186,3,186,0,0,94060.991751,9.00445700000273,165.25149711965406,0
"147.32.84.165",1827,"46.4.36.120",443,6,366,3,186,3,180,94074.210681,1.0306080000009388,1443.8079269699483,1397.2334777128533
"147.32.84.165",1972,"64.12.90.97",25,3,186,3,186,0,0,94074.51171,9.028814999997849,164.80568047970354,0
"147.32.84.165",1978,"74.6.136.244",25,3,186,3,186,0,0,94074.511819,9.028825999994297,164.80547969369883,0
"147.32.84.165",1979,"205.188.59.193",25,3,186,3,186,0,0,94074.511849,9.02884699999413,164.80509637620034,0
"147.32.84.165",1980,"64.12.90.33",25,3,186,3,186,0,0,94074.91262,9.029018000001088,164.80197514279192,0
"147.32.84.165",1988,"74.6.136.244",25,3,186,3,186,0,0,94074.912747,9.028995000000577,164.80239495092255,0
"147.32.84.165",1989,"74.208.5.21",25,3,186,3,186,0,0,94074.912802,9.028963999997359,164.8029607827028,0
"147.32.84.165",1990,"205.188.156.193",25,3,186,3,186,0,0,94075.012693,9.029292999999598,164.79695586355058,0
"147.32.84.165",1997,"74.6.136.244",25,3,186,3,186,0,0,94075.113299,9.028714000000036,164.80752408371714,0
"147.32.84.165",2001,"64.12.90.97",25,3,186,3,186,0,0,94075.113395,9.028667000005953,164.80838201242983,0
"147.32.84.165",2002,"205.188.190.2",25,3,186,3,186,0,0,94075.241509,9.00124300000607,165.31050211609625,0
"147.32.84.165",1528,"212.117.171.138",65500,32,2697,15,1607,17,1090,94079.126319,42.26919300000009,304.1458586635419,206.2968176373744
"147.32.84.165",1916,"46.4.36.120",443,6,366,3,186,3,180,94079.126445,1.0302249999949709,1444.3446819939952,1397.752918058705
"147.32.84.165",2005,"74.6.136.244",25,3,186,3,186,0,0,94079.126504,9.029250000006869,164.79774067601053,0
"147.32.84.165",2010,"205.188.59.193",25,3,186,3,186,0,0,94079.126554,9.029297000000952,164.7968828580833,0
"147.32.84.165",2011,"205.188.156.193",25,3,186,3,186,0,0,94079.126609,9.029265999997733,164.79744865201374,0
"147.32.84.165",2012,"66.196.94.104",25,3,186,3,186,0,0,94079.126684,9.029211999994004,164.79843423778155,0
"147.32.84.165",2013,"64.12.90.97",25,3,186,3,186,0,0,94079.326807,9.02935399999842,164.7958425376013,0
"147.32.84.165",2016,"205.188.190.2",25,3,186,3,186,0,0,94079.326979,9.029302999988431,164.7967733502693,0
"147.32.84.165",2017,"205.188.156.193",25,3,186,3,186,0,0,94079.327054,9.02929099999892,164.79699236630847,0
"147.32.84.165",2018,"128.121.85.2",25,3,186,3,186,0,0,94079.327128,9.029260999988765,164.79753990961737,0
"147.32.84.165",2019,"61.9.168.122",25,3,186,3,186,0,0,94079.92854,9.029524000012316,164.7927399050017,0
"147.32.84.165",2020,"209.128.52.124",25,3,186,3,186,0,0,94080.156809,9.00203300001158,165.29599480451648,0
"147.32.84.165",2022,"74.6.136.244",25,3,186,3,186,0,0,94081.132885,9.029670999996597,164.79005713503415,0
"147.32.84.165",1955,"212.117.171.138",65500,15,912,8,486,7,426,94095.480593,4.730584999997518,821.8856653039825,720.4182992170711
"147.32.84.165",1958,"46.4.36.120",443,6,366,3,186,3,180,94095.480691,1.030650999993668,1443.7476895759494,1397.1751834605964
"147.32.84.165",2027,"74.6.136.244",25,3,186,3,186,0,0,94095.881919,9.038610999996308,164.62706493294243,0
"147.32.84.165",1962,"64.12.175.136",587,17,1780,9,597,8,1183,94095.882016,25.609251000001677,186.49510678776537,369.55395532650994
"147.32.84.165",2028,"205.188.156.193",25,3,186,3,186,0,0,94095.981775,9.038940000013099,164.62107282467232,0
"147.32.84.165",1916,"79.119.209.87",6667,3,186,3,186,0,0,94096.000233,9.020581000004313,164.95611535435341,0
"147.32.84.165",2032,"209.85.225.27",25,3,186,3,186,0,0,94096.082078,9.039116999992984,164.61784928784027,0
"147.32.84.165",2033,"216.32.181.178",25,3,186,3,186,0,0,94096.182707,9.038753999993787,164.6244604069347,0
"147.32.84.165",2037,"65.55.92.168",25,3,186,3,186,0,0,94096.511477,9.010894000006374,165.13344846792643,0
"147.32.84.165",1989,"46.4.36.120",443,6,366,3,186,3,180,94100.095897,1.0300999999890337,1444.5199495348422,1397.9225318079118
"147.32.84.165",2044,"74.6.136.244",25,3,186,3,186,0,0,94100.295837,9.038507999997819,164.62894097127082,0
"147.32.84.165",1997,"212.117.171.138",65500,14,868,8,486,6,382,94100.295962,22.80674299999373,170.47589829030252,133.99545914999086
"147.32.84.165",2045,"64.12.90.33",25,3,186,3,186,0,0,94100.296015,9.038455000001704,164.6299063279863,0
"147.32.84.165",2051,"204.127.208.75",25,3,186,3,186,0,0,94100.898084,9.038383999999496,164.63119955957646,0
"147.32.84.165",2011,"212.117.171.138",65500,14,852,8,486,6,366,94101.098673,16.131162999998196,241.02415926244345,181.51202117295122
"147.32.84.165",2052,"74.6.136.244",25,3,186,3,186,0,0,94101.09873,9.038503000003402,164.6290320420804,0
"147.32.84.165",2055,"205.188.156.193",25,3,186,3,186,0,0,94101.098784,9.038572000004933,164.62777527237574,0
"147.32.84.165",2056,"64.12.90.33",25,3,186,3,186,0,0,94101.098838,9.038566999995965,164.6278663421607,0
"147.32.84.165",2057,"74.6.136.244",25,3,186,3,186,0,0,94101.098887,9.038560999993933,164.6279756258766,0
"147.32.84.165",2058,"209.86.93.229",25,3,186,3,186,0,0,94101.098939,9.038558999993256,164.62801205381413,0
"147.32.84.165",2060,"64.12.90.33",25,3,186,3,186,0,0,94101.126193,9.011352000001352,165.12505559651612,0
"147.32.84.165",2061,"168.110.95.1",25,3,186,3,186,0,0,94101.126255,9.011333000002196,165.1254037554308,0
"147.32.84.165",2012,"207.115.21.24",25,3,186,3,186,0,0,94102.101584,9.03828199999407,164.63305747718167,0
"147.32.84.165",2016,"46.4.36.120",443,6,366,3,186,3,180,94117.059096,1.0303039999998873,1444.2339348388075,1397.6457433923945
"147.32.84.165",2066,"205.188.156.193",25,3,186,3,186,0,0,94117.059228,8.929615000000922,166.63652352311342,0
"147.32.84.165",2067,"205.188.59.193",25,3,186,3,186,0,0,94117.15967,8.929624000011245,166.63635557310434,0
"147.32.84.165",2018,"212.117.171.138",65500,14,852,8,486,6,366,94117.259789,4.096726999996463,949.0503028401348,714.7168947314595
"147.32.84.165",2068,"74.6.136.244",25,3,186,3,186,0,0,94117.259928,9.029295999993337,164.79690110957688,0
"147.32.84.165",2019,"178.125.53.75",6667,3,186,3,186,0,0,94117.560912,8.929000000003725,166.64800089588746,0
"147.32.84.165",2071,"65.55.37.88",25,3,186,3,186,0,0,94118.089639,8.903225999994902,167.13043114943414,0
"147.32.84.165",2016,"46.4.36.120",443,6,366,3,186,3,180,94121.272793,1.0317369999975199,1442.2280096609668,1395.704525478355
"147.32.84.165",2076,"216.129.105.32",25,3,186,3,186,0,0,94121.876166,9.029123999993317,164.80004040271254,0
"147.32.84.165",2032,"212.117.171.138",65500,9,544,5,302,4,242,94122.076072,55.0362310000055,43.89835488552547,35.17682742482505
"147.32.84.165",2080,"74.6.136.244",25,3,186,3,186,0,0,94122.076196,9.02989499999967,164.78596927207397,0
"147.32.84.165",2084,"205.188.156.193",25,3,186,3,186,0,0,94122.076249,9.029962999993586,164.784728353932,0
"147.32.84.165",2085,"67.195.168.31",25,3,186,3,186,0,0,94122.076297,9.029964999994263,164.7846918566069,0
"147.32.84.165",2086,"74.125.45.27",25,3,186,3,186,0,0,94122.076358,9.029953999997815,164.78489259196226,0
"147.32.84.165",2087,"12.30.177.163",25,3,186,3,186,0,0,94122.304766,9.001764000000549,165.30093435019063,0
"147.32.84.165",2089,"209.85.225.27",25,3,186,3,186,0,0,94123.079635,9.029420999999274,164.79461972147712,0
"147.32.84.165",1528,"59.48.7.168",6667,6,366,3,186,3,180,94138.029351,1.938016999993124,767.7951225429289,743.0275379447698
"147.32.84.165",1185,"46.4.36.120",443,6,366,3,186,3,180,94138.129371,1.0308099999965634,1443.5249949117303,1396.959672495223
"147.32.84.165",2091,"200.73.70.106",25,3,186,3,186,0,0,94138.32984,9.031007999990834,164.76566071046668,0
"147.32.84.165",2092,"205.188.190.2",25,3,186,3,186,0,0,94138.531121,9.029853999993065,164.78671748193744,0
"147.32.84.165",2094,"209.85.225.27",25,3,186,3,186,0,0,94139.031887,9.031085999988136,164.76423765668434,0
"147.32.84.165",2095,"74.6.136.244",25,3,186,3,186,0,0,94139.032013,9.03102100000251,164.765423532908,0
"147.32.84.165",2098,"67.195.168.31",25,3,186,3,186,0,0,94139.160447,9.003047999998671,165.27735940097395,0
"147.32.84.165",2099,"65.54.188.126",25,3,186,3,186,0,0,94139.160478,9.00314200000139,165.27563377316167,0
"147.32.84.165",2100,"209.85.225.27",25,3,186,3,186,0,0,94139.967612,8.998405000005732,165.36263926763155,0
"147.32.84.165",2102,"12.30.177.163",25,3,186,3,186,0,0,94139.96767,8.998466000004555,165.3615182853663,0
"147.32.84.165",2103,"216.32.181.178",25,3,186,3,186,0,0,94139.967724,8.998462000003201,165.36159179196073,0
"147.32.84.165",2071,"46.4.36.120",443,6,366,3,186,3,180,94142.946741,1.0306669999990845,1443.725276933599,1397.1534938067086
"147.32.84.165",2105,"205.188.59.193",25,3,186,3,186,0,0,94143.146998,8.92866900000081,166.65417880311892,0
"147.32.84.165",2106,"206.54.145.17",25,3,186,3,186,0,0,94143.147129,8.928661999991164,166.65430945884978,0
"147.32.84.165",2107,"74.6.136.244",25,3,186,3,186,0,0,94143.348356,8.927947000003769,166.6676560691245,0
"147.32.84.165",2110,"213.46.255.2",25,3,186,3,186,0,0,94143.348428,8.927997000006144,166.66672267015502,0
"147.32.84.165",2112,"205.188.190.2",25,3,186,3,186,0,0,94143.977689,8.900219999995898,167.1868785266753,0
"147.32.84.165",2114,"66.102.142.26",25,3,186,3,186,0,0,94143.977725,8.900249999991502,167.18631499131158,0
"147.32.84.165",2115,"212.82.111.207",25,3,186,3,186,0,0,94144.150235,8.92873200000031,166.65300291238987,0
"147.32.84.165",2084,"89.200.164.105",6667,3,186,3,186,0,0,94159.298671,9.02883500000462,164.80531541436284,0
"147.32.84.165",2086,"46.4.36.120",443,6,366,3,186,3,180,94159.499488,1.0309479999996256,1443.3317684311337,1396.7726791269035
"147.32.84.165",2117,"210.159.5.11",25,3,186,3,186,0,0,94160.00082,9.028972000000067,164.80281476119197,0
"147.32.84.165",2118,"205.188.156.193",25,3,186,3,186,0,0,94160.10149,9.02879500000563,164.80604554639598,0
"147.32.84.165",2119,"207.115.20.23",25,3,186,3,186,0,0,94160.53062,9.000781999988249,165.3189689520247,0
"147.32.84.165",2120,"208.67.174.100",25,3,186,3,186,0,0,94160.903969,9.028762999994797,164.80662965689294,0
"147.32.84.165",2092,"46.4.36.120",443,6,366,3,186,3,180,94164.114462,1.0307759999996051,1443.5726093744615,1397.0057510075435
"147.32.84.165",2121,"67.195.168.31",25,3,186,3,186,0,0,94164.114569,9.030425999997533,164.77627965728377,0
"147.32.84.165",2122,"74.6.136.244",25,3,186,3,186,0,0,94164.315247,9.030566999994335,164.77370690023488,0
"147.32.84.165",2123,"65.55.92.168",25,3,186,3,186,0,0,94164.916359,9.031119999999646,164.76361735865078,0
"147.32.84.165",2127,"209.85.225.27",25,3,186,3,186,0,0,94165.117733,9.030030999987503,164.7834874544793,0
"147.32.84.165",2132,"216.32.181.178",25,3,186,3,186,0,0,94165.145477,9.00235199999588,165.29013751080618,0
"147.32.84.165",2102,"109.201.233.98",6667,3,186,3,186,0,0,94180.369837,8.92924800000037,166.6433724318037,0
"147.32.84.165",2105,"46.4.36.120",443,6,366,3,186,3,180,94181.072198,1.0306860000127926,1443.6986628144084,1397.127738207492
"147.32.84.165",2140,"67.231.144.172",25,3,186,3,186,0,0,94181.172933,8.929264000005787,166.64307382994116,0
"147.32.84.165",2032,"212.117.171.138",65500,9,544,5,302,4,242,94181.574073,19.870741000006092,121.58580296523715,97.42968317081917
"147.32.84.165",2143,"67.195.168.31",25,3,186,3,186,0,0,94181.597061,8.906558000002406,167.06790659192902,0
"147.32.84.165",2144,"74.6.136.244",25,3,186,3,186,0,0,94181.597154,8.906562999996822,167.0678128028209,0
"147.32.84.165",2145,"64.136.52.37",25,3,186,3,186,0,0,94181.597217,8.90652799999225,167.068469329608,0
"147.32.84.165",2146,"98.137.54.238",25,3,186,3,186,0,0,94181.975011,8.929818999997224,166.63271674380664,0
"147.32.84.165",2147,"173.51.1.83",25,3,186,3,186,0,0,94182.10312,8.901962999996613,167.15414341764463,0
"147.32.84.165",2118,"46.4.36.120",443,6,366,3,186,3,180,94185.085156,1.0310979999921983,1443.1217983268891,1396.5694822518283
"147.32.84.165",2148,"209.85.225.27",25,3,186,3,186,0,0,94185.285948,9.030750999998418,164.77034966419302,0
"147.32.84.165",2151,"205.188.156.193",25,3,186,3,186,0,0,94185.286075,9.030736000000616,164.77062334674588,0
"147.32.84.165",2154,"208.65.144.2",25,3,186,3,186,0,0,94185.887909,9.031384000001708,164.75880108737692,0
"147.32.84.165",2158,"125.5.96.59",25,3,186,3,186,0,0,94186.088834,9.032360000011977,164.740997922805,0
"147.32.84.165",2159,"205.188.156.193",25,3,186,3,186,0,0,94186.088893,9.032423000011477,164.73984887533604,0
"147.32.84.165",2162,"65.55.92.152",25,3,186,3,186,0,0,94186.088955,9.032414000001154,164.74001302418267,0
"147.32.84.165",2165,"74.6.136.244",25,3,186,3,186,0,0,94186.116493,9.004920000006678,165.24300049294126,0
"147.32.84.165",2123,"46.4.36.120",443,6,366,3,186,3,180,94201.341835,1.0298190000030445,1444.914106261004,1398.3039738009718
"147.32.84.165",2166,"98.137.54.238",25,3,186,3,186,0,0,94202.144066,9.028369999999995,164.81380359909937,0
"147.32.84.165",2102,"212.117.171.138",65500,7,424,4,242,3,182,94202.144192,302.6472389999981,6.396886376353205,4.810881489654063
"147.32.84.165",2168,"209.85.225.27",25,3,186,3,186,0,0,94202.166688,9.005795999997645,165.22692719226475,0
"147.32.84.165",2170,"213.46.255.2",25,3,186,3,186,0,0,94202.371857,9.000740999996196,165.3197220096244,0
"147.32.84.165",2171,"207.115.20.23",25,3,186,3,186,0,0,94202.544539,9.029374000005191,164.7954775158438,0
"147.32.84.165",2173,"125.5.96.59",25,3,186,3,186,0,0,94202.946313,9.028537000005599,164.81075505356816,0
"147.32.84.165",2174,"65.54.188.126",25,3,186,3,186,0,0,94202.946417,9.028535000004922,164.8107915624394,0
"147.32.84.165",2175,"64.12.90.97",25,3,186,3,186,0,0,94203.047212,9.028218999999808,164.81656016541376,0
"147.32.84.165",2123,"46.4.36.120",443,6,366,3,186,3,180,94206.357687,1.030188000004273,1444.3965567389916,1397.8031194248306
"147.32.84.165",2177,"67.195.168.31",25,3,186,3,186,0,0,94206.95902,8.928303000007872,166.6610104964726,0
"147.32.84.165",2145,"87.239.184.119",6667,6,366,3,186,3,180,94207.159311,1.0205490000080317,1458.0387614786644,1411.0052530438688
"147.32.84.165",2178,"200.95.144.74",25,3,186,3,186,0,0,94207.159447,8.928379000004497,166.65959184743954,0
"147.32.84.165",2180,"202.137.234.30",25,3,186,3,186,0,0,94207.159507,8.92844000000332,166.65845321236932,0
"147.32.84.165",2181,"74.6.136.244",25,3,186,3,186,0,0,94207.388164,8.900717999989865,167.17752433025,0
"147.32.84.165",2183,"209.85.225.27",25,3,186,3,186,0,0,94208.180102,8.910757000005106,166.98917948263514,0
"147.32.84.165",2184,"213.46.255.2",25,3,186,3,186,0,0,94208.18016,8.910819999990053,166.98799885999952,0
"147.32.84.165",2185,"24.71.223.11",25,3,186,3,186,0,0,94208.180214,8.9108159999887,166.98807381971383,0
"147.32.84.165",2148,"46.4.36.120",443,6,366,3,186,3,180,94223.111662,1.0305060000100639,1443.9508357888924,1397.3717765698957
"147.32.84.165",2186,"205.188.59.193",25,3,186,3,186,0,0,94223.312389,9.030610999994678,164.77290407048613,0
"147.32.84.165",2188,"209.65.160.73",25,3,186,3,186,0,0,94223.512498,9.031195000003208,164.7622490710777,0
"147.32.84.165",2189,"205.188.156.193",25,3,186,3,186,0,0,94223.913882,9.03115200001048,164.76303355300337,0
"147.32.84.165",2191,"74.125.93.27",25,3,186,3,186,0,0,94224.014355,9.030918999997084,164.76728448128927,0
"147.32.84.165",2192,"67.195.168.31",25,3,186,3,186,0,0,94224.142446,9.002793000006932,165.2820408065424,0
"147.32.84.165",2194,"220.181.12.60",25,3,186,3,186,0,0,94224.142504,9.002857999992557,165.28084748212515,0
"147.32.84.165",2168,"46.4.36.120",443,6,366,3,186,3,180,94227.926508,1.0306369999889284,1443.7673012088492,1397.1941624601766
"147.32.84.165",2200,"209.85.225.27",25,3,186,3,186,0,0,94228.127155,9.032363000005716,164.74094320600912,0
"147.32.84.165",2203,"65.54.188.126",25,3,186,3,186,0,0,94228.127287,9.032354000009946,164.74110735677118,0
"147.32.84.165",2175,"115.60.169.243",6667,6,366,3,186,3,180,94228.328755,2.230444000000716,667.1317459660597,645.6113670639288
"147.32.84.165",2204,"64.12.90.33",25,3,186,3,186,0,0,94228.957365,9.004632000011043,165.2482855488348,0
"147.32.84.165",2205,"72.18.139.34",25,3,186,3,186,0,0,94229.130942,9.031344999995781,164.75951256437386,0
"147.32.84.165",2180,"46.4.36.120",443,6,366,3,186,3,180,94230.559502,1.0079229999973904,1476.3032493591797,1428.6805638959804
"147.32.84.165",2210,"212.82.111.207",25,3,186,3,186,0,0,94231.567667,9.003668000004836,165.26597826565802,0
"147.32.84.165",2183,"46.4.36.120",443,6,366,3,186,3,180,94244.384477,1.0306710000004387,1443.71967388174,1397.148071498458
"147.32.84.165",2211,"218.102.53.136",25,3,186,3,186,0,0,94244.585746,8.927775000003749,166.6708670412701,0
"147.32.84.165",2213,"74.6.136.244",25,3,186,3,186,0,0,94244.885998,9.028837999998359,164.80526065483403,0
"147.32.84.165",2214,"61.19.247.49",25,3,186,3,186,0,0,94244.986189,9.028984999997192,164.80257747692158,0
"147.32.84.165",2217,"85.13.145.159",25,3,186,3,186,0,0,94245.086109,9.02939100000367,164.79516724875413,0
"147.32.84.165",2218,"205.188.190.2",25,3,186,3,186,0,0,94245.415311,9.000969000000623,165.31553436078903,0
"147.32.84.165",2186,"46.4.36.120",443,6,366,3,186,3,180,94249.099133,1.0310800000006566,1443.146991503135,1396.5938627449693
"147.32.84.165",2219,"66.45.104.194",25,3,186,3,186,0,0,94249.099269,9.029183999999077,164.798945286767,0
"147.32.84.165",2220,"67.195.168.31",25,3,186,3,186,0,0,94249.90202,9.028381000010995,164.81360279303541,0
"147.32.84.165",2228,"205.188.156.193",25,3,186,3,186,0,0,94250.102726,9.028237000005902,164.81623156315317,0
"147.32.84.165",2231,"200.196.152.9",25,3,186,3,186,0,0,94250.13051,9.000577999991947,165.3227159412797,0
"147.32.84.165",2200,"175.100.132.205",6667,6,366,3,186,3,180,94252.510164,1.6363429999910295,909.3448011866444,880.0110979225591
"147.32.84.165",2203,"46.4.36.120",443,6,366,3,186,3,180,94254.146737,0.9994389999919804,1488.8352365796611,1440.8082934641882
"147.32.84.165",2232,"218.102.53.146",25,3,186,3,186,0,0,94255.146383,9.00205399999686,165.2956092021353,0
"147.32.84.165",2233,"209.85.225.27",25,3,186,3,186,0,0,94265.5539,9.028327000007266,164.81458857203583,0
"147.32.84.165",2236,"85.13.145.159",25,3,186,3,186,0,0,94265.955346,9.029549999992014,164.79226539543123,0
"147.32.84.165",2237,"67.195.168.31",25,3,186,3,186,0,0,94265.955472,9.029525000005378,164.7927216546954,0
"147.32.84.165",2238,"216.82.253.99",25,3,186,3,186,0,0,94265.955526,9.029494999995222,164.79326916962546,0
"147.32.84.165",2240,"208.65.144.13",25,3,186,3,186,0,0,94266.055494,9.029842000003555,164.7869364712488,0
"147.32.84.165",2211,"46.4.36.120",443,6,366,3,186,3,180,94266.155697,1.030720000009751,1443.6510400360166,1397.081651647758
"147.32.84.165",2242,"76.96.62.116",25,3,186,3,186,0,0,94266.456343,9.030494999999064,164.7750206384206,0
"147.32.84.165",2243,"205.188.156.193",25,3,186,3,186,0,0,94267.186658,8.902954999997746,167.135518488005,0
"147.32.84.165",2245,"205.188.156.193",25,3,186,3,186,0,0,94267.186715,8.903016999989632,167.13435456786536,0
"147.32.84.165",2246,"217.72.192.149",25,3,186,3,186,0,0,94267.186769,8.903012999988277,167.13442965903332,0
"147.32.84.165",2213,"46.4.36.120",443,6,366,3,186,3,180,94270.169261,1.0303149999963352,1444.218515701793,1397.6308216468963
"147.32.84.165",2247,"65.54.188.72",25,3,186,3,186,0,0,94270.970959,8.932172000000719,166.5888207257854,0
"147.32.84.165",2248,"64.12.90.97",25,3,186,3,186,0,0,94271.171988,8.931354999993346,166.60405951852866,0
"147.32.84.165",2249,"67.195.168.31",25,3,186,3,186,0,0,94271.172018,8.931425999995554,166.60273510643663,0
"147.32.84.165",2250,"65.55.37.88",25,3,186,3,186,0,0,94271.199761,8.903707000004943,167.12140235512848,0
"147.32.84.165",2231,"62.178.214.33",6667,3,186,3,186,0,0,94276.089842,9.030274999997346,164.77903496852946,0
"147.32.84.165",2213,"94.100.176.20",25,3,186,3,186,0,0,94286.524988,9.02931099999114,164.79662733972285,0
"147.32.84.165",2257,"98.139.175.225",25,3,186,3,186,0,0,94286.926144,9.029613999999128,164.79109738247323,0
"147.32.84.165",2220,"46.4.36.120",443,6,366,3,186,3,180,94287.025846,1.0311839999922086,1443.001443012346,1396.4530093667865
"147.32.84.165",2261,"89.234.65.83",25,3,186,3,186,0,0,94287.427357,9.030517000006512,164.77461921603458,0
"147.32.84.165",2264,"205.188.190.1",25,3,186,3,186,0,0,94288.057304,9.001806999993278,165.30014473773002,0
"147.32.84.165",2265,"64.12.90.97",25,3,186,3,186,0,0,94288.129611,9.030049000008148,164.78315898381695,0
"147.32.84.165",2266,"65.55.37.104",25,3,186,3,186,0,0,94288.129738,9.030044999992242,164.78323197739084,0
"147.32.84.165",2238,"46.4.36.120",443,6,366,3,186,3,180,94291.942265,1.0304769999929704,1443.9914719204316,1397.4111018584822
"147.32.84.165",2267,"165.21.74.122",25,3,186,3,186,0,0,94292.142621,9.029872999992222,164.7863707497638,0
"147.32.84.165",2268,"67.195.168.31",25,3,186,3,186,0,0,94292.142753,9.029864000011003,164.7865349908024,0
"147.32.84.165",2270,"205.188.59.193",25,3,186,3,186,0,0,94292.142813,9.029853000000003,164.78673573091385,0
"147.32.84.165",2271,"65.55.92.136",25,3,186,3,186,0,0,94292.972972,9.001589999999851,165.30412960377274,0
"147.32.84.165",2238,"46.4.36.120",443,6,366,3,186,3,180,94294.852012,1.0305930000031367,1443.8289411974185,1397.253814062018
"147.32.84.165",2272,"66.11.225.98",25,3,186,3,186,0,0,94295.882851,9.001579999996466,165.30431324285118,0
"147.32.84.165",2238,"46.4.36.120",443,6,366,3,186,3,180,94307.493224,1.0308509999886155,1443.4675816548008,1396.9041112788395
"147.32.84.165",2274,"64.12.90.33",25,3,186,3,186,0,0,94307.895287,9.030738999994355,164.77056861026878,0
"147.32.84.165",2213,"74.125.93.27",25,3,186,3,186,0,0,94308.396475,9.030956000002334,164.76660942646774,0
"147.32.84.165",2278,"65.54.188.126",25,3,186,3,186,0,0,94308.524308,9.003356000001077,165.27170535074055,0
"147.32.84.165",2279,"216.82.242.115",25,3,186,3,186,0,0,94308.998769,9.030437000008533,164.7760789426463,0
"147.32.84.165",2281,"64.12.90.97",25,3,186,3,186,0,0,94309.098494,9.031009999991511,164.76562422158747,0
"147.32.84.165",2261,"46.4.36.120",443,6,366,3,186,3,180,94313.11358,1.0305159999988973,1443.9368238839495,1397.3582166618867
"147.32.84.165",2283,"205.188.190.2",25,3,186,3,186,0,0,94313.113713,9.028975000008359,164.80276000305932,0
"147.32.84.165",2285,"212.27.48.6",25,3,186,3,186,0,0,94313.113772,9.029034999999567,164.80166485123507,0
"147.32.84.165",2288,"216.32.181.178",25,3,186,3,186,0,0,94313.916184,9.028940000003786,164.8033988485222,0
"147.32.84.165",2293,"67.195.168.31",25,3,186,3,186,0,0,94314.14432,9.001302999997279,165.30940020577575,0
"147.32.84.165",2261,"222.23.80.7",6667,3,186,3,186,0,0,94316.82544,9.028974000000744,164.8027782558547,0
"147.32.84.165",2271,"46.4.36.120",443,6,366,3,186,3,180,94328.964354,1.030467000004137,1444.0054848860043,1397.4246627929074
"147.32.84.165",2297,"205.188.190.2",25,3,186,3,186,0,0,94329.465561,9.029154999996535,164.79947459098565,0
"147.32.84.165",2300,"212.74.114.146",25,3,186,3,186,0,0,94329.465618,9.029219999996712,164.798288224292,0
"147.32.84.165",2274,"74.125.39.27",25,3,186,3,186,0,0,94329.566187,9.028762000001734,164.80664791027985,0
"147.32.84.165",2301,"74.6.136.244",25,3,186,3,186,0,0,94329.99506,8.900869000004604,167.17468822417567,0
"147.32.84.165",2302,"205.188.190.2",25,3,186,3,186,0,0,94330.06762,8.928341999999247,166.66028250263324,0
"147.32.84.165",2303,"98.139.175.225",25,3,186,3,186,0,0,94330.067746,8.928318000005675,166.66073049806855,0
"147.32.84.165",2304,"64.12.90.33",25,3,186,3,186,0,0,94330.167921,8.92888700000185,166.6501099184805,0
"147.32.84.165",2281,"46.4.36.120",443,6,366,3,186,3,180,94334.180447,1.0310089999984484,1443.246373215209,1396.6900385953634
"147.32.84.165",2305,"216.32.181.178",25,3,186,3,186,0,0,94334.180578,8.930464999997639,166.62066308981596,0
"147.32.84.165",2308,"67.195.168.31",25,3,186,3,186,0,0,94334.180632,8.930532999991556,166.61939438568862,0
"147.32.84.165",2313,"209.85.225.27",25,3,186,3,186,0,0,94334.180681,8.930531999998493,166.6194130428345,0
"147.32.84.165",2315,"65.54.188.72",25,3,186,3,186,0,0,94334.983325,8.929568000006839,166.63740059976703,0
"147.32.84.165",2316,"205.188.156.193",25,3,186,3,186,0,0,94335.184076,8.929615999993985,166.63650486213544,0
"147.32.84.165",2318,"202.3.77.187",25,3,186,3,186,0,0,94335.211674,8.902138999997987,167.1508386917275,0
"147.32.84.165",2319,"67.195.168.31",25,3,186,3,186,0,0,94335.986342,8.929780999998911,166.63342583655538,0
"147.32.84.165",2288,"83.148.82.159",6667,3,186,3,186,0,0,94350.536039,9.030924999999115,164.76717501254254,0
"147.32.84.165",2293,"46.4.36.120",443,6,366,3,186,3,180,94350.635876,1.032565000001341,1441.071506392399,1394.5853287668376
"147.32.84.165",2320,"216.82.255.3",25,3,186,3,186,0,0,94350.937498,9.030612000002293,164.77288582430762,0
"147.32.84.165",2274,"66.111.4.71",25,3,186,3,186,0,0,94351.037093,9.031268999999156,164.76089904975026,0
"147.32.84.165",2321,"212.57.28.123",25,3,186,3,186,0,0,94351.138052,9.03033900000446,164.77786714311225,0
"147.32.84.165",2324,"209.85.225.27",25,3,186,3,186,0,0,94351.668683,9.001678000000538,165.3025135980104,0
"147.32.84.165",2325,"209.85.225.27",25,3,186,3,186,0,0,94351.66874,9.001743000000715,165.30131997768453,0
"147.32.84.165",2326,"168.95.6.53",25,3,186,3,186,0,0,94351.668793,9.001739999992424,165.30137506762608,0
"147.32.84.165",2303,"46.4.36.120",443,6,366,3,186,3,180,94355.15183,1.0306560000026366,1443.740685540271,1397.1684053615525
"147.32.84.165",2329,"205.188.59.193",25,3,186,3,186,0,0,94355.953788,9.03120700000727,164.76203014711123,0
"147.32.84.165",2331,"67.195.168.31",25,3,186,3,186,0,0,94356.155037,9.030529999989085,164.77438201321502,0
"147.32.84.165",2332,"64.12.90.33",25,3,186,3,186,0,0,94356.155091,9.030600000012782,164.773104776858,0
"147.32.84.165",2333,"209.85.225.27",25,3,186,3,186,0,0,94356.155145,9.030595000003814,164.77319600750246,0
"147.32.84.165",2335,"65.55.92.168",25,3,186,3,186,0,0,94356.182727,9.003060999995796,165.2771207482316,0
"147.32.84.165",2337,"193.109.254.67",25,3,186,3,186,0,0,94356.957558,9.030960000003688,164.7665364478851,0
"147.32.84.165",2316,"113.21.74.83",6667,6,366,3,186,3,180,94371.507113,1.6164459999999963,920.538019828688,890.8432449955045
"147.32.84.165",2318,"46.4.36.120",443,6,366,3,186,3,180,94371.907904,1.030942999990657,1443.338768499796,1396.7794533868994
"147.32.84.165",2338,"74.6.140.31",25,3,186,3,186,0,0,94372.00817,9.03112699999474,164.76348965094465,0
"147.32.84.165",2274,"216.157.130.15",25,3,186,3,186,0,0,94372.109021,9.030247000002419,164.77954589720542,0
"147.32.84.165",2339,"205.188.190.2",25,3,186,3,186,0,0,94372.610329,9.031323000002885,164.75991391289236,0
"147.32.84.165",2340,"68.6.19.3",25,3,186,3,186,0,0,94372.939129,9.00301399998716,165.27798357329246,0
"147.32.84.165",2341,"212.64.225.221",25,3,186,3,186,0,0,94373.123762,9.01873899999191,164.98980622472106,0
"147.32.84.165",2316,"46.4.36.120",443,6,366,3,186,3,180,94376.926417,1.0301310000068042,1444.4764791955308,1397.8804637376106
"147.32.84.165",2342,"65.54.188.126",25,3,186,3,186,0,0,94377.126943,9.029592999999295,164.79148063485434,0
"147.32.84.165",2344,"74.6.136.244",25,3,186,3,186,0,0,94377.127075,9.029584000003524,164.7916448863446,0
"147.32.84.165",2352,"205.188.156.193",25,3,186,3,186,0,0,94377.127133,9.029574999993201,164.79180913842794,0
"147.32.84.165",2353,"65.55.92.152",25,3,186,3,186,0,0,94377.929305,9.029790000000503,164.7878854325424,0
"147.32.84.165",2357,"209.85.225.27",25,3,186,3,186,0,0,94377.956784,9.002434000009089,165.28863194092816,0
"147.32.84.165",2331,"46.4.36.120",443,6,366,3,186,3,180,94393.078383,1.0304869999963557,1443.9774592064357,1397.3975411675183
"147.32.84.165",2358,"74.6.140.31",25,3,186,3,186,0,0,94393.179042,8.92918199999258,166.64460417552655,0
"147.32.84.165",2359,"67.195.168.31",25,3,186,3,186,0,0,94393.680246,8.930481999996118,166.6203459119728,0
"147.32.84.165",2360,"205.188.156.193",25,3,186,3,186,0,0,94393.98121,8.931005999998888,166.6105699626879,0
"147.32.84.165",2362,"68.6.19.3",25,3,186,3,186,0,0,94393.98134,8.931001000004471,166.61066323912124,0
"147.32.84.165",2367,"65.55.92.136",25,3,186,3,186,0,0,94394.109119,8.902967000001809,167.13529321176836,0
"147.32.84.165",2369,"64.12.90.33",25,3,186,3,186,0,0,94394.182034,8.930712000001222,166.6160548005351,0
"147.32.84.165",2341,"112.110.18.151",6667,3,186,3,186,0,0,94398.194681,8.931298000010429,166.60512279382712,0
"147.32.84.165",2339,"46.4.36.120",443,6,366,3,186,3,180,94398.194813,1.0308170000062091,1443.5151923096312,1396.9501861060946
"147.32.84.165",2370,"74.6.136.244",25,3,186,3,186,0,0,94398.194872,8.931228000001283,166.6064285896392,0
"147.32.84.165",2371,"65.54.188.126",25,3,186,3,186,0,0,94398.997031,8.93064599999343,166.6172861404533,0
"147.32.84.165",2372,"209.85.225.27",25,3,186,3,186,0,0,94398.997163,8.930636000004597,166.6174727084649,0
"147.32.84.165",2373,"128.242.120.13",25,3,186,3,186,0,0,94399.225869,8.903108999991673,167.13262749017133,0
"147.32.84.165",2357,"46.4.36.120",443,6,366,3,186,3,180,94414.147863,1.030596999989939,1443.8233373612832,1397.2483909947903
"147.32.84.165",2379,"205.188.190.2",25,3,186,3,186,0,0,94414.649646,9.029274999993504,164.79728438895376,0
"147.32.84.165",2381,"67.195.168.31",25,3,186,3,186,0,0,94414.950633,9.029507999992347,164.79303191284188,0
"147.32.84.165",2382,"64.12.90.33",25,3,186,3,186,0,0,94415.050606,9.029394999990473,164.79509424513714,0
"147.32.84.165",2383,"68.6.19.3",25,3,186,3,186,0,0,94415.050732,9.02939100000367,164.79516724875413,0
"147.32.84.165",2384,"203.183.81.32",25,3,186,3,186,0,0,94415.15124,9.029661999986274,164.79022138395234,0
"147.32.84.165",2385,"74.6.136.244",25,3,186,3,186,0,0,94415.178897,9.002126999999746,165.29426878781447,0
"147.32.84.165",2386,"81.169.145.102",25,3,186,3,186,0,0,94415.179004,9.002068999994663,165.2953337728118,0
"147.32.84.165",2357,"46.4.36.120",443,6,366,3,186,3,180,94418.762067,1.0314559999969788,1442.6209164563088,1396.084757860944
"147.32.84.165",2387,"209.85.225.27",25,3,186,3,186,0,0,94419.163691,9.029808000006597,164.787556944612,0
"147.32.84.165",2389,"65.55.92.184",25,3,186,3,186,0,0,94419.163818,9.029804000005242,164.7876299418167,0
"147.32.84.165",2390,"141.194.10.236",25,3,186,3,186,0,0,94419.793726,9.00182199999108,165.29986929329135,0
"147.32.84.165",2392,"98.139.175.224",25,3,186,3,186,0,0,94419.966082,9.030085999998846,164.78248379917866,0
"147.32.84.165",2396,"64.12.90.33",25,3,186,3,186,0,0,94419.966216,9.030073000001721,164.78272102559043,0
"147.32.84.165",2399,"98.139.175.225",25,3,186,3,186,0,0,94420.166673,9.030291000002762,164.7787430105569,0
"147.32.84.165",2372,"46.4.36.120",443,6,366,3,186,3,180,94435.61847,1.0309879999986151,1443.2757704279766,1396.7184875109451
"147.32.84.165",2400,"93.17.128.25",25,3,186,3,186,0,0,94435.91909,9.029714000003878,164.78927239548904,0
"147.32.84.165",2402,"67.195.168.31",25,3,186,3,186,0,0,94436.019193,9.029999999998836,164.78405315616743,0
"147.32.84.165",2404,"64.12.90.33",25,3,186,3,186,0,0,94436.120109,9.029831000007107,164.78713721207285,0
"147.32.84.165",2408,"205.188.190.2",25,3,186,3,186,0,0,94436.120176,9.029884000003221,164.78617001054158,0
"147.32.84.165",2410,"216.32.180.22",25,3,186,3,186,0,0,94436.120252,9.029857000001357,164.78666273450136,0
"147.32.84.165",2411,"65.54.188.110",25,3,186,3,186,0,0,94436.64967,9.00177299999632,165.30076908189181,0
"147.32.84.165",2372,"79.175.253.7",6667,3,186,3,186,0,0,94440.132329,9.030950999993365,164.76670064991973,0
"147.32.84.165",2381,"46.4.36.120",443,6,366,3,186,3,180,94440.735288,1.0304980000073556,1443.9620455249585,1397.382624701573
"147.32.84.165",2413,"74.6.136.244",25,3,186,3,186,0,0,94440.935641,9.030312999995658,164.77834157029943,0
"147.32.84.165",2415,"209.85.225.27",25,3,186,3,186,0,0,94440.935821,9.03025899999193,164.77932692753663,0
"147.32.84.165",2418,"205.188.59.193",25,3,186,3,186,0,0,94441.135584,9.031395999991219,164.75858217283871,0
"147.32.84.165",2422,"205.188.190.2",25,3,186,3,186,0,0,94441.766071,9.002707999999984,165.28360133417664,0
"147.32.84.165",2428,"67.195.168.31",25,3,186,3,186,0,0,94441.766133,9.002774000007776,165.28238962776527,0
"147.32.84.165",2435,"65.55.92.168",25,3,186,3,186,0,0,94441.766189,9.002756999994745,165.2827017324658,0
"147.32.84.165",2392,"46.4.36.120",443,6,366,3,186,3,180,94456.988454,1.030849999995553,1443.4689819143612,1396.9054663687366
"147.32.84.165",2436,"98.139.175.225",25,3,186,3,186,0,0,94457.08909,8.931259000004502,166.60585030612705,0
"147.32.84.165",2444,"65.55.37.72",25,3,186,3,186,0,0,94457.189247,8.932096000004094,166.59023817022543,0
"147.32.84.165",2447,"209.85.225.27",25,3,186,3,186,0,0,94457.189377,8.932086999993771,166.5904060272854,0
"147.32.84.165",2448,"98.139.54.60",25,3,186,3,186,0,0,94457.189432,8.932081000006292,166.5905179318181,0
"147.32.84.165",2451,"205.188.59.193",25,3,186,3,186,0,0,94457.690418,8.931414000006043,166.60295894905255,0
"147.32.84.165",2453,"74.125.148.13",25,3,186,3,186,0,0,94457.690519,8.931437000006554,166.60252991751585,0
"147.32.84.165",2454,"205.188.156.193",25,3,186,3,186,0,0,94458.019571,8.903527000002214,167.12478099966788,0
"147.32.84.165",2404,"46.4.36.120",443,6,366,3,186,3,180,94459.898908,1.0303290000010747,1444.1988918087793,1397.6118307826898
"147.32.84.165",2456,"65.55.37.120",25,3,186,3,186,0,0,94460.929458,8.903233000004548,167.13029974608548,0
"147.32.84.165",2404,"46.4.36.120",443,6,366,3,186,3,180,94462.006655,1.0317579999973532,1442.1986551146852,1395.676117852921
"147.32.84.165",2457,"74.6.136.244",25,3,186,3,186,0,0,94462.006792,8.929944000003161,166.63038424423192,0
"147.32.84.165",2458,"64.12.90.97",25,3,186,3,186,0,0,94462.207421,8.928721000003861,166.65320822538374,0
"147.32.84.165",2461,"98.139.54.60",25,3,186,3,186,0,0,94462.809549,8.928763000003528,166.65242430551825,0
"147.32.84.165",2462,"67.195.168.31",25,3,186,3,186,0,0,94462.80968,8.928759999995236,166.652480299705,0
"147.32.84.165",2466,"64.12.90.97",25,3,186,3,186,0,0,94463.038656,8.900962999992771,167.1729227501798,0
"147.32.84.165",2468,"209.85.225.27",25,3,186,3,186,0,0,94463.03869,8.901048999992781,167.17130756174996,0
"147.32.84.165",2415,"46.4.36.120",443,6,366,3,186,3,180,94478.058463,1.030590000009397,1443.8331441081634,1397.257881394997
"147.32.84.165",2473,"209.85.225.27",25,3,186,3,186,0,0,94478.158758,9.030241000000387,164.7796553823908,0
"147.32.84.165",2481,"205.188.190.2",25,3,186,3,186,0,0,94478.158897,9.030268000002252,164.779162700335,0
"147.32.84.165",2483,"193.165.254.6",25,3,186,3,186,0,0,94478.159003,9.030231000011554,164.7798378577576,0
"147.32.84.165",2436,"173.192.170.88",80,13,1674,9,1428,4,246,94478.660699,45.4493039999943,251.35698447662548,43.30099312412456
"147.32.84.165",2486,"74.6.136.244",25,3,186,3,186,0,0,94478.961541,9.030108999999356,164.78206409248284,0
"147.32.84.165",2493,"204.127.217.16",25,3,186,3,186,0,0,94478.961683,9.03004699999292,164.7831954807286,0
"147.32.84.165",2498,"200.144.74.27",25,3,186,3,186,0,0,94479.089472,9.001883999997517,165.298730799065,0
"147.32.84.165",2448,"178.125.172.9",6667,6,366,3,186,3,180,94481.87071,1.0567779999983031,1408.0535363173622,1362.632454500673
"147.32.84.165",2447,"46.4.36.120",443,6,366,3,186,3,180,94481.871037,1.0305850000004284,1443.8401490409635,1397.264660362223
"147.32.84.165",2500,"205.188.156.193",25,3,186,3,186,0,0,94482.901845,9.001759000006132,165.3010261659956,0
"147.32.84.165",2502,"209.85.225.27",25,3,186,3,186,0,0,94482.927706,8.976033999992069,165.77477313491846,0
"147.32.84.165",2504,"209.85.225.27",25,3,186,3,186,0,0,94482.927781,8.976018999994267,165.77505016432679,0
"147.32.84.165",2508,"64.12.90.97",25,3,186,3,186,0,0,94482.927849,8.97601100000611,165.77519791352606,0
"147.32.84.165",2522,"74.6.136.244",25,3,186,3,186,0,0,94482.927917,8.976026000003912,165.77492088362393,0
"147.32.84.165",2526,"67.195.168.31",25,3,186,3,186,0,0,94482.928,8.976005999997142,165.7752902572117,0
"147.32.84.165",2546,"64.12.90.33",25,3,186,3,186,0,0,94482.928072,8.975996000008308,165.7754749443541,0
"147.32.84.165",2547,"207.130.95.54",25,3,186,3,186,0,0,94482.974138,9.029822999989847,164.78728320606874,0
"147.32.84.165",2569,"89.185.128.130",25,3,186,3,186,0,0,94483.174743,9.030297000004794,164.77863352658392,0
"147.32.84.165",2616,"98.139.54.60",25,3,186,3,186,0,0,94483.776888,9.029501000011805,164.79315966608283,0
"147.32.84.165",2456,"46.4.36.120",443,6,366,3,186,3,180,94483.97787,1.0317570000042906,1442.20005291344,1395.6774705613934
"147.32.84.165",2618,"74.6.136.244",25,3,186,3,186,0,0,94485.009904,9.00077600000077,165.31907915493872,0
"147.32.84.165",2461,"46.4.36.120",443,6,366,3,186,3,180,94499.127183,1.0308010000007926,1443.537598429625,1396.9718694480243
"147.32.84.165",2624,"67.195.168.31",25,3,186,3,186,0,0,94499.127281,9.029031000012765,164.80173786067368,0
"147.32.84.165",2632,"64.18.7.10",25,3,186,3,186,0,0,94499.929567,9.029930000004242,164.78533056173202,0
"147.32.84.165",2644,"205.188.190.2",25,3,186,3,186,0,0,94500.029919,9.029777000003378,164.78812267450718,0
"147.32.84.165",2646,"209.85.225.27",25,3,186,3,186,0,0,94500.158253,9.001527000000351,165.30528653637788,0
"147.32.84.165",2498,"82.103.123.207",6667,3,186,3,186,0,0,94503.841567,9.029990000010002,164.78423564127445,0
"147.32.84.165",2481,"46.4.36.120",443,6,366,3,186,3,180,94503.841683,1.0319329999911133,1441.9540803645336,1395.4394326108388
"147.32.84.165",2647,"216.200.145.235",25,3,186,3,186,0,0,94503.942809,9.029064999995171,164.8011172807811,0
"147.32.84.165",2648,"205.188.190.2",25,3,186,3,186,0,0,94504.142954,9.029797000010149,164.78775768694774,0
"147.32.84.165",2649,"212.82.111.207",25,3,186,3,186,0,0,94504.14308,9.029795000009472,164.78779418563093,0
"147.32.84.165",2502,"212.117.171.138",65500,9,544,5,302,4,242,94504.745916,15.404429999995045,156.83800049731,125.67813284883782
"147.32.84.165",2650,"219.113.19.146",25,3,186,3,186,0,0,94504.746052,9.028137999994215,164.81803889140303,0
"147.32.84.165",2661,"67.195.168.31",25,3,186,3,186,0,0,94504.873887,9.000825000010082,165.31817916672452,0
"147.32.84.165",2662,"98.139.175.225",25,3,186,3,186,0,0,94504.873949,9.00088799999503,165.3170220539153,0
"147.32.84.165",2508,"46.4.36.120",443,6,366,3,186,3,180,94505.949128,1.0313230000028852,1442.806957661021,1396.264797736472
"147.32.84.165",2675,"205.188.103.2",25,3,186,3,186,0,0,94506.980574,9.002162000004319,165.29362613106565,0
"147.32.84.165",2547,"46.4.36.120",443,6,366,3,186,3,180,94520.197185,1.030956000002334,1443.3205684788018,1396.7618404633565
"147.32.84.165",2676,"64.12.90.33",25,3,186,3,186,0,0,94520.999523,8.929670999990776,166.63547850772295,0
"147.32.84.165",2616,"94.100.176.20",25,3,186,3,186,0,0,94521.099901,8.929622000010568,166.63639289526915,0
"147.32.84.165",2677,"205.188.190.2",25,3,186,3,186,0,0,94521.200696,8.929508999994141,166.6385016243308,0
"147.32.84.165",2678,"67.231.152.94",25,3,186,3,186,0,0,94521.228369,8.901956999994582,167.15425608109607,0
"147.32.84.165",2624,"212.117.171.138",65500,9,544,5,302,4,242,94523.609159,35.93525900000532,67.23201855869864,53.874663878162494
"147.32.84.165",2547,"46.4.36.120",443,6,366,3,186,3,180,94523.632247,1.0070149999955902,1477.6343947275027,1429.9687690911317
"147.32.84.165",2679,"205.188.59.194",25,3,186,3,186,0,0,94524.639507,8.901052999994135,167.17123243744086,0
"147.32.84.165",2644,"117.204.64.121",6667,3,186,3,186,0,0,94525.013708,8.92899000000034,166.6481875329621,0
"147.32.84.165",2683,"67.195.168.31",25,3,186,3,186,0,0,94525.214158,8.929380999994464,166.64089033729465,0
"147.32.84.165",2436,"46.4.36.120",443,6,366,3,186,3,180,94525.815974,0.9300720000028377,1599.8761386166448,1548.2672309193335
"147.32.84.165",2684,"209.85.225.27",25,3,186,3,186,0,0,94525.916791,8.929042000003392,166.6472170250106,0
"147.32.84.165",2686,"68.1.17.3",25,3,186,3,186,0,0,94526.746333,9.001863999990746,165.29909805363974,0
"147.32.84.165",2647,"46.4.36.120",443,6,366,3,186,3,180,94527.922901,1.0305660000012722,1443.8667683565761,1397.290420990235
"147.32.84.165",2691,"98.137.34.115",25,3,186,3,186,0,0,94528.953709,9.002978000004077,165.27864446623397,0
"147.32.84.165",2436,"46.4.36.120",443,5,306,3,186,2,120,94541.969521,3.73731699999189,398.14658483699105,256.868764410962
"147.32.84.165",2701,"202.134.61.252",25,3,186,3,186,0,0,94542.069816,9.030633000002126,164.77250265841272,0
"147.32.84.165",2616,"74.125.93.27",25,3,186,3,186,0,0,94542.169721,9.031323999995948,164.75989566985612,0
"147.32.84.165",2707,"205.188.156.193",25,3,186,3,186,0,0,94542.169867,9.03122699999949,164.76166527539215,0
"147.32.84.165",2708,"64.12.90.33",25,3,186,3,186,0,0,94544.68014,9.029923000009148,164.7854583032981,0
"147.32.84.165",2709,"65.54.188.94",25,3,186,3,186,0,0,94545.583138,9.03183999999601,164.7504827367023,0
"147.32.84.165",2711,"65.55.37.72",25,3,186,3,186,0,0,94545.707052,9.00925499999721,165.16349021095093,0
"147.32.84.165",2712,"67.195.168.31",25,3,186,3,186,0,0,94546.184974,9.032876999990549,164.7315689122698,0
"147.32.84.165",2678,"46.4.36.120",443,6,366,3,186,3,180,94546.887072,1.3090220000012778,1136.7265026856292,1100.0579058248022
"147.32.84.165",2714,"65.55.37.72",25,3,186,3,186,0,0,94547.790243,9.033960000000661,164.71182072976757,0
"147.32.84.165",2716,"89.104.217.10",25,3,186,3,186,0,0,94547.790374,9.033952999991016,164.7119483576547,0
"147.32.84.165",2719,"205.188.59.193",25,3,186,3,186,0,0,94548.196329,8.928436999995029,166.65850921060746,0
"147.32.84.165",2678,"46.4.36.120",443,6,366,3,186,3,180,94549.997418,1.0304089999990538,1444.0867655478228,1397.503321497893
"147.32.84.165",2725,"98.139.175.225",25,3,186,3,186,0,0,94551.028108,8.907307999994373,167.05383938682036,0
"147.32.84.165",2624,"212.117.171.138",65500,50,19452,26,17378,24,2074,94563.044742,109.86798900000576,1265.3731197354737,151.01759985794524
"147.32.84.165",2678,"46.4.36.120",443,5,306,3,186,2,120,94563.067384,3.703763000012259,401.7535679240478,259.1958502735792
"147.32.84.165",2736,"173.0.137.227",25,3,186,3,186,0,0,94563.144998,9.02905899999314,164.80122679463392,0
"147.32.84.165",2741,"64.12.90.33",25,3,186,3,186,0,0,94563.14513,9.028974999993807,164.80276000332492,0
"147.32.84.165",2743,"205.188.59.193",25,3,186,3,186,0,0,94563.145184,9.028962000011234,164.8029972878553,0
"147.32.84.165",2746,"98.139.54.60",25,3,186,3,186,0,0,94563.145232,9.028962000011234,164.8029972878553,0
"147.32.84.165",2701,"116.73.89.104",6667,3,186,3,186,0,0,94565.652954,9.02868099999614,164.80812645840916,0
"147.32.84.165",2616,"74.125.39.27",25,3,186,3,186,0,0,94566.555781,9.029104000001098,164.8004054444183,0
"147.32.84.165",2751,"67.195.168.31",25,3,186,3,186,0,0,94566.656207,9.028961999996682,164.80299728812093,0
"147.32.84.165",2763,"94.245.120.86",25,3,186,3,186,0,0,94566.656262,9.029030999998213,164.80173786093928,0
"147.32.84.165",2777,"205.188.190.2",25,3,186,3,186,0,0,94566.771452,9.013607000000775,165.08374505343667,0
"147.32.84.165",2778,"98.136.59.15",25,3,186,3,186,0,0,94567.158094,9.02907299999788,164.80097126253708,0
"147.32.84.165",2708,"46.4.36.120",443,6,366,3,186,3,180,94568.76257,1.0314929999876767,1442.5691691730115,1396.0346798448497
"147.32.84.165",2792,"65.54.188.94",25,3,186,3,186,0,0,94569.165003,9.028567000001203,164.81020742270636,0
"147.32.84.165",2812,"209.85.225.27",25,3,186,3,186,0,0,94569.794269,9.000783999988926,165.31893221766356,0
"147.32.84.165",2708,"46.4.36.120",443,6,366,3,186,3,180,94571.973383,1.1749659999914002,1266.419624066476,1225.5673781288476
"147.32.84.165",2818,"74.6.136.244",25,3,186,3,186,0,0,94573.148576,8.957156999997096,166.1241396126564,0
"147.32.84.165",2725,"46.4.36.120",443,6,366,3,186,3,180,94584.212701,1.0304009999963455,1444.097977394507,1397.5141716721037
"147.32.84.165",2831,"205.188.156.193",25,3,186,3,186,0,0,94584.212772,8.927546999999322,166.67512363699828,0
"147.32.84.165",2840,"216.32.181.178",25,3,186,3,186,0,0,94585.243341,8.900442000012845,167.182708454013,0
"147.32.84.165",2847,"74.6.136.244",25,3,186,3,186,0,0,94585.817383,8.929288999992423,166.6426072670806,0
"147.32.84.165",2849,"65.55.37.72",25,3,186,3,186,0,0,94585.817513,8.929286999991746,166.64264459204588,0
"147.32.84.165",2741,"82.103.123.207",6667,3,186,3,186,0,0,94587.623048,8.928701000011642,166.65358152300763,0
"147.32.84.165",2746,"46.4.36.120",443,6,366,3,186,3,180,94587.723671,0.9304819999961182,1599.1711822541517,1547.585015084663
"147.32.84.165",2851,"218.102.53.145",25,3,186,3,186,0,0,94587.823626,8.929755999997724,166.63389234827685,0
"147.32.84.165",2616,"66.111.4.71",25,3,186,3,186,0,0,94588.224679,8.928569999989122,166.6560266651673,0
"147.32.84.165",2852,"67.195.168.31",25,3,186,3,186,0,0,94588.654411,9.000874999997905,165.31726082190303,0
"147.32.84.165",2763,"46.4.36.120",443,6,366,3,186,3,180,94590.130937,1.0307420000026468,1443.6202269784087,1397.0518325597504
"147.32.84.165",2859,"205.188.59.193",25,3,186,3,186,0,0,94590.733226,9.028642999997828,164.80882010733595,0
"147.32.84.165",2860,"65.54.188.126",25,3,186,3,186,0,0,94591.161917,9.00132099998882,165.30906963565104,0
"147.32.84.165",2746,"46.4.36.120",443,6,366,3,186,3,180,94594.043296,1.0309239999915008,1443.3653693310735,1396.8051961268452
"147.32.84.165",2863,"205.188.156.193",25,3,186,3,186,0,0,94595.074459,9.001669000004767,165.30267886979757,0
"147.32.84.165",2869,"209.85.225.27",25,3,186,3,186,0,0,94595.074532,9.001717999999528,165.3017790604058,0
"147.32.84.165",2812,"46.4.36.120",443,6,366,3,186,3,180,94605.179999,1.029960999992909,1444.7148969817738,1398.111190627523
"147.32.84.165",2878,"68.1.17.3",25,3,186,3,186,0,0,94606.182562,9.028483999994933,164.81172254398803,0
"147.32.84.165",2880,"67.195.168.31",25,3,186,3,186,0,0,94606.210234,9.00095099999453,165.3158649570367,0
"147.32.84.165",2890,"205.188.190.2",25,3,186,3,186,0,0,94606.210293,9.000975000002654,165.31542416233367,0
"147.32.84.165",2900,"212.82.111.207",25,3,186,3,186,0,0,94606.784162,9.028998000008869,164.80234019306886,0
"147.32.84.165",2909,"216.163.188.54",25,3,186,3,186,0,0,94606.884346,9.029312999991816,164.79659083712667,0
"147.32.84.165",2831,"117.207.49.181",6667,3,186,3,186,0,0,94608.790333,9.02964300000167,164.79056813206512,0
"147.32.84.165",2812,"46.4.36.120",443,6,366,3,186,3,180,94609.19284,1.029607999997097,1445.210215930913,1398.5905315460448
"147.32.84.165",2912,"74.6.136.244",25,3,186,3,186,0,0,94609.693703,9.02922199999739,164.79825172096002,0
"147.32.84.165",2616,"216.157.130.15",25,3,186,3,186,0,0,94610.222658,9.000874999997905,165.31726082190303,0
"147.32.84.165",2915,"64.12.139.193",25,3,186,3,186,0,0,94611.800638,8.928434999994352,166.6585465426966,0
"147.32.84.165",2812,"46.4.36.120",443,6,366,3,186,3,180,94612.201032,1.0308630000072299,1443.4507786093438,1396.887850267107
"147.32.84.165",2918,"205.188.190.2",25,3,186,3,186,0,0,94613.232132,8.901262999992468,167.1672885074016,0
"147.32.84.165",2923,"209.85.225.27",25,3,186,3,186,0,0,94613.232168,8.901324999998906,167.16612414445973,0
"147.32.84.165",2933,"65.55.92.136",25,3,186,3,186,0,0,94613.232201,8.901316999996197,167.16627438396316,0
"147.32.84.165",2860,"46.4.36.120",443,6,366,3,186,3,180,94616.114143,1.0308740000036778,1443.4353761901953,1396.872944700189
"147.32.84.165",2937,"62.146.106.39",25,3,186,3,186,0,0,94617.145247,8.900559000001522,167.18051079710224,0
"147.32.84.165",2863,"46.4.36.120",443,6,366,3,186,3,180,94627.149022,1.0308919999952195,1443.4101729443048,1396.8485544622304
"147.32.84.165",2947,"217.72.192.149",25,3,186,3,186,0,0,94627.14918,9.032494000013685,164.73855393623793,0
"147.32.84.165",2948,"195.75.94.108",25,3,186,3,186,0,0,94627.751227,9.033062000002246,164.72819515681726,0
"147.32.84.165",2955,"205.188.156.193",25,3,186,3,186,0,0,94627.852203,9.031902000002447,164.74935179761658,0
"147.32.84.165",2959,"65.55.37.88",25,3,186,3,186,0,0,94627.951852,9.033269999999902,164.72440212680635,0
"147.32.84.165",2960,"67.195.168.31",25,3,186,3,186,0,0,94628.18012,9.005122000002302,165.2392938151887,0
"147.32.84.165",2878,"46.4.36.120",443,6,366,3,186,3,180,94630.663531,1.0305939999961993,1443.8275402394033,1397.2524582961967
"147.32.84.165",2964,"209.85.225.27",25,3,186,3,186,0,0,94631.16485,9.032875000004424,164.73160538580146,0
"147.32.84.165",2975,"94.245.120.86",25,3,186,3,186,0,0,94631.694398,9.003983999995398,165.26017816121848,0
"147.32.84.165",2900,"46.4.36.120",443,6,366,3,186,3,180,94632.770259,1.0308119999972405,1443.5221941575994,1396.9569620879995
"147.32.84.165",2979,"74.6.136.244",25,3,186,3,186,0,0,94633.801328,9.004862999994657,165.24404646699043,0
"147.32.84.165",2984,"64.12.90.33",25,3,186,3,186,0,0,94634.175855,9.03156200000376,164.75555391186825,0
"147.32.84.165",2900,"85.66.209.80",6667,3,186,3,186,0,0,94638.08824,9.033360000001267,164.7227609659962,0
"147.32.84.165",2878,"46.4.36.120",443,6,366,3,186,3,180,94648.224991,1.0312840000115102,1442.8615201858968,1396.3176001799002
"147.32.84.165",2986,"195.245.230.83",25,3,186,3,186,0,0,94648.827299,8.928546000010101,166.65647463745123,0
"147.32.84.165",3034,"65.55.92.136",25,3,186,3,186,0,0,94648.927478,8.929183000000194,166.64458551246713,0
"147.32.84.165",3057,"67.195.168.31",25,3,186,3,186,0,0,94649.027937,8.928682999990997,166.65391749281505,0
"147.32.84.165",3058,"62.149.128.65",25,3,186,3,186,0,0,94649.028064,8.92867799999658,166.65401081779072,0
"147.32.84.165",3065,"74.6.136.244",25,3,186,3,186,0,0,94649.228826,8.928331999995862,166.66046916721842,0
"147.32.84.165",3067,"62.20.233.128",25,3,186,3,186,0,0,94649.228881,8.928327000001445,166.660562499532,0
"147.32.84.165",3068,"205.188.59.193",25,3,186,3,186,0,0,94649.256536,8.900720000005094,167.17748676501995,0
"147.32.84.165",2947,"46.4.36.120",443,6,366,3,186,3,180,94652.138151,1.0326239999994868,1440.9891693401853,1394.5056477485664
"147.32.84.165",3070,"143.248.116.51",25,3,186,3,186,0,0,94652.639559,9.029271999999764,164.79733914318217,0
"147.32.84.165",3082,"216.32.180.22",25,3,186,3,186,0,0,94653.170978,8.998852000004263,165.3544252088261,0
"147.32.84.165",2959,"46.4.36.120",443,6,366,3,186,3,180,94654.746393,1.0306370000034804,1443.7673011884642,1397.1941624404492
"147.32.84.165",3095,"67.195.168.31",25,3,186,3,186,0,0,94655.147487,9.028828000009526,164.8054431869153,0
"147.32.84.165",3099,"205.188.59.193",25,3,186,3,186,0,0,94655.77725,9.000889000002644,165.31700368703167,0
"147.32.84.165",3101,"67.195.168.31",25,3,186,3,186,0,0,94655.77731,9.000961999990977,165.315662925973,0
"147.32.84.165",3113,"79.171.16.207",25,3,186,3,186,0,0,94655.777361,9.0009710000013,165.31549762795427,0
"147.32.84.165",2960,"46.4.36.120",443,6,366,3,186,3,180,94658.558255,1.0310969999991357,1443.123197915664,1396.5708366925778
"147.32.84.165",3117,"64.12.90.97",25,3,186,3,186,0,0,94659.589605,9.000579999992624,165.32267920525337,0
"147.32.84.165",2947,"163.21.59.10",6667,1,62,1,62,0,0,94669.793985,0,0,0
"147.32.84.165",2975,"46.4.36.120",443,6,366,3,186,3,180,94669.894462,1.0311860000074375,1442.9986442690918,1396.4503009055727
"147.32.84.165",3131,"207.115.37.23",25,3,186,3,186,0,0,94669.995535,9.030369000000064,164.77731973078724,0
"147.32.84.165",3134,"213.46.255.2",25,3,186,3,186,0,0,94670.195787,9.030392000000575,164.77690005039707,0
"147.32.84.165",2984,"212.117.171.138",65500,39,13765,20,10849,19,2916,94670.195917,12.321412999997847,7043.9973077775385,1893.2893492007838
"147.32.84.165",3153,"205.188.156.193",25,3,186,3,186,0,0,94670.195973,9.03039300000819,164.77688180333354,0
"147.32.84.165",2947,"65.54.186.47",443,22,17801,13,1399,9,16402,94670.925872,1.7849379999970552,6270.245801265066,73512.91753563232
"147.32.84.165",3157,"74.6.136.244",25,3,186,3,186,0,0,94671.08927,8.939532999997027,166.45164797763985,0
"147.32.84.165",2986,"46.4.36.120",443,6,366,3,186,3,180,94673.70796,1.0304349999933038,1444.0503282688085,1397.468059614976
"147.32.84.165",3158,"67.195.168.31",25,3,186,3,186,0,0,94674.209318,8.930639000012889,166.61741673780034,0
"147.32.84.165",3167,"209.85.225.27",25,3,186,3,186,0,0,94674.209372,8.930710000000545,166.61609211360678,0
"147.32.84.165",3169,"212.27.48.6",25,3,186,3,186,0,0,94674.738666,8.90419099999417,167.11231823317516,0
"147.32.84.165",3065,"46.4.36.120",443,6,366,3,186,3,180,94676.215717,1.031646000003093,1442.3552264977898,1395.8276385462482
"147.32.84.165",3180,"209.85.225.27",25,3,186,3,186,0,0,94676.819043,8.931101000009221,166.60879772812598,0
"147.32.84.165",3189,"202.179.178.24",25,3,186,3,186,0,0,94676.8192,8.931075000000419,166.60928275710708,0
"147.32.84.165",3191,"74.125.67.27",25,3,186,3,186,0,0,94677.247613,8.90401600000041,167.11560266737294,0
"147.32.84.165",3068,"212.117.171.138",65500,20,3247,11,1441,9,1806,94679.627388,12.827547000008053,898.6909188477549,1126.3260232054445
"147.32.84.165",2947,"46.4.36.120",443,6,366,3,186,3,180,94679.62755,1.0303189999976894,1444.2129088207992,1397.6253956330315
"147.32.84.165",3199,"74.6.136.244",25,3,186,3,186,0,0,94680.630448,8.931830000001355,166.59519941599586,0
"147.32.84.165",2624,"65.54.186.47",443,23,12804,14,2595,9,10209,94680.630518,1.8210169999947539,11400.223062200852,44849.66367707456
"147.32.84.165",3219,"67.195.168.31",25,3,186,3,186,0,0,94680.658096,8.90430500000366,167.11017872808583,0
"147.32.84.165",2979,"143.107.171.10",6667,3,186,3,186,0,0,94680.793949,8.868390999996336,167.78691873200165,0
"147.32.84.165",3070,"46.4.36.120",443,6,366,3,186,3,180,94690.966809,1.030891000002157,1443.4115730924866,1396.8499094443418
"147.32.84.165",3222,"205.188.59.193",25,3,186,3,186,0,0,94691.166977,9.028894999995828,164.80422022857587,0
"147.32.84.165",3229,"68.1.17.3",25,3,186,3,186,0,0,94691.167115,9.028856999997515,164.8049138446217,0
"147.32.84.165",3113,"212.117.171.138",65500,14,876,8,486,6,390,94691.970149,3.4201089999987744,1136.8058737313324,912.2516270683531
"147.32.84.165",3237,"205.188.190.2",25,3,186,3,186,0,0,94691.970205,9.028852999996161,164.80498685720463,0
"147.32.84.165",3067,"157.55.0.137",80,12,2743,6,1606,6,1137,94691.997928,0.4675799999968149,27477.65088345849,19453.355575649002
"147.32.84.165",3243,"209.85.225.27",25,3,186,3,186,0,0,94692.032332,8.966847000003327,165.94461799107847,0
"147.32.84.165",3244,"198.103.152.58",25,3,186,3,186,0,0,94692.032392,8.966836000006879,165.94482156235026,0
"147.32.84.165",3067,"46.4.36.120",443,6,366,3,186,3,180,94695.179781,1.0310500000050524,1443.1889820985484,1396.6344988050469
"147.32.84.165",3256,"205.188.59.193",25,3,186,3,186,0,0,94695.682054,9.029819999996107,164.7873379536515,0
"147.32.84.165",3158,"212.117.171.138",65500,14,876,8,486,6,390,94695.682109,2.1753570000000764,1787.2928443468652,1434.2473442289659
"147.32.84.165",3261,"202.41.136.81",25,3,186,3,186,0,0,94695.705277,9.006647000001976,165.21131559832128,0
"147.32.84.165",3270,"67.195.168.31",25,3,186,3,186,0,0,94696.211071,9.002057000005152,165.29555411603687,0
"147.32.84.165",3271,"66.94.237.64",25,3,186,3,186,0,0,94696.211133,9.002121999990777,165.29436059648208,0
"147.32.84.165",3169,"46.4.36.120",443,6,366,3,186,3,180,94697.788757,1.0308179999992717,1443.5137919604151,1396.948830929434
"147.32.84.165",3285,"64.12.90.33",25,3,186,3,186,0,0,94698.189957,9.02989200000593,164.7860240187837,0
"147.32.84.165",3286,"64.12.90.33",25,3,186,3,186,0,0,94698.819858,9.0016789999936,165.30249523461765,0
"147.32.84.165",3289,"74.6.136.244",25,3,186,3,186,0,0,94698.819916,9.001709000003757,165.30194433072418,0
"147.32.84.165",3101,"46.4.36.120",443,6,366,3,186,3,180,94700.698176,1.0299279999890132,1444.7611872051962,1398.1559876179317
"147.32.84.165",3307,"207.115.37.23",25,3,186,3,186,0,0,94701.600987,9.029621000008774,164.79096963189863,0
"147.32.84.165",3158,"98.154.67.160",6667,3,186,3,186,0,0,94701.728365,9.002672000002349,165.28426227231336,0
"147.32.84.165",3101,"46.4.36.120",443,5,306,3,186,2,120,94712.235704,1.0031879999878583,1483.2713310147344,956.9492458159576
"147.32.84.165",3313,"67.195.168.31",25,3,186,3,186,0,0,94712.23584,9.65250600001309,154.15685833274614,0
"147.32.84.165",3191,"212.117.171.138",65500,66,34813,34,31636,32,3177,94713.038373,9.088107999996282,27848.260606069332,2796.621695077831
"147.32.84.165",3326,"209.85.225.27",25,3,186,3,186,0,0,94713.03851,9.073417999999947,163.9955306809417,0
"147.32.84.165",3327,"216.32.180.22",25,3,186,3,186,0,0,94713.061035,9.054112999991048,164.345198696048,0
"147.32.84.165",3330,"205.188.59.193",25,3,186,3,186,0,0,94716.649571,9.028812999997172,164.80571698632656,0
"147.32.84.165",3343,"205.188.156.193",25,3,186,3,186,0,0,94717.151517,9.028693000000203,164.80790741250883,0
"147.32.84.165",3344,"74.6.136.244",25,3,186,3,186,0,0,94719.157335,9.029378000006545,164.79540451168634,0
"147.32.84.165",3261,"212.117.171.138",65500,9,544,5,302,4,242,94719.157461,6.81997599999886,354.2534460532418,283.8719667049156
"147.32.84.165",3345,"64.12.90.97",25,3,186,3,186,0,0,94719.157514,9.029246999998577,164.79779543080775,0
"147.32.84.165",3270,"65.55.33.167",80,35,32993,19,2363,16,30630,94719.759129,2.4511230000061914,7712.383262672763,99970.50331598253
"147.32.84.165",3348,"216.32.180.22",25,3,186,3,186,0,0,94719.92095,8.967571000001044,165.9312203939982,0
"147.32.84.165",3349,"65.55.88.22",25,3,186,3,186,0,0,94719.921011,8.967642999996315,165.92988815462564,0
"147.32.84.165",3358,"212.82.111.207",25,3,186,3,186,0,0,94722.108745,8.685916999995243,171.31179125943927,0
"147.32.84.165",3289,"46.148.34.83",6667,3,186,3,186,0,0,94722.568388,9.029169000001275,164.79921906432253,0
"147.32.84.165",3360,"67.195.168.31",25,3,186,3,186,0,0,94725.176439,9.030149999991409,164.7813159251414,0
"147.32.84.165",3365,"74.55.28.130",25,3,186,3,186,0,0,94725.17651,9.030102999997325,164.7821735810146,0
"147.32.84.165",3261,"212.117.171.138",65500,15,936,8,486,7,450,94733.203595,4.625054999996792,840.6386518652637,778.3691220974664
"147.32.84.165",3101,"46.4.36.120",443,6,366,3,186,3,180,94733.226308,1.007605999999214,1476.7677048381618,1429.1300369401565
"147.32.84.165",3368,"216.69.186.201",25,3,186,3,186,0,0,94734.005955,9.029118000005838,164.80014991486854,0
"147.32.84.165",3372,"209.85.225.27",25,3,186,3,186,0,0,94734.006087,9.029083000001265,164.80078874009592,0
"147.32.84.165",3373,"205.188.59.193",25,3,186,3,186,0,0,94734.234149,9.001845999999205,165.29942858388506,0
"147.32.84.165",3376,"74.6.136.244",25,3,186,3,186,0,0,94734.234179,9.001936999993632,165.297757582735,0
"147.32.84.165",3101,"46.4.36.120",443,6,366,3,186,3,180,94737.717828,1.0412790000118548,1429.011821023049,1382.9146655061763
"147.32.84.165",3378,"205.188.190.2",25,3,186,3,186,0,0,94738.21945,8.929133999990881,166.64550000050616,0
"147.32.84.165",3386,"67.195.168.31",25,3,186,3,186,0,0,94738.759358,8.889862000010908,167.38167589082644,0
"147.32.84.165",3327,"212.117.171.138",65500,23,5344,11,1383,12,3961,94740.225905,4.468273999998928,2476.123890343935,7091.776377188955
"147.32.84.165",3343,"46.4.36.120",443,6,366,3,186,3,180,94740.248437,1.0083559999911813,1475.6693072813703,1428.0670715626165
"147.32.84.165",3392,"209.85.225.27",25,3,186,3,186,0,0,94740.928171,8.928421999997227,166.65878920154785,0
"147.32.84.165",3393,"205.188.59.193",25,3,186,3,186,0,0,94740.928303,8.928413000001456,166.65895719650933,0
"147.32.84.165",3399,"205.188.156.193",25,3,186,3,186,0,0,94741.25702,8.900441999998293,167.18270845428637,0
"147.32.84.165",3343,"46.4.36.120",443,6,366,3,186,3,180,94742.834182,1.0304879999894183,1443.9760579601893,1397.3961851227639
"147.32.84.165",3408,"74.6.136.244",25,3,186,3,186,0,0,94742.834316,8.928575000012643,166.65593333739068,0
"147.32.84.165",3344,"65.55.33.167",80,14,4772,8,3693,6,1079,94742.83437,1.9997720000101253,14773.684199923997,4316.492080075275
"147.32.84.165",3412,"205.188.59.193",25,3,186,3,186,0,0,94742.99618,8.86722600000212,167.80896302853276,0
"147.32.84.165",3261,"117.197.21.10",6667,6,366,3,186,3,180,94742.996211,1.965358000001288,757.113971092811,732.6909397672364
"147.32.84.165",3428,"67.195.168.31",25,3,186,3,186,0,0,94743.864807,8.901273999988916,167.1670819257842,0
"147.32.84.165",3358,"212.117.171.138",65500,15,936,8,486,7,450,94743.864836,11.213948000004166,346.7110780252018,321.02877594926093
"147.32.84.165",3432,"209.85.225.27",25,3,186,3,186,0,0,94743.864859,8.901347999999416,167.1656922075283,0
"147.32.84.165",3440,"205.188.190.2",25,3,186,3,186,0,0,94743.864891,8.901365999990958,167.16535417165315,0
"147.32.84.165",3444,"62.128.193.152",25,3,186,3,186,0,0,94743.864919,8.901385000004666,167.16499735706523,0
"147.32.84.165",3101,"46.4.36.120",443,6,366,3,186,3,180,94744.961703,1.010057000006782,1473.1841866251202,1425.662116088826
"147.32.84.165",3446,"64.85.60.138",25,3,186,3,186,0,0,94745.971984,9.00051299999177,165.3239098706219,0
"147.32.84.165",3447,"205.188.190.2",25,3,186,3,186,0,0,94746.144762,9.02884400000039,164.80515113561998,0
"147.32.84.165",3448,"65.55.92.168",25,3,186,3,186,0,0,94746.144889,9.028854999996838,164.80495035090507,0
"147.32.84.165",3360,"46.4.36.120",443,6,366,3,186,3,180,94754.972692,1.0318910000059986,1442.0127707203085,1395.4962297293307
"147.32.84.165",3451,"74.6.136.244",25,3,186,3,186,0,0,94754.972819,9.03507399999944,164.6915122111996,0
"147.32.84.165",3101,"212.117.171.138",65500,15,936,8,486,7,450,94754.972931,4.311914999998407,901.6875332657152,834.8958641349215
"147.32.84.165",3457,"216.32.181.178",25,3,186,3,186,0,0,94754.972999,9.03503099999216,164.6922960199352,0
"147.32.84.165",3462,"67.195.168.31",25,3,186,3,186,0,0,94755.173824,9.03453800000716,164.70128300958174,0
"147.32.84.165",3465,"64.12.90.33",25,3,186,3,186,0,0,94755.173891,9.034606000001077,164.7000433665644,0
"147.32.84.165",3469,"65.55.37.120",25,3,186,3,186,0,0,94756.004839,9.006697999997414,165.2103800971707,0
"147.32.84.165",3373,"46.4.36.120",443,6,366,3,186,3,180,94759.18934,1.030721999995876,1443.6482388131362,1397.078940786906
"147.32.84.165",3470,"205.188.190.2",25,3,186,3,186,0,0,94759.690889,9.033693999997922,164.7166707218932,0
"147.32.84.165",3360,"212.117.171.138",65500,15,936,8,486,7,450,94760.220281,1.7818289999995613,2182.027568302546,2020.3958965764314
"147.32.84.165",3476,"209.85.225.27",25,3,186,3,186,0,0,94760.242956,8.983670000001439,165.63386678270257,0
"147.32.84.165",3373,"46.4.36.120",443,6,366,3,186,3,180,94761.898413,1.032680000003893,1440.9110276120296,1394.4300267213189
"147.32.84.165",3484,"205.188.59.193",25,3,186,3,186,0,0,94762.199707,9.033221999998204,164.72527742596117,0
"147.32.84.165",3499,"74.6.136.244",25,3,186,3,186,0,0,94762.931358,9.003182999993442,165.27488111716534,0
"147.32.84.165",3408,"46.4.36.120",443,6,366,3,186,3,180,94764.81169,1.0310210000025108,1443.2295753397616,1396.673782586866
"147.32.84.165",3512,"216.32.181.178",25,3,186,3,186,0,0,94765.842938,9.001275999995414,165.30989606370898,0
"147.32.84.165",3360,"61.17.216.90",6667,3,186,3,186,0,0,94765.842999,9.001340000002529,165.308720701538,0
"147.32.84.165",3444,"46.4.36.120",443,6,366,3,186,3,180,94767.019466,1.0306759999948554,1443.7126701382658,1397.1412936821928
"147.32.84.165",3513,"67.195.168.31",25,3,186,3,186,0,0,94767.220155,9.028497999999672,164.81146697934187,0
"147.32.84.165",3440,"212.117.171.138",65500,9,544,5,302,4,242,94768.05038,34.13002700000652,70.78810690655294,56.724244607237786
"147.32.84.165",3517,"200.42.208.2",25,3,186,3,186,0,0,94768.073182,8.877836000014213,167.60841268047955,0
"147.32.84.165",3444,"46.4.36.120",443,6,366,3,186,3,180,94776.048365,0.9300220000004629,1599.9621514321805,1548.3504691279168
"147.32.84.165",3521,"205.188.190.2",25,3,186,3,186,0,0,94776.248796,9.028340999997454,164.81433299876684,0
"147.32.84.165",3531,"64.12.90.33",25,3,186,3,186,0,0,94776.248851,9.028424000003724,164.81281782948898,0
"147.32.84.165",3540,"98.139.175.225",25,3,186,3,186,0,0,94776.951084,9.028437999993912,164.81256226171166,0
"147.32.84.165",3542,"74.6.136.244",25,3,186,3,186,0,0,94776.978677,9.000894999990123,165.31689348688468,0
"147.32.84.165",3543,"67.195.168.31",25,3,186,3,186,0,0,94776.978736,9.000883000000613,165.31711388759288,0
"147.32.84.165",3550,"64.12.90.97",25,3,186,3,186,0,0,94776.97881,9.000855000005686,165.31762815855384,0
"147.32.84.165",3465,"173.192.170.88",80,27,5050,13,1224,14,3826,94780.662663,44.54186300000583,219.8381329491925,687.1737717839954
"147.32.84.165",3462,"46.4.36.120",443,6,366,3,186,3,180,94780.863639,1.0301000000035856,1444.5199495144361,1397.922531788164
"147.32.84.165",3559,"205.188.59.193",25,3,186,3,186,0,0,94781.164708,9.028612000009161,164.8093859829717,0
"147.32.84.165",3566,"65.55.92.168",25,3,186,3,186,0,0,94781.16481,9.028638999996474,164.80889312338007,0
"147.32.84.165",3596,"66.210.5.50",25,3,186,3,186,0,0,94781.893972,9.001339999987977,165.30872070180524,0
"147.32.84.165",3470,"46.4.36.120",443,6,366,3,186,3,180,94783.170502,1.031051000012667,1443.187582361803,1396.6331442210997
"147.32.84.165",3605,"67.195.168.31",25,3,186,3,186,0,0,94783.873308,9.028595000010682,164.8096963036042,0
"147.32.84.165",3607,"74.6.136.244",25,3,186,3,186,0,0,94783.873438,9.028588000001037,164.80982408321535,0
"147.32.84.165",3612,"98.139.175.225",25,3,186,3,186,0,0,94784.201759,9.001015000001644,165.31468950998618,0
"147.32.84.165",3621,"205.188.156.193",25,3,186,3,186,0,0,94784.201822,9.00107699999353,165.3135508118717,0
"147.32.84.165",3470,"46.4.36.120",443,6,366,3,186,3,180,94785.979399,1.031327999997302,1442.799962770227,1396.2580284873166
"147.32.84.165",3629,"209.85.225.27",25,3,186,3,186,0,0,94787.010964,9.000419000003603,165.32563650641202,0
"147.32.84.165",3470,"46.4.36.120",443,6,366,3,186,3,180,94788.287382,1.0304739999992307,1443.9956757774683,1397.4151701072274
"147.32.84.165",3631,"205.188.190.2",25,3,186,3,186,0,0,94788.989698,9.03072899999097,164.7707510657764,0
"147.32.84.165",3633,"200.32.104.82",25,3,186,3,186,0,0,94789.318087,9.002991999994265,165.27838745174358,0
"147.32.84.165",3517,"46.4.36.120",443,6,366,3,186,3,180,94797.317151,1.0315630000113742,1442.4712790043777,1395.9399474235913
"147.32.84.165",3637,"64.12.90.33",25,3,186,3,186,0,0,94798.020566,9.030606000000262,164.77299530064283,0
"147.32.84.165",3646,"98.139.175.225",25,3,186,3,186,0,0,94798.020646,9.030647999999928,164.77222896961678,0
"147.32.84.165",3665,"74.125.45.27",25,3,186,3,186,0,0,94798.348923,9.003270000001066,165.27328404011251,0
"147.32.84.165",3521,"46.4.36.120",443,6,366,3,186,3,180,94802.234621,1.0303649999987101,1444.1484328387153,1397.5629995213374
"147.32.84.165",3668,"64.12.90.97",25,3,186,3,186,0,0,94802.936588,8.933102000009967,166.57147763434693,0
"147.32.84.165",3440,"212.117.171.138",65500,9,544,5,302,4,242,94803.265222,20.458134000000427,118.09483699735027,94.63228660052572
"147.32.84.165",3672,"64.12.90.33",25,3,186,3,186,0,0,94803.287983,8.882260999991558,167.52491285736977,0
"147.32.84.165",3704,"216.104.13.1",25,3,186,3,186,0,0,94803.288043,8.88234999999986,167.52323427921928,0
"147.32.84.165",3559,"46.4.36.120",443,6,366,3,186,3,180,94804.945299,1.0298920000059297,1444.8116889843136,1398.2048603074002
"147.32.84.165",3707,"74.6.136.244",25,3,186,3,186,0,0,94805.244821,8.931540000005043,166.60060862954876,0
"147.32.84.165",3711,"205.188.190.2",25,3,186,3,186,0,0,94805.975733,8.904246000005514,167.111286008841,0
"147.32.84.165",3727,"64.136.44.37",25,3,186,3,186,0,0,94805.975768,8.904391999996733,167.10854598500896,0
"147.32.84.165",3521,"116.193.128.2",6667,6,366,3,186,3,180,94807.954502,1.625370000008843,915.4838590548026,885.952121665938
"147.32.84.165",3612,"46.4.36.120",443,6,366,3,186,3,180,94809.580165,1.0124739999882877,1469.6673692531494,1422.2587444385317
"147.32.84.165",3735,"67.195.168.31",25,3,186,3,186,0,0,94809.962262,9.031868000005488,164.7499719879759,0
"147.32.84.165",3739,"122.1.235.148",25,3,186,3,186,0,0,94810.263514,9.031703999993624,164.752963560481,0
"147.32.84.165",3746,"205.188.156.193",25,3,186,3,186,0,0,94810.592856,9.003093999999692,165.27651494031394,0
"147.32.84.165",3612,"46.4.36.120",443,6,366,3,186,3,180,94818.994232,1.030441000009887,1444.0419199019866,1397.4599224857934
"147.32.84.165",3755,"209.85.225.27",25,3,186,3,186,0,0,94818.994273,9.03541499999119,164.6852966910154,0
"147.32.84.165",3762,"98.139.54.60",25,3,186,3,186,0,0,94819.295369,9.035633000006783,164.68132337810567,0
"147.32.84.165",3637,"59.113.49.130",6667,6,366,3,186,3,180,94820.024895,1.938334999998915,767.6691593562687,742.9056380867115
"147.32.84.165",3612,"46.4.36.120",443,6,366,3,186,3,180,94821.96351,0.9746929999964777,1526.6345403171842,1477.3882648230815
"147.32.84.165",3763,"64.12.90.97",25,3,186,3,186,0,0,94822.938434,9.003771000003326,165.26408768053412,0
"147.32.84.165",3804,"74.6.136.244",25,3,186,3,186,0,0,94822.938506,9.003757999991649,165.26432629590667,0
"147.32.84.165",3809,"74.125.45.27",25,3,186,3,186,0,0,94822.938574,9.00371499999892,165.26511556620557,0
"147.32.84.165",3440,"212.117.171.138",65500,15,912,8,486,7,426,94823.916038,37.65776100000949,103.24564968158943,90.49927317768949
"147.32.84.165",3816,"205.188.190.2",25,3,186,3,186,0,0,94823.938609,9.006889999989653,165.20685830533174,0
"147.32.84.165",3895,"64.12.90.97",25,3,186,3,186,0,0,94824.216875,9.029311000005691,164.79662733945725,0
"147.32.84.165",3672,"173.192.170.88",80,10,1039,6,542,4,497,94826.223417,125.87229499999376,34.44761216120049,31.587570561100815
"147.32.84.165",3668,"46.4.36.120",443,6,366,3,186,3,180,94826.424391,1.0296140000136802,1445.201794051197,1398.5823813398683
"147.32.84.165",3906,"65.55.92.184",25,3,186,3,186,0,0,94826.925214,9.029817000002367,164.78739270127068,0
"147.32.84.165",3916,"80.12.242.53",25,3,186,3,186,0,0,94827.454214,9.003098000001046,165.2764415093368,0
"147.32.84.165",3668,"46.4.36.120",443,6,366,3,186,3,180,94831.039289,1.0308070000028238,1443.5291960531156,1396.9637381159182
"147.32.84.165",3948,"67.195.168.31",25,3,186,3,186,0,0,94831.340364,8.9294799999916,166.63904281116032,0
"147.32.84.165",3950,"205.188.156.193",25,3,186,3,186,0,0,94831.64103,8.929841000004672,166.63230621902693,0
"147.32.84.165",3951,"74.6.136.244",25,3,186,3,186,0,0,94832.070319,8.901619999989634,167.160584253398,0
"147.32.84.165",3739,"46.4.36.120",443,6,366,3,186,3,180,94839.969043,1.0304909999977099,1443.9718541969864,1397.3921169648256
"147.32.84.165",3971,"65.54.188.94",25,3,186,3,186,0,0,94840.269994,9.029991999996128,164.78419914443313,0
"147.32.84.165",3998,"202.152.60.3",25,3,186,3,186,0,0,94840.999769,9.002112000001944,165.29454421358884,0
"147.32.84.165",3755,"46.4.36.120",443,6,366,3,186,3,180,94843.882251,1.0313939999905415,1442.7076364741756,1396.1686804588796
"147.32.84.165",3999,"209.85.225.27",25,3,186,3,186,0,0,94844.885456,9.029360000000452,164.79573303090424,0
"147.32.84.165",4000,"205.188.156.193",25,3,186,3,186,0,0,94844.913895,9.001040999995894,165.3142119895553,0
"147.32.84.165",4001,"218.102.23.149",25,3,186,3,186,0,0,94844.913967,9.001017999995383,165.3146344114369,0
"147.32.84.165",4019,"207.115.20.22",25,3,186,3,186,0,0,94845.186774,9.028202999994392,164.81685225741205,0
"147.32.84.165",3809,"46.4.36.120",443,6,366,3,186,3,180,94847.895587,1.030375999995158,1444.133015527334,1397.5480795425815
"147.32.84.165",4021,"212.85.96.2",25,3,186,3,186,0,0,94848.397012,9.028741999994963,164.8070129815239,0
"147.32.84.165",4050,"205.188.190.2",25,3,186,3,186,0,0,94848.926181,9.001319999995758,165.30908800050452,0
"147.32.84.165",3809,"46.4.36.120",443,6,366,3,186,3,180,94852.309074,1.0308939999958966,1443.407372635715,1396.845844486176
"147.32.84.165",4056,"67.195.168.31",25,3,186,3,186,0,0,94852.610049,9.029032000005827,164.80171960837438,0
"147.32.84.165",4060,"74.6.136.244",25,3,186,3,186,0,0,94853.011641,9.02859499999613,164.80969630386986,0
"147.32.84.165",4131,"24.113.32.85",25,3,186,3,186,0,0,94853.340211,9.001420000000508,165.30725152252825,0
"147.32.84.165",3951,"46.4.36.120",443,6,366,3,186,3,180,94861.337947,1.0312189999967813,1442.9524669392674,1396.405613167033
"147.32.84.165",4135,"209.85.225.27",25,3,186,3,186,0,0,94862.040376,8.929403000001912,166.64047977224024,0
"147.32.84.165",3809,"212.117.171.138",65500,9,544,5,302,4,242,94862.040435,21.533756999997422,112.1959349685375,89.90535186220555
"147.32.84.165",4153,"205.188.156.193",25,3,186,3,186,0,0,94862.063074,8.906827999991947,167.06284212531614,0
"147.32.84.165",3440,"201.65.242.60",6667,3,186,3,186,0,0,94862.369404,8.901488000003155,167.1630630743391,0
"147.32.84.165",4166,"74.125.43.27",25,3,186,3,186,0,0,94865.953113,8.929562000004807,166.63751256771596,0
"147.32.84.165",4169,"67.195.168.31",25,3,186,3,186,0,0,94865.953255,8.929541000004974,166.63790445658643,0
"147.32.84.165",4177,"205.188.190.2",25,3,186,3,186,0,0,94865.953298,8.929547000007005,166.63779248811085,0
"147.32.84.165",4200,"205.188.159.42",25,3,186,3,186,0,0,94865.953328,8.929564999998547,166.63745658385847,0
"147.32.84.165",4202,"74.6.136.244",25,3,186,3,186,0,0,94866.254087,8.929157999999006,166.64505208667666,0
"147.32.84.165",4222,"209.85.225.27",25,3,186,3,186,0,0,94866.254215,8.929167000009329,166.64488411947556,0
"147.32.84.165",3999,"46.4.36.120",443,6,366,3,186,3,180,94869.465288,0.9301179999893066,1599.7970150207902,1548.1906596975389
"147.32.84.165",4223,"74.55.28.130",25,3,186,3,186,0,0,94869.866071,9.0300270000007,164.78356044781313,0
"147.32.84.165",4232,"195.74.38.202",25,3,186,3,186,0,0,94870.39564,9.002198000001954,165.2929651180386,0
"147.32.84.165",3999,"46.4.36.120",443,6,366,3,186,3,180,94873.578054,1.0306370000034804,1443.7673011884642,1397.1941624404492
"147.32.84.165",4239,"205.188.190.2",25,3,186,3,186,0,0,94873.979969,9.029159999990952,164.79938333150494,0
"147.32.84.165",4255,"205.188.190.2",25,3,186,3,186,0,0,94874.280629,9.029842999996617,164.78691822222794,0
"147.32.84.165",4272,"64.12.90.97",25,3,186,3,186,0,0,94874.280758,9.029777000003378,164.78812267450718,0
"147.32.84.165",4276,"208.65.144.3",25,3,186,3,186,0,0,94874.608927,9.002520000009099,165.28705295833788,0
"147.32.84.165",3999,"46.4.36.120",443,6,366,3,186,3,180,94882.808303,1.0310339999996359,1443.2113780927937,1396.6561723478649
"147.32.84.165",4298,"67.195.168.31",25,3,186,3,186,0,0,94883.00928,9.029498000003514,164.79321441783597,0
"147.32.84.165",4135,"212.117.171.138",65500,9,544,5,302,4,242,94883.839578,3.0828659999970114,783.6863490019813,627.9870743658261
"147.32.84.165",4301,"217.22.246.78",25,3,186,3,186,0,0,94883.862058,9.25295599999663,160.8134740941751,0
"147.32.84.165",4153,"46.4.36.120",443,6,366,3,186,3,180,94886.922765,1.0320820000051754,1441.7459077791673,1395.2379752701618
"147.32.84.165",4325,"74.6.136.244",25,3,186,3,186,0,0,94886.922908,9.028862999999546,164.8048043258686,0
"147.32.84.165",4166,"212.117.171.138",65500,40,15603,21,14303,19,1300,94887.223939,5.910391999990679,19359.79880863747,1759.6125603879404
"147.32.84.165",4332,"207.115.20.23",25,3,186,3,186,0,0,94887.246715,9.005739000000176,165.22797296257096,0
"147.32.84.165",4339,"205.188.190.2",25,3,186,3,186,0,0,94887.95508,9.001384999995935,165.3078942852319,0
"147.32.84.165",4343,"98.139.54.60",25,3,186,3,186,0,0,94887.955111,9.001481999992393,165.30611292687777,0
"147.32.84.165",4153,"46.4.36.120",443,6,366,3,186,3,180,94890.935673,1.0306240000063553,1443.785512457331,1397.21178624903
"147.32.84.165",4354,"64.12.90.97",25,3,186,3,186,0,0,94891.437285,9.031817999988561,164.7508840414947,0
"147.32.84.165",4177,"212.117.171.138",65500,9,544,5,302,4,242,94891.437312,0.8768649999983609,2755.2701955312577,2207.8655209223984
"147.32.84.165",4397,"205.188.59.193",25,3,186,3,186,0,0,94891.43734,9.03188899999077,164.74958892890743,0
"147.32.84.165",4222,"65.54.186.77",80,17,14251,10,756,7,13495,94891.966536,1.3068969999876572,4627.755668623556,82607.88723290329
"147.32.84.165",4403,"67.195.168.31",25,3,186,3,186,0,0,94892.131617,8.939371000000392,166.4546644277248,0
"147.32.84.165",4425,"74.6.136.244",25,3,186,3,186,0,0,94892.131649,8.939463000002434,166.45295136851004,0
"147.32.84.165",4429,"209.85.225.27",25,3,186,3,186,0,0,94892.131673,8.939488000003621,166.45248586936938,0
"147.32.84.165",4223,"212.117.171.138",65500,14,852,8,486,6,366,94895.049128,1.2999589999963064,2990.86355801302,2252.3787288740027
"147.32.84.165",4232,"46.4.36.120",443,6,366,3,186,3,180,94895.071567,1.0083709999889834,1475.6473559991875,1428.0458283863104
"147.32.84.165",4465,"205.188.59.193",25,3,186,3,186,0,0,94895.349992,8.932260999994469,166.587160854449,0
"147.32.84.165",4153,"196.205.12.237",6667,2,124,2,124,0,0,94895.350122,3.0113819999969564,329.41685910356193,0
"147.32.84.165",4470,"65.55.92.184",25,3,186,3,186,0,0,94895.650903,8.932390999994823,166.58473638255003,0
"147.32.84.165",4239,"98.126.71.122",80,11,4148,7,715,4,3433,94896.080487,16.964340999998967,337.1778485235794,1618.9252503237037
"147.32.84.165",4471,"72.167.238.201",25,3,186,3,186,0,0,94896.255861,8.930470000006608,166.620569801914,0
"147.32.84.165",4255,"95.100.248.97",80,11,4399,6,1280,5,3119,94903.980751,11.667221000010613,877.6725837275804,2138.64124112994
"147.32.84.165",4222,"212.117.171.138",65500,223,171559,131,164663,92,6896,94903.981756,188.77980200000457,6977.992274830165,292.23465336614066
"147.32.84.165",4272,"46.4.36.120",443,6,366,3,186,3,180,94904.004361,1.0085019999969518,1475.455675848434,1427.8603314662266
"147.32.84.165",4472,"209.85.225.27",25,3,186,3,186,0,0,94904.785041,9.03059700000449,164.77315951528564,0
"147.32.84.165",4153,"195.113.232.83",80,8,1170,5,798,3,372,94904.785173,10.862990000008722,587.6835015032578,273.95772250527807
"147.32.84.165",4477,"74.6.136.244",25,3,186,3,186,0,0,94904.786119,9.029622000001837,164.79095138198446,0
"147.32.84.165",4490,"205.188.156.193",25,3,186,3,186,0,0,94904.786178,9.029588000004878,164.79157188558284,0
"147.32.84.165",4298,"195.113.232.83",80,8,2617,5,762,3,1855,94905.013122,10.635286999997334,573.1862243117208,1395.3549161394253
"147.32.84.165",4492,"67.195.168.31",25,3,186,3,186,0,0,94905.013187,9.003922999996576,165.26129776993494,0
"147.32.84.165",4301,"74.125.232.217",80,8,1293,5,578,3,715,94907.895749,7.752840000001015,596.426599800769,737.7941502725777
"147.32.84.165",4272,"46.4.36.120",443,6,366,3,186,3,180,94907.903888,1.0229770000005374,1454.578157670425,1407.6562816165404
"147.32.84.165",4495,"205.188.156.193",25,3,186,3,186,0,0,94908.19761,9.029045999996015,164.80146407501488,0
"147.32.84.165",4504,"212.27.48.6",25,3,186,3,186,0,0,94908.197672,9.029106000001775,164.8003689401484,0
"147.32.84.165",4505,"74.6.136.244",25,3,186,3,186,0,0,94908.89957,9.028652000008151,164.8086558213404,0
"147.32.84.165",4512,"209.85.225.27",25,3,186,3,186,0,0,94908.927107,9.001239999997779,165.31055721215824,0
"147.32.84.165",4523,"74.6.140.31",25,3,186,3,186,0,0,94908.927167,9.00122900000133,165.31075923074283,0
"147.32.84.165",4325,"46.4.36.120",443,6,366,3,186,3,180,94912.411037,1.030956000002334,1443.3205684788018,1396.7618404633565
"147.32.84.165",4524,"67.195.168.31",25,3,186,3,186,0,0,94913.113381,9.028661000003922,164.808491535938,0
"147.32.84.165",4525,"205.188.156.193",25,3,186,3,186,0,0,94913.113475,9.028693000000203,164.80790741250883,0
"147.32.84.165",4526,"205.188.156.193",25,3,186,3,186,0,0,94913.113501,9.028714999993099,164.8075058301361,0
"147.32.84.165",4528,"205.188.156.193",25,3,186,3,186,0,0,94913.113523,9.028741999994963,164.8070129815239,0
"147.32.84.165",4531,"209.85.225.27",25,3,186,3,186,0,0,94913.113547,9.028764000002411,164.8066114032444,0
"147.32.84.165",4533,"209.85.143.27",25,3,186,3,186,0,0,94913.44214,9.000792000006186,165.31878528011507,0
"147.32.84.165",4534,"66.94.237.64",25,3,186,3,186,0,0,94913.915931,9.028281999999308,164.8154100636327,0
"147.32.84.165",4239,"89.108.150.205",6667,2,124,2,124,0,0,94916.624315,3.009745000003022,329.5960288991273,0
"147.32.84.165",4272,"46.4.36.120",443,6,366,3,186,3,180,94917.226843,1.0303569999960018,1444.1596456429897,1397.573850622248
"147.32.84.165",4536,"64.136.44.37",25,3,186,3,186,0,0,94918.257422,9.000969000000623,165.31553436078903,0
"147.32.84.165",4332,"173.192.170.88",80,15,1525,9,906,6,619,94925.854355,58.73355399999127,123.40475769610464,84.31296359148871
"147.32.84.165",4343,"46.4.36.120",443,6,366,3,186,3,180,94925.85446,1.0301089999993565,1444.507328836977,1397.9103182293327
"147.32.84.165",4537,"66.94.237.64",25,3,186,3,186,0,0,94926.054829,8.928364999999758,166.65985317580996,0
"147.32.84.165",4539,"128.121.85.2",25,3,186,3,186,0,0,94926.054961,8.928281999993487,166.6614024961449,0
"147.32.84.165",4540,"65.54.188.110",25,3,186,3,186,0,0,94926.884847,8.900872000012896,167.17463187852204,0
"147.32.84.165",4301,"46.4.36.120",443,6,366,3,186,3,180,94929.264518,1.0310980000067502,1443.1217983065224,1396.5694822321184
"147.32.84.165",4542,"67.195.168.31",25,3,186,3,186,0,0,94929.967272,8.927958000000217,166.66745072053024,0
"147.32.84.165",4543,"98.139.175.225",25,3,186,3,186,0,0,94929.967421,8.927910000013071,166.66834679088626,0
"147.32.84.165",4547,"64.12.90.97",25,3,186,3,186,0,0,94930.295809,8.900924999994459,167.17363644800133,0
"147.32.84.165",4470,"46.4.36.120",443,6,366,3,186,3,180,94934.080176,1.030531999989762,1443.9144053894327,1397.3365213446123
"147.32.84.165",4551,"74.6.136.244",25,3,186,3,186,0,0,94934.380827,9.029043999995338,164.80150057976994,0
"147.32.84.165",4557,"205.188.156.193",25,3,186,3,186,0,0,94934.882545,9.028906000006828,164.80401944586362,0
"147.32.84.165",4558,"209.85.225.27",25,3,186,3,186,0,0,94934.983069,9.028679000010015,164.8081629658502,0
"147.32.84.165",4343,"210.211.186.109",6667,3,186,3,186,0,0,94935.110949,9.001104000009946,165.31305493174568,0
"147.32.84.165",4477,"46.4.36.120",443,6,366,3,186,3,180,94939.196874,1.0307639999955427,1443.5894152361109,1397.0220147446234
"147.32.84.165",4574,"205.188.156.193",25,3,186,3,186,0,0,94940.227888,9.00248600001214,165.28767720360725,0
"147.32.84.165",4575,"67.195.168.31",25,3,186,3,186,0,0,94940.227956,9.002542000001995,165.2866490375352,0
"147.32.84.165",4578,"209.85.225.27",25,3,186,3,186,0,0,94940.228013,9.002536999993026,165.2867408377386,0
"147.32.84.165",4579,"65.54.188.94",25,3,186,3,186,0,0,94940.228068,9.002531000005547,165.28685099768978,0
"147.32.84.165",4512,"46.4.36.120",443,6,366,3,186,3,180,94947.022053,1.0303840000124183,1444.1218031161843,1397.537228822114
"147.32.84.165",4525,"184.82.148.43",80,10,1921,5,983,5,938,94947.824673,0.30668900000455324,25641.61088230503,24467.783324112024
"147.32.84.165",4590,"64.12.90.33",25,3,186,3,186,0,0,94947.925453,9.031999999991967,164.74756421626697,0
"147.32.84.165",4531,"184.82.148.44",80,10,1512,5,594,5,918,94948.052669,0.32312000000092667,14706.610547122964,22728.398118280944
"147.32.84.165",4592,"74.6.136.244",25,3,186,3,186,0,0,94948.159129,8.998871999996481,165.3540577086308,0
"147.32.84.165",4599,"207.115.37.23",25,3,186,3,186,0,0,94948.159191,8.998932999995304,165.35293684270974,0
"147.32.84.165",4534,"46.4.36.120",443,6,366,3,186,3,180,94950.936675,1.031617999993614,1442.3943746708678,1395.8655238750332
"147.32.84.165",4533,"217.163.21.36",80,14,6141,7,810,7,5331,94950.936745,0.1873619999969378,34585.45489536783,227623.5309224764
"147.32.84.165",4606,"195.50.106.142",25,3,186,3,186,0,0,94950.982584,8.983734000008553,165.63268680913563,0
"147.32.84.165",4512,"217.163.21.36",80,10,1451,5,701,5,750,94951.238078,0.1407630000030622,39840.01477574364,42624.837491879785
"147.32.84.165",4613,"216.32.181.178",25,3,186,3,186,0,0,94951.285029,8.982825999992201,165.6494292554806,0
"147.32.84.165",4525,"217.163.21.37",80,9,2951,5,1380,4,1571,94951.968556,0.2794059999869205,39512.394152297384,44981.13856033274
"147.32.84.165",4614,"67.195.168.31",25,3,186,3,186,0,0,94952.01462,8.962237999992794,166.02995814228504,0
"147.32.84.165",3672,"46.4.36.120",443,6,366,3,186,3,180,94955.45141,1.0321729999996023,1441.618798399661,1395.1149661932204
"147.32.84.165",4531,"217.163.21.36",80,10,2277,5,1156,5,1121,94955.551893,0.13954699999885634,66271.57875178823,64265.08631553167
"147.32.84.165",4634,"205.188.156.193",25,3,186,3,186,0,0,94955.597643,8.891778000004706,167.3456084935108,0
"147.32.84.165",4635,"74.6.136.244",25,3,186,3,186,0,0,94955.597733,8.891814000002341,167.34493096679802,0
"147.32.84.165",4637,"212.82.111.207",25,3,186,3,186,0,0,94955.954263,8.936314999999013,166.5115878301251,0
"147.32.84.165",4534,"78.56.242.233",6667,3,186,3,186,0,0,94956.055092,8.935235000011744,166.53171405095046,0
"147.32.84.165",4533,"217.163.21.38",80,13,4103,7,1949,6,2154,94956.483857,0.15800100000342354,98682.91972621791,109062.6008672516
"147.32.84.165",4645,"198.77.13.239",25,3,186,3,186,0,0,94956.529888,8.862420999997994,167.89994517303305,0
"147.32.84.165",4547,"46.4.36.120",443,6,366,3,186,3,180,94961.278531,0.9309970000031171,1598.2865680501848,1546.7289368227596
"147.32.84.165",4542,"184.82.148.43",80,10,1921,5,983,5,938,94962.209774,0.3083950000000186,25499.76491188095,24332.4308111336
"147.32.84.165",4658,"216.32.180.22",25,3,186,3,186,0,0,94962.311357,9.002604000008432,165.28551072540859,0
"147.32.84.165",4558,"46.4.36.120",443,6,366,3,186,3,180,94968.905208,1.0314730000100099,1442.597140192288,1396.0617485731818
"147.32.84.165",4551,"173.192.170.88",80,9,988,7,864,2,124,94969.106486,13.035986999995657,530.2245238509598,76.09703814527664
"147.32.84.165",4543,"195.113.232.90",80,168,195598,110,15451,58,180147,94969.106612,115.60729499999434,1069.205883590703,12466.133733170303
"147.32.84.165",4662,"64.12.90.97",25,3,186,3,186,0,0,94969.107397,9.029248000006191,164.7977771791161,0
"147.32.84.165",4557,"184.82.148.44",80,10,1511,5,594,5,917,94969.936964,0.303211000005831,15672.25463426002,24194.37289497717
"147.32.84.165",4663,"205.188.156.193",25,3,186,3,186,0,0,94970.037233,9.001812000002246,165.30005292263698,0
"147.32.84.165",4592,"46.4.36.120",443,6,366,3,186,3,180,94971.916143,1.030577000012272,1443.8513570381263,1397.2755068110898
"147.32.84.165",4578,"195.113.232.99",80,11,2010,6,685,5,1325,94972.217305,0.025838999994448386,212082.51097865243,410232.59422878025
"147.32.84.165",4664,"209.85.225.27",25,3,186,3,186,0,0,94972.21825,9.027457999996841,164.83045393293668,0
"147.32.84.165",4558,"31.192.109.161",80,10,1273,5,540,5,733,94972.919021,0.24163300001237076,17878.352707530972,24268.208397444818
"147.32.84.165",4534,"217.163.21.36",80,14,6137,7,809,7,5328,94972.946937,0.18921799999952782,34203.93408669445,225263.9812285637
"147.32.84.165",4673,"64.18.7.11",25,3,186,3,186,0,0,94972.992984,8.956186000010348,166.1421502409933,0
"147.32.84.165",4590,"184.82.148.43",80,10,1921,5,983,5,938,94973.000584,0.32284200000867713,24358.664609278338,23243.568060532125
"147.32.84.165",4677,"212.27.48.7",25,3,186,3,186,0,0,94973.1073,8.94184800000221,166.40855447326237,0
"147.32.84.165",4590,"46.4.36.120",443,6,366,3,186,3,180,94976.530472,1.030761000001803,1443.5936167524742,1397.026080728201
"147.32.84.165",4578,"217.163.21.39",80,14,7528,7,2516,7,5012,94976.630457,3.1549079999967944,6379.900776827867,12709.086921089534
"147.32.84.165",4678,"74.6.136.244",25,3,186,3,186,0,0,94976.676321,8.984177999998792,165.62450120647654,0
"147.32.84.165",4606,"195.113.232.97",80,14,3691,9,2213,5,1478,94976.931398,107.77931100000569,164.26158077777157,109.70565584706118
"147.32.84.165",4702,"67.195.168.31",25,3,186,3,186,0,0,94976.932292,9.02951700000267,164.79286765832103,0
"147.32.84.165",4614,"217.163.21.37",80,10,1448,5,699,5,749,94977.434142,0.13952799999970011,40077.977180293696,42944.78527616592
"147.32.84.165",4703,"208.81.96.33",25,3,186,3,186,0,0,94977.480221,8.98299199999019,165.6463681590304,0
"147.32.84.165",4558,"184.82.148.44",80,10,1512,5,594,5,918,94977.56147,0.3293929999927059,14426.53608335705,22295.555765188168
"147.32.84.165",4708,"205.188.156.193",25,3,186,3,186,0,0,94977.669317,8.994277999998303,165.43851546508577,0
"147.32.84.165",4634,"217.163.21.39",80,9,2982,5,1413,4,1569,94977.669376,0.27420600000186823,41224.480864470446,45775.80359260731
"147.32.84.165",4722,"207.115.20.23",25,3,186,3,186,0,0,94977.669425,8.99430299999949,165.4380556225518,0
"147.32.84.165",4645,"46.4.36.120",443,6,366,3,186,3,180,94983.353264,1.030557999998564,1443.8779767874041,1397.3012678587781
"147.32.84.165",4635,"217.163.21.37",80,13,6081,6,750,7,5331,94984.384063,0.18878399999812245,31782.35443713277,225908.97533913972
"147.32.84.165",4726,"98.139.54.60",25,3,186,3,186,0,0,94984.429925,8.856340999991517,168.01521079658352,0
"147.32.84.165",4658,"173.192.170.88",80,13,1693,9,1447,4,246,94990.175888,45.251650999998674,255.8138707469555,43.49012591827992
"147.32.84.165",4332,"46.4.36.120",443,6,366,3,186,3,180,94990.376713,1.0307939999911468,1443.547401336038,1396.9813561316496
"147.32.84.165",4637,"217.163.21.37",80,10,2274,5,1154,5,1120,94991.078613,0.13935499999206513,66248.07147591167,64296.221883033846
"147.32.84.165",4734,"137.207.32.19",25,3,186,3,186,0,0,94991.124497,8.884699000002001,167.4789432933704,0
"147.32.84.165",4590,"217.163.21.39",80,11,4011,6,1413,5,2598,94991.407745,0.24466499999107327,46201.94960624704,84948.80755628437
"147.32.84.165",4738,"209.85.225.27",25,3,186,3,186,0,0,94991.453637,8.856752000006963,168.00741400446012,0
"147.32.84.165",4634,"184.82.148.43",80,10,1921,5,983,5,938,94991.453695,0.3423029999976279,22973.798067952943,21922.098258128037
"147.32.84.165",4741,"205.188.59.193",25,3,186,3,186,0,0,94991.566476,8.844805999993696,168.23432871236074,0
"147.32.84.165",4332,"46.4.36.120",443,6,366,3,186,3,180,94993.185766,1.031434000004083,1442.6516868690676,1396.1145356797429
"147.32.84.165",4662,"217.163.21.39",80,13,4155,7,1982,6,2173,94993.888137,0.1727109999919776,91806.54388392465,100653.69316839972
"147.32.84.165",4756,"65.55.92.168",25,3,186,3,186,0,0,94993.934243,8.9856090000103,165.59812473459445,0
"147.32.84.165",4590,"184.82.148.44",80,10,1511,5,594,5,917,94993.988241,0.3227500000066357,14723.470177853756,22729.66692439713
"147.32.84.165",4785,"207.115.37.23",25,3,186,3,186,0,0,94994.094707,9.025502999997116,164.8661575981389,0
"147.32.84.165",4664,"195.113.232.99",80,11,1964,6,787,5,1177,94994.217399,0.013156999993952923,478528.5401606521,715664.6655261595
"147.32.84.165",4798,"74.6.136.244",25,3,186,3,186,0,0,94994.218212,9.002502999996068,165.28736508065035,0
"147.32.84.165",4800,"209.85.225.27",25,3,186,3,186,0,0,94994.21827,9.00257799999963,165.28598808031,0
"147.32.84.165",4664,"46.4.36.120",443,6,366,3,186,3,180,94997.600843,1.0303470000071684,1444.173661872794,1397.587414715607
"147.32.84.165",4662,"217.163.21.34",80,14,6137,7,809,7,5328,94997.901528,0.1887259999930393,34293.102170547274,225851.23407252887
"147.32.84.165",4819,"216.32.181.178",25,3,186,3,186,0,0,94997.947369,8.985235999993165,165.60499913426113,0
"147.32.84.165",4677,"217.163.21.39",80,14,6508,7,1498,7,5010,94998.403586,0.2026869999972405,59125.64693425409,197743.31851843323
"147.32.84.165",4824,"205.188.156.193",25,3,186,3,186,0,0,94998.449481,8.984972999998718,165.60984657385308,0
"147.32.84.165",4678,"217.163.21.34",80,10,1448,5,699,5,749,94998.603945,0.13934300000255462,40131.187070017724,43001.80130964704
"147.32.84.165",4829,"195.50.106.142",25,3,186,3,186,0,0,94998.63151,9.003605999998399,165.2671163087617,0
"147.32.84.165",4841,"205.188.190.2",25,3,186,3,186,0,0,94998.649906,8.985330999988946,165.6032482277871,0
"147.32.84.165",4677,"46.4.36.120",443,6,366,3,186,3,180,95005.327782,1.030168000012054,1444.424598689329,1397.830256796125
"147.32.84.165",4702,"217.163.21.40",80,11,4070,6,1441,5,2629,95006.358192,0.24177799999597482,47680.103235993025,86988.89063665902
"147.32.84.165",4843,"158.35.238.238",25,3,186,3,186,0,0,95006.404097,8.955898999993224,166.14747441894173,0
"147.32.84.165",4702,"46.24.73.184",6667,2,124,2,124,0,0,95012.049942,3.0095629999996163,329.6159608554885,0
"147.32.84.165",4677,"46.4.36.120",443,6,366,3,186,3,180,95012.451198,1.0303920000005746,1444.1105909199316,1397.5263783096113
"147.32.84.165",4703,"217.163.21.40",80,10,3082,5,1443,5,1639,95013.481827,0.259425000011106,44498.40994316585,50542.546013062245
"147.32.84.165",4857,"209.86.93.226",25,3,186,3,186,0,0,95013.527767,8.956503999987035,166.1362513768937,0
"147.32.84.165",4677,"46.4.36.120",443,6,366,3,186,3,180,95014.959281,1.031634999992093,1442.3706058939497,1395.8425218328546
"147.32.84.165",4678,"184.82.148.43",80,10,1921,5,983,5,938,95015.159313,0.3398250000027474,23141.322739458315,22081.9539467059
"147.32.84.165",4872,"204.127.217.16",25,3,186,3,186,0,0,95015.260328,9.029864999989513,164.78651674213603,0
"147.32.84.165",4738,"217.163.21.34",80,10,2274,5,1154,5,1120,95015.271647,0.13993699999991804,65972.54478805039,64028.81296587212
"147.32.84.165",4882,"74.6.136.244",25,3,186,3,186,0,0,95015.31748,8.972835000007763,165.8338752466431,0
"147.32.84.165",4756,"217.163.21.41",80,13,4240,7,2037,6,2203,95015.991149,0.15907700000389013,102440.95626395702,110789.11470274783
"147.32.84.165",4905,"205.188.59.193",25,3,186,3,186,0,0,95016.037237,8.85486600000877,168.04319794320168,0
"147.32.84.165",4677,"46.4.36.120",443,6,366,3,186,3,180,95018.97319,1.0305089999892516,1443.9466322133237,1397.3677085935392
"147.32.84.165",4785,"184.82.148.44",80,10,1512,5,594,5,918,95019.474618,0.32703300000866875,14530.643696122524,22456.449348552993
"147.32.84.165",4925,"207.115.37.23",25,3,186,3,186,0,0,95019.582369,8.9222010000085,166.77499195530146,0
"147.32.84.165",4678,"195.113.232.99",80,11,1978,6,801,5,1177,95019.674914,0.011690999992424622,548113.9341503866,805405.8682834021
"147.32.84.165",4935,"212.143.86.2",25,3,186,3,186,0,0,95019.67498,8.929364000010537,166.64120759308773,0
"147.32.84.165",4936,"204.127.217.16",25,3,186,3,186,0,0,95019.675799,8.928667999993195,166.6541974683272,0
"147.32.84.165",4937,"209.85.225.27",25,3,186,3,186,0,0,95019.675834,8.928683000005549,166.65391749254346,0
"147.32.84.165",4819,"217.163.21.34",80,14,6135,7,810,7,5325,95020.00394,0.18798800000513438,34470.2853364205,226610.2091560977
"147.32.84.165",4939,"98.139.54.60",25,3,186,3,186,0,0,95020.049935,8.855846999998903,168.02458308055506,0
"147.32.84.165",4824,"46.4.36.120",443,6,366,3,186,3,180,95027.300375,1.0311629999923753,1443.0308302479848,1396.481448627082
"147.32.84.165",4678,"217.163.21.41",80,13,6479,6,1468,7,5011,95027.801773,0.19474400000763126,60304.81041541613,205849.73092074264
"147.32.84.165",4942,"205.188.59.193",25,3,186,3,186,0,0,95027.847872,8.98369300000195,165.63344272780438,0
"147.32.84.165",4785,"217.163.21.34",80,10,1447,5,699,5,748,95027.847905,0.13890399999218062,40258.01992969816,43080.11288614338
"147.32.84.165",4946,"67.195.168.31",25,3,186,3,186,0,0,95027.893823,8.937790999989375,166.4840898608805,0
"147.32.84.165",4678,"111.88.33.160",6667,3,186,3,186,0,0,95028.331777,9.001722999993945,165.30168724376443,0
"147.32.84.165",4677,"184.82.148.43",80,10,1921,5,983,5,938,95034.424478,0.3220609999989392,24417.73452863247,23299.933863537393
"147.32.84.165",4949,"64.12.90.97",25,3,186,3,186,0,0,95034.531026,9.024360000010347,164.88703908069868,0
"147.32.84.165",4658,"173.192.170.88",80,9,984,6,547,3,437,95036.330421,29.115686999997706,150.29698595126212,120.07272917861341
"147.32.84.165",4677,"46.4.36.120",443,6,366,3,186,3,180,95036.330553,1.0304039999900851,1444.0937729417956,1397.510102846899
"147.32.84.165",4977,"208.177.94.80",25,3,186,3,186,0,0,95036.932374,9.030509999996866,164.77474694125985,0
"147.32.84.165",1030,"173.247.252.128",25,3,186,3,186,0,0,95037.36118,9.003477999998722,165.2694658664364,0
"147.32.84.165",4872,"46.4.36.120",443,6,366,3,186,3,180,95040.544915,1.0304869999963557,1443.9774592064357,1397.3975411675183
"147.32.84.165",1033,"64.12.90.97",25,3,186,3,186,0,0,95040.64568,9.030408999999054,164.77658985325647,0
"147.32.84.165",1040,"205.188.156.193",25,3,186,3,186,0,0,95040.645805,9.030333000002429,164.77797662606682,0
"147.32.84.165",1044,"67.195.168.31",25,3,186,3,186,0,0,95040.645867,9.030318000004627,164.77825033395698,0
"147.32.84.165",1055,"125.206.187.30",25,3,186,3,186,0,0,95040.645917,9.030314000003273,164.77832332291666,0
"147.32.84.165",1056,"209.85.225.27",25,3,186,3,186,0,0,95040.946406,9.02967799999169,164.78992938633795,0
"147.32.84.165",1077,"74.6.136.244",25,3,186,3,186,0,0,95041.575612,9.00171899999259,165.30176069717626,0
"147.32.84.165",4678,"46.4.36.120",443,6,366,3,186,3,180,95045.56165,1.0306689999997616,1443.7224754022332,1397.1507826473223
"147.32.84.165",4872,"184.82.155.107",80,10,1909,5,981,5,928,95046.592531,0.3226719999947818,24321.912034905155,23007.88416757593
"147.32.84.165",1083,"77.238.177.9",25,3,186,3,186,0,0,95046.699144,8.894777000008617,167.28918555221324,0
"147.32.84.165",4678,"46.4.36.120",443,6,366,3,186,3,180,95048.872727,1.0305630000075325,1443.87097148755,1397.2944885363388
"147.32.84.165",4939,"184.82.155.108",80,10,1507,5,596,5,911,95048.872868,0.30841299999156035,15459.789308915237,23630.65110809024
"147.32.84.165",1084,"65.54.188.94",25,3,186,3,186,0,0,95048.974581,8.926246999995783,166.6993978545186,0
"147.32.84.165",4872,"58.252.109.242",6667,3,186,3,186,0,0,95049.903502,8.90068199999223,167.17820050208502,0
"147.32.84.165",4946,"46.4.36.120",443,6,366,3,186,3,180,95055.493285,1.0311789999977918,1443.0084398568886,1396.4597805066662
"147.32.84.165",4942,"217.163.21.35",80,14,6137,7,809,7,5328,95056.524706,0.1888980000076117,34261.876778680606,225645.58649791134
"147.32.84.165",1085,"114.134.80.211",25,3,186,3,186,0,0,95056.57073,8.95589499999187,166.14754862594424,0
"147.32.84.165",4939,"184.82.147.251",80,10,1910,5,982,5,928,95057.900978,0.3398919999890495,23113.224201373087,21842.232239179455
"147.32.84.165",1087,"67.195.168.31",25,3,186,3,186,0,0,95058.013348,9.018723000001046,164.99009893083837,0
"147.32.84.165",4949,"217.163.21.35",80,10,1448,5,699,5,749,95058.302852,0.1393650000100024,40124.8520044391,42995.01309202416
"147.32.84.165",1088,"205.188.156.193",25,3,186,3,186,0,0,95058.348718,8.985041000007186,165.60859321608103,0
"147.32.84.165",4946,"184.82.147.252",80,10,1508,5,596,5,912,95058.348777,0.3036909999937052,15700.168922025445,24024.41955853558
"147.32.84.165",1090,"205.188.190.2",25,3,186,3,186,0,0,95058.449213,8.983995999995386,165.6278564684094,0
"147.32.84.165",4939,"46.4.36.120",443,6,366,3,186,3,180,95061.612894,1.0308949999889592,1443.4059724956824,1396.8444895119505
"147.32.84.165",1030,"217.163.21.41",80,11,3818,6,1533,5,2285,95061.613031,0.2587340000027325,47400.032465275064,70651.71179592532
"147.32.84.165",1102,"98.139.175.225",25,3,186,3,186,0,0,95061.659086,8.984641000002739,165.6159661804569,0
"147.32.84.165",4977,"217.163.21.35",80,13,6081,6,750,7,5331,95061.914144,0.18710900000587571,32066.870112135624,227931.31275706002
"147.32.84.165",1126,"65.55.37.72",25,3,186,3,186,0,0,95061.960369,8.984062000003178,165.62663970923995,0
"147.32.84.165",4949,"217.163.21.35",80,10,1451,5,701,5,750,95062.515722,0.13900500000454485,40343.872521252066,43163.914965676246
"147.32.84.165",1146,"209.85.225.27",25,3,186,3,186,0,0,95062.561605,8.985288000010769,165.60404073839555,0
"147.32.84.165",1159,"205.188.190.2",25,3,186,3,186,0,0,95062.644064,9.00318800000241,165.27478933013523,0
"147.32.84.165",1160,"72.167.238.201",25,3,186,3,186,0,0,95062.644124,9.003152000004775,165.2754501977986,0
"147.32.84.165",1044,"46.4.36.120",443,6,366,3,186,3,180,95067.634344,1.0303929999936372,1444.1091894152896,1397.5250220147964
"147.32.84.165",1033,"217.163.21.34",80,9,3051,5,1471,4,1580,95068.664978,0.22472800000105053,52365.52632491273,56245.77266713944
"147.32.84.165",1161,"67.195.168.31",25,3,186,3,186,0,0,95068.710919,8.956546000001254,166.13547231262942,0
"147.32.84.165",4977,"184.82.147.251",80,10,1894,5,982,5,912,95068.710949,0.322465999997803,24362.25834678237,22625.64115301988
"147.32.84.165",1162,"65.54.188.126",25,3,186,3,186,0,0,95068.817492,8.949744999990799,166.26172030616848,0
"147.32.84.165",1033,"46.4.36.120",443,6,366,3,186,3,180,95069.941656,1.0302130000054603,1444.3615058168682,1397.7691991776144
"147.32.84.165",4939,"217.163.21.35",80,10,2277,5,1156,5,1121,95069.941797,0.1404939999920316,65824.87508736685,63831.90741603654
"147.32.84.165",1163,"65.254.0.15",25,3,186,3,186,0,0,95069.987735,8.983236000000034,165.64186892117655,0
"147.32.84.165",1044,"61.17.216.5",6667,3,186,3,186,0,0,95070.97211,9.002470999999787,165.2879526076824,0
"147.32.84.165",1033,"46.4.36.120",443,6,366,3,186,3,180,95077.567458,1.030174999992596,1444.4147839063212,1397.8207586190206
"147.32.84.165",4949,"184.82.147.252",80,10,1306,5,584,5,722,95078.597846,0.32307199999922886,14461.17274171439,17878.367670407173
"147.32.84.165",1164,"163.192.2.18",25,3,186,3,186,0,0,95078.704219,10.094490999996196,147.4071352384742,0
"147.32.84.165",1083,"217.163.21.34",80,13,4498,7,2040,6,2458,95079.071894,0.15994700000737794,102033.79869111144,122940.72410919212
"147.32.84.165",1179,"74.6.136.244",25,3,186,3,186,0,0,95079.117836,10.111676000000443,147.1566137997237,0
"147.32.84.165",4537,"212.117.171.138",65500,15,923,8,486,7,437,95079.473055,12.998035000011441,299.1221365380673,268.9637318253815
"147.32.84.165",4949,"173.241.240.4",80,9,2195,5,1165,4,1030,95079.473182,0.06811300000117626,136831.44186629646,120975.4378732063
"147.32.84.165",1192,"212.61.26.38",25,3,186,3,186,0,0,95079.489585,10.173905000003288,146.25652588652235,0
"147.32.84.165",1087,"65.55.16.187",443,138,166805,71,5644,67,161161,95082.683218,10.218024000001606,4418.858284145046,126177.8206823352
"147.32.84.165",1033,"46.4.36.120",443,6,366,3,186,3,180,95082.845438,0.9695470000006026,1534.7373567233722,1485.2297000548763
"147.32.84.165",1194,"98.139.54.60",25,3,186,3,186,0,0,95082.984354,9.47715099999914,157.00921089050235,0
"147.32.84.165",1210,"195.137.161.8",25,3,186,3,186,0,0,95083.587182,8.928615999990143,166.65516805758503,0
"147.32.84.165",1211,"207.115.20.23",25,3,186,3,186,0,0,95083.687388,8.928034999989904,166.66601329426717,0
"147.32.84.165",1220,"205.188.156.193",25,3,186,3,186,0,0,95083.815231,8.900976000004448,167.17267859156755,0
"147.32.84.165",1126,"46.4.36.120",443,6,366,3,186,3,180,95090.95269,1.9917439999990165,747.0839625979718,722.9844799335211
"147.32.84.165",1224,"74.125.45.27",25,3,186,3,186,0,0,95091.814291,8.125637999997707,183.1240820721302,0
"147.32.84.165",1146,"212.117.171.138",65500,9,544,5,302,4,242,95092.248305,5.977278000005754,404.19736207646264,323.8932504056422
"147.32.84.165",1242,"67.195.168.31",25,3,186,3,186,0,0,95092.251504,7.789180000007036,191.0342295336166,0
"147.32.84.165",1162,"221.208.241.38",6667,3,186,3,186,0,0,95092.944671,9.002110000001267,165.29458093711258,0
"147.32.84.165",4939,"46.4.36.120",443,6,366,3,186,3,180,95099.639391,1.0315089999930933,1442.5467931059866,1396.0130255864387
"147.32.84.165",1033,"184.82.148.43",80,10,1907,5,987,5,920,95100.040823,0.3047799999912968,25907.21176004159,24148.56617957271
"147.32.84.165",1251,"65.55.92.152",25,3,186,3,186,0,0,95100.141346,9.029070999997202,164.80100776707383,0
"147.32.84.165",1164,"184.82.148.44",80,10,1475,5,581,5,894,95100.441734,0.32251199999882374,14411.866845317236,22175.91903565165
"147.32.84.165",1266,"209.85.225.27",25,3,186,3,186,0,0,95100.547986,9.023786999998265,164.8975092165059,0
"147.32.84.165",1271,"74.6.136.244",25,3,186,3,186,0,0,95100.671145,9.001055999993696,165.31393649823335,0
"147.32.84.165",1164,"212.117.171.138",65500,14,863,8,486,6,377,95103.953016,7.709562999996706,504.3087396784566,391.2024585571567
"147.32.84.165",1162,"46.4.36.120",443,6,366,3,186,3,180,95103.975615,1.009344999998575,1474.2233824927064,1426.6677895090706
"147.32.84.165",1179,"217.163.21.35",80,13,6804,6,1500,7,5304,95104.554991,0.1874249999964377,64025.61024531455,226394.55782743223
"147.32.84.165",1275,"65.55.92.152",25,3,186,3,186,0,0,95104.600949,8.984039000002667,165.62706372930464,0
"147.32.84.165",1277,"207.115.37.23",25,3,186,3,186,0,0,95104.601009,8.98410000000149,165.62593915915375,0
"147.32.84.165",1278,"67.195.168.31",25,3,186,3,186,0,0,95104.656537,9.028619000004255,164.8092582043055,0
"147.32.84.165",1279,"168.95.5.43",25,3,186,3,186,0,0,95104.656663,9.028617000003578,164.80929471251358,0
"147.32.84.165",1194,"217.163.21.35",80,11,4028,6,1502,5,2526,95104.756363,0.24609100000816397,48827.46626086031,82115.96522964923
"147.32.84.165",1283,"209.85.225.27",25,3,186,3,186,0,0,95104.8022,8.98330699998769,165.6405597629068,0
"147.32.84.165",1285,"64.12.90.97",25,3,186,3,186,0,0,95104.80223,8.983370999994804,165.63937969397688,0
"147.32.84.165",1179,"195.113.232.88",80,27,30488,17,1716,10,28772,95104.985202,60.027456000010716,228.69534900825298,3834.5119939775377
"147.32.84.165",1288,"121.197.253.23",25,3,186,3,186,0,0,95104.986086,8.999732999989646,165.33823836792845,0
"147.32.84.165",1162,"46.4.36.120",443,6,366,3,186,3,180,95111.578883,1.0301350000081584,1444.470870311382,1397.8750357852084
"147.32.84.165",1297,"202.67.240.102",25,3,186,3,186,0,0,95111.97983,8.92917899999884,166.6446601641868,0
"147.32.84.165",1211,"212.117.171.138",65500,9,544,5,302,4,242,95112.080237,4.702389999991283,513.781289940749,411.7055369723883
"147.32.84.165",1210,"94.100.176.20",25,3,186,3,186,0,0,95112.103215,8.906305000011344,167.07265246340708,0
"147.32.84.165",1315,"124.108.116.109",25,3,186,3,186,0,0,95112.609268,8.902755000002799,167.13927317999116,0
"147.32.84.165",1211,"212.117.171.138",65500,9,544,5,302,4,242,95121.109357,63.39190300001064,38.11212293152951,30.540177978245502
"147.32.84.165",1162,"46.4.36.120",443,6,366,3,186,3,180,95121.132209,1.0093070000002626,1474.278886403852,1426.7215029714698
"147.32.84.165",1316,"202.146.123.1",25,3,186,3,186,0,0,95121.512157,9.033916000000318,164.7126229643875,0
"147.32.84.165",1336,"64.12.90.33",25,3,186,3,186,0,0,95121.612288,9.033649999997579,164.71747300375804,0
"147.32.84.165",1266,"58.252.109.242",6667,3,186,3,186,0,0,95122.141757,9.005607999992208,165.2303764500173,0
"147.32.84.165",1271,"46.4.36.120",443,6,366,3,186,3,180,95125.528898,1.031340999994427,1442.7817763552896,1396.2404287309253
"147.32.84.165",1340,"64.12.90.33",25,3,186,3,186,0,0,95125.62914,9.030815999998595,164.76916371679278,0
"147.32.84.165",1350,"65.55.37.104",25,3,186,3,186,0,0,95125.629269,9.0308090000035,164.76929143329497,0
"147.32.84.165",1354,"74.6.136.244",25,3,186,3,186,0,0,95125.729201,9.030599000005168,164.77312302308502,0
"147.32.84.165",1356,"67.195.168.31",25,3,186,3,186,0,0,95125.929953,9.031077000006917,164.7644018536062,0
"147.32.84.165",1359,"98.139.54.60",25,3,186,3,186,0,0,95126.560456,9.0022459999891,165.29208377573792,0
"147.32.84.165",1275,"46.4.36.120",443,6,366,3,186,3,180,95132.953679,1.031472999995458,1442.59714021264,1396.0617485928774
"147.32.84.165",1361,"209.85.225.27",25,3,186,3,186,0,0,95133.053935,9.03194899999653,164.74849448336917,0
"147.32.84.165",1210,"74.125.93.27",25,3,186,3,186,0,0,95133.5555,9.03197499999078,164.74802022830212,0
"147.32.84.165",1365,"199.239.254.18",25,3,186,3,186,0,0,95133.9854,9.003238999997848,165.2738531100147,0
"147.32.84.165",1297,"46.4.36.120",443,6,366,3,186,3,180,95142.587619,1.0363470000011148,1435.812522252102,1389.4959892762279
"147.32.84.165",1387,"165.21.74.121",25,3,186,3,186,0,0,95142.687586,8.929355999993277,166.64135689081277,0
"147.32.84.165",1401,"65.55.37.120",25,3,186,3,186,0,0,95142.687719,8.9293650000036,166.64118893106064,0
"147.32.84.165",1404,"205.188.190.2",25,3,186,3,186,0,0,95143.624203,8.895904999997583,167.2679732978718,0
"147.32.84.165",1336,"46.4.36.120",443,6,366,3,186,3,180,95146.70148,1.0311919999949168,1442.9902481859197,1396.4421756637933
"147.32.84.165",1412,"64.12.90.97",25,3,186,3,186,0,0,95146.801353,8.929833999995026,166.6324368404641,0
"147.32.84.165",1417,"98.139.175.225",25,3,186,3,186,0,0,95147.002433,8.929619000002276,166.6364488786835,0
"147.32.84.165",1419,"66.194.105.178",25,3,186,3,186,0,0,95147.604299,8.929434999998193,166.63988259058956,0
"147.32.84.165",1423,"98.139.54.60",25,3,186,3,186,0,0,95147.732869,8.901362000004156,167.16542929040583,0
"147.32.84.165",1354,"46.4.36.120",443,6,366,3,186,3,180,95154.025753,1.0308170000062091,1443.5151923096312,1396.9501861060946
"147.32.84.165",1424,"198.185.24.87",25,3,186,3,186,0,0,95154.527328,9.029839000009815,164.7869912186012,0
"147.32.84.165",1210,"74.125.39.27",25,3,186,3,186,0,0,95154.928495,9.03038799999922,164.77697303816055,0
"147.32.84.165",1457,"74.6.136.244",25,3,186,3,186,0,0,95155.056801,9.001873999994132,165.29891442614837,0
"147.32.84.165",1354,"46.4.36.120",443,6,366,3,186,3,180,95163.657475,1.0327660000039032,1440.7910407530615,1394.3139104061886
"147.32.84.165",1365,"184.82.148.43",80,10,1927,5,987,5,940,95163.657613,0.3052809999935562,25864.69515026047,24633.043000248068
"147.32.84.165",1474,"67.195.168.31",25,3,186,3,186,0,0,95163.758593,9.033607999997912,164.7182388255439,0
"147.32.84.165",1481,"165.21.74.121",25,3,186,3,186,0,0,95164.560921,9.0341000000044,164.70926821700834,0
"147.32.84.165",1486,"67.195.168.230",25,3,186,3,186,0,0,95164.69048,9.00486999998975,165.24391801344092,0
"147.32.84.165",1404,"46.4.36.120",443,6,366,3,186,3,180,95167.774983,1.031862000003457,1442.0532978198778,1395.5354495031074
"147.32.84.165",1488,"204.227.183.215",25,3,186,3,186,0,0,95167.975104,9.033038000008673,164.7286328252545,0
"147.32.84.165",1514,"209.85.225.27",25,3,186,3,186,0,0,95168.579296,9.030908000000636,164.76748517423664,0
"147.32.84.165",1515,"64.12.90.97",25,3,186,3,186,0,0,95168.679453,9.030954000001657,164.76664591578333,0
"147.32.84.165",1519,"209.85.225.27",25,3,186,3,186,0,0,95168.807045,9.003242999999202,165.2737796814028,0
"147.32.84.165",1520,"205.188.190.2",25,3,186,3,186,0,0,95168.807075,9.00338599999668,165.27115465232177,0
"147.32.84.165",1417,"46.4.36.120",443,5,306,3,186,2,120,95175.603618,1.0037440000014612,1482.4497082899961,956.4191666387071
"147.32.84.165",1526,"74.125.148.11",25,3,186,3,186,0,0,95176.00503,8.929868000006536,166.63180239606126,0
"147.32.84.165",1424,"66.111.4.71",25,3,186,3,186,0,0,95176.104974,8.92938800000411,166.64075970260393,0
"147.32.84.165",1530,"74.6.136.244",25,3,186,3,186,0,0,95184.733811,9.02828800000134,164.81530053092894,0
"147.32.84.165",1211,"212.117.171.138",65500,9,544,5,302,4,242,95185.536012,22.321781999999075,108.23508624894285,86.73142672928533
"147.32.84.165",1532,"67.195.168.31",25,3,186,3,186,0,0,95185.558751,9.005948999998509,165.22412018991517,0
"147.32.84.165",1536,"205.188.59.193",25,3,186,3,186,0,0,95185.636787,9.028143000003183,164.81794761109515,0
"147.32.84.165",1543,"118.23.180.72",25,3,186,3,186,0,0,95188.545908,9.028489999996964,164.81161301618548,0
"147.32.84.165",1564,"209.85.225.27",25,3,186,3,186,0,0,95188.947051,9.029857000001357,164.78666273450136,0
"147.32.84.165",1569,"64.12.90.33",25,3,186,3,186,0,0,95188.947179,9.02985200000694,164.78675397989429,0
"147.32.84.165",1417,"46.4.36.120",443,5,306,3,186,2,120,95189.549116,6.553830000004382,227.04281313354255,146.47923427970485
"147.32.84.165",1579,"64.12.90.65",25,3,186,3,186,0,0,95189.649611,9.028271999995923,164.81559261846255,0
"147.32.84.165",1588,"65.54.188.94",25,3,186,3,186,0,0,95189.749599,9.02912199999264,164.8000769068369,0
"147.32.84.165",1520,"196.192.41.18",6667,2,124,2,124,0,0,95196.103233,2.9759889999986626,333.33456541689026,0
"147.32.84.165",1589,"83.244.190.250",25,3,186,3,186,0,0,95196.972951,9.028307000000495,164.81495367846023,0
"147.32.84.165",1625,"209.85.225.27",25,3,186,3,186,0,0,95197.073305,9.028164000003017,164.81756423559682,0
"147.32.84.165",1424,"216.157.130.15",25,3,186,3,186,0,0,95205.800654,8.930884999994305,166.61282728430035,0
"147.32.84.165",1627,"205.188.190.2",25,3,186,3,186,0,0,95206.603494,8.932262000002083,166.58714220425387,0
"147.32.84.165",1526,"46.4.36.120",443,6,366,3,186,3,180,95206.704392,1.0302519999968354,1444.3068297897705,1397.7162868933262
"147.32.84.165",1637,"74.6.136.244",25,3,186,3,186,0,0,95207.734921,8.904397000005702,167.10845214999367,0
"147.32.84.165",1532,"212.117.171.138",65500,9,544,5,302,4,242,95209.613947,16.385427000001073,147.44809518847705,118.15377164109749
"147.32.84.165",1536,"46.4.36.120",443,6,366,3,186,3,180,95209.636577,1.0084979999955976,1475.461527942044,1427.8659947826231
"147.32.84.165",1642,"205.188.190.2",25,3,186,3,186,0,0,95210.015646,8.934349999995902,166.54820999856537,0
"147.32.84.165",1647,"67.195.168.31",25,3,186,3,186,0,0,95210.015748,8.934295999992173,166.54921663680088,0
"147.32.84.165",1653,"68.70.191.253",25,3,186,3,186,0,0,95210.645328,8.90718100000231,167.05622126681988,0
"147.32.84.165",1654,"124.108.110.37",25,3,186,3,186,0,0,95210.717818,8.934475999994902,166.54586122351765,0
"147.32.84.165",1655,"205.188.156.193",25,3,186,3,186,0,0,95210.817797,9.034507000003941,164.70184814725926,0
"147.32.84.165",1579,"31.192.109.161",80,10,1273,5,540,5,733,95213.928186,0.2552319999958854,16925.777332268848,22975.175526950123
"147.32.84.165",1564,"46.4.36.120",443,6,366,3,186,3,180,95214.007613,1.0528480000066338,1413.3094235736064,1367.718797006716
"147.32.84.165",1661,"65.55.37.120",25,3,186,3,186,0,0,95215.060737,9.005464999994729,165.23300018387403,0
"147.32.84.165",1564,"46.4.36.120",443,6,366,3,186,3,180,95217.945735,1.03169999999227,1442.2797324911785,1395.7545798301726
"147.32.84.165",1673,"65.55.92.184",25,3,186,3,186,0,0,95218.046261,9.029607000004034,164.79122513298034,0
"147.32.84.165",1675,"205.188.156.219",25,3,186,3,186,0,0,95218.977675,9.001002999997581,165.31490990508502,0
"147.32.84.165",1532,"212.117.171.138",65500,38,15492,19,14189,19,1303,95226.774592,66.39151400000264,1709.736578683768,157.00801762104092
"147.32.84.165",1625,"46.4.36.120",443,6,366,3,186,3,180,95226.797979,1.0075980000110576,1476.7794298754766,1429.141383750461
"147.32.84.165",1589,"184.82.148.43",80,10,1903,5,983,5,920,95227.577371,0.3216039999970235,24452.43218390562,22885.28749663598
"147.32.84.165",1676,"64.12.90.33",25,3,186,3,186,0,0,95227.683678,9.023342000000412,164.90564139095383,0
"147.32.84.165",1424,"184.82.148.44",80,10,1308,5,583,5,725,95227.805816,0.32607400001143105,14303.501658631158,17787.373417680254
"147.32.84.165",1678,"66.94.236.34",25,3,186,3,186,0,0,95227.914245,8.993936999992002,165.44478797231105,0
"147.32.84.165",1424,"93.184.220.20",80,13,6589,8,758,5,5831,95228.680777,8.491278999994393,714.1444769396936,5493.636471022894
"147.32.84.165",1679,"68.6.19.3",25,3,186,3,186,0,0,95228.697199,9.013250999996671,165.09026543258915,0
"147.32.84.165",1589,"46.4.36.120",443,6,366,3,186,3,180,95230.988022,1.0308680000016466,1443.4437774745393,1396.8810749753604
"147.32.84.165",1625,"68.67.179.209",80,10,1614,6,784,4,830,95231.589597,17.27695699999458,363.0268918306602,384.3269390554183
"147.32.84.165",1683,"67.195.168.31",25,3,186,3,186,0,0,95231.61359,9.006982000006246,165.20517083291253,0
"147.32.84.165",1637,"195.113.232.97",80,11,2384,7,1230,4,1154,95231.690539,72.79353100000299,135.1768469645963,126.82445642044237
"147.32.84.165",1697,"209.85.225.27",25,3,186,3,186,0,0,95231.691394,9.029060000000754,164.8012085421822,0
"147.32.84.165",1647,"68.67.185.210",80,15,4982,9,2086,6,2896,95231.891594,16.974858000001404,983.1010073838979,1364.8420505195438
"147.32.84.165",1698,"205.188.156.193",25,3,186,3,186,0,0,95231.920847,8.999899000002188,165.33518876152257,0
"147.32.84.165",1704,"74.6.136.244",25,3,186,3,186,0,0,95232.019131,9.001885000005132,165.2987124362455,0
"147.32.84.165",1589,"46.4.36.120",443,6,366,3,186,3,180,95236.105124,1.0307470000116155,1443.6132241793882,1397.0450556574724
"147.32.84.165",1653,"94.245.121.179",80,8,1621,5,536,3,1085,95237.136115,0.15335799999593291,27960.719363278855,56599.59050215962
"147.32.84.165",1715,"64.12.90.97",25,3,186,3,186,0,0,95237.171888,8.867519000006723,167.80341829533964,0
"147.32.84.165",1589,"46.4.36.120",443,6,366,3,186,3,180,95239.114721,1.0315149999951245,1442.538402259815,1396.0049054127242
"147.32.84.165",1654,"217.163.21.34",80,14,5905,7,797,7,5108,95240.0182,0.1888079999916954,33769.75552031929,216431.5071490476
"147.32.84.165",1731,"98.139.175.225",25,3,186,3,186,0,0,95240.064139,8.884102000010898,167.49019765848868,0
"147.32.84.165",1424,"65.54.89.114",80,9,1124,6,716,3,408,95240.146474,8.719880000004196,656.8897737121662,374.3170777577707
"147.32.84.165",1737,"76.96.30.116",25,3,186,3,186,0,0,95240.163101,8.885869000005187,167.4568913855394,0
"147.32.84.165",1589,"46.4.36.120",443,6,366,3,186,3,180,95248.647524,1.0356339999998454,1436.8010320250419,1390.4526116371371
"147.32.84.165",1673,"95.172.94.28",80,8,1199,5,810,3,389,95248.848352,0.05392500000016298,120166.89846973417,57709.78210460073
"147.32.84.165",1739,"205.188.59.193",25,3,186,3,186,0,0,95248.86604,9.01272600000084,165.0998821000285,0
"147.32.84.165",1675,"217.163.21.34",80,10,1544,5,714,5,830,95249.650759,0.13966800000343937,40896.98427599264,47541.31225360489
"147.32.84.165",1745,"77.238.177.9",25,3,186,3,186,0,0,95249.683397,8.997816999995848,165.37344558137676,0
"147.32.84.165",1654,"46.137.48.58",80,8,1438,5,736,3,702,95249.696717,0.14264299999922514,41277.87553565184,39371.017154928784
"147.32.84.165",1759,"76.96.62.116",25,3,186,3,186,0,0,95249.74119,8.940145999993547,166.4402348687677,0
"147.32.84.165",1625,"46.4.36.120",443,6,366,3,186,3,180,95252.560982,1.0304069999983767,1444.0895684931722,1397.5060340256507
"147.32.84.165",1424,"217.163.21.37",80,9,3197,5,1505,4,1692,95252.661088,0.2288000000116881,52622.37761968944,59160.83915781697
"147.32.84.165",1764,"209.85.225.27",25,3,186,3,186,0,0,95252.707224,8.984785000007832,165.6133118375902,0
"147.32.84.165",1673,"184.82.148.43",80,10,1927,5,987,5,940,95252.862282,0.33991799999785144,23229.13173191743,22122.982601826123
"147.32.84.165",1766,"67.195.168.31",25,3,186,3,186,0,0,95252.962605,9.030867000008584,164.76823321598974,0
"147.32.84.165",1678,"217.163.21.34",80,10,2466,5,1217,5,1249,95252.974475,0.13947799999732524,69803.12307451144,71638.53797868923
"147.32.84.165",1767,"77.93.250.148",25,3,186,3,186,0,0,95253.02032,8.973200000007637,165.82712967489118,0
"147.32.84.165",1679,"217.163.21.37",80,13,4028,7,2122,6,1906,95253.591628,0.15645400001085363,108504.7362088686,97459.95627431836
"147.32.84.165",1768,"205.188.156.193",25,3,186,3,186,0,0,95253.637386,8.957297000000835,166.12154313961693,0
"147.32.84.165",1683,"119.154.117.193",6667,2,124,2,124,0,0,95258.080125,3.0100530000054277,329.56230338741915,0
"147.32.84.165",1698,"46.4.36.120",443,6,366,3,186,3,180,95260.990061,1.0365739999979269,1435.4980927584293,1389.1917026694475
"147.32.84.165",1424,"184.82.148.44",80,10,1513,5,596,5,917,95261.090312,0.35578300000634044,13401.42727425152,20619.31008471249
"147.32.84.165",1772,"205.188.156.193",25,3,186,3,186,0,0,95261.198193,9.0209840000025,164.94874616777813,0
"147.32.84.165",1654,"74.125.232.220",80,43,30958,21,4696,22,26262,95261.198253,73.684871999998,509.84685160342036,2851.277260819639
"147.32.84.165",1784,"65.55.37.72",25,3,186,3,186,0,0,95261.206435,9.012864000003901,165.09735418168475,0
"147.32.84.165",1715,"184.82.155.107",80,10,1921,5,993,5,928,95262.026892,0.304219000012381,26112.767446072394,24403.472497437244
"147.32.84.165",1785,"74.6.136.244",25,3,186,3,186,0,0,95262.127342,8.994928000000073,165.4265603904765,0
"147.32.84.165",1683,"46.4.36.120",443,6,366,3,186,3,180,95269.918549,1.0314660000003641,1442.6069303297197,1396.0712228997288
"147.32.84.165",1731,"217.163.21.35",80,14,6137,7,809,7,5328,95270.721187,0.22084199999517296,29306.019688924487,193006.76502174247
"147.32.84.165",1792,"203.228.172.80",25,3,186,3,186,0,0,95270.721323,8.930211999992025,166.62538358566727,0
"147.32.84.165",1737,"74.125.232.217",80,39,27517,19,5244,20,22273,95270.767068,64.11595199999283,654.3145456220426,2779.0899837223023
"147.32.84.165",1797,"216.68.8.214",25,3,186,3,186,0,0,95270.775231,8.876424999994924,167.63505577987206,0
"147.32.84.165",1739,"184.82.155.107",80,10,1905,5,977,5,928,95270.950249,0.3417029999982333,22873.66514206902,21726.47006329586
"147.32.84.165",1798,"207.115.11.16",25,3,186,3,186,0,0,95271.063137,8.889251999993576,167.39316198945372,0
"147.32.84.165",1683,"46.4.36.120",443,6,366,3,186,3,180,95273.630122,1.0312799999956042,1442.867116599122,1396.3230160636665
"147.32.84.165",1745,"217.163.21.36",80,10,1448,5,699,5,749,95273.931546,0.13986499999009538,39981.410648811354,42841.31126746739
"147.32.84.165",1807,"80.12.242.62",25,3,186,3,186,0,0,95273.931605,9.03064299999096,164.7723201992914,0
"147.32.84.165",1759,"209.85.148.103",80,8,2163,5,1165,3,998,95273.977447,60.90547399999923,153.02401225873587,131.08838131692565
"147.32.84.165",1819,"67.195.168.31",25,3,186,3,186,0,0,95273.986693,8.97560400000657,165.78271501270677,0
"147.32.84.165",1731,"184.82.155.108",80,10,1507,5,596,5,911,95274.533302,0.32327300000179093,14749.143912339061,22544.41292641088
"147.32.84.165",1821,"205.188.190.2",25,3,186,3,186,0,0,95274.633692,9.030650999993668,164.7721742320729,0
"147.32.84.165",1764,"217.163.21.37",80,11,3887,6,1570,5,2317,95274.640195,0.2700429999968037,46511.11119395305,68640.92015056638
"147.32.84.165",1822,"64.12.90.97",25,3,186,3,186,0,0,95274.661678,9.002785999997286,165.282169319636,0
"147.32.84.165",1828,"74.6.136.244",25,3,186,3,186,0,0,95274.686274,8.97823699998844,165.73409679449495,0
"147.32.84.165",1838,"207.115.11.16",25,3,186,3,186,0,0,95274.686332,8.978226999999606,165.73428138986299,0
"147.32.84.165",1842,"65.254.254.55",25,3,186,3,186,0,0,95274.686382,8.978224999998929,165.73431830903965,0
"147.32.84.165",1731,"60.190.222.152",6667,12,2756,9,2570,3,186,95282.159156,93.6394580000051,219.56555963831912,15.890737001061229
"147.32.84.165",1764,"46.4.36.120",443,6,366,3,186,3,180,95282.488152,1.0029969999886816,1483.5537893102287,1435.6972154615116
"147.32.84.165",1766,"217.163.21.36",80,14,6137,7,809,7,5328,95283.062041,0.18946300000243355,34159.70400509266,224972.685956902
"147.32.84.165",1848,"67.195.168.31",25,3,186,3,186,0,0,95283.107956,8.985156999988249,165.60645517957516,0
"147.32.84.165",1849,"205.188.190.2",25,3,186,3,186,0,0,95283.108017,8.985218999994686,165.6053124582584,0
"147.32.84.165",1852,"204.127.208.75",25,3,186,3,186,0,0,95283.108072,8.985211999999592,165.60544147428772,0
"147.32.84.165",1772,"217.163.21.37",80,10,1448,5,699,5,749,95283.49139,0.13930700000491925,40141.55785281812,43012.913922404536
"147.32.84.165",1854,"65.55.37.104",25,3,186,3,186,0,0,95283.537261,8.957343000001856,166.1206900304802,0
"147.32.84.165",1785,"212.117.171.138",65500,14,852,8,486,6,366,95291.691495,3.375657999989926,1151.7754464497302,867.38644732634
"147.32.84.165",1772,"46.4.36.120",443,6,366,3,186,3,180,95291.691624,1.0308890000014799,1443.4143734173747,1396.852619436169
"147.32.84.165",1856,"98.139.175.225",25,3,186,3,186,0,0,95291.691683,9.033456000004662,164.72101043047445,0
"147.32.84.165",1766,"65.54.186.10",80,17,14260,10,759,7,13501,95291.992941,1.3139879999944242,4621.046767569997,82198.6197746542
"147.32.84.165",1857,"74.125.93.27",25,3,186,3,186,0,0,95292.159338,8.966576999999234,165.9496148864976,0
"147.32.84.165",1860,"64.12.90.33",25,3,186,3,186,0,0,95292.929809,8.798827000005986,169.1134511451342,0
"147.32.84.165",1798,"46.4.36.120",443,6,366,3,186,3,180,95295.00406,1.0330579999863403,1440.3837926037795,1393.91979929398
"147.32.84.165",1864,"74.6.136.244",25,3,186,3,186,0,0,95295.004191,9.032162999996217,164.74459107974727,0
"147.32.84.165",1807,"184.82.148.43",80,10,1923,5,983,5,940,95295.708876,0.34470000000146683,22814.041195145157,21816.071946527412
"147.32.84.165",1866,"67.195.168.31",25,3,186,3,186,0,0,95295.708907,8.929406000010204,166.64042378611742,0
"147.32.84.165",1868,"209.85.225.27",25,3,186,3,186,0,0,95295.708946,8.929470000002766,166.63922942789875,0
"147.32.84.165",1869,"67.195.168.31",25,3,186,3,186,0,0,95295.82282,8.916085000004387,166.88939147610952,0
"147.32.84.165",1872,"205.188.190.2",25,3,186,3,186,0,0,95295.82288,8.916226999994251,166.88673359269112,0
"147.32.84.165",1819,"184.82.148.44",80,10,1514,5,596,5,918,95296.03737,0.3239599999942584,14717.86640352051,22669.465366496355
"147.32.84.165",1878,"65.55.37.104",25,3,186,3,186,0,0,95296.144205,8.895022999990033,167.2845590170669,0
"147.32.84.165",1889,"98.139.54.60",25,3,186,3,186,0,0,95296.144264,8.8950130000012,167.28474708241566,0
"147.32.84.165",1797,"46.4.36.120",443,6,366,3,186,3,180,95304.136753,0.9297749999968801,1600.3871904546725,1548.761797214199
"147.32.84.165",1532,"217.163.21.37",80,14,6141,7,810,7,5331,95304.437725,0.1893419999978505,34223.78553133253,225243.2107006589
"147.32.84.165",1893,"74.6.136.244",25,3,186,3,186,0,0,95304.483706,8.98417199999676,165.62461181737578,0
"147.32.84.165",1819,"184.82.148.43",80,10,1923,5,983,5,940,95304.483766,0.3231529999902705,24335.222016310447,23270.710778567467
"147.32.84.165",1903,"64.12.90.33",25,3,186,3,186,0,0,95304.590528,8.978161999999429,165.73548127112147,0
"147.32.84.165",1917,"67.195.168.31",25,3,186,3,186,0,0,95304.590588,8.978223999991314,165.73433676876846,0
"147.32.84.165",1919,"65.54.188.126",25,3,186,3,186,0,0,95304.590636,8.97822800000722,165.73426293014649,0
"147.32.84.165",1637,"217.163.21.37",80,10,1451,5,701,5,750,95305.066765,0.1472970000031637,38072.7373936981,40734.02716872122
"147.32.84.165",1921,"74.125.113.27",25,3,186,3,186,0,0,95305.112676,8.957247999991523,166.1224518960967,0
"147.32.84.165",1848,"212.117.171.138",65500,74,29778,37,3233,37,26545,95312.664454,183.56375200000184,140.89927732573116,1156.8732807335398
"147.32.84.165",1532,"46.4.36.120",443,6,366,3,186,3,180,95312.686925,1.0099459999910323,1473.3460997055413,1425.8188061666528
"147.32.84.165",1785,"184.82.148.44",80,10,1514,5,596,5,918,95313.065726,0.32221699999354314,14797.481200853912,22792.093527489753
"147.32.84.165",1924,"200.10.152.53",25,3,186,3,186,0,0,95313.172556,9.023741999990307,164.89833153492182,0
"147.32.84.165",1849,"217.163.21.34",80,11,3914,6,1577,5,2337,95313.669314,0.2875179999973625,43878.991924386406,65025.49405662082
"147.32.84.165",1926,"205.188.156.193",25,3,186,3,186,0,0,95313.697108,9.000276000006124,165.32826326648066,0
"147.32.84.165",1856,"184.82.155.107",80,10,1917,5,989,5,928,95313.715248,0.3225770000135526,24527.47715946143,23014.660064691816
"147.32.84.165",1931,"65.55.92.168",25,3,186,3,186,0,0,95313.822004,8.976091999997152,165.7737019630004,0
"147.32.84.165",1860,"219.232.102.130",6667,3,186,3,186,0,0,95315.976146,9.029657999999472,164.79029438325205,0
"147.32.84.165",1532,"46.4.36.120",443,6,366,3,186,3,180,95316.678064,1.0307109999994282,1443.6636457754166,1397.0938507504034
"147.32.84.165",1857,"217.163.21.38",80,14,6138,7,810,7,5328,95316.678099,0.18911099999968428,34265.590050345134,225391.43677560354
"147.32.84.165",1933,"209.85.225.27",25,3,186,3,186,0,0,95316.724101,8.98287100000016,165.64859942884337,0
"147.32.84.165",1785,"184.82.155.108",80,10,1508,5,596,5,912,95316.779113,0.3070560000051046,15528.112135638892,23761.13803305817
"147.32.84.165",1936,"74.6.136.244",25,3,186,3,186,0,0,95316.88072,9.0274919999938,164.82983313649262,0
"147.32.84.165",1864,"217.163.21.38",80,10,1449,5,700,5,749,95317.080178,0.140625,39822.22222222222,42609.77777777778
"147.32.84.165",1937,"67.195.168.31",25,3,186,3,186,0,0,95317.126335,8.982524999999441,165.6549800863446,0
"147.32.84.165",1942,"98.139.54.60",25,3,186,3,186,0,0,95317.708947,9.001590999992914,165.30411124002094,0
"147.32.84.165",1872,"46.4.36.120",443,6,366,3,186,3,180,95325.606763,1.0310069999977713,1443.249172899133,1396.692747966903
"147.32.84.165",1866,"217.163.21.34",80,9,3104,5,1535,4,1569,95326.10893,0.23814699999638833,51564.7898154763,52706.94151171487
"147.32.84.165",1946,"64.12.90.33",25,3,186,3,186,0,0,95326.15487,8.882096999994246,167.52800605543533,0
"147.32.84.165",1868,"217.163.21.39",80,13,6078,6,750,7,5328,95326.638004,0.18705900000350084,32075.441437662495,227863.93597315438
"147.32.84.165",1948,"77.238.177.9",25,3,186,3,186,0,0,95326.684142,8.854460999995354,168.05088418151945,0
"147.32.84.165",1917,"46.4.36.120",443,6,366,3,186,3,180,95334.234709,0.9298750000016298,1600.2150826695975,1548.5952412931588
"147.32.84.165",1864,"184.82.147.251",80,10,1917,5,982,5,935,95334.736343,0.307823000010103,25521.15988650023,24299.67871066977
"147.32.84.165",1960,"205.188.59.193",25,3,186,3,186,0,0,95334.836402,8.928287000002456,166.66130916261883,0
"147.32.84.165",1860,"217.163.21.39",80,10,2275,5,1155,5,1120,95334.836537,0.14021599999978207,65898.32829359247,63901.409254392696
"147.32.84.165",1968,"65.54.188.126",25,3,186,3,186,0,0,95334.837892,8.92687599999772,166.6876519849027,0
"147.32.84.165",1893,"217.163.21.39",80,10,1449,5,700,5,749,95334.882748,0.13911299999745097,40255.044460996534,43072.897573266295
"147.32.84.165",1974,"74.6.136.65",25,3,186,3,186,0,0,95334.882779,8.882021999990684,167.52942066587548,0
"147.32.84.165",1759,"85.185.8.55",6667,3,186,3,186,0,0,95335.164815,9.001571000000695,165.304478518237,0
"147.32.84.165",1926,"46.4.36.120",443,6,366,3,186,3,180,95337.645674,1.0301659999968251,1444.4274029666926,1397.8329706129284
"147.32.84.165",1924,"217.163.21.34",80,13,4631,7,2104,6,2527,95337.846139,0.16262899999856018,103499.37588098692,124307.47283804844
"147.32.84.165",1976,"74.6.136.244",25,3,186,3,186,0,0,95337.892161,8.982663000002503,165.6524351408469,0
"147.32.84.165",1654,"184.82.147.252",80,10,1514,5,603,5,911,95338.046385,0.32391000000643544,14893.02584021536,22500.07718148622
"147.32.84.165",1984,"209.85.225.27",25,3,186,3,186,0,0,95338.152837,9.022947999997996,164.91284223297424,0
"147.32.84.165",1737,"217.163.21.34",80,9,3104,5,1535,4,1569,95338.648467,0.24948899999435525,49220.60692165922,50310.83534858848
"147.32.84.165",1985,"67.195.168.31",25,3,186,3,186,0,0,95338.676081,9.001002999997581,165.31490990508502,0
"147.32.84.165",1860,"173.241.240.4",80,9,2194,5,1164,4,1030,95338.694378,0.1234309999999823,75442.960034362,66757.94573487359
"147.32.84.165",1991,"64.12.90.33",25,3,186,3,186,0,0,95338.711438,8.965766000008443,165.96462588903154,0
"147.32.84.165",1864,"92.240.244.181",80,10,1759,6,1365,4,394,95338.711468,8.9121390000073,1225.2950722594267,353.6749146301935
"147.32.84.165",2003,"205.188.156.193",25,3,186,3,186,0,0,95338.741582,8.935670999999274,166.52358843562178,0
"147.32.84.165",1860,"46.4.36.120",443,6,366,3,186,3,180,95347.075653,1.0308949999889592,1443.4059724956824,1396.8444895119505
"147.32.84.165",1893,"217.163.21.39",80,14,6134,7,809,7,5325,95347.577343,0.18735100000048988,34544.78492232802,227380.6918558674
"147.32.84.165",2004,"74.6.136.244",25,3,186,3,186,0,0,95347.623225,8.985977999996976,165.59132461714248,0
"147.32.84.165",1759,"94.100.176.20",25,3,186,3,186,0,0,95347.623286,8.986038999995799,165.5902005322585,0
"147.32.84.165",1933,"217.163.21.39",80,10,2275,5,1155,5,1120,95348.106813,0.14038299999083392,65819.93546656868,63825.391967581745
"147.32.84.165",2009,"65.55.37.120",25,3,186,3,186,0,0,95348.153005,8.957494999995106,166.11787112365823,0
"147.32.84.165",1860,"46.4.36.120",443,6,366,3,186,3,180,95355.805541,1.0312160000030417,1442.956664748812,1396.4096755633666
"147.32.84.165",1937,"184.82.147.251",80,10,1929,5,994,5,935,95355.805621,0.32298099999025,24620.643320319312,23159.257046779232
"147.32.84.165",2014,"76.162.254.116",25,3,186,3,186,0,0,95355.805651,9.030635000002803,164.77246616650302,0
"147.32.84.165",1864,"217.163.21.39",80,10,1446,5,698,5,748,95355.905778,0.14022400000249036,39821.99908646757,42674.577817589896
"147.32.84.165",2015,"64.12.90.97",25,3,186,3,186,0,0,95355.912481,9.024239999998827,164.88923166939193,0
"147.32.84.165",2024,"74.6.136.244",25,3,186,3,186,0,0,95355.952061,8.98479000000225,165.6132196745419,0
"147.32.84.165",2026,"93.17.128.16",25,3,186,3,186,0,0,95355.95212,8.98479000000225,165.6132196745419,0
"147.32.84.165",1968,"196.46.196.3",6667,3,186,3,186,0,0,95356.837,9.002473999993526,165.28789752695425,0
"147.32.84.165",1860,"46.4.36.120",443,6,366,3,186,3,180,95358.916797,1.0305000000080327,1443.9592430746252,1397.379912652863
"147.32.84.165",1960,"217.163.21.39",80,11,3939,6,1593,5,2346,95359.216892,0.23795399999653455,53556.56975795993,78872.3871011764
"147.32.84.165",2030,"193.110.85.38",25,3,186,3,186,0,0,95359.262752,8.883958999998868,167.49289365250218,0
"147.32.84.165",1974,"184.82.147.252",80,10,1514,5,603,5,911,95359.718947,0.33967200000188313,14201.935985224734,21455.992840032723
"147.32.84.165",2035,"98.139.175.224",25,3,186,3,186,0,0,95359.719118,8.92876100000285,166.65246163488135,0
"147.32.84.165",2041,"74.6.136.244",25,3,186,3,186,0,0,95359.83149,8.917065000001458,166.87105005960558,0
"147.32.84.165",2046,"205.188.59.193",25,3,186,3,186,0,0,95359.947558,8.901213000004645,167.16822752126293,0
"147.32.84.165",1976,"46.4.36.120",443,6,366,3,186,3,180,95368.547606,1.0314530000032391,1442.6251123369918,1396.0888183906372
"147.32.84.165",1960,"217.163.21.40",80,14,6137,7,809,7,5328,95369.05057,0.19792199999210425,32699.75040803038,215357.5651099949
"147.32.84.165",2059,"74.6.136.244",25,3,186,3,186,0,0,95369.096611,8.982153999997536,165.66182232017044,0
"147.32.84.165",1759,"74.125.93.27",25,3,186,3,186,0,0,95369.096642,8.982171999989077,165.66149033906382,0
"147.32.84.165",1991,"184.82.147.251",80,10,1929,5,994,5,935,95369.579288,0.32302700000582263,24617.137266719696,23155.95909897678
"147.32.84.165",2064,"67.195.168.31",25,3,186,3,186,0,0,95369.685877,8.994633000009344,165.4319859407776,0
"147.32.84.165",1960,"46.4.36.120",443,6,366,3,186,3,180,95376.774281,1.0311109999893233,1443.1036037976587,1396.5518746428954
"147.32.84.165",1968,"217.163.21.40",80,10,1448,5,699,5,749,95376.874463,0.1401999999943655,39885.87731971995,42738.94436691022
"147.32.84.165",2065,"209.85.225.27",25,3,186,3,186,0,0,95376.874535,9.02843700000085,164.81258051641277,0
"147.32.84.165",2004,"184.82.147.252",80,10,1514,5,603,5,911,95376.920689,0.3227409999963129,14946.969861452717,22581.574699475
"147.32.84.165",2072,"68.189.127.14",25,3,186,3,186,0,0,95376.974996,9.028523999993922,164.8109923616531,0
"147.32.84.165",2015,"86.126.237.212",6667,6,366,3,186,3,180,95377.027353,1.117815999998129,1331.1672046226665,1288.2263270541935
"147.32.84.165",2014,"217.163.21.40",80,9,3098,5,1530,4,1568,95377.805624,0.22662600000330713,54009.68997300126,55351.1071095856
"147.32.84.165",2073,"65.55.37.72",25,3,186,3,186,0,0,95377.851779,8.954398000001675,166.17532524238052,0
"147.32.84.165",2024,"217.163.21.40",80,14,6134,7,809,7,5325,95378.145416,0.18930300000647549,34188.57598547626,225036.05330366018
"147.32.84.165",2074,"50.58.16.21",25,3,186,3,186,0,0,95378.191549,9.016920000009122,165.02308992410875,0
"147.32.84.165",2014,"173.192.170.88",80,25,4612,12,943,13,3669,95380.185178,76.36345999999321,98.79070434996883,384.37231628847894
"147.32.84.165",2015,"46.4.36.120",443,6,366,3,186,3,180,95380.386363,1.0369659999996657,1434.955437305061,1388.6665522307042
"147.32.84.165",2026,"184.82.147.251",80,10,1929,5,994,5,935,95380.68642,0.3073160000058124,25875.645914464592,24339.76753523581
"147.32.84.165",2024,"173.192.170.88",80,25,5011,12,943,13,4068,95380.787019,40.8922670000029,184.48475845077175,795.8472930834989
"147.32.84.165",1960,"173.192.170.88",80,27,5059,13,1003,14,4056,95380.78713,40.72860000000219,197.0114366808476,796.6883222108852
"147.32.84.165",2079,"64.12.90.97",25,3,186,3,186,0,0,95380.787191,8.930963000006159,166.611372144188,0
"147.32.84.165",1968,"217.163.21.40",80,10,2274,5,1154,5,1120,95380.787455,0.14119799999753013,65383.36237171552,63456.989476881616
"147.32.84.165",2081,"94.245.120.86",25,3,186,3,186,0,0,95380.833684,8.98513400000229,165.60687909602913,0
"147.32.84.165",2004,"217.163.21.40",80,10,1446,5,698,5,748,95380.887475,0.1394609999988461,40039.867776985695,42908.053147829945
"147.32.84.165",2108,"205.188.59.193",25,3,186,3,186,0,0,95380.887531,9.031795999995666,164.75128534797665,0
"147.32.84.165",2030,"217.163.21.34",80,13,4610,7,2099,6,2511,95381.423574,0.16595199999574106,101185.88507779926,121047.04975243162
"147.32.84.165",2111,"205.188.59.193",25,3,186,3,186,0,0,95381.46991,8.950851000001421,166.24117639761445,0
"147.32.84.165",2035,"184.82.147.252",80,10,1514,5,603,5,911,95381.469943,0.307210999992094,15702.56273416038,23723.108873665184
"147.32.84.165",2129,"74.6.136.244",25,3,186,3,186,0,0,95381.571751,8.949401999998372,166.2680925496777,0
"147.32.84.165",2046,"46.4.36.120",443,6,366,3,186,3,180,95390.120035,1.0318790000019362,1442.029540282541,1395.5124583379427
"147.32.84.165",2041,"217.163.21.34",80,9,3096,5,1529,4,1567,95390.72185,0.27461599999514874,44542.19710510708,45649.19742557409
"147.32.84.165",2133,"65.55.92.152",25,3,186,3,186,0,0,95390.767984,8.885453999988385,167.46471255176664,0
"147.32.84.165",1759,"74.125.39.27",25,3,186,3,186,0,0,95391.152145,8.90238600000157,167.146201029672,0
"147.32.84.165",2041,"208.73.210.29",80,48,34275,21,2087,27,32188,95397.847572,16.931248000008054,986.1056904955889,15208.802091840927
"147.32.84.165",2046,"208.73.210.29",80,46,34372,20,3232,26,31140,95397.947488,19.81322799999907,1304.9867492566689,12573.418122479168
"147.32.84.165",1968,"173.241.240.4",80,9,2194,5,1164,4,1030,95397.947615,0.06877199999871664,135403.9434678906,119816.20427141522
"147.32.84.165",2134,"209.85.225.27",25,3,186,3,186,0,0,95397.963975,9.014414999997825,165.06894790181715,0
"147.32.84.165",2064,"208.73.210.29",80,50,35642,22,3345,28,32297,95398.035985,19.88692100001208,1345.6080003527818,12992.257574706666
"147.32.84.165",2035,"46.4.36.120",443,6,366,3,186,3,180,95398.036024,1.0481849999923725,1419.5967315033397,1373.803288551619
"147.32.84.165",2004,"92.240.244.181",80,11,1818,6,1364,5,454,95398.750271,3.858342999999877,2828.1570612048613,941.3367344479524
"147.32.84.165",2138,"205.188.156.193",25,3,186,3,186,0,0,95398.758828,9.022299999996903,164.9246866099011,0
"147.32.84.165",1968,"178.150.146.54",6667,3,186,3,186,0,0,95399.084441,8.997461000006297,165.37998886563204,0
"147.32.84.165",2065,"74.125.232.217",80,8,1909,5,1035,3,874,95399.151154,15.627937999990536,529.8203768152276,447.40387375508107
"147.32.84.165",2072,"74.125.232.217",80,8,1904,5,1030,3,874,95399.159417,18.601568999991287,442.9733857398728,375.88227100645514
"147.32.84.165",2026,"217.163.21.40",80,13,6077,6,749,7,5328,95399.159471,0.2759459999942919,21714.393396258496,154465.00402572134
"147.32.84.165",2141,"67.195.168.31",25,3,186,3,186,0,0,95399.219844,8.96245999999519,166.02584558266355,0
"147.32.84.165",2073,"74.125.232.218",80,8,1909,5,1035,3,874,95401.6611,16.262054999999236,509.1607425998983,429.9579604176919
"147.32.84.165",2035,"46.4.36.120",443,5,306,3,186,2,120,95401.669173,3.5365230000024894,420.752247334162,271.45306279623355
"147.32.84.165",2026,"50.22.198.84",80,8,2198,5,1166,3,1032,95401.7617,0.4629389999900013,20149.522939742532,17833.883082173495
"147.32.84.165",2074,"94.127.76.180",80,16,5661,9,3183,7,2478,95401.86226,15.898904000001494,1601.6198349268357,1246.878401177725
"147.32.84.165",2059,"217.163.21.40",80,10,2272,5,1153,5,1119,95401.876198,0.20772500000020955,44404.86219757225,43095.438680904896
"147.32.84.165",2150,"207.5.72.155",25,3,186,3,186,0,0,95401.882543,9.00878499999817,165.1721070044742,0
"147.32.84.165",2079,"94.127.76.180",80,10,2486,6,1423,4,1063,95401.921928,16.00140900000406,711.437349048269,531.4531989025368
"147.32.84.165",2153,"65.55.37.72",25,3,186,3,186,0,0,95401.921959,8.969492000003811,165.8956828323575,0
"147.32.84.165",2081,"94.127.76.180",80,8,1420,5,829,3,591,95402.464357,15.296982999992906,433.54954372395366,309.0805552965701
"147.32.84.165",2108,"217.163.21.34",80,13,4609,7,2098,6,2511,95402.464485,0.1711619999987306,98059.14864353347,117362.49868632629
"147.32.84.165",2161,"209.85.225.27",25,3,186,3,186,0,0,95402.510404,8.982631999999285,165.65300682473895,0
"147.32.84.165",2164,"50.58.16.21",25,3,186,3,186,0,0,95402.510435,8.982724000001326,165.65131022613858,0
"147.32.84.165",2026,"92.240.244.181",80,10,1757,6,1363,4,394,95405.205935,6.906179999990854,1578.8757315932164,456.40281602914695
"147.32.84.165",2167,"64.12.90.97",25,3,186,3,186,0,0,95405.214452,8.987431999994442,165.5645350085453,0
"147.32.84.165",2129,"46.4.36.120",443,6,366,3,186,3,180,95411.694219,1.0300410000054399,1444.6026905648819,1398.0026037724665
"147.32.84.165",2059,"173.241.240.4",80,9,2193,5,1163,4,1030,95412.095112,0.07626000000163913,122003.67164699738,108051.40309235366
"147.32.84.165",2176,"98.139.54.60",25,3,186,3,186,0,0,95412.111819,9.012520999996923,165.10363748395238,0
"147.32.84.165",1759,"66.111.4.71",25,3,186,3,186,0,0,95412.724546,9.00166700000409,165.30271559693597,0
"147.32.84.165",2111,"184.82.148.43",80,10,1933,5,995,5,938,95419.017081,0.30818799999542534,25828.390463347554,24348.774125246237
"147.32.84.165",2179,"218.102.53.147",25,3,186,3,186,0,0,95419.117394,9.030291999995825,164.77872476335074,0
"147.32.84.165",2108,"173.192.170.88",80,11,1099,6,542,5,557,95419.118933,83.29581899999175,52.05543389879424,53.496082438428765
"147.32.84.165",2004,"46.4.36.120",443,6,366,3,186,3,180,95419.119013,1.0305629999929806,1443.870971507938,1397.294488556069
"147.32.84.165",2026,"184.82.148.44",80,10,1511,5,594,5,917,95419.82078,0.3234130000055302,14693.286911530282,22683.070871840522
"147.32.84.165",2182,"74.6.136.244",25,3,186,3,186,0,0,95419.927741,9.022589999993215,164.91938567541237,0
"147.32.84.165",2133,"190.37.39.215",6667,3,186,3,186,0,0,95420.149763,9.00216500001261,165.29357104628895,0
"147.32.84.165",2041,"217.163.21.39",80,13,6077,6,749,7,5328,95420.221796,0.18685900000855327,32066.959577680085,228107.82460598063
"147.32.84.165",2190,"64.12.90.97",25,3,186,3,186,0,0,95420.267879,8.884169999990263,167.48891567829418,0
"147.32.84.165",2195,"64.12.90.33",25,3,186,3,186,0,0,95420.26794,8.884158000000753,167.4891419085381,0
"147.32.84.165",2059,"46.4.36.120",443,6,366,3,186,3,180,95422.930279,1.030785000009928,1443.5600052248224,1396.9935534433764
"147.32.84.165",2046,"217.163.21.39",80,10,1448,5,699,5,749,95422.930339,0.1412750000017695,39582.37480042441,42413.732082285955
"147.32.84.165",2065,"173.192.170.88",80,13,1223,8,666,5,557,95422.976166,74.64482200000202,71.37802539069429,59.696036250175254
"147.32.84.165",2064,"173.192.170.88",80,13,1223,8,666,5,557,95422.976227,69.98098199999367,76.1349704981345,63.67444229348486
"147.32.84.165",2199,"98.139.175.224",25,3,186,3,186,0,0,95422.976281,8.883538000009139,167.50083131275727,0
"147.32.84.165",2072,"217.163.21.34",80,11,3926,6,1590,5,2336,95423.532126,0.26105099999404047,48726.110990918954,71587.54419797905
"147.32.84.165",2201,"65.54.188.94",25,3,186,3,186,0,0,95423.578128,8.884994000007282,167.47338264930517,0
"147.32.84.165",2206,"157.205.238.165",25,3,186,3,186,0,0,95423.961302,8.902830000006361,167.13786515062478,0
"147.32.84.165",2079,"46.4.36.120",443,6,366,3,186,3,180,95426.240556,1.0324129999935394,1441.2836723378257,1394.7906506495087
"147.32.84.165",2081,"184.82.148.43",80,10,1921,5,983,5,938,95427.273213,0.3227160000096774,24368.175112991546,23252.64319021981
"147.32.84.165",2207,"62.225.75.210",25,3,186,3,186,0,0,95427.379783,8.89495899999747,167.2857626438102,0
"147.32.84.165",2134,"46.4.36.120",443,6,366,3,186,3,180,95433.065088,1.0304269999905955,1444.0615395497018,1397.478909241647
"147.32.84.165",2129,"184.82.148.44",80,10,1512,5,594,5,918,95433.667769,0.34112299999105744,13930.459101627783,21528.8913388793
"147.32.84.165",2209,"64.12.90.97",25,3,186,3,186,0,0,95433.780393,9.015712000007625,165.04520108880382,0
"147.32.84.165",2026,"216.157.130.15",25,3,186,3,186,0,0,95434.09579,9.000771999999415,165.3191526238079,0
"147.32.84.165",2041,"217.163.21.39",80,14,6138,7,810,7,5328,95440.086851,0.18893499999830965,34297.509725873846,225601.39730797018
"147.32.84.165",2212,"207.115.37.23",25,3,186,3,186,0,0,95440.132791,8.983091000001878,165.6445426189815,0
"147.32.84.165",2079,"194.67.211.76",6667,3,186,3,186,0,0,95440.187317,9.029081000000588,164.80082524455182,0
"147.32.84.165",2046,"46.4.36.120",443,6,366,3,186,3,180,95440.889561,1.030629000000772,1443.7785080750546,1397.205007814569
"147.32.84.165",2059,"184.82.148.43",80,10,1901,5,983,5,918,95441.190519,0.32274499999766704,24365.985530548405,22754.80642629037
"147.32.84.165",2215,"209.85.225.27",25,3,186,3,186,0,0,95441.297215,9.02267999999458,164.9177406270525,0
"147.32.84.165",2081,"217.163.21.39",80,10,1449,5,700,5,749,95441.92042,0.13920200000575278,40229.30704852351,43045.358541920155
"147.32.84.165",2216,"67.195.168.31",25,3,186,3,186,0,0,95441.966348,8.956288999994285,166.1402395569135,0
"147.32.84.165",2150,"46.4.36.120",443,6,366,3,186,3,180,95443.898922,1.0313160000077914,1442.8167506261498,1396.2742747994998
"147.32.84.165",2111,"184.82.148.44",80,10,1306,5,579,5,727,95444.500801,0.3101579999929527,14934.323796598015,18751.73298812911
"147.32.84.165",2221,"65.55.88.22",25,3,186,3,186,0,0,95444.602361,9.02854600000137,164.81059076398063,0
"147.32.84.165",2141,"217.163.21.34",80,9,3100,5,1531,4,1569,95444.90296,0.2968259999906877,41263.231658898665,42287.40070072633
"147.32.84.165",2223,"74.6.136.244",25,3,186,3,186,0,0,95444.930471,9.001843999998528,165.29946530957918,0
"147.32.84.165",2164,"217.163.21.34",80,14,6548,7,1537,7,5011,95444.948888,0.18892800000321586,65082.994578837985,212186.65311291942
"147.32.84.165",2225,"64.12.90.97",25,3,186,3,186,0,0,95444.948948,8.98350199998822,165.63696429320672,0
"147.32.84.165",2230,"63.249.123.251",25,3,186,3,186,0,0,95444.949033,8.983468000005814,165.63759118405463,0
"147.32.84.165",2046,"46.4.36.120",443,6,366,3,186,3,180,95448.313347,1.0304479999904288,1444.0321103188332,1397.4504293408063
"147.32.84.165",1759,"217.163.21.34",80,11,4092,6,1512,5,2580,95449.344026,0.2481709999992745,48740.58612825577,83168.46045694436
"147.32.84.165",2234,"205.188.190.2",25,3,186,3,186,0,0,95449.389908,8.958477000007406,166.0996618062166,0
"147.32.84.165",2195,"31.192.109.161",80,10,1273,5,540,5,733,95454.835123,0.25566900000558235,16896.847094898778,22935.905408445935
"147.32.84.165",2176,"46.4.36.120",443,6,366,3,186,3,180,95454.913943,1.0580489999993006,1406.36208720105,1360.9955682590805
"147.32.84.165",2239,"209.85.225.27",25,3,186,3,186,0,0,95455.136142,8.931652999992366,166.59850085994964,0
"147.32.84.165",2133,"184.82.148.43",80,10,1921,5,983,5,938,95455.136268,0.3399610000051325,23132.06514830017,22073.12015168419
"147.32.84.165",2241,"65.55.37.72",25,3,186,3,186,0,0,95455.24866,8.919489000007161,166.82570044077698,0
"147.32.84.165",2134,"195.113.232.88",80,18,19025,13,1423,5,17602,95455.972233,64.45883000000322,176.60885250320914,2184.5882092491124
"147.32.84.165",2244,"209.85.225.27",25,3,186,3,186,0,0,95455.973119,8.896918999991613,167.24890942599373,0
"147.32.84.165",2201,"217.163.21.40",80,10,2275,5,1155,5,1120,95455.973179,0.13984300001175143,66074.09737508159,64071.85200007912
"147.32.84.165",2252,"67.195.168.31",25,3,186,3,186,0,0,95456.019199,8.850959999996121,168.11735676137414,0
"147.32.84.165",2206,"184.82.148.44",80,10,1511,5,594,5,917,95456.019262,0.3590669999975944,13234.298891381934,20430.727413126653
"147.32.84.165",2253,"208.43.248.158",25,3,186,3,186,0,0,95456.137926,8.832454000003054,168.46960086058593,0
"147.32.84.165",2079,"46.4.36.120",443,6,366,3,186,3,180,95460.755732,1.0311369999981252,1443.0672160951508,1396.5166607372425
"147.32.84.165",2269,"74.6.136.244",25,3,186,3,186,0,0,95461.057845,9.02895300000091,164.80316156256987,0
"147.32.84.165",2041,"217.163.21.40",80,13,6077,6,749,7,5328,95461.057971,0.18757100000220817,31945.236736646173,227241.95104519467
"147.32.84.165",2273,"65.54.188.126",25,3,186,3,186,0,0,95461.104266,8.982657000000472,165.65254578906016,0
"147.32.84.165",2207,"117.224.242.30",6667,3,186,3,186,0,0,95461.787148,9.002123999991454,165.29432387305624,0
"147.32.84.165",2195,"217.163.21.35",80,13,4642,7,2105,6,2537,95462.261516,0.1613680000009481,104357.7413111711,125774.62693892689
"147.32.84.165",2276,"194.106.220.35",25,3,186,3,186,0,0,95462.307488,8.984703999987687,165.61480489530197,0
"147.32.84.165",2041,"46.4.36.120",443,6,366,3,186,3,180,95462.863694,1.0316230000025826,1442.3873837596436,1395.8587584770746
"147.32.84.165",2209,"217.163.21.40",80,10,1448,5,699,5,749,95463.895568,0.13923599998815916,40162.02706538217,43034.847313263585
"147.32.84.165",2282,"205.188.156.193",25,3,186,3,186,0,0,95463.941521,8.953854999999749,166.18540282370464,0
"147.32.84.165",2209,"46.4.36.120",443,6,366,3,186,3,180,95465.572726,1.0302610000071581,1444.2942128156471,1397.7040769183684
"147.32.84.165",2015,"173.241.240.4",80,9,2194,5,1164,4,1030,95465.874132,0.06729700000141747,138371.69561501793,122442.30797548838
"147.32.84.165",2291,"98.129.185.3",25,3,186,3,186,0,0,95465.87427,9.027518999995664,164.82934015433418,0
"147.32.84.165",2030,"92.240.244.181",80,10,1759,6,1365,4,394,95465.890712,5.650316000013845,1932.6352720756224,557.8449063720111
"147.32.84.165",2292,"209.85.225.27",25,3,186,3,186,0,0,95465.899333,9.002581000007922,165.285933000624,0
"147.32.84.165",2201,"184.82.148.43",80,10,1921,5,983,5,938,95466.603105,0.3598280000005616,21854.886223383746,20854.40821722681
"147.32.84.165",2295,"81.92.237.18",25,3,186,3,186,0,0,95466.717027,8.987811999992118,165.5575350264675,0
"147.32.84.165",2041,"46.4.36.120",443,6,366,3,186,3,180,95470.287546,1.0320859999919776,1441.7403201008117,1395.232567839495
"147.32.84.165",2206,"98.126.71.122",80,11,4148,7,715,4,3433,95471.319885,16.068253999997978,355.9814277270399,1709.2087292124868
"147.32.84.165",2212,"217.163.21.35",80,9,3127,5,1559,4,1568,95471.494682,0.2605079999921145,47875.68903978966,48152.07210672879
"147.32.84.165",2310,"205.188.156.193",25,3,186,3,186,0,0,95471.540674,8.979716000001645,165.70679963594924,0
"147.32.84.165",2216,"184.82.148.44",80,10,1511,5,594,5,917,95471.540734,0.32313499999872874,14705.927863025345,22702.58560672431
"147.32.84.165",2311,"67.195.168.31",25,3,186,3,186,0,0,95471.647227,8.97335000000021,165.82435768135258,0
"147.32.84.165",2041,"46.4.36.120",443,6,366,3,186,3,180,95476.206551,1.0303660000063246,1444.1470312402257,1397.5616431357023
"147.32.84.165",2216,"195.113.232.98",80,11,4480,6,1278,5,3202,95477.009091,18.504295999999158,552.5203444648997,1384.3271854277064
"147.32.84.165",2212,"195.113.232.98",80,12,4619,6,1393,6,3226,95477.009219,17.90136899999925,622.5222216245287,1441.677449361615
"147.32.84.165",2209,"195.113.232.98",80,15,5812,8,2048,7,3764,95477.009273,10.882117000001017,1505.5893995624629,2767.1086425552294
"147.32.84.165",2030,"217.163.21.40",80,10,2274,5,1154,5,1120,95477.009321,0.1462079999910202,63142.91967995603,61282.556361829076
"147.32.84.165",2323,"211.189.96.7",25,3,186,3,186,0,0,95477.055369,8.98299400000542,165.64633127875877,0
"147.32.84.165",2201,"217.163.21.40",80,14,6137,7,809,7,5328,95477.237154,0.1891990000003716,34207.368960656706,225286.60299428794
"147.32.84.165",2328,"64.12.90.97",25,3,186,3,186,0,0,95477.283328,8.956054999987828,166.14458039862666,0
"147.32.84.165",2241,"212.117.171.138",65500,55,24421,29,21945,26,2476,95481.824584,7.296734999996261,24060.07618477168,2714.6388076324756
"147.32.84.165",2201,"46.4.36.120",443,6,366,3,186,3,180,95481.824711,1.0304790000081994,1443.988669335484,1397.4083896795007
"147.32.84.165",2252,"195.113.232.96",80,8,1909,5,886,3,1023,95482.12545,5.766131999989739,1229.2469197744022,1419.3223464212342
"147.32.84.165",2244,"217.163.21.37",80,13,4659,7,2128,6,2531,95482.126272,0.19051900001068134,89355.91725258666,106278.11398792146
"147.32.84.165",2330,"74.125.93.27",25,3,186,3,186,0,0,95482.172075,10.137713000003714,146.77866694386148,0
"147.32.84.165",2030,"64.12.168.40",587,43,11890,21,9688,22,2202,95482.855434,13.3444690000033,5807.9493459035975,1320.0974875804832
"147.32.84.165",2253,"217.163.21.40",80,10,1448,5,699,5,749,95482.973365,0.14026000000012573,39868.81505771416,42720.6616283661
"147.32.84.165",2346,"9.251.141.128",25,3,186,3,186,0,0,95483.019298,10.168107999998028,146.33990905685587,0
"147.32.84.165",2269,"173.241.240.4",80,9,2194,5,1164,4,1030,95483.329116,0.0680220000067493,136896.8862879075,121137.27910356074
"147.32.84.165",2347,"195.50.106.142",25,3,186,3,186,0,0,95483.345528,10.27267700000084,144.85026639111484,0
"147.32.84.165",2244,"212.117.171.138",65500,172,133671,104,126211,68,7460,95484.934916,11.271317000006093,89580.30370359153,5294.8559604851625
"147.32.84.165",2201,"46.4.36.120",443,6,366,3,186,3,180,95484.935043,1.0307689999899594,1443.582412756393,1397.015238151348
"147.32.84.165",2348,"89.105.202.5",25,3,186,3,186,0,0,95485.966064,9.944545000005746,149.6297718999854,0
"147.32.84.165",2253,"65.54.165.177",443,26,22716,16,1861,10,20855,95486.94169,1.9632189999974798,7583.463688981775,84982.87761080866
"147.32.84.165",2354,"168.144.68.74",25,3,186,3,186,0,0,95486.941824,9.23518000000331,161.12301005497093,0
"147.32.84.165",2201,"46.4.36.120",443,6,366,3,186,3,180,95487.107042,1.3861249999899883,1073.496257560283,1038.8673460260804
"147.32.84.165",2355,"64.12.90.97",25,3,186,3,186,0,0,95487.744063,8.930759999988368,166.61515929237132,0
"147.32.84.165",2291,"65.55.72.199",443,107,130051,56,6736,51,123315,95487.74416,8.570741999996244,6287.436957036347,115103.21976795385
"147.32.84.165",2356,"80.12.242.53",25,3,186,3,186,0,0,95487.871984,8.903478000007453,167.12570076533623,0
"147.32.84.165",2292,"212.117.171.138",65500,38,13787,20,10898,18,2889,95489.086144,17.045220999993035,5114.864747135613,1355.9225779477688
"147.32.84.165",2363,"64.12.90.97",25,3,186,3,186,0,0,95489.089322,8.288199999995413,179.53234719249335,0
"147.32.84.165",2364,"67.195.168.31",25,3,186,3,186,0,0,95489.092502,8.285084000002826,179.59986887272265,0
"147.32.84.165",2368,"70.243.11.177",25,3,186,3,186,0,0,95489.095704,8.281905999989249,179.66878638829414,0
"147.32.84.165",2253,"190.77.235.75",6667,3,186,3,186,0,0,95493.624588,7.9659519999986514,186.79499951798002,0
"147.32.84.165",2252,"46.4.36.120",443,4,246,3,186,1,60,95497.978757,6.52113300000201,228.18120716132324,73.6068410197817
"147.32.84.165",2295,"184.82.148.43",80,10,1921,5,983,5,938,95498.179443,0.30460499999753665,25817.04174279344,24635.18327033596
"147.32.84.165",2244,"173.192.170.88",80,15,1704,9,1085,6,619,95498.279998,66.77403699999559,129.9906429201004,74.16056033874854
"147.32.84.165",2241,"173.192.170.88",80,12,1341,7,784,5,557,95498.28006,66.9539519999962,93.67632249699548,66.55320361074806
"147.32.84.165",2374,"65.55.92.168",25,3,186,3,186,0,0,95498.280115,9.028265000000829,164.81572040695121,0
"147.32.84.165",2276,"184.82.148.44",80,10,1512,5,594,5,918,95503.195601,0.3044660000014119,15607.654056538213,24120.919905559058
"147.32.84.165",2375,"64.18.6.14",25,3,186,3,186,0,0,95503.295942,9.028228000010131,164.81639586398686,0
"147.32.84.165",2212,"212.117.171.138",65500,8,484,5,302,3,182,95503.897553,3.0101399999985006,802.6204761244339,483.6984326312814
"147.32.84.165",2253,"217.163.21.40",80,13,6081,6,750,7,5331,95503.89768,0.19594499999948312,30620.83747998585,217652.91280773943
"147.32.84.165",2377,"74.125.45.27",25,3,186,3,186,0,0,95503.94363,8.982993000012357,165.6463497186242,0
"147.32.84.165",2108,"65.54.165.177",443,23,12886,14,2628,9,10258,95504.299789,1.7648600000102306,11912.55963638936,46498.872431538075
"147.32.84.165",2346,"217.163.21.40",80,10,1451,5,701,5,750,95504.465004,0.1394810000056168,40206.19295656161,43016.611579773475
"147.32.84.165",2378,"205.188.156.193",25,3,186,3,186,0,0,95504.510981,9.017284999994445,165.01641015016347,0
"147.32.84.165",2253,"217.163.21.39",80,9,3127,5,1557,4,1570,95506.907591,0.24367999999958556,51116.217990894555,51543.00722267466
"147.32.84.165",2380,"74.6.136.244",25,3,186,3,186,0,0,95506.953547,8.982767000008607,165.65051726250655,0
"147.32.84.165",2347,"212.117.171.138",65500,20,3286,11,1465,9,1821,95507.9101,18.048497000010684,649.3615507148912,807.1586237896361
"147.32.84.165",2108,"184.82.148.43",80,10,1921,5,983,5,938,95507.932658,0.32251099999120925,24383.66443381575,23267.423437354195
"147.32.84.165",2393,"216.32.180.22",25,3,186,3,186,0,0,95508.039094,9.001510999994935,165.30558036321207,0
"147.32.84.165",2311,"217.163.21.40",80,10,2277,5,1156,5,1121,95508.813444,0.14030600000114646,65913.07570541839,63917.43760015054
"147.32.84.165",2395,"67.195.168.31",25,3,186,3,186,0,0,95508.859403,8.983480000009877,165.63736992773002,0
"147.32.84.165",2346,"184.82.148.44",80,10,1512,5,594,5,918,95509.415209,0.3257750000047963,14586.754661745184,22543.166295424377
"147.32.84.165",2398,"205.188.156.193",25,3,186,3,186,0,0,95509.521925,9.023467999999411,164.90333871634465,0
"147.32.84.165",2403,"80.79.101.252",25,3,186,3,186,0,0,95509.522024,9.023465999998734,164.90337526624566,0
"147.32.84.165",2348,"217.163.21.40",80,13,4659,7,2126,6,2533,95512.926488,0.16337799999746494,104102.14349706756,124031.38733681662
"147.32.84.165",2355,"173.192.170.88",80,14,1907,9,1316,5,591,95512.972439,15.562467999989167,676.4993830032183,303.8078536131474
"147.32.84.165",2405,"195.50.106.142",25,3,186,3,186,0,0,95512.97247,8.984849000000395,165.6121321571386,0
"147.32.84.165",2364,"121.245.3.131",6667,2,124,2,124,0,0,95516.537743,3.0111090000136755,329.4467254408574,0
"147.32.84.165",2252,"46.4.36.120",443,6,366,3,186,3,180,95519.348098,1.0364929999923334,1435.6102742719984,1389.3002654245145
"147.32.84.165",2354,"217.163.21.40",80,13,6081,6,750,7,5331,95520.384832,0.18660100000852253,32154.16851852865,228551.82982970166
"147.32.84.165",2406,"64.18.6.14",25,3,186,3,186,0,0,95520.430647,8.850923999998486,168.11804055715027,0
"147.32.84.165",2356,"173.241.240.4",80,9,2195,5,1165,4,1030,95520.430714,0.07439300000260118,125280.60435355641,110763.10942846618
"147.32.84.165",2412,"209.85.225.27",25,3,186,3,186,0,0,95520.4473,8.834373000005144,168.43300594157998,0
"147.32.84.165",2348,"212.117.171.138",65500,16,996,9,546,7,450,95524.264938,9.549708000005921,457.39618426001,376.97487713737087
"147.32.84.165",2252,"46.4.36.120",443,4,246,3,186,1,60,95524.26504,9.063011000005645,164.1838457438784,52.96253088512207
"147.32.84.165",2363,"92.240.244.181",80,10,1760,6,1366,4,394,95524.866842,9.153724999996484,1193.8309267543211,344.3406919042478
"147.32.84.165",2414,"216.82.250.99",25,3,186,3,186,0,0,95524.87549,9.02110499999253,164.94653371191578,0
"147.32.84.165",2374,"157.55.0.137",80,12,2782,6,1621,6,1161,95525.468622,0.5025730000052135,25803.216646866174,18480.897302289715
"147.32.84.165",2134,"217.163.21.40",80,10,1451,5,701,5,750,95525.504595,0.1401239999977406,40021.695070726106,42819.217265398824
"147.32.84.165",2420,"209.85.225.27",25,3,186,3,186,0,0,95525.550892,8.947390000001178,166.30548126322918,0
"147.32.84.165",2421,"216.54.161.40",25,3,186,3,186,0,0,95525.550971,8.947434000001522,166.30466343755617,0
"147.32.84.165",2375,"217.163.21.40",80,9,3127,5,1557,4,1570,95527.877164,0.2791109999961918,44627.40630132797,45000.01791463385
"147.32.84.165",2423,"67.195.168.31",25,3,186,3,186,0,0,95527.923049,8.983030999996117,165.64564900206213,0
"147.32.84.165",2425,"74.6.136.244",25,3,186,3,186,0,0,95527.923109,8.983078000004753,165.64478233398538,0
"147.32.84.165",2347,"217.163.21.40",80,10,2277,5,1156,5,1121,95528.980965,0.1401929999992717,65966.20373376732,63968.95708092835
"147.32.84.165",2427,"64.12.90.97",25,3,186,3,186,0,0,95529.027253,8.982151000003796,165.66187765039479,0
"147.32.84.165",2377,"217.163.21.40",80,13,4659,7,2126,6,2533,95529.784017,0.1594420000037644,106672.01866257601,127093.23766336078
"147.32.84.165",2430,"64.12.90.33",25,3,186,3,186,0,0,95529.829922,8.983377999989898,165.63925062506257,0
"147.32.84.165",2347,"173.241.240.4",80,9,2195,5,1165,4,1030,95530.485525,0.06852700001036283,136004.78641397707,120244.57511278658
"147.32.84.165",2431,"82.223.191.131",25,3,186,3,186,0,0,95530.501866,9.013807999988785,165.08006383116341,0
"147.32.84.165",2395,"184.82.148.43",80,10,1901,5,983,5,918,95533.328269,0.34053299999504816,23093.20976267896,21566.191823132536
"147.32.84.165",2432,"212.82.111.207",25,3,186,3,186,0,0,95533.440738,8.983456000001752,165.63781244097035,0
"147.32.84.165",2398,"212.117.171.138",65500,9,544,5,302,4,242,95533.896731,8.241586999996798,293.1474241551947,234.90621405813616
"147.32.84.165",2079,"184.82.148.44",80,10,1473,5,579,5,894,95533.919547,0.3039980000030482,15236.94234815214,23526.47056864942
"147.32.84.165",2433,"98.139.54.60",25,3,186,3,186,0,0,95533.996773,9.029656999991857,164.79031263328628,0
"147.32.84.165",2434,"64.12.90.97",25,3,186,3,186,0,0,95534.020025,9.006526999990456,165.2135168196994,0
"147.32.84.165",2438,"209.85.225.27",25,3,186,3,186,0,0,95534.020082,9.006523000003654,165.2135901945064,0
"147.32.84.165",2460,"74.6.136.244",25,3,186,3,186,0,0,95534.020131,9.006542999995872,165.21322332005542,0
"147.32.84.165",2464,"64.12.90.33",25,3,186,3,186,0,0,95534.020183,9.006559000001289,165.21292982145422,0
"147.32.84.165",2478,"205.188.190.2",25,3,186,3,186,0,0,95534.020235,9.006572999991477,165.21267301130055,0
"147.32.84.165",2405,"173.192.170.88",80,7,860,4,423,3,437,95541.321379,29.668344000005163,114.06096680014939,117.83603425925598
"147.32.84.165",2348,"94.137.182.140",6667,2,124,2,124,0,0,95541.321482,3.009105000004638,329.6661299617232,0
"147.32.84.165",2363,"46.4.36.120",443,6,366,3,186,3,180,95545.935727,1.0303839999978663,1444.1218031365795,1397.5372288418512
"147.32.84.165",2395,"217.163.21.40",80,14,6954,7,1650,7,5304,95546.537993,0.19057999999495223,69262.25207445493,222646.65757752056
"147.32.84.165",2482,"67.195.168.31",25,3,186,3,186,0,0,95546.584582,8.882956000001286,167.51180575472677,0
"147.32.84.165",2398,"212.117.171.138",65500,9,544,5,302,4,242,95546.966264,2.2636879999918165,1067.284890854541,855.2415350556256
"147.32.84.165",2406,"184.82.148.43",80,10,1897,5,983,5,914,95546.988879,0.30739300001005176,25582.88575127881,23787.138938625463
"147.32.84.165",2484,"74.125.113.27",25,3,186,3,186,0,0,95547.090462,8.878299000003608,167.59967196412234,0
"147.32.84.165",2363,"46.4.36.120",443,6,366,3,186,3,180,95548.945188,1.0322500000038417,1441.511261801368,1395.010898517453
"147.32.84.165",2485,"199.26.167.215",25,3,186,3,186,0,0,95549.977675,8.900205999991158,167.1871415112727,0
"147.32.84.165",2423,"212.117.171.138",65500,9,544,5,302,4,242,95550.049739,39.18567800000892,61.655179221333114,49.40580586610137
"147.32.84.165",2420,"184.82.148.44",80,10,1305,5,578,5,727,95550.072292,0.3413600000058068,13545.816732837304,17037.731426942424
"147.32.84.165",2487,"205.188.156.193",25,3,186,3,186,0,0,95550.185128,8.893341999995755,167.3161787774169,0
"147.32.84.165",2348,"217.163.21.35",80,11,4196,6,1592,5,2604,95550.852703,0.2669880000030389,47702.518464706416,78025.97869478361
"147.32.84.165",2488,"77.238.14.21",25,3,186,3,186,0,0,95550.898646,8.98281400000269,165.64965054375548,0
"147.32.84.165",2427,"46.4.36.120",443,6,366,3,186,3,180,95551.55483,1.030508000010741,1443.9480333820704,1397.369064563294
"147.32.84.165",2398,"93.184.220.20",80,13,6576,8,757,5,5819,95552.585584,15.432285999995656,392.4240387977325,3016.5330010092543
"147.32.84.165",2489,"203.188.197.119",25,3,186,3,186,0,0,95552.602142,8.885089000003063,167.4715920121326,0
"147.32.84.165",2427,"46.4.36.120",443,6,366,3,186,3,180,95554.363611,1.0304980000073556,1443.9620455249585,1397.382624701573
"147.32.84.165",2363,"195.113.232.88",80,49,63043,32,2920,17,60123,95554.965573,104.0641050000122,224.47701827635245,4621.997181448335
"147.32.84.165",2490,"91.83.45.27",25,3,186,3,186,0,0,95554.965717,9.030631999994512,164.7725209045064,0
"147.32.84.165",2420,"68.67.185.212",80,10,1603,6,777,4,826,95554.966387,19.602167000004556,317.10779731641685,337.10558633637106
"147.32.84.165",2491,"205.188.59.193",25,3,186,3,186,0,0,95554.990337,9.006082000007154,165.22168019332025,0
"147.32.84.165",2430,"195.113.232.97",80,11,2372,7,1218,4,1154,95555.065559,78.95029900000372,123.41941858889655,116.93432598652431
"147.32.84.165",2492,"218.102.53.146",25,3,186,3,186,0,0,95555.066561,9.030014999996638,164.78377942899917,0
"147.32.84.165",2433,"79.132.91.208",6667,3,186,3,186,0,0,95555.394348,9.003234999996494,165.27392653869188,0
"147.32.84.165",2460,"46.4.36.120",443,6,366,3,186,3,180,95567.507876,1.030337000003783,1444.1876783950654,1397.6009790919989
"147.32.84.165",2348,"74.125.232.200",80,18,6456,10,4226,8,2230,95568.009395,66.00625299999956,512.1938977508726,270.2774235647056
"147.32.84.165",2494,"74.6.136.244",25,3,186,3,186,0,0,95568.017558,9.023511999999755,164.90253462288746,0
"147.32.84.165",2432,"68.67.179.210",80,10,2104,6,925,4,1179,95568.538552,20.99400500000047,352.4815774788962,449.2711133487769
"147.32.84.165",2495,"64.12.90.33",25,3,186,3,186,0,0,95568.567863,8.974537999994936,165.80240676465345,0
"147.32.84.165",2460,"46.4.36.120",443,6,366,3,186,3,180,95570.918569,1.030757000000449,1443.5992188259231,1397.031502089603
"147.32.84.165",2434,"184.82.148.43",80,10,1921,5,983,5,938,95571.118806,0.3581209999974817,21959.05853065109,20953.811700661976
"147.32.84.165",2496,"67.195.168.31",25,3,186,3,186,0,0,95571.23743,9.016868999999133,165.02402330566665,0
"147.32.84.165",2398,"74.125.232.201",80,8,1441,5,935,3,506,95571.921907,62.09385299999849,120.4628097406064,65.19163821256346
"147.32.84.165",2503,"12.7.232.25",25,3,186,3,186,0,0,95571.93011,9.02661800000351,164.84579274313165,0
"147.32.84.165",2482,"217.163.21.34",80,13,5832,6,729,7,5103,95571.94955,0.18977699999231845,30730.805104075098,215115.6357285257
"147.32.84.165",2505,"207.115.20.23",25,3,186,3,186,0,0,95571.995529,8.961321999988286,166.0469292367739,0
"147.32.84.165",2488,"46.4.36.120",443,6,366,3,186,3,180,95573.529055,1.030600999991293,1443.817733548261,1397.2429679499298
"147.32.84.165",2484,"74.125.232.218",80,8,1304,5,593,3,711,95574.559893,69.46005799999693,68.29824415061977,81.88878851785944
"147.32.84.165",2507,"67.231.144.220",25,3,186,3,186,0,0,95574.568224,8.99771100000362,165.37539380842543,0
"147.32.84.165",2420,"94.100.176.20",25,3,186,3,186,0,0,95576.037842,8.932000999993761,166.59201000996745,0
"147.32.84.165",2405,"184.82.148.44",80,10,1511,5,594,5,917,95576.037987,0.32311399999889545,14706.883638642226,22704.061105445995
"147.32.84.165",2510,"38.111.4.126",25,3,186,3,186,0,0,95576.138025,8.931403000009595,166.60316413875864,0
"147.32.84.165",2489,"46.4.36.120",443,6,366,3,186,3,180,95576.138159,1.0367910000059055,1435.197643489888,1388.9009453127949
"147.32.84.165",2487,"95.172.94.25",80,8,1192,5,803,3,389,95576.144607,0.054083000009995885,118780.39307754165,57541.18668389004
"147.32.84.165",2511,"205.188.59.193",25,3,186,3,186,0,0,95576.162251,8.907277000005706,167.05442078415734,0
"147.32.84.165",2488,"163.21.59.10",6667,3,186,3,186,0,0,95577.175193,8.897704000002705,167.23415388953686,0
"147.32.84.165",2405,"46.4.36.120",443,4,246,3,186,1,60,95588.984007,9.062509999988833,164.1929222700812,52.965458796800384
"147.32.84.165",2434,"217.163.21.34",80,10,1525,5,703,5,822,95589.486,0.13969499999075197,40259.135977467464,47073.98260807718
"147.32.84.165",2512,"201.131.48.26",25,3,186,3,186,0,0,95589.53201,8.98276500000793,165.65055414437384,0
"147.32.84.165",2494,"212.117.171.138",65500,49,4875,23,2164,26,2711,95592.194537,48.4955079999927,356.98151672114886,447.2166782953025
"147.32.84.165",2482,"68.67.179.209",80,10,1868,6,786,4,1082,95592.217871,21.111441999993986,297.8479632041142,410.0146261919231
"147.32.84.165",2513,"74.53.45.213",25,3,186,3,186,0,0,95592.247364,8.975577999997768,165.78319524384614,0
"147.32.84.165",2490,"217.163.21.40",80,13,6077,6,749,7,5328,95592.896052,0.19281700000283308,31076.098061436278,221059.3464236749
"147.32.84.165",2516,"74.6.136.244",25,3,186,3,186,0,0,95592.896127,9.029326000003493,164.79635357051282,0
"147.32.84.165",2423,"217.163.21.35",80,12,3743,6,1624,6,2119,95592.942025,0.23471900000004098,55351.29239643033,72222.5299187413
"147.32.84.165",2518,"64.12.90.97",25,3,186,3,186,0,0,95592.987973,8.937604999999166,166.4875545518222,0
"147.32.84.165",2503,"217.163.21.34",80,10,1448,5,699,5,749,95595.504975,0.1411319999897387,39622.481084421524,42456.70719918701
"147.32.84.165",2520,"209.85.225.27",25,3,186,3,186,0,0,95595.551198,8.98264499999641,165.65276708593012,0
"147.32.84.165",2490,"184.82.148.43",80,10,1925,5,987,5,938,95597.009302,0.328719999990426,24020.442930852918,22827.938671874406
"147.32.84.165",2521,"207.115.20.23",25,3,186,3,186,0,0,95597.110262,9.028504999994766,164.8113391974488,0
"147.32.84.165",2420,"74.125.93.27",25,3,186,3,186,0,0,95597.110394,9.028495999998995,164.8115034885285,0
"147.32.84.165",2507,"217.163.21.36",80,9,3148,5,1580,4,1568,95597.116002,0.2571600000082981,49152.27873538704,48778.97028929549
"147.32.84.165",2524,"205.188.59.193",25,3,186,3,186,0,0,95597.162228,8.976710999995703,165.76227083624642,0
"147.32.84.165",2503,"220.164.82.72",6667,3,186,3,186,0,0,95597.209979,9.029397999998764,164.79503949213486,0
"147.32.84.165",2510,"217.163.21.34",80,10,2274,5,1154,5,1120,95598.046755,0.14067599999543745,65625.97742542738,63692.45642675794
"147.32.84.165",2527,"209.85.225.27",25,3,186,3,186,0,0,95598.092966,8.948841000004904,166.27851584346894,0
"147.32.84.165",2530,"216.32.181.178",25,3,186,3,186,0,0,95598.093026,8.948889999999665,166.27760537899738,0
"147.32.84.165",2405,"46.4.36.120",443,5,306,3,186,2,120,95610.552797,6.45473199999833,230.5285486679207,148.72809591478753
"147.32.84.165",2511,"217.163.21.36",80,13,4700,7,2149,6,2551,95613.261401,0.16455400000268128,104476.3421109172,124020.07851323862
"147.32.84.165",2532,"205.188.156.193",25,3,186,3,186,0,0,95613.31009,8.881110999995144,167.54660537412644,0
"147.32.84.165",2512,"173.241.240.4",80,9,2194,5,1164,4,1030,95613.964052,0.06464199999754783,144054.94880036582,127471.30349173264
"147.32.84.165",2534,"74.6.136.244",25,3,186,3,186,0,0,95613.964156,8.929176999998163,166.64469749007174,0
"147.32.84.165",2541,"76.96.30.116",25,3,186,3,186,0,0,95613.980588,8.912845999991987,166.95004042494818,0
"147.32.84.165",2543,"64.12.90.33",25,3,186,3,186,0,0,95616.472448,9.029043000002275,164.80151883202075,0
"147.32.84.165",2544,"74.6.136.244",25,3,186,3,186,0,0,95617.007769,8.995337999993353,165.41902038601546,0
"147.32.84.165",2545,"76.96.30.116",25,3,186,3,186,0,0,95617.007827,8.995402000000468,165.41784347157832,0
"147.32.84.165",2553,"205.188.156.193",25,3,186,3,186,0,0,95617.007879,8.995397999999113,165.41791702825674,0
"147.32.84.165",2555,"78.67.179.71",25,3,186,3,186,0,0,95617.007933,8.995387999995728,165.41810092023897,0
"147.32.84.165",2556,"74.6.136.244",25,3,186,3,186,0,0,95617.776979,9.028919999997015,164.80376390537205,0
"147.32.84.165",2558,"67.195.168.31",25,3,186,3,186,0,0,95617.777112,9.028883000006317,164.80443926440944,0
"147.32.84.165",2516,"46.4.36.120",443,6,366,3,186,3,180,95618.07775,1.0307339999999385,1443.631431581852,1397.062675724373
"147.32.84.165",2560,"207.115.36.22",25,3,186,3,186,0,0,95618.077856,9.028532999989693,164.81082807159243,0
"147.32.84.165",2565,"74.53.45.213",25,3,186,3,186,0,0,95618.077892,9.028619999997318,164.80923995034036,0
"147.32.84.165",2405,"115.137.250.215",6667,6,366,3,186,3,180,95618.981583,1.9334099999978207,769.6246528163593,744.7980511126058
"147.32.84.165",2518,"74.125.39.27",25,3,186,3,186,0,0,95619.10869,9.0012970000098,165.30951039593296,0
"147.32.84.165",2566,"216.17.3.48",25,3,186,3,186,0,0,95620.91525,9.000344999993104,165.32699579862108,0
"147.32.84.165",2520,"46.4.36.120",443,6,366,3,186,3,180,95634.230078,1.0321680000051856,1441.6257818422237,1395.1217243634424
"147.32.84.165",2521,"184.82.148.43",80,10,1897,5,979,5,918,95634.933759,0.34114299999782816,22958.114339294258,21527.629176171737
"147.32.84.165",2567,"74.53.90.155",25,3,186,3,186,0,0,95634.933892,9.029766999999993,164.7883051688932,0
"147.32.84.165",2568,"65.54.188.126",25,3,186,3,186,0,0,95635.046562,9.017314999990049,165.0158611517555,0
"147.32.84.165",2430,"212.117.171.138",65500,14,852,8,486,6,366,95635.262541,214.86261399999785,18.095283900809466,13.627312567276265
"147.32.84.165",2570,"98.139.54.60",25,3,186,3,186,0,0,95635.262578,9.002000000007683,165.2966007552466,0
"147.32.84.165",2534,"64.12.175.136",587,30,3718,16,2098,14,1620,95637.542795,3.2430979999917326,5175.298433794719,3996.1789622247115
"147.32.84.165",2541,"46.4.36.120",443,5,306,3,186,2,120,95637.660822,3.5260009999910835,422.00782132613205,272.2631105329884
"147.32.84.165",2571,"67.231.152.222",25,3,186,3,186,0,0,95638.043909,8.929088999997475,166.64633984501899,0
"147.32.84.165",2572,"205.188.59.193",25,3,186,3,186,0,0,95638.846239,8.928994999994757,166.64809421450832,0
"147.32.84.165",2574,"64.12.90.97",25,3,186,3,186,0,0,95639.147042,8.929730000003474,166.63437752310776,0
"147.32.84.165",2575,"64.12.90.97",25,3,186,3,186,0,0,95639.147176,8.929732000004151,166.63434020184573,0
"147.32.84.165",2577,"64.12.138.161",25,3,186,3,186,0,0,95639.14723,8.929741999992984,166.63415359605787,0
"147.32.84.165",2579,"207.115.36.22",25,3,186,3,186,0,0,95640.149815,8.929876000009244,166.63165311572743,0
"147.32.84.165",2544,"82.205.221.102",6667,3,186,3,186,0,0,95641.187047,8.895967999997083,167.2667887295107,0
"147.32.84.165",2518,"66.111.4.71",25,3,186,3,186,0,0,95641.957153,8.929392000005464,166.6406850543788,0
"147.32.84.165",2553,"184.82.148.43",80,10,1921,5,983,5,938,95655.907665,0.34431999998923857,22839.21933156884,21793.680298078914
"147.32.84.165",2580,"74.53.45.213",25,3,186,3,186,0,0,95656.007808,9.032038999997894,164.7468528424586,0
"147.32.84.165",2545,"46.4.36.120",443,4,246,3,186,1,60,95656.021526,9.05181000000448,164.38701210026102,53.02806841943904
"147.32.84.165",2581,"206.251.228.150",25,3,186,3,186,0,0,95656.208907,9.03135900000052,164.75925716162033,0
"147.32.84.165",2583,"64.12.90.97",25,3,186,3,186,0,0,95659.019195,9.032363999998779,164.74092496717373,0
"147.32.84.165",2584,"65.55.88.22",25,3,186,3,186,0,0,95659.019222,9.032462000002852,164.73913756842046,0
"147.32.84.165",2587,"67.195.168.31",25,3,186,3,186,0,0,95659.821219,9.032607000001008,164.73649301910666,0
"147.32.84.165",2588,"64.82.228.16",25,3,186,3,186,0,0,95660.121584,9.032727000012528,164.73430449054158,0
"147.32.84.165",2590,"124.217.225.31",25,3,186,3,186,0,0,95660.121721,9.03264799999306,164.73574526552383,0
"147.32.84.165",2594,"98.139.175.225",25,3,186,3,186,0,0,95661.125141,9.033061000009184,164.72821339283408,0
"147.32.84.165",2595,"209.191.88.254",25,3,186,3,186,0,0,95661.927861,9.032946999999695,164.7302923398145,0
"147.32.84.165",2572,"61.17.216.4",6667,10,1152,5,594,5,558,95662.930679,1.0450399999972433,4547.194365777898,4271.606828458026
"147.32.84.165",2574,"216.157.130.15",25,3,186,3,186,0,0,95663.121973,8.942106999995303,166.40373460089234,0
"147.32.84.165",2575,"184.82.148.43",80,10,1921,5,983,5,938,95665.07354,0.34424800000851974,22843.996188228764,21798.238478696418
"147.32.84.165",2602,"207.115.20.23",25,3,186,3,186,0,0,95665.187458,8.983986000006553,165.62804082719126,0
"147.32.84.165",2545,"46.4.36.120",443,4,246,3,186,1,60,95677.080292,8.963474999996834,166.00704525873343,53.55065976088175
"147.32.84.165",2579,"184.82.148.44",80,10,1511,5,594,5,917,95677.280568,0.3442819999909261,13802.638535053367,21308.113698053767
"147.32.84.165",2603,"205.188.156.193",25,3,186,3,186,0,0,95677.393395,8.917978999990737,166.85394751451483,0
"147.32.84.165",2580,"217.163.21.34",80,14,6137,7,809,7,5328,95679.989485,0.18931899999734014,34185.686592951206,225143.8049038863
"147.32.84.165",2604,"67.195.168.31",25,3,186,3,186,0,0,95680.035683,8.98467299999902,165.615376319223,0
"147.32.84.165",2607,"74.6.136.244",25,3,186,3,186,0,0,95680.035772,8.984651999999187,165.61576341522573,0
"147.32.84.165",2583,"217.163.21.35",80,10,1448,5,699,5,749,95680.792041,0.13954000000376254,40074.53059946408,42941.09215879627
"147.32.84.165",2609,"209.85.225.27",25,3,186,3,186,0,0,95680.838029,8.98444699999527,165.61954230469425,0
"147.32.84.165",2584,"217.163.21.36",80,9,3153,5,1585,4,1568,95681.092605,0.26124999999592546,48535.885168221095,48015.31100553355
"147.32.84.165",2610,"213.239.225.190",25,3,186,3,186,0,0,95681.092737,9.030918999997084,164.76728448128927,0
"147.32.84.165",2619,"64.12.90.97",25,3,186,3,186,0,0,95681.138499,8.985279000000446,165.60420661394332,0
"147.32.84.165",2580,"217.163.21.35",80,10,2274,5,1154,5,1120,95682.096748,0.13986300000397023,66007.45014577075,64062.68991617266
"147.32.84.165",2620,"64.207.20.170",25,3,186,3,186,0,0,95682.142783,8.983924999993178,165.6291654261506,0
"147.32.84.165",2583,"217.163.21.36",80,13,4705,7,2154,6,2551,95682.899451,0.16746799999964423,102897.26992641344,121862.08708555279
"147.32.84.165",2621,"199.228.142.101",25,3,186,3,186,0,0,95682.945438,8.984000000011292,165.62778272463598,0
"147.32.84.165",2583,"80.75.1.194",6667,3,186,3,186,0,0,95684.003356,9.030111999993096,164.78200934840427,0
"147.32.84.165",2587,"173.241.240.4",80,9,2194,5,1164,4,1030,95686.044009,0.06624499999452382,140569.0995663036,124386.74617980472
"147.32.84.165",2626,"76.3.238.11",25,3,186,3,186,0,0,95686.060394,8.978533000001335,165.72863295148315,0
"147.32.84.165",2627,"207.115.11.16",25,3,186,3,186,0,0,95686.110915,9.028747999996995,164.80690345998087,0
"147.32.84.165",2587,"46.4.36.120",443,6,366,3,186,3,180,95698.350011,1.0308019999938551,1443.5361980369366,1396.9705142292935
"147.32.84.165",2629,"209.85.225.27",25,3,186,3,186,0,0,95699.381054,9.001413999998476,165.3073617100882,0
"147.32.84.165",2631,"198.36.33.47",25,3,186,3,186,0,0,95699.381085,9.001510000001872,165.30559872729026,0
"147.32.84.165",2587,"46.4.36.120",443,6,366,3,186,3,180,95701.058301,1.0307270000048447,1443.6412357423508,1397.0721636216297
"147.32.84.165",2635,"67.195.168.31",25,3,186,3,186,0,0,95701.862043,8.928128999992623,166.66425854747726,0
"147.32.84.165",2636,"74.6.136.244",25,3,186,3,186,0,0,95702.089204,8.901691999999457,167.15923219991106,0
"147.32.84.165",2637,"64.12.90.97",25,3,186,3,186,0,0,95702.161871,8.929852999994182,166.63208229754392,0
"147.32.84.165",2642,"64.12.90.33",25,3,186,3,186,0,0,95702.161997,8.929770000002463,166.633631101315,0
"147.32.84.165",2643,"205.188.59.193",25,3,186,3,186,0,0,95702.162056,8.929759999999078,166.63381770620416,0
"147.32.84.165",2587,"46.4.36.120",443,6,366,3,186,3,180,95703.166013,1.0308530000038445,1443.4647811030773,1396.9014010674941
"147.32.84.165",2645,"65.55.37.104",25,3,186,3,186,0,0,95703.969028,8.92790999999852,166.66834679115794,0
"147.32.84.165",2663,"204.232.236.147",25,3,186,3,186,0,0,95704.197085,8.90245499998855,167.14490553469957,0
"147.32.84.165",2667,"64.12.90.97",25,3,186,3,186,0,0,95704.570978,8.929017000002204,166.6476836139558,0
"147.32.84.165",2610,"60.249.196.250",6667,2,124,2,124,0,0,95707.079071,2.9088340000016615,341.0301172220324,0
"147.32.84.165",2619,"46.4.36.120",443,6,366,3,186,3,180,95707.179246,1.0304599999944912,1444.0152941482006,1397.434155627291
"147.32.84.165",2672,"74.6.136.244",25,3,186,3,186,0,0,95708.20995,8.902707999994163,167.14015555727264,0
"147.32.84.165",2673,"151.151.26.152",25,3,186,3,186,0,0,95708.210016,8.902733000009903,167.13968620628575,0
"147.32.84.165",2626,"46.4.36.120",443,6,366,3,186,3,180,95720.325301,1.0367739999928745,1435.2211764668352,1388.9237191614536
"147.32.84.165",2629,"184.82.155.107",80,10,1916,5,985,5,931,95721.362316,0.32269600000290666,24419.267669661294,23080.546396400678
"147.32.84.165",2674,"98.139.54.60",25,3,186,3,186,0,0,95721.469007,8.990114999993239,165.5151241114401,0
"147.32.84.165",2626,"46.4.36.120",443,6,366,3,186,3,180,95722.833976,1.0361180000036256,1436.1298616516585,1389.8030919209598
"147.32.84.165",2631,"184.82.155.108",80,10,1511,5,599,5,912,95723.034649,0.30452400000649504,15736.033941159954,23958.70276183285
"147.32.84.165",2680,"64.12.90.33",25,3,186,3,186,0,0,95723.134976,9.029928000003565,164.78536705934008,0
"147.32.84.165",2681,"209.85.225.27",25,3,186,3,186,0,0,95723.135009,9.030016999997315,164.7837429320944,0
"147.32.84.165",2682,"213.171.216.66",25,3,186,3,186,0,0,95723.135051,9.030023999992409,164.78361519318784,0
"147.32.84.165",2635,"217.163.21.36",80,15,6201,7,810,8,5391,95723.870316,0.18819400000211317,34432.553641068465,229167.77367777788
"147.32.84.165",2685,"216.32.181.178",25,3,186,3,186,0,0,95723.916143,8.950756999998703,166.24292224671228,0
"147.32.84.165",2642,"173.192.170.88",80,3,186,3,186,0,0,95724.94225,9.02866000001086,164.80850978973737,0
"147.32.84.165",2643,"46.4.36.120",443,6,366,3,186,3,180,95725.142278,1.0308050000021467,1443.531996834417,1396.9664485494357
"147.32.84.165",2637,"217.163.21.36",80,10,1451,5,701,5,750,95725.543877,0.13949299999512732,40202.73418878292,43012.91104363365
"147.32.84.165",2689,"12.71.42.136",25,3,186,3,186,0,0,95725.589804,8.98272800000268,165.65123646174703,0
"147.32.84.165",2631,"217.163.21.36",80,13,6714,8,4337,5,2377,95725.643602,9.232174999997369,3758.1609967326103,2059.752983452482
"147.32.84.165",2692,"65.55.92.184",25,3,186,3,186,0,0,95725.643729,9.029230000000098,164.7981057077939,0
"147.32.84.165",2635,"58.42.247.143",6667,12,1829,7,1271,5,558,95726.173321,11.259700000009616,903.0435979636505,396.45816495965147
"147.32.84.165",2693,"98.139.175.225",25,3,186,3,186,0,0,95726.703917,8.972700999991503,165.83635184114675,0
"147.32.84.165",2663,"46.4.36.120",443,6,366,3,186,3,180,95729.15549,1.0304979999928037,1443.9620455453492,1397.3826247213055
"147.32.84.165",2672,"184.82.155.107",80,10,1912,5,985,5,927,95730.186218,0.34090999999898486,23114.605027788755,21753.54199061947
"147.32.84.165",2694,"64.12.90.33",25,3,186,3,186,0,0,95730.298898,8.98888600000646,165.53775406640275,0
"147.32.84.165",2696,"209.85.225.27",25,3,186,3,186,0,0,95730.298969,8.988928999999189,165.53696218983754,0
"147.32.84.165",2698,"207.115.11.16",25,3,186,3,186,0,0,95730.299042,8.988882000005106,165.5378277297616,0
"147.32.84.165",2663,"46.4.36.120",443,6,366,3,186,3,180,95742.397411,1.031717000005301,1442.2559674720437,1395.7315814245585
"147.32.84.165",2673,"184.82.155.108",80,10,1495,5,595,5,900,95743.429384,0.3066220000036992,15524.000234629522,23481.681027170707
"147.32.84.165",2699,"74.6.136.244",25,3,186,3,186,0,0,95743.530032,9.00655600000755,165.21298485222906,0
"147.32.84.165",2635,"184.82.155.107",80,10,1921,5,993,5,928,95744.106171,0.32270299999800045,24617.062748252178,23005.673948014122
"147.32.84.165",2704,"64.12.90.33",25,3,186,3,186,0,0,95744.106304,9.032032999995863,164.7469622842035,0
"147.32.84.165",2674,"217.163.21.37",80,13,6939,6,1632,7,5307,95744.106363,0.18780899999546818,69517.43526835796,226059.4540252302
"147.32.84.165",2706,"67.195.168.31",25,3,186,3,186,0,0,95744.152351,8.986109000004944,165.58891061739638,0
"147.32.84.165",2717,"205.188.190.2",25,3,186,3,186,0,0,95744.212784,9.02597999999125,164.8574448427143,0
"147.32.84.165",2681,"46.4.36.120",443,6,366,3,186,3,180,95744.809492,1.0302320000046166,1444.3348682562105,1397.7434208931068
"147.32.84.165",2673,"217.163.21.37",80,11,4308,6,1635,5,2673,95745.839942,0.2827899999974761,46253.40358611244,75617.94971601135
"147.32.84.165",2733,"66.64.39.125",25,3,186,3,186,0,0,95745.885798,8.958329999994021,166.1023873870457,0
"147.32.84.165",2680,"184.82.155.108",80,10,1507,5,596,5,911,95745.912781,0.32357399999455083,14735.423736395061,22523.441315194465
"147.32.84.165",2735,"207.115.21.22",25,3,186,3,186,0,0,95746.019751,9.0250570000062,164.87430494887488,0
"147.32.84.165",2635,"173.192.170.88",80,19,4572,11,1106,8,3466,95746.514303,68.9347940000007,128.35317967295168,402.23519054832775
"147.32.84.165",2642,"195.113.232.88",80,54,69031,35,3591,19,65440,95746.614556,112.32502099999692,255.75779772167402,4660.76031270018
"147.32.84.165",2738,"65.55.37.88",25,3,186,3,186,0,0,95746.615354,9.031408000009833,164.7583632583513,0
"147.32.84.165",2680,"124.123.147.161",6667,3,186,3,186,0,0,95747.618449,9.031384000001708,164.75880108737692,0
"147.32.84.165",2689,"46.4.36.120",443,6,366,3,186,3,180,95749.726563,1.0306849999906262,1443.700063563099,1397.129093770741
"147.32.84.165",2663,"217.163.21.36",80,14,6137,7,809,7,5328,95750.757509,0.1885809999948833,34319.4701490373,226024.89116696006
"147.32.84.165",2739,"168.215.102.170",25,3,186,3,186,0,0,95750.803321,8.956382000003941,166.1385144134479,0
"147.32.84.165",2693,"217.163.21.40",80,10,1448,5,699,5,749,95751.233425,0.13942500000121072,40107.58472262106,42976.51066844517
"147.32.84.165",2740,"209.85.225.27",25,3,186,3,186,0,0,95751.279387,8.981790999998339,165.66851755961315,0
"147.32.84.165",2696,"46.4.36.120",443,6,366,3,186,3,180,95764.576043,1.0307990000001155,1443.5403992435317,1396.9745799130953
"147.32.84.165",2663,"217.163.21.37",80,9,3173,5,1605,4,1568,95765.178303,0.23590400000102818,54428.92023850395,53174.172544532215
"147.32.84.165",2748,"67.195.168.31",25,3,186,3,186,0,0,95765.178436,8.929225999992923,166.64378301111196,0
"147.32.84.165",2693,"184.82.148.43",80,10,1921,5,983,5,938,95765.224338,0.3237059999955818,24293.649175817976,23181.528918532313
"147.32.84.165",2749,"74.6.136.244",25,3,186,3,186,0,0,95765.278044,8.93049699999392,166.6200660501888,0
"147.32.84.165",2750,"205.188.190.2",25,3,186,3,186,0,0,95765.33121,8.87745200000063,167.61566269239128,0
"147.32.84.165",2699,"217.163.21.34",80,10,2274,5,1154,5,1120,95765.607043,0.14015099999960512,65871.80969116176,63931.04580078091
"147.32.84.165",2752,"207.115.20.23",25,3,186,3,186,0,0,95765.652981,8.855486999993445,168.03141374394218,0
"147.32.84.165",2663,"46.4.36.120",443,6,366,3,186,3,180,95766.883595,1.0307579999935115,1443.597818313675,1397.0301467551692
"147.32.84.165",2704,"184.82.148.44",80,10,1512,5,594,5,918,95767.084199,0.3082339999964461,15416.858620576544,23826.054231800113
"147.32.84.165",2753,"205.188.190.2",25,3,186,3,186,0,0,95767.186909,8.927322000003187,166.67932443788504,0
"147.32.84.165",2706,"217.163.21.37",80,13,4745,7,2174,6,2571,95767.186969,0.16851299999689218,103208.65452707361,122055.86512838374
"147.32.84.165",2757,"205.188.190.2",25,3,186,3,186,0,0,95767.232891,8.881398999990779,167.5411722862068,0
"147.32.84.165",2766,"168.215.102.170",25,3,186,3,186,0,0,95767.232949,8.881363000007696,167.5418514026181,0
"147.32.84.165",2767,"209.85.225.27",25,3,186,3,186,0,0,95767.232998,8.881341000000248,167.5422664212486,0
"147.32.84.165",2768,"205.188.156.193",25,3,186,3,186,0,0,95767.23305,8.881311999997706,167.54281349426574,0
"147.32.84.165",2693,"217.163.21.34",80,14,6141,7,810,7,5331,95767.685906,0.1901099999959115,34085.52943106285,224333.28073703218
"147.32.84.165",2769,"12.168.76.27",25,3,186,3,186,0,0,95767.732039,8.883560000002035,167.5004164996532,0
"147.32.84.165",2696,"173.241.240.4",80,9,2194,5,1164,4,1030,95767.786432,0.06941300000471529,134153.54471593833,118709.75176753993
"147.32.84.165",2772,"74.6.136.244",25,3,186,3,186,0,0,95767.802842,8.912649999998393,166.95371185901703,0
"147.32.84.165",2773,"209.85.225.27",25,3,186,3,186,0,0,95767.802913,8.912700999993831,166.95275652139907,0
"147.32.84.165",2775,"202.221.162.79",25,3,186,3,186,0,0,95767.802982,8.912682000009227,166.95311242995763,0
"147.32.84.165",2699,"217.163.21.34",80,10,1451,5,701,5,750,95767.914628,0.13908199999423232,40321.53693671763,43140.018120596615
"147.32.84.165",2779,"62.80.17.242",25,3,186,3,186,0,0,95767.960553,8.85586900000635,168.0241656689968,0
"147.32.84.165",2733,"46.4.36.120",443,6,366,3,186,3,180,95771.700118,1.0305530000041472,1443.884982134846,1397.3080472272704
"147.32.84.165",2735,"208.73.210.29",80,50,35660,22,3330,28,32330,95772.201146,16.951856999992742,1571.5092452709698,15257.325495378514
"147.32.84.165",2704,"217.163.21.37",80,10,3242,5,1612,5,1630,95772.38143,0.23950100000365637,53845.28665768878,54446.53675684412
"147.32.84.165",2783,"207.115.20.23",25,3,186,3,186,0,0,95772.427192,9.004934999989928,165.24272523917878,0
"147.32.84.165",2784,"205.188.59.193",25,3,186,3,186,0,0,95772.427235,9.004950000002282,165.24244998579925,0
"147.32.84.165",2699,"217.163.21.34",80,10,2277,5,1156,5,1121,95772.730925,0.13962699999683537,66233.60811454522,64228.26530830899
"147.32.84.165",2785,"130.220.2.1",25,3,186,3,186,0,0,95772.776764,8.956042999998317,166.14480301180774,0
"147.32.84.165",2699,"46.4.36.120",443,6,366,3,186,3,180,95786.147151,1.0306200000050012,1443.7911160202395,1397.2172090518447
"147.32.84.165",2739,"74.125.232.218",80,8,1910,5,1036,3,874,95786.247314,2.906088000003365,2851.9439191071997,2405.983576544105
"147.32.84.165",2704,"217.163.21.38",80,14,4814,7,2181,7,2633,95786.247445,0.23829399999522138,73220.47554848167,88395.00784922157
"147.32.84.165",2786,"74.6.136.244",25,3,186,3,186,0,0,95786.255547,9.021733000001404,164.93505183535893,0
"147.32.84.165",2740,"184.82.148.43",80,10,1905,5,983,5,922,95786.293408,0.40724000000045635,19310.480306431557,18112.169727904267
"147.32.84.165",2787,"205.188.156.193",25,3,186,3,186,0,0,95786.405708,8.972293999991962,165.84387448754276,0
"147.32.84.165",2748,"94.127.76.180",80,10,2483,6,1420,4,1063,95786.406107,2.7470909999974538,4135.283468953351,3095.638258800994
"147.32.84.165",2749,"173.241.240.4",80,9,2195,5,1165,4,1030,95786.449708,0.15833099999872502,58864.02536505833,52042.87221116745
"147.32.84.165",2794,"209.85.225.27",25,3,186,3,186,0,0,95786.495331,8.982252999994671,165.65999643974433,0
"147.32.84.165",2750,"184.82.148.44",80,10,1490,5,582,5,908,95786.594961,0.3416870000073686,13626.50612958524,21259.22262141477
"147.32.84.165",2796,"64.12.90.97",25,3,186,3,186,0,0,95786.707637,8.970822000002954,165.87108739862524,0
"147.32.84.165",2704,"67.214.158.5",80,10,1697,5,851,5,846,95787.178025,0.32074999999895226,21225.253312618046,21100.545596327695
"147.32.84.165",2740,"70.32.97.26",80,8,2577,5,767,3,1810,95787.281567,0.3564990000013495,17211.829486132563,40617.22473259445
"147.32.84.165",2797,"209.85.225.27",25,3,186,3,186,0,0,95787.393721,8.987003000002005,165.57243833118426,0
"147.32.84.165",2752,"50.22.198.84",80,8,2201,5,1168,3,1033,95787.393751,0.37530400000105146,24897.150043628157,22019.48287248963
"147.32.84.165",2798,"209.85.225.27",25,3,186,3,186,0,0,95787.514293,8.966792000006535,165.94563585270134,0
"147.32.84.165",2749,"195.113.232.83",80,8,1364,5,776,3,588,95787.514324,1.639257999995607,3787.079276121658,2869.5909978859986
"147.32.84.165",2801,"67.195.168.31",25,3,186,3,186,0,0,95787.515032,8.966248000011547,165.95570410255033,0
"147.32.84.165",2740,"119.154.75.69",6667,3,186,3,186,0,0,95788.153376,9.031010999999125,164.76560597702118,0
"147.32.84.165",2699,"46.4.36.120",443,6,366,3,186,3,180,95788.655664,1.0309849999903236,1443.2799701392025,1396.7225517476154
"147.32.84.165",2750,"67.214.158.5",80,10,1762,5,873,5,889,95788.756117,0.34082900000794325,20491.21406874777,20866.76896576949
"147.32.84.165",2704,"195.113.232.96",80,8,1854,5,653,3,1201,95788.856501,61.621635999996215,84.77541881556537,155.9192618644625
"147.32.84.165",2802,"98.139.54.60",25,3,186,3,186,0,0,95788.857375,9.029298999987077,164.79684635563953,0
"147.32.84.165",2813,"205.188.156.193",25,3,186,3,186,0,0,95788.859863,9.026933000001009,164.84004035477318,0
"147.32.84.165",2752,"68.67.179.211",80,10,1728,6,702,4,1026,95789.686869,17.75920000000042,316.2304608315615,462.1829812153592
"147.32.84.165",2814,"205.188.190.2",25,3,186,3,186,0,0,95789.715926,8.973234999997658,165.82648286826193,0
"147.32.84.165",2767,"46.4.36.120",443,6,366,3,186,3,180,95793.471625,1.0303429999912623,1444.1792684694503,1397.5928404543067
"147.32.84.165",2757,"68.67.185.214",80,10,2485,6,1117,4,1368,95793.772167,13.673685999994632,653.5180053135276,800.3694102675969
"147.32.84.165",2822,"195.130.90.41",25,3,186,3,186,0,0,95793.801275,8.902634999991278,167.14152607643217,0
"147.32.84.165",2739,"173.192.170.88",80,3,186,3,186,0,0,95794.502307,8.903540999992401,167.12451821149247,0
"147.32.84.165",2735,"217.163.21.38",80,13,6678,6,1645,7,5033,95794.502367,0.18775700000696816,70090.59582072358,214447.39742595854
"147.32.84.165",2824,"74.6.136.244",25,3,186,3,186,0,0,95794.548492,8.857479999991483,167.99360540485904,0
"147.32.84.165",2748,"64.4.62.124",81,7,1080,4,559,3,521,95794.548565,60.617983999996795,73.77348609944264,68.75847273311201
"147.32.84.165",2825,"67.195.168.31",25,3,186,3,186,0,0,95794.71,8.896709999986342,167.2528384090618,0
"147.32.84.165",2750,"184.82.148.43",80,10,1921,5,983,5,938,95794.710061,0.3404249999875901,23100.536095429758,22043.034443044875
"147.32.84.165",2826,"98.139.54.60",25,3,186,3,186,0,0,95794.822655,8.885348000010708,167.4667103638717,0
"147.32.84.165",2769,"217.163.21.38",80,11,4462,6,1649,5,2813,95794.822687,0.2304699999949662,57239.55395621179,97643.944984126
"147.32.84.165",2827,"218.102.53.145",25,3,186,3,186,0,0,95794.869548,8.838592000000062,168.3526063879846,0
"147.32.84.165",2735,"46.4.36.120",443,6,366,3,186,3,180,95807.221297,1.030259000006481,1444.297016566358,1397.7067902255078
"147.32.84.165",2773,"68.67.185.203",80,10,1683,6,889,4,794,95807.421696,21.73004699999001,327.2887536784099,292.3141399557452
"147.32.84.165",2829,"205.188.59.193",25,3,186,3,186,0,0,95807.445519,9.005753000004916,165.22771610538152,0
"147.32.84.165",2775,"184.82.148.44",80,10,1512,5,594,5,918,95807.622639,0.32631899999978486,14562.437369577416,22505.585025710552
"147.32.84.165",2830,"205.188.190.2",25,3,186,3,186,0,0,95807.730303,9.022254999988945,164.92550919939896,0
"147.32.84.165",2779,"70.32.97.26",80,8,1497,5,842,3,655,95807.730378,0.35095400000864174,19193.3985645815,14930.731662471357
"147.32.84.165",2838,"205.188.190.2",25,3,186,3,186,0,0,95807.842632,9.01044300000649,165.14171389785477,0
"147.32.84.165",2740,"184.82.148.43",80,10,1931,5,991,5,940,95807.842706,0.3400160000019241,23316.549809288786,22116.6062772265
"147.32.84.165",2839,"195.130.90.41",25,3,186,3,186,0,0,95807.955079,8.998683999991044,165.35751227640407,0
"147.32.84.165",2752,"217.163.21.35",80,13,6081,6,750,7,5331,95807.955152,0.1867130000027828,32134.880805892335,228414.7327682827
"147.32.84.165",2842,"74.6.136.244",25,3,186,3,186,0,0,95808.001043,8.952841999998782,166.2042064408377,0
"147.32.84.165",2757,"184.82.148.44",80,10,1514,5,596,5,918,95808.251766,0.32300400000531226,14761.427102827158,22736.56053757606
"147.32.84.165",2845,"67.195.168.31",25,3,186,3,186,0,0,95808.358264,8.99616400001105,165.40383212202138,0
"147.32.84.165",2786,"217.163.21.35",80,10,1451,5,701,5,750,95808.358336,0.1401719999994384,40007.99018364915,42804.55440476014
"147.32.84.165",2848,"74.125.45.27",25,3,186,3,186,0,0,95808.404873,8.949678999997559,166.2629464141011,0
"147.32.84.165",2854,"209.85.225.27",25,3,186,3,186,0,0,95808.425344,9.029580999995233,164.7916996370912,0
"147.32.84.165",2857,"208.65.145.12",25,3,186,3,186,0,0,95808.425494,9.029527000006055,164.79268515382944,0
"147.32.84.165",2740,"189.212.138.52",6667,3,186,3,186,0,0,95809.829727,9.02968300000066,164.7898381371629,0
"147.32.84.165",2752,"46.4.36.120",443,6,366,3,186,3,180,95809.829862,1.0307259999972302,1443.642636359225,1397.0735190573146
"147.32.84.165",2794,"217.163.21.38",80,9,3187,5,1617,4,1570,95810.632205,0.23463900000206195,55131.49987805233,53529.038224206655
"147.32.84.165",2864,"64.12.90.33",25,3,186,3,186,0,0,95810.677996,8.984404999995604,165.62031653745885,0
"147.32.84.165",2796,"217.163.21.35",80,15,6201,7,810,8,5391,95810.860798,0.1871030000038445,34633.330303986855,230504.05391209028
"147.32.84.165",2866,"205.188.156.193",25,3,186,3,186,0,0,95810.906627,8.955783999990672,166.1496078960312,0
"147.32.84.165",2797,"46.4.36.120",443,6,366,3,186,3,180,95814.746919,1.0304449999966891,1444.0363144124926,1397.4544978185413
"147.32.84.165",2779,"217.163.21.35",80,10,2277,5,1156,5,1121,95815.749717,0.14009299999452196,66013.29117344639,64014.61886283165
"147.32.84.165",2867,"98.129.185.3",25,3,186,3,186,0,0,95815.777706,9.001453000004403,165.30664549370775,0
"147.32.84.165",2796,"173.192.170.88",80,11,1279,7,782,4,497,95815.796118,75.49769400000514,82.86345805475295,52.66386017034811
"147.32.84.165",2786,"217.163.21.35",80,10,1451,5,701,5,750,95815.996915,0.16221200001018587,34572.04152373347,36988.63215806006
"147.32.84.165",2868,"74.6.136.244",25,3,186,3,186,0,0,95816.043067,8.936824999997043,166.5020854722446,0
"147.32.84.165",2813,"217.163.21.38",80,13,4764,7,2186,6,2578,95816.043097,0.159285000001546,109790.62686273198,129478.60752613131
"147.32.84.165",2870,"63.165.126.52",25,3,186,3,186,0,0,95816.088911,8.991221999996924,165.49474587553382,0
"147.32.84.165",2822,"46.4.36.120",443,6,366,3,186,3,180,95828.492053,1.0297090000094613,1445.0684610762146,1398.4533494285947
"147.32.84.165",2814,"184.82.148.43",80,10,1923,5,983,5,940,95828.992551,0.34073899999202695,23079.248340178296,22069.677965175582
"147.32.84.165",2873,"209.85.225.27",25,3,186,3,186,0,0,95829.105098,8.917237000001478,166.86783136971164,0
"147.32.84.165",2635,"217.163.21.38",80,9,3187,5,1617,4,1570,95829.105158,0.28008799999952316,46185.48456207343,44843.049327430606
"147.32.84.165",2875,"67.195.168.31",25,3,186,3,186,0,0,95829.151186,8.871272000003955,167.73242890076378,0
"147.32.84.165",2739,"173.241.240.4",80,9,2195,5,1165,4,1030,95829.393595,0.0673430000024382,138395.9728503714,122358.67127543567
"147.32.84.165",2877,"217.72.192.149",25,3,186,3,186,0,0,95829.409822,8.913864000001922,166.93097404219753,0
"147.32.84.165",2779,"92.240.244.181",80,10,1760,6,1366,4,394,95829.494151,7.542030999989947,1448.946576859014,417.9245617001841
"147.32.84.165",2879,"205.188.156.193",25,3,186,3,186,0,0,95829.49433,8.92901599999459,166.64770227770916,0
"147.32.84.165",2773,"217.163.21.35",80,10,2277,5,1156,5,1121,95829.49438,0.14017800000146963,65973.26256547422,63975.80219368217
"147.32.84.165",2881,"205.188.59.193",25,3,186,3,186,0,0,95829.494437,8.929030999992392,166.64742232402014,0
"147.32.84.165",2888,"208.84.244.136",25,3,186,3,186,0,0,95829.502677,8.920840000006137,166.8004358332821,0
"147.32.84.165",2899,"65.55.92.168",25,3,186,3,186,0,0,95829.522,8.90156100000604,167.16169220196213,0
"147.32.84.165",2905,"74.6.136.244",25,3,186,3,186,0,0,95829.540506,8.88310300000012,167.50903372391156,0
"147.32.84.165",2839,"62.209.146.67",6667,3,186,3,186,0,0,95831.701009,8.930307000002358,166.6236110359484,0
"147.32.84.165",2635,"46.4.36.120",443,6,366,3,186,3,180,95831.902113,1.0308090000035008,1443.5263952826822,1396.9610276929184
"147.32.84.165",2829,"217.163.21.38",80,13,4769,7,2191,6,2578,95832.933149,0.16515000000072177,106133.81774098332,124880.41174635098
"147.32.84.165",2914,"67.195.168.31",25,3,186,3,186,0,0,95832.979279,8.856445999990683,168.0132188466531,0
"147.32.84.165",2916,"205.188.190.2",25,3,186,3,186,0,0,95832.97934,8.856443999990006,168.01325678812842,0
"147.32.84.165",2845,"46.4.36.120",443,6,366,3,186,3,180,95836.718628,1.0298059999913676,1444.9323464929057,1398.321625638296
"147.32.84.165",2822,"173.241.240.4",80,9,2195,5,1165,4,1030,95837.019199,0.0685760000051232,135907.60614943592,120158.65608061716
"147.32.84.165",2920,"94.245.120.86",25,3,186,3,186,0,0,95837.036021,9.013530999989598,165.08513700143897,0
"147.32.84.165",2857,"184.82.148.43",80,10,1923,5,983,5,940,95837.748671,0.32285500000580214,24357.68378949892,23292.189991992862
"147.32.84.165",2922,"205.188.59.193",25,3,186,3,186,0,0,95837.855323,8.997103000001516,165.3865694323772,0
"147.32.84.165",2939,"64.12.90.33",25,3,186,3,186,0,0,95837.855354,8.997157999998308,165.38555841747805,0
"147.32.84.165",2822,"46.4.36.120",443,6,366,3,186,3,180,95850.06396,1.0311860000074375,1442.9986442690918,1396.4503009055727
"147.32.84.165",2779,"184.82.148.44",80,10,1514,5,596,5,918,95850.36494,0.3424950000044191,13921.371114727162,21442.648797515998
"147.32.84.165",2940,"74.6.136.244",25,3,186,3,186,0,0,95850.465483,9.029569999998785,164.79190038952024,0
"147.32.84.165",2870,"212.117.171.138",65500,126,92449,65,4659,61,87790,95850.465609,60.42238999999245,616.8574265268994,11623.50578982539
"147.32.84.165",2942,"67.195.168.31",25,3,186,3,186,0,0,95850.465667,9.029488000000129,164.79339692349984,0
"147.32.84.165",2943,"205.188.156.193",25,3,186,3,186,0,0,95850.465722,9.029456000003847,164.79398094407526,0
"147.32.84.165",2944,"209.143.0.180",25,3,186,3,186,0,0,95850.46578,9.029418999998597,164.7946562232001,0
"147.32.84.165",2950,"91.217.56.204",25,3,186,3,186,0,0,95850.47781,9.017414000001736,165.01404948244735,0
"147.32.84.165",2953,"205.188.190.2",25,3,186,3,186,0,0,95850.488435,9.006811999992351,165.20828901516583,0
"147.32.84.165",2956,"74.6.136.244",25,3,186,3,186,0,0,95850.488465,9.00680299999658,165.20845409859248,0
"147.32.84.165",2957,"66.175.58.41",25,3,186,3,186,0,0,95850.565088,9.030209999997169,164.7802210580337,0
"147.32.84.165",2704,"77.123.72.98",6667,3,186,3,186,0,0,95851.095367,9.00238900000113,165.28945816491745,0
"147.32.84.165",2868,"46.4.36.120",443,6,366,3,186,3,180,95853.876369,1.0302410000003874,1444.3222508126162,1397.731210463822
"147.32.84.165",2873,"217.163.21.35",80,13,6081,6,750,7,5331,95854.90683,0.19605699999374337,30603.34494657918,217528.5758802848
"147.32.84.165",2961,"205.188.156.193",25,3,186,3,186,0,0,95854.952838,8.957151000009617,166.12425089165097,0
"147.32.84.165",2962,"208.65.144.2",25,3,186,3,186,0,0,95854.952912,8.957200000004377,166.1233421157586,0
"147.32.84.165",2899,"46.4.36.120",443,4,246,3,186,1,60,95858.090839,3.5113470000069356,423.7689980503382,136.69967679043168
"147.32.84.165",2879,"217.163.21.35",80,10,1451,5,701,5,750,95858.893432,0.14069300000846852,39859.83666324868,42646.04493214909
"147.32.84.165",2968,"64.12.90.97",25,3,186,3,186,0,0,95858.93941,8.884316999989096,167.48614440500336,0
"147.32.84.165",2922,"98.126.71.122",80,9,4083,6,710,3,3373,95871.434675,14.77803899999708,384.35410814663044,1825.9526856036402
"147.32.84.165",2873,"217.163.21.38",80,9,3202,5,1622,4,1580,95871.434807,0.2860190000064904,45367.61543710574,44192.86830494887
"147.32.84.165",2969,"207.115.37.23",25,3,186,3,186,0,0,95871.434865,9.02923099999316,164.79808745629913,0
"147.32.84.165",2920,"212.117.171.138",65500,9,544,5,302,4,242,95871.43492,31.343733999994583,77.08079707415898,61.76673143028634
"147.32.84.165",2916,"184.82.148.43",80,10,1925,5,987,5,938,95871.434974,0.3054379999957746,25851.400284539686,24567.99743353417
"147.32.84.165",2976,"67.195.168.31",25,3,186,3,186,0,0,95871.435031,9.02918499999214,164.79892703508625,0
"147.32.84.165",2977,"205.188.156.193",25,3,186,3,186,0,0,95871.480745,8.983520000008866,165.6366324111853,0
"147.32.84.165",2978,"74.6.136.244",25,3,186,3,186,0,0,95871.535137,9.029942000008305,164.78511157642336,0
"147.32.84.165",2980,"205.188.156.193",25,3,186,3,186,0,0,95871.535737,9.029464000006556,164.79383493847692,0
"147.32.84.165",2981,"65.54.188.110",25,3,186,3,186,0,0,95871.535796,9.02945400000317,164.79401744551527,0
"147.32.84.165",2983,"174.143.82.88",25,3,186,3,186,0,0,95871.609954,8.955340999993496,166.1578269326741,0
"147.32.84.165",2989,"64.136.44.37",25,3,186,3,186,0,0,95871.635736,9.028705999997328,164.80767011357335,0
"147.32.84.165",2942,"190.136.214.243",6667,3,186,3,186,0,0,95873.541324,9.029700999992201,164.78950964171295,0
"147.32.84.165",2956,"46.4.36.120",443,6,366,3,186,3,180,95875.848923,1.0307650000031572,1443.5880147225046,1397.0206594088752
"147.32.84.165",2944,"195.113.232.88",80,15,6000,8,2160,7,3840,95876.879942,9.332991000002949,1851.4964816739393,3291.5493007536697
"147.32.84.165",2940,"217.163.21.35",80,10,2277,5,1156,5,1121,95876.880806,0.13947599999664817,66305.31417750899,64297.80033995465
"147.32.84.165",2990,"205.188.156.193",25,3,186,3,186,0,0,95876.926617,8.954547999994247,166.17254159572946,0
"147.32.84.165",2873,"31.192.109.161",80,10,1273,5,540,5,733,95876.926677,0.24716800000169314,17477.990678285245,23724.75401330201
"147.32.84.165",2943,"64.12.175.136",587,48,14617,24,12295,24,2322,95877.010494,33.798076999999466,2910.2247444433465,549.6170684503824
"147.32.84.165",2962,"195.113.232.96",80,8,1964,5,941,3,1023,95877.12822,9.084948000003351,828.623344899412,900.8306927014862
"147.32.84.165",2961,"217.163.21.39",80,13,4769,7,2191,6,2578,95877.129083,0.19804999999178108,88502.90331091845,104135.31936811855
"147.32.84.165",2992,"65.55.37.104",25,3,186,3,186,0,0,95877.174997,9.00709800000186,165.20304319989552,0
"147.32.84.165",2961,"46.4.36.120",443,6,366,3,186,3,180,95879.861791,1.030641999997897,1443.7602969828865,1397.187384176987
"147.32.84.165",2940,"195.113.232.83",80,23,22177,14,1301,9,20876,95880.892678,5.32067200000165,1956.1438855837705,31388.516337776167
"147.32.84.165",2873,"173.241.240.4",80,9,2195,5,1165,4,1030,95880.893559,0.06809200000134297,136873.64154109414,121012.74745693302
"147.32.84.165",2993,"64.12.90.97",25,3,186,3,186,0,0,95880.910434,8.984226999993552,165.62359789006533,0
"147.32.84.165",2796,"173.192.170.88",80,11,1281,7,784,4,497,95892.503206,57.20573700001114,109.63935312989287,69.50351850198567
"147.32.84.165",2873,"46.4.36.120",443,6,366,3,186,3,180,95892.503347,1.0310029999964172,1443.2547722995673,1396.6981667415168
"147.32.84.165",2996,"74.6.136.244",25,3,186,3,186,0,0,95892.503406,8.928876999998465,166.65029656027917,0
"147.32.84.165",3000,"194.153.145.93",25,3,186,3,186,0,0,95892.503454,8.928957999989507,166.64878477441025,0
"147.32.84.165",3003,"208.84.66.226",25,3,186,3,186,0,0,95892.603577,8.929888999991817,166.63141053616272,0
"147.32.84.165",3008,"67.195.168.31",25,3,186,3,186,0,0,95892.603648,8.92991500000062,166.6309253783375,0
"147.32.84.165",3010,"64.12.90.33",25,3,186,3,186,0,0,95892.603683,8.929907000012463,166.6310746570959,0
"147.32.84.165",3011,"64.136.44.37",25,3,186,3,186,0,0,95892.703737,8.92954899999313,166.63775516559065,0
"147.32.84.165",3012,"209.85.143.27",25,3,186,3,186,0,0,95892.703873,8.929517999989912,166.63833367060585,0
"147.32.84.165",3015,"64.12.90.97",25,3,186,3,186,0,0,95892.703935,8.929510000001756,166.6384829626382,0
"147.32.84.165",3016,"207.115.20.23",25,3,186,3,186,0,0,95892.703991,8.929503999999724,166.63859493204168,0
"147.32.84.165",3019,"74.6.136.244",25,3,186,3,186,0,0,95892.704084,8.929457000005641,166.63947203050085,0
"147.32.84.165",3023,"98.139.175.225",25,3,186,3,186,0,0,95893.5347,8.902359999992768,167.1466891926645,0
"147.32.84.165",2969,"46.4.36.120",443,6,366,3,186,3,180,95898.122339,1.030895000003511,1443.4059724753074,1396.844489492233
"147.32.84.165",2978,"184.82.148.43",80,10,1917,5,979,5,938,95899.153454,0.341669000001275,22922.770283434475,21962.776839490845
"147.32.84.165",3026,"205.188.59.193",25,3,186,3,186,0,0,95899.266677,8.988471999997273,165.54537856939993,0
"147.32.84.165",2873,"46.4.36.120",443,6,366,3,186,3,180,95901.833837,1.032099999996717,1441.7207634964955,1395.2136420933828
"147.32.84.165",2989,"184.82.148.44",80,10,1511,5,594,5,917,95902.866187,0.34378699999069795,13822.51219542501,21338.794079469248
"147.32.84.165",3028,"67.195.168.31",25,3,186,3,186,0,0,95902.979981,8.989371999996365,165.52880445937734,0
"147.32.84.165",2920,"212.117.171.138",65500,14,861,8,486,6,375,95902.980011,201.97532999998657,19.249875715020536,14.853299162824486
"147.32.84.165",3031,"205.188.59.193",25,3,186,3,186,0,0,95902.980035,8.989442999998573,165.52749708744315,0
"147.32.84.165",3032,"64.12.90.97",25,3,186,3,186,0,0,95902.980058,8.989468999992823,165.52701833681033,0
"147.32.84.165",2873,"46.4.36.120",443,6,366,3,186,3,180,95913.473949,1.0320989999891026,1441.7221603893724,1395.2149939251992
"147.32.84.165",3035,"67.195.168.31",25,3,186,3,186,0,0,95913.57551,9.030203000002075,164.7803487916781,0
"147.32.84.165",3039,"74.6.136.244",25,3,186,3,186,0,0,95913.575661,9.03018100000918,164.7807502417158,0
"147.32.84.165",3041,"207.115.37.23",25,3,186,3,186,0,0,95913.575729,9.030147999990731,164.7813524209711,0
"147.32.84.165",3048,"205.188.156.193",25,3,186,3,186,0,0,95913.575802,9.030124999990221,164.78177212404162,0
"147.32.84.165",3049,"209.86.93.226",25,3,186,3,186,0,0,95913.575878,9.030096000002231,164.78230131768615,0
"147.32.84.165",3050,"67.195.168.31",25,3,186,3,186,0,0,95913.675837,9.029368999996223,164.79556877126436,0
"147.32.84.165",3054,"64.12.90.33",25,3,186,3,186,0,0,95913.675985,9.029344000009587,164.79602504882084,0
"147.32.84.165",3055,"139.175.54.239",25,3,186,3,186,0,0,95913.67606,9.029317000007723,164.7965178317172,0
"147.32.84.165",3056,"77.238.184.241",25,3,186,3,186,0,0,95914.478769,9.028924000012921,164.8036908936071,0
"147.32.84.165",3059,"129.1.11.86",25,3,186,3,186,0,0,95914.506172,9.001643000010517,165.30315632360242,0
"147.32.84.165",3003,"46.4.36.120",443,6,366,3,186,3,180,95920.297017,1.0376169999944977,1434.055147523499,1387.7953040549992
"147.32.84.165",3060,"205.188.156.193",25,3,186,3,186,0,0,95921.334856,8.894866999995429,167.28749288783797,0
"147.32.84.165",3062,"209.85.225.27",25,3,186,3,186,0,0,95921.334916,8.894937999997637,167.28615758765213,0
"147.32.84.165",2905,"61.17.216.28",6667,3,186,3,186,0,0,95924.009469,8.929709999996703,166.6347507366476,0
"147.32.84.165",3019,"46.4.36.120",443,5,306,3,186,2,120,95934.544955,6.555163999990327,226.99660908593526,146.4494252167324
"147.32.84.165",3023,"184.82.148.43",80,10,1921,5,983,5,938,95934.545058,0.3229859999992186,24347.804548862878,23233.205154459185
"147.32.84.165",3064,"67.195.168.31",25,3,186,3,186,0,0,95934.545093,9.033111000011559,164.72730159057008,0
"147.32.84.165",3028,"94.100.176.20",25,3,186,3,186,0,0,95934.545119,9.033209999994142,164.72549625226966,0
"147.32.84.165",2905,"94.63.150.20",80,15,9103,8,777,7,8326,95934.645515,0.7665410000045085,8109.155283231346,86894.24309933615
"147.32.84.165",3072,"74.6.136.244",25,3,186,3,186,0,0,95934.64565,9.03293699999631,164.73047470613466,0
"147.32.84.165",3074,"207.115.20.23",25,3,186,3,186,0,0,95934.645709,9.032961999997497,164.730018791224,0
"147.32.84.165",3075,"216.82.253.243",25,3,186,3,186,0,0,95934.65154,9.027158999990206,164.83591349189865,0
"147.32.84.165",3077,"194.248.190.66",25,3,186,3,186,0,0,95934.743736,8.934983999992255,166.53639223095306,0
"147.32.84.165",3035,"184.82.148.44",80,10,1512,5,594,5,918,95935.448432,0.34173299999383744,13905.59296317796,21490.461852184122
"147.32.84.165",3080,"205.188.59.193",25,3,186,3,186,0,0,95935.448534,9.032088000007207,164.7459590737837,0
"147.32.84.165",3081,"65.54.188.126",25,3,186,3,186,0,0,95935.561234,9.020222999999532,164.96266223130814,0
"147.32.84.165",3049,"31.192.109.161",80,10,1273,5,540,5,733,95941.10035,0.23879700001270976,18090.67953018703,24556.42239930943
"147.32.84.165",3039,"217.163.21.34",80,14,6141,7,810,7,5331,95941.178376,0.1887410000053933,34332.76288572612,225960.44314050116
"147.32.84.165",3085,"205.188.190.2",25,3,186,3,186,0,0,95941.224276,8.976003000003402,165.77534566325747,0
"147.32.84.165",3056,"46.4.36.120",443,6,366,3,186,3,180,95942.272743,1.0318440000119153,1442.0784537030959,1395.5597939062218
"147.32.84.165",3050,"217.163.21.34",80,10,1451,5,701,5,750,95943.30483,0.1395290000073146,40192.36144246722,43001.813240870775
"147.32.84.165",3086,"74.6.136.244",25,3,186,3,186,0,0,95943.35069,8.956544999993639,166.13549086182863,0
"147.32.84.165",3019,"184.82.148.43",80,10,1925,5,983,5,942,95943.35075,0.3237020000087796,24293.94937253001,23280.671728304445
"147.32.84.165",3098,"64.12.90.33",25,3,186,3,186,0,0,95943.457722,8.949576999992132,166.26484134404433,0
"147.32.84.165",3039,"217.163.21.39",80,9,3192,5,1622,4,1570,95943.879193,0.2559239999973215,50702.552320750714,49077.06975559718
"147.32.84.165",3205,"209.86.93.226",25,3,186,3,186,0,0,95943.925337,8.98376200000348,165.63217057613764,0
"147.32.84.165",2796,"173.192.170.88",80,7,860,4,423,3,437,95955.619317,30.306746999995084,111.65830499725189,115.3538517347496
"147.32.84.165",3019,"82.206.239.241",6667,3,186,3,186,0,0,95955.719635,8.929843999998411,166.63225023866764,0
"147.32.84.165",3039,"46.4.36.120",443,5,306,3,186,2,120,95955.719778,1.0044179999968037,1481.4549321146526,955.7773755578404
"147.32.84.165",3049,"184.82.148.44",80,10,1512,5,594,5,918,95955.719838,0.30352999999013264,15655.783613331405,24195.301947875807
"147.32.84.165",3209,"74.6.136.244",25,3,186,3,186,0,0,95955.719894,8.929707000002963,166.63480671868697,0
"147.32.84.165",3028,"74.125.39.27",25,3,186,3,186,0,0,95955.819993,8.929917000001296,166.63088805862182,0
"147.32.84.165",3050,"217.163.21.34",80,10,2277,5,1156,5,1121,95955.820369,0.14015099999960512,65985.97227294887,63988.12709167446
"147.32.84.165",3210,"64.12.90.33",25,3,186,3,186,0,0,95955.866687,8.88328900000488,167.50552638771325,0
"147.32.84.165",3226,"207.115.20.21",25,3,186,3,186,0,0,95955.866746,8.883253000007244,167.50620521545278,0
"147.32.84.165",3072,"217.163.21.40",80,13,4769,7,2191,6,2578,95956.522202,0.15956300000834744,109850.02788292419,129253.02231044207
"147.32.84.165",3250,"94.245.120.86",25,3,186,3,186,0,0,95956.56841,8.883755999995628,167.4967209816132,0
"147.32.84.165",3074,"217.163.21.34",80,14,6141,7,810,7,5331,95956.623339,0.1913639999984298,33862.16843321195,222863.2344659912
"147.32.84.165",3259,"208.40.195.230",25,3,186,3,186,0,0,95956.669344,8.882855000003474,167.51371040047576,0
"147.32.84.165",3077,"173.241.240.4",80,9,2195,5,1165,4,1030,95962.141901,0.0687750000070082,135514.3584013128,119810.97781403622
"147.32.84.165",3272,"205.188.59.193",25,3,186,3,186,0,0,95962.158275,9.011461000001873,165.12305829206727,0
"147.32.84.165",3049,"92.240.244.181",80,10,1760,6,1366,4,394,95964.348374,4.359573000008822,2506.6675107809606,723.0065880290618
"147.32.84.165",3275,"205.188.156.193",25,3,186,3,186,0,0,95964.35697,9.020321000003605,164.96087001775274,0
"147.32.84.165",3050,"217.163.21.34",80,10,1451,5,701,5,750,95964.850024,0.14023900000029244,39988.87613280404,42784.10427903428
"147.32.84.165",3276,"74.6.136.244",25,3,186,3,186,0,0,95964.895977,8.982882000011159,165.64839658342962,0
"147.32.84.165",3278,"207.115.20.23",25,3,186,3,186,0,0,95964.896039,8.983036999998149,165.64553836306214,0
"147.32.84.165",3086,"217.163.21.40",80,9,3202,5,1622,4,1580,95968.661799,0.2757500000006985,47057.116953643264,45838.62194004708
"147.32.84.165",3304,"205.188.156.193",25,3,186,3,186,0,0,95968.707664,8.983307999995304,165.64054132406213,0
"147.32.84.165",3098,"184.82.148.43",80,10,1923,5,983,5,940,95968.707736,0.32255799999984447,24380.11148383792,23313.636617301774
"147.32.84.165",3308,"205.188.156.193",25,3,186,3,186,0,0,95968.814307,8.97689900000114,165.7587993359189,0
"147.32.84.165",3318,"65.55.37.120",25,3,186,3,186,0,0,95968.814381,8.976945999995223,165.75793148369075,0
"147.32.84.165",3039,"46.4.36.120",443,5,306,3,186,2,120,95976.687683,1.003192999996827,1483.2639382498746,956.9444762902417
"147.32.84.165",3049,"217.163.21.34",80,10,2277,5,1156,5,1121,95976.687862,0.1465709999902174,63095.70106376596,61185.364093842254
"147.32.84.165",3329,"98.139.175.225",25,3,186,3,186,0,0,95976.733864,8.987503000011202,165.56322707187363,0
"147.32.84.165",3362,"209.85.225.27",25,3,186,3,186,0,0,95976.787889,9.033658000000287,164.71732713369852,0
"147.32.84.165",3385,"184.182.187.229",25,3,186,3,186,0,0,95976.788044,9.03363900000113,164.71767357537905,0
"147.32.84.165",3019,"66.111.4.71",25,3,186,3,186,0,0,95977.489932,9.034073000002536,164.70976048118965,0
"147.32.84.165",3028,"217.163.21.40",80,13,4769,7,2191,6,2578,95977.590557,0.17018600000301376,102993.19567819682,121185.05634796503
"147.32.84.165",3390,"67.195.168.31",25,3,186,3,186,0,0,95977.636464,8.987573000005796,165.56193757747954,0
"147.32.84.165",3259,"173.192.170.88",80,28,4856,12,943,16,3913,95983.212568,44.073724000001675,171.1677461155702,710.2644650585644
"147.32.84.165",3209,"184.82.148.43",80,10,1923,5,983,5,940,95983.212631,0.3044569999910891,25829.591700076413,24699.711290001862
"147.32.84.165",3396,"98.139.175.224",25,3,186,3,186,0,0,95983.313106,8.933032000000821,166.57278290281096,0
"147.32.84.165",3210,"173.241.240.4",80,9,2195,5,1165,4,1030,95985.420845,0.06913000000349712,134818.457970903,119195.7182060344
"147.32.84.165",3401,"207.115.20.23",25,3,186,3,186,0,0,95985.437657,8.915016999992076,166.90938446907307,0
"147.32.84.165",3226,"92.240.244.181",80,10,1760,6,1366,4,394,95985.437716,5.0360470000014175,2169.9559197912417,625.8877250349556
"147.32.84.165",3402,"66.234.224.26",25,3,186,3,186,0,0,95985.446257,8.906541000003926,167.06822547601183,0
"147.32.84.165",3414,"74.6.136.244",25,3,186,3,186,0,0,95985.921956,8.932904999994207,166.57515108477756,0
"147.32.84.165",3449,"64.12.90.97",25,3,186,3,186,0,0,95989.636277,9.031641000008676,164.75411279064022,0
"147.32.84.165",3453,"205.188.190.2",25,3,186,3,186,0,0,95989.737104,9.031300000002375,164.7603335067608,0
"147.32.84.165",2996,"46.4.36.120",443,6,366,3,186,3,180,95997.663375,1.031965999995009,1441.9079698431892,1395.394809525667
"147.32.84.165",3039,"184.82.148.43",80,10,1923,5,983,5,940,95997.764239,0.30507000000216067,25777.690365962902,24650.080309262594
"147.32.84.165",3459,"77.238.184.241",25,3,186,3,186,0,0,95997.764333,9.02981500000169,164.78742919979217,0
"147.32.84.165",3461,"65.55.37.120",25,3,186,3,186,0,0,95997.864926,9.02909300000465,164.80060621805907,0
"147.32.84.165",3502,"98.139.175.225",25,3,186,3,186,0,0,95998.467506,9.02867200000037,164.80829074308372,0
"147.32.84.165",3329,"216.157.130.15",25,3,186,3,186,0,0,95998.567273,9.029264000011608,164.79748515472434,0
"147.32.84.165",3516,"216.237.221.35",25,3,186,3,186,0,0,95998.695584,9.001822000005632,165.29986929302413,0
"147.32.84.165",3039,"31.192.109.161",80,10,1273,5,540,5,733,96004.285492,0.2665350000024773,16208.002701183137,22000.862925865258
"147.32.84.165",2996,"46.4.36.120",443,6,366,3,186,3,180,96004.363717,1.0530980000039563,1412.9739112546124,1367.394107665754
"147.32.84.165",3553,"67.195.168.31",25,3,186,3,186,0,0,96005.417051,9.000832999998238,165.31803223104922,0
"147.32.84.165",3396,"222.85.179.42",6667,3,186,3,186,0,0,96006.392165,9.02929099999892,164.79699236630847,0
"147.32.84.165",2996,"46.4.36.120",443,6,366,3,186,3,180,96006.894156,1.0310830000089481,1443.142792565765,1396.5897992571918
"147.32.84.165",3039,"184.82.148.43",80,10,1923,5,983,5,940,96007.92545,0.30549500000779517,25741.82883451231,24615.78749180221
"147.32.84.165",3556,"209.85.225.27",25,3,186,3,186,0,0,96008.026109,9.000595000004978,165.32240368544268,0
"147.32.84.165",2996,"46.4.36.120",443,6,366,3,186,3,180,96010.705967,1.0304789999936474,1443.9886693558753,1397.4083896992342
"147.32.84.165",3589,"205.188.59.193",25,3,186,3,186,0,0,96010.806334,9.037876000002143,164.64045313297584,0
"147.32.84.165",3597,"205.188.59.193",25,3,186,3,186,0,0,96011.736707,9.008640999993077,165.17474722337627,0
"147.32.84.165",3598,"203.188.197.119",25,3,186,3,186,0,0,96011.73677,9.008726999993087,165.17317041588026,0
"147.32.84.165",3453,"46.4.36.120",443,6,366,3,186,3,180,96018.832344,1.044954000011785,1423.986127602955,1378.0510912286663
"147.32.84.165",3396,"184.82.155.107",80,10,1909,5,981,5,928,96018.932469,0.3231109999906039,24288.866675007106,22976.62413293231
"147.32.84.165",3638,"147.187.10.115",25,3,186,3,186,0,0,96019.03931,8.916574000002583,166.8802389796315,0
"147.32.84.165",3650,"205.188.156.193",25,3,186,3,186,0,0,96019.543744,8.912550000008196,166.95558510175334,0
"147.32.84.165",3660,"65.55.92.152",25,3,186,3,186,0,0,96019.643694,8.913331000003382,166.94095619240838,0
"147.32.84.165",3667,"67.195.168.31",25,3,186,3,186,0,0,96019.744029,8.912993000005372,166.9472869550221,0
"147.32.84.165",3697,"205.188.59.193",25,3,186,3,186,0,0,96019.744115,8.91300400000182,166.9470809167926,0
"147.32.84.165",3698,"65.54.188.110",25,3,186,3,186,0,0,96019.744149,8.913002999994205,166.9470996476684,0
"147.32.84.165",3706,"205.188.156.193",25,3,186,3,186,0,0,96019.877573,8.879759999996168,167.57209654322213,0
"147.32.84.165",3741,"216.32.181.178",25,3,186,3,186,0,0,96019.877632,8.879848999989918,167.57041701966887,0
"147.32.84.165",3329,"46.4.36.120",443,6,366,3,186,3,180,96026.353533,1.0345910000032745,1438.2495111549301,1391.8543656338034
"147.32.84.165",3743,"209.85.225.27",25,3,186,3,186,0,0,96026.85399,9.013135000001057,165.09239016167243,0
"147.32.84.165",3779,"65.55.88.22",25,3,186,3,186,0,0,96026.854122,9.013175000000047,165.0916574902842,0
"147.32.84.165",3780,"128.121.85.2",25,3,186,3,186,0,0,96027.388362,8.98000100000354,165.70154056769186,0
"147.32.84.165",3259,"147.32.84.171",139,22,3171,11,1639,11,1532,96028.957416,0.04518899999675341,290159.1095386494,271216.4464998236
"147.32.84.165",3810,"67.195.168.31",25,3,186,3,186,0,0,96028.957626,9.012598999994225,165.10220858610856,0
"147.32.84.165",3259,"46.4.36.120",443,6,366,3,186,3,180,96031.761205,1.0334129999973811,1439.8889892073846,1393.440957297469
"147.32.84.165",3820,"98.139.175.225",25,3,186,3,186,0,0,96032.667412,9.008073000004515,165.18516224271875,0
"147.32.84.165",3827,"74.6.136.244",25,3,186,3,186,0,0,96032.794904,8.980825000006007,165.68633727959343,0
"147.32.84.165",3598,"201.249.127.77",6667,2,124,2,124,0,0,96039.972965,3.0044640000123763,330.1753657211115,0
"147.32.84.165",3589,"46.4.36.120",443,6,366,3,186,3,180,96040.474022,1.0290660000027856,1445.9713954167878,1399.327156854956
"147.32.84.165",3857,"205.188.190.2",25,3,186,3,186,0,0,96040.574451,9.004879000000074,165.2437528588655,0
"147.32.84.165",3863,"205.188.156.193",25,3,186,3,186,0,0,96040.674424,9.004912999997032,165.24312894533134,0
"147.32.84.165",3864,"205.188.59.193",25,3,186,3,186,0,0,96040.774274,9.005318000010448,165.2356973955027,0
"147.32.84.165",3870,"207.115.20.23",25,3,186,3,186,0,0,96041.503358,8.979315999997198,165.7141813474951,0
"147.32.84.165",3650,"46.4.36.120",443,6,366,3,186,3,180,96047.884267,1.036565000002156,1435.510556498536,1389.203764353422
"147.32.84.165",3697,"184.82.148.43",80,10,1919,5,979,5,940,96048.385407,0.3429130000004079,22839.612379789287,21929.760609807894
"147.32.84.165",3897,"65.55.37.88",25,3,186,3,186,0,0,96048.499571,9.005769000010332,165.2274225552857,0
"147.32.84.165",3743,"98.126.71.122",80,12,4253,7,766,5,3487,96048.92109,17.236231999995653,355.53014139062094,1618.4511788891584
"147.32.84.165",3779,"184.82.148.44",80,10,1513,5,596,5,917,96049.096155,0.323882999990019,14721.365431797698,22650.154531809545
"147.32.84.165",3898,"66.94.238.147",25,3,186,3,186,0,0,96049.203903,9.0038840000052,165.26201359314942,0
"147.32.84.165",3650,"46.4.36.120",443,6,366,3,186,3,180,96049.980436,1.0378009999985807,1433.8008924659305,1387.549250773481
"147.32.84.165",3697,"195.113.232.98",80,11,3610,6,1391,5,2219,96051.018459,17.651456000006874,630.4295804264343,1005.6960740231904
"147.32.84.165",3780,"217.163.21.34",80,13,6077,6,749,7,5328,96051.018533,0.18709099999978207,32027.195322099833,227824.96218444314
"147.32.84.165",3900,"210.158.149.183",25,3,186,3,186,0,0,96051.064501,8.948707000003196,166.28100573630007,0
"147.32.84.165",3650,"46.4.36.120",443,6,366,3,186,3,180,96053.693353,1.0364910000062082,1435.6130443883135,1389.3029461822389
"147.32.84.165",3904,"67.195.168.31",25,3,186,3,186,0,0,96053.793778,9.02880099999311,164.80593602640437,0
"147.32.84.165",3925,"195.75.94.98",25,3,186,3,186,0,0,96054.730095,8.995308999990812,165.41955368087076,0
"147.32.84.165",3820,"46.4.36.120",443,6,366,3,186,3,180,96057.103936,1.0313960000057705,1442.7048388704968,1396.1659731004809
"147.32.84.165",3827,"184.82.148.43",80,10,1923,5,983,5,940,96058.135703,0.3483459999988554,22575.255636711314,21587.73173805558
"147.32.84.165",3929,"205.188.190.2",25,3,186,3,186,0,0,96058.24997,8.986824999999953,165.5757177868722,0
"147.32.84.165",3949,"64.12.90.97",25,3,186,3,186,0,0,96058.250039,8.986879999996745,165.57470445811438,0
"147.32.84.165",3827,"46.4.36.120",443,6,366,3,186,3,180,96061.618907,1.030230999997002,1444.3362702193294,1397.7447776316092
"147.32.84.165",4006,"207.44.238.147",25,3,186,3,186,0,0,96061.718985,8.928499999994528,166.6573332587682,0
"147.32.84.165",4007,"65.55.92.152",25,3,186,3,186,0,0,96061.818895,8.928913999989163,166.6496059881197,0
"147.32.84.165",4015,"196.25.36.7",25,3,186,3,186,0,0,96062.521698,8.928498000008403,166.6573705900589,0
"147.32.84.165",4040,"74.6.136.244",25,3,186,3,186,0,0,96062.649387,8.900827999998,167.17545828324447,0
"147.32.84.165",3827,"31.192.109.161",80,10,1273,5,540,5,733,96069.443506,0.24159200000576675,17881.386800460623,24272.32689766229
"147.32.84.165",3870,"46.4.36.120",443,6,366,3,186,3,180,96069.524381,1.0499140000029001,1417.2589373947674,1371.5409071562265
"147.32.84.165",3743,"184.82.148.43",80,10,1923,5,983,5,940,96070.145684,0.3229319999954896,24351.875937069835,23286.63619618072
"147.32.84.165",4052,"207.115.20.23",25,3,186,3,186,0,0,96070.252231,9.022547999993549,164.92015337586056,0
"147.32.84.165",3697,"184.82.148.44",80,10,1514,5,596,5,918,96070.574537,0.34026100000482984,14012.772547933264,21583.4315419509
"147.32.84.165",4062,"67.195.168.31",25,3,186,3,186,0,0,96070.686825,8.989625000001979,165.524145890365,0
"147.32.84.165",4065,"217.72.192.188",25,3,186,3,186,0,0,96070.686887,8.989587000003667,165.5248455796015,0
"147.32.84.165",3898,"46.4.36.120",443,6,366,3,186,3,180,96071.951649,1.031148000009125,1443.0518218401548,1396.5017630711177
"147.32.84.165",3897,"217.163.21.35",80,14,6141,7,810,7,5331,96072.983122,0.18925199999648612,34240.06087185507,225350.3265529128
"147.32.84.165",4071,"64.12.139.193",25,3,186,3,186,0,0,96073.029247,8.954435000006924,166.17463860074358,0
"147.32.84.165",3897,"173.192.170.88",80,11,1100,6,543,5,557,96074.760469,76.54668699999456,56.74968010046351,58.2128394400703
"147.32.84.165",3870,"217.163.21.35",80,10,1451,5,701,5,750,96074.961253,0.1404599999950733,39925.95756939131,42716.787699063454
"147.32.84.165",4083,"205.188.190.2",25,3,186,3,186,0,0,96075.007796,8.983410999993794,165.63864215953473,0
"147.32.84.165",3898,"46.4.36.120",443,6,366,3,186,3,180,96075.663674,1.0309300000080839,1443.3569689390474,1396.7970667152072
"147.32.84.165",3900,"217.163.21.40",80,11,4179,6,1682,5,2497,96076.694865,0.286697000003187,46934.56855094549,69676.34819959031
"147.32.84.165",4103,"64.12.90.33",25,3,186,3,186,0,0,96076.741126,8.955845000004047,166.14847621852854,0
"147.32.84.165",3898,"46.4.36.120",443,6,366,3,186,3,180,96079.174978,1.0302740000042832,1444.27598871156,1397.6864406886066
"147.32.84.165",3925,"195.113.232.96",80,44,56279,31,2918,13,53361,96080.205494,87.19062400000985,267.73520969407633,4896.031022784649
"147.32.84.165",4104,"203.127.37.73",25,3,186,3,186,0,0,96080.206344,9.00272099999711,165.28336266340784,0
"147.32.84.165",3898,"46.4.36.120",443,6,366,3,186,3,180,96082.686813,1.030547000002116,1443.893388653739,1397.3161825681345
"147.32.84.165",4136,"114.108.154.199",25,3,186,3,186,0,0,96082.78747,9.029525999998441,164.7927034043932,0
"147.32.84.165",4148,"165.21.74.121",25,3,186,3,186,0,0,96083.489673,9.02978099999018,164.7880496771315,0
"147.32.84.165",4176,"74.6.136.244",25,3,186,3,186,0,0,96083.589362,9.030249000003096,164.77950940217593,0
"147.32.84.165",4192,"206.81.145.5",25,3,186,3,186,0,0,96083.71758,9.002455000008922,165.28824637263116,0
"147.32.84.165",3898,"79.113.153.241",6667,2,124,2,124,0,0,96091.315681,3.0089830000069924,329.67949636062906,0
"147.32.84.165",4007,"46.4.36.120",443,5,306,3,186,2,120,96091.716371,6.555437000002712,226.98715585236872,146.44332635636692
"147.32.84.165",4197,"67.195.168.31",25,3,186,3,186,0,0,96094.024376,8.929793999996036,166.6331832515577,0
"147.32.84.165",4052,"184.82.148.43",80,10,1907,5,987,5,920,96096.03005,0.3583749999961583,22032.786885482088,20537.14684361046
"147.32.84.165",4198,"205.188.156.193",25,3,186,3,186,0,0,96096.148711,9.013141000003088,165.09228026050965,0
"147.32.84.165",4062,"184.82.148.44",80,10,1476,5,581,5,895,96097.736114,0.32806600000185426,14167.880853162867,21824.876701515946
"147.32.84.165",4211,"68.6.19.3",25,3,186,3,186,0,0,96097.842664,8.925067000003764,166.72143749726163,0
"147.32.84.165",4065,"217.163.21.40",80,14,7110,7,1803,7,5307,96098.272029,0.18957099999533966,76087.5872383149,223958.3058645242
"147.32.84.165",4214,"205.188.156.193",25,3,186,3,186,0,0,96098.317996,8.851051999998163,168.11560930839735,0
"147.32.84.165",4215,"207.115.20.22",25,3,186,3,186,0,0,96098.318026,8.851143000007141,168.11388088507886,0
"147.32.84.165",4065,"46.4.36.120",443,6,366,3,186,3,180,96101.14894,1.0304239999968559,1444.0657438147214,1397.482977885214
"147.32.84.165",4083,"217.163.21.40",80,11,4432,6,1746,5,2686,96102.179598,0.23102599999401718,60460.72736558537,93011.17623365538
"147.32.84.165",4234,"195.102.249.132",25,3,186,3,186,0,0,96102.22557,8.95743800001219,166.11892820223542,0
"147.32.84.165",4065,"46.4.36.120",443,6,366,3,186,3,180,96103.757338,1.0301089999993565,1444.507328836977,1397.9103182293327
"147.32.84.165",4267,"74.6.136.244",25,3,186,3,186,0,0,96104.459212,9.032047000000603,164.74670692035824,0
"147.32.84.165",4280,"205.188.156.193",25,3,186,3,186,0,0,96104.459343,9.032040000005509,164.7468346020492,0
"147.32.84.165",4285,"68.6.19.3",25,3,186,3,186,0,0,96104.459397,9.032049999994342,164.74665219976995,0
"147.32.84.165",4286,"65.54.188.126",25,3,186,3,186,0,0,96104.459445,9.032045999992988,164.74672516073935,0
"147.32.84.165",4288,"216.32.180.22",25,3,186,3,186,0,0,96104.559477,9.032145000004675,164.74491939613787,0
"147.32.84.165",4290,"205.188.59.193",25,3,186,3,186,0,0,96104.660271,9.031724000000395,164.75259872865192,0
"147.32.84.165",4292,"207.115.20.23",25,3,186,3,186,0,0,96104.787679,9.004266999996617,165.25498410926278,0
"147.32.84.165",4176,"212.117.171.138",65500,9,544,5,302,4,242,96107.771258,13.932318999999552,173.40975325070275,138.95748439294724
"147.32.84.165",4192,"46.4.36.120",443,6,366,3,186,3,180,96107.793759,1.0135110000119312,1468.1636410285464,1420.8035235760126
"147.32.84.165",4293,"98.139.175.225",25,3,186,3,186,0,0,96108.807519,9.000460000010207,165.3248833946612,0
"147.32.84.165",3210,"46.4.36.120",443,6,366,3,186,3,180,96114.995612,1.0310549999994691,1443.181983503078,1396.6277259707206
"147.32.84.165",4296,"98.139.54.60",25,3,186,3,186,0,0,96116.026909,9.006205000012415,165.21942371930785,0
"147.32.84.165",4197,"46.4.36.120",443,6,366,3,186,3,180,96117.20461,1.032783999995445,1440.7659297651423,1394.2896094501377
"147.32.84.165",4297,"218.102.53.139",25,3,186,3,186,0,0,96118.237644,9.005162000001292,165.23855983932177,0
"147.32.84.165",4198,"202.9.159.34",6667,3,186,3,186,0,0,96118.81198,9.032650000008289,164.73570878962812,0
"147.32.84.165",4314,"74.6.136.244",25,3,186,3,186,0,0,96119.213112,9.032949000000372,164.73025586659892,0
"147.32.84.165",4176,"212.117.171.138",65500,9,544,5,302,4,242,96123.225844,75.45928300000378,32.017266848399274,25.656220454677566
"147.32.84.165",4197,"46.4.36.120",443,6,366,3,186,3,180,96123.248402,1.008551000006264,1475.3839914796158,1427.7909594964024
"147.32.84.165",4211,"184.82.148.43",80,10,1927,5,987,5,940,96124.257395,0.34217200000421144,23076.11376706106,21977.251206724817
"147.32.84.165",4319,"216.32.181.178",25,3,186,3,186,0,0,96124.369937,8.8931339999981,167.32009210704777,0
"147.32.84.165",4197,"46.4.36.120",443,6,366,3,186,3,180,96125.534881,1.0314990000042599,1442.5607780461783,1396.0265593995273
"147.32.84.165",4234,"173.192.170.88",80,3,186,3,186,0,0,96125.634835,8.932639999999083,166.5800927833376,0
"147.32.84.165",4320,"66.240.127.98",25,3,186,3,186,0,0,96125.634962,8.93263900000602,166.58011143168298,0
"147.32.84.165",4344,"205.188.59.193",25,3,186,3,186,0,0,96125.73584,8.932289000003948,166.5866386543631,0
"147.32.84.165",4347,"78.67.175.163",25,3,186,3,186,0,0,96125.836566,8.93115800000669,166.60773440564878,0
"147.32.84.165",4355,"205.188.59.193",25,3,186,3,186,0,0,96126.566523,8.90394999999262,167.11684140198827,0
"147.32.84.165",4404,"67.195.168.31",25,3,186,3,186,0,0,96126.566558,8.904039999993984,167.11515222314875,0
"147.32.84.165",4288,"31.192.109.161",80,10,1273,5,540,5,733,96129.851587,0.2439929999964079,17705.42597559602,24033.476370577562
"147.32.84.165",4197,"46.4.36.120",443,6,366,3,186,3,180,96129.930486,0.9514239999989513,1563.9714785433625,1513.520785687125
"147.32.84.165",4415,"207.115.11.16",25,3,186,3,186,0,0,96130.882112,9.00356899999315,165.2677954710107,0
"147.32.84.165",4292,"46.4.36.120",443,6,366,3,186,3,180,96136.975042,1.0368719999969471,1435.0855264722948,1388.7924449731884
"147.32.84.165",4198,"184.82.148.43",80,10,1923,5,983,5,940,96138.012138,0.32525199999508914,24178.175691828907,23120.534232267724
"147.32.84.165",4440,"205.188.156.193",25,3,186,3,186,0,0,96138.118703,8.992068000006839,165.47917564667753,0
"147.32.84.165",4441,"68.125.255.102",25,3,186,3,186,0,0,96138.881102,9.032053999995696,164.74657923886517,0
"147.32.84.165",4452,"74.125.93.27",25,3,186,3,186,0,0,96139.182267,9.031581000002916,164.75520731082625,0
"147.32.84.165",4292,"94.100.176.20",25,3,186,3,186,0,0,96140.186045,9.030664000005345,164.77193703576162,0
"147.32.84.165",4459,"64.12.90.33",25,3,186,3,186,0,0,96145.304612,9.02859799998987,164.80964154142976,0
"147.32.84.165",4314,"46.4.36.120",443,6,366,3,186,3,180,96146.608587,1.0307420000026468,1443.6202269784087,1397.0518325597504
"147.32.84.165",4319,"184.82.148.43",80,10,1923,5,983,5,940,96146.709106,0.3422030000074301,22980.511567196234,21975.260298234443
"147.32.84.165",4461,"65.55.37.120",25,3,186,3,186,0,0,96146.809548,9.028303999992204,164.81500844469625,0
"147.32.84.165",4462,"67.195.168.31",25,3,186,3,186,0,0,96146.821727,9.016225999992457,165.03579213755788,0
"147.32.84.165",4468,"205.188.156.193",25,3,186,3,186,0,0,96146.821785,9.016194000010728,165.03637787720956,0
"147.32.84.165",4473,"77.238.177.9",25,3,186,3,186,0,0,96146.821837,9.01616300000751,165.03694531684494,0
"147.32.84.165",4482,"205.188.190.2",25,3,186,3,186,0,0,96147.51127,9.029559000002337,164.7921011424384,0
"147.32.84.165",4487,"208.85.113.25",25,3,186,3,186,0,0,96147.639563,9.001294000001508,165.30956549133387,0
"147.32.84.165",4404,"173.192.170.88",80,10,2734,5,483,5,2251,96151.92623,1.6183600000076694,2387.6022640090514,11127.314070982142
"147.32.84.165",4355,"218.93.203.210",6667,2,124,2,124,0,0,96152.127311,3.0088859999959823,329.690124518285,0
"147.32.84.165",4314,"46.4.36.120",443,6,366,3,186,3,180,96159.148714,1.030350000000908,1444.169456979365,1397.5833454639014
"147.32.84.165",4491,"98.139.54.60",25,3,186,3,186,0,0,96159.951597,8.930256999999983,166.62454395209485,0
"147.32.84.165",4502,"207.115.20.23",25,3,186,3,186,0,0,96160.179327,8.90270099999907,167.1402869758465,0
"147.32.84.165",4506,"64.12.90.33",25,3,186,3,186,0,0,96160.251904,8.930548999996972,166.6190958697505,0
"147.32.84.165",4520,"67.195.168.31",25,3,186,3,186,0,0,96160.252002,8.930573000005097,166.6186480978489,0
"147.32.84.165",4452,"46.4.36.120",443,6,366,3,186,3,180,96161.255588,1.0316109999985201,1442.4041620360142,1395.8749955187234
"147.32.84.165",4544,"205.188.59.193",25,3,186,3,186,0,0,96162.287419,9.003129000004265,165.27587242160976,0
"147.32.84.165",4292,"74.125.93.27",25,3,186,3,186,0,0,96166.272402,9.041442000001553,164.57551793173528,0
"147.32.84.165",4559,"98.139.54.60",25,3,186,3,186,0,0,96167.777608,9.038457000002381,164.62986989921043,0
"147.32.84.165",4459,"46.4.36.120",443,6,366,3,186,3,180,96167.777741,1.030458000008366,1444.0180967957153,1397.4368678668213
"147.32.84.165",4562,"24.40.8.248",25,3,186,3,186,0,0,96167.777809,9.038354999996955,164.63172778680428,0
"147.32.84.165",4565,"74.6.136.244",25,3,186,3,186,0,0,96168.479331,9.038163999997778,164.6352068849786,0
"147.32.84.165",4568,"65.55.92.168",25,3,186,3,186,0,0,96168.58001,9.037037000001874,164.65573837970248,0
"147.32.84.165",4570,"207.115.20.23",25,3,186,3,186,0,0,96168.808431,9.008904000002076,165.1699252206103,0
"147.32.84.165",4571,"205.188.156.193",25,3,186,3,186,0,0,96168.808464,9.008965999993961,165.1687885159071,0
"147.32.84.165",4459,"117.205.50.80",6667,6,366,3,186,3,180,96169.986035,2.1525540000002366,691.2718565944624,668.972764446254
"147.32.84.165",4473,"46.4.36.120",443,6,366,3,186,3,180,96172.138846,0.9911160000046948,1501.3378857701334,1452.9076313904516
"147.32.84.165",4487,"184.82.148.43",80,10,1923,5,983,5,940,96173.13017,0.30491999999503605,25790.371245336555,24662.206480789788
"147.32.84.165",4584,"218.103.17.209",25,3,186,3,186,0,0,96173.231086,8.983731000000262,165.63274212016773,0
"147.32.84.165",4487,"46.4.36.120",443,6,366,3,186,3,180,96180.921694,1.029112999996869,1445.9053573363929,1399.263249035219
"147.32.84.165",4459,"184.82.148.44",80,10,1514,5,596,5,918,96181.122023,0.34122000000206754,13973.389601931627,21522.771232505424
"147.32.84.165",4600,"64.12.90.33",25,3,186,3,186,0,0,96181.222134,9.020556000003126,164.95657252163662,0
"147.32.84.165",4603,"10.145.129.176",25,3,186,3,186,0,0,96181.234706,9.008105999993859,165.18455710900986,0
"147.32.84.165",4491,"217.163.21.35",80,14,6141,7,810,7,5331,96181.951085,0.1897960000060266,34141.92079808974,224704.41947483507
"147.32.84.165",4611,"205.188.156.193",25,3,186,3,186,0,0,96181.997272,8.946472000010544,166.32254591511003,0
"147.32.84.165",4502,"184.82.155.107",80,10,1913,5,985,5,928,96181.997332,0.33990300000004936,23183.084585893197,21841.525376354202
"147.32.84.165",4615,"208.65.145.2",25,3,186,3,186,0,0,96182.109655,8.934640000006766,166.54280418672417,0
"147.32.84.165",4459,"207.232.61.93",6667,3,186,3,186,0,0,96183.318841,9.030012000002898,164.78383417425385,0
"147.32.84.165",4502,"46.4.36.120",443,6,366,3,186,3,180,96187.332334,1.0312310000008438,1442.9356759046057,1396.3893637786507
"147.32.84.165",4520,"217.163.21.35",80,10,1451,5,701,5,750,96188.363806,0.1387539999996079,40416.852847599686,43241.99662724645
"147.32.84.165",4650,"205.188.156.193",25,3,186,3,186,0,0,96188.409682,8.854321999999229,168.05352233633806,0
"147.32.84.165",4292,"74.125.39.27",25,3,186,3,186,0,0,96188.409712,8.854416000001947,168.0517382512492,0
"147.32.84.165",4491,"184.82.155.108",80,10,1508,5,596,5,912,96188.837605,0.3403650000109337,14008.490884335448,21435.811554553573
"147.32.84.165",4666,"207.115.11.16",25,3,186,3,186,0,0,96188.949989,8.917094000003999,166.87050736476846,0
"147.32.84.165",4559,"46.4.36.120",443,6,366,3,186,3,180,96189.539317,1.0314799999905517,1442.5873502284387,1396.052274414618
"147.32.84.165",4520,"217.163.21.36",80,13,6078,6,750,7,5328,96189.639965,0.18631800000730436,32203.007759662392,228770.16712464162
"147.32.84.165",4669,"65.54.188.72",25,3,186,3,186,0,0,96189.685905,8.882675000000745,167.5171049261484,0
"147.32.84.165",4562,"217.163.21.36",80,10,1449,5,700,5,749,96189.840685,0.14728599999216385,38021.26475223674,40682.75328489331
"147.32.84.165",4675,"64.12.90.33",25,3,186,3,186,0,0,96189.886518,8.882737000007182,167.51593568500303,0
"147.32.84.165",4711,"205.188.190.2",25,3,186,3,186,0,0,96189.886577,8.88273900000786,167.51589796780965,0
"147.32.84.165",4502,"31.192.109.161",80,10,1273,5,540,5,733,96190.57104,0.24173800001153722,17870.587163763343,24257.667390812094
"147.32.84.165",4491,"217.163.21.37",80,12,5772,7,3264,5,2508,96190.650294,3.1989019999891752,8162.8008610730685,6272.152132221586
"147.32.84.165",4727,"209.85.225.27",25,3,186,3,186,0,0,96190.696375,8.875058000005083,167.66087613164305,0
"147.32.84.165",4502,"46.4.36.120",443,6,366,3,186,3,180,96194.254383,1.0306349999882514,1443.7701029141863,1397.1968737879222
"147.32.84.165",4520,"184.82.147.251",80,10,1894,5,982,5,912,96195.285257,0.3266189999994822,24052.489291842958,22337.95339527574
"147.32.84.165",4728,"98.137.54.237",25,3,186,3,186,0,0,96195.392966,8.893863999997848,167.30635863111468,0
"147.32.84.165",4176,"212.117.171.138",65500,14,852,7,426,7,426,96202.179755,8.391537999996217,406.1234066986929,406.1234066986929
"147.32.84.165",4502,"46.4.36.120",443,6,366,3,186,3,180,96202.179888,1.0304780000005849,1443.990070626598,1397.4097457676755
"147.32.84.165",4491,"184.82.147.252",80,10,1307,5,586,5,721,96202.20242,0.30416099999274593,15412.889884343509,18963.640966914114
"147.32.84.165",4745,"205.188.59.193",25,3,186,3,186,0,0,96202.303066,9.005698000008124,165.2287251913908,0
"147.32.84.165",4600,"217.163.21.38",80,14,6750,7,1739,7,5011,96202.983111,0.1898300000029849,73286.6248737357,211178.42279602622
"147.32.84.165",4749,"205.188.190.2",25,3,186,3,186,0,0,96202.983246,9.027579000001424,164.82824464895464,0
"147.32.84.165",4758,"207.115.11.16",25,3,186,3,186,0,0,96202.983299,9.027646000002278,164.82702135192545,0
"147.32.84.165",4759,"65.55.37.88",25,3,186,3,186,0,0,96202.98335,9.027645000009215,164.8270396098297,0
"147.32.84.165",4764,"205.178.149.7",25,3,186,3,186,0,0,96203.029122,8.981916999997338,165.66619353089558,0
"147.32.84.165",4491,"117.204.73.9",6667,3,186,3,186,0,0,96203.210573,9.001628999991226,165.30341341566626,0
"147.32.84.165",4615,"46.4.36.120",443,6,366,3,186,3,180,96209.302658,1.030769999997574,1443.5810122563737,1397.0138828287486
"147.32.84.165",4603,"217.163.21.38",80,11,4411,6,1719,5,2692,96209.90472,0.24968699998862576,55076.95635185836,86251.98749226452
"147.32.84.165",4771,"74.6.136.244",25,3,186,3,186,0,0,96209.951114,8.982474999997066,165.65590218736884,0
"147.32.84.165",4292,"66.111.4.73",25,3,186,3,186,0,0,96210.333662,9.000965999992331,165.31558946020547,0
"147.32.84.165",4611,"184.82.147.251",80,10,1910,5,982,5,928,96210.607081,0.3284340000100201,23919.569836741397,22604.23707586152
"147.32.84.165",4777,"81.169.145.101",25,3,186,3,186,0,0,96210.714765,9.021175000001676,164.9452538055989,0
"147.32.84.165",4666,"195.113.232.88",80,57,72165,39,3713,18,68452,96210.807551,123.6742249999952,240.1793906531547,4427.891098569821
"147.32.84.165",4795,"163.5.42.12",25,3,186,3,186,0,0,96210.808375,9.028044000006048,164.81975497671513,0
"147.32.84.165",4669,"212.117.171.138",65500,9,544,5,302,4,242,96211.609812,1.3405090000014752,1802.300469446562,1444.227528496914
"147.32.84.165",4611,"46.4.36.120",443,6,366,3,186,3,180,96211.632392,1.00857299999916,1475.3518089431695,1427.7598151062932
"147.32.84.165",4603,"184.82.147.252",80,10,1508,5,596,5,912,96212.641171,0.3234179999999469,14742.531337157432,22559.041240750972
"147.32.84.165",4823,"205.188.156.193",25,3,186,3,186,0,0,96212.748039,8.99409100000048,165.4419551681121,0
"147.32.84.165",4603,"212.117.171.138",65500,14,870,8,486,6,384,96216.325471,7.210044999999809,539.2476745984391,426.07223671975436
"147.32.84.165",4669,"46.4.36.120",443,6,366,3,186,3,180,96216.34844,1.0077779999992345,1476.515661188407,1428.8861237307165
"147.32.84.165",4727,"217.163.21.36",80,14,6141,7,810,7,5331,96217.356506,0.18896400000085123,34292.24614196783,225693.78294176605
"147.32.84.165",4827,"98.137.54.237",25,3,186,3,186,0,0,96217.402341,8.955655000012484,166.15200116551225,0
"147.32.84.165",4669,"46.4.36.120",443,6,366,3,186,3,180,96223.347663,1.030443000010564,1444.0391171416034,1397.4572101370354
"147.32.84.165",4728,"217.163.21.36",80,10,1451,5,701,5,750,96224.050278,0.1393380000081379,40247.455824487726,43060.758728053916
"147.32.84.165",4844,"74.6.136.244",25,3,186,3,186,0,0,96224.050418,8.928981000004569,166.64835550655093,0
"147.32.84.165",4745,"212.117.171.138",65500,15,912,8,486,7,426,96224.050472,7.116232999993372,546.3564782102584,478.9050611472635
"147.32.84.165",4852,"205.188.190.2",25,3,186,3,186,0,0,96224.050524,8.92899899999611,166.6480195597119,0
"147.32.84.165",4855,"24.40.8.248",25,3,186,3,186,0,0,96224.073278,8.906295000007958,167.0728400528694,0
"147.32.84.165",4858,"205.188.190.2",25,3,186,3,186,0,0,96224.096237,8.883388000002014,167.50365963973007,0
"147.32.84.165",4861,"205.178.149.7",25,3,186,3,186,0,0,96224.096267,8.883405999993556,167.50332023562578,0
"147.32.84.165",4727,"61.17.216.4",6667,10,1141,5,583,5,558,96224.378348,1.0333689999970375,4513.392602268281,4319.850895481476
"147.32.84.165",4863,"98.137.54.237",25,3,186,3,186,0,0,96224.562985,8.917926000009174,166.8549391415077,0
"147.32.84.165",4889,"213.4.149.227",25,3,186,3,186,0,0,96224.563017,8.918015000002924,166.85327396281707,0
"147.32.84.165",4758,"46.4.36.120",443,5,306,3,186,2,120,96230.872555,6.553550000011455,227.0525135228081,146.48549259536006
"147.32.84.165",4749,"217.163.21.39",80,11,4298,6,1789,5,2509,96231.273624,0.29343299999891315,48774.33690161983,68404.03090338968
"147.32.84.165",4901,"76.162.254.120",25,3,186,3,186,0,0,96231.319578,8.983141000004252,165.64362064441553,0
"147.32.84.165",4771,"216.157.130.15",25,3,186,3,186,0,0,96231.674584,9.029474000009941,164.79365243184284,0
"147.32.84.165",4918,"207.115.20.22",25,3,186,3,186,0,0,96231.775311,9.028781999993953,164.8062828409188,0
"147.32.84.165",4922,"205.188.190.2",25,3,186,3,186,0,0,96233.681424,9.028873000002932,164.80462179493685,0
"147.32.84.165",4924,"98.139.175.224",25,3,186,3,186,0,0,96233.681534,9.028890000001411,164.80431149341365,0
"147.32.84.165",4745,"184.82.148.43",80,10,1927,5,987,5,940,96237.426341,0.3230920000059996,24438.85951943526,23275.104304224056
"147.32.84.165",4973,"98.137.54.237",25,3,186,3,186,0,0,96237.532922,8.9894820000045,165.52677896226447,0
"147.32.84.165",4749,"94.137.182.140",6667,2,124,2,124,0,0,96237.532981,2.9711820000084117,333.8738589548508,0
"147.32.84.165",4603,"184.82.148.44",80,10,1513,5,596,5,917,96238.295988,0.3048689999995986,15639.504180504668,24062.794183763053
"147.32.84.165",4978,"74.6.136.244",25,3,186,3,186,0,0,96238.396567,9.028867999993963,164.80471306048497,0
"147.32.84.165",4827,"212.117.171.138",65500,15,921,8,486,7,435,96245.017502,194.439062999998,19.995981980226063,17.89763819217765
"147.32.84.165",4745,"46.4.36.120",443,6,366,3,186,3,180,96245.017608,1.031503000005614,1442.5551840294227,1396.0211458349252
"147.32.84.165",4758,"217.163.21.36",80,13,6074,6,749,7,5325,96245.017642,0.18714499998895917,32017.953994782147,227630.98133807068
"147.32.84.165",4982,"66.94.238.147",25,3,186,3,186,0,0,96245.040141,9.006964000000153,165.20550098789946,0
"147.32.84.165",4986,"64.12.90.97",25,3,186,3,186,0,0,96245.063556,8.983671000009053,165.63384834534796,0
"147.32.84.165",4844,"217.163.21.37",80,10,1446,5,698,5,748,96245.519495,0.14027299999725074,39808.08851389393,42659.670785662835
"147.32.84.165",1029,"193.180.251.37",25,3,186,3,186,0,0,96245.566046,8.983017999998992,165.6458887202683,0
"147.32.84.165",4855,"217.163.21.39",80,11,4314,6,1787,5,2527,96246.049391,0.2651260000129696,53921.53164646492,76250.53747656231
"147.32.84.165",1031,"98.137.54.237",25,3,186,3,186,0,0,96246.095883,8.954807000001892,166.16773538499328,0
"147.32.84.165",4863,"31.192.109.161",80,10,1273,5,540,5,733,96252.341759,0.25239500000316184,17116.02844725879,23233.423799704986
"147.32.84.165",4745,"46.4.36.120",443,6,366,3,186,3,180,96252.422163,1.0508260000060545,1416.0289143887062,1370.3505623116512
"147.32.84.165",4858,"184.82.148.43",80,10,1923,5,983,5,940,96252.743423,0.3266659999935655,24073.518517858916,23020.455144239455
"147.32.84.165",1098,"98.139.175.225",25,3,186,3,186,0,0,96252.843329,8.928700000004028,166.6536001880821,0
"147.32.84.165",1172,"205.178.149.7",25,3,186,3,186,0,0,96252.851754,8.920368999999482,166.8092429808774,0
"147.32.84.165",4771,"184.82.148.44",80,10,1514,5,596,5,918,96253.473221,0.3217900000017835,14817.116753079878,22822.337549206924
"147.32.84.165",1202,"209.85.225.27",25,3,186,3,186,0,0,96253.579912,8.894776999994065,167.2891855524869,0
"147.32.84.165",4918,"46.4.36.120",443,6,366,3,186,3,180,96254.749782,1.0304159999941476,1444.0769553349826,1397.4938277435315
"147.32.84.165",4901,"217.163.21.37",80,13,6081,6,750,7,5331,96255.780428,0.1869250000017928,32098.43520097608,228155.677408538
"147.32.84.165",1208,"64.12.138.161",25,3,186,3,186,0,0,96255.826364,8.855874000000767,168.0240708031608,0
"147.32.84.165",4922,"217.163.21.37",80,10,1451,5,701,5,750,96256.154232,0.13919200000236742,40289.67181953429,43105.92562717649
"147.32.84.165",1254,"74.208.5.90",25,3,186,3,186,0,0,96256.200092,8.883761000004597,167.49662671015463,0
"147.32.84.165",4924,"61.26.131.206",6667,2,124,2,124,0,0,96259.36445,3.00966999999946,329.60424232562974,0
"147.32.84.165",4918,"46.4.36.120",443,6,366,3,186,3,180,96265.98645,1.030838999999105,1443.484385050713,1396.9203726297224
"147.32.84.165",4901,"217.163.21.39",80,11,4358,6,1809,5,2549,96265.986583,0.2322920000005979,62300.89714653432,87786.06236955001
"147.32.84.165",1261,"98.139.175.225",25,3,186,3,186,0,0,96266.032446,8.982841999997618,165.64913420500935,0
"147.32.84.165",4973,"184.82.155.107",80,10,1888,5,981,5,907,96266.032505,0.3271539999986999,23988.702568304798,22179.15721656723
"147.32.84.165",1273,"205.188.103.2",25,3,186,3,186,0,0,96266.140147,8.976221000004443,165.77131957861369,0
"147.32.84.165",4901,"184.82.155.108",80,10,1303,5,583,5,720,96266.488122,0.3418320000055246,13644.129279659663,16850.382643833545
"147.32.84.165",1274,"64.12.90.33",25,3,186,3,186,0,0,96266.60108,9.015875000011874,165.04221719999893,0
"147.32.84.165",4982,"93.184.220.20",80,13,6575,8,756,5,5819,96266.989791,6.822776000000886,886.4427030873086,6823.029218604562
"147.32.84.165",1324,"98.137.54.237",25,3,186,3,186,0,0,96267.006268,9.012000000002445,165.11318242339064,0
"147.32.84.165",1357,"204.232.236.158",25,3,186,3,186,0,0,96267.017548,9.000813999999082,165.31838120420574,0
"147.32.84.165",4901,"46.4.36.120",443,6,366,3,186,3,180,96273.810989,1.0340359999972861,1439.0214654073025,1392.601418136099
"147.32.84.165",4986,"195.113.232.98",80,11,2374,7,1220,4,1154,96273.811131,71.37574000000313,136.74113921620386,129.34366775040922
"147.32.84.165",1364,"74.208.5.90",25,3,186,3,186,0,0,96273.811185,9.02981799999543,164.78737445214875,0
"147.32.84.165",1029,"63.251.249.49",80,9,1241,5,613,4,628,96273.811234,0.5392100000026403,9094.786817707363,9317.334619119452
"147.32.84.165",1397,"205.188.146.194",25,3,186,3,186,0,0,96273.989371,8.952357999995002,166.21319209987254,0
"147.32.84.165",1031,"68.67.185.217",80,10,1599,6,775,4,824,96274.513824,12.651207000002614,490.07181686290636,521.0570027032708
"147.32.84.165",1465,"208.65.145.3",25,3,186,3,186,0,0,96274.543224,9.000045000007958,165.3325066706538,0
"147.32.84.165",4982,"184.82.147.251",80,10,1901,5,986,5,915,96274.845271,0.34131400000478607,23110.68400326207,21446.527244406487
"147.32.84.165",1484,"209.85.143.27",25,3,186,3,186,0,0,96274.958415,8.986235999997007,165.5865703950459,0
"147.32.84.165",1029,"68.67.185.216",80,10,2218,6,977,4,1241,96276.720774,10.444050000005518,748.3686883915599,950.5890913960345
"147.32.84.165",1529,"209.240.204.25",25,3,186,3,186,0,0,96276.745483,9.005171999990125,165.23837634657414,0
"147.32.84.165",4982,"46.4.36.120",443,6,366,3,186,3,180,96277.122173,1.0305539999972098,1443.8835810680748,1397.3066913562016
"147.32.84.165",1202,"184.82.147.252",80,10,1310,5,588,5,722,96277.222353,0.3262189999950351,14419.760958348816,17705.89695906096
"147.32.84.165",1542,"98.139.175.225",25,3,186,3,186,0,0,96277.330003,9.023311000011745,164.90620793166312,0
"147.32.84.165",1208,"217.163.21.34",80,14,5890,7,788,7,5102,96278.152968,0.18920100000104867,33319.06279546651,215728.2466782616
"147.32.84.165",1580,"98.137.54.237",25,3,186,3,186,0,0,96278.198836,8.957357999999658,166.12041184465963,0
"147.32.84.165",1254,"217.163.21.39",80,13,6721,6,1710,7,5011,96278.198898,0.1876429999974789,72904.3982465842,213639.73076820667
"147.32.84.165",1592,"64.12.90.66",25,3,186,3,186,0,0,96278.245358,9.011488000003737,165.12256355436338,0
"147.32.84.165",1208,"74.125.232.205",80,8,1476,5,970,3,506,96287.156332,64.84690899999987,119.66645935275058,62.423946837620406
"147.32.84.165",1593,"66.96.142.51",25,3,186,3,186,0,0,96287.164521,8.923187000007601,166.75656354604385,0
"147.32.84.165",1273,"180.241.97.224",6667,3,186,3,186,0,0,96287.658428,8.930363999999827,166.62254752438184,0
"147.32.84.165",1261,"46.4.36.120",443,6,366,3,186,3,180,96288.06006,1.030111999993096,1444.5031220002998,1397.9062470970641
"147.32.84.165",1254,"46.137.9.143",80,8,1435,5,733,3,702,96288.060125,0.13558699999703094,43248.98404809022,41419.90013882583
"147.32.84.165",1621,"205.188.146.194",25,3,186,3,186,0,0,96288.101845,8.888508999996702,167.40715456333027,0
"147.32.84.165",1705,"74.125.43.27",25,3,186,3,186,0,0,96288.101876,8.888575999997556,167.40589268746862,0
"147.32.84.165",1718,"65.54.188.126",25,3,186,3,186,0,0,96289.090402,8.903550999995787,167.12433050596377,0
"147.32.84.165",1031,"46.4.36.120",443,6,366,3,186,3,180,96294.882803,1.031849000006332,1442.07146587424,1395.5530314912
"147.32.84.165",1729,"216.32.181.178",25,3,186,3,186,0,0,96295.486321,9.028229000003194,164.81637760844055,0
"147.32.84.165",1765,"98.137.54.237",25,3,186,3,186,0,0,96295.887228,9.028776999999536,164.80637410804104,0
"147.32.84.165",1782,"209.85.143.27",25,3,186,3,186,0,0,96295.914892,9.00123700000404,165.31061230798971,0
"147.32.84.165",1465,"46.4.36.120",443,5,306,3,186,2,120,96297.692492,6.554187000001548,227.03044633905756,146.47125570261778
"147.32.84.165",1789,"64.12.138.161",25,3,186,3,186,0,0,96298.294213,9.029236999995192,164.79797794661857,0
"147.32.84.165",1273,"184.82.148.43",80,10,1935,5,995,5,940,96299.197024,0.34108800000103656,23337.08603051356,22047.096350434924
"147.32.84.165",1800,"12.102.252.75",25,3,186,3,186,0,0,96299.309548,9.016669999997248,165.02766542420363,0
"147.32.84.165",1529,"184.82.148.44",80,10,1513,5,596,5,917,96304.246883,0.34037600000738166,14008.038169249881,21552.635908057284
"147.32.84.165",1808,"205.188.103.2",25,3,186,3,186,0,0,96304.359652,8.983732000007876,165.6327236830635,0
"147.32.84.165",1465,"46.4.36.120",443,6,366,3,186,3,180,96307.82467,1.0363930000021355,1435.7487941320849,1389.4343169020176
"147.32.84.165",1823,"98.137.54.237",25,3,186,3,186,0,0,96308.125961,9.029433000003337,164.7944007114788,0
"147.32.84.165",1831,"98.139.175.225",25,3,186,3,186,0,0,96308.126064,9.029452000002493,164.79405394697145,0
"147.32.84.165",1836,"209.85.143.27",25,3,186,3,186,0,0,96308.861316,8.99667400000908,165.39445577315553,0
"147.32.84.165",1837,"64.236.55.17",25,3,186,3,186,0,0,96308.861377,8.996736000000965,165.39331597590953,0
"147.32.84.165",1839,"64.12.90.66",25,3,186,3,186,0,0,96309.02912,9.02937999999267,164.79536800989746,0
"147.32.84.165",1465,"46.4.36.120",443,6,366,3,186,3,180,96310.032994,1.0360750000108965,1436.1894650332752,1389.8607726128469
"147.32.84.165",1840,"212.94.223.189",25,3,186,3,186,0,0,96311.069199,8.995876999993925,165.40910908419545,0
"147.32.84.165",1465,"46.4.36.120",443,5,306,3,186,2,120,96316.553716,6.4549540000007255,230.5206202863464,148.7229808299009
"147.32.84.165",1871,"208.65.145.2",25,3,186,3,186,0,0,96316.954945,8.929673999999068,166.63542252496063,0
"147.32.84.165",1894,"64.12.90.34",25,3,186,3,186,0,0,96316.955078,8.929661999995005,166.63564645569252,0
"147.32.84.165",1765,"114.59.51.188",6667,3,186,3,186,0,0,96319.362577,8.929696999999578,166.6349933262092,0
"147.32.84.165",1901,"165.21.74.116",25,3,186,3,186,0,0,96320.365846,8.929732999997213,166.63432154135677,0
"147.32.84.165",1907,"66.94.237.64",25,3,186,3,186,0,0,96323.008921,8.996375999995507,165.39993437365703,0
"147.32.84.165",1800,"46.4.36.120",443,6,366,3,186,3,180,96325.282744,1.031064000009792,1443.1693861737667,1396.615535006871
"147.32.84.165",1789,"184.82.148.43",80,10,1927,5,987,5,940,96326.314043,0.3253770000010263,24267.234623145134,23111.652022042985
"147.32.84.165",1938,"98.137.54.237",25,3,186,3,186,0,0,96326.421681,8.994115999987116,165.44149530672402,0
"147.32.84.165",1800,"46.4.36.120",443,6,366,3,186,3,180,96329.094796,1.0308609999920009,1443.4535791067335,1396.8905604258712
"147.32.84.165",1949,"64.71.138.81",25,3,186,3,186,0,0,96329.797021,9.02992099999392,164.78549480122828,0
"147.32.84.165",1956,"205.188.103.2",25,3,186,3,186,0,0,96329.997654,9.029476999989129,164.79359768032984,0
"147.32.84.165",1961,"209.85.143.27",25,3,186,3,186,0,0,96330.125887,9.001562999997986,165.3046254300873,0
"147.32.84.165",1823,"46.4.36.120",443,6,366,3,186,3,180,96332.005437,1.0359239999961574,1436.3988091843798,1390.0633637268193
"147.32.84.165",1966,"195.50.106.142",25,3,186,3,186,0,0,96333.041597,8.995576000001165,165.4146438204521,0
"147.32.84.165",1836,"46.4.36.120",443,6,366,3,186,3,180,96337.92403,1.0315669999981765,1442.465685702073,1395.9345345503932
"147.32.84.165",1839,"184.82.148.43",80,10,1915,5,983,5,932,96337.924168,0.3407770000048913,23076.674775255153,21879.41087541994
"147.32.84.165",1981,"98.139.175.225",25,3,186,3,186,0,0,96338.036694,9.01627500000177,165.03489523109133,0
"147.32.84.165",1840,"184.82.148.44",80,10,1506,5,591,5,915,96338.927979,0.32186900000669993,14689.205856735452,22742.171504082806
"147.32.84.165",1986,"98.137.54.237",25,3,186,3,186,0,0,96338.955838,9.000420000011218,165.32561813761419,0
"147.32.84.165",1987,"98.139.214.154",25,3,186,3,186,0,0,96338.955869,9.00043800000276,165.32528750262418,0
"147.32.84.165",1992,"216.32.180.22",25,3,186,3,186,0,0,96339.034554,9.021569999997155,164.93803185038405,0
"147.32.84.165",1894,"189.242.185.74",6667,2,124,2,124,0,0,96341.334606,3.009479000000283,329.62516103282553,0
"147.32.84.165",1836,"46.4.36.120",443,6,366,3,186,3,180,96344.04364,1.0306879999989178,1443.6958614067132,1397.1250271677868
"147.32.84.165",1871,"70.32.97.26",80,8,2627,5,813,3,1814,96345.074578,0.35307100000500213,18421.22405948904,41102.214568158815
"147.32.84.165",1993,"66.94.238.147",25,3,186,3,186,0,0,96345.186717,8.888762000002316,167.4023896690689,0
"147.32.84.165",1836,"46.4.36.120",443,6,366,3,186,3,180,96347.454005,1.0306999999884283,1443.6790530869368,1397.1087610518744
"147.32.84.165",1907,"195.113.232.82",80,8,1404,5,721,3,683,96348.484941,67.19801399999415,85.83587008985864,81.31192686736956
"147.32.84.165",1994,"64.12.90.34",25,3,186,3,186,0,0,96348.485796,8.899834000010742,167.1941296880598,0
"147.32.84.165",1836,"46.4.36.120",443,6,366,3,186,3,180,96350.865178,1.0309830000041984,1443.2827699331033,1396.7252612255838
"147.32.84.165",1871,"184.82.148.43",80,10,1923,5,983,5,940,96351.065779,0.3447230000019772,22812.519036893085,21814.616373020854
"147.32.84.165",2029,"207.115.20.23",25,3,186,3,186,0,0,96351.166104,8.92827099999704,166.66160782983553,0
"147.32.84.165",2034,"98.139.175.225",25,3,186,3,186,0,0,96351.179741,8.914766000001691,166.91408389179455,0
"147.32.84.165",2036,"12.41.25.137",25,3,186,3,186,0,0,96351.1798,8.91475700000592,166.91425240183347,0
"147.32.84.165",1894,"184.82.148.44",80,10,1514,5,596,5,918,96351.896483,0.32300399999076035,14761.427103492188,22736.56053860038
"147.32.84.165",2040,"98.137.54.237",25,3,186,3,186,0,0,96352.003085,8.893874999994296,167.306151705635,0
"147.32.84.165",1961,"46.4.36.120",443,6,366,3,186,3,180,96353.974573,1.0308050000021467,1443.531996834417,1396.9664485494357
"147.32.84.165",1949,"217.163.21.40",80,14,6141,7,810,7,5331,96355.005584,0.19044400000711903,34025.75035053753,223939.8458255748
"147.32.84.165",2048,"124.108.110.37",25,3,186,3,186,0,0,96355.051631,8.955056999999215,166.1630964493169,0
"147.32.84.165",1966,"46.4.36.120",443,6,366,3,186,3,180,96358.991211,1.0313480000040727,1442.7719838445646,1396.2309521076431
"147.32.84.165",1836,"217.163.21.40",80,10,1451,5,701,5,750,96359.894066,0.13914100000692997,40304.43937962708,43121.725441826406
"147.32.84.165",2050,"209.85.143.27",25,3,186,3,186,0,0,96359.939975,8.984180999992532,165.62444590121646,0
"147.32.84.165",1961,"184.82.148.43",80,10,1923,5,983,5,940,96359.994998,0.3404980000050273,23095.583527315557,22085.298591736137
"147.32.84.165",2053,"72.167.238.201",25,3,186,3,186,0,0,96359.995193,9.029208000007202,164.79850724435778,0
"147.32.84.165",1981,"217.163.21.37",80,13,4473,7,1878,6,2595,96360.022802,0.2990259999933187,50243.12267272976,69425.40113723841
"147.32.84.165",2063,"64.12.138.161",25,3,186,3,186,0,0,96360.068635,8.955885999996099,166.14771559180724,0
"147.32.84.165",2077,"65.55.37.120",25,3,186,3,186,0,0,96360.107317,9.017460000002757,165.01320771032476,0
"147.32.84.165",1986,"201.249.127.77",6667,2,124,2,124,0,0,96366.11439,3.010261999996146,329.53942215038757,0
"147.32.84.165",1992,"46.4.36.120",443,6,366,3,186,3,180,96369.424989,1.0311669999937294,1443.0252325850697,1396.4760315339386
"147.32.84.165",1836,"184.82.148.44",80,10,1513,5,596,5,917,96370.45637,0.32083399999828544,14861.267820821611,22865.407033042648
"147.32.84.165",2078,"64.12.138.161",25,3,186,3,186,0,0,96370.562608,8.994728000005125,165.4302386908367,0
"147.32.84.165",2082,"98.137.54.237",25,3,186,3,186,0,0,96370.562666,8.994791999997688,165.42906161703155,0
"147.32.84.165",2136,"209.85.143.27",25,3,186,3,186,0,0,96370.562718,8.99478999999701,165.42909840035117,0
"147.32.84.165",2139,"213.123.26.151",25,3,186,3,186,0,0,96370.56277,8.994781999994302,165.4292455337931,0
"147.32.84.165",2198,"64.12.138.161",25,3,186,3,186,0,0,96372.134285,9.029538000002503,164.7924843994884,0
"147.32.84.165",2224,"207.115.20.23",25,3,186,3,186,0,0,96372.134414,9.0295080000069,164.7930319125763,0
"147.32.84.165",2227,"200.41.237.69",25,3,186,3,186,0,0,96372.134466,9.029480999990483,164.7935246778379,0
"147.32.84.165",1986,"46.4.36.120",443,6,366,3,186,3,180,96372.936886,1.0304790000081994,1443.988669335484,1397.4083896795007
"147.32.84.165",2251,"65.54.188.72",25,3,186,3,186,0,0,96373.96758,9.001780999999028,165.30062217689596,0
"147.32.84.165",1992,"94.100.176.20",25,3,186,3,186,0,0,96376.046473,8.929533000002266,166.63805374812125,0
"147.32.84.165",2275,"98.137.54.237",25,3,186,3,186,0,0,96380.962157,8.93029899999965,166.62376030187323,0
"147.32.84.165",2034,"46.4.36.120",443,6,366,3,186,3,180,96381.063088,1.0307360000006156,1443.6286304146856,1397.0599649174376
"147.32.84.165",2286,"94.126.18.110",25,3,186,3,186,0,0,96381.063222,8.929870000007213,166.63176507595273,0
"147.32.84.165",2287,"65.54.188.109",25,3,186,3,186,0,0,96381.063281,8.929933000006713,166.6305895014981,0
"147.32.84.165",2289,"207.115.20.23",25,3,186,3,186,0,0,96381.163977,8.929579000003287,166.63719532572054,0
"147.32.84.165",2294,"64.12.90.66",25,3,186,3,186,0,0,96381.164004,8.929672999991453,166.63544118596775,0
"147.32.84.165",2296,"200.155.87.21",25,3,186,3,186,0,0,96382.094078,8.901733000006061,167.15846229031885,0
"147.32.84.165",2034,"46.4.36.120",443,6,366,3,186,3,180,96391.497508,1.0308450000011362,1443.4759832936668,1396.912241897097
"147.32.84.165",2309,"209.85.143.27",25,3,186,3,186,0,0,96392.528595,9.002430000007735,165.28870538273793,0
"147.32.84.165",2350,"205.188.146.194",25,3,186,3,186,0,0,96393.102679,9.029872999992222,164.7863707497638,0
"147.32.84.165",2351,"199.239.254.18",25,3,186,3,186,0,0,96393.102787,9.029886999996961,164.78611526373484,0
"147.32.84.165",2139,"46.4.36.120",443,6,366,3,186,3,180,96394.908781,1.0312419999972917,1442.9202844762992,1396.3744688480315
"147.32.84.165",2388,"205.188.59.193",25,3,186,3,186,0,0,96395.940263,9.001436999998987,165.30693932537298,0
"147.32.84.165",2227,"46.4.36.120",443,6,366,3,186,3,180,96397.016185,1.0307659999962198,1443.5866142319956,1397.0193040954796
"147.32.84.165",2429,"98.137.54.237",25,3,186,3,186,0,0,96398.047193,9.00117199998931,165.31180606278463,0
"147.32.84.165",2251,"74.125.93.27",25,3,186,3,186,0,0,96398.047253,9.001214000003529,165.3110347114752,0
"147.32.84.165",2441,"65.54.188.126",25,3,186,3,186,0,0,96401.932008,9.030610000001616,164.7729223164032,0
"147.32.84.165",2459,"209.85.143.27",25,3,186,3,186,0,0,96402.032307,9.030876999997417,164.76805076632374,0
"147.32.84.165",2465,"68.1.17.3",25,3,186,3,186,0,0,96402.032433,9.030872000003,164.76814199110623,0
"147.32.84.165",2474,"205.188.146.194",25,3,186,3,186,0,0,96402.032493,9.030860999992,164.7683426864081,0
"147.32.84.165",2477,"67.69.240.18",25,3,186,3,186,0,0,96402.032559,9.030838999999105,164.7687440779475,0
"147.32.84.165",2509,"98.137.54.237",25,3,186,3,186,0,0,96402.132738,9.030836000005365,164.7687988132124,0
"147.32.84.165",2514,"80.12.204.241",25,3,186,3,186,0,0,96403.035107,9.031008999998448,164.7656424658923,0
"147.32.84.165",2286,"46.4.36.120",443,6,366,3,186,3,180,96413.571329,1.0302349999983562,1444.330662423985,1397.7393507328886
"147.32.84.165",2517,"66.94.237.64",25,3,186,3,186,0,0,96414.17311,8.929101000001538,166.6461158855459,0
"147.32.84.165",2519,"205.188.103.2",25,3,186,3,186,0,0,96414.173242,8.929017000002204,166.6476836139558,0
"147.32.84.165",2535,"207.69.189.219",25,3,186,3,186,0,0,96414.60172,9.002244999996037,165.29210213681753,0
"147.32.84.165",2286,"46.4.36.120",443,6,366,3,186,3,180,96416.882339,1.0332930000004126,1440.0562086449884,1393.6027825596661
"147.32.84.165",2350,"184.82.148.43",80,10,1925,5,987,5,938,96417.915898,0.32234599998628255,24495.417968071622,23279.333388096435
"147.32.84.165",2536,"209.85.143.27",25,3,186,3,186,0,0,96418.022535,8.993708000009065,165.44900056778587,0
"147.32.84.165",2286,"46.4.36.120",443,6,366,3,186,3,180,96418.98807,1.0306979999877512,1443.681854449784,1397.1114720481778
"147.32.84.165",2388,"184.82.148.44",80,10,1512,5,594,5,918,96420.018898,0.33944500000507105,13999.322423158417,21635.316472153918
"147.32.84.165",2537,"98.139.175.225",25,3,186,3,186,0,0,96420.131345,8.991662999993423,165.48662911422375,0
"147.32.84.165",2251,"74.125.39.27",25,3,186,3,186,0,0,96422.901834,9.029954999990878,164.7848743433941,0
"147.32.84.165",2429,"217.163.21.36",80,14,6141,7,810,7,5331,96423.002192,0.19702399999368936,32889.39418653338,216460.93877581414
"147.32.84.165",2538,"205.188.103.2",25,3,186,3,186,0,0,96423.002328,9.029725000000326,164.7890716494629,0
"147.32.84.165",2286,"46.4.36.120",443,6,366,3,186,3,180,96423.002383,1.0304420000029495,1444.0405185306313,1397.4585663199657
"147.32.84.165",2554,"72.52.248.24",25,3,186,3,186,0,0,96423.048059,8.984102000002167,165.62590228824664,0
"147.32.84.165",2557,"98.137.54.237",25,3,186,3,186,0,0,96423.102317,9.030507999996189,164.77478343417977,0
"147.32.84.165",2441,"217.163.21.37",80,10,1451,5,701,5,750,96424.005357,0.1469399999914458,38165.23751413143,40832.9930607683
"147.32.84.165",2585,"65.61.209.25",25,3,186,3,186,0,0,96424.033077,9.002229999998235,165.29237755537147,0
"147.32.84.165",2589,"125.5.96.59",25,3,186,3,186,0,0,96424.051326,8.98410299999523,165.62588385293336,0
"147.32.84.165",2441,"86.126.40.27",6667,2,124,2,124,0,0,96435.142055,3.0093379999889294,329.6406053436501,0
"147.32.84.165",2465,"46.4.36.120",443,6,366,3,186,3,180,96435.142186,1.0358300000079907,1436.529160179297,1390.1895098509324
"147.32.84.165",2459,"217.163.21.37",80,13,4481,7,1878,6,2603,96435.643814,0.2546580000052927,58996.77214023415,81772.4163370764
"147.32.84.165",2592,"209.85.143.27",25,3,186,3,186,0,0,96435.689734,8.983848999996553,165.630566586835,0
"147.32.84.165",2477,"184.82.148.43",80,10,1921,5,983,5,938,96435.689805,0.32414100000460166,24261.046889743535,23150.419107405327
"147.32.84.165",2597,"98.139.175.225",25,3,186,3,186,0,0,96435.796592,8.977045999999973,165.7560850195047,0
"147.32.84.165",2599,"64.12.90.65",25,3,186,3,186,0,0,96435.796653,8.97710800000641,165.75494023230394,0
"147.32.84.165",2517,"184.82.148.44",80,10,1511,5,594,5,917,96436.178292,0.3230909999983851,14707.930583098112,22705.67734798143
"147.32.84.165",2600,"67.69.240.20",25,3,186,3,186,0,0,96436.285034,8.990531999996165,165.5074471678244,0
"147.32.84.165",2477,"46.4.36.120",443,5,306,3,186,2,120,96439.054803,1.0036909999907948,1482.5279892054896,956.4696704551545
"147.32.84.165",2601,"98.137.54.237",25,3,186,3,186,0,0,96441.162393,8.929441000000224,166.63977061945565,0
"147.32.84.165",2517,"212.117.171.138",65500,31,9839,16,5319,15,4520,96441.162521,96.3105649999925,441.8206870658823,375.4520596987757
"147.32.84.165",2536,"217.163.21.35",80,14,6137,7,809,7,5328,96441.185437,0.19027900000219233,34013.21217751529,224007.90418022432
"147.32.84.165",2605,"205.188.146.194",25,3,186,3,186,0,0,96441.232344,8.859616000001552,167.95310315929487,0
"147.32.84.165",2459,"217.163.21.35",80,10,1448,5,699,5,749,96443.971057,0.1405220000015106,39794.48057912559,42641.00994816176
"147.32.84.165",2613,"205.188.103.2",25,3,186,3,186,0,0,96444.016982,8.883503000004566,167.5014912472293,0
"147.32.84.165",2536,"66.111.4.73",25,3,186,3,186,0,0,96444.07155,8.929462000000058,166.6393787218077,0
"147.32.84.165",2441,"184.82.148.43",80,10,1921,5,983,5,938,96444.172168,0.32396300000254996,24274.377011998597,23163.13900025909
"147.32.84.165",2615,"98.139.175.225",25,3,186,3,186,0,0,96444.278942,8.922405999997864,166.7711601557199,0
"147.32.84.165",2251,"217.163.21.37",80,13,4478,7,1876,6,2602,96445.075649,0.26398099999642,56852.57651195932,78854.15995955125
"147.32.84.165",2617,"64.12.139.193",25,3,186,3,186,0,0,96445.075783,8.928356000003987,166.66002117291643,0
"147.32.84.165",2622,"207.115.11.16",25,3,186,3,186,0,0,96445.121513,8.882747999989078,167.51572824106117,0
"147.32.84.165",2628,"207.115.20.23",25,3,186,3,186,0,0,96451.797852,9.030371999993804,164.77726498986098,0
"147.32.84.165",2633,"208.65.145.13",25,3,186,3,186,0,0,96451.997886,9.032436000008602,164.73961177234835,0
"147.32.84.165",2251,"186.90.182.143",6667,2,124,2,124,0,0,96456.713073,3.0105009999970207,329.5132604177782,0
"147.32.84.165",2477,"46.4.36.120",443,4,246,3,186,1,60,96457.215922,9.06427899999835,164.16087810186235,52.955121968342695
"147.32.84.165",2441,"184.82.148.43",80,10,1917,5,979,5,938,96462.13311,0.32348600000841543,24211.248708742423,23197.294472727674
"147.32.84.165",2654,"209.85.143.27",25,3,186,3,186,0,0,96462.239971,9.025536999994074,164.86553653272674,0
"147.32.84.165",2599,"184.82.148.44",80,10,1511,5,594,5,917,96464.941713,0.3268930000049295,14536.866803291416,22441.594038077827
"147.32.84.165",2655,"65.55.92.152",25,3,186,3,186,0,0,96465.042187,9.03213200000755,164.74515651440393,0
"147.32.84.165",2251,"216.157.130.15",25,3,186,3,186,0,0,96465.049539,9.024902999997721,164.87711834690919,0
"147.32.84.165",2441,"217.163.21.35",80,14,6134,7,809,7,5325,96465.24307,0.18923499999800697,34200.86136321591,225116.9181200553
"147.32.84.165",2665,"213.165.64.100",25,3,186,3,186,0,0,96465.289298,8.985166999991634,165.60627086857545,0
"147.32.84.165",2710,"205.188.103.1",25,3,186,3,186,0,0,96466.046803,9.03013299999293,164.78162614007624,0
"147.32.84.165",2713,"65.55.88.22",25,3,186,3,186,0,0,96466.046901,9.030162000010023,164.78109695023727,0
"147.32.84.165",2605,"217.163.21.36",80,10,1446,5,698,5,748,96466.280445,0.13943599999765866,40047.04667441524,42915.746292926364
"147.32.84.165",2715,"205.188.146.194",25,3,186,3,186,0,0,96466.326445,8.951191000000108,166.23486193066174,0
"147.32.84.165",2441,"46.4.36.120",443,4,246,3,186,1,60,96472.871634,6.419087000002037,231.8086668710874,74.776989313254
"147.32.84.165",2613,"217.163.21.37",80,13,4470,7,1876,6,2594,96472.871769,0.23448600000119768,64003.82112332226,88499.95308843174
"147.32.84.165",2721,"64.12.90.34",25,3,186,3,186,0,0,96472.91763,8.88110100000631,167.54679402913476,0
"147.32.84.165",2536,"184.82.148.43",80,10,1921,5,983,5,938,96473.071002,0.3584930000070017,21936.272116460877,20932.06840817935
"147.32.84.165",2722,"82.137.248.20",25,3,186,3,186,0,0,96473.189538,8.910301999989315,166.99770669970383,0
"147.32.84.165",2605,"114.58.187.40",6667,1,62,1,62,0,0,96483.205583,0,0,0
"147.32.84.165",2615,"184.82.148.44",80,10,1512,5,594,5,918,96486.016137,0.3036430000065593,15649.957350893474,24186.297724108095
"147.32.84.165",2724,"98.139.175.225",25,3,186,3,186,0,0,96486.016272,9.028862999999546,164.8048043258686,0
"147.32.84.165",2628,"184.82.148.43",80,10,1931,5,991,5,940,96486.11661,0.3402700000006007,23299.144796737895,22100.096981769548
"147.32.84.165",2755,"98.139.175.224",25,3,186,3,186,0,0,96486.217083,9.028707999998005,164.80763360608503,0
"147.32.84.165",2799,"65.101.196.37",25,3,186,3,186,0,0,96486.229361,9.016540999989957,165.03002648151408,0
"147.32.84.165",2251,"217.163.21.36",80,14,6141,7,810,7,5331,96487.019353,0.18877000000793487,34327.48847659912,225925.72971450607
"147.32.84.165",2806,"98.137.54.237",25,3,186,3,186,0,0,96487.019446,9.028578999990714,164.80998837154002,0
"147.32.84.165",2605,"184.82.148.44",80,10,1514,5,596,5,918,96487.0652,0.3230480000056559,14759.416557033388,22733.463757309815
"147.32.84.165",2816,"209.85.143.27",25,3,186,3,186,0,0,96487.171968,8.976460000005318,165.76690588484976,0
"147.32.84.165",2654,"217.163.21.36",80,10,1451,5,701,5,750,96487.220661,0.1397960000031162,40115.59701189584,42919.68296565176
"147.32.84.165",2817,"98.139.175.225",25,3,186,3,186,0,0,96487.266421,8.982673000005889,165.65225072748663,0
"147.32.84.165",2821,"68.1.17.3",25,3,186,3,186,0,0,96487.266482,8.98271099998965,165.65154996099892,0
"147.32.84.165",2655,"217.163.21.36",80,14,6138,7,810,7,5328,96491.333189,0.18973700000788085,34152.53745832836,224647.80194811546
"147.32.84.165",2837,"205.188.103.1",25,3,186,3,186,0,0,96491.379123,8.984101999987615,165.62590228851488,0
"147.32.84.165",2615,"31.192.109.161",80,10,1273,5,540,5,733,96493.841527,0.24215099999855738,17840.108031871587,24216.294791410874
"147.32.84.165",2605,"46.4.36.120",443,6,366,3,186,3,180,96493.919094,1.0528570000024047,1413.2973423709027,1367.7071055202284
"147.32.84.165",2665,"217.163.21.37",80,11,3448,6,1818,5,1630,96493.94146,0.24630299999262206,59049.21986510786,52942.9199010593
"147.32.84.165",2865,"210.172.144.10",25,3,186,3,186,0,0,96493.987636,8.983947999993688,165.6287413953248,0
"147.32.84.165",2872,"205.188.146.194",25,3,186,3,186,0,0,96494.142728,9.02901600000041,164.80201164777338,0
"147.32.84.165",2655,"210.211.247.235",6667,3,186,3,186,0,0,96494.972194,9.0024459999986,165.2884116161576,0
"147.32.84.165",2251,"46.4.36.120",443,6,366,3,186,3,180,96507.084605,0.9298580000031507,1600.2443383774278,1548.6235532684784
"147.32.84.165",2441,"217.163.21.37",80,10,1449,5,700,5,749,96507.285117,0.14087399998970795,39751.83497600073,42534.46342432079
"147.32.84.165",2883,"212.82.111.207",25,3,186,3,186,0,0,96507.285222,8.931514999989304,166.6010749578075,0
"147.32.84.165",2615,"217.163.21.37",80,10,2277,5,1156,5,1121,96507.330934,0.1424059999990277,64941.08394353568,62974.8746545878
"147.32.84.165",2892,"98.139.175.225",25,3,186,3,186,0,0,96507.331035,8.885823999997228,167.4577394286072,0
"147.32.84.165",2721,"184.82.148.43",80,10,1923,5,983,5,940,96507.987144,0.37699600000632927,20859.637767689772,19947.161242755225
"147.32.84.165",2903,"64.12.90.65",25,3,186,3,186,0,0,96508.014644,9.004439000011189,165.251827459562,0
"147.32.84.165",2724,"217.163.21.39",80,11,3446,6,1817,5,1629,96508.087187,0.25568299999576993,56851.64833109939,50969.36440911442
"147.32.84.165",2904,"66.94.237.64",25,3,186,3,186,0,0,96508.093794,9.025777000002563,164.86115267412185,0
"147.32.84.165",2755,"217.163.21.39",80,13,5048,7,2333,6,2715,96508.133058,0.21206599999277387,88010.33640770314,102420.94442645265
"147.32.84.165",2907,"205.188.103.2",25,3,186,3,186,0,0,96508.133118,8.986575999995694,165.58030555805826,0
"147.32.84.165",2908,"98.137.54.237",25,3,186,3,186,0,0,96508.251419,8.967977000007522,165.92370832337681,0
"147.32.84.165",2816,"46.4.36.120",443,6,366,3,186,3,180,96512.301512,1.0318739999929676,1442.036527725421,1395.5192203794395
"147.32.84.165",2799,"184.82.148.44",80,10,1514,5,596,5,918,96513.33363,0.32307399999990594,14758.228764931218,22731.63423860211
"147.32.84.165",2919,"209.85.143.27",25,3,186,3,186,0,0,96513.440351,8.996547000002465,165.39679056860285,0
"147.32.84.165",2755,"46.4.36.120",443,6,366,3,186,3,180,96514.911025,1.0352210000128252,1437.374241810749,1391.0073307845958
"147.32.84.165",2441,"217.163.21.37",80,10,2275,5,1155,5,1120,96515.011853,0.13990100000228267,66046.70445421575,64045.28916772436
"147.32.84.165",2929,"67.195.168.230",25,3,186,3,186,0,0,96515.05771,8.984957000007853,165.61014148411613,0
"147.32.84.165",2615,"92.240.244.181",80,10,1760,6,1366,4,394,96515.112505,13.160277999995742,830.3775953671751,239.50861828306512
"147.32.84.165",2941,"205.188.190.1",25,3,186,3,186,0,0,96515.121015,9.021697999996832,164.93569170687408,0
"147.32.84.165",2816,"122.127.64.127",6667,3,186,3,186,0,0,96515.946496,8.99909499999194,165.34996019058948,0
"147.32.84.165",2441,"46.4.36.120",443,6,366,3,186,3,180,96528.255843,1.0313469999964582,1442.773382775254,1396.2323059115363
"147.32.84.165",2806,"173.241.240.4",80,9,2195,5,1165,4,1030,96528.255976,0.0706860000063898,131850.7200740953,116571.88126722588
"147.32.84.165",2952,"64.12.90.66",25,3,186,3,186,0,0,96528.272226,9.013535000005504,165.08506374015204,0
"147.32.84.165",2724,"217.163.21.37",80,14,6141,7,810,7,5331,96529.058104,0.18852399999741465,34372.28151370045,226220.5342586878
"147.32.84.165",2967,"98.139.175.225",25,3,186,3,186,0,0,96529.10391,8.984751999989385,165.61392011730075,0
"147.32.84.165",2799,"217.163.21.40",80,14,5107,7,2332,7,2775,96529.158803,0.22647399999550544,82375.9018711651,98024.49729523291
"147.32.84.165",2988,"209.85.143.27",25,3,186,3,186,0,0,96529.158932,9.029792999994243,164.78783068459583,0
"147.32.84.165",2837,"184.82.148.43",80,10,1927,5,987,5,940,96529.159017,0.3453469999949448,22863.960017361038,21775.200016534323
"147.32.84.165",2994,"205.188.103.2",25,3,186,3,186,0,0,96529.20487,8.983980000004522,165.62815144281834,0
"147.32.84.165",2883,"217.163.21.37",80,10,1451,5,701,5,750,96529.259346,0.17805799999041483,31495.355447673726,33696.88528638416
"147.32.84.165",2997,"200.75.140.165",25,3,186,3,186,0,0,96529.265497,9.023650000002817,164.90001274423713,0
"147.32.84.165",2892,"173.241.240.4",80,9,2194,5,1164,4,1030,96529.293323,0.12427099999331404,74933.00931432916,66306.70068192357
"147.32.84.165",2998,"216.17.3.48",25,3,186,3,186,0,0,96529.305267,8.98400299999048,165.62772741745263,0
"147.32.84.165",2999,"205.188.103.2",25,3,186,3,186,0,0,96529.326089,8.96323000000848,166.01158287789025,0
"147.32.84.165",3002,"209.85.143.27",25,3,186,3,186,0,0,96529.329291,8.960076000003028,166.07001994173902,0
"147.32.84.165",3004,"208.15.91.13",25,3,186,3,186,0,0,96529.332492,8.956921999997576,166.12849816046213,0
"147.32.84.165",2903,"46.4.36.120",443,6,366,3,186,3,180,96534.475779,1.0302620000002207,1444.292810954574,1397.7027202786198
"147.32.84.165",2724,"217.163.21.40",80,13,4481,7,1878,6,2603,96535.506252,0.24002699999255128,62592.958294134565,86756.90651737608
"147.32.84.165",3018,"217.56.59.218",25,3,186,3,186,0,0,96535.552316,8.858024999994086,167.9832694083606,0
"147.32.84.165",2907,"212.117.171.138",65500,9,544,5,302,4,242,96536.081736,11.583761000001687,208.56783906363816,167.1305200443723
"147.32.84.165",2799,"184.82.148.44",80,10,1514,5,596,5,918,96536.081863,0.32279200000630226,14771.12196060283,22751.493221196975
"147.32.84.165",3022,"98.139.175.225",25,3,186,3,186,0,0,96536.081925,8.929493999996339,166.63878154804854,0
"147.32.84.165",2892,"65.55.196.251",443,20,9171,10,4216,10,4955,96536.081989,1.470474000001559,22936.821732287848,26957.29404257265
"147.32.84.165",3024,"205.188.190.1",25,3,186,3,186,0,0,96536.181916,8.92987799999537,166.6316157959573,0
"147.32.84.165",3025,"64.12.90.34",25,3,186,3,186,0,0,96536.183235,8.928661999991164,166.65430945884978,0
"147.32.84.165",3027,"207.115.37.21",25,3,186,3,186,0,0,96536.188421,8.923500000004424,166.75071440569982,0
"147.32.84.165",2724,"109.86.117.4",6667,6,366,3,186,3,180,96549.224918,1.0430839999899035,1426.5389939970348,1380.5216070939045
"147.32.84.165",2929,"46.4.36.120",443,6,366,3,186,3,180,96550.027564,1.0304899999900954,1443.9732554554648,1397.3934730214175
"147.32.84.165",2919,"217.163.21.37",80,14,6141,7,810,7,5331,96550.127812,0.18821699998807162,34428.34600705927,226589.52168349747
"147.32.84.165",3033,"98.137.54.237",25,3,186,3,186,0,0,96550.173689,8.986157999999705,165.5880076891647,0
"147.32.84.165",2907,"212.117.171.138",65500,9,544,5,302,4,242,96550.228253,39.568027000001166,61.059400308231915,48.92839362447723
"147.32.84.165",2941,"184.82.148.43",80,10,1927,5,987,5,940,96550.228311,0.30419999999867287,25956.607495182274,24720.57856684026
"147.32.84.165",3051,"65.54.188.110",25,3,186,3,186,0,0,96550.228375,9.031476999996812,164.7571045135281,0
"147.32.84.165",3061,"205.178.132.80",25,3,186,3,186,0,0,96550.25105,9.00892299998668,165.16957687419463,0
"147.32.84.165",3063,"64.12.90.66",25,3,186,3,186,0,0,96550.268289,8.991733000002569,165.4853408124524,0
"147.32.84.165",2967,"217.163.21.37",80,10,1451,5,701,5,750,96550.329145,0.1388569999980973,40386.87282655425,43209.92099845319
"147.32.84.165",3066,"64.12.90.65",25,3,186,3,186,0,0,96550.37501,8.9854720000003,165.60064958189736,0
"147.32.84.165",2988,"217.163.21.40",80,11,3448,6,1818,5,1630,96551.058288,0.2295659999945201,63354.32947538911,56802.83665835217
"147.32.84.165",3078,"66.94.237.64",25,3,186,3,186,0,0,96551.104499,8.957657999999356,166.11484832308926,0
"147.32.84.165",2967,"31.192.109.161",80,10,1273,5,540,5,733,96556.449759,0.24192300000868272,17856.921416504232,24239.11740425482
"147.32.84.165",2941,"46.4.36.120",443,6,366,3,186,3,180,96556.530657,1.0510150000045542,1415.7742753372238,1370.10413742312
"147.32.84.165",2994,"184.82.148.44",80,10,1514,5,596,5,918,96557.151985,0.3225709999969695,14781.241959273446,22767.08073592789
"147.32.84.165",3079,"209.85.143.27",25,3,186,3,186,0,0,96557.152116,9.032680000003893,164.7351616573773,0
"147.32.84.165",3087,"98.137.54.237",25,3,186,3,186,0,0,96557.15218,9.032739999995101,164.7340674037786,0
"147.32.84.165",3088,"74.125.45.27",25,3,186,3,186,0,0,96557.152229,9.032739999995101,164.7340674037786,0
"147.32.84.165",3004,"217.163.21.38",80,10,2277,5,1156,5,1121,96557.258853,0.14202699999441393,65114.37966276647,63142.92353110832
"147.32.84.165",3089,"98.139.175.225",25,3,186,3,186,0,0,96557.306905,8.978048999997554,165.73756725992533,0
"147.32.84.165",2919,"46.98.119.151",6667,6,366,3,186,3,180,96557.581913,1.039390000005369,1431.6089244579164,1385.4279914108868
"147.32.84.165",3024,"46.4.36.120",443,6,366,3,186,3,180,96558.621407,0.9668200000014622,1539.0662170804799,1489.4189197553032
"147.32.84.165",2929,"217.163.21.40",80,13,5048,7,2333,6,2715,96559.588464,0.16046600000117905,116311.24350244203,135355.77630052727
"147.32.84.165",3091,"64.12.90.34",25,3,186,3,186,0,0,96559.634376,8.959499999997206,166.0806964674886,0
"147.32.84.165",2994,"46.4.36.120",443,6,366,3,186,3,180,96571.102755,1.0321560000011232,1441.6425424048116,1395.137944262721
"147.32.84.165",2967,"217.163.21.38",80,13,6081,6,750,7,5331,96571.202762,0.21940899999754038,27346.189080973258,194376.7119875579
"147.32.84.165",3093,"94.245.120.86",25,3,186,3,186,0,0,96571.202896,9.032139999995707,164.74501059557394,0
"147.32.84.165",3022,"184.82.148.43",80,10,1915,5,987,5,928,96571.202955,0.321909999998752,24528.594948993854,23062.34661870952
"147.32.84.165",3100,"64.12.90.34",25,3,186,3,186,0,0,96571.24877,8.986389999990934,165.58373273377867,0
"147.32.84.165",2919,"173.241.240.4",80,9,2195,5,1165,4,1030,96571.248828,0.12116100000275765,76922.44203817958,68008.68266036478
"147.32.84.165",3104,"205.188.190.1",25,3,186,3,186,0,0,96571.265223,8.969986000010977,165.88654653398333,0
"147.32.84.165",2941,"92.240.244.181",80,10,1760,6,1366,4,394,96571.303516,6.9374859999952605,1575.2103860112245,454.3432592155362
"147.32.84.165",3106,"216.99.131.25",25,3,186,3,186,0,0,96571.309079,9.025651999996626,164.86343590474752,0
"147.32.84.165",3112,"98.137.54.237",25,3,186,3,186,0,0,96571.312056,9.022796000004746,164.9156203907544,0
"147.32.84.165",2919,"217.163.21.38",80,10,1451,5,701,5,750,96572.005646,0.13998300000093877,40062.00752921705,42862.347570489
"147.32.84.165",3114,"64.191.223.42",25,3,186,3,186,0,0,96572.052203,8.984805000000051,165.6129431857443,0
"147.32.84.165",3051,"184.82.148.44",80,10,1502,5,589,5,913,96572.135143,0.32201199998962693,14632.995044134346,22682.384508140338
"147.32.84.165",3119,"205.188.190.1",25,3,186,3,186,0,0,96572.241652,8.996681999997236,165.39430870185888,0
"147.32.84.165",2967,"217.163.21.40",80,13,4477,7,1878,6,2599,96572.241711,0.291575000010198,51527.05135719636,71309.26862478878
"147.32.84.165",3120,"205.188.146.194",25,3,186,3,186,0,0,96572.289557,8.948820999998134,166.27888746465152,0
"147.32.84.165",3078,"46.4.36.120",443,6,366,3,186,3,180,96578.128279,1.0300090000091586,1444.647571027796,1398.0460364785122
"147.32.84.165",3022,"70.32.97.26",80,8,2623,5,811,3,1812,96578.128387,0.35930899999220856,18056.881403306594,40344.1049356246
"147.32.84.165",3121,"65.54.188.72",25,3,186,3,186,0,0,96578.229211,9.027811000007205,164.82400883213134,0
"147.32.84.165",3123,"66.180.193.211",25,3,186,3,186,0,0,96578.240703,9.016443000000436,165.03182019782392,0
"147.32.84.165",3089,"111.92.129.242",6667,3,186,3,186,0,0,96579.158484,9.001352000006591,165.30850032294154,0
"147.32.84.165",3022,"173.192.170.88",80,31,5299,14,1063,17,4236,96580.536597,49.17958300000464,172.91728561421917,689.0664363704915
"147.32.84.165",3051,"195.113.232.82",80,20,6341,11,2612,9,3729,96580.737666,82.63072899999679,252.88412982536812,361.02791735022885
"147.32.84.165",3125,"98.139.175.225",25,3,186,3,186,0,0,96580.738644,9.027606000003289,164.82775167629802,0
"147.32.84.165",2907,"212.117.171.138",65500,9,544,2,122,7,422,96592.276536,382.315300000002,2.5528667045237134,8.83040778122137
"147.32.84.165",3091,"46.4.36.120",443,6,366,3,186,3,180,96592.276687,1.0311649999930523,1443.0280314110987,1396.4787400752568
"147.32.84.165",3078,"195.113.232.96",80,8,1825,5,930,3,895,96592.299217,64.21085399998992,115.86826115100678,111.5076276668291
"147.32.84.165",3126,"64.12.90.34",25,3,186,3,186,0,0,96592.300123,8.90566500001296,167.0846590342029,0
"147.32.84.165",3129,"209.85.143.27",25,3,186,3,186,0,0,96592.377132,8.92948800000886,166.6388935175817,0
"147.32.84.165",3136,"64.71.138.88",25,3,186,3,186,0,0,96592.377285,8.929455999998027,166.63949069241497,0
"147.32.84.165",3093,"46.137.9.143",80,8,1568,5,869,3,699,96593.081168,0.14071900000271853,49403.42100118459,39738.770172414304
"147.32.84.165",3137,"98.139.175.225",25,3,186,3,186,0,0,96593.126065,8.883816999994451,167.49557087915358,0
"147.32.84.165",3100,"74.125.232.218",80,11,3429,6,1353,5,2076,96593.126151,63.3836650000012,170.76955079829787,262.02334623596926
"147.32.84.165",3139,"98.137.54.237",25,3,186,3,186,0,0,96593.134236,8.875706000006176,167.64863549997764,0
"147.32.84.165",3104,"68.67.185.209",80,10,1728,6,702,4,1026,96593.280669,14.503163999994285,387.2258494768599,565.9454723123337
"147.32.84.165",3143,"205.188.190.1",25,3,186,3,186,0,0,96593.304647,8.90569700000924,167.0840586647464,0
"147.32.84.165",3106,"68.67.185.206",80,10,1966,6,1045,4,921,96593.308104,14.475506000002497,577.5273071627727,508.99775109752494
"147.32.84.165",3144,"205.188.146.194",25,3,186,3,186,0,0,96593.332,8.878395000007004,167.59785974816688,0
"147.32.84.165",3119,"46.4.36.120",443,6,366,3,186,3,180,96599.299492,1.030415000001085,1444.0783567770588,1397.495183977799
"147.32.84.165",3093,"68.67.179.213",80,10,2638,6,1166,4,1472,96599.299638,18.486581999997725,504.5821883137266,637.0025567734181
"147.32.84.165",3147,"98.139.175.225",25,3,186,3,186,0,0,96599.299714,8.93161900000996,166.59913505024574,0
"147.32.84.165",3120,"184.82.148.43",80,10,1927,5,987,5,940,96599.299781,0.32221700000809506,24505.22473923359,23338.30927546056
"147.32.84.165",3148,"193.252.22.184",25,3,186,3,186,0,0,96599.329184,8.902247999998508,167.1487920804104,0
"147.32.84.165",3121,"217.163.21.41",80,14,6890,7,1857,7,5033,96599.406335,0.19070099999953527,77902.05609847984,211136.80578548682
"147.32.84.165",3149,"64.12.138.161",25,3,186,3,186,0,0,96599.452189,8.87908499999321,167.5848355997423,0
"147.32.84.165",3120,"61.17.216.19",6667,3,186,3,186,0,0,96600.330144,8.905248999988544,167.09246423114215,0
"147.32.84.165",3119,"46.4.36.120",443,6,366,3,186,3,180,96601.708159,1.0310299999982817,1443.216977199965,1396.6615908386757
"147.32.84.165",3123,"195.113.232.82",80,8,1350,5,819,3,531,96602.739478,60.62911399999575,108.06689340702651,70.06534847268752
"147.32.84.165",3150,"209.85.143.27",25,3,186,3,186,0,0,96602.739595,9.003347999998368,165.27185220434328,0
"147.32.84.165",3151,"205.188.103.1",25,3,186,3,186,0,0,96602.739663,9.003404999995837,165.27080587851907,0
"147.32.84.165",3119,"46.4.36.120",443,6,366,3,186,3,180,96613.249473,1.0315849999897182,1442.4405163072659,1395.9101770715477
"147.32.84.165",3152,"98.137.54.237",25,3,186,3,186,0,0,96613.349216,9.02880099999311,164.80593602640437,0
"147.32.84.165",3154,"65.55.92.184",25,3,186,3,186,0,0,96613.349317,9.02882099999988,164.80557095993152,0
"147.32.84.165",3155,"207.191.230.136",25,3,186,3,186,0,0,96613.349347,9.028853000010713,164.80498685693902,0
"147.32.84.165",3162,"129.121.69.100",25,3,186,3,186,0,0,96614.051674,9.028418000001693,164.8129273588929,0
"147.32.84.165",3173,"205.188.146.194",25,3,186,3,186,0,0,96614.252646,9.028249000009964,164.81601249570738,0
"147.32.84.165",3186,"205.188.103.1",25,3,186,3,186,0,0,96614.252699,9.028317999996943,164.81475286985946,0
"147.32.84.165",3187,"98.137.54.237",25,3,186,3,186,0,0,96614.252745,9.028320999990683,164.81469810405895,0
"147.32.84.165",3223,"207.191.230.136",25,3,186,3,186,0,0,96614.252802,9.028307999993558,164.81493542323344,0
"147.32.84.165",3238,"132.247.146.65",25,3,186,3,186,0,0,96614.252855,9.028302999999141,164.81502669993924,0
"147.32.84.165",3258,"205.188.103.2",25,3,186,3,186,0,0,96614.281264,8.99993999999424,165.33443556300958,0
"147.32.84.165",3119,"31.192.109.161",80,10,1273,5,540,5,733,96620.271477,0.24489099999482278,17640.501284617763,23945.34711412004
"147.32.84.165",3136,"46.4.36.120",443,6,366,3,186,3,180,96620.351278,1.0509349999920232,1415.8820479014346,1370.2084334530011
"147.32.84.165",3273,"209.85.143.27",25,3,186,3,186,0,0,96620.372053,9.029532000000472,164.79259390186803,0
"147.32.84.165",3279,"206.192.47.244",25,3,186,3,186,0,0,96620.372187,9.029506000006222,164.7930684135959,0
"147.32.84.165",3119,"218.94.106.74",6667,6,366,3,186,3,180,96621.402432,1.9147249999950873,777.1350977314329,752.0662236110641
"147.32.84.165",3136,"46.4.36.120",443,6,366,3,186,3,180,96623.31739,0.9941420000104699,1496.7680673227053,1448.4852264413278
"147.32.84.165",3119,"184.82.148.43",80,10,1923,5,983,5,940,96623.783053,0.34099099999002647,23062.19225794819,22053.36797809898
"147.32.84.165",3280,"205.188.103.2",25,3,186,3,186,0,0,96623.89592,8.917595999999321,166.86111369029425,0
"147.32.84.165",3284,"98.137.54.237",25,3,186,3,186,0,0,96623.895958,8.917683000006946,166.85948581025374,0
"147.32.84.165",3292,"205.188.103.1",25,3,186,3,186,0,0,96623.895982,8.917707999993581,166.85901803479896,0
"147.32.84.165",3300,"98.137.34.115",25,3,186,3,186,0,0,96624.31177,8.902524999997695,167.14359128453842,0
"147.32.84.165",3119,"46.4.36.120",443,6,366,3,186,3,180,96634.318097,1.0320790000114357,1441.7500985714394,1395.2420308755866
"147.32.84.165",3328,"209.85.143.27",25,3,186,3,186,0,0,96634.31823,9.031791000001249,164.75137655419553,0
"147.32.84.165",3382,"209.85.143.27",25,3,186,3,186,0,0,96634.318283,9.031858999995166,164.75013615699675,0
"147.32.84.165",3420,"64.12.90.34",25,3,186,3,186,0,0,96634.318336,9.031856000001426,164.75019087989944,0
"147.32.84.165",3473,"205.188.103.2",25,3,186,3,186,0,0,96635.021167,9.031711999996332,164.75281762755546,0
"147.32.84.165",3490,"205.188.103.1",25,3,186,3,186,0,0,96635.021297,9.031705000001239,164.75294531871845,0
"147.32.84.165",3493,"74.125.45.27",25,3,186,3,186,0,0,96635.021351,9.031703000000562,164.75298180198214,0
"147.32.84.165",3494,"98.137.54.237",25,3,186,3,186,0,0,96635.221792,9.031726000001072,164.75256224555787,0
"147.32.84.165",3495,"98.139.175.225",25,3,186,3,186,0,0,96635.221916,9.031723000007332,164.75261697007227,0
"147.32.84.165",3497,"65.55.92.184",25,3,186,3,186,0,0,96635.221982,9.031705999994301,164.75292707722537,0
"147.32.84.165",3501,"64.12.90.34",25,3,186,3,186,0,0,96635.350437,9.003857000003336,165.26250916684359,0
"147.32.84.165",3503,"205.188.103.1",25,3,186,3,186,0,0,96635.350494,9.00382399999944,165.26311487209128,0
"147.32.84.165",3505,"72.55.128.124",25,3,186,3,186,0,0,96635.350543,9.00379500001145,165.26364716190312,0
"147.32.84.165",3154,"46.4.36.120",443,6,366,3,186,3,180,96641.342213,1.0314119999966351,1442.682458614845,1396.1443147885595
"147.32.84.165",3507,"210.168.35.4",25,3,186,3,186,0,0,96641.342279,9.032997999995132,164.72936227826042,0
"147.32.84.165",3508,"98.139.175.225",25,3,186,3,186,0,0,96642.373858,9.004927999994834,165.2428536908739,0
"147.32.84.165",3515,"66.94.237.64",25,3,186,3,186,0,0,96642.37389,9.005017000003136,165.24122053289648,0
"147.32.84.165",3238,"86.101.54.123",6667,3,186,3,186,0,0,96644.856697,9.030945000005886,164.76681011777063,0
"147.32.84.165",3258,"46.4.36.120",443,6,366,3,186,3,180,96645.256995,1.0308359999908134,1443.4885859761016,1396.9244380413886
"147.32.84.165",3518,"98.137.54.237",25,3,186,3,186,0,0,96646.288123,9.005359999995562,165.23492675481415,0
"147.32.84.165",3520,"64.12.90.66",25,3,186,3,186,0,0,96646.288182,9.005399999994552,165.23419281774272,0
"147.32.84.165",3279,"46.4.36.120",443,6,366,3,186,3,180,96655.393511,1.0308890000014799,1443.4143734173747,1396.852619436169
"147.32.84.165",3258,"184.82.148.43",80,10,1923,5,983,5,940,96656.095732,0.30808499999693595,25525.423178922087,24408.84820771797
"147.32.84.165",3534,"205.188.103.1",25,3,186,3,186,0,0,96656.197446,8.930389999994077,166.62206241843714,0
"147.32.84.165",3536,"67.195.168.230",25,3,186,3,186,0,0,96656.295908,8.932780999995884,166.57746339025726,0
"147.32.84.165",3539,"98.139.175.225",25,3,186,3,186,0,0,96656.295972,8.932837999993353,166.57640046770211,0
"147.32.84.165",3541,"209.85.143.27",25,3,186,3,186,0,0,96656.296002,8.93285699999251,166.57604616319816,0
"147.32.84.165",3328,"184.82.148.44",80,10,1514,5,596,5,918,96656.397019,0.3425780000106897,13917.99823646358,21437.453659519408
"147.32.84.165",3544,"206.46.232.11",25,3,186,3,186,0,0,96656.424605,8.904966000001878,167.09777443279248,0
"147.32.84.165",3545,"195.76.106.170",25,3,186,3,186,0,0,96656.509523,8.920297999997274,166.81057067829514,0
"147.32.84.165",3420,"46.4.36.120",443,6,366,3,186,3,180,96662.419064,0.9303749999962747,1599.3550987569079,1547.7629987970074
"147.32.84.165",3382,"217.163.21.38",80,14,6135,7,810,7,5325,96663.322177,0.1971520000079181,32868.040901130844,216076.93555373052
"147.32.84.165",3546,"64.12.138.161",25,3,186,3,186,0,0,96663.349675,9.005624999990687,165.23006454316484,0
"147.32.84.165",3547,"205.188.190.1",25,3,186,3,186,0,0,96663.368093,8.987328999995952,165.566432474061,0
"147.32.84.165",3494,"217.163.21.38",80,10,1447,5,699,5,748,96664.023596,0.13945099999546073,40100.10684887182,42911.13007575984
"147.32.84.165",3548,"98.137.54.237",25,3,186,3,186,0,0,96664.069521,8.986948000005214,165.57345163220447,0
"147.32.84.165",3503,"218.201.21.157",6667,2,124,2,124,0,0,96667.235373,3.0115829999995185,329.3948730618278,0
"147.32.84.165",3505,"46.4.36.120",443,6,366,3,186,3,180,96677.170157,1.0305119999975432,1443.9424286214498,1397.3636406014032
"147.32.84.165",3497,"217.163.21.34",80,13,4479,7,1876,6,2603,96677.270307,0.25007100000220817,60014.95575203633,83272.3506516794
"147.32.84.165",3549,"74.50.52.43",25,3,186,3,186,0,0,96677.270441,9.03570999999647,164.6799200063505,0
"147.32.84.165",3501,"184.82.148.43",80,10,1907,5,983,5,924,96677.2705,0.3394209999969462,23168.866982510666,21778.263572573607
"147.32.84.165",3558,"209.85.225.27",25,3,186,3,186,0,0,96677.316333,8.98994300000777,165.51829082772983,0
"147.32.84.165",3567,"203.188.197.119",25,3,186,3,186,0,0,96677.371327,9.035344999996596,164.68657256591317,0
"147.32.84.165",3578,"209.85.143.27",25,3,186,3,186,0,0,96677.382766,9.024027000006754,164.89312365741884,0
"147.32.84.165",3579,"98.137.54.237",25,3,186,3,186,0,0,96677.470536,9.036124000005657,164.6723750137856,0
"147.32.84.165",3583,"206.46.232.11",25,3,186,3,186,0,0,96677.470662,9.03611999998975,164.67244790924508,0
"147.32.84.165",3534,"184.82.148.44",80,10,1312,5,584,5,728,96678.200913,0.327173000012408,14279.906959996133,17800.979909036276
"147.32.84.165",3584,"98.139.175.225",25,3,186,3,186,0,0,96678.308651,9.000595000004978,165.32240368544268,0
"147.32.84.165",3505,"31.192.109.161",80,10,1273,5,540,5,733,96684.397977,0.23718500000541098,18213.6307097896,24723.31724125144
"147.32.84.165",3539,"46.4.36.120",443,6,366,3,186,3,180,96684.39811,1.0312770000018645,1442.8713139120816,1396.3270779794339
"147.32.84.165",3545,"173.192.170.88",80,12,1341,7,784,5,557,96684.476636,70.92136899998877,88.43596913648118,62.830146440076554
"147.32.84.165",3536,"217.163.21.34",80,13,6725,6,1713,7,5012,96684.677665,0.18886100000236183,72561.30169716681,212304.28727740812
"147.32.84.165",3585,"94.228.131.151",25,3,186,3,186,0,0,96684.724673,8.908039000001736,167.04013083010864,0
"147.32.84.165",3505,"217.163.21.34",80,11,4493,6,1751,5,2742,96685.102488,0.2630510000017239,53252.03097463305,83390.67329094451
"147.32.84.165",3588,"205.188.146.194",25,3,186,3,186,0,0,96685.10262,8.930763999989722,166.61508466708028,0
"147.32.84.165",3590,"64.12.139.193",25,3,186,3,186,0,0,96685.14853,8.884986999997636,167.47351459269393,0
"147.32.84.165",3547,"180.241.97.224",6667,3,186,3,186,0,0,96685.429614,8.904745000007097,167.1019215035146,0
"147.32.84.165",3539,"46.4.36.120",443,6,366,3,186,3,180,96698.249182,1.0310690000042086,1443.1623877683514,1396.608762356469
"147.32.84.165",3546,"195.113.232.96",80,28,34488,19,1788,9,32700,96698.249313,63.525061000007554,225.1709762230421,4118.0598000522805
"147.32.84.165",3592,"80.179.55.150",25,3,186,3,186,0,0,96698.250196,9.027599000008195,164.82787948364225,0
"147.32.84.165",3505,"184.82.148.43",80,10,1927,5,987,5,940,96698.349704,0.340756000005058,23172.005775049583,22068.57692861865
"147.32.84.165",3595,"98.137.54.237",25,3,186,3,186,0,0,96698.349835,9.028325999999652,164.81460682745146,0
"147.32.84.165",3600,"209.85.143.27",25,3,186,3,186,0,0,96698.449365,9.028785000002244,164.8062280804815,0
"147.32.84.165",3606,"205.188.103.2",25,3,186,3,186,0,0,96698.462382,9.015891999995802,165.04190600338745,0
"147.32.84.165",3610,"205.188.103.1",25,3,186,3,186,0,0,96699.252901,9.029454999996233,164.79399919492602,0
"147.32.84.165",3614,"98.139.175.225",25,3,186,3,186,0,0,96699.280508,9.00198200000159,165.29693127577207,0
"147.32.84.165",3549,"46.4.36.120",443,6,366,3,186,3,180,96705.673107,1.0306879999989178,1443.6958614067132,1397.1250271677868
"147.32.84.165",3618,"195.90.97.34",25,3,186,3,186,0,0,96706.074279,9.029896000007284,164.7859510230018,0
"147.32.84.165",3620,"66.94.237.64",25,3,186,3,186,0,0,96706.074386,9.029916000014055,164.78558604506222,0
"147.32.84.165",3624,"67.231.152.30",25,3,186,3,186,0,0,96706.174353,9.03014400000393,164.78142541241343,0
"147.32.84.165",3539,"27.255.59.64",6667,6,366,3,186,3,180,96706.704077,1.327636000001803,1120.7891319593466,1084.634643831626
"147.32.84.165",3588,"46.4.36.120",443,6,366,3,186,3,180,96708.031936,0.9796020000067074,1518.9842405281038,1469.984748898165
"147.32.84.165",3584,"184.82.148.43",80,10,1923,5,983,5,940,96709.011785,0.32282700001087505,24359.796422650787,23294.210210876645
"147.32.84.165",3627,"98.137.54.237",25,3,186,3,186,0,0,96709.118478,8.994622999991407,165.43216986430912,0
"147.32.84.165",3630,"98.137.54.237",25,3,186,3,186,0,0,96709.118536,8.994685000012396,165.43102954666554,0
"147.32.84.165",3639,"74.50.52.43",25,3,186,3,186,0,0,96709.11859,8.994680000003427,165.43112150731687,0
"147.32.84.165",3549,"46.4.36.120",443,6,366,3,186,3,180,96719.31778,1.030110000006971,1444.505926541758,1397.9089611694433
"147.32.84.165",3539,"184.82.148.44",80,10,1514,5,596,5,918,96719.417692,0.3585480000037933,13298.080033773878,20482.613206383256
"147.32.84.165",3642,"205.188.103.2",25,3,186,3,186,0,0,96719.518401,8.929438999999547,166.63980794315023,0
"147.32.84.165",3644,"205.188.190.1",25,3,186,3,186,0,0,96719.518527,8.929435000012745,166.639882590318,0
"147.32.84.165",3645,"209.85.143.27",25,3,186,3,186,0,0,96719.518628,8.929382999995141,166.6408530131152,0
"147.32.84.165",3651,"98.139.175.225",25,3,186,3,186,0,0,96719.536081,8.911991000000853,166.96605730412628,0
"147.32.84.165",3656,"98.137.54.237",25,3,186,3,186,0,0,96719.53614,8.911991000000853,166.96605730412628,0
"147.32.84.165",3592,"217.163.21.39",80,14,6141,7,810,7,5331,96720.320569,0.19043999999121297,34026.46502992539,223944.54947473117
"147.32.84.165",3658,"83.140.31.145",25,3,186,3,186,0,0,96720.320629,8.930139000003692,166.62674567544636,0
"147.32.84.165",3662,"205.188.103.2",25,3,186,3,186,0,0,96720.348152,8.90275299998757,167.1393107280498,0
"147.32.84.165",3671,"64.12.90.65",25,3,186,3,186,0,0,96720.367962,8.88300599998911,167.51086287702884,0
"147.32.84.165",3600,"46.4.36.120",443,6,366,3,186,3,180,96727.042905,1.0309520000009798,1443.3261684332404,1396.7672597741034
"147.32.84.165",3595,"217.163.21.39",80,10,1451,5,701,5,750,96727.043036,0.1458589999965625,38448.090279874166,41135.61727518634
"147.32.84.165",3675,"65.54.188.94",25,3,186,3,186,0,0,96727.088871,8.986667999997735,165.57861044831913,0
"147.32.84.165",3614,"94.100.176.20",25,3,186,3,186,0,0,96727.143969,9.031853000007686,164.7502456028385,0
"147.32.84.165",3618,"217.163.21.37",80,13,4492,7,1878,6,2614,96728.074099,0.23987399999168701,62632.882265358756,87179.10236509467
"147.32.84.165",3676,"98.139.175.225",25,3,186,3,186,0,0,96728.120049,8.959181999991415,166.0865913876318,0
"147.32.84.165",3620,"173.192.170.88",80,11,1723,7,1194,4,529,96730.053815,17.140803999995114,557.26674198029,246.89623660600788
"147.32.84.165",3595,"124.123.106.96",6667,2,124,2,124,0,0,96730.053902,3.010567000004812,329.50603656999306,0
"147.32.84.165",3600,"46.4.36.120",443,6,366,3,186,3,180,96740.489745,1.030908000000636,1443.3877707798192,1396.8268749482122
"147.32.84.165",3627,"184.82.155.107",80,10,1913,5,985,5,928,96740.489905,0.3424809999996796,23008.57565823322,21677.114934863377
"147.32.84.165",3677,"216.40.42.4",25,3,186,3,186,0,0,96740.489973,9.03123300000152,164.76155581411192,0
"147.32.84.165",3639,"50.23.235.4",80,23,12336,12,2337,11,9999,96740.602876,6.699252999998862,2790.7589099864085,11940.43574709204
"147.32.84.165",3680,"209.85.143.27",25,3,186,3,186,0,0,96740.756356,8.964745000004768,165.9835276964608,0
"147.32.84.165",3684,"212.82.111.207",25,3,186,3,186,0,0,96741.292329,9.03091799998947,164.76730272622729,0
"147.32.84.165",3687,"64.12.138.161",25,3,186,3,186,0,0,96741.292459,9.03088900000148,164.76783182693933,0
"147.32.84.165",3692,"98.137.54.237",25,3,186,3,186,0,0,96741.292518,9.030855000004522,164.7684521564409,0
"147.32.84.165",3644,"87.248.203.254",80,69,52824,34,2436,35,50388,96741.520901,0.45288300000538584,43030.98151126945,890084.1939202977
"147.32.84.165",3695,"65.55.92.184",25,3,186,3,186,0,0,96741.538123,8.986439999993308,165.58281143602005,0
"147.32.84.165",3600,"31.192.109.161",80,10,1273,5,540,5,733,96748.114944,0.24385899999469984,17715.15506950284,24046.68271471404
"147.32.84.165",3656,"46.4.36.120",443,6,366,3,186,3,180,96748.195588,1.0513740000023972,1415.29084797285,1369.6363044898549
"147.32.84.165",3696,"81.169.145.101",25,3,186,3,186,0,0,96748.215723,8.929934999992838,166.63055218220438,0
"147.32.84.165",3662,"74.125.93.27",25,3,186,3,186,0,0,96748.818635,8.929032999993069,166.64738499691455,0
"147.32.84.165",3671,"184.82.147.251",80,10,1906,5,978,5,928,96749.119345,0.3420159999950556,22876.12275482173,21706.58682666111
"147.32.84.165",3700,"98.139.175.225",25,3,186,3,186,0,0,96749.232378,8.917075999997905,166.87084420950876,0
"147.32.84.165",3600,"94.137.182.140",6667,3,186,3,186,0,0,96749.247181,8.902396000004956,167.14601327543414,0
"147.32.84.165",3645,"46.4.36.120",443,6,366,3,186,3,180,96761.460977,1.0313650000025518,1442.7482026211073,1396.2079380204264
"147.32.84.165",3620,"184.82.147.252",80,10,1508,5,596,5,912,96761.661313,0.3415719999902649,13958.989613129566,21360.064642909674
"147.32.84.165",3760,"98.137.54.237",25,3,186,3,186,0,0,96761.774001,9.018550000007963,164.99326388373808,0
"147.32.84.165",3545,"184.82.147.251",80,10,1925,5,990,5,935,96761.774068,0.3046639999956824,25995.851167555866,24551.637213802762
"147.32.84.165",3823,"216.32.181.178",25,3,186,3,186,0,0,96761.87464,9.018181000006734,165.0000149696362,0
"147.32.84.165",3600,"217.163.21.39",80,14,6141,7,810,7,5331,96762.263662,0.18976300000213087,34147.858117373966,224743.49583175383
"147.32.84.165",3832,"64.12.138.161",25,3,186,3,186,0,0,96762.263793,9.030283999993117,164.77887074217534,0
"147.32.84.165",3546,"184.82.147.252",80,10,1515,5,603,5,912,96762.263851,0.36058600000978913,13378.223225164145,20233.73064900448
"147.32.84.165",3848,"194.150.245.6",25,3,186,3,186,0,0,96762.309612,8.984588000006624,165.6169431474101,0
"147.32.84.165",3850,"64.12.90.34",25,3,186,3,186,0,0,96762.382334,9.012383000008413,165.10616559445054,0
"147.32.84.165",3677,"217.163.21.39",80,10,1451,5,701,5,750,96762.465038,0.1411120000120718,39741.48194002104,42519.41719688413
"147.32.84.165",3862,"98.137.54.237",25,3,186,3,186,0,0,96762.492578,9.002255999992485,165.2919001638303,0
"147.32.84.165",3887,"82.57.200.133",25,3,186,3,186,0,0,96762.51103,8.983917000005022,165.62931291542077,0
"147.32.84.165",3600,"46.4.36.120",443,6,366,3,186,3,180,96769.187155,1.0305289999960223,1443.9186087977566,1397.3405891591194
"147.32.84.165",3680,"217.163.21.39",80,14,6141,7,810,7,5331,96769.789258,0.1879449999978533,34478.17180597523,226917.4492563629
"147.32.84.165",3994,"98.139.175.225",25,3,186,3,186,0,0,96769.835206,8.984622999996645,165.6162979793983,0
"147.32.84.165",3695,"74.125.39.27",25,3,186,3,186,0,0,96769.835237,8.984722999986843,165.614454669574,0
"147.32.84.165",3545,"217.163.21.37",80,11,3453,6,1823,5,1630,96769.889295,0.2270520000020042,64231.982100449524,57431.777742036604
"147.32.84.165",4009,"209.85.143.27",25,3,186,3,186,0,0,96769.935112,8.98564699999406,165.5974244259744,0
"147.32.84.165",3662,"219.94.105.182",6667,3,186,3,186,0,0,96770.19035,9.030785999988439,164.76971107519378,0
"147.32.84.165",3273,"217.163.21.39",80,10,1451,5,701,5,750,96770.217918,0.13966500000969972,40153.22378269806,42959.93985310064
"147.32.84.165",4011,"205.188.103.2",25,3,186,3,186,0,0,96770.263934,8.957322000002023,166.12107949224824,0
"147.32.84.165",3700,"46.4.36.120",443,6,366,3,186,3,180,96782.933436,1.0304329999926267,1444.0531310727115,1397.47077200585
"147.32.84.165",3645,"184.82.147.251",80,10,1925,5,990,5,935,96783.334614,0.4015029999864055,19725.880006545813,18629.997783959934
"147.32.84.165",4066,"64.12.90.34",25,3,186,3,186,0,0,96783.334744,8.931419999993523,166.60284702780513,0
"147.32.84.165",3677,"217.163.21.39",80,10,2277,5,1156,5,1121,96783.334801,0.13996799998858478,66072.24508997935,64071.787842445374
"147.32.84.165",4069,"65.55.37.88",25,3,186,3,186,0,0,96783.380806,8.885479999997187,167.464222529393,0
"147.32.84.165",4070,"98.137.54.237",25,3,186,3,186,0,0,96783.43504,8.930975000010221,166.61114827869264,0
"147.32.84.165",3760,"217.163.21.39",80,14,5128,7,2338,7,2790,96783.435108,0.24111599999014288,77572.62065049454,92569.55158891351
"147.32.84.165",4084,"209.85.143.27",25,3,186,3,186,0,0,96783.43516,8.930976000003284,166.61112962339757,0
"147.32.84.165",4086,"62.85.117.16",25,3,186,3,186,0,0,96783.435213,8.930970999994315,166.61122290072908,0
"147.32.84.165",3823,"217.163.21.39",80,11,3453,6,1823,5,1630,96783.446887,0.3601280000002589,40496.71228004908,36209.347787427316
"147.32.84.165",4263,"98.137.54.237",25,3,186,3,186,0,0,96783.446947,8.919280999994953,166.8295908606133,0
"147.32.84.165",4333,"98.139.175.225",25,3,186,3,186,0,0,96783.447001,8.91927399999986,166.82972179126054,0
"147.32.84.165",4345,"65.55.88.22",25,3,186,3,186,0,0,96783.614409,8.85215099999914,168.09473765191586,0
"147.32.84.165",4383,"205.188.146.194",25,3,186,3,186,0,0,96783.61761,8.84904899999674,168.15366261397673,0
"147.32.84.165",3832,"184.82.147.252",80,10,1515,5,603,5,912,96783.964105,0.3263639999931911,14781.042027002495,22355.406846809747
"147.32.84.165",4393,"216.163.188.58",25,3,186,3,186,0,0,96784.071939,8.896334999997634,167.25988848221158,0
"147.32.84.165",3850,"46.4.36.120",443,6,366,3,186,3,180,96790.760431,1.0314959999959683,1442.5649735973925,1396.0306196103797
"147.32.84.165",3848,"173.241.240.4",80,9,2195,5,1165,4,1030,96790.860629,0.06864199999836273,135776.92957988262,120043.12228950995
"147.32.84.165",4400,"98.137.54.237",25,3,186,3,186,0,0,96790.877039,9.013449000005494,165.0866388658873,0
"147.32.84.165",3695,"66.111.4.73",25,3,186,3,186,0,0,96790.960823,9.02977799999644,164.7881044252236,0
"147.32.84.165",3545,"217.163.21.39",80,10,2277,5,1156,5,1121,96791.161766,0.13997799999197014,66067.52490055947,64067.21056533491
"147.32.84.165",4414,"64.12.90.66",25,3,186,3,186,0,0,96791.207639,8.983819000000949,165.63111968304824,0
"147.32.84.165",3700,"196.2.13.199",6667,3,186,3,186,0,0,96791.79217,9.000677000003634,165.32089752797475,0
"147.32.84.165",3848,"46.4.36.120",443,6,366,3,186,3,180,96804.304156,1.0309779999952298,1443.289769526493,1396.7320350256384
"147.32.84.165",3645,"217.163.21.39",80,13,6081,6,750,7,5331,96804.404818,0.18855700000131037,31820.616577259414,226180.9426311599
"147.32.84.165",4430,"76.96.30.116",25,3,186,3,186,0,0,96804.404971,9.030592000010074,164.7732507457252,0
"147.32.84.165",4497,"98.139.175.225",25,3,186,3,186,0,0,96804.451202,8.984481999999844,165.61889711616385,0
"147.32.84.165",3832,"184.82.147.251",80,10,1929,5,994,5,935,96804.505247,0.3259550000075251,24396.005583029615,22947.952937759244
"147.32.84.165",4503,"199.239.254.18",25,3,186,3,186,0,0,96804.505395,9.030174999992596,164.78085972876715,0
"147.32.84.165",3823,"217.163.21.34",80,13,5058,7,2338,6,2720,96804.611986,0.1639769999892451,114064.77738479638,132701.53741943804
"147.32.84.165",4535,"205.188.190.2",25,3,186,3,186,0,0,96804.657821,8.978348000004189,165.73204781094537,0
"147.32.84.165",4066,"217.163.21.39",80,10,1451,5,701,5,750,96805.006404,0.13925700000254437,40270.86609576205,43085.80538062987
"147.32.84.165",4541,"64.12.138.161",25,3,186,3,186,0,0,96805.05226,8.98543200000131,165.60138677804062,0
"147.32.84.165",4069,"184.82.147.252",80,10,1515,5,603,5,912,96805.335358,0.32330699999874923,14920.802828329304,22566.78636722442
"147.32.84.165",4561,"209.85.143.27",25,3,186,3,186,0,0,96805.442042,8.997123000008287,165.3862017890196,0
"147.32.84.165",3645,"31.192.109.161",80,10,1273,5,540,5,733,96811.930582,0.25831299999845214,16723.896977797813,22701.141638381105
"147.32.84.165",4263,"46.4.36.120",443,6,366,3,186,3,180,96812.007405,1.0543170000019018,1411.3402325840482,1365.8131283071434
"147.32.84.165",4070,"173.241.240.4",80,9,2195,5,1165,4,1030,96812.030702,0.09152799998992123,101826.76340602098,90027.0955435207
"147.32.84.165",4597,"64.12.138.161",25,3,186,3,186,0,0,96812.030853,8.93095799999719,166.61146542179105,0
"147.32.84.165",4084,"217.163.21.34",80,11,3453,6,1823,5,1630,96812.03091,0.2980249999964144,48935.49198951585,43754.71856440529
"147.32.84.165",4612,"98.137.54.237",25,3,186,3,186,0,0,96812.046957,8.914978000000701,166.91011464076334,0
"147.32.84.165",4383,"182.2.117.2",6667,5,306,3,186,2,120,96812.076853,9.241821999996318,161.00721264709412,103.87562106264137
"147.32.84.165",4345,"216.157.130.15",25,3,186,3,186,0,0,96812.231911,8.930663999999524,166.61695031859662,0
"147.32.84.165",4086,"217.163.21.39",80,13,6081,6,750,7,5331,96813.062006,0.1872740000108024,32038.61721143301,227730.49113886585
"147.32.84.165",4618,"76.96.30.116",25,3,186,3,186,0,0,96813.108046,8.85698300000513,168.003032183661,0
"147.32.84.165",4393,"217.163.21.39",80,10,2277,5,1156,5,1121,96813.108104,0.13926399999763817,66406.25000112622,64395.68014815094
"147.32.84.165",4629,"206.122.102.56",25,3,186,3,186,0,0,96813.108163,8.856993000008515,168.00284249954464,0
"147.32.84.165",4414,"46.4.36.120",443,6,366,3,186,3,180,96821.318925,0.9740790000068955,1527.5968376173457,1478.3195202748507
"147.32.84.165",4070,"184.82.147.251",80,10,1929,5,994,5,935,96822.293274,0.3404270000028191,23358.89926455348,21972.40524382043
"147.32.84.165",4660,"98.139.175.225",25,3,186,3,186,0,0,96822.405825,8.993603000009898,165.45093217905688,0
"147.32.84.165",4776,"205.188.146.194",25,3,186,3,186,0,0,96822.405894,8.993660000007367,165.449883584523,0
"147.32.84.165",4414,"46.4.36.120",443,6,366,3,186,3,180,96825.376923,1.0323959999950603,1441.3074053048633,1394.8136180369645
"147.32.84.165",4400,"217.163.21.39",80,10,1451,5,701,5,750,96825.376995,0.16532699999515899,33920.654219602424,36291.71278844767
"147.32.84.165",4778,"64.12.90.34",25,2,124,2,124,0,0,96825.423054,2.9663520000030985,334.4174932708471,0
"147.32.84.165",4084,"217.163.21.35",80,13,5058,7,2338,6,2720,96825.479126,0.1658119999920018,112802.45097400801,131232.96263870905
"147.32.84.165",4853,"98.137.54.237",25,2,124,2,124,0,0,96825.52549,2.964267999996082,334.65260226177634,0
"147.32.84.165",4383,"184.82.147.252",80,10,1515,5,603,5,912,96825.525549,0.3395250000030501,14208.084824259375,21488.84470932761
"147.32.84.165",4916,"148.123.15.75",25,2,124,2,124,0,0,96825.579168,3.010288000004948,329.5365759018305,0
"147.32.84.165",4430,"217.163.21.36",80,11,3453,6,1823,5,1630,96825.638349,0.25045399999362417,58230.25386047445,52065.44914567929
"147.32.84.165",4971,"98.139.175.225",25,2,124,2,124,0,0,96825.684479,3.005474999998114,330.06429932061405,0
"147.32.84.165",4497,"173.241.240.4",80,9,2195,5,1165,4,1030,96825.980682,0.08704800000123214,107067.36513036575,94660.4172397225
"147.32.84.165",4975,"209.85.143.27",25,2,124,2,124,0,0,96825.996906,2.994516000006115,331.272232306648,0
"147.32.84.165",4503,"92.240.244.181",80,10,1760,6,1366,4,394,96825.996966,7.209869999991497,1515.7000056884365,437.1784789467379
"147.32.84.165",4984,"98.137.54.237",25,2,124,2,124,0,0,96826.005523,2.985960999998497,332.2213518530548,0
"147.32.84.165",4084,"217.163.21.39",80,14,6141,7,810,7,5331,96826.005582,0.1888080000062473,34320.57963532048,225880.25930357218
"147.32.84.165",1045,"205.188.103.2",25,2,124,2,124,0,0,96826.051439,2.940069999996922,337.4069324883552,0
"147.32.84.165",4400,"217.163.21.39",80,10,2277,5,1156,5,1121,96826.381996,0.13988100001006387,66113.3391907024,64111.63774461713
"147.32.84.165",1123,"67.195.168.230",25,2,124,2,124,0,0,96826.409566,2.982906000004732,332.5616026782025,0
"147.32.84.165",4383,"217.163.21.39",80,10,1451,5,701,5,750,96826.427964,0.1393580000003567,40241.67970253337,43054.57885435097
"147.32.84.165",1124,"64.12.138.161",25,2,124,2,124,0,0,96826.428022,2.9645740000123624,334.6180597940424,0
"147.32.84.165",4541,"46.4.36.120",443,2,122,1,62,1,60,96833.004821,0.027421999999205582,18087.66683737033,17504.19371358419
"147.32.84.165",1200,"66.94.237.64",25,1,62,1,62,0,0,96833.206619,0,0,0
"147.32.96.45",2048,"147.32.84.165",21,3,194,1,74,2,120,490.741756,0.00028099999997266423,0,0
"147.32.96.45",2049,"147.32.84.165",21,3,194,1,74,2,120,492.232811,0.00035799999994878817,0,0
"147.32.96.45",2048,"147.32.84.165",21,3,194,1,74,2,120,588.797695,0.000279999999975189,0,0
"147.32.96.45",2049,"147.32.84.165",21,3,194,1,74,2,120,591.261955,0.0003330000000687505,0,0
"147.32.96.45",2050,"147.32.84.165",21,3,194,1,74,2,120,593.226712,0.00024099999995996768,0,0
"147.32.96.45",2051,"147.32.84.165",21,3,194,1,74,2,120,594.445427,0.0003400000000510772,0,0
"147.32.96.45",2052,"147.32.84.165",21,3,194,1,74,2,120,595.695837,0.00027499999998781277,0,0
"147.32.96.45",2049,"147.32.84.165",21,3,194,1,74,2,120,890.575651,0.00026700000000801083,0,0
"147.32.96.45",2050,"147.32.84.165",21,3,194,1,74,2,120,896.569872,0.00011599999993450183,0,0
"147.32.96.45",2051,"147.32.84.165",21,3,194,1,74,2,120,899.629649,0.0002870000000712025,0,0
"147.32.96.45",2049,"147.32.84.165",21,3,194,1,74,2,120,1070.294551,0.000293000000056054,0,0
"147.32.96.45",2050,"147.32.84.165",21,3,194,1,74,2,120,1077.78757,0.000293000000056054,0,0
"147.32.96.45",2051,"147.32.84.165",21,3,194,1,74,2,120,1090.305648,0.00027299999987917545,0,0
"147.32.96.45",2048,"147.32.84.165",21,3,194,1,74,2,120,1339.594239,0.00032499999997526174,0,0
"147.32.96.45",2049,"147.32.84.165",21,3,194,1,74,2,120,1341.078879,0.0002620000000206346,0,0
"147.32.96.45",2048,"147.32.84.165",21,3,194,1,74,2,120,2778.659361,0.000266999999894324,0,0
"147.32.96.45",2049,"147.32.84.165",21,3,194,1,74,2,120,2780.138097,0.00027199999976801337,0,0
"147.32.96.45",2048,"147.32.84.165",21,3,194,1,74,2,120,2948.17981,0.0009439999998903659,0,0
"147.32.96.45",2049,"147.32.84.165",21,3,194,1,74,2,120,2949.678335,0.00027499999987412593,0,0
"147.32.96.45",2048,"147.32.84.165",21,3,194,1,74,2,120,3229.535472,0.00028500000007625204,0,0
"147.32.96.45",2048,"147.32.84.165",21,3,194,1,74,2,120,3292.982891,0.00024399999983870657,0,0
"147.32.96.45",2048,"147.32.84.165",21,3,194,1,74,2,120,3352.099029,0.00025899999991452205,0,0
"147.32.96.45",2049,"147.32.84.165",21,3,194,1,74,2,120,3353.238407,0.00016000000005078618,0,0
"147.32.96.45",2050,"147.32.84.165",21,3,194,1,74,2,120,3354.482391,0.00022099999978308915,0,0
"147.32.96.45",2051,"147.32.84.165",21,3,194,1,74,2,120,3355.641715,0.00023599999985890463,0,0
"147.32.96.45",2052,"147.32.84.165",21,3,194,1,74,2,120,3357.637742,0.00026800000023285975,0,0
"147.32.96.45",2053,"147.32.84.165",21,3,194,1,74,2,120,3368.145683,0.0002529999997022969,0,0
"147.32.96.45",2049,"147.32.84.165",21,3,194,1,74,2,120,3413.488453,0.00028699999984382885,0,0
"147.32.96.45",2050,"147.32.84.165",21,3,194,1,74,2,120,3414.987864,0.00024699999994481914,0,0
"147.32.96.45",2051,"147.32.84.165",21,3,194,1,74,2,120,3424.470459,0.00027000000000043656,0,0
"147.32.96.45",2052,"147.32.84.165",21,3,194,1,74,2,120,3427.471899,0.00023599999985890463,0,0
"147.32.96.45",2048,"147.32.84.165",21,3,194,1,74,2,120,4076.092198,0.0002899999999499414,0,0
"147.32.96.45",2049,"147.32.84.165",21,3,194,1,74,2,120,4077.567913,0.00030800000013186946,0,0
"147.32.96.45",2050,"147.32.84.165",21,3,194,1,74,2,120,4079.069821,0.00021999999989930075,0,0
"147.32.96.45",2051,"147.32.84.165",21,3,194,1,74,2,120,4080.363678,0.0002559999998084095,0,0
"147.32.96.45",2052,"147.32.84.165",21,3,194,1,74,2,120,4081.518725,0.00038500000027852366,0,0
"147.32.96.45",2048,"147.32.84.165",21,3,194,1,74,2,120,4250.76676,0.0002749999994193786,0,0
"147.32.96.45",2049,"147.32.84.165",21,3,194,1,74,2,120,4254.131485,0.00026900000011664815,0,0
"147.32.96.45",2050,"147.32.84.165",21,3,194,1,74,2,120,4255.625707,0.0003329999999550637,0,0
"147.32.96.45",2048,"147.32.84.165",21,3,194,1,74,2,120,4336.836925,0.00029100000028847717,0,0
"147.32.96.45",2049,"147.32.84.165",21,3,194,1,74,2,120,4339.82563,0.00022399999943445437,0,0
"147.32.96.45",2049,"147.32.84.165",21,3,194,1,74,2,120,4393.332996,0.00022400000034394907,0,0
"147.32.96.45",2050,"147.32.84.165",21,3,194,1,74,2,120,4398.808094,0.0003020000003743917,0,0
"147.32.96.45",2048,"147.32.84.165",21,3,194,1,74,2,120,5214.287812,0.5141730000004827,1151.3634515998394,1867.0758674591991
"147.32.96.45",2049,"147.32.84.165",21,3,194,1,74,2,120,5216.123511,0.0002610000001368462,0,0
"147.32.96.45",2050,"147.32.84.165",21,3,194,1,74,2,120,5217.274298,0.0002749999994193786,0,0
"147.32.96.45",2051,"147.32.84.165",21,3,194,1,74,2,120,5219.292378,0.00023299999975279206,0,0
"147.32.96.45",2048,"147.32.84.165",21,3,194,1,74,2,120,5473.02305,0.0003210000004401081,0,0
"147.32.96.45",2049,"147.32.84.165",21,3,194,1,74,2,120,5478.076555,0.00022000000080879545,0,0
"147.32.96.45",2048,"147.32.84.165",21,3,194,1,74,2,120,5571.014574,0.0002300000005561742,0,0
"147.32.96.45",2049,"147.32.84.165",21,3,194,1,74,2,120,5572.558905,0.00024200000007112976,0,0
"147.32.96.45",2048,"147.32.84.165",21,3,194,1,74,2,120,6015.167961,0.0003010000000358559,0,0
"147.32.96.45",2048,"147.32.84.165",21,3,194,1,74,2,120,6597.66757,0.00027800000043498585,0,0
"147.32.96.45",2048,"147.32.84.165",21,3,194,1,74,2,120,6964.160806,0.0003080000005866168,0,0
"147.32.96.45",2049,"147.32.84.165",21,3,194,1,74,2,120,6974.200168,0.000323999999636726,0,0
"147.32.96.45",2048,"147.32.84.165",21,3,194,1,74,2,120,7549.127889,0.00023599999985890463,0,0
"147.32.96.45",2049,"147.32.84.165",21,3,194,1,74,2,120,7550.521044,0.00025600000026315683,0,0
"147.32.96.45",2049,"147.32.84.165",21,3,194,1,74,2,120,7914.020331,0.00024500000017724233,0,0
"147.32.96.45",2049,"147.32.84.165",21,3,194,1,74,2,120,7993.779793,0.0002720000002227607,0,0
"147.32.96.45",2049,"147.32.84.165",21,3,194,1,74,2,120,8051.97518,0.00011999999969702912,0,0
"147.32.96.45",2050,"147.32.84.165",21,3,194,1,74,2,120,8053.471527,0.0002770000000964501,0,0
"147.32.96.45",2051,"147.32.84.165",21,3,194,1,74,2,120,8054.834492,0.00029600000016216654,0,0
"147.32.96.45",2052,"147.32.84.165",21,3,194,1,74,2,120,8055.908734,0.00027800000043498585,0,0
"147.32.96.45",2048,"147.32.84.165",21,3,194,1,74,2,120,8130.842655,0.0002589999994597747,0,0
"147.32.96.45",2049,"147.32.84.165",21,3,194,1,74,2,120,8134.834148,0.0002700000004551839,0,0
"147.32.96.45",2048,"147.32.84.165",21,3,194,1,74,2,120,9520.567251,0.0002659999991010409,0,0
"147.32.96.45",2049,"147.32.84.165",21,3,194,1,74,2,120,9525.563577,0.00027299999965180177,0,0
"147.32.96.45",2050,"147.32.84.165",21,3,194,1,74,2,120,9714.289854,0.0002839999997377163,0,0
"147.32.96.45",2051,"147.32.84.165",21,3,194,1,74,2,120,9716.14119,0.00029600000016216654,0,0
"147.32.96.45",2052,"147.32.84.165",21,3,194,1,74,2,120,9717.332648,0.0002949999998236308,0,0
"147.32.96.45",2053,"147.32.84.165",21,3,194,1,74,2,120,9733.340816,0.00027399999999033753,0,0
"147.32.96.45",2054,"147.32.84.165",21,3,194,1,74,2,120,9734.844329,0.00027800000134448055,0,0
"147.32.96.45",2055,"147.32.84.165",21,3,194,1,74,2,120,9738.894254,0.000271999999313266,0,0
"147.32.96.45",2056,"147.32.84.165",21,3,194,1,74,2,120,9827.983118,0.00025300000015704427,0,0
"147.32.96.45",2057,"147.32.84.165",21,3,194,1,74,2,120,9833.976782,0.0002920000006270129,0,0
"147.32.96.45",2058,"147.32.84.165",21,3,194,1,74,2,120,9835.482992,0.00024000000121304765,0,0
"147.32.96.45",2059,"147.32.84.165",21,3,194,1,74,2,120,9847.977718,0.0002569999996921979,0,0
"147.32.96.45",2060,"147.32.84.165",21,3,194,1,74,2,120,9849.034085,0.0002660000009200303,0,0
"147.32.96.45",2061,"147.32.84.165",21,3,194,1,74,2,120,9858.022303,0.00024699999994481914,0,0
"147.32.96.45",2062,"147.32.84.165",21,3,194,1,74,2,120,9863.072228,0.000271999999313266,0,0
"147.32.96.45",2063,"147.32.84.165",21,3,194,1,74,2,120,9864.567322,0.0003299999989394564,0,0
"147.32.96.45",2064,"147.32.84.165",21,3,194,1,74,2,120,9886.069282,0.0002970000005007023,0,0
"147.32.96.45",2065,"147.32.84.165",21,3,194,1,74,2,120,9889.621371,0.00026000000070780516,0,0
"147.32.96.45",2066,"147.32.84.165",21,3,194,1,74,2,120,9898.622977,0.0003009999982168665,0,0
"147.32.96.45",2067,"147.32.84.165",21,3,194,1,74,2,120,9905.116029,0.17792299999928218,3327.282026508031,5395.592475418429
"147.32.96.45",2068,"147.32.84.165",21,3,194,1,74,2,120,9907.624481,0.0002879999992728699,0,0
"147.32.96.45",2069,"147.32.84.165",21,3,194,1,74,2,120,9910.113607,0.00026000000070780516,0,0
"147.32.96.45",2070,"147.32.84.165",21,3,194,1,74,2,120,9911.61965,0.0009509999999863794,0,0
"147.32.96.45",2071,"147.32.84.165",21,3,194,1,74,2,120,9913.119964,0.00010600000132399146,0,0
"147.32.96.45",2072,"147.32.84.165",21,3,194,1,74,2,120,9915.114681,0.00012100000094505958,0,0
"147.32.96.45",2073,"147.32.84.165",21,3,194,1,74,2,120,9920.122606,0.0002879999992728699,0,0
"147.32.96.45",2074,"147.32.84.165",21,3,194,1,74,2,120,9921.622436,0.00010900000052060932,0,0
"147.32.96.45",2075,"147.32.84.165",21,3,194,1,74,2,120,9924.120775,0.00021800000104121864,0,0
"147.32.96.45",2076,"147.32.84.165",21,3,194,1,74,2,120,9925.669837,0.0002970000005007023,0,0
"147.32.96.45",2077,"147.32.84.165",21,3,194,1,74,2,120,9929.163647,0.00021300000116752926,0,0
"147.32.96.45",2078,"147.32.84.165",21,3,194,1,74,2,120,9932.667891,0.00021400000150606502,0,0
"147.32.96.45",2079,"147.32.84.165",21,3,194,1,74,2,120,9940.668289,0.00026200000138487667,0,0
"147.32.96.45",2080,"147.32.84.165",21,3,194,1,74,2,120,9942.664411,0.00023499999952036887,0,0
"147.32.96.45",2081,"147.32.84.165",21,3,194,1,74,2,120,9958.660219,0.00032699999974283855,0,0
"147.32.96.45",2082,"147.32.84.165",21,3,194,1,74,2,120,9960.165485,0.0003310000010969816,0,0
"147.32.96.45",2083,"147.32.84.165",21,3,194,1,74,2,120,9962.167347,0.00024899999880290125,0,0
"147.32.96.45",2084,"147.32.84.165",21,3,194,1,74,2,120,9963.258545,0.00033599999915168155,0,0
"147.32.96.45",2085,"147.32.84.165",21,3,194,1,74,2,120,9965.264403,0.0003100000012636883,0,0
"147.32.96.45",2086,"147.32.84.165",21,3,194,1,74,2,120,9991.255431,0.0002080000012938399,0,0
"147.32.96.45",2087,"147.32.84.165",21,3,194,1,74,2,120,9992.767227,0.0002949999998236308,0,0
"147.32.96.45",2088,"147.32.84.165",21,3,194,1,74,2,120,10001.806782,0.00030300000071292743,0,0
"147.32.96.45",2089,"147.32.84.165",21,3,194,1,74,2,120,10072.858128,0.00020700000095530413,0,0
"147.32.96.45",2090,"147.32.84.165",21,3,194,1,74,2,120,10075.908286,0.0002640000002429588,0,0
"147.32.96.45",2091,"147.32.84.165",21,3,194,1,74,2,120,10715.193773,0.00027999999838357326,0,0
"147.32.96.45",2092,"147.32.84.165",21,3,194,1,74,2,120,10716.69569,0.0003369999994902173,0,0
"147.32.96.45",2093,"147.32.84.165",21,3,194,1,74,2,120,10736.189894,0.0002610000010463409,0,0
"147.32.96.45",2094,"147.32.84.165",21,3,194,1,74,2,120,10762.742976,0.00023300000066228677,0,0
"147.32.96.45",2095,"147.32.84.165",21,3,194,1,74,2,120,10780.239763,0.00026700000125856604,0,0
"147.32.96.45",2096,"147.32.84.165",21,3,194,1,74,2,120,10850.329615,0.0002919999988080235,0,0
"147.32.96.45",2097,"147.32.84.165",21,3,194,1,74,2,120,10851.831648,0.00028300000121816993,0,0
"147.32.96.45",2098,"147.32.84.165",21,3,194,1,74,2,120,10855.330447,0.00025999999888881575,0,0
"147.32.96.45",2099,"147.32.84.165",21,3,194,1,74,2,120,10856.82083,0.00021399999968707561,0,0
"147.32.96.45",2100,"147.32.84.165",21,3,194,1,74,2,120,10858.330947,0.0002229999990959186,0,0
"147.32.96.45",2101,"147.32.84.165",21,3,194,1,74,2,120,10860.332942,0.00027100000079371966,0,0
"147.32.96.45",2102,"147.32.84.165",21,3,194,1,74,2,120,11030.561781,0.000210000000151922,0,0
"147.32.96.45",2103,"147.32.84.165",21,3,194,1,74,2,120,11128.204911,0.000240999999732594,0,0
"147.32.96.45",2104,"147.32.84.165",21,3,194,1,74,2,120,11214.794411,0.00027599999884841964,0,0
"147.32.96.45",2105,"147.32.84.165",21,3,194,1,74,2,120,11217.282753,0.00028500000007625204,0,0
"147.32.96.45",2106,"147.32.84.165",21,3,194,1,74,2,120,11555.713827,0.00028000000020256266,0,0
"147.32.96.45",2107,"147.32.84.165",21,3,194,1,74,2,120,11557.701309,0.00022899999930814374,0,0
"147.32.96.45",2108,"147.32.84.165",21,3,194,1,74,2,120,11780.487513,0.0003010000000358559,0,0
"147.32.96.45",2109,"147.32.84.165",21,3,194,1,74,2,120,11839.028383,0.0002879999992728699,0,0
"147.32.96.45",2110,"147.32.84.165",21,3,194,1,74,2,120,11852.080428,0.00022200000057637226,0,0
"147.32.96.45",2111,"147.32.84.165",21,3,194,1,74,2,120,11878.628655,0.0002659999991010409,0,0
"147.32.96.45",2112,"147.32.84.165",21,3,194,1,74,2,120,13166.203118,0.0003020000003743917,0,0
"147.32.96.45",2113,"147.32.84.165",21,3,194,1,74,2,120,13193.739424,0.0002700000004551839,0,0
"147.32.96.45",2114,"147.32.84.165",21,3,194,1,74,2,120,13196.239857,0.00021500000002561137,0,0
"147.32.96.45",2115,"147.32.84.165",21,3,194,1,74,2,120,14001.219018,0.00028500000007625204,0,0
"147.32.96.45",2116,"147.32.84.165",21,3,194,1,74,2,120,14002.565569,0.0003309999992779922,0,0
"147.32.96.45",2117,"147.32.84.165",21,3,194,1,74,2,120,14003.865995,0.0002769999991869554,0,0
"147.32.96.45",2118,"147.32.84.165",21,3,194,1,74,2,120,14014.86743,0.0003329999999550637,0,0
"147.32.96.45",2119,"147.32.84.165",21,3,194,1,74,2,120,14027.902707,0.0002610000010463409,0,0
"147.32.96.45",2120,"147.32.84.165",21,3,194,1,74,2,120,14050.411099,0.0003679999990708893,0,0
"147.32.96.45",2121,"147.32.84.165",21,3,194,1,74,2,120,14052.913825,0.0002770000010059448,0,0
"147.32.96.45",2122,"147.32.84.165",21,3,194,1,74,2,120,14094.506862,0.00023800000053597614,0,0
"147.32.96.45",2123,"147.32.84.165",21,3,194,1,74,2,120,14099.510907,0.0002750000003288733,0,0
"147.32.96.45",2124,"147.32.84.165",21,3,194,1,74,2,120,14101.005976,0.0002839999997377163,0,0
"147.32.96.45",2125,"147.32.84.165",21,3,194,1,74,2,120,14178.098273,0.00028300000121816993,0,0
"147.32.96.45",2126,"147.32.84.165",21,3,194,1,74,2,120,14222.650709,0.00023099999998521525,0,0
"147.32.96.45",2127,"147.32.84.165",21,3,194,1,74,2,120,14231.642336,0.00028500000007625204,0,0
"147.32.96.45",2128,"147.32.84.165",21,3,194,1,74,2,120,14233.643895,0.0003420000011828961,0,0
"147.32.96.45",2129,"147.32.84.165",21,3,194,1,74,2,120,14240.642666,0.0002860000004147878,0,0
"147.32.96.45",2130,"147.32.84.165",21,3,194,1,74,2,120,14244.183338,0.0002749999985098839,0,0
"147.32.96.45",2131,"147.32.84.165",21,3,194,1,74,2,120,14245.534768,0.0003660000002128072,0,0
"147.32.96.45",2132,"147.32.84.165",21,3,194,1,74,2,120,14247.542219,0.00031799999851500615,0,0
"147.32.96.45",2133,"147.32.84.165",21,3,194,1,74,2,120,14249.541682,0.0002680000015971018,0,0
"147.32.96.45",2134,"147.32.84.165",21,3,194,1,74,2,120,14251.540441,0.00030300000071292743,0,0
"147.32.96.45",2135,"147.32.84.165",21,3,194,1,74,2,120,14253.53206,0.0003390000001672888,0,0
"147.32.96.45",2136,"147.32.84.165",21,3,194,1,74,2,120,14257.531774,0.0002970000005007023,0,0
"147.32.96.45",2137,"147.32.84.165",21,3,194,1,74,2,120,14259.541273,0.00024699999994481914,0,0
"147.32.96.45",2138,"147.32.84.165",21,3,194,1,74,2,120,14261.540128,0.00025899999855028,0,0
"147.32.96.45",2139,"147.32.84.165",21,3,194,1,74,2,120,14271.539655,0.0003129999986413168,0,0
"147.32.96.45",2140,"147.32.84.165",21,3,194,1,74,2,120,14274.181581,0.00028899999961140566,0,0
"147.32.96.45",2141,"147.32.84.165",21,3,194,1,74,2,120,14275.538343,0.0002989999993587844,0,0
"147.32.96.45",2142,"147.32.84.165",21,3,194,1,74,2,120,14291.587461,0.0003240000005462207,0,0
"147.32.96.45",2143,"147.32.84.165",21,3,194,1,74,2,120,14293.586702,0.00025599999935366213,0,0
"147.32.96.45",2144,"147.32.84.165",21,3,194,1,74,2,120,14295.586399,0.00034500000037951395,0,0
"147.32.96.45",2145,"147.32.84.165",21,3,194,1,74,2,120,14297.586339,0.0003620000006776536,0,0
"147.32.96.45",2146,"147.32.84.165",21,3,194,1,74,2,120,14299.579339,0.00017300000035902485,0,0
"147.32.96.45",2147,"147.32.84.165",21,3,194,1,74,2,120,14305.586304,0.0002480000002833549,0,0
"147.32.96.45",2148,"147.32.84.165",21,3,194,1,74,2,120,14323.633909,0.0002789999998640269,0,0
"147.32.96.45",2149,"147.32.84.165",21,3,194,1,74,2,120,14325.635441,0.00031099999978323467,0,0
"147.32.96.45",2150,"147.32.84.165",21,3,194,1,74,2,120,14327.635512,0.00029600000016216654,0,0
"147.32.96.45",2151,"147.32.84.165",21,3,194,1,74,2,120,14329.633086,0.0003680000008898787,0,0
"147.32.96.45",2152,"147.32.84.165",21,3,194,1,74,2,120,14330.878557,0.00024300000040966552,0,0
"147.32.96.45",2153,"147.32.84.165",21,3,194,1,74,2,120,14332.884452,0.0002769999991869554,0,0
"147.32.96.45",2154,"147.32.84.165",21,3,194,1,74,2,120,14334.884466,0.00028700000075332355,0,0
"147.32.96.45",2155,"147.32.84.165",21,3,194,1,74,2,120,14336.885626,0.00028300000121816993,0,0
"147.32.96.45",2156,"147.32.84.165",21,3,194,1,74,2,120,14338.884566,0.00028500000007625204,0,0
"147.32.96.45",2157,"147.32.84.165",21,3,194,1,74,2,120,14341.531776,0.00034299999970244244,0,0
"147.32.96.45",2158,"147.32.84.165",21,3,194,1,74,2,120,14342.832037,0.0002389999990555225,0,0
"147.32.96.45",2159,"147.32.84.165",21,3,194,1,74,2,120,14344.172661,0.0002929999991465593,0,0
"147.32.96.45",2160,"147.32.84.165",21,3,194,1,74,2,120,14345.532369,0.00030299999889393803,0,0
"147.32.96.45",2161,"147.32.84.165",21,3,194,1,74,2,120,14346.832503,0.0002930000009655487,0,0
"147.32.96.45",2162,"147.32.84.165",21,3,194,1,74,2,120,14350.834258,0.00030199999855540227,0,0
"147.32.96.45",2163,"147.32.84.165",21,3,194,1,74,2,120,14354.171614,0.0002859999985957984,0,0
"147.32.96.45",2164,"147.32.84.165",21,3,194,1,74,2,120,14355.53135,0.000262999999904423,0,0
"147.32.96.45",2165,"147.32.84.165",21,3,194,1,74,2,120,14357.580245,0.00027399999999033753,0,0
"147.32.96.45",2166,"147.32.84.165",21,3,194,1,74,2,120,14359.579782,0.00028699999893433414,0,0
"147.32.96.45",2167,"147.32.84.165",21,3,194,1,74,2,120,14361.571589,0.0002120000008289935,0,0
"147.32.96.45",2168,"147.32.84.165",21,3,194,1,74,2,120,14365.581466,0.0003169999999954598,0,0
"147.32.96.45",2169,"147.32.84.165",21,3,194,1,74,2,120,14367.580341,0.0003169999999954598,0,0
"147.32.96.45",2170,"147.32.84.165",21,3,194,1,74,2,120,14369.584495,0.0003120000001217704,0,0
"147.32.96.45",2171,"147.32.84.165",21,3,194,1,74,2,120,14371.578839,0.00028000000020256266,0,0
"147.32.96.45",2172,"147.32.84.165",21,3,194,1,74,2,120,14374.228515,0.0002519999998185085,0,0
"147.32.96.45",2173,"147.32.84.165",21,3,194,1,74,2,120,14376.872363,0.00029399999948509503,0,0
"147.32.96.45",2174,"147.32.84.165",21,3,194,1,74,2,120,14386.875786,0.00023999999939405825,0,0
"147.32.96.45",2175,"147.32.84.165",21,3,194,1,74,2,120,14388.227268,0.00022399999943445437,0,0
"147.32.96.45",2176,"147.32.84.165",21,3,194,1,74,2,120,14396.278711,0.00035199999911128543,0,0
"147.32.96.45",2177,"147.32.84.165",21,3,194,1,74,2,120,14400.276981,0.0003209999995306134,0,0
"147.32.96.45",2178,"147.32.84.165",21,3,194,1,74,2,120,14402.276428,0.00029100000028847717,0,0
"147.32.96.45",2179,"147.32.84.165",21,3,194,1,74,2,120,14404.277867,0.00027599999884841964,0,0
"147.32.96.45",2180,"147.32.84.165",21,3,194,1,74,2,120,14406.275997,0.00028199999906064477,0,0
"147.32.96.45",2181,"147.32.84.165",21,3,194,1,74,2,120,14408.277274,0.00031599999965692405,0,0
"147.32.96.45",2182,"147.32.84.165",21,3,194,1,74,2,120,14410.277052,0.00017300000035902485,0,0
"147.32.96.45",2183,"147.32.84.165",21,3,194,1,74,2,120,14414.275135,0.00023599999985890463,0,0
"147.32.96.45",2184,"147.32.84.165",21,3,194,1,74,2,120,14416.275145,0.0003550000001268927,0,0
"147.32.96.45",2185,"147.32.84.165",21,3,194,1,74,2,120,14418.274961,0.00030700000024808105,0,0
"147.32.96.45",2186,"147.32.84.165",21,3,194,1,74,2,120,14419.576049,0.0003620000006776536,0,0
"147.32.96.45",2187,"147.32.84.165",21,3,194,1,74,2,120,14421.576156,0.0003329999999550637,0,0
"147.32.96.45",2188,"147.32.84.165",21,3,194,1,74,2,120,14423.577217,0.00031400000079884194,0,0
"147.32.96.45",2189,"147.32.84.165",21,3,194,1,74,2,120,14424.87462,0.000271999999313266,0,0
"147.32.96.45",2190,"147.32.84.165",21,3,194,1,74,2,120,14513.513437,0.00034500000037951395,0,0
"147.32.96.45",2191,"147.32.84.165",21,3,194,1,74,2,120,14593.096745,0.0003129999986413168,0,0
"147.32.96.45",2192,"147.32.84.165",21,3,194,1,74,2,120,14594.607084,0.0001740000006975606,0,0
"147.32.96.45",2193,"147.32.84.165",21,3,194,1,74,2,120,14870.43459,0.00010199999996984843,0,0
"147.32.96.45",2194,"147.32.84.165",21,3,194,1,74,2,120,14878.92849,0.00023599999985890463,0,0
"147.32.96.45",2195,"147.32.84.165",21,3,194,1,74,2,120,15028.114134,0.00025100000129896216,0,0
"147.32.96.45",2196,"147.32.84.165",21,3,194,1,74,2,120,15569.813273,1.2086899999994785,489.78646303043416,794.2483184277311
"147.32.96.45",2197,"147.32.84.165",21,3,194,1,74,2,120,15640.900198,0.0002660000009200303,0,0
"147.32.96.45",2198,"147.32.84.165",21,3,222,3,222,0,0,17253.897691,9.089872000000469,195.38228921154317,0
"147.32.96.45",2048,"147.32.84.165",21,2,134,1,74,1,60,87523.846426,0.0001269999920623377,0,0
"147.32.96.45",2048,"147.32.84.165",21,2,134,1,74,1,60,89084.538801,0.0003389999910723418,0,0
"147.32.96.45",2049,"147.32.84.165",21,2,134,1,74,1,60,89113.450738,0.00019299999985378236,0,0
"147.32.96.45",2048,"147.32.84.165",21,2,134,1,74,1,60,89145.848014,0.0002629999944474548,0,0
"147.32.96.45",2049,"147.32.84.165",21,2,134,1,74,1,60,89146.265635,0.00023299999884329736,0,0
"147.32.96.45",2050,"147.32.84.165",21,2,134,1,74,1,60,89150.769089,0.000295000005280599,0,0
"147.32.96.45",2051,"147.32.84.165",21,2,134,1,74,1,60,89175.31494,0.0002519999979995191,0,0
"147.32.96.45",2049,"147.32.84.165",21,2,134,1,74,1,60,89534.205639,0.00020199999562464654,0,0
"147.32.96.45",2050,"147.32.84.165",21,2,134,1,74,1,60,89536.21581,0.0002640000020619482,0,0
"147.32.96.45",2048,"147.32.84.165",21,2,134,1,74,1,60,89565.920899,0.00024399999529123306,0,0
"147.32.96.45",2049,"147.32.84.165",21,2,134,1,74,1,60,89568.425493,0.00020199999562464654,0,0
"147.32.96.45",2050,"147.32.84.165",21,2,134,1,74,1,60,89570.908186,0.0002539999986765906,0,0
"147.32.96.45",2051,"147.32.84.165",21,2,134,1,74,1,60,89577.426005,0.00026699999580159783,0,0
"147.32.96.45",2052,"147.32.84.165",21,2,134,1,74,1,60,89586.474476,0.00025499999173916876,0,0
"147.32.96.45",2049,"147.32.84.165",21,2,134,1,74,1,60,89624.347418,0.00027099999715574086,0,0
"147.32.96.45",2049,"147.32.84.165",21,2,134,1,74,1,60,89818.664098,0.00024500000290572643,0,0
"147.32.96.45",2050,"147.32.84.165",21,2,134,1,74,1,60,89821.664109,0.00029099998937454075,0,0
"147.32.96.45",2048,"147.32.84.165",21,2,134,1,74,1,60,89868.177263,0.0002410000015515834,0,0
"147.32.96.45",2049,"147.32.84.165",21,2,134,1,74,1,60,89871.685331,0.00023999999393709004,0,0
"147.32.96.45",2048,"147.32.84.165",21,2,134,1,74,1,60,89926.17211,0.0002390000008745119,0,0
"147.32.96.45",2048,"147.32.84.165",21,2,134,1,74,1,60,89984.78418,0.00023599999258294702,0,0
"147.32.96.45",2049,"147.32.84.165",21,2,134,1,74,1,60,90065.829274,0.0002339999919058755,0,0
"147.32.96.45",2050,"147.32.84.165",21,2,134,1,74,1,60,90069.817623,0.00026000000070780516,0,0
"147.32.96.45",2051,"147.32.84.165",21,2,134,1,74,1,60,90073.834071,0.00027299999783281237,0,0
"147.32.96.45",2048,"147.32.84.165",21,2,134,1,74,1,60,90164.279315,0.0002469999890308827,0,0
"147.32.96.45",2048,"147.32.84.165",21,2,134,1,74,1,60,90298.48189,0.0002410000015515834,0,0
"147.32.96.45",2049,"147.32.84.165",21,2,134,1,74,1,60,90300.478856,0.0002769999991869554,0,0
"147.32.96.45",2048,"147.32.84.165",21,2,134,1,74,1,60,91716.953648,0.00022500001068692654,0,0
"147.32.96.45",2048,"147.32.84.165",21,2,134,1,74,1,60,92077.794025,0.00022899999748915434,0,0
"147.32.96.45",2048,"147.32.84.165",21,2,134,1,74,1,60,92138.583595,0.00027299999783281237,0,0
"147.32.96.45",2049,"147.32.84.165",21,2,134,1,74,1,60,92380.597647,0.0002969999914057553,0,0
"147.32.96.45",2050,"147.32.84.165",21,2,134,1,74,1,60,92388.088349,0.0002280000044265762,0,0
"147.32.96.45",2048,"147.32.84.165",21,2,134,1,74,1,60,92452.563286,0.0002879999956348911,0,0
"147.32.96.45",2049,"147.32.84.165",21,2,134,1,74,1,60,92461.602928,0.00021500000730156898,0,0
"147.32.96.45",2050,"147.32.84.165",21,2,134,1,74,1,60,92466.085486,0.0002530000056140125,0,0
"147.32.96.45",2049,"147.32.84.165",21,2,134,1,74,1,60,92742.932618,0.0002429999876767397,0,0
"147.32.96.45",2050,"147.32.84.165",21,2,134,1,74,1,60,92746.934561,0.0002769999991869554,0,0
"147.32.96.45",2049,"147.32.84.165",21,2,134,1,74,1,60,93123.59081,0.00010400000610388815,0,0
"147.32.96.45",2049,"147.32.84.165",21,2,134,1,74,1,60,93777.086875,0.0002460000105202198,0,0
"147.32.96.45",2050,"147.32.84.165",21,2,134,1,74,1,60,93783.135717,0.0002300000051036477,0,0
"147.32.96.45",2049,"147.32.84.165",21,2,134,1,74,1,60,94072.017471,0.00024399999529123306,0,0
"147.32.96.45",2049,"147.32.84.165",21,2,134,1,74,1,60,94116.685095,0.00024700000358279794,0,0
"147.32.96.45",2050,"147.32.84.165",21,2,134,1,74,1,60,94118.282637,0.0002390000008745119,0,0
"147.32.96.45",2051,"147.32.84.165",21,2,134,1,74,1,60,94120.183521,0.00024300000222865492,0,0
"147.32.96.45",2052,"147.32.84.165",21,2,134,1,74,1,60,94130.171984,0.0003440000000409782,0,0
"147.32.96.45",2053,"147.32.84.165",21,2,134,1,74,1,60,94132.174858,0.00024000000848900527,0,0
"147.32.96.45",2054,"147.32.84.165",21,2,134,1,74,1,60,94133.472235,0.00025800000003073364,0,0
"147.32.96.45",2055,"147.32.84.165",21,2,134,1,74,1,60,94134.637131,0.00026300000899937004,0,0
"147.32.96.45",2048,"147.32.84.165",21,2,134,1,74,1,60,94671.007344,0.00022499999613501132,0,0
"147.32.96.45",2049,"147.32.84.165",21,2,134,1,74,1,60,94672.479171,0.4137710000068182,1430.743092169932,1160.0619666242692
"147.32.96.45",2050,"147.32.84.165",21,2,134,1,74,1,60,94673.9817,0.00027299999783281237,0,0
"147.32.96.45",2051,"147.32.84.165",21,2,134,1,74,1,60,94676.492626,0.000311999989207834,0,0
"147.32.96.45",2048,"147.32.84.165",21,2,134,1,74,1,60,95887.002477,0.00013499999477062374,0,0
"147.32.96.45",2049,"147.32.84.165",21,2,134,1,74,1,60,95888.498089,0.0002459999959683046,0,0
"147.32.96.45",2050,"147.32.84.165",21,2,134,1,74,1,60,95891.247469,0.0002539999986765906,0,0
"147.32.96.45",2051,"147.32.84.165",21,2,134,1,74,1,60,95893.24711,0.00023800000781193376,0,0
"147.32.96.45",2052,"147.32.84.165",21,2,134,1,74,1,60,95895.14117,0.00027099999715574086,0,0
"147.32.96.45",2053,"147.32.84.165",21,2,134,1,74,1,60,95896.238111,0.00018000000272877514,0,0
"147.32.96.45",2054,"147.32.84.165",21,2,134,1,74,1,60,95898.794523,0.00028500000189524144,0,0
"178.121.31.113",25837,"147.32.84.165",4084,1,60,1,60,0,0,89387.589426,0,0,0
"178.122.100.224",13825,"147.32.84.165",3841,1,60,1,60,0,0,85605.365836,0,0,0
"178.122.100.224",13838,"147.32.84.165",3841,1,60,1,60,0,0,85608.373674,0,0,0
"178.123.29.226",13741,"147.32.84.165",1477,1,60,1,60,0,0,854.364673,0,0,0
"178.123.29.226",13755,"147.32.84.165",1477,1,60,1,60,0,0,857.368753,0,0,0
"178.123.29.226",13792,"147.32.84.165",1477,1,60,1,60,0,0,863.376681,0,0,0
"178.123.29.226",23643,"147.32.84.165",4460,1,60,1,60,0,0,3113.823996,0,0,0
"178.123.248.251",21928,"147.32.84.165",2019,1,60,1,60,0,0,85247.689442,0,0,0
"178.123.248.251",21940,"147.32.84.165",2019,1,60,1,60,0,0,85250.653991,0,0,0
"178.123.248.251",25846,"147.32.84.165",1493,1,60,1,60,0,0,86177.605951,0,0,0
"188.205.231.61",38349,"147.32.84.165",22,3,194,1,74,2,120,8181.892637,0.0002949999998236308,0,0
"195.113.232.98",80,"147.32.84.165",1039,2,120,1,60,1,60,85143.806836,0.00010799999290611595,0,0
"199.59.163.170",80,"147.32.84.165",63919,2,120,1,60,1,60,85391.663205,0.00010299999848939478,0,0
"199.59.163.170",80,"147.32.84.165",16970,2,120,1,60,1,60,85608.127012,0.00022300001000985503,0,0
"199.59.163.170",80,"147.32.84.165",41993,2,120,1,60,1,60,89316.437181,0.00019700000120792538,0,0
"199.59.163.170",80,"147.32.84.165",26997,2,120,1,60,1,60,92872.348022,0.00022199998784344643,0,0
"199.59.163.170",80,"147.32.84.165",30794,2,120,1,60,1,60,93269.223667,0.00023200000578071922,0,0
"201.217.51.166",2824,"147.32.84.165",4899,9,546,3,186,6,360,13535.931443,1.6292059999996127,913.328332942767,1767.7322573085814
"222.252.117.126",10019,"147.32.84.165",4512,1,60,1,60,0,0,88175.362505,0,0,0
"222.252.117.126",10033,"147.32.84.165",4512,1,60,1,60,0,0,88178.380462,0,0,0
"223.224.40.42",34301,"147.32.84.165",22,2,122,1,62,1,60,92193.727591,0.0002539999986765906,0,0
