"Address A","Port A","Address B","Port B","Packets","Bytes","Packets A → B","Bytes A → B","Packets B → A","Bytes B → A","Rel Start","Duration","Bits/s A → B","Bits/s B → A"
"1.36.164.194",7600,"147.32.84.165",7600,6,749,2,249,4,500,238.613317,0.35909300000000144,5547.30947136255,11139.175645306324
"1.53.87.72",55000,"147.32.84.192",31037,3,825,1,145,2,680,3648.14322,0.11076200000024983,10472.905870220686,49114.31718448322
"1.60.64.147",24452,"147.32.84.191",7600,6,749,2,249,4,500,1413.032427,0.7312729999998737,2724.016885623213,5469.913424946211
"1.60.84.83",40302,"147.32.84.165",7600,925,931460,79,8320,846,923140,2128.256314,7.598037999999633,8760.156240335098,971977.239387373
"1.64.42.249",57106,"147.32.84.191",29676,3,828,1,140,2,688,2190.047452,0.18939399999999296,5913.598107648825,29061.110700445657
"1.64.133.160",56504,"147.32.84.192",31037,3,825,1,145,2,680,1638.455925,0.3004439999999704,3860.952457030642,18106.535660557496
"1.80.103.79",7600,"147.32.84.165",7600,6,749,2,249,4,500,355.232336,1.3495090000000118,1476.0924158341904,2964.0409956509848
"1.87.180.119",7600,"147.32.84.191",7600,249,234642,33,3242,216,231400,2027.201973,9.060822000000144,2862.4334525056984,204308.17424732223
"1.168.198.210",7600,"147.32.84.165",7600,104,94465,14,1413,90,93052,1098.424148,1.1266209999998864,10033.542779693562,660751.0422760405
"1.169.187.35",13827,"147.32.84.192",31037,3,825,1,145,2,680,3409.188233,0.04026700000031269,28807.708545235357,135098.219384552
"1.193.0.187",7600,"147.32.84.192",7600,188,169073,26,2565,162,166508,1521.50729,3.744474999999966,5480.0739756575185,355741.19202291704
"1.194.134.179",16224,"147.32.84.165",7600,6,749,2,249,4,500,1210.714493,1.3077100000000428,1523.2735086524801,3058.782145888514
"1.195.24.155",56410,"147.32.84.191",7600,3,269,1,89,2,180,1465.208833,0.6188290000000052,1150.5601709034224,2326.975626546248
"1.195.77.44",7600,"147.32.84.192",7600,247,230412,35,3404,212,227008,1911.127134,4.669039999999995,5832.462347720308,388958.75811730075
"1.195.252.231",16224,"147.32.84.165",7600,6,749,2,249,4,500,1137.587088,3.6438029999999344,546.6815851460784,1097.7541870403181
"1.202.15.178",15362,"147.32.84.192",7600,6,749,2,249,4,500,2855.225605,0.6497989999998026,3065.563351129511,6155.749701063275
"1.204.134.40",20050,"147.32.84.165",7600,9,1089,3,409,6,680,2623.230304,1.4887319999997999,2197.8435339607395,3654.116388981181
"1.204.200.76",7600,"147.32.84.165",7600,96,87699,12,1235,84,86464,184.403122,4.113997000000012,2401.5574148449723,168136.243171786
"1.212.108.19",50868,"147.32.84.191",29676,1,143,1,143,0,0,3618.20356,0,0,0
"2.0.189.76",34170,"147.32.84.165",32234,3,825,1,145,2,680,3115.490424,0.2541809999997895,4563.677064772586,21402.071752036954
"2.2.61.83",34247,"147.32.84.191",29676,3,825,1,145,2,680,1700.630646,0.0901010000000042,12874.440905205778,60376.688383033994
"2.26.209.70",16788,"147.32.84.165",32234,3,825,1,145,2,680,2784.35386,0.23357499999974607,4966.284919196237,23290.16375898925
"2.27.33.129",24921,"147.32.84.191",29676,9,2475,3,435,6,2040,1546.592231,1766.222593,1.9703065818499583,9.240058452813598
"2.39.126.229",36613,"147.32.84.165",32234,3,825,1,145,2,680,3672.167558,0.0783859999996821,14798.560967579728,69400.14798589113
"2.40.133.48",50225,"147.32.84.192",31037,3,825,1,145,2,680,3060.526912,0.15138000000024476,7662.835249029756,35936.05496096713
"2.49.153.10",24795,"147.32.84.192",31037,3,825,1,145,2,680,720.213247,0.18625899999995,6227.88697459082,29206.642363598326
"2.49.169.223",27575,"147.32.84.191",29676,3,825,1,145,2,680,2117.451882,0.23166100000025835,5007.316725727275,23482.588782721017
"2.50.141.5",14329,"147.32.84.165",32234,3,825,1,145,2,680,289.174224,0.038411999999993895,30198.896178282423,141622.40966366927
"2.51.4.140",36666,"147.32.84.165",32234,6,1650,2,290,4,1360,1893.410282,984.2351980000001,2.3571601632560184,11.054268351821328
"2.51.228.85",47600,"147.32.84.191",29676,1,143,1,143,0,0,1806.128368,0,0,0
"2.60.0.78",1024,"147.32.84.192",31037,3,825,1,145,2,680,3184.212471,0.17153099999995902,6762.625997634696,31714.383988907543
"2.60.192.116",64287,"147.32.84.191",29676,6,1650,2,290,4,1360,1231.46982,1734.9615780000001,1.3372054052484612,6.271032245303129
"2.60.230.43",26833,"147.32.84.165",32234,3,825,1,145,2,680,2538.925409,0.24246900000025562,4784.116732443228,22435.85777973376
"2.61.33.161",1999,"147.32.84.192",31037,3,825,1,145,2,680,889.417221,0.09429199999999582,12302.210155687135,57693.12348873967
"2.83.1.209",50629,"147.32.84.191",29676,3,825,1,145,2,680,3041.730841,0.22673200000008364,5116.17239736593,23993.08434626781
"2.88.16.45",18581,"147.32.84.192",31037,3,825,1,145,2,680,1062.048093,0.2188629999998284,5300.119252687341,24855.73166777512
"2.90.21.10",29639,"147.32.84.165",32234,3,825,1,145,2,680,2983.404212,0.18978199999992285,6112.276190579041,28664.467652370677
"2.90.70.249",40857,"147.32.84.192",31037,3,825,1,145,2,680,2800.351741,0.22693600000002334,5111.573307011143,23971.516198397083
"2.90.142.208",61731,"147.32.84.191",29676,3,825,1,145,2,680,2949.477998,0.25639400000000023,4524.286839785638,21217.345179684373
"2.91.109.69",7600,"147.32.84.192",7600,355,337918,45,4426,310,333492,715.868102,1.9987239999999247,17715.3023629082,1334819.6149143656
"2.91.127.139",39854,"147.32.84.192",31037,3,825,1,145,2,680,1108.509843,0.15310999999996966,7576.252367580366,35530.01110313551
"2.93.195.220",10386,"147.32.84.191",29676,4,1007,2,327,2,680,3361.13639,30.009639999999763,87.17198873428741,181.27508360646922
"2.93.215.208",62964,"147.32.84.192",31037,6,1650,2,290,4,1360,1424.682569,1791.122589,1.2952770593414697,6.074402761049651
"2.94.8.41",3579,"147.32.84.165",32234,1,143,1,143,0,0,1820.844873,0,0,0
"2.94.46.229",63720,"147.32.84.165",32234,3,825,1,145,2,680,2817.62906,0.1691689999997834,6857.0482771754,32157.191920546702
"2.94.77.78",37767,"147.32.84.165",32234,4,1007,2,327,2,680,628.372066,40.11084800000003,65.21926437456516,135.62415833242906
"2.94.85.109",11203,"147.32.84.165",32234,3,825,1,145,2,680,3599.83801,0.2066979999999603,5612.052366255227,26318.59040726589
"2.94.95.224",17890,"147.32.84.165",32234,6,1650,2,290,4,1360,686.335102,1797.611668,1.290601324690556,6.05247517785916
"2.94.200.31",9000,"147.32.84.165",32234,3,825,1,145,2,680,1574.855061,0.09916900000007445,11697.203763264015,54855.85213116918
"2.95.196.142",44146,"147.32.84.165",32234,3,825,1,145,2,680,311.058927,0.2196660000000179,5280.744402865739,24764.8703030945
"2.95.221.50",43518,"147.32.84.192",31037,3,825,1,145,2,680,1561.581185,0.25918499999988853,4475.567644734452,20988.86895461674
"2.100.113.93",44678,"147.32.84.165",32234,3,506,1,148,2,358,1877.02566,0.18538199999989047,6386.812096108034,15449.18061085592
"2.134.9.158",50877,"147.32.84.165",32234,1,143,1,143,0,0,2939.558644,0,0,0
"2.137.11.177",2125,"147.32.84.192",31037,3,825,1,145,2,680,2655.187143,0.1258429999998043,9217.83492130515,43228.46721715518
"2.192.64.147",7600,"147.32.84.191",7600,707,695952,73,7398,634,688554,848.759814,7.564609000000019,7823.801600320632,728184.6292386013
"2.193.61.137",32902,"147.32.84.165",32234,3,825,1,145,2,680,427.651603,0.16924099999999953,6854.131091165871,32143.511324088224
"2.226.26.11",58041,"147.32.84.191",29676,6,1147,2,259,4,888,1426.081821,2123.8505480000003,0.975586536421394,3.344868124873351
"12.12.122.122",52887,"147.32.84.165",32234,3,825,1,145,2,680,3162.553617,0.24749599999995553,4686.944435466466,21980.153214601356
"12.147.51.62",8500,"147.32.84.192",31037,1,143,1,143,0,0,2341.913571,0,0,0
"14.43.205.254",59750,"147.32.84.191",29676,4,1007,2,327,2,680,2485.900034,31.98942500000021,81.77702475114769,170.05619825926738
"14.97.118.30",55813,"147.32.84.165",32234,9,1593,1,145,8,1448,1094.35977,2059.897867,0.5631347158436569,5.623579783045622
"14.99.144.250",21651,"147.32.84.191",29676,3,825,1,145,2,680,2995.843573,0.24067100000002029,4819.857814194075,22603.471128634283
"14.99.199.95",11970,"147.32.84.191",29676,3,825,1,145,2,680,2529.578431,0.13339100000030157,8696.238876666173,40782.36162850343
"14.99.205.185",20387,"147.32.84.191",29676,3,825,1,145,2,680,1873.411198,0.18409399999995912,6301.128771172648,29550.12113377518
"14.99.225.240",34893,"147.32.84.165",32234,3,825,1,145,2,680,1951.332571,0.17199300000015683,6744.460530364272,31629.194211363483
"14.145.28.229",7600,"147.32.84.191",7600,6,749,2,249,4,500,445.190187,1.9491730000000302,1021.9718824342268,2052.1523743659172
"14.195.219.10",12159,"147.32.84.191",29676,3,828,1,140,2,688,1897.042596,0.1215389999999843,9215.14904680921,45285.875315748126
"14.200.251.115",42456,"147.32.84.165",32234,3,825,1,145,2,680,3284.780205,0.12460199999986799,9309.641899818855,43659.010288805664
"14.223.179.100",12631,"147.32.84.165",32234,3,831,1,143,2,688,2692.955938,0.19379799999978786,5903.053695091035,28400.705889668752
"24.5.168.23",45044,"147.32.84.165",32234,3,825,1,145,2,680,3220.418618,0.06360399999994115,18237.84667632654,85529.21199932447
"24.8.16.85",18311,"147.32.84.165",32234,4,654,2,296,2,358,1264.615453,2542.015547,0.9315442632892756,1.1266650211404077
"24.14.134.72",51036,"147.32.84.192",31037,3,825,1,145,2,680,3065.147645,0.17357300000003306,6683.067066881249,31341.28003778793
"24.36.228.195",55555,"147.32.84.165",32234,3,825,1,145,2,680,1423.22408,0.1028240000000551,11281.412899706085,52905.93635724233
"24.44.173.205",51413,"147.32.84.165",32234,3,816,1,136,2,680,2995.593361,0.16479600000002392,6602.101992765856,33010.50996382928
"24.47.150.51",38206,"147.32.84.191",29676,3,828,1,148,2,680,2443.053351,0.11725399999977526,10097.736537792052,46395.0057141797
"24.47.150.51",38459,"147.32.84.191",29676,3,828,1,148,2,680,3651.62618,0.15674999999964712,7553.4290271302425,34704.944178706515
"24.67.165.29",64041,"147.32.84.165",32234,3,825,1,145,2,680,1672.436038,0.15365799999995033,7549.2327116087345,35403.29823375131
"24.68.45.212",4528,"147.32.84.192",31037,3,825,1,145,2,680,2222.327902,0.31361299999980474,3698.8262603932944,17346.21970391338
"24.72.0.73",1112,"147.32.84.165",32234,3,825,1,145,2,680,3463.902463,0.2035169999999198,5699.769552422928,26729.953763086836
"24.77.230.16",1342,"147.32.84.192",31037,3,825,1,145,2,680,1326.680135,0.02345900000000256,49447.973059374795,231893.9426232749
"24.78.106.17",49885,"147.32.84.165",32234,3,825,1,145,2,680,1982.228821,0.17919500000016342,6473.394904985866,30357.989899244058
"24.91.93.173",30374,"147.32.84.191",29676,3,825,1,145,2,680,2498.782308,0.13749600000028295,8436.60906497362,39564.78733918663
"24.99.235.140",6881,"147.32.84.192",31037,1,143,1,143,0,0,2360.656173,0,0,0
"24.106.188.179",32369,"147.32.84.165",32234,3,825,1,145,2,680,3400.868338,0.16912399999955596,6858.872779753587,32165.74820849958
"24.111.126.45",17004,"147.32.84.191",29676,3,825,1,145,2,680,2546.416611,0.19693299999971714,5890.32818268988,27623.608029166335
"24.113.18.137",17966,"147.32.84.165",32234,3,825,1,145,2,680,2148.477111,0.23059799999964525,5030.3992228977895,23590.837734968944
"24.113.156.177",20794,"147.32.84.165",32234,3,825,1,145,2,680,1002.32959,0.1335039999999026,8688.878235864442,40747.84276129531
"24.127.95.51",18317,"147.32.84.192",31037,3,825,1,145,2,680,2382.981469,0.2511410000001888,4618.919252527974,21661.138563579465
"24.128.138.93",48296,"147.32.84.192",31037,3,825,1,145,2,680,2907.987471,0.2253049999999348,5148.576374249731,24145.047824067704
"24.131.243.175",42475,"147.32.84.191",29676,3,825,1,145,2,680,2547.315528,0.10548699999981181,10996.61569674054,51570.335681265984
"24.138.65.78",10754,"147.32.84.191",29676,3,825,1,145,2,680,3236.778047,0.11236600000029284,10323.407436386246,48413.22108098377
"24.145.57.62",42003,"147.32.84.165",32234,3,825,1,145,2,680,2155.182286,0.2244630000000143,5167.889585365633,24235.620124473317
"24.150.247.43",20731,"147.32.84.191",29676,3,825,1,145,2,680,3707.519987,0.10259999999971114,11306.042885022083,53021.44249527598
"24.162.141.49",60399,"147.32.84.165",32234,6,1334,2,296,4,1038,437.889153,1403.123186,1.6876636517928654,5.918225914057413
"24.187.47.55",43699,"147.32.84.191",29676,6,1650,2,290,4,1360,1443.227502,1831.1546030000002,1.2669601988816888,5.94160644992792
"24.192.92.185",24090,"147.32.84.191",29676,3,825,1,145,2,680,2688.945978,0.08421299999963594,13774.595371320518,64598.10243102036
"24.201.119.166",53165,"147.32.84.165",32234,3,825,1,145,2,680,3378.887128,0.09688900000037393,11972.463334284834,56146.724602163355
"24.207.93.242",17452,"147.32.84.165",32234,12,2070,4,620,8,1450,3110.207623,47.29533900000024,104.87291358668504,245.26729790434405
"24.253.84.250",48160,"147.32.84.165",32234,3,825,1,145,2,680,2585.765981,0.1938759999998183,5983.205760388532,28059.171841822084
"27.5.0.222",59543,"147.32.84.165",32234,1,107,1,107,0,0,2721.418942,0,0,0
"27.32.107.237",29940,"147.32.84.192",31037,3,825,1,145,2,680,3386.000703,0.04727699999966717,24536.243839671857,115066.5228343232
"27.74.214.11",61101,"147.32.84.192",31037,1,143,1,143,0,0,2095.068053,0,0,0
"27.106.46.172",20623,"147.32.84.165",32234,3,825,1,145,2,680,1164.964588,0.16523800000004485,7020.176956872421,32922.20917705687
"31.9.38.67",27011,"147.32.84.192",31037,3,825,1,145,2,680,1039.587277,0.2101759999998194,5519.183922051027,25883.069427549646
"31.9.199.98",14664,"147.32.84.191",29676,3,825,1,145,2,680,2899.747305,0.06139100000018516,18895.27780939391,88612.3373130197
"31.28.217.30",46830,"147.32.84.165",32234,3,825,1,145,2,680,601.328923,0.19849699999997483,5843.917036530261,27405.95575752122
"31.28.239.85",50948,"147.32.84.165",32234,4,1007,2,327,2,680,938.972292,34.75665900000001,75.26615259539183,156.51676992313898
"31.28.250.183",60008,"147.32.84.165",32234,6,1147,2,259,4,888,3180.380879,595.3068560000002,3.4805579326302927,11.933341483303861
"31.28.254.147",34586,"147.32.84.192",31037,1,143,1,143,0,0,3430.731508,0,0,0
"31.29.15.143",13488,"147.32.84.165",32234,4,1007,2,327,2,680,2541.198976,35.36819699999978,73.96475426779647,153.81049817156452
"31.31.118.233",37879,"147.32.84.191",29676,10,2180,4,688,6,1492,2484.21509,1325.8542229999998,4.151285944201424,9.002498006901925
"31.35.24.21",49876,"147.32.84.192",31037,1,107,1,107,0,0,3571.897754,0,0,0
"31.36.20.85",46246,"147.32.84.192",31037,3,825,1,145,2,680,3492.212587,0.15362099999993006,7551.050963087911,35411.82520620538
"31.40.21.178",35691,"147.32.84.165",32234,182,45927,90,14647,92,31280,1208.470241,2574.000658,45.522909885751865,97.21831236610352
"31.42.200.14",24520,"147.32.84.192",31037,3,825,1,145,2,680,1097.095678,0.0668510000000424,17352.02166009879,81374.99813011846
"31.43.175.141",35691,"147.32.84.165",32234,3,825,1,145,2,680,289.547366,0.08823699999999235,13146.412502692754,61652.141391938436
"31.44.4.113",57217,"147.32.84.165",32234,3,825,1,145,2,680,3073.31889,0.040460000000166474,28670.291645952228,134453.78151205182
"31.46.107.136",27992,"147.32.84.165",32234,3,825,1,145,2,680,568.33437,0.2261429999999791,5129.497707203438,24055.575454471298
"31.57.52.192",60089,"147.32.84.165",32234,3,825,1,145,2,680,3525.766973,0.16138900000032663,7187.602624699653,33707.37782617768
"31.63.155.214",13327,"147.32.84.192",31037,6,1044,2,344,4,700,3682.339685,38.917389000000185,70.71389090362632,143.89454544342564
"31.128.151.99",43935,"147.32.84.165",32234,3,825,1,145,2,680,944.072627,0.2271369999999706,5107.049930218987,23950.303121026973
"31.130.4.225",53078,"147.32.84.192",31037,1,145,1,145,0,0,3779.859088,0,0,0
"31.140.47.117",29023,"147.32.84.165",32234,3,825,1,145,2,680,1142.862214,0.2347749999998996,4940.900862530066,23171.121286347894
"31.148.64.9",19924,"147.32.84.165",32234,3,825,1,145,2,680,766.151436,0.24504100000001472,4733.901673597195,22200.3664692834
"31.162.31.76",42613,"147.32.84.191",29676,1,143,1,143,0,0,2467.551329,0,0,0
"31.162.182.123",56946,"147.32.84.192",31037,3,825,1,145,2,680,777.348913,0.06453099999998813,17975.85656506506,84300.5687189258
"31.163.93.101",32719,"147.32.84.165",32234,3,825,1,145,2,680,1348.282746,0.185312999999951,6259.6795691630205,29355.738669178303
"31.163.186.237",56870,"147.32.84.192",31037,6,1650,2,290,4,1360,2739.594948,956.2532160000001,2.4261356314225457,11.377739512878145
"31.171.134.241",28552,"147.32.84.191",29676,3,825,1,145,2,680,3656.218722,0.19554199999993216,5932.229393175903,27820.11025765251
"31.181.95.143",50088,"147.32.84.165",32234,3,825,1,145,2,680,3474.123399,0.1380490000001373,8402.813493751104,39406.297763798284
"31.210.181.119",20665,"147.32.84.165",32234,3,825,1,145,2,680,2640.842589,0.10270500000024185,11294.484202300457,52967.23625906421
"38.107.163.247",6882,"147.32.84.192",31037,38,10222,14,1966,24,8256,2076.48018,1370.182621,11.47876185184807,48.20379341244031
"41.72.14.34",17791,"147.32.84.192",31037,4,1007,2,327,2,680,2572.213529,33.99525700000004,76.95191126220922,160.02232311407423
"41.82.145.38",13169,"147.32.84.165",32234,3,825,1,145,2,680,1681.00131,0.3115539999998873,3723.271086233589,17460.85750785407
"41.84.142.248",48324,"147.32.84.192",31037,3,825,1,145,2,680,3043.444147,0.10336599999982354,11222.258769827411,52628.52388608717
"41.85.161.2",34114,"147.32.84.192",31037,1,145,1,145,0,0,3816.963564,0,0,0
"41.96.11.150",20423,"147.32.84.165",32234,3,825,1,145,2,680,2273.53503,0.14726999999993495,7876.689074492513,36938.955659689025
"41.97.217.209",14990,"147.32.84.165",32234,3,825,1,145,2,680,2602.402467,0.17548200000010183,6610.364595795163,31000.3305182118
"41.99.88.126",56630,"147.32.84.165",32234,9,2475,3,435,6,2040,1699.532459,1759.7672579999999,1.97753423595065,9.273953658251324
"41.103.66.130",23007,"147.32.84.165",32234,3,825,1,145,2,680,1842.331804,0.09968000000003485,11637.239165324983,54574.63884428269
"41.110.140.207",11675,"147.32.84.165",32234,3,825,1,145,2,680,2111.9273,0.2873130000002675,4037.408679728798,18934.0544980385
"41.116.75.154",29188,"147.32.84.165",32234,3,825,1,145,2,680,782.563917,0.13318100000003597,8709.951119151281,40846.66731739911
"41.118.15.254",16881,"147.32.84.192",31037,6,1656,2,280,4,1376,724.474387,1975.340097,1.1339819423510644,5.572711259553802
"41.132.107.103",52213,"147.32.84.191",29676,3,825,1,145,2,680,2352.731575,0.19733800000039992,5878.239365949027,27566.915647209233
"41.132.159.115",10000,"147.32.84.192",31037,3,825,1,145,2,680,3173.35796,0.13415299999996932,8646.843529404972,40550.71448272677
"41.132.203.63",51484,"147.32.84.165",32234,3,825,1,145,2,680,564.825697,0.2593490000000429,4472.737508144655,20975.59658991976
"41.139.112.172",1031,"147.32.84.165",32234,3,825,1,145,2,680,3652.04595,0.19749499999988984,5873.566419406299,27545.001139284712
"41.145.68.241",13668,"147.32.84.191",7600,203,186076,31,2988,172,183088,1179.132666,8.858265999999958,2698.4965229086724,165348.83915204252
"41.201.54.160",60776,"147.32.84.165",32234,3,825,1,145,2,680,3346.85174,0.12454500000012558,9313.90260547457,43678.99152912212
"41.203.81.230",7600,"147.32.84.165",7600,875,845732,109,10650,766,835082,2692.788253,6.997900999999729,12175.079355938773,954665.6918982218
"41.205.198.226",36226,"147.32.84.165",32234,3,825,1,145,2,680,2418.894898,0.23834900000019843,4866.812950753031,22823.674527669387
"41.206.151.172",58387,"147.32.84.192",31037,3,831,1,143,2,688,1742.000412,0.285993999999846,4000.0839178465844,19245.158989359792
"41.207.209.56",15179,"147.32.84.192",31037,3,825,1,145,2,680,1326.952073,0.169591999999966,6839.9452804391285,32076.984763438668
"41.208.189.17",13372,"147.32.84.191",29676,3,825,1,145,2,680,2990.407614,0.24026499999990847,4828.002414003046,22641.666493255667
"41.208.191.128",12329,"147.32.84.165",32234,3,828,1,148,2,680,2677.746456,0.07088400000020556,16703.34631223642,76745.10467784302
"41.212.91.183",33123,"147.32.84.192",31037,3,825,1,145,2,680,1860.811222,0.14822299999991628,7826.045890318339,36701.456589079105
"41.214.28.73",1163,"147.32.84.165",32234,7,1241,1,145,6,1096,2002.358036,321.65487699999994,3.606349795840342,27.259030180972513
"41.219.135.79",34783,"147.32.84.192",31037,3,825,1,145,2,680,736.204498,0.0693940000001021,16716.142605964396,78392.94463486751
"41.222.112.95",45391,"147.32.84.192",31037,3,825,1,145,2,680,857.889935,0.11758799999995517,9864.952206011176,46263.22413853517
"41.223.106.165",62300,"147.32.84.192",7600,196,180105,26,2573,170,177532,2470.648713,23.205059999999776,887.0479111021561,61204.582104076166
"41.223.158.165",46412,"147.32.84.192",31037,3,825,1,145,2,680,3309.723926,0.18091699999968114,6411.779987519384,30069.037182849526
"41.225.87.203",7600,"147.32.84.165",7600,420,400265,54,5285,366,394980,1080.790865,2.202744000000166,19194.241364405854,1434501.694250336
"41.225.134.228",29575,"147.32.84.165",32234,1,143,1,143,0,0,1238.822833,0,0,0
"41.230.57.34",15661,"147.32.84.165",32234,6,1650,2,290,4,1360,2723.445528,925.3248779999999,2.5072275210134363,11.758032512338874
"41.234.84.97",23608,"147.32.84.192",31037,3,825,1,145,2,680,2460.051471,0.30310499999995955,3827.0566305410825,17947.57592253749
"41.234.185.247",11667,"147.32.84.192",31037,3,825,1,145,2,680,2450.363911,0.3138969999999972,3695.479727426545,17330.525618276213
"41.234.244.203",28195,"147.32.84.191",29676,3,828,1,140,2,688,3182.486398,0.26294899999993504,4259.381096715624,20931.81567528821
"41.238.157.145",10987,"147.32.84.192",7600,211,196910,29,2842,182,194068,2699.899928,13.046317000000272,1742.714054855445,119002.47403155753
"41.238.160.23",15713,"147.32.84.165",32234,3,825,1,145,2,680,631.660106,0.24829699999997956,4671.824468278293,21909.24578227062
"41.239.12.152",14915,"147.32.84.165",32234,3,825,1,145,2,680,713.509072,0.2557560000000194,4535.572967984766,21270.27322916994
"42.48.244.29",15403,"147.32.84.192",31037,6,1656,2,280,4,1376,1622.073681,1980.0822660000001,1.1312661289195143,5.55936497640447
"42.119.181.140",10070,"147.32.84.192",31037,15,4125,5,725,10,3400,1038.476888,2665.032582,2.1763336175227295,10.20625420631349
"46.0.117.189",16741,"147.32.84.192",31037,12,3300,4,580,8,2720,926.599295,2734.761826,1.696674260948968,7.956817223760678
"46.10.54.154",44340,"147.32.84.191",29676,3,825,1,145,2,680,1962.026552,0.22186699999997472,5228.357529511519,24519.193931502294
"46.10.88.57",52093,"147.32.84.165",32234,1,143,1,143,0,0,3368.051499,0,0,0
"46.12.144.68",34027,"147.32.84.192",31037,3,825,1,145,2,680,1265.15713,0.18574100000000726,6245.255490171554,29288.09471252867
"46.25.96.55",14914,"147.32.84.191",29676,3,825,1,145,2,680,3726.125661,0.22198600000001534,5225.554764714531,24506.049931075042
"46.30.165.154",18670,"147.32.84.192",31037,1,107,1,107,0,0,2026.683225,0,0,0
"46.33.254.154",55682,"147.32.84.165",32234,1,143,1,143,0,0,1790.607213,0,0,0
"46.41.113.4",10443,"147.32.84.192",31037,3,825,1,145,2,680,1464.030724,0.10315600000012637,11245.104501905647,52735.66249169545
"46.42.33.235",20438,"147.32.84.191",29676,9,1792,3,540,6,1252,1723.627099,1353.8077689999998,3.19099956354291,7.398391580658747
"46.44.41.164",53895,"147.32.84.165",32234,3,825,1,145,2,680,3183.110128,0.20908600000029764,5547.956343314945,26018.002161752847
"46.50.37.182",40086,"147.32.84.165",32234,3,825,1,145,2,680,1422.952897,0.16687799999999697,6951.185896283639,32598.664892916375
"46.63.19.157",52072,"147.32.84.191",29676,9,1808,3,492,6,1316,1882.575124,1401.260147,2.8089002662544145,7.513237297542296
"46.70.40.121",13685,"147.32.84.192",31037,3,825,1,145,2,680,1077.073056,0.17396099999996295,6668.161254535482,31271.376917821573
"46.70.80.6",35154,"147.32.84.192",31037,3,825,1,145,2,680,951.29085,0.13469099999997525,8612.305202279389,40388.74163827576
"46.70.153.189",27737,"147.32.84.165",32234,3,825,1,145,2,680,3538.975864,0.1501629999997931,7724.9388997396045,36227.29966774435
"46.70.229.141",10063,"147.32.84.192",31037,1,143,1,143,0,0,996.676206,0,0,0
"46.72.13.189",57701,"147.32.84.165",32234,6,1254,2,296,4,958,1001.4065,1494.37966,1.5846040088634503,5.12854946111887
"46.72.133.32",24928,"147.32.84.165",32234,3,825,1,145,2,680,1959.259619,0.20523200000002362,5652.140017150671,26506.587666637628
"46.72.185.102",39036,"147.32.84.192",31037,3,825,1,145,2,680,3239.351461,0.23783599999978833,4877.310415584825,22872.90401791504
"46.72.228.7",1884,"147.32.84.192",31037,3,825,1,145,2,680,943.980049,0.18492000000003372,6272.982911528166,29418.1267575114
"46.98.13.111",51938,"147.32.84.165",32234,3,825,1,145,2,680,1475.832105,0.17241100000001097,6728.108995365296,31552.511150678634
"46.98.128.26",37456,"147.32.84.192",31037,1,143,1,143,0,0,975.04952,0,0,0
"46.107.149.20",27221,"147.32.84.192",31037,3,825,1,145,2,680,762.05131,0.023913000000106877,48509.17910738157,227491.3227104791
"46.109.33.245",64114,"147.32.84.165",32234,3,825,1,145,2,680,3410.434064,0.04468600000018341,25958.91330607436,121738.35205607285
"46.109.188.125",21552,"147.32.84.191",29676,3,825,1,145,2,680,3134.139298,0.03257499999972424,35610.13046845188,166999.23254170534
"46.116.33.254",27017,"147.32.84.192",31037,9,1278,3,492,6,786,2082.039845,1358.3806280000003,2.8975678236777673,4.6290412792900915
"46.116.99.60",28676,"147.32.84.192",31037,3,825,1,145,2,680,3259.118032,0.20589700000027733,5633.884903609269,26420.97747899519
"46.118.208.234",35691,"147.32.84.165",32234,3,825,1,145,2,680,1930.696256,0.2255689999999504,5142.5506164422195,24116.789097798
"46.119.64.142",60887,"147.32.84.192",31037,3,825,1,145,2,680,3420.384643,0.11395500000026004,10179.456803100811,47738.142249024495
"46.119.73.146",35288,"147.32.84.191",29676,3,825,1,145,2,680,1849.857721,0.18006500000001324,6442.118124010301,30211.312581565544
"46.119.87.252",35236,"147.32.84.192",31037,3,825,1,145,2,680,2146.707184,0.16326400000025387,7105.056840443675,33320.26656208069
"46.120.23.236",45863,"147.32.84.192",31037,3,825,1,145,2,680,2852.323042,0.08379899999999907,13842.647286960619,64917.24244919463
"46.138.107.98",45419,"147.32.84.192",31037,3,825,1,145,2,680,3729.824963,0.29997099999991406,3867.040480580897,18135.086391689725
"46.145.224.198",63955,"147.32.84.165",32234,3,442,1,148,2,294,3192.047695,0.22404199999982666,5284.72340008086,10498.031619079546
"46.146.23.52",60433,"147.32.84.165",32234,3,825,1,145,2,680,405.298854,0.052181000000018685,22230.31371571232,104252.50570127157
"46.146.101.24",35691,"147.32.84.191",29676,3,825,1,145,2,680,1666.753375,0.15133700000001227,7665.01252172242,35946.26561911204
"46.146.177.33",57339,"147.32.84.165",32234,3,825,1,145,2,680,3516.513195,0.28969599999982165,4004.197503592435,18778.305534088664
"46.149.181.23",17283,"147.32.84.165",32234,3,825,1,145,2,680,3354.735722,0.011657999999897584,99502.48756306319,466632.35546815844
"46.150.45.220",41209,"147.32.84.192",31037,3,825,1,145,2,680,746.119913,0.11209499999995387,10348.365225928697,48530.26450780355
"46.151.8.2",53303,"147.32.84.165",32234,3,825,1,145,2,680,752.545398,0.13213500000006206,8778.900367044727,41170.01551441666
"46.151.80.146",63717,"147.32.84.191",29676,3,825,1,145,2,680,3139.984528,0.226854000000003,5113.420966789145,23980.18108563185
"46.158.234.180",18652,"147.32.84.165",32234,3,825,1,145,2,680,469.662894,0.188254000000029,6161.887662412598,28897.12834786598
"46.158.241.250",19930,"147.32.84.165",32234,1,143,1,143,0,0,1654.385792,0,0,0
"46.159.112.174",10234,"147.32.84.191",29676,3,825,1,145,2,680,2711.598079,0.18743300000005547,6188.878159127031,29023.70447038883
"46.159.156.196",17588,"147.32.84.165",32234,3,825,1,145,2,680,998.812779,0.1862700000000359,6227.519192568725,29204.91759273609
"46.159.233.243",6881,"147.32.84.192",31037,1,143,1,143,0,0,1521.611915,0,0,0
"46.160.65.25",54233,"147.32.84.165",32234,1,107,1,107,0,0,2438.52669,0,0,0
"46.163.130.74",57990,"147.32.84.192",31037,3,825,1,145,2,680,2822.498295,0.060817000000042754,19073.61428546598,89448.67389046116
"46.164.15.188",33509,"147.32.84.165",32234,3,825,1,145,2,680,3656.564354,0.1307769999998527,8870.061249312237,41597.52861746429
"46.164.40.88",52667,"147.32.84.191",29676,12,3176,4,688,8,2488,2062.54236,1235.162937,4.456092257243628,16.11447316282289
"46.164.133.106",44171,"147.32.84.165",32234,3,825,1,145,2,680,2598.127653,0.1935910000001968,5992.014091558082,28100.4798776517
"46.164.188.165",35691,"147.32.84.165",32234,3,825,1,145,2,680,2380.387356,0.03800599999976839,30521.49660598508,143135.29442806798
"46.174.24.10",56899,"147.32.84.165",32234,3,825,1,145,2,680,366.035868,0.2594720000000166,4470.617253499128,20965.653326754535
"46.175.163.28",56541,"147.32.84.192",31037,3,825,1,145,2,680,2857.381808,0.06827199999997902,16990.860089060763,79681.2749004229
"46.175.184.42",26111,"147.32.84.192",31037,3,825,1,145,2,680,1750.424868,0.1226249999999709,9459.734964324365,44362.89500510737
"46.176.74.116",26943,"147.32.84.165",32234,3,825,1,145,2,680,2370.530792,0.167348999999831,6931.621939785547,32506.916683132218
"46.176.130.6",62559,"147.32.84.192",31037,3,825,1,145,2,680,1518.201639,0.17242800000008174,6727.445658474552,31549.4003293979
"46.176.144.5",49008,"147.32.84.165",32234,3,825,1,145,2,680,613.932361,0.19103799999993498,6072.090369457358,28476.01000848968
"46.177.220.3",62970,"147.32.84.165",32234,3,825,1,145,2,680,2064.220251,0.18625699999984136,6227.953848719715,29206.9559802028
"46.181.69.241",24239,"147.32.84.191",29676,3,825,1,145,2,680,2004.528018,0.21111799999994219,5494.557546018425,25767.58021581054
"46.185.47.40",27599,"147.32.84.192",31037,3,825,1,145,2,680,3037.639087,0.26637399999981426,4354.7793703620055,20422.41359893906
"46.191.138.22",62770,"147.32.84.192",31037,3,825,1,145,2,680,2472.519675,0.12168100000008053,9533.123495034,44707.06190774566
"46.191.153.149",30625,"147.32.84.192",31037,3,825,1,145,2,680,3120.801279,0.29295700000011493,3959.6254740441254,18569.278085172453
"46.191.177.162",56986,"147.32.84.165",32234,3,825,1,145,2,680,2317.143977,0.17020699999966382,6815.230865959044,31961.082681738968
"46.195.45.104",6890,"147.32.84.165",32234,1,143,1,143,0,0,1659.498547,0,0,0
"46.202.57.197",50599,"147.32.84.191",29676,3,825,1,145,2,680,3046.215937,0.21386500000016895,5423.982418811323,25436.607205459997
"46.203.36.150",51870,"147.32.84.192",31037,3,825,1,145,2,680,2071.600124,0.11884599999984857,9760.53043435604,45773.52203698005
"46.211.170.16",56108,"147.32.84.165",32234,3,825,1,145,2,680,3614.630052,0.06575000000020736,17642.585551275155,82737.64258529039
"46.211.202.106",23126,"147.32.84.165",32234,244,61427,122,19947,122,41480,170.938226,3634.8705769999997,43.9014255444837,91.29348431268782
"46.216.9.46",32599,"147.32.84.191",29676,3,825,1,145,2,680,3623.156218,0.030021000000033382,38639.618933370315,181206.488790978
"46.217.18.118",27398,"147.32.84.192",31037,3,825,1,145,2,680,3347.1255,0.25191899999981615,4604.654670750704,21594.24259386537
"46.228.83.254",1028,"147.32.84.165",32234,3,825,1,145,2,680,2283.906463,0.1487200000001394,7799.892415269719,36578.805809540754
"46.233.203.114",34013,"147.32.84.165",32234,3,825,1,145,2,680,2018.29036,0.15139700000008816,7661.974807950782,35932.01978901056
"46.242.68.56",64072,"147.32.84.165",32234,3,825,1,145,2,680,2267.886289,0.08578699999998207,13521.8622868295,63412.87141409697
"46.242.91.165",19529,"147.32.84.165",32234,3,825,1,145,2,680,3737.367772,0.13024499999983163,8906.291988187642,41767.4382894317
"46.242.92.244",45963,"147.32.84.191",29676,3,825,1,145,2,680,2432.790714,0.09831599999961327,11798.689938611853,55331.78729831766
"46.246.161.188",21187,"147.32.84.192",31037,3,825,1,145,2,680,3216.907144,0.3115890000003674,3722.852860655005,17458.89617410623
"46.246.200.64",10842,"147.32.84.165",32234,3,825,1,145,2,680,297.32543,0.05265600000001314,22029.778182917627,103312.06320264819
"46.247.191.11",43737,"147.32.84.165",32234,3,825,1,145,2,680,2889.42219,0.3640380000001642,3186.4805322506904,14943.494909865307
"46.247.237.29",28166,"147.32.84.165",32234,3,825,1,145,2,680,3285.776522,0.17108599999983198,6780.215797909467,31796.87408674785
"46.249.0.5",44616,"147.32.84.191",29676,9,1856,3,492,6,1364,1922.818506,1537.453032,2.560078206018329,7.097452587416668
"46.249.0.116",49512,"147.32.84.192",31037,3,825,1,145,2,680,2282.990862,0.3119579999997768,3718.449278431167,17438.244891953058
"46.249.143.6",64496,"147.32.84.192",31037,3,825,1,145,2,680,1892.338898,0.09220499999992171,12580.662653879777,58998.96968716034
"46.250.73.224",47550,"147.32.84.165",32234,3,825,1,145,2,680,2291.932731,0.1991800000000694,5823.877899385459,27311.979114359394
"46.252.33.222",36893,"147.32.84.165",32234,10,2066,2,290,8,1776,1605.264935,865.294196,2.6811690298220836,16.419848955048348
"49.140.72.1",34399,"147.32.84.192",31037,3,825,1,145,2,680,2262.54068,0.22931900000003225,5058.455688363532,23722.412883360015
"49.156.224.43",44868,"147.32.84.191",29676,3,825,1,145,2,680,3386.137379,0.1898350000001301,6110.569705266179,28656.464824696563
"49.202.56.15",18594,"147.32.84.165",32234,3,825,1,145,2,680,1482.449908,0.21075199999995675,5504.09960522433,25812.329183120997
"50.23.239.38",35374,"147.32.84.191",29676,2,250,2,250,0,0,1585.164842,1005.1412050000001,1.9897701835833104,0
"50.36.226.85",54135,"147.32.84.165",32234,3,825,1,145,2,680,729.496769,0.30602699999997185,3790.5152159780237,17776.209288724527
"50.71.85.91",46615,"147.32.84.165",32234,3,825,1,145,2,680,1436.259497,0.076528000000053,15157.850721294124,71085.09303779314
"50.88.94.188",17358,"147.32.84.165",32234,3,825,1,145,2,680,1732.833865,0.03244700000004741,35750.60868488011,167658.0269359895
"50.90.151.4",15957,"147.32.84.165",32234,3,825,1,145,2,680,3505.748434,0.1104179999997541,10505.533518109214,49267.32960216735
"50.129.172.45",55699,"147.32.84.165",32234,3,825,1,145,2,680,3071.973836,0.15482699999984106,7492.23326681516,35135.9904926504
"50.131.49.189",25219,"147.32.84.191",29676,3,828,1,140,2,688,1936.346487,0.11190499999997883,10008.489343641588,49184.57620303866
"58.8.6.219",16799,"147.32.84.165",32234,3,825,1,145,2,680,668.517491,0.1261410000000751,9196.058379109958,43126.34274341222
"58.8.49.86",61460,"147.32.84.192",31037,3,825,1,145,2,680,953.317239,0.12088500000004387,9595.896926827803,45001.44765684763
"58.11.30.136",48946,"147.32.84.191",29676,3,825,1,145,2,680,3061.140696,0.18683899999996356,6208.553888643304,29115.97685708584
"58.11.64.213",10097,"147.32.84.192",7600,3,269,1,89,2,180,1353.713905,0.0027999999999792635,0,0
"58.16.224.3",55539,"147.32.84.165",32234,1,143,1,143,0,0,1096.632884,0,0,0
"58.18.43.241",55386,"147.32.84.191",29676,1,107,1,107,0,0,2801.296626,0,0,0
"58.19.50.208",3896,"147.32.84.165",32234,1,143,1,143,0,0,3212.379286,0,0,0
"58.22.63.66",30430,"147.32.84.191",7600,685,653446,91,8812,594,644634,3021.575457,8.355869999999868,8436.703778302093,617179.5396529722
"58.22.221.110",12560,"147.32.84.192",31037,6,1656,2,280,4,1376,1029.913495,2154.0693359999996,1.0398922460683506,5.11032760925018
"58.25.7.164",7600,"147.32.84.192",7600,6,749,2,249,4,500,1746.429497,0.7839969999999994,2540.8260490792713,5102.060339516609
"58.69.1.94",22875,"147.32.84.165",32234,3,825,1,145,2,680,1798.216938,0.29003599999987273,3999.50350991087,18756.292322340632
"58.71.168.195",7600,"147.32.84.192",7600,904,883079,104,10447,800,872632,1192.395565,20.481626000000006,4080.5354028044444,340844.8137857804
"58.79.133.54",54467,"147.32.84.165",32234,1,107,1,107,0,0,3006.893078,0,0,0
"58.83.252.11",34756,"147.32.84.192",7600,6,749,2,249,4,500,1285.440596,0.3691080000000966,5396.794434147942,10836.936614754904
"58.83.252.17",45494,"147.32.84.165",7600,6,749,2,249,4,500,1021.903542,0.8044320000000198,2476.281401038187,4972.45261252648
"58.83.252.115",34696,"147.32.84.165",7600,6,749,2,249,4,500,450.45816,0.4154869999999846,4794.373831191045,9627.256689138645
"58.83.252.201",43288,"147.32.84.191",7600,6,749,2,249,4,500,1692.349003,0.6735869999999977,2957.301729397994,5938.356886341354
"58.93.201.201",47668,"147.32.84.192",31037,3,825,1,145,2,680,3362.544736,0.16259200000013152,7134.422357797811,33457.98071243111
"58.98.78.35",58804,"147.32.84.191",29676,3,825,1,145,2,680,2827.43076,0.08808899999985442,13168.500039754306,61755.72432436502
"58.101.11.6",7600,"147.32.84.191",7600,6,749,2,249,4,500,3562.867989,0.46346700000003693,4298.040637197128,8630.60368915086
"58.103.184.38",55724,"147.32.84.165",32234,1,143,1,143,0,0,1601.193695,0,0,0
"58.110.104.214",27088,"147.32.84.165",32234,3,825,1,145,2,680,589.524853,0.3010669999999891,3852.96296173291,18069.067682609508
"58.114.202.104",2542,"147.32.84.192",7600,654,640479,72,7211,582,633268,2584.763877,5.162052000000131,11175.4007902281,981420.5668598209
"58.115.117.29",8417,"147.32.84.191",29676,3,828,1,140,2,688,3056.556789,0.1450569999997242,7721.102738938,37943.70488849531
"58.115.130.212",7600,"147.32.84.165",7600,296,281257,38,3741,258,277516,267.14193,2.324957999999981,12872.490599830297,954911.0134462722
"58.145.76.169",19020,"147.32.84.165",32234,3,825,1,145,2,680,2156.241565,0.1775860000002467,6532.04644509358,30633.045397680235
"58.146.184.169",7600,"147.32.84.192",7600,1781,1834638,115,12948,1666,1821690,3563.461372,5.549028999999791,18667.0496766198,2626318.946972623
"58.148.117.62",36694,"147.32.84.192",31037,3,825,1,145,2,680,822.182098,0.10841000000004897,10700.119915132147,50179.87270544731
"58.165.167.86",44845,"147.32.84.192",31037,3,825,1,145,2,680,2227.187453,0.2874109999997927,4036.0320238294175,18927.598456579337
"58.165.201.110",18187,"147.32.84.192",31037,3,825,1,145,2,680,1103.347061,0.27129500000000917,4275.788348476606,20051.972944579946
"58.173.147.28",21639,"147.32.84.192",31037,3,825,1,145,2,680,2077.080482,0.28726200000028257,4038.125474301714,18937.416017414933
"58.187.2.122",23948,"147.32.84.191",7600,3,269,1,89,2,180,2405.370687,0.0026290000000699365,0,0
"58.208.142.170",1078,"147.32.84.165",32234,1,143,1,143,0,0,1020.123602,0,0,0
"58.230.102.21",4025,"147.32.84.192",31037,4,1007,2,327,2,680,3091.984897,32.90641300000016,79.49818170701217,165.31731975770114
"58.241.4.22",44635,"147.32.84.165",32234,1,143,1,143,0,0,1604.309271,0,0,0
"58.246.23.38",7600,"147.32.84.192",7600,487,470000,59,5872,428,464128,1468.667423,8.438465999999835,5566.888579038053,440011.7272499614
"58.247.135.20",26711,"147.32.84.165",49153,1,92,1,92,0,0,1566.34052,0,0,0
"59.10.87.60",54069,"147.32.84.191",29676,1,143,1,143,0,0,2963.363894,0,0,0
"59.49.15.146",57750,"147.32.84.165",32234,1,143,1,143,0,0,2234.707632,0,0,0
"59.49.199.58",16001,"147.32.84.191",29676,9,2042,3,476,6,1566,3522.096634,14.479404000000159,262.994250315825,865.2289831818949
"59.90.168.145",11120,"147.32.84.165",32234,3,825,1,145,2,680,3612.41008,0.24255899999980102,4782.34161585821,22427.533095059192
"59.94.8.166",29673,"147.32.84.165",32234,1,143,1,143,0,0,1474.820158,0,0,0
"59.97.9.19",25670,"147.32.84.192",31037,3,825,1,145,2,680,2554.98273,0.1932929999998123,6001.251985333801,28143.802413979203
"59.101.32.145",61288,"147.32.84.165",32234,3,825,1,145,2,680,1255.023557,0.1695799999999963,6840.429295907686,32079.25462908432
"59.115.102.225",25282,"147.32.84.191",29676,3,429,1,143,2,286,2876.908999,0.12255199999981414,9334.812977362548,18669.625954725096
"59.126.203.6",29344,"147.32.84.165",32234,3,825,1,145,2,680,767.94764,0.1673560000000407,6931.332010801632,32505.55701617317
"59.152.217.244",3600,"147.32.84.192",7600,323,306096,41,4038,282,302058,1283.595304,3.527127999999948,9158.726306502196,685108.1106214563
"59.164.100.181",15498,"147.32.84.165",32234,9,1593,1,145,8,1448,1605.442357,1919.443609,0.6043417970504181,6.035082221579348
"59.165.69.155",22022,"147.32.84.192",31037,3,825,1,145,2,680,1257.390785,0.2714349999998831,4273.582994088823,20041.630592968275
"59.173.201.229",3912,"147.32.84.192",31037,1,143,1,143,0,0,1112.914945,0,0,0
"59.177.72.131",11758,"147.32.84.165",32234,1,145,1,145,0,0,3820.721809,0,0,0
"59.177.75.35",10000,"147.32.84.165",32234,3,825,1,145,2,680,1931.42381,0.11850499999991371,9788.616514078263,45905.236066022204
"59.177.76.30",27327,"147.32.84.191",29676,3,825,1,145,2,680,1694.457439,0.0162279999999555,71481.39018999143,335223.0712358219
"59.180.9.157",10312,"147.32.84.165",32234,3,825,1,145,2,680,3430.033628,0.17420899999979156,6658.668610699722,31226.859691557318
"59.182.158.134",50799,"147.32.84.165",32234,1,143,1,143,0,0,2180.27805,0,0,0
"60.1.112.153",1046,"147.32.84.191",29676,1,143,1,143,0,0,2097.359335,0,0,0
"60.26.184.223",39558,"147.32.84.165",32234,3,825,1,145,2,680,3336.830528,0.0016310000000885339,0,0
"60.29.99.116",7600,"147.32.84.192",7600,543,509718,81,8210,462,501508,2147.884079,6.371265000000221,10308.78483315287,629712.3098787855
"60.48.101.159",20161,"147.32.84.165",7600,6,749,2,249,4,500,3101.669715,0.25864799999999377,7701.586712443352,15465.033559123196
"60.48.180.235",7600,"147.32.84.191",7600,3,269,1,89,2,180,918.557795,0.00021099999992202356,0,0
"60.48.208.17",7600,"147.32.84.191",7600,9,1018,3,338,6,680,3506.895242,4.694040999999743,576.0495061717927,1158.9161662627782
"60.48.209.58",7600,"147.32.84.191",7600,6,749,2,249,4,500,3517.8007,0.2811810000002879,7084.404707280934,14225.712263616335
"60.50.74.185",7600,"147.32.84.191",7600,12,1076,4,356,8,720,1332.960819,13.601463000000194,209.38923996631533,423.483856111649
"60.50.81.158",7600,"147.32.84.192",7600,870,735077,214,20557,656,714520,1761.97994,258.5608420000001,636.0437208044052,22107.601273977896
"60.50.130.30",7600,"147.32.84.165",7600,8,718,2,178,6,540,428.524687,4.897902000000045,290.73672768462643,882.0102974702149
"60.50.218.230",7600,"147.32.84.165",7600,6,749,2,249,4,500,3309.786334,0.2536119999999755,7854.517925020079,15772.124347429877
"60.50.225.93",7600,"147.32.84.191",7600,6,749,2,249,4,500,2530.644833,0.7516820000000735,2650.056805936294,5321.3992087074175
"60.51.35.62",7600,"147.32.84.191",7600,6,749,2,249,4,500,590.194123,0.2444390000000567,8149.272415611003,16364.000834560247
"60.51.90.177",49610,"147.32.84.192",31037,3,825,1,145,2,680,3148.352654,0.13926900000024034,8329.204632746685,39061.097588053424
"60.51.112.187",7600,"147.32.84.191",7600,6,749,2,249,4,500,3506.578477,0.24655500000017128,8079.3332116510155,16223.560665965895
"60.52.65.5",7600,"147.32.84.191",7600,9053,8611334,1317,124850,7736,8486484,1644.643438,1247.632424,800.5563023103991,54416.5658843121
"60.52.79.168",7600,"147.32.84.192",7600,6,749,2,249,4,500,3494.082032,0.24666700000034325,8075.664762603948,16216.194302417565
"60.53.78.128",7600,"147.32.84.165",7600,6,538,2,178,4,360,466.878289,4.608560000000011,308.990226882149,624.9240543683912
"60.53.117.67",7600,"147.32.84.192",7600,6,749,2,249,4,500,1795.002066,0.24881200000004355,8006.04472452957,16076.395029175843
"60.53.123.42",7600,"147.32.84.192",7600,633,539850,149,14186,484,525664,1921.668126,220.23908900000015,515.2945397444862,19094.303463995882
"60.53.143.154",61869,"147.32.84.165",7600,6,538,2,178,4,360,880.584796,4.484955000000014,317.50597274665984,642.1469111730198
"60.54.55.117",7600,"147.32.84.191",7600,1539,1462600,219,20884,1320,1441716,2105.952937,487.83751600000005,342.47468577221923,23642.560528288683
"60.54.76.26",7600,"147.32.84.165",7600,6,749,2,249,4,500,827.664895,0.3295779999999695,6044.09274890977,12136.73242752966
"60.54.92.0",7600,"147.32.84.191",7600,6,749,2,249,4,500,906.82964,0.5075199999999995,3924.968474148806,7881.462799495594
"60.54.92.245",7600,"147.32.84.192",7600,9,1018,3,338,6,680,793.648633,4.887096999999926,553.2937038082201,1113.1352620993778
"60.54.98.41",7600,"147.32.84.192",7600,6,749,2,249,4,500,3439.14056,0.3842859999999746,5183.639268670031,10408.914194116529
"60.54.120.60",1566,"147.32.84.165",7600,2460,2396098,299,29488,2161,2366610,417.37149,32.090169,7351.285685033319,589990.0371356723
"60.54.124.90",7600,"147.32.84.192",7600,6,749,2,249,4,500,2672.812145,0.3213180000002467,6199.4659496152435,12448.726806456312
"60.191.2.67",55867,"147.32.84.165",7600,920,878161,126,12117,794,866044,3415.217625,32.59736299999986,2973.7374768627883,212543.3275078119
"60.191.2.67",55867,"147.32.84.191",7600,448,417947,68,6475,380,411472,3420.938529,26.90717399999994,1925.1371400058629,122338.22845907218
"60.191.2.67",55867,"147.32.84.192",7600,6,749,2,249,4,500,3430.37118,0.33199400000012247,6000.1084356924075,12048.41051343857
"60.198.81.167",7600,"147.32.84.191",7600,604,581411,76,7435,528,573976,2273.436301,12.304305999999997,4834.0800366960975,373187.0777596072
"60.198.249.15",16001,"147.32.84.165",32234,3,831,1,143,2,688,2712.13218,0.11547299999983807,9907.07784505126,47664.82207968719
"60.215.90.126",16881,"147.32.84.192",31037,9,1950,3,384,6,1566,1057.397724,1969.442141,1.5598325718978305,6.3611922072708404
"60.215.169.12",11935,"147.32.84.165",32234,1,143,1,143,0,0,2969.847887,0,0,0
"60.231.17.230",16618,"147.32.84.192",31037,3,825,1,145,2,680,3459.266621,0.0852749999999105,13603.048959263762,63793.60891240937
"60.240.238.18",22962,"147.32.84.165",32234,3,825,1,145,2,680,1757.44159,0.16012799999998606,7244.204636291598,33972.821742608874
"60.252.35.11",7600,"147.32.84.191",7600,6,749,2,249,4,500,1890.389545,0.5950729999999567,3347.488459399343,6721.864376303901
"60.255.36.246",1199,"147.32.84.191",29676,3,828,1,148,2,680,2185.992245,0.2197839999998905,5387.107341756406,24751.574272934835
"61.7.2.194",9031,"147.32.84.192",31037,9,2042,3,476,6,1566,1624.471073,1214.6366260000002,3.135094001356089,10.314195811184108
"61.15.100.20",11380,"147.32.84.165",32234,1,143,1,143,0,0,3783.722796,0,0,0
"61.16.190.155",30661,"147.32.84.165",32234,3,825,1,145,2,680,1337.916818,0.12661500000012893,9161.631718191516,42964.89357496711
"61.50.144.126",56018,"147.32.84.192",7600,3,269,1,89,2,180,1549.202785,0.00020600000016202102,0,0
"61.50.179.6",51389,"147.32.84.192",7600,6,749,2,249,4,500,3215.349451,0.4705229999999574,4233.586880981759,8501.178475866987
"61.50.179.6",51389,"147.32.84.165",7600,6,749,2,249,4,500,3676.652645,0.455304999999953,4375.0892259039665,8785.319730730856
"61.52.149.78",11935,"147.32.84.192",31037,1,143,1,143,0,0,969.123215,0,0,0
"61.60.245.227",7600,"147.32.84.191",7600,1130,1088821,146,14157,984,1074664,1076.607287,25.576510999999982,4428.1254780998115,336140.9224268316
"61.77.51.98",29743,"147.32.84.192",31037,3,825,1,145,2,680,2685.178573,0.13544699999965815,8564.235457433002,40163.31111072028
"61.94.228.147",21816,"147.32.84.165",32234,3,825,1,145,2,680,3459.723103,0.1973310000003039,5878.447887043665,27567.89353923926
"61.98.42.190",37606,"147.32.84.192",31037,3,825,1,145,2,680,1518.805038,0.17267600000013772,6717.783594703808,31504.08858205924
"61.132.137.82",7600,"147.32.84.191",7600,922,878327,128,12283,794,866044,2036.872511,36.60102800000004,2684.733335905207,189293.91819268005
"61.132.137.82",7600,"147.32.84.165",7600,1205,1143862,173,16494,1032,1127368,2036.904565,36.60103700000013,3605.143755899581,246412.25329216674
"61.132.137.82",7600,"147.32.84.192",7600,492,454279,80,7671,412,446608,2037.534563,35.70142499999997,1718.9229841665997,100076.2294502251
"61.163.195.84",20765,"147.32.84.165",7600,1087,918064,811,887594,276,30470,164.950535,19.440989000000002,365246.43885143904,12538.456762667784
"61.173.235.104",49492,"147.32.84.192",31037,1,143,1,143,0,0,2822.346324,0,0,0
"61.178.17.180",13878,"147.32.84.165",7600,1265,1217998,165,15966,1100,1202032,2648.616568,46.85990200000015,2725.741936037331,205212.89182380214
"61.178.17.180",14142,"147.32.84.191",7600,959,905826,139,13250,820,892576,2650.548986,44.699821000000156,2371.3741493506122,159745.78511175638
"61.178.17.180",16024,"147.32.84.192",7600,776,724105,122,11781,654,712324,2653.612754,41.39284299999963,2276.9153594982795,137670.94954072256
"61.191.209.166",7600,"147.32.84.165",7600,6,749,2,249,4,500,2754.291789,0.3553700000002209,5605.425331341311,11255.874159319903
"61.191.209.166",7600,"147.32.84.191",7600,6,538,2,178,4,360,2754.646814,4.5794049999999515,310.95742787545873,628.9026631189053
"61.191.209.166",7600,"147.32.84.192",7600,6,749,2,249,4,500,2754.809816,0.40283499999986816,4944.952648108163,9929.623791381853
"61.215.105.161",7600,"147.32.84.191",7600,6,749,2,249,4,500,2246.491514,0.30524500000001353,6525.905420235915,13104.22775147774
"61.216.203.21",55857,"147.32.84.192",31037,3,825,1,145,2,680,1022.044642,0.09230200000001787,12567.441658899867,58936.96777966834
"61.224.50.175",62415,"147.32.84.192",31037,3,825,1,145,2,680,1306.284917,0.2081190000001243,5573.7342578011,26138.891691756886
"61.224.117.163",58789,"147.32.84.165",32234,3,825,1,145,2,680,1752.932301,0.22350200000005316,5190.110155612586,24339.82693666592
"61.233.112.109",7600,"147.32.84.191",7600,6,749,2,249,4,500,2606.143126,0.4400610000002416,4526.64516964445,9089.648935029016
"61.233.117.133",56733,"147.32.84.192",7600,6,749,2,249,4,500,3311.413231,0.3854849999997896,5167.5162457711385,10376.538646126784
"61.234.36.51",11982,"147.32.84.191",7600,6,749,2,249,4,500,3090.888645,0.37394899999981135,5326.929608050844,10696.645799298884
"61.235.138.162",7600,"147.32.84.192",7600,6,749,2,249,4,500,2650.124973,0.4046710000002349,4922.517304177575,9884.57289995497
"62.1.250.227",63944,"147.32.84.165",7600,3,269,1,89,2,180,333.821903,0.00027699999998276326,0,0
"62.5.241.138",24464,"147.32.84.191",29676,3,825,1,145,2,680,2210.680404,0.10066499999993539,11523.369592219187,54040.62981178654
"62.21.4.65",7600,"147.32.84.165",7600,472,455431,56,5551,416,449880,2307.88622,1.2033150000002024,36904.717384884694,2990937.535058895
"62.30.216.199",36118,"147.32.84.165",32234,6,1650,2,290,4,1360,1050.549086,1676.708596,1.3836632110878735,6.488903334756924
"62.35.172.213",36344,"147.32.84.165",32234,3,825,1,145,2,680,1956.496076,0.1548330000000533,7491.942932059708,35134.62892276277
"62.47.43.243",65268,"147.32.84.165",32234,3,825,1,145,2,680,2725.284906,0.11982000000034532,9681.188449312776,45401.43548643233
"62.57.93.115",43519,"147.32.84.165",32234,3,825,1,145,2,680,1474.466898,0.11991299999999683,9673.68008472835,45366.22384562261
"62.61.41.51",26126,"147.32.84.192",31037,9,2475,3,435,6,2040,875.535162,2661.7342909999998,1.3074182542437705,6.13134077852251
"62.68.148.55",35691,"147.32.84.165",32234,3,825,1,145,2,680,906.158489,0.2005179999999882,5785.01680647158,27129.73398897017
"62.77.126.250",25312,"147.32.84.192",31037,3,825,1,145,2,680,3164.300449,0.13585200000034092,8538.703883616648,40043.57683351256
"62.78.34.76",35511,"147.32.84.192",31037,3,825,1,145,2,680,3357.240339,0.19470099999989543,5957.853323817664,27940.277656524217
"62.122.136.243",27154,"147.32.84.165",32234,3,825,1,145,2,680,2488.61357,0.2323860000001332,4991.694852526981,23409.327584264465
"62.162.141.241",19086,"147.32.84.192",31037,3,825,1,145,2,680,1674.163322,0.1143659999997908,10142.874630590577,47566.584474493735
"62.163.166.253",10260,"147.32.84.165",32234,3,426,1,148,2,278,1190.686244,0.14384799999993447,8230.910405431701,15460.76413993252
"62.165.53.126",44664,"147.32.84.191",29676,3,825,1,145,2,680,3187.068744,0.12022099999967395,9648.89661542614,45249.99792061914
"62.195.133.43",61437,"147.32.84.165",32234,3,825,1,145,2,680,3619.183155,0.1290099999996528,8991.55104257904,42167.273854853425
"62.199.155.133",34813,"147.32.84.165",32234,4,1007,2,327,2,680,2628.041504,35.116901000000325,74.49404490447422,154.91116371572622
"62.221.82.25",14568,"147.32.84.165",32234,3,825,1,145,2,680,1698.709525,0.2792139999999108,4154.519472520613,19483.263733200118
"62.228.114.90",15115,"147.32.84.192",31037,3,825,1,145,2,680,3166.85068,0.1988019999998869,5834.951358641562,27363.90981983629
"62.228.192.142",61912,"147.32.84.191",29676,6,1650,2,290,4,1360,1511.195461,1861.2381939999998,1.2464820502173728,5.845570994122852
"62.245.49.164",40734,"147.32.84.192",31037,3,825,1,145,2,680,3763.835422,0.10889999999972133,10651.974288365183,49954.08631785051
"64.34.248.155",28343,"147.32.84.191",29676,3,825,1,145,2,680,2206.709992,0.24115200000005643,4810.244161357686,22558.38641188432
"64.91.122.162",22452,"147.32.84.165",32234,3,825,1,145,2,680,2368.707663,0.14982699999973192,7742.262743044148,36308.54251910359
"64.121.195.165",11557,"147.32.84.165",32234,3,825,1,145,2,680,1619.822437,0.14128200000004654,8210.52929601519,38504.55118131261
"64.228.157.206",61588,"147.32.84.165",32234,12,3300,4,580,8,2720,716.393359,2672.153136,1.736427429060338,8.143245874214
"64.237.234.128",14747,"147.32.84.191",29676,3,828,1,140,2,688,3428.889227,0.3488640000000487,3210.4201064020467,15776.921665747202
"65.8.253.28",50392,"147.32.84.191",29676,6,1650,2,290,4,1360,1279.453374,1845.844864,1.2568770243087992,5.894319838137817
"65.24.134.50",36297,"147.32.84.165",32234,3,825,1,145,2,680,844.813074,0.22471499999994649,5162.094208220529,24208.44180406869
"65.31.37.156",40716,"147.32.84.165",32234,3,825,1,145,2,680,651.353052,0.2347780000000057,4940.837727555273,23170.825205086796
"65.32.65.8",60640,"147.32.84.165",32234,3,828,1,148,2,680,1663.340819,0.09441599999991013,12540.247415704192,57617.35299107332
"65.94.247.109",29270,"147.32.84.192",31037,3,825,1,145,2,680,3284.152255,0.16770099999985177,6917.07264715789,32438.685517705966
"65.95.4.158",46663,"147.32.84.165",32234,3,825,1,145,2,680,2671.302108,0.21696300000030533,5346.533740768553,25073.39961188011
"65.96.242.109",63986,"147.32.84.192",31037,3,825,1,145,2,680,3341.246291,0.08409400000027745,13794.087568627641,64689.51411494342
"65.113.98.193",54354,"147.32.84.192",31037,3,825,1,145,2,680,3614.755383,0.0793799999996736,14613.252708550892,68531.11615044557
"66.30.1.203",32331,"147.32.84.165",32234,3,825,1,145,2,680,2360.030715,0.1746040000002722,6643.60495749348,31156.216352383217
"66.30.32.96",39243,"147.32.84.165",32234,14,1999,4,487,10,1512,1315.992004,2440.1491670000005,1.5966237034557482,4.957074003336944
"66.36.196.101",7600,"147.32.84.165",7600,6,749,2,249,4,500,735.404091,0.8076889999999821,2466.295814354342,4952.401233643257
"66.49.177.38",46928,"147.32.84.165",32234,3,825,1,145,2,680,3581.0863,0.28555499999993117,4062.264712578241,19050.620721056577
"66.75.242.81",62101,"147.32.84.192",31037,3,825,1,145,2,680,3286.269062,0.2646460000000843,4383.213802587723,20555.761281101044
"66.130.82.192",46495,"147.32.84.165",32234,3,825,1,145,2,680,1163.627606,0.06105899999988651,18998.018310194337,89094.15483401483
"66.130.92.194",47200,"147.32.84.165",32234,3,825,1,145,2,680,2462.524345,0.0814250000003085,14246.238870071908,66809.94780447514
"66.131.214.228",35720,"147.32.84.192",31037,3,825,1,145,2,680,3456.140864,0.18904599999996208,6136.072701883312,28776.065084694153
"66.176.26.66",29505,"147.32.84.165",32234,3,825,1,145,2,680,1814.119183,0.23679700000002413,4898.710710016942,22973.264019389797
"66.186.86.171",25257,"147.32.84.191",29676,3,828,1,140,2,688,2582.217881,0.20479100000011385,5468.990336486356,26876.18108216152
"66.222.199.17",51099,"147.32.84.165",32234,3,825,1,145,2,680,1217.347106,0.1836550000000443,6316.1906836172175,29620.7563093773
"67.2.57.57",42582,"147.32.84.165",32234,3,825,1,145,2,680,3671.873353,0.17131500000004962,6771.152555232548,31754.37060384919
"67.40.129.130",20684,"147.32.84.165",32234,6,1656,2,296,4,1360,1636.456138,1368.2143339999998,1.730722987733295,7.951970484180004
"67.54.234.79",48266,"147.32.84.191",29676,3,825,1,145,2,680,3494.106014,0.21182200000021112,5476.29613542901,25681.940497184325
"67.58.248.59",36576,"147.32.84.165",32234,9,2475,3,435,6,2040,1953.763637,1757.7463899999998,1.9798077924085513,9.284615854053895
"67.70.196.95",28031,"147.32.84.165",32234,3,825,1,145,2,680,3432.792184,0.264922000000297,4378.64729995508,20534.34595841003
"67.121.124.12",47410,"147.32.84.192",31037,3,825,1,145,2,680,2648.134066,0.12190000000009604,9515.996718614324,44626.743232122346
"67.136.57.10",2089,"147.32.84.191",29676,3,825,1,145,2,680,1442.716628,0.30370700000003126,3819.470739890357,17912.00071120995
"67.140.53.85",19912,"147.32.84.165",32234,3,825,1,145,2,680,839.958802,0.22394099999996797,5179.935786658833,24292.11265467591
"67.149.149.224",54336,"147.32.84.191",29676,3,825,1,145,2,680,1270.063019,0.28237699999999677,4107.983298923118,19265.025125984277
"67.149.149.224",54630,"147.32.84.191",29676,3,825,1,145,2,680,2985.125867,0.06170199999996839,18800.03889664183,88165.69965321686
"67.149.149.224",54403,"147.32.84.191",29676,1,114,1,114,0,0,3319.804665,0,0,0
"67.163.45.4",63580,"147.32.84.191",29676,3,825,1,145,2,680,1527.632665,0.3345329999999649,3467.520394101992,16261.474951650722
"67.165.252.213",50894,"147.32.84.165",32234,3,825,1,145,2,680,2539.217611,0.15097999999989042,7683.136839322042,36031.26241888958
"67.169.110.202",44094,"147.32.84.192",31037,6,804,2,344,4,460,3709.046199,34.76053200000024,79.17024975336916,105.86719443764481
"67.169.111.74",44094,"147.32.84.192",31037,21,3606,5,836,16,2770,772.362136,2656.397033,2.5176959305841837,8.342126468562427
"67.175.251.96",22377,"147.32.84.191",29676,3,825,1,145,2,680,2572.545547,0.23671299999978146,4900.449067018165,22981.416314292084
"67.185.64.74",27897,"147.32.84.165",32234,3,825,1,145,2,680,2569.933567,0.04836299999988114,23985.278001837167,112482.68304309844
"67.191.41.34",29440,"147.32.84.191",29676,3,825,1,145,2,680,2297.278541,0.07590600000003178,15282.059389238193,71667.58885987567
"67.197.19.115",53139,"147.32.84.165",32234,3,825,1,145,2,680,2670.957928,0.15949500000033368,7272.955265040116,34107.65227742951
"67.204.18.111",9247,"147.32.84.191",29676,6,1662,2,286,4,1376,2195.671491,147.59843199999978,15.501519690940913,74.58073809347796
"67.204.227.213",18688,"147.32.84.165",32234,3,825,1,145,2,680,1885.988852,0.16847900000016125,6885.13108457962,32288.890603545802
"67.219.91.188",62050,"147.32.84.165",32234,3,825,1,145,2,680,1907.468643,0.15261200000009012,7600.975021618975,35645.951825523465
"67.237.34.109",23033,"147.32.84.165",32234,3,506,1,148,2,358,1281.964506,0.23773800000003575,4980.272400709277,12046.875131445411
"67.249.176.19",11378,"147.32.84.192",31037,18,2846,6,1032,12,1814,659.900003,2463.015639,3.3519884605166324,5.891964212574778
"68.5.37.28",16026,"147.32.84.165",32234,3,825,1,145,2,680,275.372632,0.06178599999998369,18774.479655590363,88045.83562621688
"68.6.164.189",22138,"147.32.84.192",31037,3,825,1,145,2,680,2895.066158,0.2691620000000512,4309.672241994707,20210.876721078628
"68.9.156.165",5859,"147.32.84.165",32234,3,825,1,145,2,680,3190.882398,0.18469999999979336,6280.454791560897,29453.167298354554
"68.19.163.98",10754,"147.32.84.165",32234,3,825,1,145,2,680,1513.308583,0.059162000000014814,19607.18028463726,91950.91443829887
"68.35.215.121",59492,"147.32.84.165",32234,3,825,1,145,2,680,3386.539283,0.20071099999995567,5779.454040885931,27103.646536568507
"68.49.227.29",57880,"147.32.84.191",29676,3,825,1,145,2,680,3357.677264,0.24819699999989098,4673.706773250722,21918.07314352063
"68.52.45.178",1287,"147.32.84.192",31037,3,825,1,145,2,680,2377.212429,0.17855399999962174,6496.63407149914,30466.97357668562
"68.56.20.213",55166,"147.32.84.192",31037,3,825,1,145,2,680,1229.029375,0.31760399999984656,3652.3469477732033,17128.24775507433
"68.84.48.243",16337,"147.32.84.165",32234,3,825,1,145,2,680,1303.428621,0.14494399999989582,8003.090848885319,37531.73639477253
"68.90.232.169",55108,"147.32.84.191",29676,3,825,1,145,2,680,3684.624373,0.255533000000014,4539.531097744465,21288.835492870596
"68.97.113.249",29327,"147.32.84.192",31037,3,825,1,145,2,680,3467.180037,0.22962199999983568,5051.780752718947,23691.109736888855
"68.110.212.2",39983,"147.32.84.191",29676,3,825,1,145,2,680,2239.386328,0.23028500000009444,5037.236467852983,23622.90205613813
"68.118.40.50",56991,"147.32.84.165",32234,3,825,1,145,2,680,1886.195606,0.16162400000007437,7177.151908129153,33658.36756915741
"68.122.32.203",62332,"147.32.84.192",31037,3,825,1,145,2,680,959.360972,0.15527500000007421,7470.616647879218,35034.61600384737
"68.140.73.102",21300,"147.32.84.191",29676,3,828,1,140,2,688,2871.09,0.3035099999997328,3690.1584791307896,18134.493097442737
"68.147.35.182",1207,"147.32.84.165",32234,3,825,1,145,2,680,3461.922982,0.10122599999976956,11459.50645093791,53741.133700950195
"68.148.178.232",41340,"147.32.84.165",32234,3,825,1,145,2,680,2073.906993,0.2533509999998387,4578.628069361236,21472.186808038903
"68.186.202.254",64372,"147.32.84.165",32234,3,825,1,145,2,680,3283.430104,0.044245999999930063,26217.059169231874,122948.96713846672
"68.195.167.34",22293,"147.32.84.191",29676,3,825,1,145,2,680,1318.921356,0.273394000000053,4242.960708719925,19898.02263399689
"69.62.145.60",59652,"147.32.84.165",32234,3,825,1,145,2,680,3623.941392,0.1175479999997151,9868.309116299823,46278.96689023365
"69.104.66.134",59705,"147.32.84.192",31037,3,825,1,145,2,680,731.628081,0.16602700000009918,6986.815397491415,32765.754967545945
"69.104.66.134",60329,"147.32.84.192",31037,3,825,1,145,2,680,1678.232131,0.2847759999999653,4073.376969969876,19102.733376410455
"69.104.66.134",60976,"147.32.84.192",31037,3,825,1,145,2,680,2652.565289,0.13024999999970532,8905.95009598944,41765.83493291599
"69.104.66.134",61544,"147.32.84.192",31037,3,825,1,145,2,680,3631.03676,0.09934299999986251,11676.716024295676,54759.77170014524
"69.112.185.98",51781,"147.32.84.165",32234,6,1650,2,290,4,1360,3461.010033,0.1914510000001428,12117.98319151255,56829.16255330024
"69.113.78.86",56866,"147.32.84.192",31037,12,3300,4,580,8,2720,907.919277,2710.131843,1.7120938274588584,8.029129673600163
"69.115.142.137",60003,"147.32.84.165",32234,3,825,1,145,2,680,1063.851122,0.12441499999999905,9323.634609974752,43724.63127436436
"69.118.78.49",29523,"147.32.84.165",32234,3,825,1,145,2,680,2633.37328,0.06294800000023315,18427.908750011175,86420.5375862593
"69.122.45.139",33232,"147.32.84.191",29676,3,825,1,145,2,680,1811.282019,0.058357999999998356,19877.309023613434,93217.7250762561
"69.122.172.137",28059,"147.32.84.192",31037,3,825,1,145,2,680,659.397951,0.08833499999991545,13131.827701376695,61583.743703007945
"69.126.195.26",14928,"147.32.84.191",29676,3,825,1,145,2,680,1774.20221,0.25030100000003586,4634.420158128948,21733.83246570817
"69.130.142.211",36283,"147.32.84.192",31037,3,825,1,145,2,680,1161.794437,0.12312700000006771,9421.166762768216,44182.02343918887
"69.132.4.113",31398,"147.32.84.165",32234,3,825,1,145,2,680,828.503929,0.1432080000000724,8100.1061393177315,37986.70465335212
"69.132.4.131",39913,"147.32.84.191",29676,6,1270,2,296,4,974,1448.568443,1281.518742,1.8478075445891529,6.08028563658728
"69.133.94.115",32552,"147.32.84.192",31037,3,825,1,145,2,680,2934.214184,0.20820000000003347,5571.565802112457,26128.722382320488
"69.136.25.202",18543,"147.32.84.165",32234,3,825,1,145,2,680,2486.476916,0.13418199999978242,8644.97473582061,40541.95048522769
"69.137.67.6",42454,"147.32.84.165",32234,3,825,1,145,2,680,750.979641,0.2936809999999923,3949.863968047066,18523.499988082793
"69.141.226.144",53134,"147.32.84.191",29676,3,825,1,145,2,680,3682.723362,0.14389699999992445,8061.321639788245,37804.818724524186
"69.146.74.78",60803,"147.32.84.165",32234,9,2475,3,435,6,2040,1888.454901,1820.2110480000001,1.9118662112416756,8.965993266512685
"69.152.226.218",27313,"147.32.84.165",32234,1,143,1,143,0,0,3420.305039,0,0,0
"69.171.133.115",39427,"147.32.84.191",29676,3,825,1,145,2,680,2283.864601,0.18703199999981734,6202.147226149177,29085.931819182348
"69.171.160.157",15237,"147.32.84.165",32234,3,825,1,145,2,680,339.472827,0.2933689999999842,3954.0646762270803,18543.199860926998
"69.172.89.132",47895,"147.32.84.192",31037,3,825,1,145,2,680,2677.30753,0.14859599999999773,7806.401249024319,36609.32999542439
"69.203.211.229",30785,"147.32.84.165",32234,3,825,1,145,2,680,2932.684692,0.12703800000008414,9131.126119737652,42821.832837390364
"69.251.104.230",20827,"147.32.84.165",32234,3,828,1,140,2,688,2193.533109,0.13890200000014374,8063.2388302460795,39625.05939435216
"70.27.34.185",54358,"147.32.84.165",32234,3,825,1,145,2,680,924.347291,0.25858499999992546,4485.952394765104,21037.56985131221
"70.27.235.63",26306,"147.32.84.191",29676,3,825,1,145,2,680,3184.376339,0.17864000000008673,6493.506493503341,30452.306314360496
"70.29.34.71",44637,"147.32.84.165",32234,6,1650,2,290,4,1360,1178.886463,1715.194189,1.352616522886319,6.343305072846186
"70.45.42.163",32167,"147.32.84.165",32234,3,825,1,145,2,680,2267.459733,0.09188099999983024,12625.025848675386,59207.01777309837
"70.55.168.181",53502,"147.32.84.192",31037,3,825,1,145,2,680,3094.476447,0.2356329999997797,4922.9097791951235,23086.749309328854
"70.63.77.237",56304,"147.32.84.192",31037,3,825,1,145,2,680,1519.572188,0.2291339999999309,5062.539823860055,23741.56607051612
"70.76.55.151",25428,"147.32.84.165",32234,3,825,1,145,2,680,2808.248551,0.1859669999998914,6237.665822434504,29252.501787968708
"70.77.245.19",34449,"147.32.84.192",31037,3,825,1,145,2,680,2076.408469,0.15343200000006618,7560.352468842872,35455.44606078037
"70.78.12.185",51223,"147.32.84.165",32234,3,825,1,145,2,680,3232.266841,0.2238560000000689,5181.9026517030725,24301.336573504064
"70.79.87.78",55132,"147.32.84.191",29676,6,1656,2,296,4,1360,1866.707304,1277.527283,1.8535807661494774,8.516452168794896
"70.112.250.17",41348,"147.32.84.192",31037,3,825,1,145,2,680,2401.25696,0.2856369999999515,4061.098527152284,19045.151713541745
"70.115.78.75",27067,"147.32.84.165",32234,3,825,1,145,2,680,3192.739759,0.13381600000002436,8668.61959705707,40652.836731026255
"70.126.73.114",51394,"147.32.84.165",32234,3,825,1,145,2,680,1234.772468,0.16014700000005178,7243.34517661664,33968.791173098725
"70.160.22.106",36148,"147.32.84.191",29676,3,825,1,145,2,680,2852.138848,0.13067599999976665,8876.916954927236,41629.67951276221
"70.171.45.26",50870,"147.32.84.165",32234,3,825,1,145,2,680,3675.050617,0.2768810000002304,4189.525464004517,19647.42976222808
"70.177.189.132",39852,"147.32.84.192",31037,3,825,1,145,2,680,2229.745362,0.1491849999997612,7775.5806549040235,36464.79203679128
"70.180.202.164",59838,"147.32.84.165",32234,3,825,1,145,2,680,3504.005057,0.19648400000005495,5903.788603650555,27686.73276194743
"70.189.83.119",33023,"147.32.84.191",29676,4,1007,2,327,2,680,3768.570371,33.91129500000034,77.14243882458555,160.41852721932165
"70.244.235.30",35742,"147.32.84.192",31037,3,825,1,145,2,680,3542.846145,0.08115300000008574,14293.987899384798,67033.87428677008
"71.17.247.21",12401,"147.32.84.165",32234,3,825,1,145,2,680,2951.537793,0.14326699999992343,8096.770365824788,37971.06102593694
"71.50.188.251",25520,"147.32.84.191",29676,3,825,1,145,2,680,3705.440345,0.17105799999990268,6781.325632245554,31802.078827082598
"71.53.225.189",11271,"147.32.84.165",32234,1,143,1,143,0,0,3220.287796,0,0,0
"71.56.181.212",58243,"147.32.84.165",32234,3,825,1,145,2,680,3221.873748,0.2906950000001416,3990.4367120158067,18713.77216669482
"71.58.178.58",50157,"147.32.84.165",32234,3,825,1,145,2,680,2057.274613,0.23567800000000716,4921.969806260936,23082.34116039611
"71.59.14.240",55048,"147.32.84.165",32234,3,825,1,145,2,680,2467.940531,0.1786669999996775,6492.525200524405,30447.704388666174
"71.80.4.153",56699,"147.32.84.191",29676,3,825,1,145,2,680,3557.780101,0.1322730000001684,8769.741368219691,41127.06296820269
"71.80.118.204",55550,"147.32.84.165",32234,3,825,1,145,2,680,540.955387,0.22103000000004158,5248.156358864325,24612.04361398442
"71.104.144.185",31526,"147.32.84.191",29676,3,825,1,145,2,680,2298.734536,0.22497000000021217,5156.243054624643,24181.001911343155
"71.131.192.52",45564,"147.32.84.192",31037,3,825,1,145,2,680,3261.834494,0.10673299999962182,10868.241312472339,50968.30408607717
"71.162.8.8",49990,"147.32.84.165",32234,3,825,1,145,2,680,705.90103,0.23897099999999227,4854.145482087942,22764.268467722763
"71.166.127.79",28494,"147.32.84.192",31037,6,1650,2,290,4,1360,2295.682349,918.3156479999998,2.5263644423926888,11.847778074669161
"71.170.77.54",17172,"147.32.84.165",32234,12,3300,4,580,8,2720,659.785577,2625.521248,1.7672681200102784,8.287878080048202
"71.188.49.124",23995,"147.32.84.192",31037,3,825,1,145,2,680,2675.137576,0.11071899999978996,10476.97323857875,49133.39173954172
"71.199.16.83",47811,"147.32.84.165",32234,3,825,1,145,2,680,2128.504467,0.11663599999974394,9945.471381070567,46640.83130433093
"71.207.81.146",16795,"147.32.84.191",29676,3,825,1,145,2,680,1300.818029,0.014826000000084605,78240.92809883856,366922.9731531739
"71.207.129.31",62254,"147.32.84.191",29676,9,1593,1,145,8,1448,1201.350001,698.828301,1.6599213259395458,16.576317792830775
"71.218.118.199",19352,"147.32.84.192",31037,3,825,1,145,2,680,1081.875973,0.2334650000000238,4968.624847407028,23301.13721542606
"71.233.222.168",55850,"147.32.84.165",32234,3,825,1,145,2,680,2140.741967,0.05886800000007497,19705.10294215062,92410.1379356029
"71.239.4.80",60128,"147.32.84.191",29676,3,825,1,145,2,680,2889.543995,0.17793699999992896,6519.161276184623,30572.618398658917
"72.10.130.130",41119,"147.32.84.165",32234,3,825,1,145,2,680,1662.834823,0.19058600000016668,6086.491137853702,28543.544646486323
"72.50.90.246",53389,"147.32.84.192",31037,3,825,1,145,2,680,2101.812576,0.11968000000024404,9692.513368964193,45454.54545445277
"72.80.22.48",32124,"147.32.84.192",31037,3,825,1,145,2,680,2866.588073,0.1227710000002844,9448.485391479362,44310.138387627354
"72.171.46.148",1895,"147.32.84.191",29676,3,825,1,145,2,680,1470.839797,0.1286769999999251,9014.820053317027,42276.39749141779
"72.225.43.69",58940,"147.32.84.192",31037,3,825,1,145,2,680,939.880547,0.23279700000000503,4982.882081813662,23367.99872850545
"72.230.92.147",63361,"147.32.84.192",31037,3,825,1,145,2,680,1081.596384,0.10595899999998437,10947.630687342946,51340.61287857381
"74.13.81.242",64420,"147.32.84.165",32234,6,1656,2,296,4,1360,850.371963,2701.984777,0.8763927984187899,4.026669614356602
"74.13.97.108",50512,"147.32.84.191",29676,3,825,1,145,2,680,1665.098556,0.19775700000013785,5865.784776261732,27508.50791626192
"74.56.85.129",34693,"147.32.84.165",32234,1,143,1,143,0,0,1749.650216,0,0,0
"74.57.55.85",15698,"147.32.84.192",31037,3,825,1,145,2,680,1948.993855,0.05030099999999038,23061.171746092958,108148.94336098766
"74.57.72.228",39113,"147.32.84.165",32234,3,825,1,145,2,680,1528.571507,0.13828699999999117,8388.351761192838,39338.477224904345
"74.66.12.147",56309,"147.32.84.165",32234,3,825,1,145,2,680,571.882761,0.31437800000003335,3689.8256239300363,17304.009822568445
"74.69.39.241",49817,"147.32.84.165",32234,3,825,1,145,2,680,2125.242593,0.13148899999987407,8822.030740222459,41372.28209207774
"74.70.236.232",32861,"147.32.84.165",32234,3,490,1,148,2,342,2807.854232,0.17104399999971065,6922.1954584902305,15995.884100024721
"74.72.39.80",1301,"147.32.84.165",32234,3,825,1,145,2,680,3073.057386,0.08233299999983501,14089.125866934577,66073.14199665871
"74.83.119.114",50894,"147.32.84.165",32234,3,825,1,145,2,680,1176.656257,0.20149999999989632,5756.823821342912,26997.518610435727
"74.94.189.233",16187,"147.32.84.165",32234,3,825,1,145,2,680,3165.240887,0.17139700000006997,6767.9130906581,31739.178632051782
"74.95.118.74",45413,"147.32.84.192",31037,9,2475,3,435,6,2040,1546.599278,1745.3787300000001,1.9938366041621234,9.350406143656855
"74.115.0.32",32092,"147.32.84.191",29676,3,825,1,145,2,680,3296.801455,0.29088000000001557,3987.8987898787746,18701.8701870177
"74.128.150.219",2289,"147.32.84.192",31037,6,1650,2,290,4,1360,1625.644933,855.089176,2.7131673106338092,12.723819111937864
"74.197.16.177",41228,"147.32.84.192",31037,3,825,1,145,2,680,3499.1795,0.24240899999995236,4785.300875793506,22441.41100372127
"74.215.249.190",31197,"147.32.84.165",32234,3,825,1,145,2,680,3224.136991,0.25118700000030003,4618.073387550368,21657.17174851207
"74.232.13.29",35496,"147.32.84.191",29676,3,825,1,145,2,680,2771.820053,0.12038299999994706,9635.912047386342,45189.104773949744
"74.237.89.80",50463,"147.32.84.165",32234,3,825,1,145,2,680,3480.769275,0.10206399999970017,11365.417777114435,53299.89026508838
"74.240.237.99",23666,"147.32.84.165",32234,3,825,1,145,2,680,2549.588851,0.35317799999984345,3284.4627921346014,15402.99792173468
"75.10.115.47",25927,"147.32.84.165",32234,3,825,1,145,2,680,409.680681,0.10669899999999188,10871.704514569848,50984.545309706875
"75.15.68.235",12184,"147.32.84.165",32234,3,825,1,145,2,680,3135.050133,0.15862699999979668,7312.752557896744,34294.28785772266
"75.18.254.150",24730,"147.32.84.191",29676,3,825,1,145,2,680,1726.406917,0.1066289999998844,10878.841590948594,51018.01573686237
"75.43.207.180",17980,"147.32.84.165",32234,3,825,1,145,2,680,2801.041624,0.10595400000011068,10948.14730919822,51343.03565692958
"75.53.40.103",27615,"147.32.84.191",29676,6,1650,2,290,4,1360,1349.405247,1756.185327,1.3210450880848295,6.195245930328856
"75.73.151.28",13108,"147.32.84.165",32234,3,825,1,145,2,680,1239.306388,0.062229000000115775,18640.826624208035,87419.04899628596
"75.120.161.65",64810,"147.32.84.165",32234,3,825,1,145,2,680,3151.953078,0.27186500000016167,4266.823607302559,20009.931399763725
"75.138.189.110",50607,"147.32.84.191",29676,3,825,1,145,2,680,3731.83396,0.1486720000002606,7802.410675836518,36590.615583233324
"75.141.220.73",46732,"147.32.84.192",31037,3,825,1,145,2,680,1931.333405,0.17772899999999936,6526.790788222542,30608.398179250544
"75.152.165.96",61580,"147.32.84.192",31037,3,825,1,145,2,680,1840.214895,0.23052099999995335,5032.079506857227,23598.71768733044
"75.156.179.93",40784,"147.32.84.165",32234,3,825,1,145,2,680,2113.704952,0.1374550000000454,8439.1255319895,39576.588701743865
"75.156.179.134",1037,"147.32.84.192",31037,3,825,1,145,2,680,1431.496393,0.07577400000013768,15308.681077914487,71792.43539987484
"75.168.194.175",44999,"147.32.84.165",32234,3,506,1,148,2,358,2557.32181,0.12115300000004936,9772.76666693782,23639.530180836075
"75.197.229.154",40838,"147.32.84.165",32234,3,825,1,145,2,680,1663.711222,0.12959200000000237,8951.169825297695,41977.8998703616
"76.0.156.159",17194,"147.32.84.192",31037,3,825,1,145,2,680,2845.302633,0.059152000000267435,19610.494995853995,91966.45929090149
"76.7.19.4",10611,"147.32.84.192",31037,3,825,1,145,2,680,910.756056,0.21354000000008,5432.237519900559,25475.320782981933
"76.7.19.4",10849,"147.32.84.192",31037,3,825,1,145,2,680,1724.04421,0.24027499999988322,4827.801477476074,22640.724170232625
"76.18.168.243",56289,"147.32.84.191",29676,3,825,1,145,2,680,2165.310509,0.11001699999997072,10543.82504522309,49446.90366035656
"76.19.92.99",27500,"147.32.84.165",32234,3,825,1,145,2,680,1749.273818,0.2474890000000869,4687.0770014004365,21980.77490311929
"76.21.132.168",35832,"147.32.84.192",31037,3,825,1,145,2,680,1812.088317,0.21958700000004683,5282.644236679551,24773.779868566173
"76.26.81.172",22408,"147.32.84.165",32234,9,1972,3,404,6,1568,618.293676,1920.0535109999998,1.6832864196147919,6.533151252366321
"76.64.31.103",16633,"147.32.84.165",32234,3,825,1,145,2,680,612.549078,0.2523429999999962,4596.9176874334435,21557.958810032702
"76.87.44.6",36017,"147.32.84.192",31037,9,2475,3,435,6,2040,1041.575258,2578.4871649999995,1.3496285912286092,6.329292703692788
"76.94.211.8",60487,"147.32.84.165",32234,3,825,1,145,2,680,1643.187707,0.14962199999990844,7752.870567167327,36358.28955637092
"76.99.9.229",54490,"147.32.84.191",29676,3,825,1,145,2,680,3536.220873,0.15476899999976013,7495.04099659362,35149.1577771287
"76.110.49.9",22257,"147.32.84.165",32234,3,825,1,145,2,680,176.661353,0.2758310000000108,4205.473641468706,19722.221215163583
"76.110.220.17",12644,"147.32.84.191",29676,7,1241,1,145,6,1096,1592.008701,1968.9255449999998,0.5891538168854425,4.45319022969962
"76.112.26.21",33115,"147.32.84.192",31037,3,825,1,145,2,680,1767.143682,0.17148100000008526,6764.597827161162,31723.631189445452
"76.113.29.196",55059,"147.32.84.165",32234,9,2475,3,435,6,2040,1858.445157,1805.885358,1.9270326239612825,9.037118512370153
"76.115.43.172",25313,"147.32.84.165",32234,6,884,2,296,4,588,799.167135,2694.5837189999997,0.8787999360727973,1.7457241973337998
"76.115.71.167",39883,"147.32.84.165",32234,3,825,1,145,2,680,2385.433997,0.2583709999998973,4489.667958093056,21054.994562091575
"76.115.170.248",46469,"147.32.84.165",32234,3,825,1,145,2,680,1363.675912,0.19786500000009255,5862.583074315607,27493.493038169738
"76.121.121.252",52655,"147.32.84.192",31037,3,825,1,145,2,680,2511.285991,0.21732599999995728,5337.603416067235,25031.519468453243
"76.167.76.255",54891,"147.32.84.165",32234,3,825,1,145,2,680,392.426783,0.29729800000001205,3901.808959360483,18298.13856803537
"76.169.83.108",13684,"147.32.84.165",32234,35,4287,31,3871,4,416,199.945329,3042.864489,10.177252425124344,1.093706279734365
"76.174.199.216",60004,"147.32.84.192",31037,3,825,1,145,2,680,3456.610221,0.1237780000001294,9371.616927069328,43949.65179591133
"76.187.69.76",55006,"147.32.84.192",31037,3,825,1,145,2,680,1377.396478,0.10920400000009067,10622.321526675185,49815.02509061466
"76.188.25.185",27384,"147.32.84.191",29676,3,825,1,145,2,680,3701.82461,0.16114699999980076,7198.396495134469,33757.997356492684
"76.235.32.79",57148,"147.32.84.165",32234,6,1438,2,478,4,960,1241.943836,1832.953153,2.086250809924546,4.189959785622519
"76.239.29.251",16416,"147.32.84.192",31037,3,825,1,145,2,680,3139.016362,0.21480700000029174,5400.196455415441,25325.059239189653
"76.242.190.212",41737,"147.32.84.191",29676,3,825,1,145,2,680,2240.952371,0.0684479999999894,16947.171575505196,79476.39083685195
"77.4.209.101",26355,"147.32.84.192",31037,3,825,1,145,2,680,1533.415456,0.24416900000005626,4750.807842108264,22279.65056988703
"77.5.134.198",8881,"147.32.84.165",32234,1,143,1,143,0,0,2982.697792,0,0,0
"77.29.104.229",63998,"147.32.84.165",32234,3,825,1,145,2,680,3606.629126,0.16003600000021834,7248.369116938798,33992.35172081643
"77.30.65.22",61797,"147.32.84.165",32234,3,825,1,145,2,680,1258.802596,0.2550140000000738,4548.769871456721,21332.16215579704
"77.31.11.0",30407,"147.32.84.165",32234,1,145,1,145,0,0,3800.779146,0,0,0
"77.31.63.203",7600,"147.32.84.165",7600,6,538,2,178,4,360,664.590203,3.0332779999999957,469.4591132101977,949.4678694138829
"77.34.31.187",54769,"147.32.84.165",32234,3,828,1,148,2,680,590.552421,0.1302490000000489,9090.280923458571,41766.15559426911
"77.34.37.139",35691,"147.32.84.191",29676,9,2475,3,435,6,2040,3464.209055,7.9387070000002495,438.35853873935525,2055.7503885707692
"77.34.42.163",54394,"147.32.84.165",32234,3,825,1,145,2,680,2680.539487,0.15214999999989232,7624.055208681045,35754.189944159385
"77.34.88.207",22637,"147.32.84.165",32234,3,825,1,145,2,680,3575.100676,0.20800000000008367,5576.923076920833,26153.84615383563
"77.35.161.253",42794,"147.32.84.165",32234,4,1007,2,327,2,680,1076.639043,38.22499300000004,68.43689938674409,142.31526477977366
"77.35.219.201",12070,"147.32.84.192",31037,3,825,1,145,2,680,3437.435555,0.17114700000001903,6777.799201854961,31785.541084561195
"77.37.235.199",13478,"147.32.84.191",29676,6,900,2,344,4,556,2926.537713,33.66709300000002,81.74153913437071,132.11713883345962
"77.38.53.49",49210,"147.32.84.191",29676,12,3176,4,688,8,2488,2384.807931,1259.1217850000003,4.371300747528563,15.807843400946316
"77.39.41.161",19921,"147.32.84.165",32234,3,825,1,145,2,680,855.521706,0.08512900000005175,13626.378789828317,63903.01777298797
"77.40.27.212",58631,"147.32.84.191",29676,3,825,1,145,2,680,2190.31571,0.12149799999997413,9547.482263084554,44774.39957860342
"77.40.76.68",45971,"147.32.84.165",32234,3,825,1,145,2,680,1252.36745,0.17641200000002755,6575.516404778694,30836.90451896215
"77.45.189.169",29100,"147.32.84.165",32234,3,825,1,145,2,680,757.320853,0.2511939999999413,4617.9446961323565,21656.568230137946
"77.46.135.186",30507,"147.32.84.165",32234,3,825,1,145,2,680,3139.506385,0.1424459999998362,8143.436811151832,38189.910562643076
"77.48.180.2",43316,"147.32.84.165",32234,3,825,1,145,2,680,2480.527767,0.18739000000005035,6190.29830833923,29030.364480487424
"77.49.191.136",13419,"147.32.84.191",29676,3,825,1,145,2,680,3618.050804,0.1109839999999167,10451.957038860292,49016.07438913792
"77.54.114.120",42650,"147.32.84.165",32234,3,825,1,145,2,680,2832.652006,0.1583690000002207,7324.6658121121145,34350.15691197405
"77.69.209.240",41077,"147.32.84.165",32234,3,825,1,145,2,680,2313.869332,0.1542939999999362,7518.114767913721,35257.36580814711
"77.71.50.84",6881,"147.32.84.165",32234,1,107,1,107,0,0,2532.054515,0,0,0
"77.76.144.102",24072,"147.32.84.165",32234,3,825,1,145,2,680,3139.705952,0.1437370000003284,8070.29505275155,37846.900937041755
"77.76.144.106",31015,"147.32.84.165",32234,3,825,1,145,2,680,1791.861136,0.17358500000000276,6682.605063801489,31339.11340265526
"77.76.144.106",31584,"147.32.84.165",32234,3,825,1,145,2,680,3668.91653,0.07530700000006618,15403.614537811633,72237.64059111662
"77.78.11.239",18172,"147.32.84.192",31037,6,1650,2,290,4,1360,2821.080154,888.075738,2.6123898004744275,12.251207340155936
"77.84.170.197",1025,"147.32.84.165",32234,3,825,1,145,2,680,1298.085968,0.2007939999998598,5777.065051748607,27092.443001303815
"77.85.246.238",17883,"147.32.84.165",32234,6,842,2,334,4,508,3201.521783,19.821907999999894,134.80034313548495,205.0256715952885
"77.87.114.4",28889,"147.32.84.191",29676,3,828,1,148,2,680,1917.925031,0.18465900000001056,6411.818541202607,29459.706810930897
"77.87.114.4",34036,"147.32.84.191",29676,6,996,2,344,4,652,3308.647851,38.20211199999994,72.0379019882462,136.53695376842012
"77.89.78.90",32987,"147.32.84.165",32234,1,145,1,145,0,0,3813.308907,0,0,0
"77.106.155.5",11667,"147.32.84.192",31037,3,825,1,145,2,680,1368.672788,0.09085499999991953,12767.596720059737,59875.62599752153
"77.106.155.5",11698,"147.32.84.192",31037,3,825,1,145,2,680,2614.331234,0.08044999999992797,14418.893722822108,67619.63952771747
"77.106.239.239",63639,"147.32.84.191",29676,3,825,1,145,2,680,2728.760008,0.12002299999994648,9664.81424394089,45324.64610951589
"77.108.85.5",41276,"147.32.84.165",32234,3,825,1,145,2,680,3038.438445,0.20342600000003586,5702.319270888655,26741.91106347783
"77.109.9.150",3861,"147.32.84.191",29676,3,828,1,148,2,680,2790.988791,0.3104099999995924,3814.310105993862,17525.208595106935
"77.109.9.245",64861,"147.32.84.191",29676,6,1656,2,296,4,1360,1502.565828,1420.619794,1.6668780837781287,7.6586290335751865
"77.111.12.131",36809,"147.32.84.191",29676,18,3224,4,688,14,2536,1265.218356,2064.724841,2.6657305083491267,9.826006641240385
"77.120.185.172",63134,"147.32.84.165",32234,3,825,1,145,2,680,3363.399277,0.09604399999989255,12077.79767607865,56640.70634298953
"77.121.90.167",61616,"147.32.84.192",31037,3,825,1,145,2,680,897.538427,0.2693580000000111,4306.536282568003,20196.170152732706
"77.123.13.168",15437,"147.32.84.165",32234,1,143,1,143,0,0,3024.931451,0,0,0
"77.123.166.89",53081,"147.32.84.165",32234,1,143,1,143,0,0,1624.80712,0,0,0
"77.126.188.175",12035,"147.32.84.192",31037,3,825,1,145,2,680,3348.833471,0.1536380000002282,7550.215441481125,35407.90689798044
"77.126.237.56",35136,"147.32.84.165",32234,3,825,1,145,2,680,3271.670784,0.09473400000024412,12244.811788766554,57423.944940422465
"77.127.190.246",43222,"147.32.84.191",29676,1,107,1,107,0,0,2586.232865,0,0,0
"77.127.224.187",7600,"147.32.84.165",7600,404,383167,48,4767,356,378400,2420.565704,1.0597729999999501,35985.064726127006,2856460.7703726576
"77.127.238.245",36442,"147.32.84.165",32234,3,825,1,145,2,680,3019.629267,0.07522000000017215,15421.430470584222,72321.19117239497
"77.167.238.18",50818,"147.32.84.165",32234,3,426,1,148,2,278,1203.549666,0.1844210000001567,6420.0931564138245,12059.364172182724
"77.167.238.18",61976,"147.32.84.165",32234,3,442,1,148,2,294,2560.409383,0.07862199999999575,15059.398132838951,29915.2908855044
"77.170.242.64",60985,"147.32.84.165",32234,3,825,1,145,2,680,658.254439,0.33334500000000844,3479.8782042627627,16319.428819990888
"77.182.52.76",12345,"147.32.84.165",32234,6,996,2,296,4,700,1468.538617,1214.1830700000003,1.9502825055862454,4.612154574021526
"77.189.95.12",57275,"147.32.84.165",32234,12,1955,4,825,8,1130,1005.897811,2068.7360929999995,3.1903537731721694,4.369817895375213
"77.204.0.82",19501,"147.32.84.191",29676,3,828,1,140,2,688,2341.628717,0.03236699999979464,34603.14517895097,170049.74202227333
"77.209.104.188",22618,"147.32.84.191",29676,6,1650,2,290,4,1360,3393.376896,6.444268999999622,360.0098009564989,1688.321825175305
"77.221.86.66",55780,"147.32.84.191",29676,3,825,1,145,2,680,2292.969545,0.1574510000000373,7367.371436191102,34550.43156282724
"77.222.229.172",22696,"147.32.84.192",31037,6,884,2,296,4,588,1286.987751,1253.295253,1.8894191088107473,3.75330552696189
"77.231.141.33",40666,"147.32.84.191",29676,3,825,1,145,2,680,2328.151656,0.010351999999784312,112055.64142428218,525502.3184035302
"77.231.148.4",19212,"147.32.84.165",32234,3,825,1,145,2,680,2656.622032,0.24521899999990637,4730.46542070738,22184.251628144953
"77.232.56.170",27691,"147.32.84.192",31037,1,143,1,143,0,0,1229.631891,0,0,0
"77.232.156.183",51244,"147.32.84.165",32234,3,825,1,145,2,680,2630.383247,0.22982699999965917,5047.274689230248,23669.977852941855
"77.232.159.223",51427,"147.32.84.192",31037,3,825,1,145,2,680,2126.188562,0.12608900000032008,9199.850898944835,43144.12835367233
"77.234.6.232",49853,"147.32.84.192",31037,3,825,1,145,2,680,3556.1545,0.07346099999995204,15790.691659530326,74052.89881710774
"77.234.143.90",54456,"147.32.84.191",29676,15,3107,5,1123,10,1984,1186.78256,2483.3804649999997,3.617649460732148,6.391288094472468
"77.238.128.28",47237,"147.32.84.192",31037,3,825,1,145,2,680,3356.623897,0.20910000000003492,5547.584887612656,26016.260162597282
"77.240.168.77",20343,"147.32.84.165",32234,3,825,1,145,2,680,3559.95631,0.3295419999999467,3520.0368996977245,16507.759253754848
"77.248.3.79",37079,"147.32.84.165",32234,3,442,1,148,2,294,2698.31713,0.09990000000016153,11851.85185183269,23543.543543505475
"77.249.177.57",17809,"147.32.84.165",32234,6,1206,2,344,4,862,1082.576871,35.34210699999994,77.86745708171854,195.12136047802727
"77.251.34.7",45962,"147.32.84.165",32234,3,825,1,145,2,680,3583.147126,0.03427700000020195,33841.93482490199,158707.0046960921
"78.1.140.228",64053,"147.32.84.191",29676,3,825,1,145,2,680,2961.938906,0.07676800000035655,15110.462692718482,70862.85952447288
"78.12.89.68",29016,"147.32.84.191",29676,3,825,1,145,2,680,2186.735602,0.07798800000000483,14874.083192285072,69754.32117761274
"78.25.175.122",27461,"147.32.84.165",32234,3,825,1,145,2,680,1013.519835,0.23946900000009919,4844.050795716855,22716.9278695687
"78.27.234.3",30107,"147.32.84.192",31037,7,893,7,893,0,0,751.196235,2837.804592,2.5174390161110853,0
"78.28.81.16",17809,"147.32.84.165",32234,3,825,1,145,2,680,3662.450865,0.16764800000009927,6919.259400644882,32448.940637507032
"78.29.150.88",4483,"147.32.84.191",29676,3,825,1,145,2,680,3217.197581,0.1653400000000147,7015.846135235859,32901.89911696817
"78.30.230.213",11529,"147.32.84.165",32234,4,1007,2,327,2,680,3115.749698,38.70977700000003,67.57982615089718,140.53297181226324
"78.34.7.246",19201,"147.32.84.165",32234,3,458,1,148,2,310,3005.579577,0.10347200000023804,11442.709138677867,23967.83670939283
"78.36.149.150",7600,"147.32.84.165",7600,275,259174,37,3618,238,255556,2104.839548,1.972074000000248,14676.934029857075,1036699.4341996005
"78.37.36.146",50127,"147.32.84.192",31037,1,107,1,107,0,0,2769.060137,0,0,0
"78.37.238.254",35691,"147.32.84.191",29676,3,825,1,145,2,680,1651.510126,0.08025800000018535,14453.387824233361,67781.40496881852
"78.48.237.133",23116,"147.32.84.165",32234,3,825,1,145,2,680,2322.379596,0.20417899999984002,5681.289456804612,26643.288487083697
"78.53.205.240",7600,"147.32.84.192",7600,3,269,1,89,2,180,1091.949666,0.0021360000000640866,0,0
"78.57.140.64",64448,"147.32.84.165",32234,3,825,1,145,2,680,3530.190416,0.21900800000003073,5296.610169490782,24839.275277611945
"78.57.143.135",13366,"147.32.84.165",32234,3,825,1,145,2,680,760.178789,0.3590629999999919,3230.630836371406,15150.544611948662
"78.60.130.50",37969,"147.32.84.165",32234,3,825,1,145,2,680,3737.522216,0.19466700000020865,5958.893905997199,27945.157628124794
"78.61.198.233",37942,"147.32.84.165",32234,3,825,1,145,2,680,2119.965248,0.11622100000022328,9980.984503641952,46807.3756032864
"78.70.66.80",11758,"147.32.84.165",32234,57,9663,19,2813,38,6850,1986.023385,227.36885100000018,98.97573876555317,241.0180627600566
"78.72.47.212",40884,"147.32.84.165",32234,3,825,1,145,2,680,3226.939772,0.29263899999978094,3963.92825290159,18589.456634297112
"78.72.152.151",10760,"147.32.84.165",32234,1,143,1,143,0,0,2273.078641,0,0,0
"78.72.172.228",17030,"147.32.84.191",29676,3,825,1,145,2,680,2754.965647,0.09245899999996254,12546.101515271308,58836.88986472062
"78.83.249.13",9857,"147.32.84.165",32234,6,1211,2,333,4,878,2923.60081,48.023287999999866,55.47308630762657,146.26237170599438
"78.85.185.4",29988,"147.32.84.191",29676,3,825,1,145,2,680,2656.438041,0.138046999999915,8402.9352322087,39406.86867518562
"78.86.74.125",55584,"147.32.84.192",31037,3,825,1,145,2,680,1711.698959,0.2185669999998936,5307.2970759564105,24889.39318379558
"78.86.149.229",20257,"147.32.84.165",32234,3,825,1,145,2,680,2529.578762,0.1447760000000926,8012.377742162084,37575.28872186357
"78.86.217.17",19303,"147.32.84.165",32234,3,825,1,145,2,680,529.628426,0.06797400000004927,17065.34851559654,80030.59993521136
"78.88.160.103",55049,"147.32.84.165",32234,3,825,1,145,2,680,2104.014883,0.06827400000020134,16990.362363367887,79678.94073855285
"78.92.66.248",13603,"147.32.84.192",31037,3,825,1,145,2,680,1905.256307,0.26209099999982755,4425.943660792485,20756.149581647518
"78.92.128.152",50901,"147.32.84.165",32234,1,143,1,143,0,0,1898.994506,0,0,0
"78.94.133.64",45959,"147.32.84.192",31037,3,825,1,145,2,680,2661.734669,0.22114400000009482,5245.450927899932,24599.35607566865
"78.97.157.11",55071,"147.32.84.165",32234,3,825,1,145,2,680,2696.96254,0.22325000000000728,5195.968645016628,24367.301231802117
"78.101.197.55",35228,"147.32.84.191",29676,3,825,1,145,2,680,2955.306683,0.06744400000025053,17199.45436207359,80659.51011179338
"78.106.48.34",9994,"147.32.84.165",32234,1,143,1,143,0,0,2806.82063,0,0,0
"78.106.186.63",56116,"147.32.84.192",31037,1,143,1,143,0,0,2083.630084,0,0,0
"78.106.244.165",7600,"147.32.84.191",7600,346,331069,42,4165,304,326904,2782.754151,1.845390999999836,18055.794137937686,1417169.5862829245
"78.108.79.107",38467,"147.32.84.165",32234,6,1650,2,290,4,1360,1752.945623,832.6118539999998,2.786412406758745,13.067313355834113
"78.109.188.61",7600,"147.32.84.192",7600,421,402459,53,5283,368,397176,1002.235538,1.0330900000000156,40910.27887212088,3075635.2302315887
"78.111.213.62",7600,"147.32.84.191",7600,326,315021,38,5685,288,309336,1278.473137,1.399707000000035,32492.514504820556,1768004.3037578138
"78.114.110.188",41864,"147.32.84.165",32234,3,825,1,145,2,680,1586.419789,0.12137600000005477,9557.078829418308,44819.40416554792
"78.115.235.158",47957,"147.32.84.165",32234,6,1650,2,290,4,1360,1615.066765,957.9684339999999,2.4217916975748706,11.357367961040772
"78.115.243.44",17099,"147.32.84.192",31037,3,825,1,145,2,680,1493.913377,0.17728999999985717,6542.952225173075,30684.18974563925
"78.116.152.224",44422,"147.32.84.192",31037,6,1650,2,290,4,1360,865.826638,2674.071378,0.8675909024295312,4.068702163117801
"78.116.225.47",46257,"147.32.84.192",31037,3,825,1,145,2,680,3155.342885,0.21117000000003827,5493.204527157218,25761.235023909714
"78.120.53.33",23842,"147.32.84.165",32234,3,828,1,140,2,688,3484.264807,0.08093000000008033,13839.12022734324,68009.39083151535
"78.123.162.128",11108,"147.32.84.191",29676,3,825,1,145,2,680,3200.832409,0.24468999999999141,4740.692304548779,22232.212186849447
"78.130.181.62",38703,"147.32.84.191",29676,3,825,1,145,2,680,3038.792254,0.35094900000012785,3305.3235655311096,15500.82775559417
"78.131.81.144",7600,"147.32.84.165",7600,293,279888,35,3492,258,276396,335.720095,0.5594449999999824,49935.20363932268,3952431.427575668
"78.131.91.60",30245,"147.32.84.165",32234,3,825,1,145,2,680,1914.221415,0.26257600000008097,4417.768569860316,20717.811224172518
"78.133.46.13",62567,"147.32.84.191",29676,3,825,1,145,2,680,1559.650387,0.13665400000013506,8488.591625556906,39808.56762330136
"78.138.212.112",17772,"147.32.84.192",31037,3,825,1,145,2,680,2161.656177,0.12720200000012483,9119.353469276126,42766.62316626045
"78.139.236.63",19630,"147.32.84.192",31037,3,825,1,145,2,680,1068.341352,0.21470700000008947,5402.711602320915,25336.85441088429
"78.149.79.214",14424,"147.32.84.192",31037,3,825,1,145,2,680,3399.060201,0.2954140000001644,3926.69270921268,18414.834774238774
"78.149.210.109",39297,"147.32.84.165",32234,3,825,1,145,2,680,418.131567,0.23875999999995656,4858.435248786275,22784.38599430805
"78.152.161.18",27741,"147.32.84.165",32234,1,143,1,143,0,0,2020.861816,0,0,0
"78.153.51.26",20075,"147.32.84.191",29676,9,2750,3,492,6,2258,1802.663436,1264.5087539999997,3.1126712152441143,14.285389439067501
"78.153.63.186",27671,"147.32.84.192",31037,1,145,1,145,0,0,3811.440262,0,0,0
"78.162.119.1",39915,"147.32.84.192",31037,3,825,1,145,2,680,3631.179436,0.1567950000003293,7398.195095491334,34694.98389609729
"78.167.199.65",20094,"147.32.84.192",31037,3,825,1,145,2,680,741.842065,0.3038009999999076,3818.2889457255005,17906.458504092003
"78.169.12.176",6881,"147.32.84.192",31037,1,143,1,143,0,0,3034.759134,0,0,0
"78.170.175.22",7600,"147.32.84.165",7600,233,215922,33,3210,200,212712,1685.340771,5.425842999999986,4732.905098802171,313627.9468462328
"78.170.188.21",12187,"147.32.84.191",29676,3,825,1,145,2,680,2098.805826,0.13883700000042154,8355.121473357087,39182.638633674615
"78.171.140.201",57931,"147.32.84.191",29676,1,143,1,143,0,0,1864.208862,0,0,0
"78.172.145.108",21988,"147.32.84.192",31037,3,825,1,145,2,680,995.711393,0.270862999999963,4282.607812806321,20083.953880746885
"78.174.230.223",18694,"147.32.84.191",29676,6,1428,2,468,4,960,1486.630848,2003.549319,1.8686837226790523,3.8331973798544663
"78.179.156.20",14837,"147.32.84.192",31037,3,825,1,145,2,680,3418.968861,0.3181899999999587,3645.620541186557,17096.70322763351
"78.180.33.103",43408,"147.32.84.165",32234,1,143,1,143,0,0,3642.713698,0,0,0
"78.183.129.141",40042,"147.32.84.165",32234,1,143,1,143,0,0,3718.163412,0,0,0
"78.190.142.19",52889,"147.32.84.192",31037,3,825,1,145,2,680,1414.212024,0.13026000000013482,8905.266390287114,41762.62858893267
"78.223.185.135",55858,"147.32.84.165",32234,12,2787,4,539,8,2248,798.751358,2617.26921,1.6475187128342828,6.8712839822847265
"78.223.189.87",36434,"147.32.84.191",29676,12,2797,4,549,8,2248,1906.653015,1807.420332,2.4299826234332746,9.950092782291442
"78.226.112.126",33122,"147.32.84.192",31037,3,825,1,145,2,680,2115.777231,0.06709700000010344,17288.40335630821,81076.65022268676
"78.230.64.21",51413,"147.32.84.165",32234,6,1114,2,252,4,862,507.666785,1853.140045,1.087883241981315,3.7212514070948153
"78.232.80.233",18056,"147.32.84.192",31037,6,1650,2,290,4,1360,1749.355563,1906.963772,1.2165936417170697,5.705404664604189
"78.232.236.170",57131,"147.32.84.165",32234,3,825,1,145,2,680,2546.365917,0.12716599999976097,9121.935108458081,42778.73016380342
"78.238.28.98",56570,"147.32.84.191",29676,6,1650,2,290,4,1360,1958.060694,944.9727129999999,2.4550973462870775,11.51355996879457
"78.244.164.95",52401,"147.32.84.165",32234,3,825,1,145,2,680,3359.822315,0.172624000000269,6719.807211037818,31513.578644867008
"78.245.28.129",38690,"147.32.84.191",29676,3,825,1,145,2,680,3284.442624,0.19519100000024991,5942.896957331613,27870.13745507239
"78.251.173.206",18177,"147.32.84.191",29676,3,825,1,145,2,680,1563.580602,0.2309219999999641,5023.341214783261,23557.73811070771
"79.2.243.138",7600,"147.32.84.192",7600,1,89,1,89,0,0,3776.181838,0,0,0
"79.14.239.194",18045,"147.32.84.191",29676,3,825,1,145,2,680,3256.658118,0.16085599999996703,7211.418908839197,33819.067986280366
"79.23.134.252",10023,"147.32.84.165",32234,11,2180,3,404,8,1776,1450.926815,2307.620412,1.4005769680286568,6.1569918198487485
"79.28.38.119",56383,"147.32.84.192",31037,3,825,1,145,2,680,2816.959342,0.14410899999984395,8049.4625595990265,37749.203727774744
"79.31.209.109",32305,"147.32.84.192",31037,3,825,1,145,2,680,3184.192705,0.19117800000003626,6067.643766541024,28455.156974123423
"79.35.65.157",11374,"147.32.84.165",32234,3,825,1,145,2,680,2801.651975,0.11308299999973315,10257.952123685589,48106.25823521517
"79.43.110.219",28297,"147.32.84.191",29676,3,825,1,145,2,680,1315.327641,0.23720099999991362,4890.367241286598,22934.13602810267
"79.50.117.17",61240,"147.32.84.192",31037,3,825,1,145,2,680,904.522865,0.16472299999998086,7042.125264839366,33025.13917303978
"79.51.112.69",21898,"147.32.84.192",31037,9,2475,3,435,6,2040,1191.935864,1787.1905080000001,1.947190288009296,9.131651005836698
"79.52.122.205",13174,"147.32.84.165",32234,3,825,1,145,2,680,565.459727,0.23798499999998057,4874.256780889949,22858.58352417356
"79.69.229.167",49651,"147.32.84.165",32234,3,825,1,145,2,680,1215.49637,0.20716799999991053,5599.320358358921,26258.88168057977
"79.80.4.118",47632,"147.32.84.192",31037,3,825,1,145,2,680,2529.543395,0.2685360000000401,4319.7187714117545,20257.99147972409
"79.80.242.229",38461,"147.32.84.165",32234,3,825,1,145,2,680,2448.211585,0.1325179999998909,8753.527822642624,41051.027030324025
"79.85.6.187",10367,"147.32.84.192",31037,3,825,1,145,2,680,1675.624117,0.2662719999998444,4356.447542365242,20430.236750402517
"79.85.166.165",24829,"147.32.84.192",31037,3,825,1,145,2,680,3242.647509,0.16278800000009142,7125.832370932431,33417.696636096916
"79.90.110.27",13799,"147.32.84.191",29676,3,825,1,145,2,680,3591.214721,0.13432800000009593,8635.578583758945,40497.885772110916
"79.100.30.247",9177,"147.32.84.191",29676,3,828,1,140,2,688,2512.816578,0.184577999999874,6067.895415492445,29819.3717561343
"79.100.186.243",13312,"147.32.84.192",31037,3,825,1,145,2,680,1162.701376,0.2228339999999207,5205.6687938124915,24412.791584775823
"79.101.217.42",57519,"147.32.84.191",29676,3,825,1,145,2,680,3538.206697,0.183556999999837,6319.5628605884285,29636.57065655263
"79.104.192.126",44437,"147.32.84.191",29676,3,825,1,145,2,680,3226.170785,0.24131400000032954,4807.014926603578,22543.24241441678
"79.105.220.193",31509,"147.32.84.192",31037,3,825,1,145,2,680,772.340306,0.11037499999997635,10509.626274067938,49286.5232163186
"79.107.60.232",29846,"147.32.84.191",29676,3,825,1,145,2,680,1883.818963,0.07075800000006893,16393.905989412786,76881.76601931514
"79.109.47.162",8571,"147.32.84.192",31037,6,1211,2,333,4,878,1605.154155,38.25345900000002,69.64076111391648,183.61738215621224
"79.109.67.141",51141,"147.32.84.165",32234,3,825,1,145,2,680,3312.701948,0.2543989999999212,4559.766351284239,21383.7318542985
"79.113.138.127",48492,"147.32.84.192",31037,12,1640,4,688,8,952,1926.11829,1471.224521,3.7411013216792353,5.176640200928244
"79.114.131.156",24028,"147.32.84.165",32234,3,825,1,145,2,680,278.659903,0.2285500000000411,5075.475825857761,23802.23145919502
"79.114.222.209",63269,"147.32.84.165",32234,3,825,1,145,2,680,2283.360387,0.08389199999965058,13827.301768998612,64845.27726151073
"79.116.12.39",44005,"147.32.84.165",32234,3,825,1,145,2,680,1621.641963,0.16370400000005247,7085.960025409448,33230.70908467879
"79.116.101.91",21879,"147.32.84.165",32234,3,825,1,145,2,680,3663.740757,0.15240099999982704,7611.498612222469,35695.30383662951
"79.116.116.226",41739,"147.32.84.165",32234,3,825,1,145,2,680,1868.266743,0.24361700000008568,4761.572468257929,22330.13295458891
"79.116.174.170",56514,"147.32.84.165",32234,3,825,1,145,2,680,742.027659,0.10431900000003225,11119.738494422314,52147.73914625637
"79.116.181.129",53044,"147.32.84.165",32234,3,825,1,145,2,680,3598.778821,0.25775300000032075,4500.432584678186,21105.476948835632
"79.117.16.137",64811,"147.32.84.192",31037,12,2022,2,296,10,1726,663.414926,2166.412232,1.0930514354665994,6.373671545997807
"79.117.71.74",45144,"147.32.84.165",32234,3,825,1,145,2,680,2704.397103,0.12934000000041124,8968.609865442337,42059.68764483302
"79.117.138.96",27425,"147.32.84.165",32234,3,825,1,145,2,680,3387.101415,0.03907900000012887,29683.461705677593,139205.19972317768
"79.117.149.122",18163,"147.32.84.165",32234,3,825,1,145,2,680,1723.048878,0.3040409999998701,3815.274913582364,17892.32373266212
"79.119.111.172",18117,"147.32.84.191",29676,3,825,1,145,2,680,3004.502848,0.2274529999999686,5099.9547159200365,23917.02901259052
"79.125.162.217",17465,"147.32.84.191",29676,6,1438,2,478,4,960,1604.743347,2065.432107,1.8514285640472035,3.7183502541533793
"79.129.21.195",58914,"147.32.84.165",32234,3,825,1,145,2,680,2766.367973,0.16708500000004278,6942.574138909555,32558.27872040343
"79.129.131.13",26001,"147.32.84.191",29676,3,825,1,145,2,680,3034.405747,0.101238000000194,11458.148126175714,53734.763626203356
"79.130.62.60",13474,"147.32.84.165",32234,3,825,1,145,2,680,1877.092132,0.11904200000003584,9744.459938506163,45698.156952994425
"79.130.121.78",23213,"147.32.84.192",31037,6,1650,2,290,4,1360,1571.954482,887.1931079999999,2.614988753947805,12.263395535755222
"79.131.122.130",23698,"147.32.84.192",31037,3,825,1,145,2,680,1731.606846,0.14997900000003028,7734.4161515929945,36271.74471091887
"79.131.213.86",28202,"147.32.84.191",29676,3,831,1,143,2,688,2823.675874,0.21739200000001802,5262.383160373451,25318.31898137716
"79.132.15.243",28522,"147.32.84.192",31037,3,825,1,145,2,680,1378.388328,0.12830200000007608,9041.168493081263,42399.962588243165
"79.136.187.203",34049,"147.32.84.165",32234,3,825,1,145,2,680,2248.603517,0.12091899999995803,9593.198752887492,44988.79415147237
"79.139.106.33",45053,"147.32.84.165",32234,3,825,1,145,2,680,2326.327229,0.17938599999979488,6466.502402647511,30325.66644000212
"79.140.168.238",1047,"147.32.84.191",29676,6,1172,2,344,4,828,3229.811319,35.5024269999999,77.51582729822972,186.57879361318084
"79.142.60.194",20112,"147.32.84.165",32234,1,107,1,107,0,0,2629.183969,0,0,0
"79.146.58.228",17303,"147.32.84.192",31037,3,825,1,145,2,680,3549.302298,0.06468499999982669,17933.06021493558,84099.86859418066
"79.146.177.184",10444,"147.32.84.165",32234,3,828,1,140,2,688,2183.47632,0.24434199999996054,4583.7391852411,22525.803996041977
"79.150.119.29",50109,"147.32.84.165",32234,3,825,1,145,2,680,539.683122,0.27130399999998644,4275.646507239326,20051.30775808787
"79.160.26.182",27133,"147.32.84.165",32234,3,825,1,145,2,680,3563.96369,0.1712729999999283,6772.812994461974,31762.157491269947
"79.160.135.180",10335,"147.32.84.165",32234,3,825,1,145,2,680,319.784728,0.2013960000000452,5759.7966195939325,27011.460009130165
"79.164.98.166",61016,"147.32.84.192",31037,3,825,1,145,2,680,1191.896481,0.14747699999998076,7865.633285191259,36887.10782020728
"79.166.110.72",10797,"147.32.84.192",31037,1,145,1,145,0,0,3786.778361,0,0,0
"79.167.13.245",53080,"147.32.84.192",31037,6,1650,2,290,4,1360,2682.211762,866.1481699999999,2.67852554603908,12.561361181424653
"79.171.125.24",6881,"147.32.84.165",32234,1,143,1,143,0,0,1114.251752,0,0,0
"79.172.15.251",62320,"147.32.84.165",32234,1,143,1,143,0,0,472.987655,0,0,0
"79.173.194.197",7600,"147.32.84.165",7600,210,196621,26,2597,184,194024,462.249848,3.8509329999999977,5395.056211053273,403069.0744294956
"79.176.195.38",55445,"147.32.84.165",32234,3,825,1,145,2,680,3056.016217,0.08894099999997707,13042.353920017755,61164.14252146257
"79.176.209.72",22525,"147.32.84.191",29676,3,825,1,145,2,680,2946.12362,0.19900300000017523,5829.0578533940625,27336.271312468707
"79.179.39.34",54330,"147.32.84.165",32234,3,825,1,145,2,680,1757.292935,0.08897700000011355,13037.076997409664,61139.39557405911
"79.180.15.5",51307,"147.32.84.191",29676,3,825,1,145,2,680,3538.742994,0.060098999999809166,19301.485881689936,90517.313100339
"79.181.109.91",14329,"147.32.84.165",32234,3,825,1,145,2,680,2525.551183,0.30731999999989057,3774.56722634522,17701.418716653447
"79.181.217.114",65023,"147.32.84.192",31037,1,143,1,143,0,0,1163.704746,0,0,0
"79.184.130.96",22447,"147.32.84.192",31037,6,884,2,296,4,588,954.20267,1478.5550269999999,1.6015636596256355,3.181484567094168
"79.184.196.63",45417,"147.32.84.191",29676,3,825,1,145,2,680,1984.542214,0.05315499999983331,21822.97055787109,102342.20675415407
"79.186.66.2",10535,"147.32.84.165",32234,3,825,1,145,2,680,2665.575528,0.06378799999993134,18185.238602891586,85282.4982756295
"79.186.99.229",61712,"147.32.84.191",29676,3,825,1,145,2,680,2950.16933,0.16685899999993126,6951.977418062424,32602.37685712033
"79.188.210.220",57369,"147.32.84.192",31037,3,825,1,145,2,680,1653.674315,0.09088900000006106,12762.820583340346,59853.227563251276
"79.216.205.223",59708,"147.32.84.192",31037,3,825,1,145,2,680,2922.989943,0.14167899999984002,8187.522498050593,38396.65723223726
"79.248.88.189",10121,"147.32.84.165",32234,15,3243,3,435,12,2808,243.958698,2771.276628,1.255738948915929,8.106011421967652
"80.4.192.212",55043,"147.32.84.192",31037,3,825,1,145,2,680,3249.618038,0.2334289999998873,4969.391121071332,23304.730774679352
"80.5.216.121",7638,"147.32.84.165",32234,6,1122,2,244,4,878,1264.674788,603.4351509999999,3.234813213590867,11.640024596445826
"80.39.130.86",24734,"147.32.84.191",29676,3,825,1,145,2,680,1373.144566,0.13450400000010632,8624.278831849484,40444.89383212172
"80.50.233.210",55380,"147.32.84.191",29676,3,825,1,145,2,680,3012.016705,0.16426099999989674,7061.931925415827,33118.02558126043
"80.66.248.241",11522,"147.32.84.191",29676,3,825,1,145,2,680,2554.709323,0.15138299999989613,7662.683392460157,35935.342806020046
"80.75.91.37",19243,"147.32.84.165",32234,3,825,1,145,2,680,200.790482,0.13487599999999134,8600.492304042784,40333.343218959264
"80.80.174.150",38921,"147.32.84.192",31037,3,825,1,145,2,680,776.96731,0.2453809999999521,4727.342377772633,22169.605633692347
"80.92.96.7",37603,"147.32.84.191",29676,26,5782,6,870,20,4912,1346.28751,1983.4556069999999,3.509027363877875,19.81188782915876
"80.92.235.22",35691,"147.32.84.165",32234,3,825,1,145,2,680,1616.393089,0.0978730000001633,11852.094040216041,55582.234119633846
"80.94.242.124",35753,"147.32.84.165",32234,1,107,1,107,0,0,3355.637062,0,0,0
"80.99.22.118",12345,"147.32.84.165",32234,3,825,1,145,2,680,1145.50913,0.22213699999997516,5222.002638012262,24489.391681712674
"80.99.96.171",35898,"147.32.84.191",29676,4,1007,2,327,2,680,3028.755103,35.03181600000016,74.67497545659602,155.28741073542903
"80.101.72.221",54919,"147.32.84.191",29676,3,825,1,145,2,680,3602.843719,0.17732500000010987,6541.660792326414,30678.133370910076
"80.103.78.114",7600,"147.32.84.165",7600,333,315752,43,4220,290,311532,986.357352,1.580697999999984,21357.65339109706,1576680.6815723341
"80.109.227.235",32944,"147.32.84.165",32234,3,825,1,145,2,680,3210.507094,0.20278400000006513,5720.372415967864,26826.57408867688
"80.122.45.209",31800,"147.32.84.192",31037,3,825,1,145,2,680,3684.866266,0.2948670000000675,3933.9770133644474,18448.995648881548
"80.167.142.79",56750,"147.32.84.192",31037,3,825,1,145,2,680,1226.091794,0.2269290000001547,5111.730981933597,23972.25563941273
"80.174.182.154",7600,"147.32.84.192",7600,3012,3114625,190,22637,2822,3091988,2234.516041,8.009095000000343,22611.29378537678,3088476.787951565
"80.177.165.116",57326,"147.32.84.165",32234,3,825,1,145,2,680,3589.290089,0.16881999999986874,6871.223788655976,32223.6701812832
"80.180.193.125",44018,"147.32.84.165",32234,3,828,1,148,2,680,2646.497675,0.17394899999999325,6806.5927369518995,31273.534196806024
"80.184.90.114",29180,"147.32.84.165",32234,18,3189,6,925,12,2264,242.580781,2835.218152,2.610028436358572,6.388220951260332
"80.203.39.182",50631,"147.32.84.192",31037,3,825,1,145,2,680,2019.247216,0.2921010000000024,3971.229129650328,18623.695228704986
"80.203.39.182",52954,"147.32.84.192",31037,1,145,1,145,0,0,3810.204743,0,0,0
"80.212.89.193",45454,"147.32.84.165",32234,3,825,1,145,2,680,1521.361717,0.10312999999996464,11247.93949384658,52748.957626314994
"80.213.6.205",29469,"147.32.84.192",31037,3,825,1,145,2,680,1983.955086,0.1279260000001159,9067.74228850233,42524.58452539024
"80.213.91.68",18747,"147.32.84.165",32234,3,825,1,145,2,680,1158.632342,0.2387309999999161,4859.025430297731,22787.153742085913
"80.216.68.77",21022,"147.32.84.192",31037,3,825,1,145,2,680,3045.395497,0.16154899999992267,7180.483939860694,33673.99364900187
"80.218.71.235",10688,"147.32.84.165",32234,3,825,1,145,2,680,678.994868,0.24260800000001836,4781.375717205996,22423.003363448806
"80.219.216.198",23479,"147.32.84.165",32234,3,825,1,145,2,680,1535.165806,0.17761300000006486,6531.053470182793,30628.388687753788
"80.221.194.229",35691,"147.32.84.165",32234,3,825,1,145,2,680,2531.386026,0.1795680000000175,6459.948320412807,30294.93005434972
"80.227.109.170",60604,"147.32.84.165",32234,3,825,1,145,2,680,3467.808776,0.08962500000006912,12942.817294271748,60697.3500696882
"80.227.234.59",60045,"147.32.84.191",29676,3,825,1,145,2,680,2909.322736,0.1441340000001219,8048.066382664874,37742.6561393939
"80.234.84.34",23425,"147.32.84.191",29676,12,2910,4,592,8,2318,2230.380034,1462.1383480000004,3.2390915719283213,12.682794364408528
"80.234.112.220",12419,"147.32.84.192",31037,3,825,1,145,2,680,2092.092999,0.18049199999995835,6426.8776455481,30139.83999291523
"80.237.46.252",35691,"147.32.84.192",31037,3,825,1,145,2,680,2403.655153,0.1118119999996452,10374.55729263121,48653.0962688912
"80.237.118.253",53579,"147.32.84.191",29676,22,4484,4,580,18,3904,1205.943963,2143.735058,2.1644465731361846,14.568964519868386
"80.244.43.208",35691,"147.32.84.165",32234,3,825,1,145,2,680,3457.269719,0.08920600000010381,13003.609622655988,60982.44512693842
"80.248.50.185",58625,"147.32.84.192",31037,6,1656,2,296,4,1360,1741.053191,1288.603278,1.8376485924165094,8.44325028948126
"80.251.140.74",17400,"147.32.84.165",32234,3,825,1,145,2,680,2898.671385,0.15558800000007977,7455.587834533545,34964.136051605594
"80.254.9.130",4759,"147.32.84.165",32234,3,825,1,145,2,680,3639.961718,0.23709199999984776,4892.6155247783345,22944.67970240874
"81.23.150.150",35227,"147.32.84.165",32234,3,825,1,145,2,680,2699.214578,0.20503000000007887,5657.708628003481,26532.70253132667
"81.25.35.6",7600,"147.32.84.165",7600,7,909,3,409,4,500,1638.396875,11.483846000000085,284.92196777978177,348.315364033963
"81.25.242.72",26900,"147.32.84.191",29676,6,1092,2,344,4,748,3619.679999,35.92394599999989,76.60628373063496,166.57412857707834
"81.27.55.38",57600,"147.32.84.165",32234,3,825,1,145,2,680,2356.685077,0.05481000000008862,21164.021163986945,99251.96132076636
"81.34.220.187",41404,"147.32.84.165",32234,3,825,1,145,2,680,1142.796345,0.09872300000006362,11750.048114413587,55103.67391587061
"81.43.164.250",16196,"147.32.84.192",31037,3,825,1,145,2,680,2010.475521,0.210933999999952,5499.35050774301,25790.057553553426
"81.49.149.84",63335,"147.32.84.165",32234,3,825,1,145,2,680,2479.879332,0.23363999999992302,4964.903269989652,23283.684300641125
"81.51.204.169",29654,"147.32.84.165",32234,3,825,1,145,2,680,3458.396278,0.2327949999998964,4982.924891000735,23368.199488831036
"81.56.231.109",51067,"147.32.84.165",32234,3,825,1,145,2,680,1948.253546,0.18593700000019453,6238.672238439828,29257.221531993677
"81.66.148.254",12456,"147.32.84.165",32234,3,825,1,145,2,680,314.79792,0.26059500000002345,4451.351714345616,20875.304591413922
"81.84.199.93",7600,"147.32.84.165",7600,441,423056,51,5084,390,417972,935.60454,1.0513969999999517,38683.770259951154,3180317.235069297
"81.90.225.18",43007,"147.32.84.165",32234,7,1385,1,145,6,1240,3067.541478,704.2081170000001,1.647240314328839,14.086744757019037
"81.91.233.236",13540,"147.32.84.165",32234,3,825,1,145,2,680,674.842391,0.12425699999994322,9335.490153476505,43780.22968526913
"81.93.6.33",28531,"147.32.84.191",29676,3,825,1,145,2,680,2854.250459,0.23011900000028618,5040.870158476951,23639.94281216777
"81.102.248.51",29950,"147.32.84.192",31037,3,825,1,145,2,680,2473.491742,0.16285699999980352,7122.813265634265,33403.53807331931
"81.103.189.197",12109,"147.32.84.191",29676,3,825,1,145,2,680,2050.433875,0.20191899999963425,5744.877896592699,26941.49634264162
"81.147.73.32",37285,"147.32.84.165",32234,3,825,1,145,2,680,2456.236735,0.059518000000025495,19489.902214447782,91400.92072982408
"81.155.11.186",45682,"147.32.84.165",32234,3,426,1,148,2,278,1905.825495,0.1908419999999751,6204.085054653349,11653.619224281292
"81.157.170.8",51488,"147.32.84.191",29676,3,825,1,145,2,680,2769.327385,0.19968999999991865,5809.003956134371,27242.22544945774
"81.166.17.74",13507,"147.32.84.191",29676,10,1775,2,327,8,1448,1345.416501,2194.5897809999997,1.1920223189993977,5.27843522296981
"81.167.10.130",46128,"147.32.84.191",29676,3,825,1,145,2,680,2900.918062,0.10628099999985352,10914.462603867096,51185.06600434224
"81.167.53.182",22379,"147.32.84.192",31037,9,2475,3,435,6,2040,1148.518429,1795.160775,1.938545030876134,9.09110773100532
"81.182.99.76",11226,"147.32.84.191",29676,3,825,1,145,2,680,2849.216446,0.2341300000002775,4954.512450342225,23234.95493953595
"81.182.121.27",56412,"147.32.84.165",32234,6,1137,2,249,4,888,1108.131785,2326.794992,0.8561132402506048,3.0531267363154098
"81.183.178.111",20673,"147.32.84.191",29676,3,825,1,145,2,680,1512.35823,0.2944640000000618,3939.3610084755915,18474.244729402773
"81.191.6.174",31194,"147.32.84.165",32234,3,825,1,145,2,680,3098.055244,0.07130199999983233,16268.828363899018,76295.19508587125
"81.193.101.6",23148,"147.32.84.192",31037,3,825,1,145,2,680,3532.448167,0.18103900000005524,6407.459166255039,30048.774021058114
"81.198.64.10",14071,"147.32.84.191",29676,3,825,1,145,2,680,1651.109389,0.07927599999993618,14632.423432071924,68621.02023316489
"81.198.211.94",30657,"147.32.84.192",31037,3,825,1,145,2,680,2253.839989,0.05600499999991371,20712.436389639985,97134.18444796682
"81.198.232.95",31879,"147.32.84.165",32234,3,825,1,145,2,680,3532.27491,0.16223399999989851,7150.16580988403,33531.8120739389
"81.200.24.105",52892,"147.32.84.191",29676,3,825,1,145,2,680,1782.136203,0.18750599999998485,6186.468699668777,29012.404936377712
"81.205.91.245",58683,"147.32.84.192",31037,3,825,1,145,2,680,1528.186799,0.21378499999991618,5426.012114977453,25446.12578058392
"81.205.105.191",53007,"147.32.84.191",29676,3,825,1,145,2,680,3004.452576,0.2775899999996909,4178.824885627334,19597.247739493705
"81.206.217.40",58348,"147.32.84.191",29676,3,825,1,145,2,680,3752.984828,0.15234000000009473,7614.546409342777,35709.59695415923
"81.206.243.135",26182,"147.32.84.191",29676,3,828,1,140,2,688,3486.210131,0.2368880000003628,4727.972712835959,23234.60876022243
"81.214.155.178",17783,"147.32.84.165",32234,3,825,1,145,2,680,3760.29723,0.0969849999996768,11960.612465885091,56091.148115874916
"81.218.194.213",22046,"147.32.84.192",31037,3,825,1,145,2,680,1009.488744,0.31074499999999716,3732.964327664196,17506.315467666573
"81.219.201.208",55803,"147.32.84.165",32234,3,825,1,145,2,680,727.444013,0.10824400000001333,10716.52932264012,50256.82716824332
"81.225.20.152",12311,"147.32.84.192",31037,3,825,1,145,2,680,2204.284151,0.20573200000035285,5638.403359701021,26442.1674799772
"81.227.64.168",56973,"147.32.84.192",31037,3,825,1,145,2,680,3080.930916,0.1027830000002723,11285.91304006428,52927.04046374973
"81.233.158.184",51865,"147.32.84.165",32234,3,825,1,145,2,680,2045.918846,0.20139399999993657,5759.853818884204,27011.728254077647
"81.234.131.118",56128,"147.32.84.165",32234,3,825,1,145,2,680,3252.674196,0.10455099999990125,11095.063653155834,52032.02264928253
"81.234.134.138",24929,"147.32.84.165",32234,3,825,1,145,2,680,3565.61635,0.13753700000006575,8434.09409831133,39552.99301277038
"81.235.128.154",37374,"147.32.84.192",31037,3,825,1,145,2,680,1138.766669,0.2526940000000195,4590.532422613558,21528.014119842894
"81.237.216.130",51043,"147.32.84.165",32234,3,825,1,145,2,680,3716.903003,0.06451700000025085,17979.757273206906,84318.86169503928
"82.2.13.200",19603,"147.32.84.165",32234,3,825,1,145,2,680,3555.333076,0.09653600000001461,12016.242645228976,56352.034474177264
"82.12.143.197",58001,"147.32.84.191",29676,3,825,1,145,2,680,3167.906045,0.11995399999977963,9670.37364324767,45350.717775230456
"82.12.249.208",40651,"147.32.84.192",31037,3,825,1,145,2,680,2757.903486,0.18088799999986804,6412.8079253507485,30073.857856817303
"82.15.67.85",61611,"147.32.84.192",31037,3,825,1,145,2,680,2127.874882,0.06330399999978908,18324.27650707483,85934.53810214401
"82.30.100.158",16305,"147.32.84.192",31037,3,825,1,145,2,680,1295.726465,0.23091999999996915,5023.38472198231,23557.94214446876
"82.52.26.145",7600,"147.32.84.165",7600,3,269,1,89,2,180,491.0486,0.0003419999999891843,0,0
"82.54.98.222",53830,"147.32.84.165",32234,6,1650,2,290,4,1360,1402.891961,911.1318829999998,2.5462834121896276,11.94119117440653
"82.56.164.246",21575,"147.32.84.192",31037,3,825,1,145,2,680,859.738791,0.09077500000000782,12778.848801981823,59928.39438170786
"82.58.157.80",51243,"147.32.84.165",32234,3,825,1,145,2,680,3250.284834,0.06309000000010201,18386.432081124178,86226.02631147891
"82.77.186.85",24350,"147.32.84.191",29676,3,828,1,140,2,688,2984.061035,0.11327799999980925,9887.180211531682,48588.42846809855
"82.78.149.75",17528,"147.32.84.192",31037,3,825,1,145,2,680,2378.716871,0.28533299999980954,4065.4253100790106,19065.44283347398
"82.79.54.131",34105,"147.32.84.191",29676,3,825,1,145,2,680,2308.045234,0.18209499999966283,6370.301216409829,29874.516049370235
"82.80.99.83",50040,"147.32.84.192",31037,6,1206,2,344,4,862,904.247654,39.50649499999997,69.65943194910108,174.55357657013118
"82.80.99.83",56184,"147.32.84.192",31037,6,804,2,344,4,460,2166.674412,33.1805760000002,82.94009121481145,110.90826150817809
"82.80.99.83",31608,"147.32.84.192",31037,3,458,1,148,2,310,3496.657585,0.13425800000004529,8818.841335336447,18471.897391583097
"82.101.237.135",16088,"147.32.84.165",32234,3,828,1,148,2,680,3454.381595,0.09165299999995113,12918.28963591624,59354.30373258814
"82.102.136.147",16880,"147.32.84.165",32234,1,147,1,147,0,0,2031.433424,0,0,0
"82.112.135.105",13002,"147.32.84.165",32234,3,825,1,145,2,680,686.494791,0.0448549999999841,25861.108014723246,121279.67896559866
"82.128.194.87",21,"147.32.84.191",29676,3,825,1,145,2,680,2518.056462,0.1851579999997739,6264.919690218173,29380.313029988676
"82.130.149.122",36709,"147.32.84.165",32234,3,825,1,145,2,680,2765.673725,0.25925699999970675,4474.324704834632,20983.039995086547
"82.137.10.48",18383,"147.32.84.165",32234,3,825,1,145,2,680,2885.209889,0.1290369999996983,8989.669629662129,42158.45067703619
"82.137.14.234",19408,"147.32.84.165",32234,3,825,1,145,2,680,1414.664146,0.1010119999998551,11483.784104875302,53854.98752631176
"82.137.72.33",49310,"147.32.84.165",7600,679,648656,91,8800,588,639856,683.335195,32.500050999999985,2166.150446963915,157502.7682264253
"82.144.209.80",62494,"147.32.84.192",31037,3,825,1,145,2,680,1559.430504,0.18969000000015512,6115.240655801842,28678.369972036224
"82.149.17.180",16452,"147.32.84.191",29676,9,2849,3,543,6,2306,2114.474755,1511.125395,2.8746787092410684,12.208119895966675
"82.161.125.25",46373,"147.32.84.192",31037,3,825,1,145,2,680,1209.407889,0.13276799999994182,8737.045071105298,40973.7286093214
"82.168.198.231",16159,"147.32.84.165",32234,6,868,2,296,4,572,1340.528607,1495.543214,1.5833711642918797,3.05975779045593
"82.170.145.48",21520,"147.32.84.165",32234,3,825,1,145,2,680,3331.273345,0.22465099999999438,5163.56481831832,24215.3384583204
"82.171.91.214",10486,"147.32.84.165",32234,3,426,1,148,2,278,1618.577803,0.17402400000014495,6803.659265383015,12779.846457949177
"82.176.214.181",49532,"147.32.84.191",29676,6,1137,2,249,4,888,1247.929937,2081.840231,0.9568457609463883,3.4123656053027824
"82.176.240.61",55449,"147.32.84.165",32234,3,825,1,145,2,680,3076.098707,0.19529400000010355,5939.762614311679,27855.438467116837
"82.207.96.18",55286,"147.32.84.191",29676,3,825,1,145,2,680,2954.265584,0.09480599999960759,12235.512520355265,57380.3345782178
"82.209.150.3",32789,"147.32.84.165",32234,3,825,1,145,2,680,1751.74333,0.20368899999994028,5694.9565268637,26707.382332878038
"82.209.223.127",14167,"147.32.84.165",32234,3,825,1,145,2,680,1429.818976,0.24928799999997864,4653.252463015065,21822.14948172582
"82.229.54.187",30738,"147.32.84.191",29676,3,825,1,145,2,680,3096.938803,0.19750100000010207,5873.387982842622,27544.16433333091
"82.232.212.4",54915,"147.32.84.165",32234,3,825,1,145,2,680,1772.972349,0.2366620000000239,4901.50510010007,22986.36874529688
"82.234.136.80",51413,"147.32.84.191",29676,7,1214,3,352,4,862,2456.362714,1345.951555,2.0922001163704587,5.123512784975385
"82.237.197.117",16486,"147.32.84.192",31037,3,825,1,145,2,680,945.665438,0.11119399999995494,10432.217565700219,48923.50306673206
"82.238.102.215",18929,"147.32.84.165",32234,3,825,1,145,2,680,3592.304728,0.2193859999997585,5287.484160344219,24796.47744161427
"82.239.62.11",56555,"147.32.84.165",32234,3,426,1,148,2,278,1188.26194,0.16065099999991617,7370.013258558103,13843.673553237519
"82.246.106.163",45918,"147.32.84.191",29676,1,143,1,143,0,0,3329.781458,0,0,0
"82.247.228.195",47444,"147.32.84.192",31037,3,825,1,145,2,680,919.057518,0.20263299999999163,5724.635177883405,26846.564972142864
"82.255.140.26",42609,"147.32.84.192",31037,3,825,1,145,2,680,2471.954462,0.0759579999999005,15271.597461775187,71618.52602763535
"83.4.233.247",49436,"147.32.84.192",31037,12,2298,4,640,8,1658,722.742858,2867.3275989999997,1.7856348196089054,4.62591020454932
"83.9.184.36",9410,"147.32.84.192",31037,15,3302,5,762,10,2540,3063.688423,194.21693499999992,31.387582138498903,104.62527379499635
"83.10.225.34",17187,"147.32.84.165",32234,3,825,1,145,2,680,3353.265453,0.03943399999980102,29416.2397932204,137952.02109924052
"83.13.24.242",34507,"147.32.84.191",29676,3,825,1,145,2,680,3200.313049,0.16223600000012084,7150.077664631376,33531.39870309887
"83.20.40.129",57258,"147.32.84.192",31037,6,820,2,344,4,476,2397.992258,34.163036999999804,80.55489914435933,111.46549997882278
"83.20.123.125",24061,"147.32.84.192",31037,4,878,2,344,2,534,3743.58643,36.98549800000001,74.4075421128573,115.50473107054012
"83.21.96.136",10098,"147.32.84.192",31037,7,1244,1,148,6,1096,757.049795,1902.68662,0.62227798711277,4.608220769429702
"83.21.206.139",56849,"147.32.84.192",31037,6,866,2,278,4,588,1023.930451,1564.0580710000002,1.4219420884916745,3.0075609641478582
"83.24.56.146",63958,"147.32.84.192",31037,6,1108,2,296,4,812,2360.289962,1299.653926,1.8220235038169692,4.99825366587628
"83.25.79.156",33325,"147.32.84.192",31037,9,1390,3,492,6,898,1886.395606,1303.2191669999997,3.0202134066679216,5.512503331682507
"83.25.183.43",25718,"147.32.84.191",29676,15,4125,5,725,10,3400,2116.859028,1108.7506360000002,5.231113121093172,24.532116705816254
"83.25.240.28",12598,"147.32.84.165",32234,3,825,1,145,2,680,3161.015304,0.16148699999985183,7183.240756228453,33686.922167140336
"83.27.37.64",58340,"147.32.84.192",31037,21,3396,5,836,16,2560,851.580757,2585.0172089999996,2.5872168187952673,7.922577818320436
"83.27.45.229",64239,"147.32.84.192",31037,9,1390,3,492,6,898,1664.89953,1492.869156,2.636533807521441,4.812210079581817
"83.27.55.151",33562,"147.32.84.192",31037,3,426,1,148,2,278,1299.691388,0.10055400000010195,11774.767786451057,22117.469220495903
"83.28.16.168",34856,"147.32.84.192",31037,3,825,1,145,2,680,1481.259436,0.07226799999989453,16051.364365994534,75275.3639232847
"83.30.59.190",22641,"147.32.84.165",32234,3,825,1,145,2,680,2343.207367,0.024152999999841995,48027.1601874545,225230.8201894418
"83.30.148.81",13068,"147.32.84.192",31037,3,825,1,145,2,680,2302.379764,0.2477520000002187,4682.101456290872,21957.441312260642
"83.37.99.73",21910,"147.32.84.191",29676,3,825,1,145,2,680,2758.659104,0.016739000000143278,69299.24129219612,324989.5453702991
"83.44.163.253",10411,"147.32.84.192",31037,3,825,1,145,2,680,3151.136143,0.18868899999961286,6147.682164844691,28830.509462719932
"83.56.152.76",15653,"147.32.84.191",29676,3,825,1,145,2,680,2642.473999,0.20815000000038708,5572.9041556466145,26134.99879889447
"83.84.29.174",64007,"147.32.84.165",32234,3,825,1,145,2,680,3006.18022,0.11237699999992401,10322.396931763478,48408.482162752865
"83.85.78.176",45102,"147.32.84.165",32234,6,804,2,344,4,460,1981.279136,52.813424999999825,52.107963079463396,69.6792529550964
"83.86.39.91",64738,"147.32.84.165",32234,3,426,1,148,2,278,1868.93733,0.19555600000012419,6054.531694242304,11372.701425671356
"83.86.227.177",50070,"147.32.84.192",31037,3,825,1,145,2,680,1158.872986,0.19600999999988744,5918.065404829683,27753.68603644265
"83.86.228.48",53502,"147.32.84.165",32234,3,825,1,145,2,680,2856.408913,0.1964140000000043,5905.8926553095735,27696.600038693174
"83.98.23.70",49499,"147.32.84.191",29676,3,825,1,145,2,680,2087.158772,0.11522399999967092,10067.347080498099,47212.38630854281
"83.98.239.87",43102,"147.32.84.192",31037,1,143,1,143,0,0,783.246676,0,0,0
"83.99.62.94",57469,"147.32.84.192",31037,3,825,1,145,2,680,3469.469302,0.1550799999999981,7480.010317255701,35078.66907402674
"83.99.223.82",57955,"147.32.84.192",31037,3,825,1,145,2,680,1097.596686,0.16851899999983289,6883.496816389548,32281.226449275124
"83.99.248.28",51903,"147.32.84.165",32234,3,825,1,145,2,680,2369.674509,0.20406400000001668,5684.491140034034,26658.303277400988
"83.103.128.246",63770,"147.32.84.192",31037,3,825,1,145,2,680,2834.726407,0.1523219999999128,7615.446225762949,35713.816782888316
"83.111.94.83",51280,"147.32.84.165",32234,3,825,1,145,2,680,2765.976373,0.15716599999996106,7380.731201406713,34613.08425487286
"83.119.134.30",25972,"147.32.84.165",32234,3,825,1,145,2,680,3465.078572,0.14894300000014482,7788.214283308864,36524.0393975864
"83.119.238.62",28630,"147.32.84.191",29676,3,825,1,145,2,680,2357.204057,0.14786800000001676,7844.834582194041,36789.56907511688
"83.131.235.147",37220,"147.32.84.191",29676,6,1588,2,344,4,1244,2523.458522,35.24463900000001,78.08279721633691,282.3691852823347
"83.135.5.218",57514,"147.32.84.165",32234,12,1816,4,640,8,1176,1021.611105,2727.192906,1.877388280358045,3.449700965157908
"83.147.249.11",7641,"147.32.84.192",7600,624,585173,94,9001,530,576172,3124.333228,17.645344000000023,4080.8498831193037,261223.3572777042
"83.149.2.37",37464,"147.32.84.191",29676,3,825,1,145,2,680,3329.763804,0.17925500000001193,6471.228138684683,30347.828512452306
"83.149.2.51",62543,"147.32.84.165",32234,3,825,1,145,2,680,3712.785686,0.145799999999781,7956.1042524125,37311.385459589656
"83.149.3.25",61105,"147.32.84.165",32234,3,825,1,145,2,680,1676.41222,0.2304269999999633,5034.132284845894,23608.34450824281
"83.149.3.140",56025,"147.32.84.191",29676,3,825,1,145,2,680,2333.894096,0.31298900000001595,3706.200537398889,17380.80252021548
"83.149.34.241",40220,"147.32.84.191",29676,3,825,1,145,2,680,3276.53638,0.25840999999991254,4488.990364151514,21051.81688015882
"83.149.37.60",36363,"147.32.84.191",29676,3,825,1,145,2,680,2821.560797,0.31794600000011997,3648.418284864607,17109.823680744365
"83.149.38.233",14292,"147.32.84.165",32234,3,825,1,145,2,680,2744.477151,0.09582099999988714,12105.905803543757,56772.52376834313
"83.149.38.241",11531,"147.32.84.165",32234,3,825,1,145,2,680,3710.102468,0.18665000000009968,6214.840610765499,29145.459416003723
"83.149.43.242",54253,"147.32.84.191",29676,3,825,1,145,2,680,1875.229227,0.18765699999994467,6181.4906984569825,28989.05982724654
"83.149.47.133",54991,"147.32.84.192",31037,3,825,1,145,2,680,2487.994443,0.1795790000001034,6459.552620291526,30293.074357229227
"83.160.102.62",32040,"147.32.84.165",32234,9,1230,3,492,6,738,1761.109086,1359.2795409999999,2.895651616373442,4.343477424560163
"83.174.247.115",58582,"147.32.84.192",31037,3,825,1,145,2,680,3210.335852,0.2343510000000606,4949.840196968224,23213.043682333737
"83.179.42.133",49167,"147.32.84.192",31037,3,825,1,145,2,680,3355.513349,0.3103310000001329,3737.944323962167,17529.669933063953
"83.185.18.180",17614,"147.32.84.165",32234,3,825,1,145,2,680,304.375944,0.14048700000000736,8256.991750125913,38722.44406955601
"83.204.0.220",47548,"147.32.84.165",32234,3,825,1,145,2,680,3296.699618,0.15755300000000716,7362.6017911429635,34528.06357225666
"83.204.40.19",52456,"147.32.84.165",32234,3,825,1,145,2,680,2083.238801,0.19400899999982357,5979.104062188119,28039.936291640835
"83.208.102.23",29630,"147.32.84.165",32234,3,825,1,145,2,680,3385.13303,0.13835500000004686,8384.228976181614,39319.142784851705
"83.208.240.193",34474,"147.32.84.165",32234,15,2838,5,836,10,2002,700.513005,2543.1055109999998,2.629855494029481,6.297811840965336
"83.223.136.114",48224,"147.32.84.165",32234,3,825,1,145,2,680,3584.460634,0.14084700000012162,8235.887168338682,38623.47085841589
"83.228.8.200",17366,"147.32.84.191",29676,3,825,1,145,2,680,3470.29226,0.24046799999996438,4823.9266763152345,22622.55268892662
"83.232.149.211",57625,"147.32.84.191",29676,3,825,1,145,2,680,2124.451378,0.08220199999959732,14111.578793772444,66178.43848113973
"83.233.228.82",42079,"147.32.84.192",31037,3,825,1,145,2,680,3694.275954,0.15782999999964886,7349.680035497566,34467.46499405755
"83.238.232.205",13836,"147.32.84.192",31037,3,825,1,145,2,680,686.929127,0.24180999999998676,4797.154790951836,22497.001778256887
"83.246.177.71",17910,"147.32.84.165",32234,3,825,1,145,2,680,1699.342747,0.06954500000006192,16679.847580688293,78222.73348184854
"83.248.59.56",58410,"147.32.84.165",32234,3,825,1,145,2,680,1094.989981,0.015560000000050422,74550.12853446278,349614.39588575653
"83.252.1.87",34200,"147.32.84.165",32234,3,825,1,145,2,680,2451.132168,0.24741499999981897,4688.478871535068,21987.34919064721
"83.252.206.46",37461,"147.32.84.165",32234,3,825,1,145,2,680,3589.27862,0.17994999999973516,6446.235065305403,30230.619616604647
"83.255.142.136",48570,"147.32.84.165",32234,6,1650,2,290,4,1360,2789.526253,876.4307819999999,2.6471000878195996,12.413986618740191
"84.0.87.237",15745,"147.32.84.192",31037,3,825,1,145,2,680,3336.261862,0.028320000000348955,40960.451976896424,192090.39547785907
"84.0.94.146",33230,"147.32.84.165",32234,3,825,1,145,2,680,368.120537,0.25727299999999786,4508.829142583985,21144.853910049034
"84.0.148.207",61174,"147.32.84.191",29676,3,825,1,145,2,680,2441.973082,0.19135899999992034,6061.9045877146245,28428.242204454793
"84.1.111.194",53800,"147.32.84.165",32234,3,825,1,145,2,680,1528.164219,0.14113100000008671,8219.313970703015,38545.74827640035
"84.2.53.176",60005,"147.32.84.165",32234,3,825,1,145,2,680,763.126082,0.2465750000000071,4704.450978404001,22062.252864239454
"84.2.188.56",57458,"147.32.84.165",32234,3,825,1,145,2,680,1356.075629,0.10797600000000784,10743.128102540524,50381.56627398315
"84.6.89.41",36174,"147.32.84.191",29676,3,825,1,145,2,680,2630.627017,0.17908500000021377,6477.371080763969,30376.636792548266
"84.13.11.238",30670,"147.32.84.165",32234,3,825,1,145,2,680,1408.6679,0.2594970000000103,4470.186553216237,20963.633490945114
"84.13.23.97",41672,"147.32.84.191",29676,3,825,1,145,2,680,3405.927422,0.13625599999977567,8513.386566477144,39924.84734623764
"84.15.156.177",21928,"147.32.84.192",31037,3,825,1,145,2,680,1574.311397,0.27392299999996794,4234.766704512347,19859.595579782042
"84.15.182.3",31234,"147.32.84.191",29676,3,825,1,145,2,680,1945.727745,0.21582400000011148,5374.749796127404,25205.72318183886
"84.20.254.207",17074,"147.32.84.191",29676,12,3278,4,790,8,2488,2173.656365,1424.1392,4.437768442860079,13.97616188080491
"84.25.106.22",56250,"147.32.84.165",32234,3,825,1,145,2,680,729.534841,0.26807899999994333,4327.082688312942,20292.52571070897
"84.25.111.34",29877,"147.32.84.165",32234,3,825,1,145,2,680,2180.570597,0.1045670000003156,11093.36597584801,52024.06112811481
"84.27.102.63",42611,"147.32.84.165",32234,3,426,1,148,2,278,2860.947377,0.10404000000016822,11380.238369839346,21376.393694698232
"84.41.68.7",13239,"147.32.84.191",29676,15,3008,5,792,10,2216,1468.111826,2082.9683429999995,3.0418129115080847,8.510931075633733
"84.48.62.146",10587,"147.32.84.165",32234,15,2516,5,836,10,1680,697.562065,2745.7958129999997,2.43572372291326,4.894755806811335
"84.48.78.194",53147,"147.32.84.191",29676,3,825,1,145,2,680,3603.568547,0.2591080000001966,4476.897664291028,20995.10628770965
"84.48.226.95",51887,"147.32.84.165",32234,3,825,1,145,2,680,316.001318,0.286342999999988,4051.0855861678074,18998.19447306282
"84.49.205.236",37844,"147.32.84.191",29676,4,1007,2,327,2,680,1884.506756,30.862358000000086,84.76345196954792,176.26650562474796
"84.52.139.39",59102,"147.32.84.191",29676,16,3264,6,950,10,2314,1148.186435,2658.779077,2.85845486965971,6.962594282518494
"84.52.155.18",20360,"147.32.84.191",29676,6,1236,2,344,4,892,1581.75025,33.00295099999994,83.38648262090275,216.2230886565269
"84.52.155.18",20425,"147.32.84.191",29676,6,1588,2,344,4,1244,3010.699761,35.730187000000114,77.02170716318925,278.5319875319983
"84.52.163.247",42654,"147.32.84.191",29676,12,3128,4,688,8,2440,1778.16098,1365.6726559999997,4.030248373077187,14.293322718471419
"84.52.168.168",54889,"147.32.84.191",29676,15,3210,5,802,10,2408,1624.989208,2095.158511,3.0622981346350264,9.194531057607412
"84.52.182.155",39851,"147.32.84.191",29676,12,3176,4,688,8,2488,1952.315609,1327.0876110000002,4.147427761647607,14.99825620781867
"84.54.167.101",62557,"147.32.84.165",32234,3,825,1,145,2,680,924.528187,0.07781199999999444,14907.726314708309,69912.09582070103
"84.54.180.199",63263,"147.32.84.192",31037,3,825,1,145,2,680,1964.127418,0.016278999999940424,71257.44824646755,334172.8607420547
"84.58.228.167",48604,"147.32.84.192",31037,3,426,1,148,2,278,1459.368102,0.317506000000094,3729.063387777395,7004.592039203485
"84.58.228.167",48646,"147.32.84.192",31037,3,374,1,196,2,178,1494.126662,0.16441100000020015,9537.074769924708,8661.22096452346
"84.58.228.167",48756,"147.32.84.192",31037,6,868,2,344,4,524,2684.143415,32.182284999999865,85.51288387384587,130.2579975287652
"84.73.3.244",26395,"147.32.84.191",29676,3,825,1,145,2,680,2957.749599,0.04445399999985966,26094.389706295544,122373.68965711012
"84.80.238.191",59095,"147.32.84.165",32234,1,137,1,137,0,0,1527.136944,0,0,0
"84.80.238.191",61365,"147.32.84.165",32234,1,137,1,137,0,0,2431.220872,0,0,0
"84.80.238.191",49626,"147.32.84.165",32234,1,137,1,137,0,0,3312.385505,0,0,0
"84.81.203.30",61841,"147.32.84.192",31037,3,825,1,145,2,680,2824.77312,0.2114150000002155,5486.838682207116,25731.381406212684
"84.82.250.193",64162,"147.32.84.165",32234,3,506,1,148,2,358,1719.606036,0.08264400000007299,14326.508881454845,34654.663375411044
"84.83.72.16",50389,"147.32.84.165",32234,3,825,1,145,2,680,890.26914,0.15478700000005574,7494.1694069888445,35145.070322430445
"84.86.26.236",51486,"147.32.84.192",31037,3,825,1,145,2,680,2334.68527,0.1675359999999273,6923.885015760812,32470.633177361047
"84.94.38.150",39317,"147.32.84.192",31037,3,825,1,145,2,680,2193.807445,0.20626900000024762,5623.724359931,26373.328032779864
"84.100.12.124",27555,"147.32.84.191",29676,3,825,1,145,2,680,3244.078531,0.05883300000004965,19716.825591063196,92465.11311671016
"84.102.195.30",51408,"147.32.84.191",29676,3,825,1,145,2,680,3520.152963,0.12655499999982567,9165.975267682808,42985.26332430559
"84.106.11.98",27408,"147.32.84.192",31037,3,825,1,145,2,680,1904.128667,0.1792809999999463,6470.289657020809,30343.4273570631
"84.111.72.124",34211,"147.32.84.192",31037,3,825,1,145,2,680,1956.637837,0.2548770000000786,4551.2148997345475,21343.628495306843
"84.111.124.18",52066,"147.32.84.165",32234,3,825,1,145,2,680,2974.911822,0.16522600000007515,7020.686816841613,32924.6002444986
"84.120.174.138",53200,"147.32.84.191",29676,3,825,1,145,2,680,3651.803302,0.18001600000025064,6443.871655843841,30219.536041198702
"84.141.53.30",33965,"147.32.84.165",32234,3,825,1,145,2,680,389.260913,0.15863799999999628,7312.245489731509,34291.909882878805
"84.141.79.20",51630,"147.32.84.191",29676,3,825,1,145,2,680,2298.967648,0.1928609999999935,6014.694520924599,28206.843270542944
"84.158.152.63",60382,"147.32.84.191",29676,3,825,1,145,2,680,3666.904057,0.18095799999991868,6410.327258261703,30062.224383572124
"84.161.20.88",39479,"147.32.84.191",29676,6,1650,2,290,4,1360,1595.067872,971.8871039999999,2.3871085339558125,11.194715883378983
"84.165.225.196",47732,"147.32.84.191",29676,3,825,1,145,2,680,2005.200682,0.14531800000008843,7982.49356583007,37435.14223975481
"84.183.94.112",13107,"147.32.84.191",29676,3,825,1,145,2,680,1160.578869,0.18289000000004307,6342.610312208031,29744.655257251456
"84.202.35.159",39936,"147.32.84.165",32234,3,825,1,145,2,680,916.066676,0.23182699999995293,5003.73123061695,23465.77404703121
"84.221.162.49",54750,"147.32.84.165",32234,3,825,1,145,2,680,3300.966347,0.2035729999997784,5698.201627923461,26722.600737847955
"84.232.224.220",55751,"147.32.84.165",32234,3,825,1,145,2,680,1689.077482,0.1565250000001015,7410.956716174718,34754.831496543506
"84.234.3.51",26765,"147.32.84.192",31037,9,1326,3,492,6,834,1337.878599,1501.228985,2.621851855598165,4.444358633270061
"84.234.52.37",10971,"147.32.84.191",29676,3,825,1,145,2,680,3306.494623,0.0676250000001346,17153.41959331151,80443.62292035743
"84.234.56.6",53623,"147.32.84.191",29676,15,2701,5,1021,10,1680,1707.319157,1963.441025,4.160043462471708,6.845125383890764
"84.237.253.58",22399,"147.32.84.192",31037,3,828,1,140,2,688,1394.981329,0.13376300000004449,8373.017949654444,41147.4024954447
"84.238.178.65",20495,"147.32.84.165",32234,3,825,1,145,2,680,3591.51799,0.18399200000021665,6304.621940076928,29566.50289139525
"84.240.221.207",22553,"147.32.84.192",31037,3,825,1,145,2,680,2513.522325,0.1953990000001795,5936.57081151354,27840.470012615224
"84.248.50.25",45001,"147.32.84.165",32234,9,1792,3,444,6,1348,611.687356,2887.04036,1.2303257166796242,3.735313211901201
"84.252.14.157",22634,"147.32.84.165",32234,6,1212,2,334,4,878,2964.744281,7.294180000000324,366.31944920469215,962.9595101847895
"84.252.20.172",60485,"147.32.84.192",31037,3,825,1,145,2,680,1835.096204,0.0641640000001189,18078.6733993805,84782.7442177844
"84.255.196.60",40120,"147.32.84.191",29676,12,3176,4,688,8,2488,1914.685603,1443.2399730000002,3.8136416001277142,13.79119229813627
"84.255.233.45",31703,"147.32.84.191",29676,12,2952,4,688,8,2264,1662.427079,1505.799157,3.6552019400552767,12.028164523670272
"85.1.127.221",8881,"147.32.84.191",29676,1,143,1,143,0,0,2785.044222,0,0,0
"85.8.120.94",63322,"147.32.84.165",32234,3,506,1,148,2,358,1109.535133,0.050207000000000335,23582.368992371423,57043.838508574125
"85.10.37.248",15524,"147.32.84.191",29676,12,2696,4,688,8,2008,1453.071737,1489.83098,3.694378807990689,10.782431172158871
"85.11.167.57",7405,"147.32.84.165",32234,6,858,2,334,4,524,3416.051381,39.272665999999845,68.03714318758016,106.74090727632336
"85.15.101.22",34881,"147.32.84.191",29676,3,825,1,145,2,680,2798.88978,0.2573929999998654,4506.727067172015,21134.995901220485
"85.15.188.137",32033,"147.32.84.165",32234,4,1007,2,327,2,680,3736.609213,35.767325999999684,73.13937866084882,152.0941207626214
"85.21.236.201",63732,"147.32.84.191",29676,3,825,1,145,2,680,3753.740461,0.19857900000033624,5841.503885093771,27394.63890940527
"85.26.125.209",39193,"147.32.84.165",32234,3,825,1,145,2,680,3750.442722,0.21321000000034473,5440.64537309753,25514.750715216003
"85.26.184.176",55031,"147.32.84.191",29676,3,825,1,145,2,680,2100.1689,0.18426399999998466,6295.3154170109,29522.858507361463
"85.26.184.206",52862,"147.32.84.191",29676,3,825,1,145,2,680,2316.504479,0.19402499999978318,5978.611003743313,28037.62401755485
"85.26.232.211",9832,"147.32.84.165",32234,3,825,1,145,2,680,2413.044993,0.17176400000016656,6753.452411441717,31671.363032968053
"85.26.232.211",26446,"147.32.84.165",32234,6,1650,2,290,4,1360,3360.964488,2.1242969999998422,1092.1260068625868,5121.694377010751
"85.50.151.62",59311,"147.32.84.165",32234,3,825,1,145,2,680,1567.378458,0.08878000000004249,13066.005857168786,61275.061950860516
"85.65.32.215",5186,"147.32.84.165",32234,6,1650,2,290,4,1360,2357.322466,882.6482219999998,2.6284537170913835,12.326541569807867
"85.66.9.28",37181,"147.32.84.192",31037,3,825,1,145,2,680,2657.349783,0.17770500000005995,6527.672265831623,30612.532005279336
"85.66.254.217",1643,"147.32.84.192",31037,3,825,1,145,2,680,2582.03959,0.10830299999997806,10710.69130125883,50229.44886107589
"85.70.243.31",20057,"147.32.84.165",32234,3,825,1,145,2,680,658.872426,0.11618299999997816,9984.248986514533,46822.684902275054
"85.73.243.43",15196,"147.32.84.165",32234,3,825,1,145,2,680,2334.119256,0.16790500000024622,6908.668592348643,32399.273398600533
"85.75.66.180",10018,"147.32.84.165",32234,3,825,1,145,2,680,896.198989,0.14073500000006334,8242.441468003539,38654.20826374073
"85.76.121.1",24139,"147.32.84.165",32234,3,825,1,145,2,680,1319.005458,0.3306359999999131,3508.3898909988775,16453.13879916715
"85.83.76.141",28317,"147.32.84.165",32234,3,825,1,145,2,680,396.025286,0.1731589999999983,6699.045386032557,31416.212844842335
"85.83.76.141",28880,"147.32.84.165",32234,3,825,1,145,2,680,1356.443355,0.15630799999985356,7421.245233776177,34803.08109632966
"85.83.76.141",10046,"147.32.84.165",32234,3,825,1,145,2,680,3316.590867,0.11185900000009497,10370.198195934303,48632.65360851949
"85.84.90.100",25943,"147.32.84.192",31037,3,825,1,145,2,680,2746.551585,0.03998799999999392,29008.702610787648,136040.8122436938
"85.85.99.68",47998,"147.32.84.165",32234,3,825,1,145,2,680,281.196906,0.11158399999999347,10395.755663895074,48752.50932033552
"85.90.207.191",24127,"147.32.84.192",31037,3,825,1,145,2,680,2974.107852,0.18004900000005364,6442.69060089006,30213.997300725798
"85.93.140.221",1025,"147.32.84.165",32234,3,825,1,145,2,680,1264.292595,0.25436500000000706,4560.37583787065,21386.590136220977
"85.94.184.245",65000,"147.32.84.165",32234,9,1760,3,444,6,1316,400.896155,2689.7887880000003,1.3205497828850343,3.9140619690916783
"85.98.81.219",10820,"147.32.84.165",32234,6,1650,2,290,4,1360,2368.296279,944.0404449999996,2.4575218278916013,11.524929951491648
"85.99.148.125",46152,"147.32.84.165",32234,3,825,1,145,2,680,3724.183252,0.10448700000006284,11101.859561469872,52063.89311585871
"85.103.157.153",11863,"147.32.84.165",32234,3,825,1,145,2,680,2754.655486,0.272588999999698,4255.49086720772,19956.78475656034
"85.105.140.222",10396,"147.32.84.191",29676,6,1650,2,290,4,1360,1559.509362,927.748601,2.5006774437593573,11.727314908664573
"85.105.247.40",15086,"147.32.84.192",31037,1,143,1,143,0,0,3472.464077,0,0,0
"85.108.53.65",37419,"147.32.84.165",32234,3,825,1,145,2,680,1738.002482,0.17153699999994387,6762.389455338379,31713.274687104124
"85.113.35.20",3385,"147.32.84.192",31037,3,825,1,145,2,680,1354.155239,0.1454439999999977,7975.57822942176,37402.7116965986
"85.113.156.114",46347,"147.32.84.191",29676,3,825,1,145,2,680,1975.237395,0.08956399999988207,12951.632352301453,60738.68965217233
"85.118.104.39",18647,"147.32.84.192",31037,3,825,1,145,2,680,2364.207131,0.28160799999977826,4119.201159061225,19317.633021804366
"85.127.236.201",62580,"147.32.84.165",32234,3,825,1,145,2,680,1934.644363,0.15180499999996755,7641.38203616645,35835.446790297836
"85.132.166.166",17176,"147.32.84.165",32234,3,825,1,145,2,680,3383.24057,0.1892640000000938,6129.004987738952,28742.919942499913
"85.133.184.182",7600,"147.32.84.191",7600,3474,3022016,776,73444,2698,2948572,565.359756,379.62988800000005,1547.6968978796526,62135.71888207073
"85.141.178.30",33533,"147.32.84.191",29676,1,145,1,145,0,0,3787.70081,0,0,0
"85.152.189.180",16350,"147.32.84.165",32234,3,825,1,145,2,680,3085.855654,0.1538060000002588,7541.968453753743,35369.2313693279
"85.164.11.231",24978,"147.32.84.165",32234,3,825,1,145,2,680,2040.059863,0.1524859999999535,7607.255748070996,35675.406266815706
"85.164.33.218",16646,"147.32.84.192",31037,3,825,1,145,2,680,1662.081613,0.2499920000000202,4640.148484751137,21760.696342281193
"85.164.40.159",50538,"147.32.84.192",31037,3,825,1,145,2,680,3172.957375,0.13384399999995367,8666.806132515478,40644.332207658794
"85.172.142.69",35691,"147.32.84.165",32234,7,1241,1,145,6,1096,239.061375,676.215319,1.7154299339379502,12.966284190317197
"85.176.193.183",37539,"147.32.84.191",29676,3,825,1,145,2,680,2078.867738,0.3379500000000917,3432.4604231385865,16097.05577747751
"85.178.226.163",33235,"147.32.84.165",32234,3,825,1,145,2,680,2532.099485,0.06836299999986295,16968.24305548799,79575.20881194368
"85.192.61.232",21467,"147.32.84.165",32234,3,825,1,145,2,680,1346.348324,0.23755499999992935,4883.07970785858,22899.960009267823
"85.198.185.238",59895,"147.32.84.165",32234,3,825,1,145,2,680,3347.951853,0.10606599999982791,10936.58665361079,51288.8201686575
"85.198.239.244",57989,"147.32.84.192",31037,3,825,1,145,2,680,3619.696348,0.16562500000009095,7003.7735849018145,32845.283018849885
"85.201.120.118",62560,"147.32.84.192",31037,3,825,1,145,2,680,1772.795269,0.17443100000014056,6650.19405953681,31187.11696886228
"85.202.146.134",24738,"147.32.84.192",31037,3,828,1,140,2,688,1554.904297,0.24589999999989232,4554.697031315537,22383.082553893495
"85.217.176.241",21672,"147.32.84.192",31037,3,825,1,145,2,680,2791.390376,0.31315900000026886,3704.1886070622404,17371.36726070568
"85.222.86.10",12615,"147.32.84.192",31037,3,426,1,148,2,278,1306.546342,0.15417200000001685,7679.734322703673,14425.446903456897
"85.222.86.10",61493,"147.32.84.192",31037,6,836,2,344,4,492,2612.376739,31.849294999999984,86.406936166091,123.58201335382783
"85.224.62.94",40785,"147.32.84.165",32234,3,825,1,145,2,680,3451.000864,0.1681100000000697,6900.243887927661,32359.764439936615
"85.228.48.24",36822,"147.32.84.165",32234,3,825,1,145,2,680,897.170769,0.18352600000002894,6320.630319408787,29641.57667033086
"85.228.170.60",12020,"147.32.84.191",29676,3,825,1,145,2,680,2297.535531,0.220346999999947,5264.42384057999,24688.332493754435
"85.228.254.16",20026,"147.32.84.165",32234,3,825,1,145,2,680,3421.761343,0.2085469999997258,5562.295309937449,26085.24697074114
"85.231.136.250",26000,"147.32.84.191",29676,1,145,1,145,0,0,3792.593633,0,0,0
"85.233.93.137",61428,"147.32.84.192",31037,3,825,1,145,2,680,920.220776,0.25950299999999515,4470.083197496837,20963.148788261027
"85.235.223.57",52050,"147.32.84.165",32234,3,825,1,145,2,680,1670.365472,0.18179800000007162,6380.708258614192,29923.321488673453
"85.240.19.66",20422,"147.32.84.165",32234,3,825,1,145,2,680,2961.993307,0.25688599999966755,4515.621715474963,21176.708734641205
"85.242.41.187",54372,"147.32.84.191",7600,363,345598,45,4442,318,341156,804.116668,1.2407419999999547,28640.926155478977,2199690.1853891457
"85.245.160.115",39244,"147.32.84.165",32234,3,825,1,145,2,680,3757.558209,0.1583680000003369,7324.712063027457,34350.37381281842
"85.250.152.14",4287,"147.32.84.165",32234,1,143,1,143,0,0,3245.873863,0,0,0
"85.250.188.241",51867,"147.32.84.165",32234,1,143,1,143,0,0,2607.985095,0,0,0
"85.254.9.90",56849,"147.32.84.165",32234,3,825,1,145,2,680,3576.729355,0.19251399999984642,6025.535805193001,28257.685155387866
"85.254.25.207",31141,"147.32.84.192",31037,1,143,1,143,0,0,2210.974241,0,0,0
"85.255.74.145",64299,"147.32.84.165",32234,3,825,1,145,2,680,1104.707031,0.19331099999999424,6000.6931835231035,28141.18182617731
"86.2.11.93",31878,"147.32.84.165",32234,6,948,2,296,4,652,879.818119,1498.953736,1.5797685699887405,3.4797604987589827
"86.19.96.20",36542,"147.32.84.192",31037,3,825,1,145,2,680,2415.72765,0.12619000000040614,9192.48751879124,43109.59663984857
"86.26.89.70",7600,"147.32.84.165",7600,471,452400,59,5792,412,446608,819.179244,2.5865689999999404,17914.078456828745,1381314.0109543114
"86.38.186.255",16956,"147.32.84.165",32234,3,825,1,145,2,680,3445.092069,0.1273909999999887,9105.823802310233,42703.17369359281
"86.58.21.178",22281,"147.32.84.191",29676,12,2456,4,688,8,1768,1273.809072,1375.3209590000001,4.001974931002269,10.284144880831413
"86.58.46.218",62731,"147.32.84.191",29676,12,3176,4,688,8,2488,2226.131104,1392.030533,3.9539362603909205,14.298536941646235
"86.58.46.228",16272,"147.32.84.191",29676,12,2632,4,688,8,1944,1386.363381,1516.870455,3.6285234390698182,10.252688322022859
"86.58.47.154",31000,"147.32.84.191",29676,6,1271,2,395,4,876,1568.207149,30.05152699999985,105.15272651536195,233.19946437330904
"86.58.52.254",34560,"147.32.84.191",29676,12,2952,4,688,8,2264,1660.457694,1330.999161,4.135239270823252,13.607822251662562
"86.58.61.50",29604,"147.32.84.191",29676,12,2776,4,688,8,2088,1550.709766,1244.0090020000002,4.4244052825592,13.427555566836643
"86.61.15.75",46859,"147.32.84.191",29676,6,1460,2,344,4,1116,1706.379813,29.617860000000064,92.9169089191452,301.4397394004827
"86.61.44.93",50586,"147.32.84.191",29676,6,935,2,395,4,540,1296.001262,36.985120999999936,85.43976373634158,116.80372763955558
"86.61.49.184",19954,"147.32.84.191",29676,12,2776,4,688,8,2088,1526.337488,1499.529139,3.670485525656731,11.13949676972566
"86.61.53.46",29108,"147.32.84.191",29676,12,2904,4,688,8,2216,1637.779975,1444.0961350000002,3.811380604519102,12.276191016881295
"86.61.54.56",1043,"147.32.84.191",29676,12,2776,4,688,8,2088,1534.743004,1518.1231670000002,3.625529284871258,11.003059806411608
"86.61.66.28",17717,"147.32.84.191",29676,12,2584,4,688,8,1896,1338.496316,1406.08371,3.914418438145478,10.78740895163347
"86.67.201.213",35473,"147.32.84.165",32234,1,143,1,143,0,0,1599.836841,0,0,0
"86.73.171.51",63355,"147.32.84.192",31037,1,143,1,143,0,0,3249.916548,0,0,0
"86.81.173.147",29770,"147.32.84.165",32234,1,143,1,143,0,0,2500.822005,0,0,0
"86.83.94.113",63131,"147.32.84.192",31037,3,825,1,145,2,680,1706.693299,0.17948099999989608,6463.07965746052,30309.614945332094
"86.92.35.46",10210,"147.32.84.192",31037,3,825,1,145,2,680,1192.52318,0.13680900000008478,8478.974336478457,39763.46585383001
"86.92.214.25",27743,"147.32.84.165",32234,3,825,1,145,2,680,3329.39675,0.1647090000001299,7042.723834150443,33027.94625670552
"86.97.122.188",59861,"147.32.84.165",32234,3,825,1,145,2,680,2896.679835,0.08433500000001004,13754.66888006002,64504.654058212516
"86.97.162.2",19985,"147.32.84.165",32234,3,828,1,140,2,688,3031.318114,0.16026899999997113,6988.251003002463,34342.26207189782
"86.97.252.206",22361,"147.32.84.192",31037,15,4125,5,725,10,3400,1016.729198,2741.180152,2.1158769866943063,9.922733454842264
"86.97.254.24",21571,"147.32.84.165",32234,3,825,1,145,2,680,353.167132,0.27931599999999435,4153.0023342738095,19476.14887797373
"86.99.39.133",44055,"147.32.84.165",32234,3,825,1,145,2,680,1892.36553,0.27371999999991203,4237.907350578595,19874.324126851337
"86.99.85.174",6881,"147.32.84.191",29676,1,143,1,143,0,0,1621.469679,0,0,0
"86.99.216.150",24201,"147.32.84.191",29676,3,825,1,145,2,680,2676.245903,0.058469999999942956,19839.23379512796,93039.16538404835
"86.99.250.159",18927,"147.32.84.165",32234,7,1832,3,472,4,1360,2619.368697,898.7038339999999,4.201606644086043,12.106324228722498
"86.100.33.195",47749,"147.32.84.191",29676,6,1650,2,290,4,1360,1686.840361,1696.0579050000001,1.3678778260816513,6.414875322313951
"86.101.21.94",34423,"147.32.84.192",31037,3,825,1,145,2,680,2452.701488,0.19722299999966708,5881.6669455487345,27582.98981360786
"86.101.32.178",63943,"147.32.84.165",32234,7,1241,1,145,6,1096,1478.228238,2006.7480990000001,0.5780496319284167,4.369257907541687
"86.106.243.42",36619,"147.32.84.191",29676,12,2184,4,688,8,1496,2119.868456,1325.0966359999998,4.153659326020658,9.031794115882128
"86.125.255.207",42058,"147.32.84.192",31037,3,825,1,145,2,680,1830.811579,0.2678000000000793,4331.590739356447,20313.666915602647
"86.126.110.125",31873,"147.32.84.165",32234,3,825,1,145,2,680,2159.276796,0.18681100000003426,6209.484452199214,29120.340879279072
"86.127.99.142",54055,"147.32.84.165",32234,3,825,1,145,2,680,515.15975,0.22238099999992755,5216.272972962519,24462.52152837595
"86.127.192.125",61123,"147.32.84.191",29676,3,825,1,145,2,680,2453.647913,0.21110200000020996,5494.973993608996,25769.533211407706
"86.136.167.252",15078,"147.32.84.191",29676,3,828,1,140,2,688,3225.059953,0.14298599999983708,7832.934692915923,38493.27906232968
"86.143.98.65",61997,"147.32.84.165",32234,3,825,1,145,2,680,2379.420002,0.17364100000031613,6680.4498937341305,31329.00639820144
"86.144.97.46",31979,"147.32.84.192",31037,3,825,1,145,2,680,3511.896191,0.20799699999997756,5577.003514474368,26154.223378224622
"86.148.187.77",50343,"147.32.84.191",29676,3,825,1,145,2,680,3134.582495,0.19700699999975768,5888.115650720161,27613.232017170412
"86.149.146.214",25117,"147.32.84.165",32234,3,825,1,145,2,680,3150.333626,0.27902799999992567,4157.288874235951,19496.251272278943
"86.153.229.130",30885,"147.32.84.192",31037,3,825,1,145,2,680,2609.501177,0.07734200000004421,14998.319153879353,70336.94499750317
"86.160.188.37",56867,"147.32.84.165",32234,3,825,1,145,2,680,2455.767582,0.1277060000002166,9083.363350179574,42597.84191808352
"86.161.46.83",56248,"147.32.84.165",32234,3,825,1,145,2,680,810.340928,0.2110290000000532,5496.87483710631,25778.447511946833
"86.167.69.33",12595,"147.32.84.192",31037,3,825,1,145,2,680,1006.521812,0.2280709999999999,5086.135457817963,23852.2214573532
"86.171.19.51",18749,"147.32.84.165",32234,3,825,1,145,2,680,628.836589,0.21783400000003894,5325.155852620769,24973.144688152574
"86.173.82.254",45682,"147.32.84.191",29676,3,825,1,145,2,680,2179.263878,0.10778099999970436,10762.564830565516,50472.71782610035
"86.193.28.164",39932,"147.32.84.192",31037,3,825,1,145,2,680,2526.681847,0.10950200000024779,10593.41381890171,49679.45790933216
"86.212.118.111",36993,"147.32.84.165",32234,3,825,1,145,2,680,426.63569,0.11745200000001432,9876.375029798202,46316.793243191576
"86.220.104.125",55528,"147.32.84.165",32234,1,107,1,107,0,0,3729.079679,0,0,0
"87.0.4.47",24320,"147.32.84.165",32234,7,1241,1,145,6,1096,1101.320326,2542.539145,0.45623683013147864,3.448521143614487
"87.4.245.84",10003,"147.32.84.165",32234,3,825,1,145,2,680,1317.901125,0.18400599999995393,6304.142256232353,29564.253339572417
"87.7.191.147",13234,"147.32.84.191",29676,3,825,1,145,2,680,2216.30143,0.12460999999984779,9309.044217971406,43656.20736703832
"87.7.252.47",28687,"147.32.84.191",29676,9,1856,3,492,6,1364,2070.630933,1392.0525780000003,2.82747940861182,7.838784376720573
"87.13.67.229",29917,"147.32.84.191",29676,6,868,2,344,4,524,1525.523047,34.86594100000002,78.93089706083074,120.23194784847475
"87.14.223.163",46998,"147.32.84.191",29676,3,828,1,148,2,680,2212.011834,0.17709000000013475,6685.865943865261,30718.843525867414
"87.15.239.108",55001,"147.32.84.165",32234,1,143,1,143,0,0,1195.366127,0,0,0
"87.16.170.42",60909,"147.32.84.165",32234,3,825,1,145,2,680,2218.815446,0.19408599999997023,5976.731964181744,28028.811969955765
"87.20.167.182",13882,"147.32.84.192",31037,11,1405,3,429,8,976,1157.749372,2446.0202710000003,1.4030954856301758,3.192123995279841
"87.21.12.185",44573,"147.32.84.192",31037,6,1650,2,290,4,1360,2041.102315,842.1480029999998,2.754860181031624,12.919344297251754
"87.55.34.188",12588,"147.32.84.192",31037,1,143,1,143,0,0,1622.791838,0,0,0
"87.60.135.140",40457,"147.32.84.165",32234,4,1007,2,327,2,680,3007.995018,30.27464000000009,86.408954821593,179.68834641799154
"87.68.57.255",21161,"147.32.84.165",32234,6,1650,2,290,4,1360,343.904716,1769.736601,1.3109295466280522,6.1478075290143135
"87.69.90.187",56067,"147.32.84.191",29676,1,143,1,143,0,0,2694.08983,0,0,0
"87.69.233.175",54471,"147.32.84.192",31037,12,3300,4,580,8,2720,1413.47896,1849.677045,2.5085460256657943,11.764215844501654
"87.95.30.174",35432,"147.32.84.165",32234,3,825,1,145,2,680,1169.26406,0.3029599999999846,3828.888302086279,17956.165830473583
"87.97.238.42",7600,"147.32.84.192",7600,431,416889,51,7657,380,409232,2619.514399,0.8233409999998003,74399.30721294683,3976306.293505114
"87.101.138.41",26177,"147.32.84.165",32234,3,825,1,145,2,680,2990.721053,0.16848899999968125,6884.722444801705,32286.97422389765
"87.101.193.38",12807,"147.32.84.191",29676,3,831,1,143,2,688,2344.637923,0.23962600000004386,4774.106315674387,22969.12688939845
"87.110.40.81",47833,"147.32.84.192",31037,3,825,1,145,2,680,2841.357673,0.1776719999998022,6528.88468639567,30618.217839648656
"87.110.133.171",33065,"147.32.84.165",32234,3,825,1,145,2,680,1199.581956,0.137662999999975,8426.374552350382,39516.79100412593
"87.110.245.226",16851,"147.32.84.191",29676,3,825,1,145,2,680,1760.169445,0.18627799999990202,6227.251742023267,29203.66334190222
"87.120.184.230",20887,"147.32.84.192",31037,6,1212,2,334,4,878,863.12022,0.35981200000003355,7426.100296820981,19521.305570685094
"87.121.77.226",2611,"147.32.84.192",31037,3,426,1,148,2,278,1852.182314,0.2682270000000244,4414.171578550601,8291.484451601806
"87.121.77.226",2622,"147.32.84.192",31037,3,458,1,148,2,310,3158.192023,0.1867699999997967,6339.347861012415,13278.363762931409
"87.126.59.27",27316,"147.32.84.165",32234,3,828,1,140,2,688,2933.857552,0.1619220000002315,6916.9106112720865,33991.67500396568
"87.126.199.162",7878,"147.32.84.192",31037,3,825,1,145,2,680,3352.437178,0.16924399999970774,6854.00959562527,32142.941551897817
"87.155.225.145",58901,"147.32.84.192",31037,1,143,1,143,0,0,3795.204949,0,0,0
"87.169.192.209",55276,"147.32.84.192",31037,3,825,1,145,2,680,764.42651,0.06986600000004728,16603.21186269738,77863.3383905808
"87.175.198.252",51954,"147.32.84.165",32234,3,825,1,145,2,680,2348.527935,0.14939499999991313,7764.650758062014,36413.5345895322
"87.194.110.128",43755,"147.32.84.192",31037,3,825,1,145,2,680,1946.905681,0.1265410000000884,9166.989355222337,42990.01904518061
"87.202.55.149",50075,"147.32.84.191",7600,361,345638,45,4438,316,341200,2972.111598,1.3954640000001746,25442.433484486563,1956051.8938501163
"87.206.203.243",1032,"147.32.84.192",31037,9,1294,3,492,6,802,1214.457178,1514.1488139999997,2.599480291241704,4.237364214585054
"87.207.125.33",55920,"147.32.84.165",32234,3,825,1,145,2,680,179.418666,0.1838989999999967,6307.810265417544,29581.455037820204
"87.207.150.116",27373,"147.32.84.165",32234,3,825,1,145,2,680,2287.559042,0.2523450000003322,4596.8812538329385,21557.787949009642
"87.208.19.39",38825,"147.32.84.192",31037,3,825,1,145,2,680,1506.286131,0.17472799999995914,6638.89016070848,31134.10558125356
"87.209.58.195",31395,"147.32.84.191",29676,14,2626,2,290,12,2336,1211.315737,2108.344523,1.1003894167632677,8.863826474341357
"87.210.226.57",50001,"147.32.84.165",32234,3,828,1,140,2,688,1884.036989,0.26779000000010456,4182.3817170154325,20553.4187236187
"87.211.68.110",32107,"147.32.84.165",32234,3,442,1,148,2,294,3510.187328,0.17707000000018525,6686.621110288368,13282.88247584311
"87.216.80.192",58943,"147.32.84.191",29676,3,429,3,429,0,0,1949.865532,1789.066728,1.918318610640441,0
"87.217.197.57",43244,"147.32.84.191",29676,3,825,1,145,2,680,2733.436869,0.06896199999982855,16820.85786379287,78884.02308537347
"87.221.54.18",14596,"147.32.84.165",32234,3,825,1,145,2,680,2281.30713,0.09367699999984325,12382.975543644023,58071.88530812369
"87.222.124.139",63473,"147.32.84.165",32234,3,825,1,145,2,680,584.70005,0.2496729999999161,4646.077068807559,21788.499357166485
"87.226.20.9",20642,"147.32.84.165",32234,3,825,1,145,2,680,890.319433,0.10461599999996452,11088.170069591586,51999.694119463995
"87.226.78.24",31000,"147.32.84.165",32234,3,825,1,145,2,680,2392.164868,0.1843189999999595,6293.436921859683,29514.049012859203
"87.228.47.212",47852,"147.32.84.191",29676,3,825,1,145,2,680,1953.416554,0.18462399999998524,6283.040124794678,29465.29161972677
"87.228.128.117",32598,"147.32.84.192",31037,3,825,1,145,2,680,2977.838541,0.07267000000001644,15962.570524284265,74858.95142422966
"87.231.218.254",57646,"147.32.84.192",31037,3,825,1,145,2,680,3676.848548,0.24737499999991996,4689.236988379485,21990.904497227933
"87.239.27.213",50734,"147.32.84.165",32234,1,143,1,143,0,0,3609.794138,0,0,0
"87.244.128.124",58718,"147.32.84.192",31037,3,825,1,145,2,680,1550.228202,0.03029799999990246,38286.35553514207,179549.80526825247
"87.247.55.47",13543,"147.32.84.165",32234,3,825,1,145,2,680,3741.378209,0.17490600000019185,6632.133831879567,31102.420728814523
"87.249.59.146",33406,"147.32.84.165",32234,3,825,1,145,2,680,3045.835232,0.23680199999989782,4898.607275278505,22972.77894613368
"87.254.136.125",35691,"147.32.84.165",32234,12,3300,4,580,8,2720,819.313371,2832.07979,1.6383719188928643,7.683399343773433
"88.0.74.97",37844,"147.32.84.165",32234,3,825,1,145,2,680,598.453279,0.15073600000005172,7695.573718286289,36089.58709265294
"88.7.62.210",19622,"147.32.84.165",32234,4,1007,2,327,2,680,949.120049,39.129575000000045,66.85480228190562,139.02527691650099
"88.17.13.128",46769,"147.32.84.165",32234,1,143,1,143,0,0,3404.349022,0,0,0
"88.24.2.237",18982,"147.32.84.191",29676,3,825,1,145,2,680,2363.123244,0.2628890000000865,4412.508701389629,20693.144254792744
"88.71.81.187",61388,"147.32.84.165",32234,3,825,1,145,2,680,2135.313841,0.20263099999965561,5724.691680946999,26846.82995202731
"88.80.114.107",39165,"147.32.84.192",31037,3,825,1,145,2,680,740.411502,0.31422699999995984,3691.5987486757926,17312.325166203715
"88.80.136.16",25570,"147.32.84.192",31037,3,825,1,145,2,680,677.224591,0.036398999999960324,31869.00739034766,149454.6553478373
"88.87.102.218",4661,"147.32.84.192",31037,3,825,1,145,2,680,2410.34608,0.27376300000014453,4237.241701761697,19871.20246343417
"88.87.254.189",15433,"147.32.84.191",29676,1,145,1,145,0,0,3778.57553,0,0,0
"88.89.52.97",12083,"147.32.84.192",31037,3,825,1,145,2,680,1692.558175,0.08960900000010952,12945.128279509672,60708.1877935626
"88.101.150.24",14968,"147.32.84.191",29676,3,825,1,145,2,680,2037.27089,0.07524100000000544,15417.126300818916,72301.00610039216
"88.113.242.222",32615,"147.32.84.165",32234,3,825,1,145,2,680,2019.860926,0.2132489999999052,5439.650361786061,25510.08445527256
"88.115.164.114",57101,"147.32.84.191",29676,3,825,1,145,2,680,1281.50053,0.1863499999999476,6224.845720420317,29192.379930247003
"88.135.63.27",57529,"147.32.84.192",31037,3,825,1,145,2,680,3086.168119,0.09788699999990058,11850.398929389788,55574.28463437969
"88.135.127.43",35691,"147.32.84.191",29676,3,825,1,145,2,680,3165.480905,0.11616200000025856,9986.053959103821,46831.14960131447
"88.135.157.31",46913,"147.32.84.191",29676,3,825,1,145,2,680,2406.351803,0.1629649999999856,7118.0928420219225,33381.40091430971
"88.159.216.129",30340,"147.32.84.165",32234,3,825,1,145,2,680,963.035762,0.15126099999997678,7668.863752058879,35964.326561379574
"88.162.30.167",51413,"147.32.84.192",31037,9,1914,3,372,6,1542,1866.885095,1658.093383,1.7948325652295303,7.439870471999828
"88.162.93.226",10387,"147.32.84.192",31037,9,2475,3,435,6,2040,673.108837,2708.7077710000003,1.2847454558434164,6.025013172231194
"88.163.141.208",33205,"147.32.84.192",31037,3,825,1,145,2,680,1462.399357,0.11292899999989459,10271.940776957936,48171.860195388945
"88.166.176.52",51413,"147.32.84.165",32234,6,1098,2,236,4,862,665.385951,1602.165534,1.1784050773370338,4.304174477392047
"88.174.100.88",64677,"147.32.84.165",32234,3,825,1,145,2,680,3504.550287,0.05671299999994517,20453.86419341459,95921.570010496
"88.174.112.40",43418,"147.32.84.192",31037,3,825,1,145,2,680,1054.120067,0.20967899999982365,5532.265987537978,25944.419803626377
"88.174.254.53",53005,"147.32.84.192",31037,3,825,1,145,2,680,1778.295353,0.14720899999997528,7879.9529920058885,36954.26230733796
"88.178.111.163",50147,"147.32.84.191",29676,3,825,1,145,2,680,2965.878618,0.15169699999978548,7646.822283905683,35860.959676247345
"88.181.214.212",41523,"147.32.84.165",32234,3,825,1,145,2,680,2121.504893,0.19861700000001292,5840.386271064031,27389.397684989937
"88.182.254.45",44484,"147.32.84.165",32234,3,825,1,145,2,680,2213.403224,0.1891499999996995,6132.698916213813,28760.243193278573
"88.184.198.136",37447,"147.32.84.165",32234,3,825,1,145,2,680,1579.7662,0.26947199999995064,4304.714404465816,20187.62617266728
"88.189.129.230",21189,"147.32.84.192",31037,1,143,1,143,0,0,3750.907234,0,0,0
"88.195.248.163",58769,"147.32.84.192",31037,3,825,1,145,2,680,778.199399,0.24141900000006444,4804.924218887869,22533.437716163797
"88.204.70.81",17668,"147.32.84.192",31037,3,825,1,145,2,680,1914.904789,0.07872700000007171,14734.462128608271,69099.54653416293
"88.213.216.61",61849,"147.32.84.192",31037,3,828,1,140,2,688,1401.561371,0.22578999999996086,4960.36139775984,24376.633154705498
"88.213.230.99",60711,"147.32.84.192",31037,3,825,1,145,2,680,2924.317579,0.2239399999998568,5179.958917570518,24292.22113067553
"88.216.130.27",24457,"147.32.84.191",29676,3,825,1,145,2,680,1363.372214,0.21790699999996832,5323.371897186271,24964.77855232182
"88.218.196.48",53698,"147.32.84.191",29676,3,825,1,145,2,680,1809.923621,0.1922270000000026,6034.532089664742,28299.874627393274
"88.219.219.209",10975,"147.32.84.165",32234,3,825,1,145,2,680,714.580081,0.26251300000001265,4418.828781812497,20722.783252637917
"88.226.49.81",21972,"147.32.84.191",29676,3,825,1,145,2,680,2939.150085,0.3267409999998563,3550.2125536755725,16649.27266551303
"88.227.80.243",32808,"147.32.84.165",32234,3,825,1,145,2,680,2725.291531,0.11331999999993059,10236.498411584103,48005.64772329097
"88.229.42.96",29678,"147.32.84.192",31037,3,825,1,145,2,680,1532.47566,0.17000599999983024,6823.288589821291,31998.87062812743
"88.229.140.244",47684,"147.32.84.191",29676,3,825,1,145,2,680,2587.009905,0.07560400000011214,15343.103539472508,71953.86487476762
"88.237.201.189",16521,"147.32.84.191",29676,3,825,1,145,2,680,3405.956941,0.10686699999996563,10854.61367868821,50904.39518281368
"88.238.125.129",18269,"147.32.84.191",29676,3,825,1,145,2,680,1763.576603,0.20126299999992625,5763.602848016899,27029.30990794132
"88.240.39.243",50982,"147.32.84.191",29676,3,825,1,145,2,680,1694.320333,0.1530200000001969,7580.708404120425,35550.90837794406
"88.245.221.75",21491,"147.32.84.165",7600,266,248257,38,3681,228,244576,1322.856229,2.098304999999982,14034.184734821798,932470.7323291975
"88.245.251.152",7600,"147.32.84.165",7600,3,269,1,89,2,180,569.006912,0.00020399999993969686,0,0
"88.246.134.163",19649,"147.32.84.165",32234,3,825,1,145,2,680,516.310073,0.1049319999999625,11054.778332638418,51843.09838754569
"88.247.43.43",54769,"147.32.84.165",32234,1,107,1,107,0,0,2341.734315,0,0,0
"88.248.10.102",52921,"147.32.84.192",31037,3,825,1,145,2,680,2566.317424,0.13867400000026464,8364.942238615648,39228.69463626648
"88.248.134.129",7600,"147.32.84.191",7600,343,330072,43,6440,300,323632,2028.885065,1.4516940000000886,35489.572871415636,1783472.2744599357
"88.250.181.235",28912,"147.32.84.165",32234,3,825,1,145,2,680,3138.988554,0.25939500000004045,4471.944332002618,20971.876867322622
"89.20.110.216",32400,"147.32.84.165",32234,3,825,1,145,2,680,3441.450727,0.09380499999997483,12366.07856724387,57992.64431535057
"89.25.16.209",58479,"147.32.84.192",31037,3,825,1,145,2,680,1463.600875,0.13072399999987283,8873.657476830027,41614.393684444265
"89.25.27.244",19467,"147.32.84.192",31037,3,825,1,145,2,680,1219.486927,0.15702299999998104,7387.452793540692,34644.60620419083
"89.28.6.139",42397,"147.32.84.191",29676,12,2120,4,688,8,1432,1811.263893,1284.6687089999998,4.284373053878127,8.917474147025404
"89.28.17.57",15879,"147.32.84.191",29676,6,1156,2,344,4,812,2705.103772,32.23995999999988,85.35990739442636,201.48908373335524
"89.28.17.156",15514,"147.32.84.191",29676,12,2056,4,688,8,1368,1631.100283,1381.0807969999998,3.9852845770905327,7.924228635842803
"89.28.59.239",39949,"147.32.84.165",32234,1,143,1,143,0,0,2899.688391,0,0,0
"89.28.93.225",40681,"147.32.84.192",31037,3,825,1,145,2,680,906.054668,0.26063699999997425,4450.634407241161,20871.940668441308
"89.28.116.16",11161,"147.32.84.191",29676,6,1188,2,344,4,844,3730.346088,32.05819500000007,85.84388484754035,210.61697328873274
"89.32.52.7",22123,"147.32.84.191",29676,3,825,1,145,2,680,2995.970477,0.11389600000029532,10184.72992903168,47762.87139132099
"89.39.58.194",25413,"147.32.84.192",31037,21,3136,7,1146,14,1990,650.477867,3010.6806779999997,3.0451585473655474,5.287840758514345
"89.41.94.10",57839,"147.32.84.165",32234,3,442,1,148,2,294,3696.256845,0.1722010000003138,6875.685971613651,13658.457267935228
"89.41.100.72",33037,"147.32.84.191",29676,12,2200,4,688,8,1512,2175.685871,1336.14286,4.11931999546815,9.05292417608698
"89.43.29.4",38792,"147.32.84.165",32234,3,825,1,145,2,680,1382.482467,0.1354959999998755,8561.138336194912,40148.78668008649
"89.46.15.32",62256,"147.32.84.165",32234,3,825,1,145,2,680,3189.561908,0.2763449999997647,4197.651486370253,19685.538005046707
"89.46.244.86",2017,"147.32.84.165",32234,3,825,1,145,2,680,1681.425538,0.08746799999994437,13261.992957432865,62194.17386934033
"89.73.11.208",41466,"147.32.84.165",32234,3,825,1,145,2,680,1380.886482,0.10433500000021922,11118.0332582313,52139.74217653299
"89.74.0.118",33942,"147.32.84.192",31037,3,825,1,145,2,680,1452.089895,0.1325970000000325,8748.31255608887,41026.5692285547
"89.74.196.47",59924,"147.32.84.192",31037,3,426,1,148,2,278,1464.305721,0.2342670000000453,5054.062245214952,9493.441244390247
"89.75.125.168",17075,"147.32.84.192",31037,9,1454,3,492,6,962,986.770227,2515.470422,1.5647172654372004,3.0594674986800543
"89.78.89.180",61778,"147.32.84.192",31037,3,825,1,145,2,680,1880.094444,0.21265500000004067,5454.844701510795,25581.340669154073
"89.79.75.196",34564,"147.32.84.165",32234,6,1650,2,290,4,1360,1423.555177,811.0873640000002,2.860357716040068,13.41409135798101
"89.80.229.248",40404,"147.32.84.165",32234,12,1688,4,688,8,1000,787.946176,1473.2892780000002,3.735858315260202,5.430026621017736
"89.82.2.211",64714,"147.32.84.165",32234,3,825,1,145,2,680,901.60619,0.21375499999999192,5426.7736427220125,25449.697083110128
"89.82.174.201",58449,"147.32.84.191",29676,1,107,1,107,0,0,1548.585083,0,0,0
"89.83.65.208",33648,"147.32.84.191",29676,3,828,1,148,2,680,2547.521738,0.10512599999992744,11262.675265879203,51747.42689728283
"89.85.38.73",10532,"147.32.84.165",32234,3,825,1,145,2,680,2215.956811,0.30903799999987314,3753.58370168224,17603.01322168223
"89.90.55.186",50321,"147.32.84.192",31037,3,825,1,145,2,680,3085.363609,0.09264200000006895,12521.31862437271,58720.66665223065
"89.103.92.164",61030,"147.32.84.165",32234,3,825,1,145,2,680,2976.368191,0.12234499999976833,9481.384609115179,44464.42437378153
"89.106.30.2",63447,"147.32.84.191",29676,1,107,1,107,0,0,2793.671654,0,0,0
"89.106.197.33",16789,"147.32.84.192",31037,2,250,2,250,0,0,1535.796811,125.03353800000014,15.995708287483618,0
"89.106.197.115",50943,"147.32.84.192",31037,1,143,1,143,0,0,3728.540033,0,0,0
"89.117.27.1",36696,"147.32.84.192",31037,3,825,1,145,2,680,942.933203,0.21930699999995795,5289.3888475982185,24805.409768046815
"89.122.65.116",10339,"147.32.84.165",32234,3,828,1,140,2,688,2035.969313,0.17600199999992583,6363.5640504112,31272.371904877895
"89.123.233.90",10013,"147.32.84.192",31037,3,825,1,145,2,680,3167.720634,0.1336670000000595,8678.282597795145,40698.152872418614
"89.123.234.177",10015,"147.32.84.191",29676,3,825,1,145,2,680,2369.440237,0.1909640000003492,6074.443350568059,28487.044678526072
"89.129.19.135",1500,"147.32.84.165",32234,1,143,1,143,0,0,904.413881,0,0,0
"89.132.173.194",28258,"147.32.84.192",31037,3,825,1,145,2,680,1611.455231,0.20926900000017667,5543.104807683033,25995.2501325825
"89.133.94.92",29014,"147.32.84.165",32234,3,825,1,145,2,680,1120.715718,0.22650599999997212,5121.277140562029,24017.023831601236
"89.133.100.70",56125,"147.32.84.191",29676,3,825,1,145,2,680,2492.454752,0.22893199999998615,5067.006796778389,23762.51463316762
"89.134.11.43",9448,"147.32.84.191",29676,3,828,1,140,2,688,2610.848302,0.23075400000016089,4853.653674472464,23852.2409145504
"89.134.167.110",15678,"147.32.84.192",31037,3,825,1,145,2,680,1927.568178,0.11241599999993923,10318.81582693413,48391.68801596695
"89.135.82.48",60088,"147.32.84.165",32234,6,1650,2,290,4,1360,2555.844121,866.1258950000001,2.6785944322793855,12.561684234137807
"89.135.200.27",9999,"147.32.84.165",32234,3,825,1,145,2,680,3466.623346,0.24744300000020303,4687.948335572428,21984.86115992587
"89.138.65.226",64000,"147.32.84.191",29676,3,825,1,145,2,680,2132.665212,0.3307310000000143,3507.382132306768,16448.412758404156
"89.139.37.81",24651,"147.32.84.191",29676,3,825,1,145,2,680,2185.748796,0.26268900000013673,4415.868193945678,20708.899116434903
"89.142.35.23",58182,"147.32.84.191",29676,3,1210,1,148,2,1062,2349.334964,0.16467499999998836,7189.919538485403,51592.530742374984
"89.142.35.23",58188,"147.32.84.191",29676,3,374,1,196,2,178,2380.083283,0.026873000000250613,58348.52826202423,52989.98995224649
"89.142.35.23",58201,"147.32.84.191",29676,1,148,1,148,0,0,3781.121338,0,0,0
"89.142.40.245",43242,"147.32.84.191",29676,12,2456,4,688,8,1768,1286.911814,1340.279603,4.106605806490066,10.55302189807331
"89.142.82.197",34865,"147.32.84.165",32234,1,146,1,146,0,0,3268.118783,0,0,0
"89.142.88.231",10419,"147.32.84.191",29676,12,3176,4,688,8,2488,2076.284208,1521.51147,3.617455476691214,13.081728526174043
"89.142.103.14",48151,"147.32.84.191",29676,6,1588,2,344,4,1244,2909.915863,52.09961699999985,52.82188542767997,191.0186786977729
"89.142.117.239",58147,"147.32.84.192",31037,3,825,1,145,2,680,2889.510236,0.1948010000000977,5954.794893247048,27925.93467177926
"89.142.125.199",45821,"147.32.84.191",29676,12,3176,4,688,8,2488,2023.370656,1329.1254410000001,4.141068878990782,14.97526071355969
"89.142.199.178",23212,"147.32.84.191",29676,12,2598,4,686,8,1912,1344.553035,1289.2676970000002,4.256679984125903,11.864099314356743
"89.142.222.61",54631,"147.32.84.191",29676,12,2696,4,688,8,2008,1477.969683,1240.458088,4.437070509068259,12.950054625303872
"89.143.109.152",61855,"147.32.84.191",29676,12,3176,4,688,8,2488,2135.228005,1432.777783,3.841488935203569,13.891896033119883
"89.143.144.140",53547,"147.32.84.191",29676,12,2600,4,688,8,1912,1355.606995,1279.017491,4.303303151622028,11.959179688810057
"89.143.181.29",15646,"147.32.84.191",29676,6,1588,2,344,4,1244,3022.793734,38.12536900000032,72.18290792149388,261.03353911144876
"89.143.201.227",51967,"147.32.84.191",29676,12,2664,4,688,8,1976,1401.647137,1315.166377,4.1850218316522545,12.019772004861709
"89.148.220.26",21039,"147.32.84.165",32234,3,825,1,145,2,680,1267.042428,0.0479609999999866,24186.318050089118,113425.49154524552
"89.149.80.162",10715,"147.32.84.191",29676,3,825,1,145,2,680,2795.580743,0.1420309999998608,8167.23109744448,38301.497560429285
"89.153.83.160",17471,"147.32.84.192",31037,4,1007,2,327,2,680,2009.763653,33.35277300000007,78.43425792512048,163.10487886569396
"89.155.160.246",37566,"147.32.84.192",31037,3,825,1,145,2,680,3664.810279,0.17025100000000748,6813.46952440778,31952.822597222694
"89.156.139.152",29312,"147.32.84.192",31037,3,825,1,145,2,680,2935.724222,0.10314400000015667,11246.412782112755,52741.79787473568
"89.164.61.205",37345,"147.32.84.191",29676,3,825,1,145,2,680,2340.366825,0.27999199999976554,4142.975513589572,19429.126546489028
"89.165.141.132",26090,"147.32.84.165",32234,3,825,1,145,2,680,166.461041,0.05060800000001109,22921.27726841104,107492.88650013453
"89.169.82.38",32400,"147.32.84.165",32234,9,2082,3,444,6,1638,417.999159,2804.165164,1.2666871572333676,4.6730485665501265
"89.169.146.232",20275,"147.32.84.165",32234,6,1650,2,290,4,1360,1845.568303,844.0754980000002,2.748569299188447,12.889842230676855
"89.169.153.169",33246,"147.32.84.165",32234,3,825,1,145,2,680,721.934872,0.15681899999992766,7397.062855907353,34689.67408287586
"89.169.166.19",21328,"147.32.84.191",29676,4,1007,2,327,2,680,2147.479397,33.40345799999977,78.31524508630268,162.85739039353462
"89.172.47.115",35519,"147.32.84.165",32234,3,825,1,145,2,680,1006.061366,0.09726799999998548,11925.813217092704,55927.95163877958
"89.176.200.211",39998,"147.32.84.165",32234,9,1469,3,373,6,1096,861.213985,734.6701919999999,4.061686498912699,11.934606978038387
"89.178.76.133",34997,"147.32.84.191",29676,9,1920,3,492,6,1428,2141.544672,1505.204784,2.614926581312274,7.589664955516112
"89.179.93.233",35691,"147.32.84.165",32234,3,825,1,145,2,680,1963.857059,0.06552000000010594,17704.517704489077,83028.08302794879
"89.179.218.218",53603,"147.32.84.165",32234,1,107,1,107,0,0,1830.320893,0,0,0
"89.180.20.192",37643,"147.32.84.191",29676,3,825,1,145,2,680,2475.597965,0.2024970000002213,5728.479928091439,26864.595524842614
"89.181.88.210",58120,"147.32.84.191",29676,3,825,1,145,2,680,1924.902128,0.06450600000016493,17982.823303212634,84333.24031851442
"89.189.191.51",17112,"147.32.84.165",32234,3,825,1,145,2,680,1406.483792,0.21985700000004726,5276.156774629649,24743.355908608006
"89.190.0.85",57512,"147.32.84.192",31037,3,825,1,145,2,680,1741.478182,0.20115499999997155,5766.697322960722,27043.821928367524
"89.190.201.5",45486,"147.32.84.192",31037,3,825,1,145,2,680,1849.449959,0.168529000000035,6883.088370546072,32279.310979112615
"89.191.147.118",15608,"147.32.84.192",31037,6,1650,2,290,4,1360,2007.816283,971.510002,2.3880351156693496,11.199061232104535
"89.191.241.236",9063,"147.32.84.192",31037,1,107,1,107,0,0,2061.215344,0,0,0
"89.200.145.206",58152,"147.32.84.192",31037,9,1534,3,444,6,1090,984.766373,2654.224411,1.3382440404358107,3.2853288380068326
"89.210.119.193",34388,"147.32.84.191",29676,7,1241,1,145,6,1096,1164.409549,2515.622286,0.4611185099033584,3.4854199093384883
"89.210.130.58",52414,"147.32.84.165",32234,3,825,1,145,2,680,3401.34177,0.09724599999981365,11928.511198426906,55940.604240898596
"89.210.147.195",16861,"147.32.84.192",31037,1,107,1,107,0,0,1929.569831,0,0,0
"89.211.189.221",36479,"147.32.84.165",32234,3,825,1,145,2,680,3253.216541,0.19226900000012392,6033.213882629298,28293.692690951186
"89.211.226.56",23628,"147.32.84.192",31037,3,825,1,145,2,680,2281.179055,0.11391099999991638,10183.388785989513,47756.58189291634
"89.212.222.206",5141,"147.32.84.191",29676,12,3122,4,650,8,2472,1893.858858,1718.251292,3.026332658215164,11.509375894012132
"89.214.192.88",57557,"147.32.84.165",32234,3,825,1,145,2,680,2362.186641,0.23749800000041432,4884.251656847537,22905.456045905692
"89.215.40.79",39338,"147.32.84.165",32234,3,825,1,145,2,680,2438.414487,0.13664999999991778,8488.840102456626,39809.73289427935
"89.215.71.20",22866,"147.32.84.165",32234,3,825,1,145,2,680,2684.829451,0.3087869999999384,3756.634832425689,17617.32197275496
"89.215.231.66",8462,"147.32.84.191",29676,3,825,1,145,2,680,3478.262579,0.130333999999948,8900.210229107239,41738.916936502916
"89.223.25.224",45299,"147.32.84.165",32234,3,825,1,145,2,680,1679.303652,0.1810009999999238,6408.804371249265,30055.082568617247
"89.223.25.252",34038,"147.32.84.165",32234,3,825,1,145,2,680,559.992671,0.16685600000005252,6952.102411658166,32602.96303398312
"89.229.200.126",33607,"147.32.84.165",32234,3,825,1,145,2,680,3503.661614,0.13417299999991883,8645.554619787154,40544.66994107079
"89.229.237.159",30607,"147.32.84.192",31037,6,1650,2,290,4,1360,1356.253422,956.8414420000001,2.424644144959599,11.370744955672603
"89.235.205.161",16380,"147.32.84.192",31037,3,828,1,140,2,688,2674.916633,0.1247640000001411,8976.948478717686,44115.2896668412
"89.239.174.187",61300,"147.32.84.165",32234,3,825,1,145,2,680,427.406879,0.17580399999997098,6598.257150009053,30943.550772456245
"89.241.223.110",14629,"147.32.84.165",32234,3,825,1,145,2,680,1663.007751,0.21919499999989966,5292.091516688478,24818.084354125276
"89.242.67.197",14865,"147.32.84.192",31037,3,831,1,143,2,688,2867.270281,0.2456720000000132,4656.615324497454,22403.855547232506
"89.242.85.96",11437,"147.32.84.191",29676,3,825,1,145,2,680,3146.858252,0.20005799999989904,5798.318487641511,27192.114286870536
"89.248.248.105",19995,"147.32.84.192",31037,3,825,1,145,2,680,2452.199749,0.2982340000003205,3889.563228869791,18240.71031469971
"89.251.107.45",29754,"147.32.84.192",31037,9,1712,3,444,6,1268,893.549776,2666.095956,1.3322851310007389,3.8048142930381457
"89.252.234.242",11201,"147.32.84.191",29676,3,828,1,140,2,688,2859.533134,0.18707800000038333,5986.807641720058,29420.88326788143
"89.253.107.75",1048,"147.32.84.165",32234,3,825,1,145,2,680,309.971878,0.09755400000000236,11890.850195788711,55763.98712507809
"89.254.136.158",20024,"147.32.84.165",32234,3,825,1,145,2,680,566.303641,0.1948459999999841,5953.4196237033075,27919.485131849997
"90.11.226.135",38513,"147.32.84.165",32234,3,825,1,145,2,680,3764.158974,0.15055100000017774,7705.030189096256,36133.934679899685
"90.20.184.149",20262,"147.32.84.165",32234,3,825,1,145,2,680,2518.069688,0.04717799999980343,24587.731569901927,115307.98253471249
"90.32.145.113",50211,"147.32.84.192",31037,3,825,1,145,2,680,996.074238,0.10909499999991112,10632.93459829456,49864.79673682966
"90.34.206.218",56320,"147.32.84.165",32234,3,825,1,145,2,680,3562.583312,0.1280069999997977,9062.004421647513,42497.67590841593
"90.37.239.152",63548,"147.32.84.192",31037,3,825,1,145,2,680,2221.064366,0.1669200000001183,6949.436855973987,32590.462496981454
"90.56.2.51",11311,"147.32.84.192",31037,3,825,1,145,2,680,1599.25629,0.21812599999998383,5318.027195291189,24939.713743434542
"90.56.222.133",49296,"147.32.84.165",32234,3,825,1,145,2,680,3191.195905,0.07204000000001543,16102.165463627869,75513.60355356518
"90.58.117.155",37422,"147.32.84.165",32234,3,825,1,145,2,680,1522.966324,0.10530999999991764,11015.098281273453,51657.01262942033
"90.58.156.136",28682,"147.32.84.165",32234,3,825,1,145,2,680,3345.627485,0.1071590000001379,10825.035694608081,50765.684636782724
"90.63.205.130",41436,"147.32.84.165",32234,6,1428,2,468,4,960,1492.159974,2122.225179,1.7641860237301425,3.6188431256002924
"90.142.178.135",22750,"147.32.84.191",29676,3,825,1,145,2,680,2101.187892,0.1682940000000599,6892.6996803188895,32324.38470770238
"90.149.172.168",49780,"147.32.84.192",31037,3,825,1,145,2,680,2971.070734,0.1860700000001998,6234.212930610815,29236.308915967962
"90.151.195.154",58513,"147.32.84.165",32234,22,5366,6,870,16,4496,780.166072,2665.693653,2.610952684741978,13.492923299540152
"90.154.134.98",7600,"147.32.84.191",7600,385,368961,47,4725,338,364236,2197.855105,1.234711999999945,30614.426684118793,2359973.8238553847
"90.157.214.106",54821,"147.32.84.191",29676,6,1588,2,344,4,1244,2105.424361,34.42874699999993,79.93320233234179,289.0607665739337
"90.157.214.106",62813,"147.32.84.191",29676,6,1588,2,344,4,1244,3360.212058,32.55130099999997,84.54347185693139,305.73278776169377
"90.157.245.88",47129,"147.32.84.191",29676,6,1588,2,344,4,1244,3237.80989,35.96999400000004,76.5082140408474,276.67505310120396
"90.157.252.77",64116,"147.32.84.191",29676,12,3176,4,688,8,2488,2373.580036,1263.491629,4.356182402534936,15.753171246376336
"90.177.230.69",18406,"147.32.84.165",32234,3,825,1,145,2,680,2887.378275,0.18168999999988955,6384.501073260527,29941.108481497646
"90.178.216.82",10008,"147.32.84.165",32234,3,825,1,145,2,680,2616.739252,0.059095000000070286,19629.410271573237,92055.16541151586
"90.180.20.40",12343,"147.32.84.191",7600,230,213639,32,3123,198,210516,2214.282564,3.967811999999867,6296.669297839927,424447.529268034
"90.188.60.54",30544,"147.32.84.165",32234,3,825,1,145,2,680,301.575971,0.29039500000004637,3994.5591349706942,18733.104908828085
"90.188.241.96",11337,"147.32.84.165",32234,1,143,1,143,0,0,3647.330003,0,0,0
"90.204.210.74",33543,"147.32.84.191",29676,3,825,1,145,2,680,3405.975663,0.0882619999997587,13142.688812888575,61634.67857078779
"90.209.96.56",24893,"147.32.84.192",31037,3,825,1,145,2,680,1160.741119,0.3501059999998688,3313.2822630872784,15538.151302754133
"90.213.72.143",23058,"147.32.84.191",29676,3,825,1,145,2,680,2401.399492,0.2787239999997837,4161.8231655720365,19517.515535096445
"90.215.176.14",57588,"147.32.84.192",31037,3,825,1,145,2,680,2146.694005,0.1736869999999726,6678.680615130567,31320.7090916468
"90.221.119.50",37774,"147.32.84.191",29676,3,825,1,145,2,680,1955.160929,0.047172000000045955,24590.85898411918,115322.64902897271
"90.221.153.59",54505,"147.32.84.165",32234,3,825,1,145,2,680,3356.117633,0.05322000000023763,21796.317173897416,102217.21157413961
"90.227.128.198",43897,"147.32.84.165",32234,3,458,1,148,2,310,2895.443056,0.3192349999999351,3708.8665089988276,7768.571741821868
"90.229.227.160",51830,"147.32.84.191",29676,3,825,1,145,2,680,2543.820704,0.1687629999996716,6873.5445565808695,32234.553782586147
"90.230.37.32",57084,"147.32.84.191",29676,3,825,1,145,2,680,1456.601535,0.09046699999998964,12822.35511291557,60132.42397781095
"90.230.109.212",64404,"147.32.84.192",31037,3,825,1,145,2,680,3372.924499,0.24493799999982002,4735.892348271204,22209.70204706496
"90.230.255.59",3025,"147.32.84.165",32234,3,825,1,145,2,680,3373.308271,0.19550800000024537,5933.261043018926,27824.948339674964
"90.231.35.111",18872,"147.32.84.165",32234,3,825,1,145,2,680,3321.685152,0.18485000000009677,6275.358398698365,29429.266973206126
"91.5.37.152",30925,"147.32.84.165",32234,3,825,1,145,2,680,957.54231,0.259260999999924,4474.255672856079,20982.716258911267
"91.47.69.188",57429,"147.32.84.165",32234,6,1334,2,296,4,1038,539.737455,1409.1034630000001,1.6805011570679815,5.893108787285692
"91.61.93.173",52108,"147.32.84.165",32234,3,825,1,145,2,680,2450.022025,0.13478899999972782,8606.043519889177,40359.37650706649
"91.76.31.2",48407,"147.32.84.192",31037,3,825,1,145,2,680,1329.278095,0.05805800000007366,19980.01997999463,93699.40404411274
"91.76.125.56",1031,"147.32.84.165",32234,3,825,1,145,2,680,559.594644,0.16367999999999938,7086.99902248292,33235.581622678525
"91.76.125.56",1032,"147.32.84.165",32234,3,825,1,145,2,680,3323.283795,0.22855800000024828,5075.298173762196,23801.39833212616
"91.79.190.85",31227,"147.32.84.165",32234,1,143,1,143,0,0,3350.920395,0,0,0
"91.82.165.159",62622,"147.32.84.165",32234,3,825,1,145,2,680,2424.290611,0.2835640000002968,4090.7872649517776,19184.38165632558
"91.82.182.225",30214,"147.32.84.165",32234,3,828,1,148,2,680,1731.955582,0.08954700000003868,13222.106826576977,60750.220554542866
"91.83.89.68",1305,"147.32.84.192",31037,3,825,1,145,2,680,873.383047,0.26027299999998377,4456.858759840907,20901.130735805633
"91.83.170.89",27298,"147.32.84.191",29676,3,825,1,145,2,680,3622.060685,0.12269000000014785,9454.723286320012,44339.39196343178
"91.88.118.71",44044,"147.32.84.165",32234,3,825,1,145,2,680,2043.47668,0.19960199999991346,5811.565014381134,27254.23592951152
"91.90.34.0",1848,"147.32.84.192",31037,3,825,1,145,2,680,1356.609983,0.132616999999982,8746.99322108144,41020.38200231297
"91.90.242.156",17214,"147.32.84.165",32234,9,2475,3,435,6,2040,1704.646892,1912.2213020000002,1.8198730431254235,8.534577029829572
"91.103.207.131",10928,"147.32.84.191",29676,3,825,1,145,2,680,2493.555002,0.13395700000000943,8659.495211149237,40610.04650745849
"91.103.207.136",35201,"147.32.84.192",31037,3,825,1,145,2,680,3515.586355,0.1414310000000114,8201.879361666864,38463.98597195496
"91.113.56.75",40150,"147.32.84.192",31037,1,145,1,145,0,0,3785.280177,0,0,0
"91.120.95.80",6115,"147.32.84.165",32234,3,825,1,145,2,680,1926.160783,0.10912299999995412,10630.206280990147,49852.00186947103
"91.122.75.150",14178,"147.32.84.191",29676,3,825,1,145,2,680,3305.615289,0.14421900000024834,8043.323001809765,37720.411318832004
"91.122.125.212",26607,"147.32.84.191",29676,3,825,1,145,2,680,3625.370616,0.22941399999990608,5056.360989305251,23712.589467086695
"91.122.186.195",29378,"147.32.84.191",29676,3,825,1,145,2,680,2986.134802,0.07098499999983687,16341.480594529348,76635.90899503419
"91.122.194.218",55390,"147.32.84.165",32234,3,825,1,145,2,680,3430.482404,0.1268079999999827,9147.68784303954,42899.50160873716
"91.124.127.251",18182,"147.32.84.165",32234,1,107,1,107,0,0,3530.664725,0,0,0
"91.124.135.41",35691,"147.32.84.191",29676,3,825,1,145,2,680,2396.549178,0.2897939999998016,4002.843399106932,18771.955250984232
"91.124.164.67",65535,"147.32.84.191",29676,9,1776,3,492,6,1284,1796.366947,1368.021287,2.877148212095036,7.508655090101679
"91.135.102.192",26696,"147.32.84.191",29676,3,825,1,145,2,680,2638.31088,0.14128799999980401,8210.180623985116,38502.9160297233
"91.139.210.248",11806,"147.32.84.192",31037,3,825,1,145,2,680,2611.304082,0.28595099999984086,4056.6390745290123,19024.238418480883
"91.140.110.252",40402,"147.32.84.165",32234,3,825,1,145,2,680,2062.761821,0.22365399999989677,5186.582846720986,24323.285074277726
"91.142.156.52",38466,"147.32.84.165",32234,3,825,1,145,2,680,1995.244436,0.07205300000009629,16099.260266726573,75499.97918189014
"91.147.251.248",55095,"147.32.84.192",31037,6,1650,2,290,4,1360,760.885801,1822.064617,1.2732808586228093,5.9712481645759325
"91.149.118.175",27973,"147.32.84.165",32234,3,825,1,145,2,680,2103.492093,0.1716350000001512,6758.528272199599,31695.167069625706
"91.154.9.110",30525,"147.32.84.191",29676,15,3243,3,435,12,2808,1183.102998,1824.4464930000001,1.9074278217267508,12.312775456111991
"91.177.219.100",10002,"147.32.84.165",32234,3,828,1,140,2,688,3520.568998,0.1513929999996435,7397.964238786716,36355.709973466146
"91.185.113.213",35848,"147.32.84.191",29676,3,825,1,145,2,680,3142.4676,0.15786000000025524,7348.283288978363,34460.91473451922
"91.187.103.3",53218,"147.32.84.191",29676,12,2168,4,688,8,1480,2029.817713,1370.2097130000002,4.016903359960344,8.64101304177516
"91.188.37.153",1363,"147.32.84.165",32234,3,825,1,145,2,680,479.965356,0.06418400000001157,18073.040009968077,84756.32556398821
"91.188.37.153",37649,"147.32.84.165",32234,6,1650,2,290,4,1360,1386.932116,3.076424999999972,754.1220735106564,3536.5724826706646
"91.188.37.153",1366,"147.32.84.165",32234,6,1650,2,290,4,1360,2315.922977,6.058916999999838,382.90671418672054,1795.700452737724
"91.188.37.153",1370,"147.32.84.165",32234,6,1650,2,290,4,1360,3160.02437,0.33219599999983984,6983.8288239506755,32751.748967492822
"91.200.45.17",58030,"147.32.84.165",32234,1,107,1,107,0,0,1768.462661,0,0,0
"91.200.212.66",28845,"147.32.84.165",32234,3,825,1,145,2,680,3649.219654,0.1550240000001395,7482.712354209389,35091.340695602645
"91.201.144.34",35020,"147.32.84.192",31037,3,825,1,145,2,680,1071.275996,0.12245899999993526,9472.558162328725,44423.0313819554
"91.201.177.6",22074,"147.32.84.165",32234,1,107,1,107,0,0,3423.073946,0,0,0
"91.202.242.190",44945,"147.32.84.192",31037,4,1007,2,327,2,680,3705.206287,38.13332300000002,68.60141719094344,142.6573813145001
"91.203.63.9",53160,"147.32.84.165",32234,1,107,1,107,0,0,3693.839881,0,0,0
"91.203.140.36",59747,"147.32.84.192",31037,6,1650,2,290,4,1360,2269.217174,846.0302620000002,2.742218693827289,12.860060081396943
"91.203.170.211",22651,"147.32.84.192",31037,12,2010,4,688,8,1322,1966.277922,1256.1872649999998,4.381512337652938,8.419126904618
"91.204.212.254",64202,"147.32.84.192",31037,3,825,1,145,2,680,2524.325763,0.24876800000038202,4662.97916129976,21867.76434264715
"91.207.210.62",51825,"147.32.84.191",29676,3,825,1,145,2,680,1921.912318,0.23426800000015646,4951.593900998964,23221.26794951238
"91.207.211.134",50792,"147.32.84.191",29676,3,825,1,145,2,680,1338.105924,0.11728199999993194,9890.690813600324,46383.929332746346
"91.209.51.123",3749,"147.32.84.165",32234,3,825,1,145,2,680,2654.647487,0.18040499999960957,6429.976996216903,30154.374878810304
"91.210.120.104",62070,"147.32.84.192",31037,3,825,1,145,2,680,1341.871113,0.22982999999999265,5047.20880650932,23669.66888569888
"91.211.60.221",55752,"147.32.84.191",29676,3,825,1,145,2,680,3364.316205,0.25201800000013463,4602.84582847011,21585.759747308104
"91.213.119.4",20665,"147.32.84.191",29676,3,825,1,145,2,680,2020.059341,0.16850600000020677,6884.027868435406,32283.716900248804
"91.214.128.99",55131,"147.32.84.191",29676,3,825,1,145,2,680,2377.121141,0.15620799999987867,7425.996107759533,34825.361057079186
"91.214.128.109",57332,"147.32.84.165",32234,3,825,1,145,2,680,666.537574,0.27565500000002885,4208.158749160649,19734.813444339594
"91.214.128.117",58350,"147.32.84.165",32234,3,828,1,148,2,680,2028.279054,0.13365399999997862,8858.694838913832,40702.11142203653
"91.214.128.117",53720,"147.32.84.165",32234,1,179,1,179,0,0,2062.926411,0,0,0
"91.215.8.75",15207,"147.32.84.191",29676,3,825,1,145,2,680,3103.777237,0.19825200000013865,5851.138954457906,27439.824062285352
"91.215.122.95",26868,"147.32.84.165",32234,3,825,1,145,2,680,1155.724795,0.2813469999998688,4123.02245981134,19335.55360463249
"91.215.233.234",39826,"147.32.84.165",32234,3,825,1,145,2,680,974.391507,0.2129659999999376,5446.878844511987,25543.983546676907
"91.216.240.2",58023,"147.32.84.165",32234,3,825,1,145,2,680,3601.292834,0.17645700000002762,6573.8395189752655,30829.040502780557
"91.217.0.144",1026,"147.32.84.192",31037,6,836,2,344,4,492,2619.297705,31.180253999999877,88.2609872260826,126.23373754428093
"91.217.67.36",35691,"147.32.84.165",32234,3,825,1,145,2,680,2483.907184,0.05848599999990256,19833.806381047303,93013.71268353218
"91.219.132.107",52008,"147.32.84.192",31037,3,825,1,145,2,680,1978.410592,0.22851300000002084,5076.297628580844,23806.085430586023
"91.222.80.20",56508,"147.32.84.165",32234,2,286,2,286,0,0,2284.45665,910.637581,2.512525342395242,0
"92.5.107.181",28981,"147.32.84.191",29676,3,825,1,145,2,680,2662.414093,0.19462800000019342,5960.087962671595,27950.75734218403
"92.18.145.107",54666,"147.32.84.191",29676,9,2042,3,476,6,1566,2295.20061,79.65919900000017,47.803644121503055,157.26997204679367
"92.18.145.107",56814,"147.32.84.191",29676,3,429,1,143,2,286,2489.785665,0.0879480000003241,13007.686360073954,26015.37272014791
"92.24.40.49",47419,"147.32.84.165",32234,3,825,1,145,2,680,1059.973788,0.10233900000002905,11334.87722177929,53156.66559179253
"92.35.28.15",58144,"147.32.84.192",31037,3,825,1,145,2,680,1992.470244,0.07367899999985639,15743.970466513674,73833.79253261586
"92.35.196.184",7600,"147.32.84.165",7600,1,89,1,89,0,0,72.669481,0,0,0
"92.36.6.202",35691,"147.32.84.165",32234,6,1650,2,290,4,1360,1427.572894,1856.3020890000003,1.2497965787722602,5.861114990104393
"92.36.150.63",46734,"147.32.84.191",29676,12,2896,4,790,8,2106,1171.850261,1425.3134719999998,4.434112301718286,11.82055760432748
"92.37.26.41",61060,"147.32.84.191",29676,6,1623,2,395,4,1228,1895.777695,32.60598099999993,96.9147347537253,301.2944158925941
"92.37.26.41",55996,"147.32.84.191",29676,6,1639,2,395,4,1244,3227.343499,36.15555399999994,87.40012668593062,275.25508252480427
"92.37.29.224",21332,"147.32.84.191",29676,6,1476,2,344,4,1132,1708.743649,34.09827999999993,80.70788321287776,265.58524359586517
"92.37.29.224",51282,"147.32.84.191",29676,6,1588,2,344,4,1244,2966.738842,34.169614999999794,80.539391503241,291.2529157849762
"92.37.54.224",51413,"147.32.84.191",29676,6,1570,2,326,4,1244,2438.65033,41.97715999999991,62.12902445043937,237.081308025603
"92.37.210.198",51323,"147.32.84.191",29676,3,825,1,145,2,680,2310.771285,0.28897100000040155,4014.243643820273,18825.418467570937
"92.42.2.1",62907,"147.32.84.165",32234,4,1007,2,327,2,680,214.008344,38.106746000000015,68.64926225923355,142.75687564611258
"92.44.32.190",7600,"147.32.84.191",7600,436,419899,52,5155,384,414744,1954.096044,0.8015510000000177,51450.25082620955,4139414.709731417
"92.44.100.159",26077,"147.32.84.192",31037,3,825,1,145,2,680,2477.505269,0.18647599999985687,6220.639653364993,29172.654926125484
"92.45.182.14",46094,"147.32.84.165",32234,12,2294,4,518,8,1776,1604.057637,1473.8820949999997,2.811622458850754,9.639848430345443
"92.46.0.166",30030,"147.32.84.165",32234,3,825,1,145,2,680,3133.228216,0.13300200000003315,8721.67335829319,40901.640576823236
"92.46.130.135",10544,"147.32.84.192",31037,3,825,1,145,2,680,962.759221,0.1861030000000028,6233.107472743494,29231.124699762597
"92.46.224.58",47400,"147.32.84.165",32234,3,825,1,145,2,680,721.71018,0.18131899999991674,6397.564513374399,30002.37151099718
"92.47.49.245",55075,"147.32.84.192",31037,3,825,1,145,2,680,2643.389699,0.22862400000030902,5073.833018398908,23794.52725869833
"92.47.66.175",11792,"147.32.84.165",32234,1,143,1,143,0,0,2049.412745,0,0,0
"92.47.99.242",26961,"147.32.84.192",31037,3,825,1,145,2,680,3284.022154,0.2976800000001276,3896.801934962049,18274.65735016685
"92.47.234.180",31112,"147.32.84.192",31037,1,143,1,143,0,0,1366.7534,0,0,0
"92.53.154.10",63535,"147.32.84.191",29676,6,1639,2,395,4,1244,2351.489694,35.095682000000124,90.03956669085356,283.56764800866284
"92.55.49.241",24965,"147.32.84.192",31037,3,825,1,145,2,680,2092.746991,0.1322450000002391,8771.598170047282,41135.7707284976
"92.60.25.179",12033,"147.32.84.192",31037,3,825,1,145,2,680,1297.399054,0.17464300000006006,6642.121356135666,31149.258773601745
"92.61.35.98",24955,"147.32.84.191",29676,7,1241,1,145,6,1096,1170.190495,699.97487,1.6572023507072475,12.526163975000989
"92.63.21.163",58133,"147.32.84.191",29676,12,2600,4,688,8,1912,1366.32184,1309.1797900000001,4.204159002485059,11.683651181324757
"92.76.93.150",9593,"147.32.84.191",29676,3,828,1,140,2,688,2377.890322,0.1907109999997374,5872.760354680864,28860.422314431675
"92.76.248.238",6888,"147.32.84.165",32234,12,2137,4,639,8,1498,568.295644,2851.727908,1.7925973882919268,4.202364456433969
"92.80.107.167",10931,"147.32.84.165",32234,3,825,1,145,2,680,590.302923,0.17954500000007556,6460.775850062724,30298.810883052774
"92.80.181.235",13199,"147.32.84.165",32234,3,825,1,145,2,680,2039.598229,0.1936439999999493,5990.374088535166,28092.788828992503
"92.81.62.13",3046,"147.32.84.191",29676,3,825,1,145,2,680,3755.831135,0.12246200000026874,9472.326109302921,44421.943133282664
"92.82.226.87",11525,"147.32.84.165",32234,3,825,1,145,2,680,2042.768434,0.08680200000003424,13363.747379087376,62671.367019168385
"92.85.188.104",62503,"147.32.84.165",32234,10,1563,2,259,8,1304,1614.910538,1431.5802709999998,1.447351602961564,7.287052085953203
"92.86.30.226",4495,"147.32.84.165",32234,3,825,1,145,2,680,3423.986658,0.26229600000033315,4422.484521298558,20739.927410227723
"92.86.31.182",27009,"147.32.84.191",29676,3,825,1,145,2,680,3311.043359,0.16557000000011612,7006.100138909141,32856.19375488425
"92.96.33.211",27566,"147.32.84.165",32234,3,825,1,145,2,680,3483.368669,0.16511399999990317,7025.449083667529,32946.93363375117
"92.96.89.255",45619,"147.32.84.165",32234,16,2928,4,692,12,2236,1048.651263,2540.391316,2.1791918296732202,7.041434871603064
"92.96.92.224",27455,"147.32.84.165",32234,3,825,1,145,2,680,983.462807,0.22327199999995173,5195.456662726409,24364.900211406606
"92.97.7.232",42350,"147.32.84.165",32234,3,825,1,145,2,680,396.848657,0.16057599999999184,7223.993622957721,33878.039059387935
"92.97.145.64",34933,"147.32.84.165",32234,3,825,1,145,2,680,1801.794471,0.17488300000013624,6633.00606690814,31106.511210327833
"92.97.149.137",23295,"147.32.84.165",32234,3,825,1,145,2,680,1067.607661,0.06590899999991962,17600.024275917018,82538.04488016258
"92.98.124.159",443,"147.32.84.165",32234,3,825,1,145,2,680,893.038825,0.20476000000007843,5665.168978313907,26567.68900174798
"92.99.85.220",54250,"147.32.84.191",29676,3,825,1,145,2,680,2788.597883,0.06794900000022608,17071.627249792353,80060.04503350896
"92.99.244.55",12527,"147.32.84.191",29676,3,825,1,145,2,680,3085.668792,0.22087800000008428,5251.767944293037,24628.980704270794
"92.100.167.70",61731,"147.32.84.192",31037,3,825,1,145,2,680,3708.04112,0.3079130000000987,3767.2979055760175,17667.32810890822
"92.100.212.46",6881,"147.32.84.192",31037,1,143,1,143,0,0,956.460858,0,0,0
"92.101.41.245",60966,"147.32.84.165",32234,3,825,1,145,2,680,3228.420343,0.22466700000040873,5163.197087235284,24213.61392634478
"92.112.60.167",1440,"147.32.84.165",32234,9,1593,1,145,8,1448,266.018048,689.128323,1.6832859153867632,16.809641417103677
"92.112.102.5",10385,"147.32.84.165",32234,3,825,1,145,2,680,1678.211614,0.057020999999849664,20343.382262728792,95403.44785279708
"92.112.111.70",50288,"147.32.84.165",32234,1,143,1,143,0,0,641.029611,0,0,0
"92.112.131.164",26921,"147.32.84.192",31037,1,143,1,143,0,0,2406.939004,0,0,0
"92.112.134.37",38141,"147.32.84.192",31037,3,825,1,145,2,680,2711.114553,0.18067300000029718,6420.43913588689,30109.645602779896
"92.113.38.40",48297,"147.32.84.191",29676,8,2014,4,654,4,1360,2082.594103,1320.574698,3.9619114374399445,8.238837239936275
"92.113.95.92",27408,"147.32.84.191",29676,3,825,1,145,2,680,1930.618253,0.17412799999988238,6661.766057157858,31241.385647360992
"92.113.203.254",27097,"147.32.84.191",29676,3,825,1,145,2,680,2587.775765,0.1176740000000791,9857.742576943252,46229.41346428559
"92.113.204.223",6881,"147.32.84.192",31037,1,143,1,143,0,0,1939.298981,0,0,0
"92.114.208.10",11581,"147.32.84.165",32234,3,825,1,145,2,680,3309.904217,0.18851900000026944,6153.22593477762,28856.50783206056
"92.114.241.245",42491,"147.32.84.191",29676,6,1028,2,344,4,684,2170.89323,37.27188299999989,73.83581881280342,146.81308159289983
"92.115.69.99",11946,"147.32.84.191",29676,3,490,1,148,2,342,1518.886001,0.020569000000023152,57562.35111083025,133015.7032425942
"92.115.69.99",13965,"147.32.84.191",29676,3,374,1,196,2,178,1551.878344,0.061705999999958294,25410.819045166754,23077.172398161645
"92.115.170.197",30131,"147.32.84.165",32234,3,825,1,145,2,680,1577.836003,0.16624500000011722,6977.653463257133,32722.78865527483
"92.115.197.12",49566,"147.32.84.165",32234,3,825,1,145,2,680,1416.757005,0.04196400000000722,27642.741397383485,129634.92517393634
"92.115.232.154",16052,"147.32.84.165",32234,3,828,1,140,2,688,1768.37584,0.16194700000005469,6915.842837469183,33986.42765841998
"92.119.171.177",51357,"147.32.84.192",31037,3,825,1,145,2,680,898.264877,0.15743600000007518,7368.073375844445,34553.72341775326
"92.124.19.173",56295,"147.32.84.165",32234,4,1007,2,327,2,680,3017.069756,34.771106000000145,75.23488036302294,156.4517389812098
"92.124.68.34",42758,"147.32.84.165",32234,3,825,1,145,2,680,829.954078,0.09728100000006634,11924.219528985197,55920.47779110299
"92.125.207.16",17992,"147.32.84.165",32234,1,143,1,143,0,0,3330.772012,0,0,0
"92.126.73.74",1025,"147.32.84.165",32234,3,825,1,145,2,680,415.284786,0.2474730000000136,4687.3800374179655,21982.196037546324
"92.127.39.91",21507,"147.32.84.191",29676,3,825,1,145,2,680,3511.810597,0.2185380000000805,5308.001354453563,24892.69600709257
"92.127.108.176",31962,"147.32.84.191",29676,4,970,2,290,2,680,2884.690633,929.9497329999999,2.494758498952115,5.849778549267028
"92.147.47.89",14610,"147.32.84.192",31037,3,825,1,145,2,680,1966.751435,0.21045900000012807,5511.762386019576,25848.2649827125
"92.153.38.222",62927,"147.32.84.191",29676,3,825,1,145,2,680,1303.260841,0.2082789999999477,5569.452513216846,26118.811786120375
"92.157.110.27",25966,"147.32.84.165",32234,3,825,1,145,2,680,3487.223738,0.2075219999996989,5589.768795605686,26214.088144909423
"92.160.82.237",24189,"147.32.84.192",31037,3,825,1,145,2,680,3346.107641,0.059244999999918946,19579.711368074724,91822.09469166078
"92.226.66.217",14248,"147.32.84.165",32234,3,825,1,145,2,680,467.697207,0.1265690000000177,9164.961404450045,42980.508655351936
"92.235.192.191",27453,"147.32.84.165",32234,3,825,1,145,2,680,2999.21548,0.17311599999993632,6700.709350957894,31424.016266561157
"92.237.59.188",30303,"147.32.84.165",32234,3,506,1,148,2,358,1247.044737,0.03643699999997807,32494.442462351803,78601.42163190503
"92.240.175.155",22491,"147.32.84.192",31037,4,1007,2,327,2,680,1796.829848,30.51080899999988,85.74010607191734,178.29746828410944
"92.240.208.35",15070,"147.32.84.191",29676,3,825,1,145,2,680,3077.535871,0.09944399999994857,11664.856602717105,54704.15510239746
"92.242.97.98",55771,"147.32.84.165",32234,3,825,1,145,2,680,560.646469,0.1337790000000041,8671.017125258557,40664.08031155737
"92.243.105.248",47087,"147.32.84.165",32234,3,825,1,145,2,680,2619.299784,0.13404200000013589,8654.003968896495,40584.29447482494
"92.243.167.146",37073,"147.32.84.191",29676,6,1206,2,344,4,862,2135.571387,30.854565999999977,89.19263359594824,223.50014581310285
"92.243.167.146",32169,"147.32.84.191",29676,3,426,1,148,2,278,3479.282787,0.11457900000004884,10333.481702576348,19410.188603488004
"92.243.167.146",40090,"147.32.84.191",29676,3,374,1,196,2,178,3511.258793,0.16730999999981577,9371.82475645046,8511.146972694805
"92.243.167.156",49403,"147.32.84.192",31037,9,2475,3,435,6,2040,1728.231622,7.779260000000022,447.3433205729067,2097.8859171694935
"92.243.167.231",39849,"147.32.84.191",29676,3,825,1,145,2,680,2631.254598,0.15328200000021752,7567.750942696167,35490.14235195444
"92.243.181.154",45788,"147.32.84.192",31037,3,825,1,145,2,680,3330.180735,0.0675890000002255,17162.556037167735,80486.46969154524
"92.246.219.8",51875,"147.32.84.191",29676,3,825,1,145,2,680,2418.915983,0.08550600000035047,13566.299440919298,63621.26634362153
"92.247.230.241",45503,"147.32.84.192",31037,3,825,1,145,2,680,3533.200531,0.23837000000003172,4866.384192641044,22821.663799971793
"92.249.209.157",42803,"147.32.84.192",31037,3,825,1,145,2,680,2091.23182,0.22911800000019866,5062.893356257449,23743.224015552176
"92.249.212.37",26121,"147.32.84.165",32234,3,825,1,145,2,680,3270.147678,0.10602800000015122,10940.506281344036,51307.20187113066
"92.249.212.103",15217,"147.32.84.191",29676,3,825,1,145,2,680,2868.839771,0.13413100000025224,8648.261773921156,40557.36556045783
"92.251.98.167",50248,"147.32.84.191",29676,1,145,1,145,0,0,3789.041636,0,0,0
"92.252.129.59",28738,"147.32.84.165",32234,7,1241,1,145,6,1096,249.968707,695.353686,1.6682157919847425,12.609410400105364
"92.252.132.21",61433,"147.32.84.165",32234,3,825,1,145,2,680,2872.192194,0.16632899999967776,6974.129586555846,32706.262888675694
"92.252.139.48",10000,"147.32.84.192",31037,3,825,1,145,2,680,2620.895856,0.161391999999978,7187.469019531068,33706.75126400777
"93.2.53.124",46674,"147.32.84.165",32234,3,825,1,145,2,680,450.426919,0.3044140000000084,3810.6000381058952,17870.40017870351
"93.12.216.65",59703,"147.32.84.192",31037,3,825,1,145,2,680,2857.347163,0.1027910000002521,11285.034681997015,52922.92126729634
"93.15.89.184",22154,"147.32.84.165",32234,3,825,1,145,2,680,1046.262893,0.18564900000001217,6248.35038163375,29302.608686282412
"93.33.246.136",31409,"147.32.84.192",31037,9,1593,1,145,8,1448,1436.649033,662.4670600000002,1.7510304587823577,17.48615244356451
"93.34.177.26",57806,"147.32.84.165",32234,3,825,1,145,2,680,788.191313,0.14108899999996538,8221.76073258925,38557.22274593579
"93.34.208.118",28331,"147.32.84.191",29676,6,1656,2,296,4,1360,1357.041682,1500.6719319999997,1.5779598122049772,7.25008562364449
"93.36.141.155",53513,"147.32.84.192",31037,3,825,1,145,2,680,2725.995779,0.19047300000011091,6090.102009205108,28560.47838799637
"93.37.208.93",29305,"147.32.84.191",29676,3,825,1,145,2,680,3218.243585,0.1228240000000369,9444.40825896935,44291.01804206316
"93.38.160.200",18625,"147.32.84.165",32234,15,2451,5,811,10,1640,1226.843952,2376.4657640000005,2.73010455201323,5.520803286438591
"93.47.40.94",29232,"147.32.84.191",29676,12,1976,4,688,8,1288,1427.715765,1376.6583410000003,3.998087133225744,7.484791028480753
"93.47.117.152",29142,"147.32.84.192",31037,3,825,1,145,2,680,2149.019113,0.2761110000001281,4201.208934086153,19702.221208128165
"93.65.106.25",52112,"147.32.84.165",32234,3,825,1,145,2,680,514.299304,0.27168700000004264,4269.619083724352,20023.041220224546
"93.71.81.243",11486,"147.32.84.192",31037,6,1662,2,286,4,1376,2946.992174,37.17035600000008,61.55442794252481,296.1499749962033
"93.71.251.119",1077,"147.32.84.191",29676,6,1028,2,344,4,684,2200.803586,38.21069699999998,72.02171685065052,143.20597187745628
"93.71.251.119",1078,"147.32.84.191",29676,6,1172,2,344,4,828,3592.794595,32.20359099999996,85.45630827319859,205.69134665758264
"93.72.55.159",41748,"147.32.84.165",32234,9,1776,3,444,6,1332,617.013426,2816.243767,1.261254455889578,3.7837633676687337
"93.75.111.225",40670,"147.32.84.192",31037,3,825,1,145,2,680,2197.169715,0.07051700000010896,16449.93405842857,77144.51834297537
"93.78.71.168",52020,"147.32.84.192",31037,3,825,1,145,2,680,1019.436824,0.2435169999999971,4763.527802987117,22339.302800215446
"93.78.213.75",32036,"147.32.84.165",32234,3,825,1,145,2,680,1021.427046,0.05380600000000868,21558.933947883375,101103.96610041859
"93.80.251.11",34089,"147.32.84.192",31037,6,1650,2,290,4,1360,949.282012,2.143646999999987,1082.2677427766857,5075.462517849284
"93.81.157.69",35691,"147.32.84.191",29676,3,825,1,145,2,680,3255.996832,0.21823100000028717,5315.468471475059,24927.71421105545
"93.81.215.179",50527,"147.32.84.165",32234,1,143,1,143,0,0,3800.279487,0,0,0
"93.86.23.229",16607,"147.32.84.191",29676,3,825,1,145,2,680,3322.729387,0.15772300000026007,7354.666091807075,34490.84787881938
"93.86.44.90",13126,"147.32.84.165",32234,9,2475,3,435,6,2040,1505.017591,1717.146978,2.0266174326284143,9.504136925429805
"93.86.102.128",23764,"147.32.84.192",31037,3,825,1,145,2,680,687.13913,0.03191300000003139,36348.82336348382,170463.44749771722
"93.86.192.125",25105,"147.32.84.191",29676,3,825,1,145,2,680,2846.835399,0.20347300000003088,5701.002098557666,26735.733979442848
"93.86.204.44",36010,"147.32.84.165",32234,1,143,1,143,0,0,3343.080641,0,0,0
"93.87.25.212",56095,"147.32.84.165",32234,3,825,1,145,2,680,497.529229,0.23554200000000947,4924.811710862408,23095.668713009916
"93.88.62.12",26497,"147.32.84.165",32234,1,107,1,107,0,0,1777.342974,0,0,0
"93.91.146.138",18054,"147.32.84.192",31037,1,143,1,143,0,0,1245.543071,0,0,0
"93.91.207.87",48652,"147.32.84.191",29676,3,825,1,145,2,680,1690.250138,0.19753499999978885,5872.377047111853,27539.42339335214
"93.95.39.57",28293,"147.32.84.165",32234,3,825,1,145,2,680,2905.76995,0.17772000000013577,6527.121314422203,30609.948233152398
"93.95.160.239",61593,"147.32.84.191",29676,3,825,1,145,2,680,2427.092375,0.15123999999968873,7669.928590335807,35969.32028571275
"93.99.63.250",16523,"147.32.84.165",32234,3,825,1,145,2,680,1666.358622,0.125782000000072,9222.305258298771,43249.431556159754
"93.99.63.255",49629,"147.32.84.191",29676,3,825,1,145,2,680,3765.126096,0.0905390000002626,12812.158296387584,60084.60442443832
"93.100.25.183",6881,"147.32.84.165",32234,1,143,1,143,0,0,2666.930243,0,0,0
"93.100.187.111",35691,"147.32.84.191",29676,3,825,1,145,2,680,3643.531168,0.19785400000000664,5862.909013716989,27495.021581569326
"93.102.138.135",10010,"147.32.84.191",29676,1,107,1,107,0,0,2512.929275,0,0,0
"93.103.9.167",13253,"147.32.84.191",29676,6,1639,2,395,4,1244,2544.078886,32.11907800000017,98.38389507942858,309.8470012121751
"93.103.59.149",48016,"147.32.84.191",29676,12,3176,4,688,8,2488,2456.299707,1252.3291359999998,4.395010737816134,15.893585342567645
"93.103.71.195",11830,"147.32.84.191",29676,12,3176,4,688,8,2488,2043.161898,1514.549385,3.634084206504762,13.141862653755592
"93.103.73.191",51348,"147.32.84.191",29676,12,2872,4,688,8,2184,1608.835814,1339.0933890000001,4.1102435761483695,13.047633677773312
"93.103.88.67",33893,"147.32.84.191",29676,7,1736,3,492,4,1244,2365.993942,1432.8526809999998,2.746967676574421,6.945584938330447
"93.103.102.159",41211,"147.32.84.191",29676,12,3176,4,688,8,2488,2089.358438,1280.4637869999997,4.298442529870625,15.544367753369354
"93.103.111.255",58393,"147.32.84.191",29676,12,2904,4,688,8,2216,1627.144201,1480.457551,3.7177695478551414,11.97467633437063
"93.103.157.128",60249,"147.32.84.191",29676,12,3176,4,688,8,2488,2305.40565,1357.0535289999998,4.055845906134482,14.66707066055609
"93.103.159.190",53025,"147.32.84.191",29676,12,2872,4,688,8,2184,1608.458493,1309.0920729999998,4.204440706287892,13.34665480019296
"93.103.192.184",20940,"147.32.84.191",29676,12,2696,4,688,8,2008,1481.930848,1330.892022,4.135572164396068,12.070100154225734
"93.103.227.70",46247,"147.32.84.165",32234,6,1656,2,296,4,1360,2283.302158,1311.6874400000002,1.8053081304186307,8.294658977599113
"93.103.245.143",30086,"147.32.84.191",29676,12,3160,4,688,8,2472,1887.561281,1363.2181819999998,4.037504834277511,14.506848765020361
"93.103.245.233",37806,"147.32.84.191",29676,12,2558,4,790,8,1768,1261.228905,1488.1745340000002,4.2468137006838464,9.504261547859546
"93.103.249.102",59150,"147.32.84.191",29676,6,868,2,344,4,524,1270.341184,33.12805399999979,83.07158639623134,126.53927695239891
"93.103.252.94",57792,"147.32.84.165",32234,3,828,1,148,2,680,2533.670445,0.13986099999965518,8465.547936901059,38895.76079116703
"93.103.252.137",1024,"147.32.84.191",29676,12,2712,4,688,8,2024,1492.728125,1465.0657959999999,3.7568278605829937,11.05206335729648
"93.103.254.175",37498,"147.32.84.191",29676,3,858,1,148,2,710,1573.062088,0.19772499999999127,5988.114805917574,28726.766974334307
"93.103.254.175",37246,"147.32.84.191",29676,3,425,1,247,2,178,1602.993633,0.292109999999866,6764.574988877158,4874.875902915523
"93.103.254.175",37294,"147.32.84.191",29676,3,1210,1,148,2,1062,2914.418003,0.09920899999997346,11934.401112805459,85637.39176891485
"93.103.254.175",37328,"147.32.84.191",29676,3,425,1,247,2,178,2948.95832,0.17419099999960963,11343.869660340823,8174.934411095815
"93.107.4.45",25159,"147.32.84.165",32234,3,825,1,145,2,680,3420.325123,0.12857899999971778,9021.690944886383,42308.619603605104
"93.113.160.94",35284,"147.32.84.191",29676,3,825,1,145,2,680,3360.957949,0.1878790000000663,6174.186577529104,28954.80601875718
"93.116.10.237",44526,"147.32.84.192",31037,6,1438,2,478,4,960,745.533501,1874.374714,2.0401470268660487,4.097366413789554
"93.116.23.239",19672,"147.32.84.191",29676,12,2008,4,688,8,1320,1469.222062,1310.179825,4.200950048975147,8.059962303266271
"93.116.41.196",54448,"147.32.84.192",31037,3,825,1,145,2,680,2348.643745,0.10936800000035873,10606.393094837567,49740.32623785894
"93.116.98.83",15066,"147.32.84.191",29676,6,868,2,392,4,476,2522.15278,46.20927500000016,67.86516343309842,82.40769845447666
"93.116.145.50",57933,"147.32.84.191",29676,12,2136,4,688,8,1448,1856.264289,1321.226684,4.165825642679799,8.767609782849345
"93.116.207.200",45489,"147.32.84.165",32234,3,825,1,145,2,680,1725.726726,0.245082999999795,4733.090422432279,22196.561981061725
"93.123.44.167",11670,"147.32.84.165",32234,3,831,1,143,2,688,2925.365521,0.13352899999972578,8567.427300454203,41219.51036861882
"93.124.109.65",30705,"147.32.84.191",29676,3,825,1,145,2,680,3766.881356,0.14576900000020032,7957.796239244324,37319.32029438717
"93.136.90.92",62598,"147.32.84.191",29676,7,1736,3,492,4,1244,2337.416271,1480.9657459999999,2.657725211154209,6.719939355032187
"93.137.192.125",19160,"147.32.84.192",31037,12,2042,4,688,8,1354,1265.672066,1319.086171,4.172585628600302,8.211745553960478
"93.137.220.34",56807,"147.32.84.192",31037,3,825,1,145,2,680,3249.68879,0.16280699999970238,7125.00076779328,33413.796704134
"93.138.40.191",46817,"147.32.84.191",29676,3,825,1,145,2,680,3537.438303,0.14542100000016944,7976.839658636981,37408.627364642394
"93.139.98.172",28651,"147.32.84.165",32234,9,2475,3,435,6,2040,502.555381,2717.926725,1.2803877190618522,6.0045768893935145
"93.139.200.189",40108,"147.32.84.191",29676,3,425,1,247,2,178,3183.947703,0.20645600000034392,9571.046615243482,6897.353431228096
"93.140.175.183",40108,"147.32.84.191",29676,9,2817,3,543,6,2274,1873.426631,1277.663909,3.399955159882347,14.238486249673034
"93.141.88.132",18246,"147.32.84.192",31037,3,825,1,145,2,680,2505.4913,0.17609899999979461,6587.203788785586,30891.71431982206
"93.142.161.238",57482,"147.32.84.191",29676,3,825,1,145,2,680,2034.805594,0.1170839999999771,9907.416897272275,46462.36889755273
"93.142.161.238",59859,"147.32.84.191",29676,3,825,1,145,2,680,2986.774849,0.23662500000000364,4902.2715266771565,22989.96302165839
"93.142.171.75",11727,"147.32.84.192",31037,26,4685,4,549,22,4136,662.218496,2870.410821,1.5300945662091343,11.527269810275008
"93.143.210.151",28431,"147.32.84.191",29676,12,3176,4,688,8,2488,2288.858025,1357.0893609999998,4.055738817334963,14.666683397571784
"93.155.254.43",7600,"147.32.84.192",7600,394,379801,46,4585,348,375216,2769.489648,0.8713459999999031,42095.79202751155,3444932.3230959154
"93.157.168.31",19277,"147.32.84.165",32234,3,825,1,145,2,680,3413.377167,0.17898699999977907,6480.917608549402,30393.268784921333
"93.172.170.207",46000,"147.32.84.165",32234,3,825,1,145,2,680,667.189897,0.02933600000005754,39541.85983084691,185437.6874825924
"93.174.180.195",9541,"147.32.84.191",29676,6,1650,2,290,4,1360,2380.973089,10.433974999999919,222.3505423388515,1042.747370968407
"93.174.180.195",9931,"147.32.84.191",29676,6,1650,2,290,4,1360,3266.761668,8.021416999999929,289.2257066301404,1356.368831093072
"93.175.115.49",38448,"147.32.84.165",32234,9,2475,3,435,6,2040,877.689729,2857.344326,1.2179141198819592,5.711597251860223
"93.177.213.46",40864,"147.32.84.192",31037,3,825,1,145,2,680,1125.705948,0.16985699999986537,6829.274036400734,32026.940308637924
"93.178.92.239",62899,"147.32.84.165",32234,28,3812,12,1716,16,2096,1724.242981,2047.506799,6.70473964076932,8.189472195252037
"93.182.162.8",10214,"147.32.84.165",32234,3,825,1,145,2,680,3357.255013,0.16664399999990565,6960.946688753611,32644.439643810038
"93.183.237.30",58751,"147.32.84.191",29676,3,825,1,145,2,680,2458.129761,0.14811699999972916,7831.646603712748,36727.72200361841
"93.185.192.69",1475,"147.32.84.191",29676,9,1664,3,492,6,1172,1199.432282,1407.8016089999999,2.795848488052126,6.660029325197341
"93.185.192.80",1074,"147.32.84.165",32234,3,825,1,145,2,680,2461.732768,0.2549779999999373,4549.412106143609,21335.174015018307
"93.187.33.212",17570,"147.32.84.165",32234,3,825,1,145,2,680,3712.579366,0.1514780000002247,7657.877711603528,35912.80581993378
"93.187.178.129",43303,"147.32.84.192",31037,3,825,1,145,2,680,3678.465836,0.26270100000010643,4415.666480141035,20707.953148247612
"93.190.108.246",12734,"147.32.84.192",31037,3,825,1,145,2,680,1677.502422,0.20152699999994184,5756.052538867421,26993.90156158515
"93.190.205.4",33111,"147.32.84.191",29676,3,825,1,145,2,680,3677.283143,0.09296300000005431,12478.08267804742,58517.90497291204
"93.210.136.100",61319,"147.32.84.165",32234,9,1593,1,145,8,1448,1670.384434,1993.725751,0.5818252582724454,5.8102274067482815
"94.2.228.240",6881,"147.32.84.165",32234,3,825,1,145,2,680,3334.67243,0.20719999999982974,5598.455598460198,26254.826254847827
"94.7.29.196",39433,"147.32.84.192",31037,3,825,1,145,2,680,3447.576472,0.08931599999959872,12987.594607967349,60907.34023046757
"94.15.150.4",32880,"147.32.84.165",32234,3,825,1,145,2,680,1772.182924,0.21164300000009462,5480.927788773933,25703.661354250165
"94.19.8.76",49179,"147.32.84.191",29676,3,825,1,145,2,680,3313.149821,0.07191700000021228,16129.705076638013,75642.75484216448
"94.21.89.236",34740,"147.32.84.165",32234,3,825,1,145,2,680,998.849217,0.14995100000010098,7735.860381052603,36278.517649074274
"94.21.115.69",51607,"147.32.84.191",29676,4,1007,2,327,2,680,3395.960823,29.895066000000043,87.50607876229463,181.9698273955974
"94.21.136.151",23642,"147.32.84.165",32234,6,1147,2,259,4,888,1155.991296,2497.929451,0.8294869973891829,2.8439554196200554
"94.21.177.167",50192,"147.32.84.191",29676,3,825,1,145,2,680,3280.616447,0.19489000000021406,5952.075529779496,27913.18179482798
"94.21.232.178",1187,"147.32.84.192",31037,3,825,1,145,2,680,2915.873888,0.19319599999971615,6004.265098665109,28157.93287649844
"94.21.245.98",30067,"147.32.84.165",32234,3,825,1,145,2,680,313.3981,0.18465099999997392,6282.121407412707,29460.98315200442
"94.22.90.186",18860,"147.32.84.191",29676,3,828,1,140,2,688,2022.768207,0.2760289999998804,4057.544678278316,19939.933847539152
"94.24.187.95",50223,"147.32.84.165",32234,1,143,1,143,0,0,2729.259085,0,0,0
"94.25.4.94",11241,"147.32.84.192",31037,3,825,1,145,2,680,1960.659328,0.2599330000000464,4462.688462025957,20928.470028811385
"94.25.90.84",35986,"147.32.84.192",31037,3,825,1,145,2,680,1845.406144,0.14534699999990153,7980.9008785925125,37427.67308581316
"94.26.14.70",15651,"147.32.84.165",32234,3,828,1,140,2,688,2011.925013,0.042248999999856096,26509.503183597597,130275.27278796532
"94.27.73.84",36449,"147.32.84.165",32234,3,825,1,145,2,680,478.316945,0.21220900000002985,5466.30915748077,25635.10501439258
"94.27.77.134",49724,"147.32.84.191",29676,3,825,1,145,2,680,3424.364563,0.2472179999999753,4692.214968166218,22004.870195538122
"94.28.210.93",57252,"147.32.84.165",32234,1,143,1,143,0,0,825.019962,0,0,0
"94.30.44.209",13882,"147.32.84.191",29676,3,825,1,145,2,680,2223.826412,0.23707400000012058,4892.986999837224,22946.421792340083
"94.41.64.133",35691,"147.32.84.165",32234,3,825,1,145,2,680,1165.109475,0.22107600000003913,5247.064357957421,24606.922506283074
"94.41.136.126",40083,"147.32.84.192",31037,3,825,1,145,2,680,2824.805287,0.17939499999965847,6466.177987135698,30324.145043119133
"94.45.65.11",19883,"147.32.84.165",32234,1,143,1,143,0,0,2565.64869,0,0,0
"94.45.190.75",52057,"147.32.84.165",32234,12,2787,4,539,8,2248,1500.237955,2163.716738,1.992867145810285,8.311624014436958
"94.50.181.96",30895,"147.32.84.192",31037,3,825,1,145,2,680,2864.682144,0.2141990000000078,5415.52481570856,25396.9439633229
"94.50.202.85",33862,"147.32.84.192",31037,3,825,1,145,2,680,3205.820131,0.11872500000026776,9770.47799534541,45820.17266782675
"94.51.163.106",52879,"147.32.84.165",32234,3,825,1,145,2,680,1396.633896,0.10390400000005684,11164.151524478031,52356.020942379735
"94.52.83.24",33122,"147.32.84.192",31037,6,1650,2,290,4,1360,692.309424,864.685751,2.6830556619175745,12.582605862785867
"94.52.141.126",14923,"147.32.84.191",29676,3,825,1,145,2,680,2580.018126,0.1959780000001956,5919.0317280452,27758.217759108524
"94.59.52.62",16125,"147.32.84.165",32234,3,825,1,145,2,680,2316.039922,0.07041400000025533,16473.99664833405,77257.36359218726
"94.66.16.82",60106,"147.32.84.165",32234,9,2475,3,435,6,2040,1376.830824,1784.127022,1.9505337664237228,9.147330766676768
"94.66.129.16",11235,"147.32.84.191",29676,3,828,1,148,2,680,3713.483984,0.1883179999999811,6287.237545004295,28887.30763920892
"94.67.237.194",11029,"147.32.84.165",32234,3,825,1,145,2,680,2012.496394,0.07563899999991008,15336.003913343367,71920.5700763689
"94.68.213.154",13238,"147.32.84.191",29676,3,825,1,145,2,680,2681.954209,0.19453100000009727,5963.059872202477,27964.694573087476
"94.70.61.182",52605,"147.32.84.191",29676,3,825,1,145,2,680,2325.214809,0.13006399999994755,8918.686185266237,41825.56279986924
"94.73.238.210",63652,"147.32.84.192",31037,3,825,1,145,2,680,800.139103,0.2869910000000573,4041.9385973768112,18955.298249767115
"94.75.53.128",22558,"147.32.84.165",32234,3,828,1,148,2,680,3026.006039,0.20556400000032227,5759.763382684438,26463.777704225795
"94.75.145.177",30728,"147.32.84.165",32234,3,825,1,145,2,680,3426.194328,0.10813499999994747,10727.331576275614,50307.48601287874
"94.75.181.135",6881,"147.32.84.192",31037,1,143,1,143,0,0,2424.48091,0,0,0
"94.77.27.14",22362,"147.32.84.191",29676,3,825,1,145,2,680,1859.793821,0.10758400000008805,10782.272456862085,50565.13979769805
"94.77.131.226",36140,"147.32.84.191",29676,9,1712,3,492,6,1220,1378.716094,1465.5086589999999,2.6857569048317718,6.6598037071031735
"94.79.4.3",30885,"147.32.84.165",32234,3,825,1,145,2,680,2267.121028,0.2108130000001438,5502.506961141907,25804.860231562045
"94.89.80.2",49872,"147.32.84.165",32234,3,825,1,145,2,680,3189.04633,0.17274099999985992,6715.255787571802,31492.23403826776
"94.122.197.134",10107,"147.32.84.165",32234,3,825,1,145,2,680,3184.758824,0.19172500000013315,6050.3325074935165,28373.97313859028
"94.125.49.207",43762,"147.32.84.165",32234,3,825,1,145,2,680,2964.946304,0.1894849999998769,6121.856611345244,28709.396522170802
"94.128.80.52",56588,"147.32.84.191",29676,3,825,1,145,2,680,2539.17377,0.19674200000008568,5896.0465990967605,27650.425430246876
"94.129.157.231",20318,"147.32.84.192",31037,3,828,1,140,2,688,1095.478875,0.2715659999998934,4124.227627907911,20267.632914290305
"94.137.223.17",21322,"147.32.84.192",31037,3,825,1,145,2,680,997.252595,0.13878999999997177,8357.95086101474,39195.907486138094
"94.138.57.177",32418,"147.32.84.192",31037,3,825,1,145,2,680,3322.335152,0.052106000000094355,22262.311442020102,104402.56400395634
"94.140.65.227",52212,"147.32.84.191",29676,6,1650,2,290,4,1360,1901.477101,1822.462955,1.2730025560382379,5.969943021420701
"94.140.71.131",61897,"147.32.84.191",29676,12,2984,4,688,8,2296,1673.621168,1482.3020010000002,3.713143472981117,12.3915369389021
"94.140.75.233",31811,"147.32.84.191",29676,12,2936,4,688,8,2248,1651.333179,1484.6544689999998,3.7072599146300087,12.113256232686423
"94.142.234.132",35113,"147.32.84.192",31037,4,1007,2,327,2,680,2653.983514,31.000277000000096,84.38634274138879,175.48230294845376
"94.160.77.99",11581,"147.32.84.191",29676,3,825,1,145,2,680,3059.110289,0.2041030000000319,5683.404947501108,26653.209408970713
"94.163.24.58",25848,"147.32.84.192",31037,3,825,1,145,2,680,3427.79953,0.15727800000013303,7375.4752730770915,34588.43576339602
"94.168.51.19",12537,"147.32.84.165",32234,1,145,1,145,0,0,3796.648798,0,0,0
"94.178.110.86",48544,"147.32.84.191",29676,1,145,1,145,0,0,3810.676452,0,0,0
"94.179.21.163",42381,"147.32.84.165",32234,3,825,1,145,2,680,1952.987972,0.20865900000012516,5559.309687093795,26071.24542912952
"94.179.62.188",18361,"147.32.84.191",29676,3,825,1,145,2,680,2257.126413,0.19138000000020838,6061.239418950449,28425.122792319347
"94.179.65.26",19215,"147.32.84.165",32234,3,825,1,145,2,680,1066.699224,0.1625659999999698,7135.563401942692,33463.33181600711
"94.179.112.59",18312,"147.32.84.165",32234,3,825,1,145,2,680,1043.27653,0.20782599999984086,5581.5922935575345,26175.74316978706
"94.179.125.185",16056,"147.32.84.191",29676,6,1650,2,290,4,1360,2036.339464,3.218860000000177,720.7520675021195,3380.07866138925
"94.179.153.26",47196,"147.32.84.165",32234,1,107,1,107,0,0,3343.331178,0,0,0
"94.179.178.185",58100,"147.32.84.191",29676,3,825,1,145,2,680,1681.533608,0.06185900000014044,18752.32383319107,87941.93245910294
"94.180.157.80",35691,"147.32.84.165",32234,3,825,1,145,2,680,3300.655566,0.11339099999986502,10230.08880776588,47975.58889159171
"94.181.33.45",35691,"147.32.84.165",32234,3,825,1,145,2,680,2537.738861,0.20711300000039046,5600.807288764168,26265.854871445754
"94.181.129.68",34140,"147.32.84.191",29676,3,825,1,145,2,680,1484.201422,0.26453399999991234,4385.069594080097,20564.46430327218
"94.181.135.252",34782,"147.32.84.192",31037,6,884,2,296,4,588,988.187398,1499.9867450000002,1.5786806169410514,3.1360277120315483
"94.194.134.246",50467,"147.32.84.165",32234,3,825,1,145,2,680,3665.732816,0.22409299999981158,5176.422288964739,24275.635562041538
"94.194.212.229",57178,"147.32.84.191",29676,3,825,1,145,2,680,1977.849145,0.09050500000012107,12816.971438024952,60107.176399013566
"94.198.111.87",63954,"147.32.84.165",32234,3,825,1,145,2,680,2309.441525,0.11564599999974234,10030.610656681463,47040.10514857514
"94.202.66.110",33748,"147.32.84.192",31037,3,825,1,145,2,680,2426.850522,0.06639799999993556,17470.405735129458,81930.17861991745
"94.209.78.3",29420,"147.32.84.165",32234,3,426,1,148,2,278,1108.457565,0.11599300000011681,10207.512522297102,19173.57081890942
"94.213.173.117",23599,"147.32.84.191",29676,4,1007,2,327,2,680,3298.585949,29.676192000000356,88.1514717252122,183.31192896986025
"94.219.40.220",30717,"147.32.84.165",32234,6,1650,2,290,4,1360,961.414079,1914.381198,1.2118798504831534,5.6832986091623745
"94.219.71.160",16966,"147.32.84.165",32234,3,506,1,148,2,358,1612.143154,0.2885109999999713,4103.829663340801,9926.831212675721
"94.229.245.195",43027,"147.32.84.191",29676,3,825,1,145,2,680,3667.56692,0.12497399999983827,9281.930641585459,43529.05404329733
"94.231.59.77",53746,"147.32.84.192",31037,6,1254,2,296,4,958,719.122861,1273.822744,1.8589713609321454,6.016535688422281
"94.232.62.16",12517,"147.32.84.192",31037,3,825,1,145,2,680,858.359766,0.26348399999994854,4402.544367021248,20646.414962582407
"94.232.62.16",12845,"147.32.84.192",31037,3,825,1,145,2,680,1796.63971,0.2078630000000885,5580.598759757658,26171.0838388635
"94.240.137.171",61790,"147.32.84.192",31037,3,825,1,145,2,680,3230.073474,0.053298000000268075,21764.418927430026,102067.61979760288
"94.241.26.226",18034,"147.32.84.192",31037,3,825,1,145,2,680,2940.158032,0.08743600000025253,13266.846607766249,62216.93581573137
"94.242.178.243",61838,"147.32.84.165",32234,3,825,1,145,2,680,2839.482733,0.018962999999985186,61171.755523962776,286874.4396985841
"94.244.1.226",34450,"147.32.84.192",31037,3,825,1,145,2,680,2070.961974,0.14995399999997971,7735.7056163900725,36277.79185617413
"94.250.61.251",23480,"147.32.84.192",31037,3,825,1,145,2,680,1134.821002,0.14954800000009527,7756.706876716914,36376.280525293114
"94.253.39.139",35691,"147.32.84.191",29676,3,825,1,145,2,680,1726.554304,0.17087500000002365,6788.588149230955,31836.137527427927
"94.253.46.12",35691,"147.32.84.165",32234,3,825,1,145,2,680,1955.837604,0.20804099999986647,5575.823996235091,26148.69184441284
"94.253.131.149",54564,"147.32.84.192",31037,3,825,1,145,2,680,2723.215096,0.1563930000002074,7417.211767780283,34784.16553165926
"94.255.119.134",24321,"147.32.84.192",31037,3,825,1,145,2,680,3006.439757,0.26155999999991764,4434.928888210603,20798.287199884206
"95.10.249.137",57294,"147.32.84.192",31037,6,1147,2,259,4,888,669.1102,1980.9106510000001,1.045983572734094,3.586229392231179
"95.16.202.69",13354,"147.32.84.165",32234,3,825,1,145,2,680,876.584414,0.25736399999993864,4507.234889107554,21137.377410987152
"95.24.132.157",65382,"147.32.84.191",29676,1,143,1,143,0,0,1937.82615,0,0,0
"95.24.181.142",56968,"147.32.84.191",29676,3,825,1,145,2,680,2356.908074,0.24316799999996874,4770.364521648198,22371.364653246725
"95.25.34.100",25758,"147.32.84.192",31037,3,825,1,145,2,680,3262.276883,0.06762699999990218,17152.912298367188,80441.24388199786
"95.25.63.224",31759,"147.32.84.191",29676,1,143,1,143,0,0,1518.285385,0,0,0
"95.25.73.27",59511,"147.32.84.192",31037,3,825,1,145,2,680,3062.971021,0.130851000000348,8865.04497479511,41574.004019728796
"95.25.201.219",39742,"147.32.84.191",29676,3,825,1,145,2,680,2485.966858,0.08170300000028874,14197.765075895628,66582.62242488985
"95.27.78.15",57817,"147.32.84.191",29676,3,825,1,145,2,680,2765.577677,0.13280399999985093,8734.676666375275,40962.62160782888
"95.27.137.213",18660,"147.32.84.165",32234,3,825,1,145,2,680,2412.563931,0.05171799999970972,22429.328280415153,105185.81538401588
"95.28.26.70",59938,"147.32.84.192",31037,3,825,1,145,2,680,1575.562392,0.23168699999996534,5006.754802816617,23479.95355803655
"95.29.74.118",55313,"147.32.84.165",32234,6,1428,2,468,4,960,1573.659985,2040.5179420000002,1.8348282673419392,3.7637502919834653
"95.29.120.107",53228,"147.32.84.192",31037,3,825,1,145,2,680,3663.743989,0.23268199999984063,4985.344805360081,23379.54805272314
"95.29.178.227",26316,"147.32.84.165",32234,3,825,1,145,2,680,3188.349409,0.06744699999990189,17198.689341285564,80655.92242809781
"95.30.35.254",59207,"147.32.84.191",29676,3,825,1,145,2,680,1960.335165,0.10169399999995221,11406.769327595975,53493.81477769147
"95.31.206.226",26662,"147.32.84.191",29676,9,1593,1,145,8,1448,1194.569497,2335.3637280000003,0.49671063487545947,4.960255167583899
"95.32.110.61",51003,"147.32.84.191",29676,3,825,1,145,2,680,3287.646971,0.21196999999983746,5472.47251970038,25664.00905790523
"95.32.183.11",6881,"147.32.84.165",32234,1,143,1,143,0,0,2366.790662,0,0,0
"95.32.244.83",10745,"147.32.84.192",31037,12,3300,4,580,8,2720,683.651583,1858.042664,2.497251591635142,11.711248843530322
"95.34.235.39",21173,"147.32.84.165",32234,3,825,1,145,2,680,958.764135,0.10699799999997595,10841.324136902193,50842.07181443787
"95.42.23.86",56165,"147.32.84.165",32234,3,825,1,145,2,680,3412.784813,0.169568999999683,6840.873036947606,32081.33562154739
"95.42.66.217",47611,"147.32.84.165",32234,1,145,1,145,0,0,3819.93172,0,0,0
"95.42.93.231",19918,"147.32.84.192",31037,10,1394,4,640,6,754,1171.968171,2618.062676,1.9556445485188223,2.3039937337237375
"95.43.24.86",59592,"147.32.84.165",32234,3,825,1,145,2,680,1732.069042,0.1767569999999523,6562.682100286342,30776.71605651526
"95.43.58.90",62868,"147.32.84.165",32234,3,825,1,145,2,680,2208.000646,0.0881600000002436,13157.894736805749,61705.9891105373
"95.44.160.104",62856,"147.32.84.191",29676,3,825,1,145,2,680,2181.492346,0.09578800000008414,12110.076418747454,56792.082515505295
"95.49.13.217",61570,"147.32.84.191",29676,1,143,1,143,0,0,3734.245563,0,0,0
"95.49.106.216",6750,"147.32.84.192",31037,9,1325,3,491,6,834,1336.126754,1472.7161150000002,2.6671807010137862,4.530404693779017
"95.52.32.18",22994,"147.32.84.165",32234,3,825,1,145,2,680,2542.747399,0.2857670000003054,4059.251068173583,19036.48776798646
"95.52.160.134",58050,"147.32.84.191",29676,3,825,1,145,2,680,2357.411186,0.1457260000001952,7960.144380539136,37330.33226735595
"95.52.190.146",64861,"147.32.84.165",32234,3,825,1,145,2,680,910.229524,0.3800860000000057,3051.940876538422,14312.550317559495
"95.53.133.127",29627,"147.32.84.191",29676,3,825,1,145,2,680,1557.367345,0.20882000000005974,5555.023465183738,26051.14452637891
"95.53.139.31",35691,"147.32.84.165",32234,3,825,1,145,2,680,3284.979628,0.12629999999990105,9184.481393514718,43072.05067303454
"95.53.170.107",10646,"147.32.84.165",32234,3,825,1,145,2,680,489.821676,0.425186999999994,2728.211351711168,12794.370476990305
"95.54.5.25",31729,"147.32.84.192",31037,3,825,1,145,2,680,2990.631249,0.1662069999997584,6979.248768112571,32730.270084941712
"95.54.25.77",38427,"147.32.84.192",31037,3,825,1,145,2,680,648.277019,0.17930300000000443,6469.495769730408,30339.70429942536
"95.54.226.174",52909,"147.32.84.192",31037,3,825,1,145,2,680,769.702539,0.3224529999999959,3597.4235004791853,16870.675726385147
"95.55.5.9",57098,"147.32.84.192",31037,3,825,1,145,2,680,2145.527356,0.1331119999999828,8714.466013583673,40867.84061542688
"95.55.207.103",1025,"147.32.84.191",29676,3,825,1,145,2,680,3071.078087,0.3108390000002146,3731.835451790796,17501.021429087872
"95.56.91.233",51995,"147.32.84.191",29676,3,825,1,145,2,680,1976.167634,0.1674030000001494,6929.385972766107,32496.43076883416
"95.56.170.196",47525,"147.32.84.192",31037,3,825,1,145,2,680,1172.216804,0.06850600000007034,16932.823402312337,79409.10285222337
"95.56.194.239",31898,"147.32.84.165",32234,3,825,1,145,2,680,3549.057028,0.05215599999974074,22240.969399604382,104302.47718435158
"95.57.30.136",11438,"147.32.84.165",32234,3,825,1,145,2,680,3277.631249,0.08445799999981318,13734.637334563522,64410.713017263406
"95.57.99.138",17938,"147.32.84.192",31037,3,825,1,145,2,680,2860.627261,0.2522279999998318,4599.013590881161,21567.78787447717
"95.57.201.73",10000,"147.32.84.165",32234,3,825,1,145,2,680,3318.897544,0.07961400000021968,14570.301705689944,68329.69075771836
"95.57.205.113",55451,"147.32.84.165",32234,3,825,1,145,2,680,2415.171793,0.1186769999999342,9774.42975471779,45838.70505660757
"95.58.4.183",14867,"147.32.84.191",29676,3,825,1,145,2,680,1504.712658,0.2832769999999982,4094.9318158551782,19203.81817090704
"95.58.16.232",53563,"147.32.84.165",32234,6,1650,2,290,4,1360,2414.534375,900.104049,2.577479795338639,12.087491454001892
"95.58.103.117",16285,"147.32.84.165",32234,3,825,1,145,2,680,1658.163302,0.1366680000000997,8487.722070997992,39804.48971226645
"95.58.187.186",62603,"147.32.84.192",31037,3,825,1,145,2,680,3279.483189,0.19966900000008536,5809.614912678003,27245.0906249727
"95.58.192.157",57293,"147.32.84.192",31037,3,825,1,145,2,680,2907.571014,0.03906699999970442,29692.579415076063,139247.95863621877
"95.59.227.10",13603,"147.32.84.165",32234,3,825,1,145,2,680,1769.924732,0.23641700000007404,4906.584551870791,23010.189622566468
"95.59.227.10",14246,"147.32.84.165",32234,3,825,1,145,2,680,2697.893431,0.12233900000001086,9481.849614594668,44466.60508913361
"95.65.17.47",61691,"147.32.84.165",32234,3,825,1,145,2,680,277.50681,0.16835500000001957,6890.20225119459,32312.672626291867
"95.65.17.47",62817,"147.32.84.165",32234,6,1650,2,290,4,1360,1119.808635,3.816147000000001,607.9430378337102,2851.043211909813
"95.65.17.47",61604,"147.32.84.165",32234,3,825,1,145,2,680,2067.485443,0.18621200000006866,6229.458896309434,29214.014134416655
"95.65.17.47",61780,"147.32.84.165",32234,6,1650,2,290,4,1360,3053.798084,1.6864730000002055,1375.6520264479284,6451.333641273044
"95.65.42.167",37448,"147.32.84.191",29676,7,1240,3,492,4,748,2485.989808,1307.147339,3.011137216567443,4.577907800797657
"95.67.164.191",22681,"147.32.84.165",32234,3,825,1,145,2,680,2913.912497,0.20634400000017195,5621.680300852137,26363.742100547952
"95.67.174.90",12054,"147.32.84.191",29676,4,1007,2,327,2,680,2514.220274,32.43666600000006,80.64947242111737,167.71144112036637
"95.68.41.210",60836,"147.32.84.165",32234,3,825,1,145,2,680,2674.56234,0.20072299999992538,5779.1085226926225,27102.02617538609
"95.68.172.76",12809,"147.32.84.191",29676,3,825,1,145,2,680,1771.73084,0.10797100000013415,10743.625603157872,50383.89938032658
"95.69.132.131",49864,"147.32.84.165",32234,3,825,1,145,2,680,1104.315543,0.18335000000001855,6326.697572947273,29670.029997269972
"95.70.85.225",6881,"147.32.84.165",32234,1,143,1,143,0,0,3815.049895,0,0,0
"95.71.238.40",54565,"147.32.84.191",29676,1,143,1,143,0,0,3140.485396,0,0,0
"95.71.251.66",50688,"147.32.84.165",32234,3,825,1,145,2,680,2705.293619,0.04620999999997366,25102.791603563324,117723.43648567627
"95.72.169.25",53302,"147.32.84.191",29676,6,1650,2,290,4,1360,2037.963163,982.2703770000003,2.361875156090551,11.076380042355687
"95.72.170.85",51230,"147.32.84.165",32234,3,825,1,145,2,680,2697.419457,0.1914769999998498,6058.168866239339,28410.72295891552
"95.73.30.79",32300,"147.32.84.165",32234,3,825,1,145,2,680,2908.974925,0.029865999999856285,38840.15268216641,182146.92292326316
"95.73.78.192",35691,"147.32.84.165",32234,3,825,1,145,2,680,2990.058014,0.2116809999997713,5479.943877822068,25699.047151165563
"95.73.88.198",17421,"147.32.84.191",29676,3,825,1,145,2,680,2290.194976,0.09521999999969921,12182.31463982004,57130.85486260433
"95.74.61.32",10000,"147.32.84.191",29676,3,825,1,145,2,680,3721.445118,0.2864629999999124,4049.388577234598,18990.236086341563
"95.76.137.178",49067,"147.32.84.192",31037,3,825,1,145,2,680,3449.407494,0.06786499999998341,17092.757680693783,80159.1394680812
"95.78.0.92",46357,"147.32.84.191",29676,3,828,1,148,2,680,3497.140291,0.19181499999967855,6172.614237687272,28360.660010995576
"95.78.80.4",12642,"147.32.84.165",32234,1,143,1,143,0,0,3474.238652,0,0,0
"95.78.136.125",49506,"147.32.84.165",32234,1,143,1,143,0,0,1740.736622,0,0,0
"95.78.136.227",58606,"147.32.84.165",32234,3,825,1,145,2,680,3759.947324,0.24599199999966004,4715.600507340088,22114.540310284556
"95.78.244.46",36520,"147.32.84.192",31037,3,825,1,145,2,680,1887.54939,0.2377880000001369,4878.294951803002,22877.521153283044
"95.79.116.188",52921,"147.32.84.165",32234,3,393,3,393,0,0,904.105148,2721.7142169999997,1.1551543436714908,0
"95.79.144.142",53796,"147.32.84.165",32234,3,825,1,145,2,680,3666.491218,0.08261700000002747,14040.693803933988,65846.01232189732
"95.79.144.253",36146,"147.32.84.165",32234,3,825,1,145,2,680,2669.593952,0.11131699999987177,10420.690460588556,48869.44491862219
"95.81.55.124",59921,"147.32.84.192",31037,1,143,1,143,0,0,1641.250025,0,0,0
"95.81.245.149",35691,"147.32.84.192",31037,3,825,1,145,2,680,1608.288017,0.14634799999998904,7926.312624703357,37171.67299860885
"95.83.87.60",18163,"147.32.84.192",31037,3,825,1,145,2,680,1271.788005,0.25465299999996205,4555.218277421326,21362.40295618277
"95.83.122.56",35690,"147.32.84.165",32234,3,825,1,145,2,680,3522.496497,0.12647599999991144,9171.700559796422,43012.112970079776
"95.83.131.187",61106,"147.32.84.191",29676,3,825,1,145,2,680,2685.129309,0.2357689999998911,4920.070068586353,23073.432045784277
"95.83.143.30",34969,"147.32.84.191",29676,3,825,1,145,2,680,2885.524143,0.16550699999970675,7008.767000803926,32868.70041756324
"95.83.160.8",52805,"147.32.84.165",32234,3,825,1,145,2,680,2304.464576,0.04084800000009636,28397.963180504885,133176.65491547118
"95.84.38.38",49127,"147.32.84.192",31037,1,143,1,143,0,0,1225.487042,0,0,0
"95.86.41.77",51362,"147.32.84.191",29676,1,145,1,145,0,0,3782.994993,0,0,0
"95.87.6.181",43379,"147.32.84.165",32234,3,825,1,145,2,680,2431.327699,0.163307000000259,7103.186023857889,33311.49307740251
"95.96.213.69",32559,"147.32.84.165",32234,12,2090,4,640,8,1450,955.638564,2767.437201,1.8500871485538724,4.191603695942367
"95.102.145.215",13079,"147.32.84.165",32234,3,825,1,145,2,680,1109.565979,0.23941899999999805,4845.062421946502,22721.67204774911
"95.105.65.231",62535,"147.32.84.165",32234,3,825,1,145,2,680,3245.55631,0.33256600000004255,3488.0294437791345,16357.655322550423
"95.105.117.47",6881,"147.32.84.165",32234,1,143,1,143,0,0,1439.733712,0,0,0
"95.110.59.152",40872,"147.32.84.165",32234,3,825,1,145,2,680,2798.232295,0.07200200000033874,16110.663592602186,75553.45684806543
"95.110.75.188",35691,"147.32.84.192",31037,6,1650,2,290,4,1360,1472.020888,1009.1138329999999,2.2990468707607143,10.78173704908473
"95.129.166.126",1050,"147.32.84.165",32234,3,825,1,145,2,680,2361.792632,0.02935299999990093,39518.958879975304,185330.28991988418
"95.129.196.45",25888,"147.32.84.191",29676,3,825,1,145,2,680,3737.264651,0.16602199999988443,6987.025815860594,32766.741757139338
"95.129.239.113",1541,"147.32.84.192",31037,3,825,1,145,2,680,1318.194797,0.20725199999992583,5597.050933165495,26248.23885898301
"95.132.21.148",16881,"147.32.84.192",31037,3,825,1,145,2,680,1744.660192,0.2442999999998392,4748.260335656011,22267.703643076467
"95.132.72.166",19723,"147.32.84.192",31037,3,825,1,145,2,680,3088.595175,0.28508099999999104,4069.0189805705622,19082.295908882636
"95.132.151.7",24741,"147.32.84.192",31037,3,825,1,145,2,680,2526.48454,0.10685800000010204,10855.527896824686,50908.682550626116
"95.132.231.70",21777,"147.32.84.165",32234,3,825,1,145,2,680,1176.382755,0.07353399999988142,15775.015639049565,73979.38368657726
"95.133.240.78",59740,"147.32.84.192",31037,3,825,1,145,2,680,1760.779907,0.29399599999987913,3945.6319133609877,18503.653110934287
"95.135.36.4",39207,"147.32.84.191",29676,6,1254,2,296,4,958,1665.948587,1453.516402,1.6291525824832076,5.272730317631463
"95.135.67.48",35691,"147.32.84.165",32234,4,1007,2,327,2,680,296.116116,35.100661,74.5285110157897,154.98283636311007
"95.135.88.222",25468,"147.32.84.165",32234,2,286,2,286,0,0,296.673759,900.1371839999999,2.5418347788196693,0
"95.135.113.55",63159,"147.32.84.191",29676,3,825,1,145,2,680,2984.622408,0.15712799999982963,7382.516165172711,34621.45511943065
"95.135.146.244",45278,"147.32.84.192",31037,3,825,1,145,2,680,3499.672978,0.14965900000015608,7750.9538350436005,36349.30074365275
"95.135.166.110",28331,"147.32.84.192",31037,3,825,1,145,2,680,2437.318028,0.07393999999976586,15688.395996803803,73573.16743328681
"95.139.23.176",19540,"147.32.84.191",29676,3,828,1,148,2,680,1838.582956,0.14697500000011132,8055.7918013206545,37013.09746552733
"95.139.165.25",30397,"147.32.84.192",31037,1,143,1,143,0,0,1303.829687,0,0,0
"95.150.21.200",54168,"147.32.84.165",32234,3,825,1,145,2,680,3522.922738,0.10161899999957313,11415.188104634692,53533.29593897649
"95.154.117.173",51773,"147.32.84.192",31037,3,825,1,145,2,680,1040.12613,0.0744129999998222,15588.674022049529,73105.5057585771
"95.154.117.173",52654,"147.32.84.192",31037,6,1650,2,290,4,1360,1926.986749,4.524544000000105,512.7588548149705,2404.662215684
"95.154.117.173",51687,"147.32.84.192",31037,6,1650,2,290,4,1360,2892.163478,10.223175999999967,226.93534768451678,1064.2485270722166
"95.154.119.245",63891,"147.32.84.165",32234,3,825,1,145,2,680,1594.644856,0.0715740000000551,16207.002542810338,76005.253304214
"95.154.119.245",50799,"147.32.84.165",32234,3,825,1,145,2,680,2463.354392,0.33245999999962805,3489.1415508671653,16362.870721308085
"95.157.157.149",19169,"147.32.84.165",32234,3,825,1,145,2,680,1243.469058,0.15624300000013136,7424.332610094691,34817.55982665096
"95.158.227.56",5013,"147.32.84.165",32234,1,107,1,107,0,0,1745.142377,0,0,0
"95.158.237.137",50415,"147.32.84.165",32234,6,1650,2,290,4,1360,1633.590169,1740.1141739999998,1.3332458494186141,6.252463293825225
"95.159.72.159",23062,"147.32.84.192",31037,3,825,1,145,2,680,2952.523386,0.19152400000029957,6056.682191256373,28403.75096589196
"95.159.82.47",51410,"147.32.84.191",29676,3,825,1,145,2,680,2554.553671,0.10657899999978326,10883.94524251831,51041.95010284449
"95.160.183.64",59507,"147.32.84.165",32234,3,825,1,145,2,680,1544.270088,0.28520400000002155,4067.2641337425575,19074.06628237889
"95.160.221.198",36964,"147.32.84.192",31037,3,825,1,145,2,680,713.802359,0.28895699999998214,4014.4381343939467,18826.330561295752
"95.161.9.43",44946,"147.32.84.191",29676,6,1254,2,296,4,958,1819.49876,1402.086085,1.688911990022353,5.4661408325723455
"95.166.138.121",20145,"147.32.84.165",32234,13,3488,5,768,8,2720,2789.865038,295.74174200000016,20.774882701543014,73.57770956796483
"95.167.162.150",42594,"147.32.84.191",29676,3,825,1,145,2,680,2262.589105,0.15402099999982966,7531.440517859792,35319.85898030799
"95.167.162.150",8229,"147.32.84.191",29676,3,825,1,145,2,680,3165.080083,0.11340100000006714,10229.186691469327,47971.358277235464
"95.167.179.106",1096,"147.32.84.165",32234,3,825,1,145,2,680,1241.942374,0.2712819999999283,4275.993246880761,20052.93384744081
"95.167.216.242",10197,"147.32.84.165",32234,3,825,1,145,2,680,3037.845881,0.18192099999987477,6376.394149113068,29903.089802737148
"95.170.180.253",48845,"147.32.84.192",31037,3,825,1,145,2,680,2204.293901,0.19610999999986234,5915.0476773281025,27739.53393505593
"95.170.183.253",27942,"147.32.84.191",29676,4,1007,2,327,2,680,3102.235145,30.156249000000116,86.74818940512097,180.39378836538918
"95.170.240.121",45493,"147.32.84.165",32234,3,825,1,145,2,680,1639.392144,0.10881100000005972,10660.686879078065,49994.945363952305
"95.173.207.34",57167,"147.32.84.192",31037,1,143,1,143,0,0,3576.056658,0,0,0
"95.176.163.51",23616,"147.32.84.191",29676,12,2520,4,688,8,1832,1310.476039,1314.095208,4.188433202170234,11.152920968569578
"95.176.191.252",14880,"147.32.84.191",29676,12,3144,4,688,8,2456,1874.409537,1429.544661,3.850177018009233,13.744236564288775
"95.176.207.148",34191,"147.32.84.191",29676,18,3996,6,1032,12,2964,1205.65207,2544.062183,3.24520369634377,9.32052689531292
"95.176.210.229",10934,"147.32.84.191",29676,6,1588,2,344,4,1244,2774.419588,34.37618899999961,80.05541277423251,289.50271363705014
"95.179.4.82",55125,"147.32.84.165",32234,3,825,1,145,2,680,3252.489748,0.07947199999989607,14596.33581640725,68451.78175970296
"95.179.37.188",49562,"147.32.84.192",31037,3,825,1,145,2,680,661.930547,0.16382899999996425,7080.553503959941,33205.35436339834
"95.179.97.235",27452,"147.32.84.191",29676,3,825,1,145,2,680,3346.307324,0.14168300000028466,8187.291347569359,38395.57321618733
"95.180.104.70",56449,"147.32.84.165",32234,3,825,1,145,2,680,3523.605891,0.057920999999623746,20027.278534685785,93921.03036956092
"95.188.50.55",37461,"147.32.84.192",31037,3,825,1,145,2,680,2221.207256,0.22660300000006828,5119.084919439065,24006.743070472858
"95.188.198.173",32734,"147.32.84.192",31037,3,825,1,145,2,680,990.237388,0.25348799999994753,4576.153506281324,21460.581960491723
"95.190.54.28",1396,"147.32.84.191",29676,6,1206,2,344,4,862,2455.464004,38.42555600000014,71.61900272828817,179.4638963714663
"95.191.11.14",45755,"147.32.84.165",32234,3,828,1,148,2,680,3245.85962,0.2300470000000132,5146.774354805461,23647.341630187257
"95.191.185.29",6881,"147.32.84.165",32234,1,143,1,143,0,0,1050.582559,0,0,0
"95.220.0.205",21920,"147.32.84.191",29676,3,825,1,145,2,680,2470.457365,0.12186599999995451,9518.651633765227,44639.19386869209
"95.221.93.23",14588,"147.32.84.191",29676,6,1650,2,290,4,1360,2703.223965,942.7233099999999,2.4609553783071307,11.541032118957578
"95.221.137.17",34761,"147.32.84.165",32234,3,825,1,145,2,680,3226.207043,0.21773699999994278,5327.5281647138745,24984.27001383058
"95.221.142.21",48608,"147.32.84.191",29676,3,825,1,145,2,680,2104.184592,0.18861900000001697,6149.963683403557,28841.208998030477
"95.221.200.179",33542,"147.32.84.191",29676,3,825,1,145,2,680,2091.886561,0.21352000000024418,5432.746346940209,25477.70700634029
"95.233.26.170",43434,"147.32.84.165",32234,3,825,1,145,2,680,3615.949274,0.09833299999991141,11796.650158146756,55322.22143130893
"95.244.204.93",59611,"147.32.84.192",31037,3,825,1,145,2,680,2792.832197,0.27986399999963396,4144.870365611573,19438.012749074962
"95.247.192.224",27806,"147.32.84.165",32234,3,825,1,145,2,680,3407.36239,0.042964000000210945,26999.3482914604,126617.63336684878
"95.250.83.30",16364,"147.32.84.192",31037,3,825,1,145,2,680,2826.457509,0.1371790000002875,8456.104797363801,39656.215601430245
"95.250.209.124",58054,"147.32.84.191",29676,3,825,1,145,2,680,2139.810528,0.2434240000002319,4765.347706055668,22347.837518054166
"95.252.0.9",30205,"147.32.84.191",29676,1,143,1,143,0,0,1902.442604,0,0,0
"95.252.230.12",57128,"147.32.84.165",32234,3,825,1,145,2,680,1926.827181,0.2582169999998314,4492.345585305218,21067.551710396885
"96.21.12.27",54544,"147.32.84.192",31037,3,825,1,145,2,680,1569.555042,0.1799900000000889,6444.802489023985,30223.90132783662
"96.27.138.239",55487,"147.32.84.192",31037,3,825,1,145,2,680,3761.029075,0.10065299999996569,11524.743425435858,54047.072615837125
"96.29.163.211",40588,"147.32.84.165",32234,6,964,2,296,4,668,1622.927872,1238.32426,1.9122616559252419,4.315509412696154
"96.37.68.67",41900,"147.32.84.192",31037,9,2475,3,435,6,2040,1209.939494,1849.935502,1.8811466649716742,8.82192918745337
"96.48.104.138",40010,"147.32.84.165",32234,3,825,1,145,2,680,2814.778753,0.15579100000013568,7445.8729965080765,34918.57681121029
"96.48.240.68",64388,"147.32.84.191",29676,3,825,1,145,2,680,2612.671767,0.2175080000001799,5333.137171961678,25010.57432368235
"96.51.48.97",2802,"147.32.84.191",29676,3,825,1,145,2,680,3155.492338,0.22985100000005332,5046.747675666979,23667.50634105894
"96.55.232.28",35132,"147.32.84.191",29676,3,825,1,145,2,680,1871.307449,0.26304800000002615,4409.841549830771,20680.636233689132
"96.61.48.18",28977,"147.32.84.165",32234,3,825,1,145,2,680,3455.893753,0.24551300000030096,4724.8007233774915,22157.686151011683
"96.61.188.146",37079,"147.32.84.192",31037,3,825,1,145,2,680,3158.855261,0.13263299999971423,8745.938039571594,41015.43356488748
"96.236.218.156",61234,"147.32.84.165",32234,9,1326,3,492,6,834,923.21057,1363.1781240000003,2.8873702788381888,4.894444740957418
"96.243.246.203",62940,"147.32.84.191",29676,3,825,1,145,2,680,1512.502789,0.15003200000001016,7731.683907432557,36258.93142795958
"96.252.219.55",59565,"147.32.84.192",31037,3,825,1,145,2,680,2854.644776,0.17757799999981216,6532.340717888629,30634.42543561564
"97.75.154.202",59910,"147.32.84.165",32234,3,825,1,145,2,680,2401.695889,0.012214999999741849,94965.2067150647,445354.0728706483
"97.90.64.129",29735,"147.32.84.165",32234,3,825,1,145,2,680,722.131067,0.16128300000002582,7192.326531623385,33729.53132071656
"97.118.195.131",51947,"147.32.84.165",32234,3,825,1,145,2,680,3214.222437,0.16090500000018437,7209.22283334061,33808.76914945941
"97.120.162.158",14455,"147.32.84.165",32234,3,825,1,145,2,680,815.944848,0.34630700000002435,3349.629086330679,15708.605370378356
"98.30.58.233",52882,"147.32.84.165",32234,3,825,1,145,2,680,739.006444,0.2192929999999933,5289.726530258766,24806.993383282486
"98.68.129.49",54932,"147.32.84.192",31037,3,825,1,145,2,680,1352.793692,0.2861250000000837,4054.172127565437,19012.669287893084
"98.91.41.167",10256,"147.32.84.192",31037,3,825,1,145,2,680,1134.546508,0.19690400000013142,5891.195709580434,27627.676431135827
"98.94.208.134",53804,"147.32.84.192",31037,3,825,1,145,2,680,2001.963673,0.26316799999995055,4407.830739300439,20671.20622568482
"98.119.74.240",42134,"147.32.84.165",32234,3,825,1,145,2,680,1523.29084,0.18237500000009277,6360.520904726031,29828.64976009449
"98.157.96.97",17787,"147.32.84.191",29676,9,2475,3,435,6,2040,1754.134319,1786.8790299999998,1.9475297105031224,9.133242780290505
"98.166.151.172",49272,"147.32.84.192",31037,3,825,1,145,2,680,1460.516641,0.17861900000002606,6494.269926490635,30455.886551818152
"98.177.201.179",56025,"147.32.84.191",29676,3,825,1,145,2,680,1536.705811,0.13306199999988166,8717.740602133077,40883.19730655512
"98.192.167.208",30626,"147.32.84.192",31037,3,825,1,145,2,680,3150.027244,0.07123300000012023,16284.587199725438,76369.09859181585
"98.195.155.90",45279,"147.32.84.191",29676,4,1007,2,327,2,680,1710.57724,33.591539999999895,77.87675111054772,161.94553747759159
"98.200.213.178",26711,"147.32.84.165",32234,6,1650,2,290,4,1360,1265.888059,1784.268882,1.300252458250292,6.097735666277231
"98.212.131.232",36854,"147.32.84.191",29676,3,825,1,145,2,680,3453.877924,0.14311300000008487,8105.4830797992645,38011.9206500931
"98.217.128.240",32105,"147.32.84.165",32234,3,825,1,145,2,680,2062.278733,0.08521500000006199,13612.626884928195,63838.52608104257
"98.227.116.45",64626,"147.32.84.165",32234,3,825,1,145,2,680,2304.359958,0.14534199999980046,7981.175434503396,37428.96065836075
"98.227.216.241",45227,"147.32.84.165",32234,3,825,1,145,2,680,2392.601949,0.15667900000016743,7403.672476839655,34720.670925868726
"98.230.92.3",23303,"147.32.84.165",32234,3,825,1,145,2,680,1653.726599,0.20654700000000048,5616.155160810844,26337.83109897499
"98.232.78.224",47813,"147.32.84.165",32234,3,825,1,145,2,680,2158.342444,0.1091839999999138,10624.267291919292,49824.150058655985
"98.235.69.201",11052,"147.32.84.165",32234,3,825,1,145,2,680,2351.698813,0.033272000000124535,34864.15003593587,163500.84154783716
"98.242.151.71",52972,"147.32.84.165",32234,3,825,1,145,2,680,2395.328574,0.10956699999997,10587.12933639068,49649.985853418366
"98.247.184.73",36259,"147.32.84.165",32234,6,1334,2,296,4,1038,585.727437,1422.216965,1.665006154669235,5.838771582927925
"98.247.184.73",1271,"147.32.84.165",32234,6,836,2,344,4,492,3469.843481,32.12225100000023,85.67270083282706,122.53188607485731
"98.251.243.239",58574,"147.32.84.192",31037,3,825,1,145,2,680,1606.765763,0.25603799999998955,4530.577492403656,21246.84617127232
"99.2.216.222",59279,"147.32.84.165",32234,3,825,1,145,2,680,3116.121423,0.04048400000010588,28653.29512886489,134374.07370778016
"99.21.250.81",24925,"147.32.84.165",32234,3,825,1,145,2,680,2058.394406,0.1338570000002619,8665.96442470495,40640.38488827148
"99.40.139.66",13250,"147.32.84.165",32234,2,286,2,286,0,0,825.666371,1850.840735,1.2361949662837954,0
"99.65.154.247",12159,"147.32.84.192",31037,3,825,1,145,2,680,1652.805217,0.15225399999985711,7618.847452290834,35729.767362467355
"99.67.113.87",35348,"147.32.84.191",29676,3,825,1,145,2,680,2209.613538,0.16048599999976432,7228.044813888461,33897.03774789071
"99.69.110.72",28764,"147.32.84.165",32234,3,825,1,145,2,680,2285.132326,0.22397499999988213,5179.149458647664,24288.425047451114
"99.106.109.11",47738,"147.32.84.191",29676,3,825,1,145,2,680,1786.435287,0.12810699999999997,9054.930643914855,42464.50233008346
"99.111.160.152",25995,"147.32.84.165",32234,3,825,1,145,2,680,2209.006594,0.11949800000002142,9707.275435570404,45523.7744564681
"99.127.163.220",10436,"147.32.84.191",29676,3,825,1,145,2,680,2582.691528,0.13784100000020771,8415.493213182232,39465.76127561322
"99.141.238.124",21874,"147.32.84.192",31037,3,825,1,145,2,680,2158.986125,0.17967399999997724,6456.1372263106905,30277.057337181166
"99.152.106.30",40539,"147.32.84.165",32234,3,825,1,145,2,680,2807.103717,0.10292299999991883,11270.561487723005,52855.046976907885
"99.156.230.136",19490,"147.32.84.165",32234,3,825,1,145,2,680,1056.231375,0.12265800000000127,9457.189910156598,44350.959578665424
"99.176.62.142",57196,"147.32.84.191",29676,6,1650,2,290,4,1360,1714.884663,1782.4475679999998,1.3015810628321385,6.10396636362658
"99.188.50.80",63988,"147.32.84.165",32234,1,143,1,143,0,0,3695.586957,0,0,0
"99.195.253.35",24026,"147.32.84.165",32234,6,1650,2,290,4,1360,986.897409,2764.1690799999997,0.8393118991114683,3.936083388936541
"99.228.38.196",60001,"147.32.84.192",31037,3,825,1,145,2,680,2249.69174,0.1753299999995761,6616.095363045712,31027.20584049023
"99.228.160.34",25330,"147.32.84.191",29676,3,825,1,145,2,680,2499.087494,0.23624400000016976,4910.177612972886,23027.039840148707
"99.229.176.119",11128,"147.32.84.165",32234,3,825,1,145,2,680,774.512774,0.09080499999993208,12774.62694786485,59908.59534171102
"99.237.50.188",56893,"147.32.84.165",32234,3,825,1,145,2,680,2914.360246,0.15989300000001094,7254.8516820618825,34022.75271587641
"99.239.51.68",46299,"147.32.84.165",32234,6,932,2,296,4,636,1625.322232,1434.498184,1.6507514797941354,3.546884936314426
"99.240.221.208",54293,"147.32.84.165",32234,6,1650,2,290,4,1360,741.760434,900.76863,2.5755781481866213,12.078573384599327
"99.243.132.145",40234,"147.32.84.191",29676,3,825,1,145,2,680,2903.334135,0.10055899999997564,11535.516462974781,54097.59444705414
"99.247.122.212",31402,"147.32.84.165",32234,3,825,1,145,2,680,2729.695035,0.03635499999973035,31907.578050023483,149635.53844148945
"99.252.131.87",34199,"147.32.84.165",32234,3,825,1,145,2,680,1290.616305,0.08953599999995276,12955.682630457157,60757.68406007494
"99.253.176.106",55691,"147.32.84.191",29676,3,825,1,145,2,680,3771.451795,0.22057399999994232,5259.00604785833,24662.924914094237
"99.253.236.160",35952,"147.32.84.165",32234,3,825,1,145,2,680,1670.220956,0.3261970000000929,3556.1332568958933,16677.038721994533
"101.51.138.216",10155,"147.32.84.192",31037,1,145,1,145,0,0,3792.787143,0,0,0
"101.51.139.195",28082,"147.32.84.191",29676,6,1656,2,280,4,1376,1523.509862,1804.614785,1.241262134511438,6.099916775313353
"101.108.141.162",10470,"147.32.84.165",32234,3,825,1,145,2,680,2730.127207,0.20601699999997436,5630.603299728393,26405.58788838143
"101.109.31.10",16763,"147.32.84.165",32234,3,825,1,145,2,680,1438.057633,0.1111150000001544,10439.634612774047,48958.286459905874
"101.109.159.158",46908,"147.32.84.192",31037,3,825,1,145,2,680,2284.24806,0.06095000000004802,19031.993437228648,89253.48646424469
"107.8.2.121",48733,"147.32.84.165",32234,9,1593,1,145,8,1448,1114.552684,2049.6556499999997,0.56594872411861,5.651681051887912
"108.15.56.211",58875,"147.32.84.192",31037,3,825,1,145,2,680,1305.50432,0.16667099999995116,6959.819044706877,32639.15138207363
"108.22.240.128",33746,"147.32.84.192",31037,3,825,1,145,2,680,1714.088821,0.05762699999991128,20129.453207728773,94400.19435348666
"108.23.240.72",25182,"147.32.84.192",31037,3,825,1,145,2,680,1053.540052,0.18556300000000192,6251.246207487419,29316.189110975483
"108.64.185.94",24625,"147.32.84.165",32234,9,1760,3,592,6,1168,1105.284192,2329.4803859999997,2.0330714216196024,4.0111949669792155
"108.196.48.212",44537,"147.32.84.165",32234,3,825,1,145,2,680,3453.762474,0.08959999999979118,12946.428571458744,60714.28571442721
"109.58.56.85",45602,"147.32.84.192",31037,1,145,1,145,0,0,3815.851409,0,0,0
"109.61.36.162",12065,"147.32.84.165",32234,3,825,1,145,2,680,3655.89468,0.19855499999994208,5842.209967013363,27397.950190131636
"109.64.214.104",15823,"147.32.84.165",32234,3,825,1,145,2,680,1129.528272,0.2002580000000762,5792.52763934304,27164.957205194947
"109.65.117.214",41462,"147.32.84.191",29676,3,825,1,145,2,680,2364.159033,0.030537999999978638,37985.46073746845,178138.71242398996
"109.68.173.132",30816,"147.32.84.165",32234,3,825,1,145,2,680,3333.844256,0.2139510000001792,5421.802188346997,25426.382676385918
"109.68.173.213",53925,"147.32.84.165",32234,3,825,1,145,2,680,3662.022782,0.1942509999998947,5971.6552295773445,28005.00383525927
"109.69.210.254",52112,"147.32.84.165",32234,3,825,1,145,2,680,2741.575137,0.13566800000035073,8550.28451806617,40097.88601575859
"109.75.192.239",2321,"147.32.84.165",32234,3,825,1,145,2,680,3756.577456,0.13202899999987494,8785.948541616604,41203.069022753734
"109.79.50.239",11851,"147.32.84.165",32234,3,825,1,145,2,680,3573.388187,0.3072019999999611,3776.017083222592,17708.218045457674
"109.86.32.11",42711,"147.32.84.165",32234,3,825,1,145,2,680,1353.730488,0.2255609999999706,5142.73300792314,24117.644450949894
"109.86.32.168",16804,"147.32.84.165",32234,3,825,1,145,2,680,2889.634658,0.15169700000024022,7646.8222838827605,35860.95967613984
"109.86.128.50",62477,"147.32.84.191",29676,3,825,1,145,2,680,3511.058772,0.16556500000024243,7006.311720462063,32857.18599940829
"109.87.26.149",60146,"147.32.84.165",32234,3,825,1,145,2,680,409.019966,0.1643799999999942,7056.819564424145,33094.05037109254
"109.87.62.85",39104,"147.32.84.165",32234,2,289,2,289,0,0,3044.686386,0.10092299999996612,22908.554046161687,0
"109.87.75.9",51128,"147.32.84.191",29676,3,825,1,145,2,680,1984.05728,0.13037899999994806,8897.138342834829,41724.51084915644
"109.87.81.7",16781,"147.32.84.192",31037,6,1650,2,290,4,1360,1136.742876,2562.3279780000003,0.9054266354344119,4.246138704106207
"109.87.169.58",24055,"147.32.84.192",31037,3,825,1,145,2,680,2525.410634,0.171603000000232,6759.788581775562,31701.077486947466
"109.90.53.194",18087,"147.32.84.165",32234,6,1650,2,290,4,1360,670.160205,1902.0671199999997,1.2197256214596677,5.720092569603959
"109.91.253.232",33021,"147.32.84.192",31037,3,825,1,145,2,680,1151.01161,0.18417299999987335,6298.425936487964,29537.445771115967
"109.92.49.128",26871,"147.32.84.165",32234,6,1650,2,290,4,1360,2154.775056,956.2016450000001,2.4262664806438394,11.37835315060559
"109.92.50.165",27865,"147.32.84.165",32234,3,825,1,145,2,680,1519.61505,0.2424149999999372,4785.182435081577,22440.85555762395
"109.92.78.68",25899,"147.32.84.192",31037,3,825,1,145,2,680,2351.589727,0.19854399999985617,5842.53364493936,27399.468127991484
"109.92.221.71",10000,"147.32.84.165",32234,3,825,1,145,2,680,3653.038052,0.22754400000030728,5097.915128495735,23907.46405087655
"109.93.42.73",52384,"147.32.84.192",31037,3,825,1,145,2,680,3167.317985,0.13471499999968728,8610.770886706698,40381.54622731417
"109.93.127.34",58654,"147.32.84.192",31037,3,825,1,145,2,680,2499.366182,0.06313299999965238,18373.909049251375,86167.29761028232
"109.98.212.99",45013,"147.32.84.191",29676,3,825,1,145,2,680,1547.617698,0.29842200000007324,3887.1128804167097,18229.2190254025
"109.98.235.186",13026,"147.32.84.191",29676,3,825,1,145,2,680,3471.498467,0.24823800000012852,4672.934844783633,21914.45306519221
"109.105.179.91",16366,"147.32.84.165",32234,3,825,1,145,2,680,3017.881922,0.21782900000016525,5325.278085099413,24973.71791632828
"109.105.186.79",29963,"147.32.84.192",31037,1,143,1,143,0,0,2986.835079,0,0,0
"109.106.141.202",27062,"147.32.84.165",32234,3,825,1,145,2,680,857.101099,0.32689800000002833,3548.507485515052,16641.276483794725
"109.106.158.153",59487,"147.32.84.165",32234,3,825,1,145,2,680,2638.85234,0.06942800000024363,16707.95644402733,78354.55435819713
"109.109.208.35",35691,"147.32.84.192",31037,3,825,1,145,2,680,1722.475186,0.19506000000001222,5946.88813698312,27888.854711369113
"109.109.208.46",35691,"147.32.84.165",32234,8,1355,2,259,6,1096,1033.148292,2061.450339,1.0051175916297443,4.253316140641698
"109.110.47.109",25562,"147.32.84.192",31037,6,884,2,296,4,588,1791.722586,1353.144302,1.7499981313892419,3.476347639381332
"109.110.136.126",4044,"147.32.84.165",32234,3,825,1,145,2,680,754.989395,0.1498070000000098,7743.296374668234,36313.38989499586
"109.120.52.181",24663,"147.32.84.165",32234,3,825,1,145,2,680,1058.138479,0.08862900000008267,13088.266820103105,61379.45819082835
"109.120.60.106",41294,"147.32.84.191",29676,3,825,1,145,2,680,1800.3109239999999,0.3420450000000983,3391.366633044385,15904.34007220815
"109.122.171.200",38907,"147.32.84.192",31037,3,825,1,145,2,680,1407.726998,0.1344099999998889,8630.310244780589,40473.179078971036
"109.126.17.212",45718,"147.32.84.191",29676,1,143,1,143,0,0,1696.950938,0,0,0
"109.126.43.178",20197,"147.32.84.192",31037,3,825,1,145,2,680,1283.753923,0.053351000000020576,21742.797698254064,101966.22368836388
"109.129.224.81",44760,"147.32.84.191",29676,3,825,1,145,2,680,1582.867404,0.27016600000001745,4293.656492674597,20135.768379439487
"109.132.173.143",11356,"147.32.84.192",31037,3,825,1,145,2,680,1220.344179,0.11298899999997047,10266.486118120376,48146.27972635762
"109.149.252.28",46616,"147.32.84.191",29676,3,825,1,145,2,680,2130.767103,0.21508099999982733,5393.316936414333,25292.796667322393
"109.154.219.202",51941,"147.32.84.165",32234,3,825,1,145,2,680,3360.782784,0.03343600000016522,34693.14511288037,162698.8874259217
"109.156.119.121",64212,"147.32.84.192",31037,3,825,1,145,2,680,3068.450874,0.0937420000000202,12374.389281215997,58031.61869811641
"109.160.0.138",61870,"147.32.84.191",29676,3,825,1,145,2,680,2770.693182,0.0389180000001943,29806.25931430723,139781.0781636477
"109.161.32.130",10260,"147.32.84.165",32234,3,825,1,145,2,680,3521.684874,0.09640300000000934,12032.820555375742,56429.779156244855
"109.164.246.132",28074,"147.32.84.192",31037,3,825,1,145,2,680,3506.441029,0.023752999999942404,48835.93651340095,229023.70226974238
"109.166.140.79",44072,"147.32.84.192",31037,3,825,1,145,2,680,2614.720511,0.09662100000014107,12005.671644862985,56302.460127633305
"109.166.143.131",58545,"147.32.84.165",32234,3,825,1,145,2,680,1805.01113,0.19470899999987523,5957.608533764455,27939.12967558503
"109.168.149.193",22933,"147.32.84.165",32234,1,107,1,107,0,0,3642.273454,0,0,0
"109.169.250.211",28672,"147.32.84.165",32234,1,143,1,143,0,0,492.267818,0,0,0
"109.171.40.134",58267,"147.32.84.192",31037,3,825,1,145,2,680,1808.592072,0.27237300000001596,4258.865599747156,19972.61108846942
"109.171.66.252",40989,"147.32.84.165",32234,3,825,1,145,2,680,886.217254,0.15146900000002006,7658.33272814798,35914.93969062501
"109.172.15.35",35691,"147.32.84.192",31037,3,825,1,145,2,680,2055.968543,0.22180200000002515,5229.889721462694,24526.379383411255
"109.172.40.75",47363,"147.32.84.165",32234,4,1007,2,327,2,680,3132.053772,30.167637999999897,86.71543990285248,180.32568542489201
"109.172.66.106",38997,"147.32.84.165",32234,2,286,2,286,0,0,1048.332116,978.5930089999999,2.3380506287675717,0
"109.175.47.36",61071,"147.32.84.192",31037,3,825,1,145,2,680,2746.094456,0.2929290000001856,3960.0039600014507,18571.053053799908
"109.182.26.95",16004,"147.32.84.191",29676,12,3176,4,688,8,2488,2179.827687,1347.286459,4.085248510613882,14.773398683731594
"109.182.48.64",59110,"147.32.84.191",29676,12,2776,4,688,8,2088,1530.814652,1347.2211160000002,4.085446653584072,12.398855541691196
"109.182.71.128",46755,"147.32.84.191",29676,3,666,1,148,2,518,1381.18675,0.1501029999999446,7887.916963687849,27607.70937290747
"109.182.97.148",28076,"147.32.84.191",29676,12,3048,4,688,8,2360,1703.82717,1366.1558839999998,4.028822819168124,13.819799205286007
"109.182.152.44",55689,"147.32.84.191",29676,12,2840,4,688,8,2152,1590.080616,1497.6159260000002,3.6751745921270333,11.495604247467115
"109.182.226.207",58173,"147.32.84.191",29676,6,1588,2,344,4,1244,2927.154491,36.06447900000012,76.30777086783898,275.95019464997586
"109.184.240.49",10027,"147.32.84.165",32234,3,825,1,145,2,680,2206.731488,0.07014500000013868,16537.17299875553,77553.63889071559
"109.185.46.214",31055,"147.32.84.191",29676,6,1092,2,344,4,748,2495.871405,34.24149400000033,80.37032496303968,174.75872986149326
"109.185.186.221",48134,"147.32.84.191",29676,12,1976,4,688,8,1288,1428.114619,1421.9422020000002,3.870762111328066,7.2464267433002165
"109.185.206.21",41447,"147.32.84.191",29676,12,1976,4,688,8,1288,1452.427255,1469.953802,3.744335361091845,7.009744106230081
"109.187.91.88",35691,"147.32.84.191",29676,18,4023,6,1215,12,2808,2442.795127,857.2334940000001,11.338801001165733,26.205228980471915
"109.187.112.79",26461,"147.32.84.165",32234,3,825,1,145,2,680,316.270095,0.2181929999999852,5316.3942014642025,24932.05556548729
"109.188.246.73",32614,"147.32.84.191",29676,3,825,1,145,2,680,2771.367158,0.17191000000002532,6747.716828572096,31644.46512709673
"109.194.200.3",51010,"147.32.84.165",32234,3,825,1,145,2,680,3746.881191,0.11031300000013289,10515.533074058385,49314.22407144622
"109.194.210.249",33239,"147.32.84.165",32234,3,825,1,145,2,680,3118.394638,0.1703389999997853,6809.94957115788,31936.31523025764
"109.195.67.9",48851,"147.32.84.165",32234,3,825,1,145,2,680,2339.477018,0.10128200000008292,11453.170356026247,53711.41960067481
"109.198.218.55",40414,"147.32.84.192",31037,3,825,1,145,2,680,2058.591441,0.23131899999998495,5014.719932215146,23517.307268319306
"109.198.222.116",35691,"147.32.84.191",29676,3,825,1,145,2,680,3461.767461,0.11343500000020867,10226.120685836524,47956.97976806094
"109.199.7.170",8040,"147.32.84.165",32234,3,825,1,145,2,680,3732.453375,0.14621200000010504,7933.685333619448,37206.24846111189
"109.199.148.167",21052,"147.32.84.191",29676,3,825,1,145,2,680,2997.596497,0.2994140000000698,3874.234337738815,18168.82310111996
"109.201.228.143",65255,"147.32.84.165",32234,1,143,1,143,0,0,3515.806594,0,0,0
"109.203.231.22",55184,"147.32.84.165",32234,3,825,1,145,2,680,457.534336,0.11503099999998767,10084.238161887877,47291.59965575004
"109.205.248.121",1558,"147.32.84.191",29676,3,825,1,145,2,680,2708.583495,0.18838099999993574,6157.733529392007,28877.646896459068
"109.205.248.220",21728,"147.32.84.165",32234,3,825,1,145,2,680,169.36326,0.214287000000013,5413.300853527884,25386.514347579043
"109.205.249.125",2279,"147.32.84.191",29676,3,825,1,145,2,680,1505.046538,0.15384199999994053,7540.203585499723,35360.95474579181
"109.205.249.125",19946,"147.32.84.191",29676,6,1650,2,290,4,1360,2446.948482,1.2666480000002593,1831.6059394555748,8589.600267791662
"109.205.249.125",46232,"147.32.84.191",29676,3,825,1,145,2,680,3286.967008,0.2820849999998245,4112.235673647027,19284.9672971033
"109.210.3.249",11482,"147.32.84.191",29676,6,1650,2,290,4,1360,2241.891376,936.4020150000001,2.477568355083046,11.618941251423939
"109.210.144.175",28894,"147.32.84.192",31037,3,825,1,145,2,680,3470.581931,0.24617999999964013,4711.999350075943,22097.652124494078
"109.213.1.239",32797,"147.32.84.192",31037,3,825,1,145,2,680,1785.795373,0.14170899999999165,8185.78918770204,38388.528604395775
"109.224.0.81",49801,"147.32.84.191",29676,3,825,1,145,2,680,2346.190351,0.09318699999994351,12448.088252660813,58377.24146075416
"109.224.16.116",41001,"147.32.84.165",32234,3,825,1,145,2,680,410.218332,0.1743900000000167,6651.757554905034,31194.44922300292
"109.225.101.111",8290,"147.32.84.165",32234,3,828,1,140,2,688,3046.970856,0.1316900000001624,8504.821930280346,41795.12491452056
"109.226.118.240",36265,"147.32.84.191",29676,3,825,1,145,2,680,3617.113045,0.24329499999976179,4767.87439117588,22359.68679999723
"109.227.238.253",25705,"147.32.84.192",31037,3,825,1,145,2,680,1084.477922,0.2618170000000646,4430.57555468023,20777.87156677625
"109.229.59.108",46779,"147.32.84.165",32234,1,143,1,143,0,0,3196.430458,0,0,0
"109.239.216.143",44504,"147.32.84.165",32234,3,825,1,145,2,680,1490.9663,0.20473100000003797,5665.971445456647,26571.45229593462
"109.242.129.94",31270,"147.32.84.191",29676,3,825,1,145,2,680,3013.721047,0.06864499999983309,16898.53594584923,79248.30650467226
"109.242.243.50",20298,"147.32.84.192",31037,3,825,1,145,2,680,2412.289573,0.14404899999999543,8052.815361439765,37764.92721226925
"109.242.254.191",37053,"147.32.84.192",31037,3,825,1,145,2,680,3741.390493,0.19977700000026744,5806.474218746138,27230.361853430164
"109.252.84.116",50289,"147.32.84.165",32234,3,825,1,145,2,680,2405.666195,0.2980560000000878,3891.8860885191316,18251.60372546903
"110.10.186.88",54025,"147.32.84.165",32234,1,143,1,143,0,0,3291.581119,0,0,0
"110.11.117.193",49261,"147.32.84.165",32234,3,825,1,145,2,680,1695.020986,0.08034900000006928,14437.018506751792,67704.6385144222
"110.16.155.247",29186,"147.32.84.165",4041,2,208,2,208,0,0,1476.039853,10.158077999999932,163.81051612322835,0
"110.49.227.41",43480,"147.32.84.165",7600,12,1076,4,356,8,720,1420.567044,31.561230000000023,90.23729430063398,182.50239296757434
"110.49.227.41",45013,"147.32.84.191",7600,850,817084,110,16380,740,800704,1420.567451,147.55497400000013,888.075789298705,43411.833748145924
"110.49.235.41",40315,"147.32.84.192",7600,12,1076,4,356,8,720,1420.56719,31.618772000000035,90.07307431167779,182.17026265283147
"110.53.21.137",25903,"147.32.84.165",7600,1227,1208742,133,13298,1094,1195444,773.020537,26.549576000000002,4006.994311321582,360214.86746153684
"110.55.125.71",26042,"147.32.84.192",31037,3,825,1,145,2,680,3468.89536,0.1224210000000312,9475.49848473468,44436.82048013506
"110.77.101.62",31566,"147.32.84.192",7600,227,212476,31,3036,196,209440,2858.648879,11.811560999999983,2056.290442897432,141854.23924915618
"110.77.165.208",7600,"147.32.84.191",7600,6,749,2,249,4,500,2843.205189,0.5118270000002667,3891.9400500539477,7815.140662758931
"110.77.228.91",7600,"147.32.84.165",7600,6,749,2,249,4,500,986.345355,2.272889999999961,876.4172485250206,1759.8739930221298
"110.77.238.105",1690,"147.32.84.191",7600,7,909,3,409,4,500,2374.338201,0.973210999999992,3362.0663967012565,4110.1056194391895
"110.77.248.230",18760,"147.32.84.165",32234,3,825,1,145,2,680,1733.531732,0.15572199999996883,7449.172242844506,34934.04913885699
"110.132.76.12",52262,"147.32.84.165",32234,3,825,1,145,2,680,2156.892736,0.1462680000004184,7930.6478518656295,37192.003719093984
"110.135.0.40",27540,"147.32.84.165",32234,3,825,1,145,2,680,2908.301925,0.09922999999980675,11690.013100899518,54822.13040421843
"110.159.22.70",7600,"147.32.84.165",7600,8622,8191289,1266,120169,7356,8071120,2434.286712,1384.446961,694.394243392037,46638.810889050736
"110.159.67.241",7600,"147.32.84.191",7600,972,931741,126,12221,846,919520,3583.220245,11.27578799999992,8670.613530513405,652385.4474738308
"110.159.229.133",15382,"147.32.84.165",32234,3,825,1,145,2,680,3260.641892,0.25903399999970134,4478.17661002547,21001.10410218841
"110.159.246.18",1024,"147.32.84.165",32234,3,825,1,145,2,680,1679.170055,0.3144729999999072,3688.7109545186468,17298.78240739779
"110.168.78.9",13742,"147.32.84.165",7600,6,749,2,249,4,500,477.339366,0.4663189999999986,4271.753885215927,8577.819046618328
"110.168.89.240",7600,"147.32.84.191",7600,6,749,2,249,4,500,1985.878863,0.42601600000011786,4675.880718093801,9389.31871103173
"110.168.106.133",24185,"147.32.84.192",31037,3,825,1,145,2,680,2183.040351,0.308596999999736,3758.9477538699093,17628.16877676923
"110.169.112.225",7600,"147.32.84.191",7600,6,749,2,249,4,500,2843.426045,0.4452969999997549,4473.418864266088,8982.768803747165
"110.171.36.224",7600,"147.32.84.192",7600,3,269,1,89,2,180,1749.397504,0.00024099999995996768,0,0
"110.185.10.123",11935,"147.32.84.192",31037,1,143,1,143,0,0,2814.507001,0,0,0
"110.186.141.55",16224,"147.32.84.192",7600,545,521676,71,6992,474,514684,2273.269156,19.269274000000223,2902.8597548615144,213680.7022412963
"110.186.141.55",16224,"147.32.84.191",7600,589,557792,83,7972,506,549820,2273.272856,21.114841999999953,3020.4346307682595,208316.02718125997
"110.251.12.38",12657,"147.32.84.165",32234,1,107,1,107,0,0,2270.666583,0,0,0
"111.85.50.227",51893,"147.32.84.191",7600,7,909,3,409,4,500,936.367551,0.9738579999999502,3359.832747690287,4107.37499717639
"111.89.53.82",61852,"147.32.84.192",31037,2,286,2,286,0,0,1510.895243,937.676125,2.4400749245908337,0
"111.90.169.4",36051,"147.32.84.191",29676,3,825,1,145,2,680,2429.902344,0.16225600000007034,7149.1963317196105,33527.265555650585
"111.93.213.137",46813,"147.32.84.165",32234,3,825,1,145,2,680,548.169899,0.13874799999996412,8360.480871798512,39207.77236429647
"111.94.63.63",9023,"147.32.84.192",31037,3,825,1,145,2,680,1659.457743,0.19902799999999843,5828.325662720869,27332.83759069097
"111.94.225.55",26562,"147.32.84.192",31037,1,143,1,143,0,0,2147.055569,0,0,0
"111.104.64.167",12200,"147.32.84.191",29676,3,825,1,145,2,680,2176.133247,0.212395000000015,5461.522163892361,25612.655665150385
"111.119.186.132",58090,"147.32.84.191",29676,3,825,1,145,2,680,2803.124751,0.24146700000028432,4803.969072372764,22528.958408368824
"111.128.209.162",7600,"147.32.84.165",7600,6,749,2,249,4,500,2637.283012,0.5735039999999572,3473.3846668901156,6974.668005803444
"111.160.67.106",7600,"147.32.84.192",7600,743,694812,115,11036,628,683776,2812.784859,37.31150200000002,2366.2408444452317,146609.16089628334
"111.160.67.106",7600,"147.32.84.165",7600,917,877864,123,11868,794,865996,2812.818333,35.77175999999963,2654.1607122490195,193671.43243720944
"111.160.67.106",7600,"147.32.84.191",7600,1049,1018813,129,12545,920,1006268,2815.813823,34.32438400000001,2923.8689323601548,234531.34657857218
"111.161.185.216",52955,"147.32.84.165",7600,3,269,1,89,2,180,2091.564032,0.00022499999977299012,0,0
"111.172.72.252",35389,"147.32.84.191",29676,1,143,1,143,0,0,2687.405034,0,0,0
"111.185.238.121",7600,"147.32.84.191",7600,119,109948,15,1524,104,108424,1867.336813,1.6101020000000972,7572.191078577173,538718.6650286426
"111.192.180.220",11935,"147.32.84.191",29676,1,143,1,143,0,0,2989.139354,0,0,0
"111.248.66.28",11007,"147.32.84.191",29676,3,831,1,143,2,688,2278.254261,0.16610700000001088,6887.126972372778,33135.26823071658
"111.250.7.88",14742,"147.32.84.191",29676,3,831,1,143,2,688,2123.556778,0.17396299999973053,6576.111012121957,31638.91172265669
"111.250.24.37",18992,"147.32.84.191",29676,3,825,1,145,2,680,2041.058026,0.11403300000006311,10172.493927190882,47705.488761998626
"111.252.247.30",14222,"147.32.84.192",31037,3,825,1,145,2,680,903.158481,0.12271099999998114,9453.105263588255,44331.80399475871
"111.255.149.201",27398,"147.32.84.165",32234,6,1212,2,334,4,878,2809.00937,59.51373100000001,44.897201958317815,118.02318359102708
"112.4.179.134",4041,"147.32.84.192",31037,34,6557,8,1447,26,5110,823.872597,2888.91057,4.007046850190313,14.15066303004319
"112.5.23.143",10798,"147.32.84.165",7600,6,749,2,249,4,500,1080.835024,0.4860989999999674,4097.930668444357,8228.776442659351
"112.15.247.41",7600,"147.32.84.192",7600,5,449,1,89,4,360,1497.058676,0.08628099999987171,8252.1064892741,33379.30714762557
"112.22.178.165",38461,"147.32.84.192",31037,3,825,1,145,2,680,3334.595923,0.08203500000036001,14140.305966903265,66313.15901720151
"112.23.30.5",7600,"147.32.84.165",7600,726,645025,146,13953,580,631072,205.197693,35.36301400000002,3156.5182764116184,142764.30170799347
"112.64.69.106",63853,"147.32.84.192",31037,3,828,1,140,2,688,1131.349307,0.16476000000011481,6797.766448162294,33406.1665452547
"112.65.66.26",7600,"147.32.84.191",7600,74,65533,10,1029,64,64504,2123.643296,2.4079059999999117,3418.7381068863574,214307.36914149427
"112.65.138.90",7600,"147.32.84.192",7600,3,269,1,89,2,180,3130.30507,0.00029799999992974335,0,0
"112.78.171.1",24206,"147.32.84.191",7600,27,2421,9,801,18,1620,3593.710202,24.133756999999605,265.52020060532243,537.0071472916634
"112.82.156.96",7600,"147.32.84.191",7600,6,749,2,249,4,500,2451.406867,0.5656309999999394,3521.730598217236,7071.7481891912375
"112.90.148.214",12165,"147.32.84.165",7600,6,538,2,178,4,360,1510.456844,4.360832999999957,326.5431168769852,660.4242813242398
"112.92.53.215",4946,"147.32.84.192",7600,284,266031,40,3887,244,262144,2468.226631,6.123204999999871,5078.386237272908,342492.53454686626
"112.92.145.163",13236,"147.32.84.165",7600,3,269,1,89,2,180,3239.182431,0.00608799999963594,116951.37977046277,236530.8804346438
"112.92.145.163",13248,"147.32.84.165",7600,3,480,1,160,2,320,3240.089547,0.00018599999975776882,0,0
"112.95.66.142",3569,"147.32.84.191",7600,441,419194,57,5570,384,413624,1587.773098,5.584988000000067,7978.531019225014,592479.6973601305
"112.95.112.218",7600,"147.32.84.192",7600,945,882566,149,14326,796,868240,1861.765456,68.49022799999989,1673.3482037758756,101414.7594894853
"112.102.27.194",7600,"147.32.84.191",7600,196,185495,24,2407,172,183088,3091.282455,2.5850900000000365,7448.870252099435,566596.9076511763
"112.104.101.152",11015,"147.32.84.165",32234,18,4986,6,858,12,4128,2789.279511,145.3604819999996,47.22053687191281,227.18691865647565
"112.104.119.92",9005,"147.32.84.165",32234,3,828,1,140,2,688,2211.493175,0.27597100000002683,4058.3974403103625,19944.124563810925
"112.115.199.6",7600,"147.32.84.191",7600,262,245660,38,3600,224,242060,1432.682279,5.501318999999967,5235.108162242577,352002.85604234395
"112.119.187.55",15380,"147.32.84.191",29676,3,825,1,145,2,680,2653.368902,0.19398699999965174,5979.782150361017,28043.116291348215
"112.120.38.117",16882,"147.32.84.192",31037,6,1122,2,244,4,878,1400.968641,21.484024999999974,90.85820743552487,326.94059888684774
"112.120.42.121",7600,"147.32.84.191",7600,393,376770,49,4826,344,371944,1693.74916,4.274764000000005,9031.609698219589,696073.982095853
"112.134.67.84",33521,"147.32.84.191",29676,3,825,1,145,2,680,2439.805009,0.1516950000000179,7646.923102276694,35861.432479642426
"112.140.119.32",7600,"147.32.84.192",7600,6,749,2,249,4,500,932.929715,0.4720360000000028,4220.017117338483,8473.929954494946
"112.144.135.193",20904,"147.32.84.165",32234,3,825,1,145,2,680,1298.195603,0.09127800000010211,12708.429194315195,59598.150704374704
"112.159.14.101",53165,"147.32.84.165",32234,3,321,3,321,0,0,1217.007573,7.781610999999884,330.0087860984105,0
"112.164.163.171",53527,"147.32.84.191",29676,1,143,1,143,0,0,3695.863135,0,0,0
"112.167.216.67",58713,"147.32.84.191",29676,1,143,1,143,0,0,2874.771422,0,0,0
"112.167.221.161",36225,"147.32.84.165",32234,3,825,1,145,2,680,3359.441996,0.1328560000001744,8731.25790328233,40946.588787806795
"112.185.36.108",58018,"147.32.84.192",31037,3,825,1,145,2,680,2603.493772,0.2505530000003091,4629.758973145677,21711.973115441797
"112.185.218.169",26372,"147.32.84.191",29676,3,825,1,145,2,680,3078.179864,0.05983299999979863,19387.29463680417,90919.72657259887
"112.187.195.34",52735,"147.32.84.165",32234,1,143,1,143,0,0,1910.781166,0,0,0
"112.194.21.13",7600,"147.32.84.191",7600,266,254359,32,3195,234,251164,2152.183266,2.3558419999999387,10849.624041001334,852906.0947211452
"112.195.89.245",59523,"147.32.84.165",7600,6,749,2,249,4,500,1700.262364,0.658055000000104,3027.102597806696,6078.519272704209
"112.198.64.43",51125,"147.32.84.165",32234,3,825,1,145,2,680,2919.289612,0.2565789999998742,4521.024713638172,21202.046932923844
"112.198.64.75",20653,"147.32.84.165",7600,122,112231,16,1611,106,110620,1655.307055,2.125784000000067,6062.704395178247,416298.17516736046
"112.198.78.138",60279,"147.32.84.191",29676,3,825,1,145,2,680,1462.36815,0.15518700000006902,7474.8529193778095,35054.48265639249
"112.198.79.31",59900,"147.32.84.165",32234,3,825,1,145,2,680,3015.775512,0.2620969999998124,4425.842340815921,20755.67442589535
"112.200.120.70",45000,"147.32.84.192",31037,3,825,1,145,2,680,1865.044124,0.1502060000000256,7722.727454294784,36216.92875117554
"112.201.2.70",16553,"147.32.84.192",31037,3,825,1,145,2,680,2854.851109,0.17492700000002515,6631.337643701849,31098.68688080867
"112.202.124.158",59147,"147.32.84.165",32234,3,825,1,145,2,680,1116.033466,0.24476099999992584,4739.317129772927,22225.7630913489
"112.202.153.240",7600,"147.32.84.191",7600,6,749,2,249,4,500,2810.930249,0.3714460000001054,5362.82528281213,10768.725467494238
"112.202.201.58",32264,"147.32.84.191",29676,3,825,1,145,2,680,1778.481174,0.20495400000004338,5659.806590745994,26542.541253153628
"112.202.240.20",49854,"147.32.84.191",29676,3,825,1,145,2,680,2490.128127,0.14669499999990876,7907.563311637899,37083.74518561221
"112.202.245.81",55160,"147.32.84.192",31037,3,825,1,145,2,680,816.758234,0.2557490000000371,4535.697109274452,21270.855409011223
"112.205.21.143",20348,"147.32.84.165",32234,3,825,1,145,2,680,2626.255128,0.2865390000001753,4048.3145400775825,18985.1992224328
"112.205.62.253",25996,"147.32.84.192",31037,3,825,1,145,2,680,2189.072706,0.11881300000004558,9763.241396139774,45786.23551293136
"112.205.67.235",12237,"147.32.84.191",29676,3,828,1,140,2,688,2985.097456,0.08326799999986179,13450.545227480654,66099.82226076207
"112.205.192.193",44802,"147.32.84.191",29676,3,825,1,145,2,680,2192.019688,0.23013900000023568,5040.43208669027,23637.888406547474
"112.206.27.179",24806,"147.32.84.192",31037,3,825,1,145,2,680,1496.364045,0.1747499999999036,6638.054363379914,31130.18597998856
"112.206.173.68",51912,"147.32.84.191",29676,9,2475,3,435,6,2040,1625.076836,1933.4404339999999,1.7999002911097701,8.440911710032026
"112.207.176.186",7600,"147.32.84.191",7600,233,221110,29,2886,204,218224,1370.653939,6.787898000000041,3401.3475158288857,257191.84348379858
"112.207.227.133",40259,"147.32.84.192",31037,3,825,1,145,2,680,3762.283168,0.05599000000029264,20717.98535441931,97160.20717934573
"112.208.120.95",40223,"147.32.84.192",31037,3,825,1,145,2,680,2404.046133,0.12319999999999709,9415.584415584639,44155.844155845196
"112.210.156.223",12831,"147.32.84.191",29676,9,1593,1,145,8,1448,1358.656369,2351.3858899999996,0.4933260869401577,4.926456371650679
"112.221.98.45",53883,"147.32.84.165",32234,1,143,1,143,0,0,346.692676,0,0,0
"112.222.98.99",7600,"147.32.84.191",7600,3,269,1,89,2,180,2246.187038,0.0037729999999100983,0,0
"112.229.43.247",3147,"147.32.84.165",7600,6,749,2,249,4,500,1547.127736,2.3860360000001037,834.8574790991894,1676.4206407614245
"112.229.123.222",4807,"147.32.84.192",7600,3,269,1,89,2,180,3427.954488,0.00021900000001551234,0,0
"112.233.62.151",7600,"147.32.84.165",7600,15,1556,5,516,10,1040,1937.697959,5.405418999999938,763.6780793496392,1539.1961289217534
"112.233.151.89",7600,"147.32.84.165",7600,6,749,2,249,4,500,2418.655008,0.5882480000000214,3386.3268553398016,6799.853123172292
"112.233.227.186",20654,"147.32.84.165",7600,596,584815,64,6447,532,578368,2358.271008,12.469330999999784,4136.228318905071,371065.93769947084
"112.234.149.237",7600,"147.32.84.191",7600,771,764101,75,7611,696,756490,2678.067096,23.04905699999972,2641.669895649125,262566.9241045338
"112.235.93.64",5680,"147.32.84.192",7600,8,929,2,249,6,680,3100.889361,0.6156439999999748,3235.6361793505366,8836.27550987295
"112.236.37.92",6411,"147.32.84.191",7600,6,749,2,249,4,500,2120.117605,0.5746880000001511,3466.228631882824,6960.298457596032
"112.238.93.90",7600,"147.32.84.165",7600,13,1447,5,587,8,860,786.29444,21.708864999999946,216.31715891180914,316.92122089294014
"112.239.17.183",10350,"147.32.84.191",7600,6,749,2,249,4,500,3703.203535,0.5613559999997051,3548.550296070669,7125.60300415797
"112.239.226.41",3791,"147.32.84.191",7600,6,749,2,249,4,500,3366.200991,1.146375999999691,1737.6497763391217,3489.2565789942205
"112.240.16.4",3785,"147.32.84.191",7600,434,408649,62,5961,372,402688,3689.499603,11.512939999999617,4142.121821185691,279815.9288591886
"112.240.110.130",7600,"147.32.84.192",7600,3,269,1,89,2,180,1813.938187,0.004701999999952022,0,0
"112.241.131.162",7600,"147.32.84.192",7600,182,172129,22,2217,160,169912,2803.65067,3.2975750000000517,5378.497835530571,412210.79126327037
"112.241.199.97",4979,"147.32.84.165",7600,6,749,2,249,4,500,400.361509,1.74476999999996,1141.6977595901155,2292.565782309469
"112.244.104.172",34746,"147.32.84.165",7600,3,269,1,89,2,180,259.432668,0.00020900000004075991,0,0
"112.246.53.178",17956,"147.32.84.192",7600,6,749,2,249,4,500,2156.983958,0.840523000000303,2369.9529935519695,4758.94175412042
"112.249.57.186",63646,"147.32.84.192",7600,6,749,2,249,4,500,3726.476518,0.5814519999998993,3425.9061797024433,6879.329678117356
"112.254.68.172",7600,"147.32.84.165",7600,18,1616,4,356,14,1260,466.86189,13.11322100000001,217.1853887004572,768.6898588836406
"113.0.250.109",14242,"147.32.84.165",7600,4,2394,2,2196,2,198,163.422732,5.442058000000003,3228.190511751251,291.0663576169161
"113.0.250.109",14331,"147.32.84.165",7600,38,19674,16,17568,22,2106,167.671843,6.572622999999993,21383.243797795818,2563.3601683833103
"113.1.79.252",1288,"147.32.84.165",7600,102,92342,14,1486,88,90856,3010.858794,3.2015019999998913,3713.2570899535294,227033.43618090032
"113.1.79.252",1314,"147.32.84.191",7600,90,81176,12,1300,78,79876,3011.104217,2.689875000000029,3866.350666852507,237560.48143500835
"113.1.79.252",1315,"147.32.84.192",7600,90,81176,12,1300,78,79876,3011.135313,2.704215999999633,3845.846633553463,236300.65053978187
"113.9.190.57",29831,"147.32.84.191",7600,7,806,1,90,6,716,429.903244,0.09634700000003704,7472.988261178067,59451.77327781662
"113.9.190.57",29727,"147.32.84.191",7600,3,480,1,160,2,320,430.863326,0.0003230000000371547,0,0
"113.14.1.113",11935,"147.32.84.165",32234,1,143,1,143,0,0,1227.354165,0,0,0
"113.20.89.50",14174,"147.32.84.191",29676,3,825,1,145,2,680,2193.856879,0.2129570000001877,5447.109040787472,25545.063087830902
"113.22.98.181",22408,"147.32.84.165",32234,3,825,1,145,2,680,1266.641116,0.23970600000006925,4839.26142858195,22694.467389211903
"113.22.103.107",7600,"147.32.84.191",7600,187,172544,27,2632,160,169912,2941.342954,3.0151079999996,6983.497771888368,450828.2953712372
"113.22.150.174",61559,"147.32.84.165",32234,3,825,1,145,2,680,2593.699853,0.17575299999998606,6600.1718320602895,30952.529971041356
"113.53.106.92",58886,"147.32.84.192",31037,3,828,1,140,2,688,2138.716902,0.09668899999996938,11583.530701531246,56924.77944752498
"113.53.235.82",34937,"147.32.84.192",31037,1,143,1,143,0,0,1834.893679,0,0,0
"113.61.201.95",7600,"147.32.84.191",7600,423,403668,55,5372,368,398296,3601.877321,7.502354000000196,5728.335399795701,424715.7625459845
"113.61.241.36",7600,"147.32.84.165",7600,489,480336,51,5180,438,475156,3021.219037,5.172156000000086,8012.132658024875,734944.5763043374
"113.72.132.126",7600,"147.32.84.192",7600,6,749,2,249,4,500,1604.672937,0.7713569999998526,2582.4618172913197,5185.666299781767
"113.73.242.224",16001,"147.32.84.165",32234,9,2042,3,476,6,1566,3041.560893,8.395136000000093,453.5959870096158,1492.2926799518032
"113.74.54.94",7600,"147.32.84.165",7600,120,110031,16,1607,104,108424,728.487364,6.942849000000024,1851.689414532846,124933.15064176061
"113.74.169.161",20906,"147.32.84.192",7600,6,749,2,249,4,500,878.047849,0.6734579999999823,2957.8681966804943,5939.494370844366
"113.80.108.127",7600,"147.32.84.192",7600,12,1358,4,498,8,860,2781.558614,6.075151000000005,655.7861689363765,1132.482139127076
"113.83.106.3",16001,"147.32.84.165",32234,3,828,1,140,2,688,3657.403441,0.30884900000000926,3626.3675776834843,17821.006381758838
"113.84.112.183",4877,"147.32.84.165",7600,108,96625,14,1421,94,95204,415.269262,2.1806359999999927,5213.157996107575,349270.5797758097
"113.87.88.179",7600,"147.32.84.192",7600,6,749,2,249,4,500,3010.261429,0.6574129999999059,3030.058730205039,6084.455281536222
"113.91.77.29",42635,"147.32.84.191",29676,1,107,1,107,0,0,3198.933122,0,0,0
"113.97.107.202",25590,"147.32.84.165",32234,3,825,1,145,2,680,1605.700816,0.22207000000003063,5223.578151032737,24496.780294498356
"113.118.180.206",11935,"147.32.84.191",29676,1,143,1,143,0,0,3232.095565,0,0,0
"113.120.29.170",7600,"147.32.84.191",7600,6,749,2,249,4,500,3140.624416,0.37651499999992666,5290.625871480254,10623.74672988003
"113.120.37.152",2332,"147.32.84.191",7600,12,1287,4,427,8,860,1957.885439,8.626006000000189,396.0117811186226,797.5881305902001
"113.120.46.184",7600,"147.32.84.165",7600,6,749,2,249,4,500,2974.621049,0.35350800000014715,5634.950269864249,11315.161184466362
"113.120.59.8",7600,"147.32.84.192",7600,10,1178,4,498,6,680,1492.39182,1802.484196,2.210282902252975,3.0180569749639012
"113.120.192.111",7600,"147.32.84.191",7600,6,749,2,249,4,500,2451.174026,1.1678119999996852,1705.754008351119,3425.2088521106807
"113.120.192.111",7600,"147.32.84.192",7600,6,749,2,249,4,500,2461.032004,0.9259189999997943,2151.376092293648,4320.0323138426675
"113.123.135.169",7600,"147.32.84.165",7600,353,332770,49,4746,304,328024,3145.120454,5.767237000000023,6583.395133579537,455017.19454220275
"113.124.157.125",7600,"147.32.84.191",7600,60,51047,8,839,52,50208,1622.799252,1.4653599999999187,4580.444395916616,274106.02172846417
"113.125.176.118",7600,"147.32.84.192",7600,18,1616,4,356,14,1260,2275.00102,3.1774350000000595,896.3204597418819,3172.3701665021663
"113.125.246.219",7600,"147.32.84.165",7600,6,749,2,249,4,500,3303.053831,0.4798619999996845,4151.193468124815,8335.729855672318
"113.126.79.214",7600,"147.32.84.192",7600,6,749,2,249,4,500,3542.267541,0.8912559999998848,2235.0480669978742,4488.048327304969
"113.126.107.217",7600,"147.32.84.192",7600,6,749,2,249,4,500,2339.908712,0.40991200000007666,4859.579617087637,9758.19200218401
"113.126.171.84",7600,"147.32.84.191",7600,6,749,2,249,4,500,2024.477358,0.424239999999827,4695.455402604216,9428.625306434167
"113.126.192.138",7600,"147.32.84.191",7600,6,749,2,249,4,500,3413.148285,0.5109759999995731,3898.4218436906317,7828.156312631791
"113.126.194.122",7600,"147.32.84.192",7600,6,749,2,249,4,500,1264.405274,2.455081000000064,811.3785247818497,1629.2741461482924
"113.126.217.96",7600,"147.32.84.165",7600,6,749,2,249,4,500,1001.171836,0.5466750000000502,3643.8468925775223,7316.961631681772
"113.127.24.10",7600,"147.32.84.192",7600,6,749,2,249,4,500,2128.794003,1.4313579999998183,1391.6853785008732,2794.5489528129983
"113.127.34.191",7600,"147.32.84.165",7600,6,749,2,249,4,500,1321.914421,0.40896300000008523,4870.856287731616,9780.83591913979
"113.127.58.210",7600,"147.32.84.191",7600,6,749,2,249,4,500,3117.20188,0.441237000000001,4514.580599541733,9065.42289064605
"113.127.85.49",7600,"147.32.84.165",7600,218,181419,32,3119,186,178300,699.19855,4.904450999999995,5087.623466928312,290837.8532072196
"113.127.85.49",7600,"147.32.84.191",7600,173,139018,27,2622,146,136396,703.872502,3.6802959999999985,5699.541558613766,296489.19543428044
"113.127.85.49",7600,"147.32.84.192",7600,125,100396,19,1872,106,98524,707.036871,3.5346270000000004,4236.9392866630615,222991.5631833288
"113.128.153.206",2324,"147.32.84.165",7600,16,1716,6,676,10,1040,525.839224,13.082842000000028,413.36584207009366,635.9474493386057
"113.139.15.92",1326,"147.32.84.192",7600,562,525121,86,8241,476,516880,761.480298,45.985321,1433.6748894283025,89920.86844408458
"113.139.46.62",7600,"147.32.84.191",7600,260,243691,36,3507,224,240184,2169.623187,9.848971999999776,2848.622170923081,195093.6605363528
"113.139.70.222",35168,"147.32.84.165",7600,6,749,2,249,4,500,3161.0259,0.7804430000001048,2552.396523512585,5125.294223920854
"113.139.72.200",1160,"147.32.84.192",7600,3,269,1,89,2,180,3683.986246,0.00022600000011152588,0,0
"113.162.74.74",1084,"147.32.84.192",7600,6,749,2,249,4,500,1054.295462,0.36210000000005493,5501.24275062054,11046.672190001085
"113.162.118.122",33583,"147.32.84.165",32234,3,825,1,145,2,680,1842.263367,0.16797399999995832,6905.830664271184,32385.964494513137
"113.162.219.141",56934,"147.32.84.191",7600,6,749,2,249,4,500,2213.94176,0.9594269999997778,2076.2392553059913,4169.155131136529
"113.162.224.162",57189,"147.32.84.192",7600,6,749,2,249,4,500,2813.877653,0.3670870000000832,5426.506522975612,10896.599443726129
"113.162.244.185",18103,"147.32.84.191",7600,7,909,3,409,4,500,1068.115944,0.7590440000001308,4310.685546555188,5269.786731730059
"113.167.238.176",1454,"147.32.84.165",32234,3,825,1,145,2,680,1983.18734,0.22380599999996775,5183.060329035715,24306.765680995075
"113.169.17.71",7600,"147.32.84.165",7600,3,269,1,89,2,180,251.648284,0.0028939999999977317,0,0
"113.169.27.29",6800,"147.32.84.165",32234,1,107,1,107,0,0,3007.413926,0,0,0
"113.180.110.229",2491,"147.32.84.192",7600,7,909,3,409,4,500,2015.386142,0.7441529999998693,4396.945251850862,5375.238694194209
"113.190.20.98",49488,"147.32.84.192",31037,3,825,1,145,2,680,2899.826933,0.1347990000003847,8605.405084582893,40356.38246563012
"113.190.88.136",10507,"147.32.84.191",7600,12,1287,4,427,8,860,1554.880775,14.372973000000002,237.6682959050991,478.67619315781076
"113.199.159.227",13248,"147.32.84.192",31037,3,825,1,145,2,680,1657.100316,0.30733699999996134,3774.3584404095373,17700.439582610245
"113.199.221.128",44469,"147.32.84.165",32234,3,825,1,145,2,680,1882.753887,0.13169599999991988,8808.164257082262,41307.25306769613
"113.199.249.96",10012,"147.32.84.191",29676,3,825,1,145,2,680,2154.613022,0.1489729999998417,7786.645902285868,36516.684231409585
"113.211.93.67",7600,"147.32.84.191",7600,6,749,2,249,4,500,3435.583179,0.4118119999998271,4837.158703488088,9713.170087325478
"113.230.107.83",3734,"147.32.84.165",32234,1,143,1,143,0,0,1208.841885,0,0,0
"113.235.252.34",7600,"147.32.84.165",7600,11,1198,3,338,8,860,784.908331,5.940877,455.1516552185813,1158.0781759999406
"113.238.39.82",53802,"147.32.84.192",7600,298,285491,36,3583,262,281908,3162.127826,7.09591300000011,4039.5083761595665,317825.76815696096
"113.238.129.99",7600,"147.32.84.192",7600,8,929,2,249,6,680,2414.856084,0.6735380000000077,2957.516873583936,8076.752907779423
"113.243.90.197",58690,"147.32.84.165",7600,3,269,1,89,2,180,2799.491655,0.00023099999998521525,0,0
"113.249.211.151",7600,"147.32.84.191",7600,813,774160,119,17916,694,756244,3015.786889,33.34318699999994,4298.569299929255,181444.9230662927
"113.249.211.151",7600,"147.32.84.165",7600,791,759474,109,16406,682,743068,3015.793569,34.802682000000004,3771.2036101125764,170807.06596118078
"113.249.211.151",7600,"147.32.84.192",7600,603,554944,107,16104,496,538840,3015.797614,34.41541099999995,3743.43924005441,125255.51416486081
"113.251.112.5",9873,"147.32.84.191",29676,3,831,1,143,2,688,2048.355745,0.05996500000037486,19077.795380519445,91786.87567690475
"113.254.215.33",7600,"147.32.84.165",7600,6,749,2,249,4,500,2086.439515,2.2013309999997546,904.9070766732591,1817.0824832796368
"114.17.162.147",27345,"147.32.84.191",29676,6,1212,2,334,4,878,3571.823898,9.255221999999776,288.70188094894587,758.9229086023188
"114.22.213.83",37650,"147.32.84.165",32234,3,825,1,145,2,680,3158.208748,0.12390199999981633,9362.237897707217,43905.66738235109
"114.27.107.76",21000,"147.32.84.165",32234,6,1212,2,334,4,878,1986.25018,1.6061039999999593,1663.653163182501,4373.3158002222635
"114.39.227.110",8563,"147.32.84.191",29676,3,828,1,140,2,688,3661.636638,0.22081000000025597,5072.234047365163,24926.40731848023
"114.43.210.162",1038,"147.32.84.165",32234,6,1662,2,286,4,1376,2039.789615,42.822674000000234,53.429638700282645,257.0600799006606
"114.46.161.78",23785,"147.32.84.165",32234,3,831,1,143,2,688,3133.291978,0.06936399999995047,16492.705149657126,79349.51848226646
"114.47.35.248",61486,"147.32.84.192",31037,3,825,1,145,2,680,3584.440655,0.19685400000025766,5892.692045874007,27634.693732374653
"114.51.83.235",7600,"147.32.84.165",7600,141,130080,19,1892,122,128188,1865.102292,3.0274440000000595,4999.597019796139,338735.91055688553
"114.76.96.193",31804,"147.32.84.192",31037,3,825,1,145,2,680,3427.664669,0.0915540000000874,12670.118181607495,59418.48526546964
"114.76.106.149",13959,"147.32.84.191",29676,1,107,1,107,0,0,3354.294022,0,0,0
"114.77.155.145",24138,"147.32.84.192",31037,3,825,1,145,2,680,2137.369344,0.2346079999997528,4944.417922667693,23187.615085614012
"114.79.7.164",23776,"147.32.84.165",32234,3,825,1,145,2,680,414.314516,0.33995799999996734,3412.1862112381864,16001.976714772185
"114.79.49.126",4141,"147.32.84.191",29676,1,333,1,333,0,0,3152.921442,0,0,0
"114.79.50.61",24112,"147.32.84.192",7600,373,323158,77,7278,296,315880,2437.164046,22.21246199999996,2621.2312709865346,113766.76750195475
"114.79.53.45",13906,"147.32.84.165",7600,419,399268,55,5364,364,393904,1671.176295,12.336199999999963,3478.5428251811845,255445.9233799719
"114.79.53.152",58899,"147.32.84.165",7600,200,187938,26,2654,174,185284,603.664184,7.8806299999999965,2694.20084434874,188090.5460604039
"114.80.183.185",16006,"147.32.84.165",32234,3,831,1,143,2,688,2305.33401,0.20649700000012672,5540.032058573723,26654.14025383721
"114.94.233.187",46756,"147.32.84.191",7600,633,587920,97,9192,536,578728,3563.248227,39.00998699999991,1885.0557422641584,118683.04390873061
"114.94.233.187",46756,"147.32.84.192",7600,468,421857,86,8189,382,413668,3563.266475,38.33477500000026,1708.9444244814154,86327.46638006816
"114.94.233.187",46756,"147.32.84.165",7600,602,562953,90,8561,512,554392,3567.876396,32.96901099999968,2077.3446919593875,134524.38715859698
"114.112.45.181",1330,"147.32.84.191",7600,3,269,1,89,2,180,3235.78681,0.0011730000001080043,0,0
"114.129.236.16",59869,"147.32.84.165",32234,1,107,1,107,0,0,3651.274964,0,0,0
"114.143.118.30",18993,"147.32.84.165",32234,6,1650,2,290,4,1360,1847.15363,1757.1970199999998,1.320284506287178,6.191679063967455
"114.150.24.180",13579,"147.32.84.165",32234,3,828,1,140,2,688,2145.70601,0.16744500000004336,6688.763474572009,32870.4947893253
"114.156.7.65",39458,"147.32.84.165",32234,3,825,1,145,2,680,3336.041637,0.11916500000006636,9734.40187974115,45650.988125682634
"114.182.30.248",6881,"147.32.84.165",32234,1,107,1,107,0,0,3270.463375,0,0,0
"114.198.65.109",15269,"147.32.84.192",31037,3,825,1,145,2,680,2166.819175,0.01716600000008839,67575.43982255779,316905.51089199516
"114.233.137.21",9252,"147.32.84.191",29676,3,828,1,140,2,688,3582.670769,0.21898300000020754,5114.55227117602,25134.371161207873
"114.249.65.232",11935,"147.32.84.165",32234,1,143,1,143,0,0,1712.816328,0,0,0
"114.249.222.15",53953,"147.32.84.165",7600,1131,1129353,109,11089,1022,1118264,2041.26696,12.74134099999992,6962.532436734921,702132.6876032951
"114.249.222.15",59586,"147.32.84.191",7600,6,749,2,249,4,500,2050.928472,0.9753590000000258,2042.3249285647103,4101.054073423113
"114.249.222.15",60193,"147.32.84.192",7600,6,749,2,249,4,500,2051.923312,1.0981719999999768,1813.9235019651221,3642.416670612695
"114.252.138.238",45193,"147.32.84.165",32234,1,143,1,143,0,0,3397.583542,0,0,0
"114.255.217.93",11935,"147.32.84.165",32234,1,143,1,143,0,0,2930.821624,0,0,0
"115.60.113.225",14239,"147.32.84.165",32234,1,143,1,143,0,0,2758.489367,0,0,0
"115.63.146.146",16224,"147.32.84.191",7600,9,1018,3,338,6,680,1027.324122,5.427967000000081,498.16072942226066,1002.216852092122
"115.64.76.48",32531,"147.32.84.192",31037,7,1241,1,145,6,1096,688.120306,1960.543915,0.5916725410356339,4.472228310172792
"115.64.119.235",23547,"147.32.84.192",31037,3,828,1,140,2,688,2139.826585,0.1940309999999954,5772.273502687852,28366.601213208873
"115.64.139.45",7600,"147.32.84.192",7600,469,452254,57,5646,412,446608,2536.554645,11.277743999999984,4005.0563304150246,316806.6237360952
"115.69.253.252",46072,"147.32.84.192",31037,3,825,1,145,2,680,904.162554,0.12366599999995742,9380.104474959968,43989.45546877778
"115.73.50.184",7600,"147.32.84.192",7600,6,749,2,249,4,500,2559.540483,0.4410649999999805,4516.341128858758,9068.958090077827
"115.74.47.219",18428,"147.32.84.165",32234,3,825,1,145,2,680,2715.743732,0.3491910000002463,3321.964197242145,15578.866580170059
"115.75.96.90",22668,"147.32.84.191",7600,6,749,2,249,4,500,686.892386,0.5801450000000159,3433.6243525324626,6894.828017133459
"115.76.104.249",21712,"147.32.84.191",29676,1,143,1,143,0,0,2508.418796,0,0,0
"115.77.129.238",7600,"147.32.84.165",7600,6,749,2,249,4,500,2924.752693,0.4036140000002888,4935.408583445011,9910.459002901629
"115.87.147.35",12518,"147.32.84.192",31037,3,825,1,145,2,680,920.237766,0.24263700000005883,4780.804246671854,22420.32336370249
"115.87.152.254",30375,"147.32.84.165",32234,3,825,1,145,2,680,2428.407955,0.21734299999980067,5337.185922716922,25029.561568603494
"115.109.193.106",11236,"147.32.84.191",29676,3,825,1,145,2,680,3019.966348,0.266943000000083,4345.496978754413,20378.882383124146
"115.111.95.19",7600,"147.32.84.165",7600,6,749,2,249,4,500,2808.339289,0.17704700000012963,11251.249668158973,22592.87081959633
"115.118.17.118",56353,"147.32.84.191",29676,3,825,1,145,2,680,2907.674574,0.18718499999977212,6197.077757306473,29062.157758402773
"115.132.62.124",7600,"147.32.84.165",7600,761,710162,119,11232,642,698930,1469.679036,27.746280999999954,3238.48806980655,201520.34068998325
"115.132.99.185",7600,"147.32.84.165",7600,6,749,2,249,4,500,2575.716521,0.3634350000002087,5481.035123196325,11006.094624892217
"115.132.213.225",7600,"147.32.84.165",7600,6,538,2,178,4,360,428.313935,4.629718999999966,307.5780625130835,622.0679915994947
"115.133.12.116",7600,"147.32.84.165",7600,193,167209,37,3705,156,163504,353.290672,2583.481581,11.472890001610583,506.3059127728304
"115.133.28.169",20157,"147.32.84.191",29676,1,143,1,143,0,0,1183.118966,0,0,0
"115.133.36.97",7600,"147.32.84.192",7600,641,576606,121,11414,520,565192,2027.821194,56.732612999999674,1609.5151478392247,79699.061278916
"115.133.80.163",17359,"147.32.84.165",7600,6,749,2,249,4,500,920.889631,0.3648689999999988,5459.493681293852,10962.838717457535
"115.133.198.198",7600,"147.32.84.191",7600,15,1556,5,516,10,1040,2254.288596,13.99907600000006,294.8766047130527,594.324939731734
"115.133.202.243",7600,"147.32.84.165",7600,6,749,2,249,4,500,1829.181294,0.323509999999942,6157.460356713415,12364.37822633216
"115.133.214.212",7600,"147.32.84.192",7600,6,749,2,249,4,500,1428.408962,0.33640300000001844,5921.469190226873,11890.500381981674
"115.134.97.200",10016,"147.32.84.191",7600,1051,1015142,133,12946,918,1002196,2659.76506,15.016665999999987,6896.870450471502,533911.3222602146
"115.134.120.38",7600,"147.32.84.165",7600,6,749,2,249,4,500,2139.898994,0.3396099999999933,5865.551662200875,11778.216189158384
"115.134.120.38",7600,"147.32.84.191",7600,6,749,2,249,4,500,2542.138901,0.3580080000001544,5564.1214721434735,11172.934683019024
"115.134.121.208",7600,"147.32.84.192",7600,6,749,2,249,4,500,1447.441105,0.34879499999988184,5711.091042018019,11468.054301241002
"115.134.122.172",7600,"147.32.84.191",7600,6,749,2,249,4,500,1528.551919,2.024028000000044,984.1761082356355,1976.2572454530832
"115.134.228.187",19047,"147.32.84.165",32234,3,825,1,145,2,680,1524.95179,0.14349399999991874,8083.961698751564,37910.99279414526
"115.135.31.111",7600,"147.32.84.192",7600,349,312386,65,6322,284,306064,1018.832006,28.072426000000064,1801.6255524192986,87221.24692750083
"115.135.61.232",15114,"147.32.84.192",7600,9,807,3,267,6,540,749.510675,8.361001999999985,255.47177240239913,516.6844835104702
"115.135.62.229",7600,"147.32.84.191",7600,6,749,2,249,4,500,970.13932,0.4544429999999693,4383.388015659026,8801.9839671868
"115.135.75.4",7600,"147.32.84.165",7600,12,1076,4,356,8,720,321.904125,13.462531999999953,211.55010067942715,427.854136205583
"115.135.75.4",7600,"147.32.84.191",7600,6,749,2,249,4,500,2286.274295,0.3499159999996664,5692.794842196125,11431.314944168926
"115.135.107.41",7600,"147.32.84.165",7600,6,749,2,249,4,500,763.933777,0.3235210000000279,6157.2509976163155,12363.957826538786
"115.135.149.0",7600,"147.32.84.192",7600,6,749,2,249,4,500,2378.741755,0.3180419999998776,6263.323711964982,12576.9552449096
"115.135.190.126",7600,"147.32.84.191",7600,6,749,2,249,4,500,1207.046613,0.4763620000001083,4181.693753908891,8396.975409455605
"115.135.194.93",7600,"147.32.84.191",7600,100,88031,16,1567,84,86464,2167.023681,3.7393910000000687,3352.4175460655947,184979.85367135645
"115.138.197.2",51162,"147.32.84.165",32234,19,2525,3,429,16,2096,1365.805886,2395.8297119999997,1.4324891217477314,6.998827970124115
"115.162.132.17",14425,"147.32.84.165",32234,3,825,1,145,2,680,816.960769,0.14904599999999846,7782.832145780578,36498.799028488225
"115.163.9.101",7600,"147.32.84.192",7600,6,749,2,249,4,500,1904.725727,0.33720500000003995,5907.3857149204905,11862.220311085322
"115.166.28.94",14893,"147.32.84.192",31037,3,825,1,145,2,680,2141.065338,0.16852800000015122,6883.129212943601,32279.502515873435
"115.167.19.185",7600,"147.32.84.165",7600,174,163329,22,2201,152,161128,2940.937778,5.750305000000026,3062.0984452128923,224166.19640175506
"115.172.73.15",16224,"147.32.84.165",7600,3,269,1,89,2,180,1151.042273,0.015953999999965163,44628.30638094238,90259.49605134413
"115.173.197.186",38056,"147.32.84.165",7600,3,269,1,89,2,180,2905.033711,0.001419000000169035,0,0
"115.174.121.195",50979,"147.32.84.191",7600,3,269,1,89,2,180,2504.912632,0.005670999999892956,125551.04920004222,253923.47029222024
"115.178.101.186",22056,"147.32.84.165",32234,3,825,1,145,2,680,1245.788924,0.07265299999994568,15966.3055895953,74876.46759258486
"115.184.29.112",40880,"147.32.84.191",29676,3,825,1,145,2,680,2599.091319,0.08851499999991574,13105.123425420597,61458.50985714487
"115.184.102.18",61462,"147.32.84.165",32234,3,825,1,145,2,680,2791.144816,0.17110700000012002,6779.383660511763,31792.971649296545
"115.186.121.216",49545,"147.32.84.165",32234,3,825,1,145,2,680,1065.761198,0.0875260000000253,13253.204762009742,62152.9602632181
"115.194.122.57",16224,"147.32.84.165",7600,6,749,2,249,4,500,1507.107253,1.2943270000000666,1539.0237552024314,3090.4091469928344
"115.194.122.57",16224,"147.32.84.191",7600,6,749,2,249,4,500,1522.963048,1.2778240000000096,1558.9001302213646,3130.3215466292463
"115.194.122.57",16224,"147.32.84.192",7600,6,749,2,249,4,500,1553.918937,1.4273480000001655,1395.5951877186005,2802.399975338555
"115.198.41.209",17897,"147.32.84.191",7600,363,347915,45,4519,318,343396,1275.774125,26.9108040000001,1343.400962676547,102084.20380156572
"115.199.212.242",1861,"147.32.84.192",7600,328,300281,54,5197,274,295084,2660.078609,20.490463999999974,2029.0414116537356,115208.32324734096
"115.199.252.217",7389,"147.32.84.191",7600,80,72133,10,1041,70,71092,2089.734785,1.305732999999691,6378.026748195819,435568.3742389406
"115.204.229.79",16224,"147.32.84.191",7600,170,158929,22,2193,148,156736,649.525902,2.6432780000000093,6637.213338892065,474368.56811882654
"115.206.29.133",7600,"147.32.84.165",7600,4,356,4,356,0,0,27.493468,12.664048000000001,224.88859802173837,0
"115.206.196.144",7600,"147.32.84.192",7600,6,749,2,249,4,500,1284.566996,1.838799999999992,1083.315205568854,2175.331738090068
"115.206.239.231",7600,"147.32.84.192",7600,6,749,2,249,4,500,2389.472258,1.5265960000001542,1304.86389326305,2620.20862101014
"115.207.3.245",7600,"147.32.84.165",7600,8,929,2,249,6,680,2055.408758,0.6099100000001272,3266.055647553876,8919.348756372032
"115.208.160.70",16224,"147.32.84.165",7600,6,749,2,249,4,500,3770.795452,0.6903800000000047,2885.367478779783,5793.910599959404
"115.208.160.70",16224,"147.32.84.191",7600,4,356,4,356,0,0,3799.382033,13.128615999999965,216.93071074666267,0
"115.211.71.72",3697,"147.32.84.192",7600,915,817266,181,17102,734,800164,1300.740827,91.80583000000001,1490.2757264979793,69726.63936484206
"115.211.117.140",16224,"147.32.84.191",7600,6,749,2,249,4,500,1076.716012,0.6587369999999737,3023.9685944467665,6072.2260932665995
"115.212.20.237",7600,"147.32.84.165",7600,226,212393,30,2953,196,209440,2724.648409,10.173812999999882,2322.0399274097404,164689.482694445
"115.213.67.5",10496,"147.32.84.165",7600,18,1616,4,356,14,1260,275.605109,14.936779999999999,190.67027833308117,674.8442435384334
"115.213.164.244",7600,"147.32.84.165",7600,104,94465,14,1413,90,93052,2666.292332,1.4353660000001582,7875.343292232611,518624.5180671118
"115.214.9.14",7600,"147.32.84.192",7600,6,749,2,249,4,500,2695.357403,0.44373600000017177,4489.15571420671,9014.36890402954
"115.214.68.185",1055,"147.32.84.165",7600,6,749,2,249,4,500,1406.717186,0.49743999999986954,4004.503055645952,8041.170794469784
"115.215.251.18",8542,"147.32.84.165",7600,6,749,2,249,4,500,2253.565061,0.3774670000002516,5277.282517408601,10596.95284620201
"115.220.90.203",7600,"147.32.84.165",7600,6,749,2,249,4,500,3454.905717,0.7007169999997132,2842.8024437837466,5708.438642136037
"115.220.246.182",22387,"147.32.84.165",7600,6,749,2,249,4,500,884.790489,0.4455320000000711,4471.05931784851,8978.030758731948
"115.221.246.236",64860,"147.32.84.191",7600,6,749,2,249,4,500,2459.667037,0.7691169999998237,2589.983058494945,5200.76919376495
"115.222.176.196",29547,"147.32.84.192",7600,6,749,2,249,4,500,1969.816933,0.524248999999827,3799.721124886566,7629.962098165795
"115.223.200.216",7600,"147.32.84.192",7600,6,749,2,249,4,500,2487.907017,0.3283489999998892,6066.715598344055,12182.159836032239
"115.225.80.44",3394,"147.32.84.165",7600,130,121031,16,1627,114,119404,2486.313038,2.301252000000204,5656.0515754028,415092.30627498217
"115.227.83.90",7600,"147.32.84.191",7600,6,749,2,249,4,500,3228.177581,0.57181700000001,3483.6320011471594,6995.244982223211
"115.228.250.158",1534,"147.32.84.165",7600,7,909,3,409,4,500,1161.978061,0.6566599999998743,4982.791703470024,6091.432400330103
"115.229.201.144",16224,"147.32.84.165",7600,301,283706,41,3994,260,279712,558.999645,11.712640999999962,2727.992772936531,191049.6531055641
"115.231.87.8",7600,"147.32.84.191",7600,389,366268,55,5304,334,360964,2906.167589,12.775509000000056,3321.3549456228957,226034.98615984595
"115.234.114.70",24299,"147.32.84.192",7600,6,749,2,249,4,500,970.007033,0.42103400000007696,4731.209356013139,9500.42039360068
"115.241.157.193",23401,"147.32.84.165",32234,3,825,1,145,2,680,2212.321144,0.2498239999999896,4643.268861278533,21775.329832202777
"115.241.182.52",26692,"147.32.84.165",32234,12,3300,4,580,8,2720,1398.867488,1870.1150369999998,2.481130790458427,11.635647844908485
"115.242.249.60",27735,"147.32.84.191",29676,3,825,1,145,2,680,1480.917736,0.3193629999998393,3632.230408659061,17033.90812336663
"115.248.164.73",12662,"147.32.84.191",29676,3,825,1,145,2,680,2102.590434,0.17739799999981187,6538.968872260286,30665.509194048238
"115.248.189.1",18805,"147.32.84.165",32234,3,825,1,145,2,680,1015.3979,0.20414199999993343,5682.3191699913705,26648.11748685608
"116.10.154.11",11935,"147.32.84.165",32234,1,143,1,143,0,0,1014.560882,0,0,0
"116.10.194.114",23334,"147.32.84.192",7600,6,538,2,178,4,360,2730.623218,10.037053000000014,141.87431310764205,286.93681302669177
"116.10.194.114",23333,"147.32.84.191",7600,3,269,1,89,2,180,2730.628425,0.000311000000237982,0,0
"116.10.194.114",23330,"147.32.84.165",7600,3,269,1,89,2,180,2730.648832,0.00019800000018221908,0,0
"116.12.188.210",16881,"147.32.84.192",31037,3,828,1,140,2,688,1260.447605,0.237177999999858,4722.191771583665,23206.199563211154
"116.15.201.168",10016,"147.32.84.191",7600,6,749,2,249,4,500,2782.992699,0.4473840000000564,4452.550828817635,8940.8651181077
"116.22.149.73",11935,"147.32.84.165",32234,1,143,1,143,0,0,3081.564299,0,0,0
"116.39.144.45",21425,"147.32.84.191",29676,6,1302,2,296,4,1006,1329.364677,1402.1262590000001,1.688863598980639,5.739853988427442
"116.49.60.41",7600,"147.32.84.191",7600,6,749,2,249,4,500,448.394002,0.3507799999999861,5678.7730201268005,11403.158674953414
"116.49.234.90",8854,"147.32.84.165",32234,3,828,1,140,2,688,2620.627557,0.23772600000029342,4711.306293794611,23152.70521521923
"116.49.243.210",7600,"147.32.84.192",7600,6,749,2,249,4,500,1154.729053,1.2946779999999762,1538.6065106536425,3089.5713065334185
"116.55.230.151",16011,"147.32.84.165",32234,6,858,2,286,4,572,3311.285721,0.8503879999998389,2690.5365550788974,5381.073110157795
"116.63.133.82",46816,"147.32.84.191",7600,6,749,2,249,4,500,2073.428072,1.0117649999997411,1968.8366369665978,3953.4872228244935
"116.74.104.55",24040,"147.32.84.165",32234,1,107,1,107,0,0,2729.963864,0,0,0
"116.86.240.79",7600,"147.32.84.165",7600,84,74576,12,1288,72,73288,2498.909078,1.3649799999998322,7548.828554265459,429533.0334510924
"116.88.88.71",7600,"147.32.84.165",7600,3,269,1,89,2,180,1800.525903,0.00021500000002561137,0,0
"116.88.214.205",7600,"147.32.84.191",7600,69,59093,11,1177,58,57916,493.945069,1.2044270000000097,7817.825405773803,384687.4903999962
"116.90.239.3",27147,"147.32.84.191",29676,3,825,1,145,2,680,2855.965495,0.33888000000024476,3423.040604341248,16052.880075531371
"116.112.0.22",44402,"147.32.84.191",29676,3,321,3,321,0,0,3198.633032,93.41631899999993,27.48984361072932,0
"116.115.150.149",7600,"147.32.84.165",7600,1247,1236844,127,12852,1120,1223992,3412.791161,58.50820500000009,1757.291990072159,167360.04804796155
"116.115.150.149",7600,"147.32.84.192",7600,844,819001,102,10053,742,808948,3412.798312,59.34011600000031,1355.3057429142805,109059.17339291966
"116.115.150.149",7600,"147.32.84.191",7600,1021,998414,117,11590,904,986824,3415.823146,53.723373999999694,1725.8781996827029,146948.9239450978
"116.197.1.51",31923,"147.32.84.165",7600,948,904970,130,12574,818,892396,1414.623028,192.102707,523.6365565634637,37163.28682447978
"116.197.3.107",24956,"147.32.84.192",7600,276,257279,40,3919,236,253360,2231.378801,12.185073999999986,2572.983963823284,166341.21384900925
"116.197.222.97",47235,"147.32.84.165",32234,3,825,1,145,2,680,2196.538524,0.14822000000003754,7826.204290916922,36702.19943326557
"116.203.239.224",59625,"147.32.84.165",32234,3,825,1,145,2,680,2354.194768,0.04116599999997561,28178.593985344392,132147.88903471854
"116.203.249.222",30707,"147.32.84.165",32234,3,825,1,145,2,680,2953.638296,0.07834999999977299,14805.360561625539,69432.03573727839
"116.217.13.204",7600,"147.32.84.191",7600,6,749,2,249,4,500,3311.093085,0.7850889999999708,2537.2919503394824,5094.963755701772
"116.217.34.172",7600,"147.32.84.165",7600,12,1076,4,356,8,720,206.241148,14.169355999999993,200.99713776688236,406.51106514650365
"116.231.110.133",64460,"147.32.84.165",7600,4,570,2,250,2,320,162.152503,2.119905000000017,943.4385031404634,1207.6012840197932
"116.253.27.65",16944,"147.32.84.165",32234,1,143,1,143,0,0,3302.907557,0,0,0
"116.254.1.230",58207,"147.32.84.165",32234,3,825,1,145,2,680,3512.144019,0.030302000000119733,38281.30156410192,179526.10388682282
"117.7.44.25",60529,"147.32.84.165",7600,7,909,3,409,4,500,1497.760659,0.7331409999999323,4462.988702037264,5455.976408358514
"117.53.141.132",31116,"147.32.84.165",32234,7,1241,1,145,6,1096,1071.532383,2072.74064,0.5596455135843721,4.230148157851529
"117.57.65.37",29930,"147.32.84.165",7600,282,129414,104,112246,178,17168,164.711051,18.816035999999997,47723.548147973364,7299.3057623826835
"117.102.45.51",24998,"147.32.84.165",32234,3,825,1,145,2,680,3621.620948,0.15796299999965413,7343.4918303814175,34438.44444592665
"117.136.9.41",32101,"147.32.84.192",7600,453,418590,73,7118,380,411472,2360.203656,27.33468499999981,2083.214055695187,120424.87411140911
"117.192.2.164",31956,"147.32.84.192",31037,3,825,1,145,2,680,3279.537841,0.1451430000001892,7992.11811798356,37480.278070543594
"117.192.197.198",64778,"147.32.84.165",32234,6,1650,2,290,4,1360,1304.731608,907.037664,2.5577769171887446,11.9950917495748
"117.194.194.114",37807,"147.32.84.165",32234,3,825,1,145,2,680,1082.958552,0.17862900000000081,6493.906364588027,30454.181571861092
"117.194.202.32",20982,"147.32.84.165",32234,3,825,1,145,2,680,358.082202,0.26157999999998083,4434.589800443784,20796.696995184644
"117.195.161.116",61248,"147.32.84.165",32234,3,825,1,145,2,680,3434.272879,0.20474400000011883,5665.611690693387,26569.765170148297
"117.196.79.199",61499,"147.32.84.192",31037,9,2475,3,435,6,2040,1014.094916,2622.479822,1.3269882844498013,6.223117471902516
"117.196.174.67",10343,"147.32.84.192",31037,3,825,1,145,2,680,3313.111151,0.2142079999998714,5415.297281150548,25395.876904706016
"117.196.229.157",7600,"147.32.84.165",7600,119,109948,15,1524,104,108424,2892.953565,1.0335660000000644,11796.0536627552,839222.6524478804
"117.197.194.51",15843,"147.32.84.165",32234,21,4769,7,953,14,3816,493.461662,2572.071312,2.964147986267031,11.869033279742906
"117.198.114.122",29160,"147.32.84.165",32234,3,825,1,145,2,680,2028.620697,0.19432800000004136,5969.289037090657,27993.90720842515
"117.198.169.229",31519,"147.32.84.192",31037,3,825,1,145,2,680,846.061503,0.10282599999993636,11281.193472475035,52904.90731919327
"117.199.4.52",24378,"147.32.84.192",31037,3,825,1,145,2,680,3448.252197,0.015248000000156026,76075.5508911418,356768.1007308719
"117.200.59.187",7600,"147.32.84.165",7600,152,143197,18,1833,134,141364,1415.259854,1.2910640000000058,11358.073650880153,875953.477132036
"117.200.82.238",45062,"147.32.84.165",32234,3,825,1,145,2,680,3134.72557,0.28289300000005824,4100.49029138141,19229.885504409373
"117.200.138.0",52040,"147.32.84.165",32234,3,825,1,145,2,680,1277.361003,0.1677159999999276,6916.454005583849,32435.784302048396
"117.201.50.34",1026,"147.32.84.192",31037,3,825,1,145,2,680,1909.862155,0.082587999999987,14045.624061609224,65869.13353030532
"117.201.117.69",41262,"147.32.84.165",32234,3,825,1,145,2,680,874.912935,0.044616000000019085,25999.641384245646,121929.35269853131
"117.201.170.61",61917,"147.32.84.165",32234,3,825,1,145,2,680,2248.805794,0.12005300000009811,9662.399107053152,45313.319950318226
"117.201.185.15",31752,"147.32.84.165",32234,3,825,1,145,2,680,1995.597481,0.11983899999995629,9679.653535163203,45394.23726835157
"117.202.23.179",47032,"147.32.84.165",32234,3,825,1,145,2,680,2854.242418,0.12167700000009063,9533.436886175168,44708.53160413182
"117.203.242.68",62973,"147.32.84.165",32234,3,825,1,145,2,680,2624.905642,0.23129199999993943,5015.305328330871,23520.052574241327
"117.204.13.188",12793,"147.32.84.165",32234,1,143,1,143,0,0,1729.766644,0,0,0
"117.205.48.186",11962,"147.32.84.192",31037,3,825,1,145,2,680,2425.27111,0.23691099999996368,4896.353482954265,22962.209437302758
"117.207.9.45",38580,"147.32.84.165",32234,3,825,1,145,2,680,3244.029538,0.19780900000023394,5864.2427796441425,27501.276483848393
"117.211.89.98",63925,"147.32.84.192",31037,3,825,1,145,2,680,1241.801135,0.08506000000011227,13637.432400640359,63954.85539610651
"117.211.91.219",7600,"147.32.84.165",7600,6,749,2,249,4,500,1954.221561,1.5923279999999522,1250.998537989698,2512.045257007426
"117.213.63.55",56757,"147.32.84.165",32234,1,145,1,145,0,0,3822.562044,0,0,0
"117.215.22.46",13583,"147.32.84.192",31037,3,825,1,145,2,680,1700.347917,0.18302700000003824,6337.862719706697,29722.390685521063
"117.228.1.20",7600,"147.32.84.191",7600,140,130853,18,2665,122,128188,2308.192015,4.113307999999961,5183.176168670132,249313.6910729782
"117.242.19.151",28208,"147.32.84.192",31037,3,825,1,145,2,680,753.075384,0.2542640000000347,4562.1873328502725,21395.08542302197
"117.253.186.83",45364,"147.32.84.192",31037,3,825,1,145,2,680,1295.954308,0.20399799999995594,5686.3302581410135,26666.928107144064
"118.16.162.16",34553,"147.32.84.165",32234,12,2585,4,737,8,1848,233.992339,1815.7837060000002,3.247082777820675,8.141938905580199
"118.22.170.150",7600,"147.32.84.192",7600,317,301306,41,4026,276,297280,2708.30505,2.477556000000277,12999.907973824365,959913.7214253619
"118.26.18.135",11935,"147.32.84.165",32234,1,143,1,143,0,0,2930.820547,0,0,0
"118.32.66.148",57644,"147.32.84.165",32234,3,825,1,145,2,680,2609.536846,0.14266700000007404,8130.822124243154,38130.75203093341
"118.32.89.241",15350,"147.32.84.165",32234,3,825,1,145,2,680,969.535744,0.22019199999999728,5268.129632320949,24705.71137916031
"118.38.210.153",7600,"147.32.84.165",7600,6,749,2,249,4,500,485.410989,0.384488000000033,5180.9159193520445,10403.445621188845
"118.41.155.250",20904,"147.32.84.192",31037,3,825,1,145,2,680,2516.750867,0.17885200000000623,6485.809496119471,30416.210050767175
"118.45.219.114",59458,"147.32.84.165",32234,9,2475,3,435,6,2040,727.83691,2610.046565,1.333309545762836,6.252762007715368
"118.71.80.31",18042,"147.32.84.191",7600,6,749,2,249,4,500,2714.482378,0.36623099999997066,5439.190019414412,10922.068312077134
"118.71.104.75",20365,"147.32.84.165",32234,9,2484,3,444,6,2040,689.505828,2498.490552,1.4216583677519545,6.531943851833304
"118.71.107.214",10001,"147.32.84.191",29676,3,825,1,145,2,680,2591.333041,0.18549000000029991,6253.7063992566955,29327.7265620314
"118.71.246.183",27653,"147.32.84.165",32234,3,825,1,145,2,680,3007.945261,0.15446700000029523,7509.694627317051,35217.87825224548
"118.88.222.252",16001,"147.32.84.165",32234,108,18160,36,5242,72,12918,2867.730108,466.117483,89.96873434159517,221.7123445678608
"118.92.6.9",7600,"147.32.84.191",7600,540,527507,58,5849,482,521658,2320.595283,3.814104999999927,12268.146786730018,1094165.9970032498
"118.92.40.70",26999,"147.32.84.165",7600,529,524336,51,5260,478,519076,2835.224975,3.858959000000141,10904.495227857686,1076095.392565676
"118.93.118.144",50682,"147.32.84.165",32234,3,825,1,145,2,680,2830.737081,0.25033099999973274,4633.864763058664,21731.22785434408
"118.96.207.121",25217,"147.32.84.165",32234,9,1593,1,145,8,1448,1491.98858,2003.0028639999998,0.5791304749727009,5.783316743175661
"118.100.48.210",7600,"147.32.84.192",7600,6,749,2,249,4,500,1211.504427,0.34293400000001384,5808.697883557535,11664.05197501513
"118.100.51.36",7600,"147.32.84.191",7600,6,749,2,249,4,500,1301.145286,0.37121799999999894,5366.119099828149,10775.339557887848
"118.100.75.214",24777,"147.32.84.165",32234,3,828,1,140,2,688,2918.889901,0.03510899999992034,31900.65225448008,156768.9196505878
"118.100.161.4",10049,"147.32.84.165",7600,6,749,2,249,4,500,2346.536024,0.33514900000000125,5943.625074220698,11934.990108876902
"118.100.241.144",10022,"147.32.84.191",7600,6,749,2,249,4,500,2957.667594,0.35589100000015605,5597.219373345003,11239.39633201808
"118.101.128.208",7600,"147.32.84.165",7600,6,749,2,249,4,500,1419.543698,0.3498810000000958,5693.364315294213,11432.45846444621
"118.101.140.124",7600,"147.32.84.191",7600,1089,1016736,171,16416,918,1000320,3553.775084,265.15896599999996,495.280253883627,30180.235353610486
"118.101.146.169",7600,"147.32.84.165",7600,5,445,5,445,0,0,72.288639,12.055713999999995,295.2956581418572,0
"118.101.174.225",7600,"147.32.84.192",7600,6,749,2,249,4,500,2920.262117,0.4128209999998944,4825.33592041226,9689.429559060763
"118.101.240.24",7600,"147.32.84.165",7600,1995,1975850,209,20990,1786,1954860,3601.421541,21.28720599999997,7888.306243665807,734660.997784304
"118.120.0.104",11935,"147.32.84.192",31037,1,143,1,143,0,0,1665.966489,0,0,0
"118.132.238.126",49110,"147.32.84.192",7600,6,749,2,249,4,500,1433.157666,0.6031040000000303,3302.912930439692,6632.355282007414
"118.160.183.189",3054,"147.32.84.191",29676,3,828,1,140,2,688,3539.581411,0.02374699999973018,47163.85227661287,231776.64547364038
"118.160.236.166",7600,"147.32.84.192",7600,6,749,2,249,4,500,3401.633801,0.3421659999999065,5821.735648780254,11690.232226466374
"118.161.55.90",7600,"147.32.84.165",7600,6,749,2,249,4,500,2435.576428,0.3589620000002469,5549.333912778037,11143.240788710918
"118.170.34.216",7600,"147.32.84.192",7600,6,749,2,249,4,500,1025.983087,0.5056459999998424,3939.514996658969,7910.672684054154
"118.171.211.158",8750,"147.32.84.165",32234,3,828,1,140,2,688,2818.142556,0.26111600000012913,4289.281392176068,21078.75427012239
"118.172.74.65",7600,"147.32.84.165",7600,3,269,1,89,2,180,224.426045,0.0002340000000060627,0,0
"118.172.104.56",7600,"147.32.84.192",7600,520,489799,76,8055,444,481744,1131.863115,8.146565999999893,7910.081376619405,473076.87680920406
"118.172.110.109",27657,"147.32.84.192",31037,1,145,1,145,0,0,3805.473261,0,0,0
"118.172.186.3",22022,"147.32.84.165",7600,23,2065,5,445,18,1620,413.621257,12.373001999999985,287.7232218987764,1047.441841519141
"118.172.221.199",16918,"147.32.84.165",32234,3,825,1,145,2,680,1259.901318,0.17766200000005483,6529.252175477266,30619.94123672097
"118.173.7.146",21575,"147.32.84.165",32234,3,825,1,145,2,680,1697.734328,0.0427190000000337,27154.193684287668,127343.80486424561
"118.173.86.33",25398,"147.32.84.191",29676,3,825,1,145,2,680,2277.151248,0.2638809999998557,4395.920888584757,20615.353132673343
"118.173.229.10",25781,"147.32.84.192",31037,6,1122,2,244,4,878,2288.145311,102.12951499999963,19.112986094176666,68.77541717494718
"118.173.239.189",63889,"147.32.84.165",32234,3,825,1,145,2,680,1954.10773,0.11529700000005505,10060.972965466977,47182.49390701755
"118.174.101.47",10135,"147.32.84.192",31037,3,828,1,140,2,688,2308.283461,0.17826100000002043,6282.922232007403,30876.074968722092
"118.175.177.179",7600,"147.32.84.191",7600,6,749,2,249,4,500,2921.043702,1.8622669999999744,1069.6640170287221,2147.9197129090808
"118.186.130.148",59965,"147.32.84.191",7600,6,749,2,249,4,500,1431.399427,2.434819999999945,818.1302929990902,1642.8319136527916
"118.186.130.188",7600,"147.32.84.191",7600,6,749,2,249,4,500,2428.555514,0.8331719999996494,2390.8628710528415,4800.929459945465
"118.186.202.64",15264,"147.32.84.192",7600,3,269,1,89,2,180,835.283008,0.0006750000000010914,0,0
"118.220.115.42",62279,"147.32.84.165",32234,3,825,1,145,2,680,2258.829101,0.18134600000030332,6396.6120013568525,29997.90455808731
"118.220.225.58",51886,"147.32.84.165",32234,1,143,1,143,0,0,1664.992588,0,0,0
"118.231.114.122",7600,"147.32.84.191",7600,161,148012,23,2256,138,145756,1036.099244,2.7899199999999382,6469.002695417933,417950.3354935001
"118.232.105.113",7600,"147.32.84.165",7600,6,749,2,249,4,500,3235.657064,0.3264560000002348,6101.894282839241,12252.799764737432
"118.232.198.4",7600,"147.32.84.165",7600,8,718,2,178,6,540,390.454506,4.800080000000037,296.661722304626,899.985000249989
"118.251.14.225",52647,"147.32.84.165",7600,6,749,2,249,4,500,2666.904287,0.6182520000002114,3221.9871508694173,6469.853716605255
"118.251.14.225",52655,"147.32.84.191",7600,6,749,2,249,4,500,2667.466187,0.6823279999998704,2919.4170545549623,5862.283242078238
"118.251.14.225",52683,"147.32.84.192",7600,6,749,2,249,4,500,2667.902587,0.6425199999998767,3100.29259789638,6225.487144370241
"119.15.202.11",7600,"147.32.84.191",7600,6,749,2,249,4,500,3362.268657,0.521603000000141,3818.9964398200573,7668.6675498394725
"119.33.96.69",7600,"147.32.84.165",7600,13,1167,3,267,10,900,236.161878,8.870805999999988,240.7898448010252,811.6511622506467
"119.33.173.83",5601,"147.32.84.191",29676,1,143,1,143,0,0,3370.509418,0,0,0
"119.33.221.200",7600,"147.32.84.192",7600,277,249426,49,4850,228,244576,2984.309291,8.632207999999991,4494.7943793754785,226663.67631549216
"119.63.112.19",19762,"147.32.84.165",32234,6,1650,2,290,4,1360,1844.056441,820.140795,2.8287825872629586,13.266014891991807
"119.68.137.109",39287,"147.32.84.192",31037,3,825,1,145,2,680,1328.280457,0.25030999999989945,4634.253525630083,21733.051016747973
"119.71.64.165",55970,"147.32.84.191",29676,12,2074,4,704,8,1370,1675.194243,1389.3614200000002,4.053660853775542,7.888516150102972
"119.71.64.165",21971,"147.32.84.191",29676,6,844,2,352,4,492,2536.608902,31.953743999999915,88.12738813955596,123.17805387687936
"119.73.42.148",10026,"147.32.84.165",32234,3,825,1,145,2,680,1624.323561,0.13633800000002338,8508.266220714702,39900.83469024826
"119.93.89.130",12735,"147.32.84.165",32234,3,825,1,145,2,680,3142.191416,0.2676659999997355,4333.759237262657,20323.836423024874
"119.135.157.76",16881,"147.32.84.192",31037,3,828,1,140,2,688,1931.104404,0.2018239999999878,5549.3895671479495,27271.285872841352
"119.152.68.96",14773,"147.32.84.165",32234,3,825,1,145,2,680,1078.237276,0.10614099999997961,10928.85878218806,51252.57911646814
"119.153.32.141",21318,"147.32.84.165",32234,3,825,1,145,2,680,1184.542816,0.206670000000031,5612.812696568569,26322.156094252598
"119.153.54.100",10166,"147.32.84.192",31037,3,825,1,145,2,680,3335.834157,0.2564790000001267,4522.787440684918,21210.313514936166
"119.153.93.229",10038,"147.32.84.165",32234,3,825,1,145,2,680,1852.731709,0.2572850000001381,4508.618846801708,21143.86769534594
"119.153.95.222",34535,"147.32.84.192",31037,3,825,1,145,2,680,1848.587557,0.22427300000003925,5172.267727277903,24256.15210033775
"119.154.49.164",23522,"147.32.84.191",29676,6,1147,2,259,4,888,1825.931724,754.706792,2.7454370650476405,9.412927080163339
"119.154.69.201",47731,"147.32.84.165",32234,3,825,1,145,2,680,1808.829893,0.026193999999804873,44284.95075241052,207681.1483561321
"119.154.181.53",62413,"147.32.84.165",32234,3,825,1,145,2,680,1947.201436,0.21586299999989933,5373.778739295483,25201.169260144336
"119.155.125.155",10289,"147.32.84.192",31037,3,825,1,145,2,680,3559.270185,0.1748240000001715,6635.244588837128,31117.009106270667
"119.171.41.50",12774,"147.32.84.191",29676,3,825,1,145,2,680,2183.238167,0.15976099999988946,7260.845888551039,34050.863477342806
"119.178.202.242",33729,"147.32.84.191",29676,1,143,1,143,0,0,3109.54357,0,0,0
"119.195.107.225",53650,"147.32.84.165",32234,1,107,1,107,0,0,2959.244209,0,0,0
"119.196.103.51",58023,"147.32.84.165",32234,3,825,1,145,2,680,1097.433027,0.23593299999993178,4916.650065909964,23057.393412543275
"119.207.223.3",32895,"147.32.84.191",29676,1,143,1,143,0,0,2987.283763,0,0,0
"119.234.130.232",7600,"147.32.84.165",7600,102,90102,14,1486,88,88616,190.580424,3.2798990000000003,3624.501852038736,216143.2409961404
"119.237.59.89",7600,"147.32.84.165",7600,7,909,3,409,4,500,1514.481262,0.7838150000000041,4174.454431211425,5103.245025930837
"119.246.67.242",7600,"147.32.84.192",7600,6,749,2,249,4,500,2307.862453,0.35555099999965023,5602.57178295648,11250.144142482892
"119.246.226.144",7600,"147.32.84.165",7600,9,807,3,267,6,540,187.654316,9.199005999999997,232.19900063115523,469.6159563326735
"119.246.246.121",61279,"147.32.84.165",7600,12,1076,4,356,8,720,3382.269004,12.09439199999997,235.48103947680931,476.2537877059065
"119.248.30.125",16881,"147.32.84.192",31037,3,828,1,140,2,688,2139.061984,0.15688200000022334,7139.123672559029,35083.6934765758
"119.249.170.168",8080,"147.32.84.192",31037,9,2460,3,420,6,2040,2230.302334,1094.3018809999999,3.070450721449505,14.913617789897597
"120.3.6.2",16001,"147.32.84.192",31037,12,2874,4,620,8,2254,3458.498268,26.213404999999966,189.21616630880294,687.8923207420029
"120.17.59.129",50468,"147.32.84.191",29676,3,825,1,145,2,680,2156.972778,0.1977540000002591,5865.873762343518,27508.925230300636
"120.51.16.84",7600,"147.32.84.191",7600,6,749,2,249,4,500,2698.328168,0.3052699999998367,6525.370983067663,13103.154584473219
"120.59.39.213",26590,"147.32.84.191",29676,3,825,1,145,2,680,2717.323164,0.09916800000019066,11697.321716660312,54856.405291924224
"120.60.166.128",25383,"147.32.84.165",32234,3,825,1,145,2,680,954.563331,0.181707000000074,6383.903757144895,29938.307274886407
"120.63.250.238",50773,"147.32.84.165",32234,3,825,1,145,2,680,1175.50232,0.13435899999990397,8633.58613863477,40488.54189152858
"120.68.59.31",2144,"147.32.84.165",32234,1,143,1,143,0,0,3485.460536,0,0,0
"120.69.3.185",7600,"147.32.84.191",7600,530,495943,80,7611,450,488332,1139.481535,53.76727800000003,1132.4359771383622,72658.61589645653
"120.69.3.185",7600,"147.32.84.192",7600,351,314414,65,6154,286,308260,1139.504349,54.36307399999987,905.6147192853759,45363.14484350178
"120.69.33.50",11935,"147.32.84.191",29676,1,143,1,143,0,0,2517.994821,0,0,0
"120.140.236.249",7600,"147.32.84.191",7600,1784,1741099,212,20811,1572,1720288,1542.570285,368.4184109999999,451.8992401821093,37355.09298421029
"120.144.177.193",49444,"147.32.84.191",29676,3,825,1,145,2,680,3052.507824,0.1580300000000534,7340.378409160337,34423.843573993305
"120.204.161.229",7600,"147.32.84.192",7600,6,749,2,249,4,500,1921.864623,0.9035229999999501,2204.7031453544737,4427.114749707778
"121.1.89.24",52664,"147.32.84.165",32234,1,143,1,143,0,0,2938.981858,0,0,0
"121.2.99.44",65535,"147.32.84.191",29676,6,1212,2,334,4,878,2499.534797,12.256328000000394,218.00983132957228,573.0917122974984
"121.6.230.167",6881,"147.32.84.165",32234,1,143,1,143,0,0,337.657999,0,0,0
"121.7.69.114",45582,"147.32.84.192",31037,3,825,1,145,2,680,3615.533598,0.10852500000009968,10688.781386767423,50126.69891725412
"121.10.120.182",14646,"147.32.84.165",32234,6,1662,2,286,4,1376,2008.103312,13.616187999999966,168.0352827090817,808.4494720548826
"121.13.198.13",43748,"147.32.84.191",29676,1,143,1,143,0,0,2184.33336,0,0,0
"121.18.214.196",9180,"147.32.84.165",7600,6,538,2,178,4,360,302.668967,3.986541999999986,357.2018054745203,722.4306178136366
"121.19.108.88",7600,"147.32.84.165",7600,1076,1057911,116,11615,960,1046296,551.286474,17.56339700000001,5290.54829199613,476580.2424212125
"121.19.108.88",7600,"147.32.84.191",7600,11,1198,3,338,8,860,561.009259,5.322018999999955,508.0778554154021,1292.7424723587155
"121.54.17.8",64361,"147.32.84.165",32234,3,825,1,145,2,680,3074.335868,0.22757099999989805,5097.31028997772,23904.627566792064
"121.54.23.50",17655,"147.32.84.192",31037,3,825,1,145,2,680,1714.363583,0.18718399999988833,6197.110864180122,29062.313018224024
"121.54.32.133",29146,"147.32.84.165",32234,3,825,1,145,2,680,1212.3086,0.14638300000001436,7924.417452845523,37162.78529610314
"121.54.32.148",51216,"147.32.84.165",32234,3,825,1,145,2,680,969.567813,0.18825500000002648,6161.854930811064,28896.97484794154
"121.54.32.151",50630,"147.32.84.192",31037,3,825,1,145,2,680,1505.508172,0.1209519999999884,9590.581387658833,44976.5196110897
"121.54.40.35",13656,"147.32.84.192",31037,3,825,1,145,2,680,2454.134502,0.1760070000000269,6590.6469629038775,30907.861619135427
"121.54.45.50",7600,"147.32.84.192",7600,209,199986,25,3722,184,196264,2827.550196,2.3223909999996977,12821.269114461724,676075.6478991713
"121.54.47.23",25460,"147.32.84.191",29676,3,825,1,145,2,680,2446.768591,0.23169999999981883,5006.4738886530295,23478.636167476277
"121.54.58.148",52419,"147.32.84.192",31037,3,825,1,145,2,680,2961.026782,0.15913499999987835,7289.408363973273,34184.811637943625
"121.54.75.150",27086,"147.32.84.191",29676,3,825,1,145,2,680,2927.470186,0.13890200000014374,8351.211645612011,39164.30288976667
"121.55.248.126",24847,"147.32.84.165",32234,3,506,1,148,2,358,1274.235309,0.26635699999997087,4445.161944308314,10752.486324745785
"121.58.93.47",1156,"147.32.84.165",7600,2,178,2,178,0,0,3817.054781,4.691471999999976,303.52946793671737,0
"121.58.93.47",1156,"147.32.84.191",7600,1,89,1,89,0,0,3820.818935,0,0,0
"121.58.93.47",1156,"147.32.84.192",7600,1,89,1,89,0,0,3821.214954,0,0,0
"121.77.162.184",62127,"147.32.84.165",7600,12,1076,4,356,8,720,2044.162846,13.664123000000245,208.42903712151514,421.5418728300306
"121.77.218.46",15380,"147.32.84.165",7600,6,749,2,249,4,500,1646.164318,0.5872099999999136,3392.3128012130123,6811.873094805245
"121.105.32.217",37252,"147.32.84.192",31037,3,825,1,145,2,680,2931.265269,0.12609299999985524,9199.55905562824,43142.75970915313
"121.112.249.199",50729,"147.32.84.165",32234,3,825,1,145,2,680,1170.191819,0.1861830000000282,6230.429201376196,29218.56453059182
"121.113.15.226",28906,"147.32.84.191",29676,6,1650,2,290,4,1360,2347.179109,846.0591289999998,2.7421251310675245,12.859621304316667
"121.113.200.247",9218,"147.32.84.165",4041,1,140,1,140,0,0,783.320735,0,0,0
"121.128.167.137",29208,"147.32.84.192",31037,3,825,1,145,2,680,2498.470458,0.15612900000041918,7429.753601168813,34842.98240548133
"121.129.66.241",59749,"147.32.84.191",29676,12,2074,4,704,8,1370,1643.651323,1447.8645499999998,3.8898666315160497,7.56976887099004
"121.138.149.152",6881,"147.32.84.165",32234,1,143,1,143,0,0,3172.148933,0,0,0
"121.145.105.2",50958,"147.32.84.192",31037,1,143,1,143,0,0,790.150459,0,0,0
"121.157.71.211",57460,"147.32.84.191",29676,3,825,1,145,2,680,2225.028744,0.2528159999997115,4588.317195119469,21517.625466767167
"121.164.3.161",58208,"147.32.84.165",32234,1,143,1,143,0,0,748.976473,0,0,0
"121.168.6.192",55389,"147.32.84.165",32234,29,3853,3,429,26,3424,403.913734,3371.6973500000004,1.017884953404848,8.124098089646154
"121.169.48.123",31576,"147.32.84.165",32234,3,825,1,145,2,680,2610.660484,0.24023500000021158,4828.605323949376,22644.49393300397
"121.169.176.226",19153,"147.32.84.192",31037,3,825,1,145,2,680,3362.624175,0.08329200000025594,13926.907746199342,65312.394947693465
"121.171.159.19",29952,"147.32.84.191",29676,3,825,1,145,2,680,2893.824389,0.13301000000001295,8721.14878580473,40899.18051273942
"121.203.188.30",41533,"147.32.84.192",31037,3,825,1,145,2,680,738.341468,0.352636000000075,3289.510997174858,15426.672262613129
"121.208.136.73",32931,"147.32.84.191",29676,3,825,1,145,2,680,2414.616351,0.15685499999972308,7395.365146167148,34681.71240961145
"121.213.193.5",43254,"147.32.84.191",29676,3,825,1,145,2,680,3647.783196,0.17841600000019753,6501.659044024727,30490.53896508148
"121.219.102.135",27865,"147.32.84.192",31037,3,825,1,145,2,680,1647.356404,0.12147299999992356,9549.447202264948,44783.614465794235
"121.219.138.212",18064,"147.32.84.165",32234,3,825,1,145,2,680,1710.620497,0.17388200000004872,6671.19080755728,31285.58447682035
"121.220.100.194",40783,"147.32.84.192",31037,6,1650,2,290,4,1360,2116.55764,858.1341809999999,2.703539902461944,12.678669887407738
"121.229.141.129",11935,"147.32.84.191",29676,1,143,1,143,0,0,3707.28238,0,0,0
"121.230.189.119",7600,"147.32.84.165",7600,2,178,2,178,0,0,108.128694,4.523986000000008,314.7666681550291,0
"121.237.200.75",11935,"147.32.84.192",31037,1,143,1,143,0,0,2904.163425,0,0,0
"121.245.9.144",57424,"147.32.84.191",29676,3,825,1,145,2,680,3608.421499,0.2717240000001766,4269.037700016363,20020.31473111122
"122.2.48.58",10399,"147.32.84.192",31037,3,828,1,140,2,688,2454.680875,0.03572500000018408,31350.59482139199,154065.78026512635
"122.17.43.176",25892,"147.32.84.192",31037,3,831,1,143,2,688,2256.340001,0.17440499999975145,6559.444970050345,31558.728247514944
"122.18.210.66",7600,"147.32.84.191",7600,522,513585,54,5489,468,508096,2233.669841,3.800372000000152,11554.658333446894,1069571.08409383
"122.32.37.142",23923,"147.32.84.165",32234,3,825,1,145,2,680,1236.768913,0.19044499999995423,6090.997400825849,28564.67746594191
"122.32.93.12",40424,"147.32.84.192",31037,3,825,1,145,2,680,3739.335831,0.24002800000016578,4832.76951022047,22664.022530689097
"122.38.42.11",59552,"147.32.84.165",32234,1,107,1,107,0,0,2677.88816,0,0,0
"122.52.165.154",49282,"147.32.84.165",32234,3,825,1,145,2,680,1506.858363,0.022555000000011205,51429.83817332848,241188.2066059542
"122.52.253.3",13144,"147.32.84.165",7600,7,838,3,338,4,500,1794.69828,0.44016499999997905,6143.150863880883,9087.5012779303
"122.55.45.34",63770,"147.32.84.165",32234,3,825,1,145,2,680,3403.846983,0.2533120000002782,4579.332996457831,21475.49267304362
"122.57.76.92",59856,"147.32.84.165",32234,3,825,1,145,2,680,2969.200135,0.1800029999999424,6444.337038829192,30221.718526923112
"122.57.251.215",11759,"147.32.84.165",32234,6,1650,2,290,4,1360,2691.56218,964.93262,2.404312956069409,11.275398690532402
"122.59.89.145",19398,"147.32.84.165",32234,3,825,1,145,2,680,929.362753,0.1356630000000223,8550.599647654919,40099.36386486445
"122.61.124.29",58938,"147.32.84.165",32234,3,825,1,145,2,680,3456.304088,0.05096000000003187,22762.95133436567,106750.39246461142
"122.66.135.35",7600,"147.32.84.192",7600,6,749,2,249,4,500,3147.521013,0.9785569999999097,2035.650452656497,4087.651511358428
"122.71.225.201",7600,"147.32.84.165",7600,18,1825,6,605,12,1220,664.383357,1241.9820570000002,3.896996718045178,7.858406604983665
"122.71.226.168",7600,"147.32.84.165",7600,6,749,2,249,4,500,1176.945636,0.4402589999999691,4524.609377662103,9085.560999321493
"122.76.36.46",7600,"147.32.84.165",7600,3,269,1,89,2,180,254.706164,0.00019000000000346517,0,0
"122.76.100.240",1107,"147.32.84.191",7600,6,749,2,249,4,500,968.841226,0.6959229999999934,2862.3856374915313,5747.762324280183
"122.81.10.98",7600,"147.32.84.191",7600,9,1018,3,338,6,680,1511.03658,4.451792000000069,607.3958531755209,1221.979822956669
"122.82.194.37",7600,"147.32.84.192",7600,9,1018,3,338,6,680,740.137572,4.567592999999988,591.9967037343316,1190.9992856193655
"122.94.37.84",7600,"147.32.84.192",7600,6,749,2,249,4,500,1626.035501,0.6585249999998268,3024.942105463762,6074.1809346661885
"122.94.39.213",7600,"147.32.84.165",7600,12,1076,4,356,8,720,759.126846,14.172766000000024,200.9487773946169,406.4132576520342
"122.96.190.140",32862,"147.32.84.165",7600,305,292174,37,3678,268,288496,1716.195186,4.219385000000102,6973.5281326542345,546991.5639364372
"122.96.221.50",39715,"147.32.84.191",7600,710,700079,70,7159,640,692920,3587.110801,13.44088099999999,4261.030210742885,412425.34622544487
"122.96.221.50",39715,"147.32.84.165",7600,969,967656,91,9380,878,958276,3587.14163,13.1632639999998,5700.713743946877,582394.153911987
"122.96.221.50",39715,"147.32.84.192",7600,717,708906,73,7562,644,701344,3587.311546,13.888594000000012,4355.804482440767,403982.7213611396
"122.100.163.117",7600,"147.32.84.165",7600,3,269,1,89,2,180,516.777143,0.00020599999993464735,0,0
"122.102.127.149",16533,"147.32.84.192",31037,3,825,1,145,2,680,3731.516625,0.21727799999962372,5338.782573486542,25037.049310143782
"122.111.164.23",43559,"147.32.84.165",32234,3,825,1,145,2,680,1081.946435,0.1488609999998971,7792.504416877502,36544.1586446669
"122.117.53.231",28728,"147.32.84.191",29676,3,825,1,145,2,680,1361.181471,0.19469699999990553,5957.975726387992,27940.85168237127
"122.140.51.217",16224,"147.32.84.165",7600,1267,1218164,167,16132,1100,1202032,2390.450448,54.238398999999845,2379.421265734639,177296.0886990788
"122.140.51.217",16224,"147.32.84.191",7600,1072,1033157,138,13393,934,1019764,2391.063815,53.515817999999854,2002.0996408949648,152443.0029267239
"122.140.51.217",16224,"147.32.84.192",7600,685,629134,113,10878,572,618256,2391.47048,52.60953400000017,1654.1488468610978,94014.29026153291
"122.148.188.87",24274,"147.32.84.191",29676,3,825,1,145,2,680,3672.252058,0.30275399999982255,3831.493555826446,17968.383572151608
"122.148.209.25",63182,"147.32.84.192",31037,3,825,1,145,2,680,2460.776198,0.18010499999991225,6440.687376811111,30204.602870562452
"122.151.249.179",16090,"147.32.84.191",29676,3,825,1,145,2,680,3358.216789,0.10957999999982349,10585.873334567152,49644.095637970095
"122.161.216.145",62522,"147.32.84.191",29676,3,825,1,145,2,680,2361.05657,0.1218829999997979,9517.32399105637,44632.96768219538
"122.162.113.34",21272,"147.32.84.192",31037,3,825,1,145,2,680,2380.180773,0.2336219999997411,4965.285803568523,23285.4782512179
"122.162.137.201",11821,"147.32.84.191",29676,3,825,1,145,2,680,3099.230762,0.11811999999963518,9820.521503586036,46054.85946509314
"122.163.41.130",57477,"147.32.84.165",32234,3,825,1,145,2,680,485.476109,0.0362259999999992,32021.200242920153,150168.3873461083
"122.163.120.188",23136,"147.32.84.192",31037,3,825,1,145,2,680,1580.11302,0.14162400000009256,8190.702140874723,38411.56866065387
"122.164.34.224",33814,"147.32.84.191",29676,3,825,1,145,2,680,3430.36289,0.0913180000002285,12702.86252433362,59572.044941702494
"122.164.162.86",14384,"147.32.84.191",29676,3,825,1,145,2,680,1782.913756,0.21271500000011656,5453.306066800011,25574.12500292419
"122.164.236.91",45825,"147.32.84.165",32234,12,3300,4,580,8,2720,1092.745979,2590.092753,1.791441636453241,8.401243536470371
"122.164.238.149",12146,"147.32.84.165",32234,3,825,1,145,2,680,3554.539994,0.2680319999999483,4327.8414517677875,20296.084049669626
"122.167.108.5",11484,"147.32.84.191",29676,3,825,1,145,2,680,1714.167113,0.2693460000000414,4306.728148923027,20197.069939776957
"122.167.231.12",10078,"147.32.84.165",32234,3,825,1,145,2,680,1949.734297,0.14668800000004012,7907.940663174102,37085.51483419579
"122.168.171.248",36838,"147.32.84.192",31037,3,825,1,145,2,680,2479.420881,0.09013499999991836,12869.584512132364,60353.91357413798
"122.168.178.118",64118,"147.32.84.165",32234,3,825,1,145,2,680,3056.574599,0.17087799999990239,6788.468966166872,31835.578599954984
"122.168.234.164",21353,"147.32.84.165",32234,1,140,1,140,0,0,3821.397126,0,0,0
"122.169.2.87",12299,"147.32.84.165",32234,1,333,1,333,0,0,2201.511025,0,0,0
"122.169.84.14",62517,"147.32.84.191",29676,3,825,1,145,2,680,2313.784932,0.2947509999999056,3935.5252399495557,18456.25629769447
"122.169.143.56",10346,"147.32.84.165",32234,3,825,1,145,2,680,1178.404142,0.262311999999838,4422.21476715025,20738.662356290828
"122.169.157.198",57444,"147.32.84.192",31037,3,825,1,145,2,680,3027.718169,0.12554499999987456,9239.714843292517,43331.07650647525
"122.170.46.221",16711,"147.32.84.165",32234,3,825,1,145,2,680,3583.571432,0.2134779999996681,5433.815194079968,25482.719530857783
"122.170.76.172",18099,"147.32.84.191",29676,3,825,1,145,2,680,2436.259036,0.2555769999999029,4538.7495744939515,21285.170418316462
"122.170.97.3",20923,"147.32.84.192",31037,3,825,1,145,2,680,3162.386344,0.031164999999873544,37221.2417777862,174554.78902685942
"122.172.90.95",34018,"147.32.84.192",31037,3,825,1,145,2,680,3446.542345,0.12057800000002317,9620.328749853017,45116.024482069326
"122.172.248.185",27078,"147.32.84.165",32234,3,825,1,145,2,680,3771.22914,0.3123359999999593,3713.9490804779184,17417.14051534472
"122.173.21.176",13019,"147.32.84.191",29676,1,333,1,333,0,0,3506.413574,0,0,0
"122.173.38.176",24784,"147.32.84.165",32234,3,825,1,145,2,680,1017.378369,0.04877699999997276,23781.70039159128,111527.97425022117
"122.173.191.113",10069,"147.32.84.165",32234,3,825,1,145,2,680,3206.56434,0.29832900000019436,3888.3246348804314,18234.90173599099
"122.174.84.192",30625,"147.32.84.165",32234,3,825,1,145,2,680,3039.724549,0.14607799999976123,7940.96304715218,37240.378428024014
"122.175.8.55",54931,"147.32.84.192",31037,3,825,1,145,2,680,963.644884,0.1048999999999296,11058.150619645172,51858.91325074977
"122.176.30.67",15509,"147.32.84.191",29676,3,825,1,145,2,680,2125.91527,0.23011700000006385,5040.913969848721,23640.148272394003
"122.176.137.148",21465,"147.32.84.192",31037,3,825,1,145,2,680,2926.543079,0.21406900000010864,5418.813560111045,25412.367040520763
"122.176.242.212",15866,"147.32.84.192",31037,3,825,1,145,2,680,1115.149053,0.20525199999997312,5651.5892658787825,26504.004833086707
"122.177.159.134",10023,"147.32.84.191",29676,3,825,1,145,2,680,2452.665465,0.18291899999985617,6341.604754021791,29739.939536102196
"122.178.113.250",25402,"147.32.84.191",29676,3,825,1,145,2,680,3451.291402,0.30152700000007826,3847.085003995327,18041.50208770222
"122.180.141.22",26968,"147.32.84.191",29676,1,143,1,143,0,0,3809.582417,0,0,0
"122.183.204.52",37153,"147.32.84.191",29676,3,825,1,145,2,680,3268.909407,0.2351929999999811,4932.119578389209,23129.94009175629
"122.193.221.154",44121,"147.32.84.192",7600,12,1287,4,427,8,860,2415.004925,20.65084399999978,165.41696794571865,333.1582960967636
"122.194.10.129",49009,"147.32.84.165",7600,373,358607,47,4551,326,354056,1405.84978,10.581061999999974,3440.864442529501,267690.33202905406
"122.195.3.179",11935,"147.32.84.192",31037,1,107,1,107,0,0,1891.253301,0,0,0
"122.195.167.123",39533,"147.32.84.165",7600,1263,1228002,153,14990,1110,1213012,1673.298247,51.406686000000036,2332.7704882590547,188771.0870916673
"122.195.167.123",39533,"147.32.84.191",7600,1475,1440862,173,17034,1302,1423828,1685.739909,38.996282000000065,3494.4869872466247,292095.12845352746
"122.200.86.233",58710,"147.32.84.191",7600,3,269,1,89,2,180,2279.979578,0.0002909999998337298,0,0
"122.201.18.130",13139,"147.32.84.165",32234,3,825,1,145,2,680,3002.877528,0.15754900000001726,7362.788719699096,34528.94020272679
"122.236.110.237",11935,"147.32.84.192",31037,1,143,1,143,0,0,2795.048567,0,0,0
"122.238.250.84",7600,"147.32.84.165",7600,784,742799,112,10711,672,732088,3741.708731,18.540301999999883,4621.715439155228,315890.4315582366
"122.238.250.84",7600,"147.32.84.192",7600,491,456186,77,7382,414,448804,3742.117437,18.16613499999994,3250.8841313796356,197644.24298289162
"122.238.250.84",7600,"147.32.84.191",7600,75,69453,9,877,66,68576,3746.940782,9.413626999999906,745.302527920436,58278.068591415984
"122.243.226.65",48942,"147.32.84.192",31037,3,828,1,140,2,688,743.355976,0.2084229999999252,5373.6871650460935,26407.83406822652
"123.3.119.231",40678,"147.32.84.165",32234,3,825,1,145,2,680,3593.992558,0.17345800000020972,6687.497838085285,31362.05882688272
"123.6.182.172",29614,"147.32.84.192",7600,12,1076,4,356,8,720,740.89392,13.218502000000058,215.455578854547,435.75285611031984
"123.9.219.27",7600,"147.32.84.165",7600,709,693629,81,7977,628,685652,3421.73914,30.921437999999853,2063.8108745136724,177392.00874163827
"123.9.219.27",7600,"147.32.84.191",7600,489,467901,65,6241,424,461660,3427.221748,26.14934200000016,1909.3405868491718,141237.9707298171
"123.9.219.27",7600,"147.32.84.192",7600,651,634148,73,7288,578,626860,3427.780641,25.807258000000274,2259.2094053540823,194320.52796930022
"123.15.57.38",17967,"147.32.84.191",7600,3,269,1,89,2,180,1903.635658,0.0033480000001873123,0,0
"123.15.57.62",24833,"147.32.84.192",7600,65,12486,7,6678,58,5808,642.960955,3.73920899999996,14287.513749565904,12426.157510853365
"123.15.134.226",7600,"147.32.84.165",7600,604,571275,82,7919,522,563356,2677.957551,43.5920430000001,1453.2927488624437,103386.94151132098
"123.15.134.226",7600,"147.32.84.191",7600,583,557294,77,7474,506,549820,2686.70479,34.19667800000025,1748.473930713374,128625.35945742941
"123.15.134.226",7600,"147.32.84.192",7600,6,749,2,249,4,500,2690.369593,0.7791879999999765,2556.507543750751,5133.549284640062
"123.20.140.213",7600,"147.32.84.165",7600,6,749,2,249,4,500,1545.23891,0.48170099999993,4135.345369846211,8303.906365153034
"123.24.104.38",15675,"147.32.84.191",29676,3,825,1,145,2,680,3650.692708,0.08301299999993716,13973.714960317999,65531.9046414913
"123.67.106.244",7600,"147.32.84.191",7600,6,749,2,249,4,500,2032.112643,0.45220400000016525,4405.0915073711685,8845.56527584572
"123.80.21.167",7600,"147.32.84.165",7600,6,749,2,249,4,500,2785.886214,0.5038159999999152,3953.824412087618,7939.406449975136
"123.80.21.200",7600,"147.32.84.165",7600,6,749,2,249,4,500,2179.577993,0.5449910000002092,3655.1062311106707,7339.57074520215
"123.80.70.162",7600,"147.32.84.192",7600,6,749,2,249,4,500,2106.036727,0.4569459999997889,4359.377256833237,8753.769592034612
"123.80.73.144",7600,"147.32.84.192",7600,6,749,2,249,4,500,3057.86327,0.4540940000001683,4386.756926978251,8808.748849353917
"123.80.93.176",7600,"147.32.84.192",7600,6,749,2,249,4,500,2376.725087,0.4854890000001433,4103.079575437161,8239.115613327634
"123.80.121.54",7600,"147.32.84.191",7600,4,356,4,356,0,0,3804.600298,12.693351000000348,224.36943562026465,0
"123.86.231.137",11935,"147.32.84.165",32234,1,143,1,143,0,0,2612.130256,0,0,0
"123.86.233.214",7600,"147.32.84.191",7600,10,1178,4,498,6,680,2019.345545,7.821761000000151,509.34821455167486,695.495554006303
"123.88.48.50",7600,"147.32.84.191",7600,1077,1084499,93,9835,984,1074664,1102.405218,28.737201999999797,2737.914428829938,299170.11405633925
"123.95.139.62",1538,"147.32.84.165",7600,6,749,2,249,4,500,1265.785219,0.4531979999999294,4395.429812135778,8826.164281397145
"123.95.147.175",7600,"147.32.84.165",7600,6,749,2,249,4,500,2106.707493,1.1909450000002835,1672.6213217231073,3358.677352857645
"123.95.151.159",7600,"147.32.84.165",7600,6,749,2,249,4,500,1522.750296,0.48990100000014536,4066.1276461966986,8164.914952202206
"123.95.198.21",16224,"147.32.84.192",7600,6,749,2,249,4,500,3200.17116,0.46903199999997014,4247.044977741662,8528.20276654952
"123.95.247.171",7600,"147.32.84.191",7600,6,749,2,249,4,500,1709.829837,0.5592810000000554,3561.71584588034,7152.039851165342
"123.109.13.151",13463,"147.32.84.192",31037,3,825,1,145,2,680,1834.472696,0.2856219999998757,4061.3118037143668,19046.151907074272
"123.110.138.141",54129,"147.32.84.165",7600,93,83382,13,1310,80,82072,1865.039435,1.4109260000000177,7427.746033455949,465351.1240135853
"123.114.164.12",11935,"147.32.84.191",29676,1,143,1,143,0,0,2594.35549,0,0,0
"123.116.36.200",7600,"147.32.84.165",7600,315,301140,39,3860,276,297280,2840.909306,10.28652000000011,3001.987066568642,231199.6671371829
"123.116.36.200",7600,"147.32.84.191",7600,6,749,2,249,4,500,2841.42552,0.7153610000000299,2784.6080510398483,5591.5824318069235
"123.116.36.200",7600,"147.32.84.192",7600,6,749,2,249,4,500,2841.674684,0.7287189999997281,2733.5639663584225,5489.084269796029
"123.117.224.218",49128,"147.32.84.165",32234,1,143,1,143,0,0,1818.403506,0,0,0
"123.118.99.115",15589,"147.32.84.165",7600,1290,1210082,188,17950,1102,1192132,442.63461,52.739416000000006,2722.821200750497,180833.5534090859
"123.125.157.0",56449,"147.32.84.165",7600,6,749,2,249,4,500,2067.510379,0.4922580000002199,4046.658459586457,8125.820199972805
"123.125.157.1",58143,"147.32.84.191",7600,6,749,2,249,4,500,3220.42331,0.4917599999998856,4050.75646657,8134.049129658635
"123.125.157.14",62329,"147.32.84.165",7600,6,749,2,249,4,500,2943.341484,0.5057529999999133,3938.681530312903,7908.9990568532185
"123.125.157.30",10728,"147.32.84.192",7600,9,1018,3,338,6,680,3113.304193,4.632399999999961,583.7147051204607,1174.337276573708
"123.125.157.38",48969,"147.32.84.165",7600,6,749,2,249,4,500,2666.534333,0.490929000000051,4057.613219019029,8147.817708873553
"123.125.157.45",49550,"147.32.84.165",7600,9,1018,3,338,6,680,287.123988,5.3034979999999905,509.8521768085903,1025.73810718888
"123.125.157.55",50046,"147.32.84.165",7600,6,749,2,249,4,500,1414.559397,0.805618000000095,2472.6359142915935,4965.132358015248
"123.125.157.62",40339,"147.32.84.191",7600,6,749,2,249,4,500,2197.667139,0.48347399999966,4120.180195835558,8273.454208505138
"123.136.101.203",51926,"147.32.84.165",7600,12,1076,4,356,8,720,166.760078,13.73985300000001,207.2802380054574,419.2184588874419
"123.162.20.190",16881,"147.32.84.192",31037,3,828,1,140,2,688,2062.472315,0.18267999999989115,6130.939347496536,30129.18765055441
"123.171.246.126",7600,"147.32.84.192",7600,6,749,2,249,4,500,3119.382877,0.33314000000018495,5979.468091489746,12006.964039136037
"123.183.139.116",7600,"147.32.84.191",7600,6,749,2,249,4,500,3673.957349,0.8266810000000078,2409.6356393820365,4838.625781891639
"123.192.88.165",16001,"147.32.84.165",32234,27,6177,9,1383,18,4794,2234.594423,1357.508937,8.150222586711413,28.251747708383594
"123.194.184.184",53181,"147.32.84.165",32234,4,1007,2,327,2,680,1740.797615,31.39667099999997,83.32093552211323,173.26677723252905
"123.203.27.206",7600,"147.32.84.192",7600,3,269,1,89,2,180,2934.226602,0.00024799999982860754,0,0
"123.205.28.131",33008,"147.32.84.191",7600,6,749,2,249,4,500,1559.502465,0.3892040000000634,5118.138559726199,10277.386666116865
"123.211.21.144",60005,"147.32.84.191",29676,9,2475,3,435,6,2040,2108.023327,7.848304999999982,443.40784411411227,2079.4298896385953
"123.219.109.149",61573,"147.32.84.165",32234,3,825,1,145,2,680,963.700527,0.10713300000008985,10827.662811636257,50778.00490974245
"123.234.40.90",54097,"147.32.84.192",7600,3,269,1,89,2,180,1559.525831,0.0002510000001620938,0,0
"123.234.40.90",54093,"147.32.84.191",7600,3,269,1,89,2,180,1559.53041,0.0002549999999246211,0,0
"123.236.7.245",30104,"147.32.84.165",32234,1,143,1,143,0,0,3452.552101,0,0,0
"123.237.183.16",30841,"147.32.84.191",29676,3,825,1,145,2,680,1931.356938,0.23779000000013184,4878.253921524693,22877.32873542615
"123.240.74.26",7600,"147.32.84.191",7600,339,321662,43,4232,296,317430,2290.554994,3.2161189999997077,10526.973659868641,789597.6485945423
"123.240.185.195",7600,"147.32.84.192",7600,616,605229,62,6325,554,598904,2983.764615,5.197947000000113,9734.612530677767,921754.6850708359
"123.243.63.50",47326,"147.32.84.191",29676,3,825,1,145,2,680,1851.428664,0.016576999999870168,69976.47342758552,328165.5305569528
"123.243.86.153",56539,"147.32.84.192",31037,3,825,1,145,2,680,773.161732,0.12711699999999837,9125.451355837653,42795.220151514506
"124.6.181.75",27155,"147.32.84.165",32234,3,825,1,145,2,680,3120.437889,0.1512840000000324,7667.697839822795,35958.85883503104
"124.6.181.99",36629,"147.32.84.191",29676,3,825,1,145,2,680,2699.807688,0.10235899999997855,11332.662491820387,53146.279271985266
"124.6.181.211",47490,"147.32.84.165",32234,3,825,1,145,2,680,2822.985694,0.10558100000025661,10986.825281037125,51524.42200762238
"124.8.134.164",7600,"147.32.84.191",7600,191,178978,25,2478,166,176500,2135.305964,1.906177999999727,10399.868217974838,740749.2899404999
"124.11.168.123",7600,"147.32.84.191",7600,547,530122,63,6268,484,523854,1831.952203,3.897991999999931,12864.059238705695,1075125.8596734097
"124.12.34.65",7600,"147.32.84.165",7600,47,38884,7,732,40,38152,1713.790148,1.3612860000000637,4301.814607657558,224211.51763845782
"124.12.48.161",54641,"147.32.84.191",7600,6,749,2,249,4,500,3428.174679,0.46050900000000183,4325.648358663982,8686.040880851371
"124.12.50.175",7600,"147.32.84.165",7600,510,492249,62,6113,448,486136,2835.090502,18.33369300000004,2667.438578795876,212127.91116334236
"124.13.33.191",7600,"147.32.84.165",7600,6,749,2,249,4,500,2403.811285,0.35021499999993466,5687.934554489018,11421.555330299234
"124.13.76.15",7600,"147.32.84.165",7600,538,513033,70,6813,468,506220,3167.663345,179.3167739999999,303.9537171240881,22584.390236688076
"124.13.76.15",7600,"147.32.84.191",7600,526,503670,68,6554,458,497116,3167.666227,179.31457699999964,292.40232934325303,22178.498070460875
"124.13.76.15",7600,"147.32.84.192",7600,402,361695,72,6999,330,354696,3172.303674,178.7116090000004,313.3092489811329,15877.916470440337
"124.13.77.209",7600,"147.32.84.191",7600,6,749,2,249,4,500,1994.02926,0.32473400000003494,6134.251418083064,12317.773931893702
"124.13.123.70",7600,"147.32.84.192",7600,6,749,2,249,4,500,2505.917877,0.3951360000000932,5041.302235178598,10123.096857788349
"124.13.217.13",10019,"147.32.84.191",7600,6,749,2,249,4,500,899.541048,0.32935999999995147,6048.093271800745,12144.765606025594
"124.14.44.200",1110,"147.32.84.192",7600,3,269,1,89,2,180,2688.55357,0.00020700000004580943,0,0
"124.15.205.197",1664,"147.32.84.191",7600,6,749,2,249,4,500,3177.861736,0.4483620000000883,4442.838599166762,8921.36264892924
"124.16.131.65",3171,"147.32.84.191",7600,7,909,3,409,4,500,2666.552181,0.48704799999995885,6718.0236855510675,8212.742891871721
"124.29.243.246",5678,"147.32.84.191",29676,3,825,1,145,2,680,1374.754028,0.1343019999999342,8637.250376022459,40505.725901346705
"124.40.128.34",16392,"147.32.84.165",7600,3,269,1,89,2,180,466.623455,0.00023800000002438537,0,0
"124.53.162.215",25758,"147.32.84.165",32234,18,4215,6,1007,12,3208,653.429551,2716.971976,2.9650655476617254,9.445809609631395
"124.64.17.167",7600,"147.32.84.165",7600,6,749,2,249,4,500,3071.847041,0.46310200000016266,4301.428195082942,8637.406014222774
"124.65.50.22",55294,"147.32.84.165",7600,3,269,1,89,2,180,898.372966,0.0002319999999826905,0,0
"124.65.80.214",56018,"147.32.84.192",7600,3,269,1,89,2,180,1549.205243,0.00017099999990932702,0,0
"124.66.75.3",40337,"147.32.84.191",7600,3,269,1,89,2,180,3762.545842,0.0065129999998134736,109319.82189780302,221096.2690067926
"124.82.63.110",7600,"147.32.84.191",7600,6,749,2,249,4,500,1103.277421,0.3175020000001041,6273.976226919348,12598.345837187446
"124.82.71.62",7600,"147.32.84.191",7600,6,749,2,249,4,500,443.437783,0.3207439999999906,6210.560446960998,12471.004913576302
"124.88.240.75",7600,"147.32.84.165",7600,6,749,2,249,4,500,330.921523,0.712615000000028,2795.3382962748774,5613.129108985698
"124.91.38.8",15287,"147.32.84.191",7600,2934,3016221,202,22301,2732,2993920,3565.366738,28.889796999999817,6175.4674150185665,829059.477295744
"124.91.38.8",15287,"147.32.84.192",7600,990,973659,108,10991,882,962668,3565.384032,28.728963999999905,3060.6046218722086,268068.97735678963
"124.91.38.8",15287,"147.32.84.165",7600,3138,3242717,198,22381,2940,3220336,3569.34914,24.38859100000036,7341.465523776972,1056341.795227105
"124.98.77.99",20062,"147.32.84.191",29676,6,1650,2,290,4,1360,2042.072422,980.1713660000003,2.366933049133777,11.100099816627369
"124.118.71.101",1159,"147.32.84.192",7600,708,693781,78,7809,630,685972,1677.050341,19.6640960000002,3176.9576389374506,279075.93616304273
"124.118.71.101",1158,"147.32.84.191",7600,1579,1585772,143,14812,1436,1570960,1677.258421,19.373299999999972,6116.459250618128,648711.370804149
"124.120.150.89",80,"147.32.84.165",32234,3,825,1,145,2,680,1152.352477,0.06857300000001487,16916.27900193587,79331.51531942339
"124.121.11.77",7600,"147.32.84.165",7600,6,749,2,249,4,500,1823.759116,0.44520699999998214,4474.323180004088,8984.584698803388
"124.121.21.184",7600,"147.32.84.165",7600,7,909,3,409,4,500,446.864361,0.8419120000000362,3886.3919269470675,4751.090375240914
"124.121.70.65",10151,"147.32.84.165",32234,3,825,1,145,2,680,864.501261,0.16936099999998078,6849.27462639056,32120.73617893504
"124.121.125.229",55555,"147.32.84.191",29676,3,825,1,145,2,680,1260.982185,0.29504899999983536,3931.550352655482,18437.61544693605
"124.121.134.152",19423,"147.32.84.165",32234,3,825,1,145,2,680,552.672236,0.137299999999982,8448.652585580132,39621.267297893035
"124.121.212.83",10085,"147.32.84.191",7600,6,749,2,249,4,500,1338.432763,0.437453000000005,4553.632047328461,9143.83945246679
"124.121.247.88",12900,"147.32.84.192",31037,3,825,1,145,2,680,2688.186622,0.15354299999989962,7554.886904650543,35429.81444939565
"124.122.220.103",7600,"147.32.84.192",7600,6,749,2,249,4,500,1082.687149,0.34396099999980834,5791.354252374862,11629.225406375226
"124.123.102.1",43320,"147.32.84.165",32234,3,825,1,145,2,680,2277.624465,0.32502800000020216,3568.9232927602498,16737.019579841173
"124.123.140.135",28412,"147.32.84.165",32234,3,825,1,145,2,680,3328.250182,0.039284999999836145,29527.80959666128,138475.2450050322
"124.125.34.90",63190,"147.32.84.165",32234,3,825,1,145,2,680,2911.226003,0.210519999999633,5510.165304968755,25840.775223301745
"124.126.20.215",7600,"147.32.84.192",7600,6,749,2,249,4,500,2602.648804,0.3141329999998561,6341.263095570705,12733.460031266477
"124.126.174.37",7600,"147.32.84.191",7600,465,434830,69,6590,396,428240,2984.296825,17.605555000000095,2994.5094034240738,194593.1269988354
"124.149.98.134",52793,"147.32.84.165",32234,14,1840,4,606,10,1234,1031.927923,2593.803718,1.8690697242650802,3.805993464922622
"124.153.173.64",28806,"147.32.84.192",31037,3,825,1,145,2,680,2576.365809,0.15403900000001158,7530.560442484778,35315.731730273445
"124.160.134.120",42853,"147.32.84.192",7600,3,269,1,89,2,180,2592.424597,0.0002689999996619008,0,0
"124.164.243.161",22562,"147.32.84.165",32234,1,143,1,143,0,0,676.830374,0,0,0
"124.168.14.83",57053,"147.32.84.165",32234,1,143,1,143,0,0,2974.748771,0,0,0
"124.168.93.148",64672,"147.32.84.165",32234,3,825,1,145,2,680,1176.251801,0.204354000000194,5676.424244198297,26620.472317619602
"124.169.95.167",63256,"147.32.84.191",29676,3,825,1,145,2,680,3518.359229,0.10846599999968021,10694.595541491528,50153.96529802923
"124.169.213.182",57585,"147.32.84.191",29676,7,1241,1,145,6,1096,1665.402776,2064.764834,0.5618073210559145,4.246488440532981
"124.170.57.203",14777,"147.32.84.192",31037,3,825,1,145,2,680,1930.563703,0.13643899999988207,8501.967912407761,39871.29779611916
"124.171.10.43",21157,"147.32.84.192",31037,3,825,1,145,2,680,2508.652698,0.03588800000034098,32322.781988101277,151582.70173730253
"124.171.108.164",27640,"147.32.84.192",31037,3,825,1,145,2,680,3057.201294,0.04501600000003236,25768.61560332251,120845.92145006418
"124.178.134.152",44721,"147.32.84.191",29676,3,825,1,145,2,680,3769.246505,0.19351099999994403,5994.491269231907,28112.096986742734
"124.180.20.115",15984,"147.32.84.165",32234,3,825,1,145,2,680,3507.02432,0.07615200000009281,15232.692509698842,71436.07521789802
"124.180.141.245",52650,"147.32.84.192",31037,3,825,1,145,2,680,1905.72853,0.19072399999981826,6082.08720455268,28522.891717902225
"124.180.141.245",55819,"147.32.84.192",31037,3,825,1,145,2,680,3640.38459,0.22304299999996147,5200.790878889723,24389.915845827665
"124.186.235.193",28353,"147.32.84.191",29676,3,825,1,145,2,680,1400.260281,0.20267300000000432,5723.505350983975,26841.266473580024
"124.195.205.219",14740,"147.32.84.192",31037,3,825,1,145,2,680,3464.768553,0.024922999999944295,46543.35352897294,218272.27861863174
"124.197.180.115",53255,"147.32.84.165",32234,1,143,1,143,0,0,2835.79383,0,0,0
"124.201.15.207",1054,"147.32.84.165",7600,6,749,2,249,4,500,920.640423,0.7153079999999363,2784.814373668654,5591.996734274405
"124.207.144.243",7600,"147.32.84.165",7600,241,225652,35,5232,206,220420,2438.117193,31.502490999999736,1328.6568354229623,55975.25605197426
"124.207.144.243",7600,"147.32.84.191",7600,751,713660,111,16708,640,696952,2438.126861,32.35945599999968,4130.600959422844,172302.52572849355
"124.207.144.243",7600,"147.32.84.192",7600,413,376628,75,11272,338,365356,2438.14001,29.670802000000094,3039.216803104942,98509.23476891493
"124.218.192.105",14950,"147.32.84.191",29676,6,1212,2,334,4,878,1711.042827,41.05362500000001,65.08560449899367,171.09329565903127
"124.227.253.3",7600,"147.32.84.192",7600,3,269,1,89,2,180,1468.244506,0.0008020000000215077,0,0
"124.228.41.13",7600,"147.32.84.192",7600,732,663501,132,12485,600,651016,755.985324,54.55905900000005,1830.6767350954478,95458.53787544239
"124.228.41.13",7600,"147.32.84.191",7600,801,760482,113,10826,688,749656,755.990317,57.498343999999975,1506.269467517187,104302.96914290267
"124.239.209.153",10669,"147.32.84.165",7600,6,749,2,249,4,500,635.143936,0.57506699999999,3463.9442012844324,6955.711247559101
"124.240.125.16",34369,"147.32.84.165",32234,1,107,1,107,0,0,2706.550024,0,0,0
"124.244.162.95",7600,"147.32.84.192",7600,7,909,3,409,4,500,1661.410589,1.9281059999998433,1697.0021357748308,2074.57473811104
"124.244.167.1",7600,"147.32.84.165",7600,56,47767,8,831,48,46936,1909.819295,0.7600970000000871,8746.252123083288,494000.10788091127
"124.253.25.106",59067,"147.32.84.165",32234,3,825,1,145,2,680,2172.684883,0.3491950000002362,3321.9261444156286,15578.688125535362
"124.253.134.37",62248,"147.32.84.165",32234,3,825,1,145,2,680,3006.875048,0.21991299999990588,5274.813221594432,24737.055108166995
"125.14.108.157",34848,"147.32.84.165",32234,3,828,1,148,2,680,1409.98265,0.22516600000017206,5258.342733801263,24159.953101249048
"125.22.12.14",23889,"147.32.84.191",29676,3,825,1,145,2,680,2727.737809,0.1359679999995933,8531.41915747433,40009.41397987962
"125.24.6.67",8023,"147.32.84.191",29676,3,825,1,145,2,680,1369.331251,0.1037509999998747,11180.615126614694,52433.22955929649
"125.24.11.53",7600,"147.32.84.165",7600,200,189895,24,2415,176,187480,1398.887442,2.2219669999999496,8694.998620591772,675005.5243844909
"125.25.15.222",18115,"147.32.84.165",32234,3,828,1,140,2,688,2678.836629,0.2021300000001247,5540.988472761634,27230.000494714313
"125.25.80.171",7600,"147.32.84.165",7600,192,181095,24,2399,168,178696,1355.424113,2.22568299999989,8622.971016088522,642305.3058319944
"125.25.94.143",7600,"147.32.84.192",7600,6,749,2,249,4,500,1766.294942,0.48170099999993,4135.345369846211,8303.906365153034
"125.25.94.143",7600,"147.32.84.191",7600,130,118791,16,1627,114,117164,1824.165845,1.310420000000022,9932.693334961145,715276.018375776
"125.25.104.74",10613,"147.32.84.165",32234,3,825,1,145,2,680,1792.542251,0.0942410000000109,12308.867690281999,57724.345030287994
"125.25.215.125",51531,"147.32.84.165",32234,3,825,1,145,2,680,2250.939853,0.1979060000003301,5861.368528483548,27487.797237026298
"125.26.148.28",29688,"147.32.84.165",32234,3,825,1,145,2,680,2133.411509,0.07435399999985748,15601.04365605379,73163.51507666605
"125.27.54.40",12880,"147.32.84.191",7600,239,225676,31,3060,208,222616,1655.947238,2.4138840000000528,10141.332392111413,737785.2456870177
"125.27.72.172",15349,"147.32.84.191",29676,3,825,1,145,2,680,3589.233271,0.0945400000000518,12269.938650300024,57541.78125657943
"125.27.235.178",17258,"147.32.84.165",32234,3,825,1,145,2,680,2161.977589,0.1333309999999983,8700.152252664531,40800.71401249574
"125.27.240.155",24807,"147.32.84.165",32234,3,828,1,140,2,688,1789.831397,0.16981400000008762,6595.4514939841365,32411.933056150614
"125.31.22.147",1156,"147.32.84.191",7600,6,749,2,249,4,500,1841.427373,0.6021749999999884,3308.0084692988557,6642.587287748706
"125.31.156.50",32147,"147.32.84.192",31037,3,825,1,145,2,680,3708.737616,0.2183620000000701,5312.279609087788,24912.759546066867
"125.39.117.31",19418,"147.32.84.165",7600,6,538,2,178,4,360,627.254669,4.04879399999993,351.70966959544614,711.3229272716887
"125.39.179.12",4955,"147.32.84.165",7600,140,130853,18,2665,122,128188,1276.978909,1.864612999999963,11434.008022040189,549982.2215119279
"125.39.179.35",30387,"147.32.84.165",32234,1,143,1,143,0,0,3714.145535,0,0,0
"125.41.116.138",45631,"147.32.84.191",29676,6,1212,2,334,4,878,3157.297041,13.947671000000355,191.57320243644492,503.5966219736486
"125.63.105.222",40928,"147.32.84.192",31037,3,825,1,145,2,680,2987.278955,0.1005139999997482,11540.680900202022,54121.81387680948
"125.72.130.54",7600,"147.32.84.192",7600,6,749,2,249,4,500,1174.379057,1.4136979999998402,1409.0703955160332,2829.4586255342033
"125.77.21.112",11935,"147.32.84.165",32234,1,143,1,143,0,0,1989.092635,0,0,0
"125.80.135.144",7600,"147.32.84.165",7600,2,178,2,178,0,0,3817.655539,5.0068129999999655,284.41245958257474,0
"125.80.135.144",7600,"147.32.84.192",7600,2,178,2,178,0,0,3817.676188,4.141958000000159,343.7987541157939,0
"125.83.26.216",7600,"147.32.84.191",7600,2,178,2,178,0,0,3817.680764,4.214872000000014,337.85130366948164,0
"125.84.182.153",1156,"147.32.84.191",7600,365,348546,49,7346,316,341200,3736.254169,16.493537000000288,3563.0926222798043,165495.12697003392
"125.84.182.153",1130,"147.32.84.165",7600,369,351044,51,7648,318,343396,3736.259893,16.995147999999972,3600.0863305221055,161644.25281851058
"125.84.182.153",1157,"147.32.84.192",7600,349,327190,53,7950,296,319240,3736.263388,15.48538600000029,4107.098137560072,164924.52948863865
"125.112.99.24",16001,"147.32.84.165",32234,3,831,1,143,2,688,1074.208644,0.26509699999996883,4315.401532269828,20762.211567843646
"125.129.219.4",20904,"147.32.84.165",32234,3,825,1,145,2,680,3427.065241,0.048606000000290805,23865.366415526063,111920.33905212223
"125.130.253.135",48783,"147.32.84.191",29676,3,825,1,145,2,680,1694.530969,0.1434310000001915,8087.512462427588,37927.64465138455
"125.137.242.143",26760,"147.32.84.165",32234,3,825,1,145,2,680,1166.942546,0.195891999999958,5921.630286077271,27770.404100224445
"125.139.33.245",45682,"147.32.84.165",32234,3,825,1,145,2,680,2711.519975,0.32683999999972,3549.137192513137,16644.2295924754
"125.139.85.208",15415,"147.32.84.192",31037,3,825,1,145,2,680,3199.273006,0.21704099999988102,5344.612308276482,25064.388756055225
"125.143.6.223",53383,"147.32.84.192",31037,3,825,1,145,2,680,1038.319207,0.19219500000008338,6035.536824576585,28304.5864876695
"125.160.229.133",10145,"147.32.84.165",32234,1,145,1,145,0,0,3783.665521,0,0,0
"125.162.193.188",19642,"147.32.84.165",32234,3,825,1,145,2,680,375.33,0.03408100000001468,34036.559960080405,159619.72946796328
"125.163.54.115",10000,"147.32.84.191",29676,3,825,1,145,2,680,2907.117466,0.14234399999986636,8149.272185698654,38217.27645706954
"125.182.12.7",15352,"147.32.84.165",32234,3,825,1,145,2,680,3150.800127,0.2134129999999459,5435.470191601702,25490.480898545913
"125.203.100.27",18668,"147.32.84.165",32234,3696,650660,1232,189616,2464,461044,3267.533216,156.9161220000001,9667.12649194835,23505.245687884115
"125.205.102.181",60096,"147.32.84.165",32234,3,828,1,148,2,680,2501.050807,0.1788139999998748,6621.405482796811,30422.673839877243
"125.214.226.134",12293,"147.32.84.165",32234,1,142,1,142,0,0,3434.363953,0,0,0
"125.229.7.40",23186,"147.32.84.165",32234,3,831,1,143,2,688,2766.893069,0.043549999999868305,26268.656716497346,126383.46727937185
"125.253.98.5",40951,"147.32.84.165",32234,6,1650,2,290,4,1360,1181.00127,841.534725,2.7568678167142777,12.928759416315232
"126.9.238.228",64173,"147.32.84.165",32234,3,825,1,145,2,680,3513.750787,0.2303710000001047,5035.356012690281,23614.08336985787
"126.25.169.72",7600,"147.32.84.165",7600,1,89,1,89,0,0,36.277472,0,0,0
"126.58.244.220",51385,"147.32.84.191",29676,3,825,1,145,2,680,2887.010478,0.2866039999998975,4047.3964075882222,18980.89349765511
"126.109.83.128",11297,"147.32.84.191",29676,3,828,1,140,2,688,2655.598449,0.1750699999997778,6397.441023598683,31438.85303025639
"128.223.8.112",6881,"147.32.84.165",32234,1,133,1,133,0,0,2133.711337,0,0,0
"130.94.4.131",41034,"147.32.84.191",29676,3,825,1,145,2,680,2113.044424,0.2150699999997414,5393.592783751312,25294.09029621305
"130.208.183.47",36380,"147.32.84.165",32234,35,8398,11,1910,24,6488,1692.942224,2078.879796,7.35011231981784,24.96729252930793
"138.217.153.96",22943,"147.32.84.165",32234,3,828,1,140,2,688,2237.693627,0.23565800000005765,4752.650026732494,23355.880131371112
"138.217.197.34",61600,"147.32.84.165",32234,3,825,1,145,2,680,3190.151316,0.2885240000000522,4020.462769127664,18854.58402073663
"138.217.199.131",32703,"147.32.84.192",31037,3,825,1,145,2,680,2687.87978,0.05616999999983818,20651.593377307134,96848.85170047484
"139.168.113.239",14399,"147.32.84.191",29676,1,143,1,143,0,0,3773.996794,0,0,0
"140.112.217.57",39860,"147.32.84.191",7600,7,909,3,409,4,500,969.324509,0.633468999999991,5165.20934726095,6314.436854842237
"140.112.225.237",21497,"147.32.84.191",29676,3,831,1,143,2,688,2539.133921,0.03636999999980617,31454.495463461557,151333.51663539547
"141.51.213.41",36395,"147.32.84.192",31037,3,825,1,145,2,680,3403.4645,0.11779299999989234,9847.783824175121,46182.71034785575
"142.161.21.105",37114,"147.32.84.165",32234,3,825,1,145,2,680,1400.418424,0.16663199999993594,6961.447981182761,32646.790532443294
"142.167.125.179",53306,"147.32.84.165",32234,3,825,1,145,2,680,1683.871642,0.0842849999999089,13762.828498561472,64542.91985532277
"142.167.243.128",20383,"147.32.84.191",29676,3,825,1,145,2,680,3706.70879,0.11027500000000146,10519.156653819857,49331.21741101726
"142.217.30.103",61129,"147.32.84.191",29676,3,825,1,145,2,680,2942.205722,0.09606799999983195,12074.78036393002,56626.55618946492
"144.131.102.81",40955,"147.32.84.165",32234,3,825,1,145,2,680,1593.123081,0.22154500000010557,5235.956577667956,24554.83084699455
"144.132.208.161",51115,"147.32.84.192",31037,3,825,1,145,2,680,2849.221894,0.1623850000000857,7143.516950453476,33500.63121591975
"144.137.16.99",27804,"147.32.84.192",31037,3,825,1,145,2,680,1005.325567,0.22078899999996793,5253.884930862355,24638.90864128553
"145.53.117.71",50418,"147.32.84.165",32234,3,426,1,148,2,278,2031.732997,0.12626399999999194,9377.177976304216,17613.88836089576
"145.236.15.219",41853,"147.32.84.191",29676,3,825,1,145,2,680,1979.568043,0.18317400000000816,6332.776485745511,29698.538002116882
"145.236.197.82",28370,"147.32.84.192",31037,3,828,1,148,2,680,1159.153778,0.11559599999986858,10242.568947034033,47060.45191880502
"147.32.84.79",51408,"147.32.84.165",0,1,69,1,69,0,0,35.361158,0,0,0
"147.32.84.165",137,"147.32.84.255",137,164,15664,164,15664,0,0,29.592745999999998,2437.647567,51.40693909014124,0
"147.32.84.165",1025,"147.32.80.9",53,65,9131,44,3344,21,5787,30.550328,124.17830799999999,215.43215100015698,372.818737391719
"147.32.84.165",123,"65.55.56.40",123,4,360,4,360,0,0,35.906978,2.874324999999999,1001.9743765927657,0
"147.32.84.165",138,"147.32.84.255",138,30,7124,30,7124,0,0,38.752586,3524.586103,16.169841886254524,0
"147.32.84.165",1034,"239.255.255.250",1900,6,1050,6,1050,0,0,39.201433,6.069603999999998,1383.9453117534524,0
"147.32.84.165",1039,"147.32.80.9",53,80,10246,56,4326,24,5920,72.291969,82.436433,419.8143798871065,574.5032660498545
"147.32.84.165",1065,"147.32.80.9",53,21,2819,14,1072,7,1747,85.429021,69.29961799999998,123.75248590836391,201.6749933599923
"147.32.84.165",1137,"221.123.176.126",53,12,720,12,720,0,0,148.464564,0.7016979999999933,8208.65956579619,0
"147.32.84.165",1143,"147.32.80.9",53,6,554,4,302,2,252,152.670207,0.41638799999998355,5802.280565242263,4841.638087553147
"147.32.84.165",1140,"221.123.176.75",9567,3,682,2,396,1,286,152.670972,0.4093340000000012,7739.40107589399,5589.567443701216
"147.32.84.165",1144,"147.32.80.9",53,3,376,2,158,1,218,152.690887,0.5611810000000048,2252.3927217778028,3107.7317300478544
"147.32.84.165",1140,"221.123.176.75",9732,3,674,2,396,1,278,152.691184,0.4149969999999996,7633.790123784034,5359.074884878691
"147.32.84.165",1146,"147.32.80.9",53,30,3190,20,1498,10,1692,152.849881,2287.7646,5.238301178364242,5.916692652731841
"147.32.84.165",1140,"221.123.176.20",8000,3,426,2,284,1,142,152.85071,0.4505620000000192,5042.5912527019655,2521.2956263509827
"147.32.84.165",1141,"221.123.176.39",3999,3,522,2,252,1,270,152.897316,0.43404499999999757,4644.679699109565,4976.442534760248
"147.32.84.165",7600,"221.123.176.136",5555,9,635,6,424,3,211,153.071024,0.9511760000000038,3566.1118447059075,1774.6452812097796
"147.32.84.165",32234,"58.48.111.62",82,278,23120,278,23120,0,0,153.230938,3588.572065,51.54139213308512,0
"147.32.84.165",32234,"67.215.242.139",6881,18,2745,12,1464,6,1281,153.252393,2022.8901710000002,5.789735976723968,5.066018979633472
"147.32.84.165",1140,"221.123.176.73",8000,21,4774,18,3452,3,1322,153.301548,3600.990274,7.669001551988084,2.9369698875226673
"147.32.84.165",32234,"221.123.176.138",554,4,416,4,416,0,0,153.744399,0.05704400000001897,58340.92980854942,0
"147.32.84.165",7600,"221.123.176.37",10007,489,46773,310,22044,179,24729,154.041905,3667.696029,48.082501550185036,53.93903923219587
"147.32.84.165",32234,"14.54.97.246",62847,8,976,8,976,0,0,154.414408,9.242862000000002,844.7599888432823,0
"147.32.84.165",32234,"217.16.140.71",52499,9,1257,6,696,3,561,154.414518,2740.755199,2.0315568504737516,1.6375048751663428
"147.32.84.165",32234,"188.187.139.160",20001,9,1227,6,696,3,531,154.433263,2741.067685,2.0313252498177548,1.549761074214408
"147.32.84.165",32234,"108.0.89.61",32589,10,1642,8,976,2,666,154.433376,2030.9562300000002,3.8444944724387287,2.623394793692821
"147.32.84.165",32234,"77.198.89.70",23872,16,3125,12,2408,4,717,154.433474,3600.317809,5.350638755235511,1.5931926858404737
"147.32.84.165",32234,"186.32.138.104",59381,6,768,6,768,0,0,154.433594,19.078651000000008,322.0353472580424,0
"147.32.84.165",32234,"84.85.86.119",10000,6,935,4,488,2,447,154.433692,2021.159396,1.9315646295518594,1.7692815356755762
"147.32.84.165",32234,"210.199.121.212",26177,9,1782,6,840,3,942,154.433786,2020.490205,3.3259255518142936,3.7297879402488863
"147.32.84.165",32234,"200.104.20.171",35630,10,1328,10,1328,0,0,154.43388,59.161294,179.5768699717758,0
"147.32.84.165",32234,"78.40.81.32",10360,6,768,6,768,0,0,154.433973,59.141075,103.8871883881042,0
"147.32.84.165",32234,"189.223.103.4",15009,9,1334,6,768,3,566,154.674279,3281.896665,1.872088193855427,1.3796899970340777
"147.32.84.165",32234,"182.53.178.95",12730,4,560,4,560,0,0,154.674383,5.88927799999999,760.7044530755735,0
"147.32.84.165",32234,"88.232.54.23",16238,6,768,6,768,0,0,154.674473,28.963994999999983,212.1254336634157,0
"147.32.84.165",32234,"210.175.51.220",14999,6,1188,4,560,2,628,154.934172,93.085139,48.12798313595471,53.97209537389207
"147.32.84.165",32234,"83.240.19.26",61142,3,613,2,280,1,333,154.95406,0.02680300000000102,83572.73439540032,99391.85912024396
"147.32.84.165",32234,"94.202.155.119",37146,3,613,2,280,1,333,154.954165,0.14046100000001616,15947.487202851627,18966.118709105685
"147.32.84.165",32234,"68.204.65.144",10547,9,966,6,624,3,342,154.973686,2741.2298680000004,1.8210804056509715,0.9980921454048595
"147.32.84.165",7600,"123.232.55.67",21935,187,120812,80,8226,107,112586,155.030165,42.196646999999984,1559.55519404184,21345.013503087113
"147.32.84.165",7600,"1.64.137.151",7600,268,201596,90,9036,178,192560,155.030261,5.7059460000000115,12668.889610942664,269978.01942044264
"147.32.84.165",7600,"202.198.62.41",18894,12,1068,12,1068,0,0,155.030352,16.417602000000016,520.4170499443214,0
"147.32.84.165",7600,"121.31.110.179",7286,6,748,4,498,2,250,155.030442,1.9189379999999971,2076.14836956692,1042.2431574131124
"147.32.84.165",7600,"221.6.23.42",48366,196,124360,86,8480,110,115880,155.03053,24.50322399999999,2768.6152646688465,37833.38878181909
"147.32.84.165",7600,"221.2.61.194",14236,792,595700,270,27374,522,568326,155.030618,19.286984999999987,11354.392612427508,235734.51215936567
"147.32.84.165",7600,"61.152.154.52",7600,5,588,4,498,1,90,155.030707,0.557547999999997,7145.573116574755,1291.368635525558
"147.32.84.165",7600,"122.224.30.182",60641,14,1460,12,1210,2,250,155.030794,15.073925000000003,642.1685128458579,132.6794448028632
"147.32.84.165",7600,"113.70.250.4",21685,14,1604,10,1174,4,430,155.030884,9.858250000000027,952.7045875282098,348.94631400096273
"147.32.84.165",7600,"221.1.207.18",14689,26,2678,16,1708,10,970,155.030975,32.29221099999998,423.1360930968774,240.30562664166925
"147.32.84.165",7600,"218.93.149.34",53600,7,766,6,676,1,90,155.031067,5.861798999999991,922.5836641618057,122.82918605704513
"147.32.84.165",7600,"60.2.16.33",54848,3,268,2,178,1,90,155.03116,0.5089759999999899,2797.7743547829923,1414.6050108453333
"147.32.84.165",7600,"223.16.48.67",7600,297,229578,94,9568,203,220010,155.03125,6.279077000000001,12190.326699290355,280308.7141629255
"147.32.84.165",7600,"116.236.169.74",53722,5,588,4,498,1,90,155.031343,0.5700999999999965,6988.247675846385,1262.9363269601902
"147.32.84.165",7600,"125.222.214.31",7600,128,74559,64,6342,64,68217,155.031431,6.313468,8036.153822273273,86439.97245254113
"147.32.84.165",7600,"118.183.190.204",41450,73,30254,48,4820,25,25434,155.03152,14.25335100000001,2705.328732871307,14275.379873827556
"147.32.84.165",7600,"221.203.113.114",15754,273,196960,100,9890,173,187070,155.031611,6.688524000000001,11829.216730028926,223750.4118995461
"147.32.84.165",7600,"221.0.93.112",5228,89,56954,38,3840,51,53114,155.031701,2.6276269999999897,11691.157078230708,161709.40548259005
"147.32.84.165",7600,"123.179.27.150",6563,295,227366,94,9552,201,217814,155.03179,5.4602820000000065,13994.881583039101,319124.9096658374
"147.32.84.165",7600,"123.8.249.48",1056,373,283136,124,12618,249,270518,155.031883,6.355681000000004,15882.48371810982,340505.44701661373
"147.32.84.165",7600,"121.232.141.223",32092,57,23808,36,3634,21,20174,155.031975,6.363419000000022,4568.613193630641,25362.466309384854
"147.32.84.165",7600,"219.148.129.150",35854,64,27442,40,3974,24,23468,155.032064,5.121780000000001,6207.217022207122,36656.00631030618
"147.32.84.165",7600,"219.138.108.66",49769,126,68404,68,6666,58,61738,155.032158,6.617206999999979,8058.989238208835,74639.34557283783
"147.32.84.165",7600,"222.88.25.114",44742,4,356,4,356,0,0,155.032249,4.709181999999998,604.7759462259053,0
"147.32.84.165",7600,"112.192.41.2",7600,78,32848,50,4988,28,27860,155.032338,6.062275999999997,6582.346300300418,36765.06975268036
"147.32.84.165",7600,"124.229.195.83",36477,6,748,4,498,2,250,155.032425,1.119004000000018,3560.308989065218,1787.3037093700896
"147.32.84.165",7600,"116.226.53.82",57931,128,57562,80,7742,48,49820,155.032514,6.018553999999995,10290.843946901541,66221.886519586
"147.32.84.165",7600,"180.109.61.162",27846,58,20886,40,4006,18,16880,155.032603,4.185498999999993,7656.912592739851,32263.775478144955
"147.32.84.165",7600,"113.227.184.104",7600,4,356,4,356,0,0,155.032693,4.749177000000003,599.6828503128012,0
"147.32.84.165",7600,"119.99.22.5",7600,3,268,2,178,1,90,155.032783,0.6135989999999936,2320.733899501164,1173.404780646656
"147.32.84.165",32234,"96.22.17.59",51276,9,966,6,624,3,342,155.215116,2741.247304,1.821068822472064,0.9980857969318043
"147.32.84.165",32234,"60.230.219.127",18192,3,613,2,280,1,333,155.254939,0.39785100000000284,5630.248510120583,6695.974120964836
"147.32.84.165",32234,"213.137.0.16",16881,3,603,2,280,1,323,155.255042,0.12343500000000063,18147.20298132611,20934.09486774405
"147.32.84.165",32234,"203.114.205.232",7646,4,416,4,416,0,0,155.495865,9.013417000000004,369.22734186158243,0
"147.32.84.165",32234,"99.164.161.49",22708,3,594,2,280,1,314,155.525002,0.1881750000000011,11903.812940082302,13349.275939949437
"147.32.84.165",7600,"112.67.28.64",29280,6,536,4,356,2,180,155.560274,5.523402000000004,515.6242475199158,260.70888919546303
"147.32.84.165",7600,"112.237.238.131",7600,6,748,4,498,2,250,155.663057,1.3585239999999885,2932.5944922577987,1472.1859900892564
"147.32.84.165",32234,"183.106.67.25",24980,4,560,4,560,0,0,155.745578,5.848863999999992,765.9607062157722,0
"147.32.84.165",32234,"112.163.152.180",4041,3,624,2,280,1,344,155.765383,0.4423919999999839,5063.382701314856,6220.7273187582505
"147.32.84.165",32234,"72.209.197.155",49335,4,560,4,560,0,0,155.996217,5.598123999999984,800.2680898100887,0
"147.32.84.165",7600,"218.247.141.243",7600,83,16294,74,7420,9,8874,156.01163,3.9773509999999987,14924.506285716301,17849.065873240765
"147.32.84.165",7600,"120.35.6.225",11862,2,178,2,178,0,0,156.011721,4.00000001832268e-06,0,0
"147.32.84.165",7600,"118.166.112.7",64189,141,89794,62,5936,79,83858,156.011806,4.252706999999987,11166.534633117248,157749.87554985614
"147.32.84.165",7600,"222.223.178.99",65205,2,178,2,178,0,0,156.01189,4.00000001832268e-06,0,0
"147.32.84.165",7600,"119.185.0.230",41704,109,68796,48,4702,61,64094,156.011974,3.0445469999999943,12355.204238922923,168416.51648012034
"147.32.84.165",7600,"113.96.152.57",25177,2,178,2,178,0,0,156.012092,6.000000013273166e-06,0,0
"147.32.84.165",7600,"221.206.154.156",54462,72,48278,28,2850,44,45428,156.012189,2.6342329999999947,8655.270813174098,137961.9798248677
"147.32.84.165",7600,"222.185.238.58",10487,53,19416,36,3634,17,15782,156.012278,4.022301999999996,7227.701947790103,31388.99068245003
"147.32.84.165",7600,"211.140.246.45",34900,2,178,2,178,0,0,156.012368,3.999999989900971e-06,0,0
"147.32.84.165",7600,"60.30.240.132",53938,122,83118,48,4750,74,78368,156.012458,2.8072410000000048,13536.422416173009,223331.02145487294
"147.32.84.165",7600,"110.7.48.70",16660,2,178,2,178,0,0,156.012548,4.9999999873762135e-06,0,0
"147.32.84.165",7600,"222.35.92.70",57124,38,15904,24,2478,14,13426,156.012639,4.3603669999999966,4546.406300203634,24632.78893726149
"147.32.84.165",7600,"59.48.59.202",41918,41,8270,34,3468,7,4802,156.012729,2.3298719999999946,11907.95030799978,16488.459451849754
"147.32.84.165",7600,"122.194.153.106",7600,149,88772,70,7154,79,81618,156.012828,182.20396899999997,314.10951316872803,3583.588236763383
"147.32.84.165",7600,"117.95.26.132",7600,44,7536,38,3832,6,3704,156.012919,3.873958999999985,7913.351690092775,7649.022614849593
"147.32.84.165",7600,"116.87.139.29",39611,8,1068,6,818,2,250,156.013012,8.264946000000009,791.7777079245276,241.98585205517347
"147.32.84.165",7600,"61.134.64.140",7600,2,178,2,178,0,0,156.013102,3.999999989900971e-06,0,0
"147.32.84.165",7600,"120.205.32.103",7600,6,748,4,498,2,250,156.013192,3.2460340000000087,1227.3438910374905,616.1364914846839
"147.32.84.165",7600,"61.161.73.36",21313,6,748,4,498,2,250,156.013286,1.1388080000000116,3498.394812821792,1756.222295593269
"147.32.84.165",7600,"222.243.197.38",18029,6,748,4,498,2,250,156.013374,1.4448879999999917,2757.307140761099,1384.190331707379
"147.32.84.165",7600,"182.148.106.130",26912,2,178,2,178,0,0,156.013466,4.00000001832268e-06,0,0
"147.32.84.165",7600,"220.164.178.131",7600,2,178,2,178,0,0,156.013555,3.999999989900971e-06,0,0
"147.32.84.165",7600,"58.153.244.139",7600,150,97126,64,6142,86,90984,156.013647,4.281425000000013,11476.552783243862,170006.94862107775
"147.32.84.165",7600,"121.17.178.99",29233,2,178,2,178,0,0,156.013735,5.000000015797923e-06,0,0
"147.32.84.165",7600,"222.185.238.221",25837,2,178,2,178,0,0,156.013825,3.999999989900971e-06,0,0
"147.32.84.165",7600,"60.215.42.114",7600,2,178,2,178,0,0,156.013914,3.999999989900971e-06,0,0
"147.32.84.165",7600,"61.190.33.222",12194,96,52572,50,4948,46,47624,156.014002,3.964950999999985,9983.47772771975,96089.96428959689
"147.32.84.165",7600,"1.202.133.61",7600,51,24176,30,3064,21,21112,156.014093,4.307800999999984,5690.142139806387,39207.010723104584
"147.32.84.165",7600,"202.198.175.238",7600,69,38982,34,3436,35,35546,156.014184,3.9356909999999914,6984.28814660502,72253.63983097266
"147.32.84.165",7600,"218.106.91.23",6842,124,63392,70,6984,54,56408,156.014271,5.630426,9923.22783391523,80147.39914883883
"147.32.84.165",32234,"222.75.243.10",16881,4,560,4,560,0,0,156.436863,5.157671000000022,868.6091067072679,0
"147.32.84.165",7600,"218.201.101.132",43917,314,185784,158,15504,156,170280,157.029893,12.51333600000001,9911.98510133508,108863.05618261981
"147.32.84.165",7600,"114.44.67.92",7600,274,202094,96,9534,178,192560,157.030116,11.345389000000011,6722.731146547723,135780.27161519084
"147.32.84.165",7600,"124.227.108.43",10679,403,215788,222,21744,181,194044,157.030205,13.028505999999993,13351.645998397675,119150.42292646608
"147.32.84.165",7600,"125.126.66.137",7600,6,748,4,498,2,250,157.030296,3.818511000000001,1043.3386207346264,523.7643678386679
"147.32.84.165",7600,"123.137.151.88",62757,8,926,6,676,2,250,157.030386,7.238658000000015,747.0998077267898,276.2943075912684
"147.32.84.165",7600,"218.21.229.234",53412,199,81574,134,13088,65,68486,157.030479,13.356214999999992,7839.346701142506,41021.2024888788
"147.32.84.165",7600,"202.127.20.52",31452,105,43260,70,6776,35,36484,157.030568,13.271357000000023,4084.5860751089663,21992.626677136293
"147.32.84.165",7600,"122.159.212.26",7158,103,41104,70,6816,33,34288,157.03066,13.631421999999986,4000.1696081303958,20122.918944186473
"147.32.84.165",7600,"123.15.52.226",21048,234,166190,88,8766,146,157424,157.030754,11.078384,6330.165121555635,113680.11796666373
"147.32.84.165",7600,"222.247.106.32",7600,11,1194,8,854,3,340,157.030845,10.400653000000005,656.8818323234124,261.5220409718504
"147.32.84.165",7600,"117.24.243.129",7600,174,81888,106,10108,68,71780,157.030935,13.67686900000001,5912.464322060841,41986.21775203079
"147.32.84.165",7600,"111.240.23.134",7600,6,534,6,534,0,0,157.031028,9.900524000000019,431.4923129321228,0
"147.32.84.165",7600,"220.161.192.250",3516,8,856,6,676,2,180,157.031116,6.666212999999999,811.2552059167627,216.01469980032144
"147.32.84.165",7600,"122.193.125.137",41839,229,159707,88,8678,141,151029,157.031207,11.179834,6209.752309381338,108072.44544060314
"147.32.84.165",7600,"221.214.216.123",48384,221,99680,140,13626,81,86054,157.031296,13.758983,7922.6785875089745,50035.09343677508
"147.32.84.165",7600,"121.30.232.18",33325,6,748,4,498,2,250,157.031387,1.4704320000000166,2709.407847489687,1360.1445017518508
"147.32.84.165",7600,"123.54.210.157",7600,101,27908,80,7734,21,20174,157.031478,11.382761000000016,5435.588079201514,14178.633813008968
"147.32.84.165",7600,"60.161.171.39",7600,5,588,4,498,1,90,157.031566,0.968164999999999,4115.0010587038405,743.6748901272001
"147.32.84.165",7600,"60.161.152.65",7600,6,748,4,498,2,250,157.031654,1.9366139999999916,2057.1988016197433,1032.7303220982647
"147.32.84.165",7600,"182.90.44.191",1079,357,181985,206,19976,151,162009,157.031742,13.455363000000006,11876.899939451647,96323.82270177323
"147.32.84.165",7600,"49.140.51.238",7600,6,534,6,534,0,0,157.031831,9.338988,457.4371441530924,0
"147.32.84.165",7600,"218.56.145.186",7035,8,712,8,712,0,0,157.03192,13.355079999999987,426.5043713702955,0
"147.32.84.165",7600,"58.57.15.242",29880,132,54804,88,8438,44,46366,157.032009,13.434550000000002,5024.6565757691915,27610.005545403452
"147.32.84.165",7600,"202.198.46.153",9466,191,104990,102,10152,89,94838,157.0321,13.967835999999977,5814.501258462667,54317.9344316472
"147.32.84.165",7600,"116.226.230.70",7600,4,356,4,356,0,0,157.032189,4.662509,610.8299201138271,0
"147.32.84.165",7600,"58.210.224.118",21031,8,712,8,712,0,0,157.032277,12.95395000000002,439.7114393679141,0
"147.32.84.165",7600,"221.224.117.116",53691,3,268,2,178,1,90,157.032364,0.37258800000000747,3821.9158963787654,1932.4293858094882
"147.32.84.165",7600,"60.29.51.50",1462,6,748,4,498,2,250,157.032451,1.7981769999999813,2215.5772207074397,1112.2375605961042
"147.32.84.165",7600,"123.133.147.197",13205,6,748,4,498,2,250,157.032539,1.5909809999999993,2504.1153854131517,1257.0860368539918
"147.32.84.165",7600,"178.165.36.252",61993,406,284900,158,15480,248,269420,157.032628,13.401036000000005,9241.076585422199,160835.32646281968
"147.32.84.165",7600,"121.232.40.213",7600,6,748,4,498,2,250,157.737959,1.6223500000000115,2455.6969827718876,1232.7796098252447
"147.32.84.165",7600,"113.231.105.15",7600,7,766,6,676,1,90,158.439132,6.950324999999992,778.0931107538146,103.5922780589398
"147.32.84.165",7600,"221.11.17.114",2394,204,119160,102,10048,102,109112,158.439231,15.886055999999996,5060.035039534043,54947.30724857071
"147.32.84.165",7600,"222.80.175.222",42531,8,856,6,676,2,180,158.439333,7.350439999999992,735.7382687294919,195.9066396025274
"147.32.84.165",7600,"113.0.250.109",14286,100,49028,58,5796,42,43232,158.439451,9.115645,5086.6395082300805,37940.9246410978
"147.32.84.165",7600,"222.73.25.82",61869,5,446,4,356,1,90,158.439542,5.128187000000025,555.3619632045372,140.40049631575377
"147.32.84.165",7600,"1.64.135.207",7600,867,726408,224,23878,643,702530,158.43963,15.485325000000017,12335.808257172503,362939.75102233846
"147.32.84.165",7600,"120.10.3.253",7600,157,75530,94,9240,63,66290,158.439717,13.685302000000007,5401.4153286496685,38751.06300175178
"147.32.84.165",7600,"59.46.74.90",62173,11,1122,10,1032,1,90,158.439804,13.688847999999979,603.1186846402278,52.597559706996606
"147.32.84.165",7600,"122.159.220.126",7600,151,75994,88,8766,63,67228,158.439893,15.656869,4479.056444810261,34350.673816073955
"147.32.84.165",7600,"218.94.63.62",18631,365,171750,226,22012,139,149738,158.439983,15.588630999999992,11296.43776929482,76844.7210021201
"147.32.84.165",7600,"61.174.21.126",5494,7,766,6,676,1,90,158.440072,6.94925600000002,778.2128043635153,103.60821359869286
"147.32.84.165",7600,"60.172.5.73",21875,8,712,8,712,0,0,158.440162,13.668849000000023,416.71394570237703,0
"147.32.84.165",7600,"222.187.109.170",1103,8,856,6,676,2,180,158.440257,6.488721999999996,833.446093082737,221.92351590960453
"147.32.84.165",7600,"222.83.234.156",27873,8,856,6,676,2,180,158.440346,7.029526000000004,769.3264097749972,204.8502274548809
"147.32.84.165",7600,"222.243.74.199",16731,126,51426,84,8194,42,43232,158.440436,15.696449000000001,4176.2311972599655,22034.02820599742
"147.32.84.165",7600,"123.244.204.255",7600,292,91162,228,21898,64,69264,158.440528,15.596220999999986,11232.46458228568,35528.60657719588
"147.32.84.165",7600,"123.133.132.54",32166,8,712,8,712,0,0,158.440618,14.509969000000012,392.5576960226445,0
"147.32.84.165",7600,"121.229.88.27",7600,7,766,6,676,1,90,158.440707,6.788304000000011,796.6643803813134,106.06478437029321
"147.32.84.165",7600,"222.175.161.138",9503,220,115552,124,12090,96,103462,158.440799,15.293033000000008,6324.448525024431,54122.42293598657
"147.32.84.165",7600,"118.167.115.137",62491,214,135138,98,9716,116,125422,158.440887,15.182012999999984,5119.742684978605,66089.78664423493
"147.32.84.165",7600,"222.184.76.210",59711,99,53800,52,5078,47,48722,158.440979,14.87959699999999,2730.181469296516,26195.33311285247
"147.32.84.165",7600,"219.78.243.74",7600,625,481862,202,20292,423,461570,158.441071,15.680998000000017,10352.402315209774,235479.91014347403
"147.32.84.165",1153,"221.123.176.74",10986,47,4883,38,4316,9,567,158.758202,3615.572473,9.549801658753806,1.2545731094794734
"147.32.84.165",7600,"221.123.176.14",10029,10,1010,10,1010,0,0,159.480273,12.137927999999988,665.681984602315,0
"147.32.84.165",7600,"221.123.176.44",10019,6,606,6,606,0,0,159.500507,4.217681999999996,1149.446544334069,0
"147.32.84.165",7600,"221.123.176.37",10008,8,808,8,808,0,0,159.500724,13.960409999999996,463.023650451527,0
"147.32.84.165",7600,"221.123.176.14",10028,10,1010,10,1010,0,0,159.520482,8.632981000000001,935.9455326033961,0
"147.32.84.165",7600,"221.202.225.87",7091,4,356,4,356,0,0,159.622119,4.945876999999996,575.8331636633912,0
"147.32.84.165",7600,"117.57.65.37",9670,4,356,4,356,0,0,159.62221,4.697025999999994,606.3411188271054,0
"147.32.84.165",7600,"61.163.195.84",10541,4,356,4,356,0,0,159.6223,4.846823999999998,587.60128281943,0
"147.32.84.165",7600,"140.109.58.74",7600,8,712,8,712,0,0,159.62239,13.507982999999996,421.67657451153156,0
"147.32.84.165",7600,"119.189.196.33",7600,4,356,4,356,0,0,159.622483,4.095798000000002,695.3467920048788,0
"147.32.84.165",7600,"218.56.166.158",13581,3,268,2,178,1,90,159.622573,0.5760429999999985,2472.0376777428137,1249.9066909935575
"147.32.84.165",7600,"119.247.248.3",1536,4,356,4,356,0,0,159.622663,4.1550670000000025,685.4281772111011,0
"147.32.84.165",7600,"116.236.217.138",41173,210,102550,126,12264,84,90286,159.622757,23.98846499999999,4089.965739783685,30109.804858293362
"147.32.84.165",7600,"218.28.77.140",4955,1586,1345364,398,43824,1188,1301540,159.622847,24.75143699999998,14164.510933244008,420675.373312669
"147.32.84.165",7600,"182.243.248.110",7600,8,712,8,712,0,0,159.622951,14.316193999999996,397.8711101567918,0
"147.32.84.165",7600,"123.117.190.114",12896,8,712,8,712,0,0,159.623056,13.838173000000012,411.6150303945467,0
"147.32.84.165",7600,"218.82.23.20",62761,241,128524,134,12984,107,115540,159.623147,23.567345000000017,4407.454467187539,39220.37038962171
"147.32.84.165",7600,"111.182.104.203",8115,3,268,2,178,1,90,159.62324,0.9448909999999842,1507.0521361723456,761.9926531208489
"147.32.84.165",7600,"125.109.59.220",7600,3,268,2,178,1,90,159.623328,1.2283400000000029,1159.288144976144,586.1569272351289
"147.32.84.165",7600,"58.39.172.225",7600,227,126296,120,11694,107,114602,159.623417,23.854510000000005,3921.7741215392803,38433.654684166635
"147.32.84.165",7600,"112.239.150.194",7600,470,244047,269,26233,201,217814,159.623508,26.114749000000018,8036.225046620201,66725.20574484552
"147.32.84.165",7600,"219.151.242.13",11360,3,268,2,178,1,90,159.623595,0.5991260000000125,2376.7955321584614,1201.7505499677613
"147.32.84.165",7600,"60.160.108.251",7600,3,268,2,178,1,90,159.623684,0.6172540000000026,2306.9919352486886,1166.456596474056
"147.32.84.165",7600,"119.1.99.111",10051,3,268,2,178,1,90,159.623772,0.5669069999999863,2511.87584559731,1270.0495848525727
"147.32.84.165",7600,"123.156.246.123",7600,577,431308,200,20270,377,411038,159.62386,24.210894999999994,6697.811047464377,135819.1838839498
"147.32.84.165",7600,"114.243.126.105",23335,528,395584,182,18560,346,377024,159.623948,24.898899,5963.315887983641,121137.56515900562
"147.32.84.165",7600,"222.244.163.130",10001,218,110300,126,12168,92,98132,159.624036,24.370314000000008,3994.367901866179,32213.618585300123
"147.32.84.165",7600,"123.122.211.30",16098,473,320688,196,19426,277,301262,159.62418,24.112741,6445.057407616994,99951.14201243235
"147.32.84.165",7600,"110.186.108.6",7600,8,712,8,712,0,0,159.624274,13.83745399999998,411.6364180867382,0
"147.32.84.165",7600,"114.238.29.110",7600,3,268,2,178,1,90,159.624362,1.0767040000000065,1322.5547597111104,668.7074627752805
"147.32.84.165",7600,"118.74.6.4",7600,411,280320,168,16390,243,263930,159.624449,24.221757999999994,5413.314756096565,87171.21193267642
"147.32.84.165",7600,"182.123.17.51",7600,472,353168,162,16680,310,336488,159.624535,23.73396199999999,5622.322981725514,113419.91699489538
"147.32.84.165",7600,"111.121.4.67",62404,292,138576,178,17296,114,121280,159.624622,25.056553000000008,5522.228057466642,38722.00617539051
"147.32.84.165",7600,"221.237.125.253",1605,303,128540,202,19588,101,108952,159.624709,25.615781,6117.478908802352,34026.52450846609
"147.32.84.165",7600,"222.218.68.250",7600,3,268,2,178,1,90,159.624799,1.5795789999999954,901.5060342027871,455.8176577429822
"147.32.84.165",7600,"221.123.176.40",10012,18,1818,18,1818,0,0,159.641054,13.309438,1092.75838694316,0
"147.32.84.165",7600,"221.123.176.40",10015,4,404,4,404,0,0,159.741327,4.577815999999984,706.0135226055419,0
"147.32.84.165",7600,"221.123.176.38",10000,20,2020,20,2020,0,0,159.761585,19.754616,818.0366553315945,0
"147.32.84.165",7600,"221.123.176.37",10006,2,202,2,202,0,0,159.78177,6.000000013273166e-06,0,0
"147.32.84.165",1158,"117.79.93.14",4999,6,2244,4,2008,2,236,160.490727,4.588604000000004,3500.846880663484,411.4541154564653
"147.32.84.165",7600,"121.16.43.144",1662,8,712,8,712,0,0,161.033663,13.542847000000023,420.59103229919015,0
"147.32.84.165",7600,"125.78.182.167",12337,201,91810,126,12344,75,79466,161.055421,23.721970999999996,4162.891860882893,26799.1222145917
"147.32.84.165",7600,"60.6.206.54",9903,294,199122,120,11962,174,187160,161.074094,23.139538999999985,4135.605294470217,64706.56135370722
"147.32.84.165",7600,"221.123.176.44",10018,12,1212,12,1212,0,0,161.094714,12.844225999999992,754.8917311171577,0
"147.32.84.165",7600,"125.229.243.53",7600,8,712,8,712,0,0,161.113695,12.528475999999984,454.6442839496207,0
"147.32.84.165",7600,"221.123.176.44",10022,8,808,8,808,0,0,161.353397,8.632742000000007,748.7771556244811,0
"147.32.84.165",7600,"221.123.176.44",10020,12,1212,12,1212,0,0,161.473948,11.987687999999991,808.8298594357817,0
"147.32.84.165",7600,"222.80.7.196",7600,3,268,2,178,1,90,161.636385,0.42756800000000794,3330.464393967681,1683.9426711072547
"147.32.84.165",7600,"221.123.176.38",10002,12,1212,12,1212,0,0,161.694603,16.76652899999999,578.2950066766953,0
"147.32.84.165",7600,"113.132.59.247",7600,151,56826,106,10300,45,46526,161.914258,18.369237,4485.760622501632,20262.572691505913
"147.32.84.165",7600,"221.123.176.14",10027,6,606,6,606,0,0,161.975042,4.956413999999995,978.1265245397186,0
"147.32.84.165",7600,"119.62.211.62",2841,446,323450,164,16698,282,306752,162.095036,22.531216999999998,5928.840861103952,108916.26493145045
"147.32.84.165",7600,"123.124.139.240",7600,1679,1462272,384,43246,1295,1419026,162.456391,21.705692,15939.044928860136,523006.0391532323
"147.32.84.165",7600,"221.123.176.14",10025,12,1212,12,1212,0,0,162.715918,10.92616000000001,887.4114968113217,0
"147.32.84.165",7600,"221.123.176.40",10014,8,808,8,808,0,0,162.976182,10.154097000000007,636.5903339312197,0
"147.32.84.165",7600,"221.123.176.40",10016,4,404,4,404,0,0,162.996027,4.556283000000008,709.35014352708,0
"147.32.84.165",7600,"221.123.176.37",10011,2,202,2,202,0,0,163.155984,6.000000013273166e-06,0,0
"147.32.84.165",7600,"221.123.176.44",10021,2,202,2,202,0,0,163.216741,6.999999982326699e-06,0,0
"147.32.84.165",7600,"124.91.191.204",45930,503,392430,158,16504,345,375926,163.636498,20.255843,6518.217977894083,148471.1349707835
"147.32.84.165",32234,"121.115.142.93",53207,3,613,2,280,1,333,163.656868,0.3100159999999903,7225.433526011787,8593.104872006876
"147.32.84.165",32234,"122.61.129.22",22985,4,560,4,560,0,0,163.65698,5.920777999999984,756.6573176700784,0
"147.32.84.165",32234,"190.212.54.168",26117,4,560,4,560,0,0,163.657071,5.920776999999987,756.6574454670409,0
"147.32.84.165",32234,"95.78.117.239",60000,4,560,4,560,0,0,163.657161,5.920776999999987,756.6574454670409,0
"147.32.84.165",7600,"221.123.176.14",10026,8,808,8,808,0,0,163.718696,10.857719000000003,595.336829033796,0
"147.32.84.165",7600,"221.123.176.44",10023,2,202,2,202,0,0,163.777636,5.999999984851456e-06,0,0
"147.32.84.165",32234,"78.84.202.248",62351,5,893,4,560,1,333,164.079961,5.562194000000005,805.4375665429857,478.94769581931115
"147.32.84.165",32234,"99.22.255.125",8500,4,560,4,560,0,0,164.508907,6.098167000000018,734.6469849054621,0
"147.32.84.165",32234,"71.17.81.91",11450,3,613,2,280,1,333,164.509068,0.18714799999997922,11969.136726014965,14234.723320582083
"147.32.84.165",32234,"87.126.60.92",14107,3,594,2,280,1,314,164.509167,0.15260800000001495,14678.129586914058,16460.47389389648
"147.32.84.165",32234,"218.159.22.148",47251,3,613,2,280,1,333,164.751345,0.3584590000000105,6248.971290998229,7431.812285365751
"147.32.84.165",32234,"94.3.132.165",59097,3,613,2,280,1,333,164.75145,0.4613209999999981,4855.621140160559,5774.720855976665
"147.32.84.165",7600,"121.232.26.5",7600,6,748,4,498,2,250,164.98911,2.076151999999979,1918.934644476917,963.3206046570868
"147.32.84.165",32234,"80.201.177.213",6881,8,1120,8,1120,0,0,165.209597,725.011624,12.358422545788038,0
"147.32.84.165",32234,"78.235.173.96",54472,43,9438,30,6456,13,2982,165.430365,3600.3810639999997,14.345148216788868,6.625965300877386
"147.32.84.165",32234,"79.118.161.58",61879,6,1438,4,960,2,478,165.670417,771.5197559999999,9.95437892584568,4.956451173493995
"147.32.84.165",32234,"78.173.171.40",10812,4,560,4,560,0,0,165.67054100000001,5.998042999999996,746.9102839042673,0
"147.32.84.165",32234,"178.179.225.132",53390,4,560,4,560,0,0,165.670639,5.998040000000003,746.9106574814435,0
"147.32.84.165",7600,"111.112.142.232",2884,8,712,8,712,0,0,165.830994,12.630231000000009,450.9814586922437,0
"147.32.84.165",7600,"60.16.182.197",7600,8,712,8,712,0,0,165.850225,13.666070000000019,416.79868462549894,0
"147.32.84.165",32234,"88.90.134.135",41929,39,8950,26,5968,13,2982,165.871117,3589.987116,13.299212074386732,6.645149196685864
"147.32.84.165",32234,"31.134.197.249",57586,42,9105,30,6456,12,2649,166.091057,3589.982767,14.386698586623048,5.903092403340219
"147.32.84.165",32234,"95.175.231.20",36771,48,9228,40,7712,8,1516,166.291673,3589.560877,17.187617681960823,3.3786862559456186
"147.32.84.165",32234,"78.232.157.35",51413,33,5712,30,5256,3,456,169.778013,3595.963844,11.693109782001468,1.0144707116804927
"147.32.84.165",32234,"84.237.152.174",11023,39,8950,26,5968,13,2982,170.807823,3585.27119,13.316705339659396,6.653889966967882
"147.32.84.165",32234,"194.44.188.91",1024,9,1665,8,1520,1,145,171.028663,1428.744896,8.5109665371641,0.8119014130847331
"147.32.84.165",32234,"112.95.64.119",2743,3,603,2,280,1,323,173.511928,0.5364609999999743,4175.513224633491,4816.752755559349
"147.32.84.165",32234,"125.73.139.191",9753,3,603,2,280,1,323,173.512035,0.5449629999999956,4110.370795815528,4741.6063108871995
"147.32.84.165",32234,"123.145.178.80",4041,3,624,2,280,1,344,173.512129,0.6850630000000137,3269.7722691197087,4017.148787775642
"147.32.84.165",32234,"77.109.199.163",51769,4,560,4,560,0,0,174.382058,5.2207520000000045,858.1139268825633,0
"147.32.84.165",32234,"222.153.249.197",46409,3,613,2,280,1,333,174.382168,0.3678019999999833,6090.233332064811,7243.027498491365
"147.32.84.165",32234,"95.42.248.161",19218,3,613,2,280,1,333,174.382265,0.07966500000000565,28117.743049015768,33440.030126150894
"147.32.84.165",32234,"70.160.106.191",10846,45,10755,34,9160,11,1595,174.622554,3597.127322,20.371811570811005,3.547275049720912
"147.32.84.165",32234,"75.70.14.184",57690,59,12772,44,9688,15,3084,174.622662,3597.127026,21.54608370507959,6.85880699282261
"147.32.84.165",32234,"173.86.36.103",60084,8,976,8,976,0,0,174.622777,31.07842099999999,251.23541508109443,0
"147.32.84.165",32234,"123.6.173.21",45881,8,976,8,976,0,0,174.622884,25.060664000000003,311.5639713297301,0
"147.32.84.165",32234,"46.53.145.31",32333,4,560,4,560,0,0,174.85318,5.761064000000005,777.6341314729357,0
"147.32.84.165",32234,"117.195.39.25",51281,4,560,4,560,0,0,175.694183,5.923001999999997,756.3732039935159,0
"147.32.84.165",32234,"68.42.33.237",64172,4,560,4,560,0,0,175.694303,5.923014000000023,756.3716715847679,0
"147.32.84.165",32234,"212.107.243.2",58229,4,560,4,560,0,0,175.694404,5.92300800000001,756.3724377883657,0
"147.32.84.165",7600,"112.113.140.106",7600,3,268,2,178,1,90,176.747931,1.1851760000000127,1201.5093116971527,607.5047081614817
"147.32.84.165",7600,"218.28.130.110",63709,5,588,4,498,1,90,177.655715,0.4954830000000072,8040.639133935861,1453.127554325758
"147.32.84.165",7600,"110.166.140.197",3887,3,268,2,178,1,90,177.849867,0.3822230000000104,3725.57381423923,1883.7170970872512
"147.32.84.165",7600,"121.24.34.219",8680,6,748,4,498,2,250,177.933275,1.0060450000000003,3960.0614286637265,1987.9826449115094
"147.32.84.165",7600,"60.166.65.220",7600,4,356,4,356,0,0,178.091719,4.074556000000001,698.9718634373903,0
"147.32.84.165",7600,"60.208.220.162",7600,6,748,4,498,2,250,178.091817,1.013986000000017,3929.0483300557735,1972.4138203091231
"147.32.84.165",7600,"124.8.236.67",7600,6,748,4,498,2,250,178.239717,0.7921179999999879,5029.553677608716,2524.8763441810825
"147.32.84.165",7600,"116.117.98.55",7600,6,748,4,498,2,250,178.720729,1.118190999999996,3562.8975729549015,1788.603199274549
"147.32.84.165",7600,"175.169.99.170",8294,6,748,4,498,2,250,179.104211,1.1933580000000177,3338.478478377772,1675.9430112338212
"147.32.84.165",32234,"188.4.124.87",58177,30,6114,20,3856,10,2258,179.602706,3586.223676,8.601805906988831,5.037053355285472
"147.32.84.165",32234,"31.134.197.173",57586,26,3280,26,3280,0,0,179.803174,2224.345903,11.796726383522374,0
"147.32.84.165",32234,"188.235.202.244",26750,27,5571,18,3576,9,1995,180.614048,2941.399865,9.72598127184588,5.425987873974422
"147.32.84.165",7600,"221.123.176.38",10001,2,202,2,202,0,0,182.166172,8.000000008223651e-06,0,0
"147.32.84.165",7600,"119.109.45.225",7600,2,178,2,178,0,0,182.696625,5.999999984851456e-06,0,0
"147.32.84.165",32234,"66.110.122.226",59211,4,560,4,560,0,0,183.638346,5.977958000000001,749.4197851507153,0
"147.32.84.165",7600,"220.164.80.144",3685,3,268,2,178,1,90,184.077672,0.9330049999999801,1526.251199082567,771.7000444799496
"147.32.84.165",32234,"46.109.87.117",12366,4,560,4,560,0,0,184.479211,6.14049,729.5834697231003,0
"147.32.84.165",32234,"110.55.169.72",31902,4,560,4,560,0,0,184.479318,6.140480999999994,729.5845390613543,0
"147.32.84.165",32234,"46.185.60.212",45072,4,560,4,560,0,0,185.541134,6.086463000000009,736.0596786672314,0
"147.32.84.165",32234,"178.198.157.232",6881,11,1537,8,976,3,561,193.662344,1981.397067,3.9406538598656358,2.265068458385883
"147.32.84.165",32234,"109.67.202.13",29631,6,644,4,416,2,228,193.952055,2000.9891690000002,1.6631774182281942,0.9115491619135295
"147.32.84.165",32234,"2.225.27.187",31402,6,1226,4,560,2,666,194.082862,1980.496375,2.262059176957595,2.690234664024568
"147.32.84.165",32234,"216.19.186.237",60638,11,1579,10,1256,1,323,194.082957,1990.239502,5.048638613545116,1.2983362039610447
"147.32.84.165",32234,"79.135.139.101",16637,6,1226,4,560,2,666,194.083051,1980.4804209999998,2.2620773992493817,2.6902563355358717
"147.32.84.165",32234,"76.106.245.72",46876,6,1226,4,560,2,666,194.08315,1980.856358,2.2616480906890675,2.6897457649980696
"147.32.84.165",32234,"61.27.50.252",56113,9,1548,6,768,3,780,194.102888,2700.913431,2.274785977766497,2.3103295086690987
"147.32.84.165",32234,"122.122.9.226",16416,9,1491,6,768,3,723,194.102993,2701.075351,2.2746496123202746,2.1413693615983838
"147.32.84.165",32234,"46.70.183.170",14193,9,1491,6,768,3,723,194.103087,2700.782747,2.274896048867569,2.141601358504235
"147.32.84.165",32234,"112.71.10.192",64956,9,1548,6,768,3,780,194.103284,2700.9177680000003,2.2747823250278234,2.310325798856383
"147.32.84.165",32234,"190.201.251.98",36910,8,976,8,976,0,0,194.103393,9.514732999999978,820.6220815655066,0
"147.32.84.165",32234,"78.101.184.151",57304,6,768,6,768,0,0,194.103491,40.473228000000006,151.80405180431862,0
"147.32.84.165",32234,"188.226.34.213",18564,6,768,6,768,0,0,194.103587,29.56916799999999,207.7839998744639,0
"147.32.84.165",32234,"189.75.214.66",23824,8,976,8,976,0,0,194.1232,9.515332999999998,820.5703363192861,0
"147.32.84.165",32234,"79.167.0.55",17773,7,1019,6,696,1,323,194.123395,1992.1378439999999,2.794987313136952,1.2970989973322349
"147.32.84.165",32234,"78.90.190.234",56982,3,613,2,280,1,333,194.342642,0.0474349999999788,47222.51502057555,56161.06250661306
"147.32.84.165",32234,"92.149.86.49",63976,3,613,2,280,1,333,194.34275,0.12241700000001288,18298.11219029844,21761.683426319218
"147.32.84.165",32234,"117.203.0.253",45682,4,560,4,560,0,0,194.342852,5.340599999999995,838.8570572594848,0
"147.32.84.165",32234,"87.3.43.168",6881,3,603,2,280,1,323,194.3929,0.10388100000000122,21563.134740712678,24874.616147322125
"147.32.84.165",32234,"71.14.96.24",37383,3,613,2,280,1,333,194.393046,0.2476790000000051,9043.964163291817,10755.85737991491
"147.32.84.165",32234,"122.164.70.101",13727,6,768,6,768,0,0,194.393156,50.14763199999999,122.51824772104895,0
"147.32.84.165",32234,"84.108.90.144",27286,6,644,4,416,2,228,194.833066,2001.0932030000001,1.663090951991005,0.9115017717643009
"147.32.84.165",32234,"111.252.164.50",16001,6,1178,4,560,2,618,194.963716,6.1028949999999895,734.0778433841657,810.1073343060971
"147.32.84.165",32234,"175.19.113.164",1040,3,603,2,280,1,323,194.96382,0.5635690000000011,3974.668585390601,4585.064118147015
"147.32.84.165",32234,"95.141.193.18",50028,3,603,2,280,1,323,194.963912,0.0755630000000167,29644.13800404305,34196.63062609252
"147.32.84.165",32234,"67.83.10.126",43004,3,603,2,280,1,323,194.964014,0.16139499999999884,13878.992533845634,16010.409244400498
"147.32.84.165",32234,"99.161.184.217",24107,3,613,2,280,1,333,194.964107,0.16173200000000065,13850.072960205716,16471.693913387513
"147.32.84.165",32234,"67.170.12.49",4128,5,893,4,560,1,333,194.9642,5.975170999999989,749.7693371453316,445.84498083820614
"147.32.84.165",32234,"171.4.24.136",28343,3,613,2,280,1,333,194.964292,0.64175800000001,3490.412273785391,4151.097454180483
"147.32.84.165",32234,"114.42.16.108",23972,6,1188,4,560,2,628,194.987547,1979.975361,2.2626544189607216,2.5374053126916665
"147.32.84.165",32234,"75.54.127.63",22879,6,1058,4,560,2,498,194.98767,1980.3303660000001,2.2622488029858348,2.01178554265526
"147.32.84.165",32234,"125.115.42.178",11935,9,1299,8,976,1,323,194.987766,80.44677900000002,97.05795678904681,32.120614798014465
"147.32.84.165",32234,"175.147.72.35",28090,9,1200,6,696,3,504,194.987878,2700.2720130000002,2.0620144834275256,1.4931829017923461
"147.32.84.165",32234,"111.242.129.238",16001,6,1178,4,560,2,618,195.515904,5.546361999999988,807.7366749591912,891.3951162942503
"147.32.84.165",32234,"24.224.249.220",51413,8,1468,6,840,2,628,195.516025,2710.1709370000003,2.4795483961017766,1.8537576104189473
"147.32.84.165",32234,"90.213.141.130",57240,3,613,2,280,1,333,195.516127,0.26275799999999094,8524.954520890238,10138.606626630177
"147.32.84.165",32234,"92.152.30.51",63609,9,1518,6,768,3,750,195.535246,1979.0980720000002,3.1044444370516264,3.031684020558229
"147.32.84.165",32234,"14.46.98.119",14206,9,1227,6,696,3,531,195.846398,2879.1058639999997,1.933933749926189,1.475458076452308
"147.32.84.165",32234,"96.2.27.39",10100,3,613,2,280,1,333,195.866254,0.1743629999999996,12846.762214460667,15278.470776483578
"147.32.84.165",32234,"190.200.48.146",16056,3,594,2,280,1,314,195.886667,0.2726900000000114,8214.455975649662,9211.925629835692
"147.32.84.165",32234,"203.218.151.9",14147,12,2376,8,1120,4,1256,195.886794,2067.011916,4.334759722788168,4.861123403412446
"147.32.84.165",32234,"72.213.184.19",55632,4,560,4,560,0,0,196.156917,5.588166000000001,801.6941515337946,0
"147.32.84.165",32234,"121.24.21.25",16001,12,2356,8,1120,4,1236,196.15704,2715.816052,3.299192518359855,3.6408946006185547
"147.32.84.165",32234,"112.201.53.119",13481,3,613,2,280,1,333,196.186568,0.5813290000000109,3853.2397317181117,4582.602966650468
"147.32.84.165",32234,"78.131.107.6",20913,3,613,2,280,1,333,196.457475,0.07059800000001815,31728.944162716,37734.780022087245
"147.32.84.165",32234,"210.213.137.131",62755,4,560,4,560,0,0,196.677945,5.879818,761.9283454011671,0
"147.32.84.165",32234,"178.77.147.98",15432,3,594,2,280,1,314,196.91762,0.25490800000000036,8787.484111914875,9854.535754075967
"147.32.84.165",32234,"123.243.72.24",51413,8,1468,6,840,2,628,197.408665,1978.4811300000001,3.396544904120465,2.5393216664138714
"147.32.84.165",32234,"188.55.122.72",12626,8,1120,8,1120,0,0,200.944783,2701.55692,3.316606040638226,0
"147.32.84.165",32234,"93.74.9.20",63055,7,1173,6,840,1,333,200.971343,1980.306742,3.393413685605682,1.345246139650824
"147.32.84.165",32234,"210.25.133.29",3516,4,560,4,560,0,0,201.243942,5.359133999999983,835.9559585559932,0
"147.32.84.165",32234,"217.66.146.110",24767,4,560,4,560,0,0,201.505559,6.148341999999985,728.6517243185253,0
"147.32.84.165",32234,"24.6.237.196",1027,4,560,4,560,0,0,202.963445,5.612540999999993,798.2124317666464,0
"147.32.84.165",32234,"174.110.158.108",58810,4,560,4,560,0,0,203.588099,5.996238000000005,747.1351203871487,0
"147.32.84.165",32234,"67.213.96.186",39645,4,560,4,560,0,0,203.588207,5.996271999999976,747.1308839892549,0
"147.32.84.165",32234,"178.93.181.125",28038,8,1120,8,1120,0,0,203.588337,2718.033473,3.2965009772710774,0
"147.32.84.165",32234,"178.234.104.158",20001,3,603,2,280,1,323,203.588452,0.3036740000000009,7376.331197270736,8509.124916851599
"147.32.84.165",32234,"180.183.171.113",28424,6,1248,4,560,2,688,203.588548,1972.408408,2.271334872549377,2.790497129132092
"147.32.84.165",32234,"175.246.248.102",50667,4,560,4,560,0,0,203.598405,5.986360999999988,748.3678314755841,0
"147.32.84.165",32234,"178.59.23.6",28904,4,560,4,560,0,0,203.598523,5.986388000000005,748.3644561628809,0
"147.32.84.165",32234,"14.41.106.152",53804,4,560,4,560,0,0,203.598633,5.986709999999988,748.3242047802564,0
"147.32.84.165",32234,"220.176.3.238",27369,4,560,4,560,0,0,203.598731,5.999442000000016,746.7361131251853,0
"147.32.84.165",32234,"117.195.6.67",17716,8,1120,8,1120,0,0,203.598825,1988.6314039999997,4.505611236942933,0
"147.32.84.165",32234,"88.123.64.19",51413,8,1120,8,1120,0,0,204.099132,1997.1650739999998,4.486359248239087,0
"147.32.84.165",32234,"72.84.99.67",39606,4,560,4,560,0,0,204.09924,5.48595899999998,816.6302373021775,0
"147.32.84.165",32234,"88.177.18.169",18499,4,560,4,560,0,0,204.570331,6.049888999999979,740.5094539751086,0
"147.32.84.165",32234,"124.254.182.222",10592,4,560,4,560,0,0,204.57044,6.049880000000002,740.5105555812676,0
"147.32.84.165",32234,"110.169.230.81",1024,4,560,4,560,0,0,205.662222,6.004034999999988,746.1648707910613,0
"147.32.84.165",32234,"76.91.222.142",8142,8,1120,8,1120,0,0,205.66236,2716.7886660000004,3.2980114029966283,0
"147.32.84.165",32234,"187.51.153.4",10933,4,560,4,560,0,0,205.662476,6.0040679999999895,746.1607696648352,0
"147.32.84.165",32234,"24.246.40.171",64288,6,915,4,488,2,427,205.685605,1969.17839,1.982552733579409,1.734733641881983
"147.32.84.165",32234,"192.121.121.230",49001,6,624,4,416,2,208,206.137028,1990.0217429999998,1.672343536801246,0.836171768400623
"147.32.84.165",32234,"186.34.208.103",30576,6,644,4,416,2,228,206.341899,1990.411908,1.6720157202757249,0.9163932313049646
"147.32.84.165",32234,"118.100.121.41",16881,4,560,4,560,0,0,206.628324,5.882596000000007,761.5685319882574,0
"147.32.84.165",32234,"71.68.229.246",56206,4,560,4,560,0,0,210.620452,6.000164000000012,746.646258335604,0
"147.32.84.165",32234,"92.98.183.113",11145,4,560,4,560,0,0,210.620553,6.000157999999999,746.6470049622028,0
"147.32.84.165",7600,"124.238.251.179",7600,6,540,6,540,0,0,210.978619,9.431571999999989,458.0360516783422,0
"147.32.84.165",32234,"92.152.168.58",61109,4,560,4,560,0,0,211.681811,5.990350999999976,747.8693652508873,0
"147.32.84.165",32234,"112.205.94.236",44708,4,560,4,560,0,0,212.511046,5.981514000000004,748.9742563504819,0
"147.32.84.165",32234,"196.215.120.180",19342,4,560,4,560,0,0,213.565026,5.991219999999998,747.7608901025169,0
"147.32.84.165",32234,"92.35.6.85",38944,4,560,4,560,0,0,213.565142,5.991195000000005,747.7640103518575,0
"147.32.84.165",32234,"46.7.123.28",33478,4,560,4,560,0,0,213.565285,5.991151000000002,747.7695020539456,0
"147.32.84.165",32234,"93.94.219.50",62954,8,1120,8,1120,0,0,213.565402,1997.5834069999999,4.485419716945016,0
"147.32.84.165",32234,"77.68.216.74",16930,4,560,4,560,0,0,213.565503,5.999105999999983,746.777936579219,0
"147.32.84.165",32234,"213.166.156.186",26373,4,560,4,560,0,0,213.5656,5.999102000000022,746.7784345056949,0
"147.32.84.165",32234,"109.126.225.191",37981,8,1120,8,1120,0,0,213.565696,2003.611456,4.471924919958133,0
"147.32.84.165",32234,"90.150.241.58",49767,8,1506,6,840,2,666,213.565808,1967.823853,3.414939802541361,2.7075594148720787
"147.32.84.165",32234,"92.115.92.170",24201,8,1120,8,1120,0,0,213.565912,1987.6984790000001,4.5077259426730185,0
"147.32.84.165",32234,"86.121.96.1",1048,6,1206,4,560,2,646,213.574925,1962.0339880000001,2.2833447470329955,2.63400126175592
"147.32.84.165",32234,"68.127.103.81",56848,4,560,4,560,0,0,213.865703,5.69927899999999,786.0643425247313,0
"147.32.84.165",32234,"80.188.29.34",28138,8,1120,8,1120,0,0,213.865811,1973.438728,4.540298045676136,0
"147.32.84.165",32234,"69.133.110.198",20851,3,603,2,280,1,323,214.51742,0.20114300000000185,11136.355727019978,12846.581785098046
"147.32.84.165",32234,"59.8.105.146",57595,3,613,2,280,1,333,214.517531,0.5105489999999975,4387.433919173303,5217.912482445394
"147.32.84.165",32234,"95.137.141.78",11672,4,560,4,560,0,0,214.928378,6.699111999999985,668.7453501299889,0
"147.32.84.165",32234,"190.173.106.56",27108,4,560,4,560,0,0,215.129309,6.4982829999999865,689.4128802946885,0
"147.32.84.165",32234,"122.169.29.135",50965,4,560,4,560,0,0,215.544956,7.103930999999989,630.6367559031763,0
"147.32.84.165",32234,"112.203.95.173",45864,4,560,4,560,0,0,215.55842,7.09057199999998,631.824907778951,0
"147.32.84.165",32234,"99.43.234.113",29912,4,560,4,560,0,0,215.558555,7.090536999999983,631.8280265655493,0
"147.32.84.165",32234,"218.102.93.41",32794,9,909,6,624,3,285,215.558666,796.518808,6.2672719713104375,2.8624559484350556
"147.32.84.165",32234,"79.124.6.20",25522,10,1748,8,1120,2,628,216.620826,2684.863496,3.337227391019659,1.8712310728217372
"147.32.84.165",32234,"58.142.64.152",6881,4,560,4,560,0,0,221.627727,5.879432000000008,761.9783679784023,0
"147.32.84.165",32234,"27.251.20.254",59274,4,560,4,560,0,0,221.627831,5.879432000000008,761.9783679784023,0
"147.32.84.165",32234,"2.60.3.168",55629,3,603,2,280,1,323,222.664479,0.14442099999999414,15510.209734042079,17892.1348003414
"147.32.84.165",32234,"97.107.202.49",7675,4,560,4,560,0,0,223.066055,5.467873999999995,819.331242819422,0
"147.32.84.165",32234,"119.207.224.178",37509,4,560,4,560,0,0,223.671794,6.886966000000001,650.5041552404933,0
"147.32.84.165",32234,"123.195.171.63",16001,6,1178,4,560,2,618,223.671905,7.620621999999997,587.8785222518584,648.7659406279437
"147.32.84.165",32234,"212.45.77.126",26134,6,1188,4,560,2,628,223.672147,334.947002,13.375250332886992,14.999387873308985
"147.32.84.165",32234,"178.77.225.2",1601,8,1120,8,1120,0,0,223.672246,1967.5157169999998,4.55396616280245,0
"147.32.84.165",32234,"222.77.60.218",2059,4,560,4,560,0,0,223.67234,6.887057999999996,650.4954655529259,0
"147.32.84.165",32234,"94.179.155.18",35691,8,1120,8,1120,0,0,223.672452,1967.51589,4.553965762380704,0
"147.32.84.165",32234,"61.68.248.69",40824,6,768,6,768,0,0,223.672547,32.175611,190.95208479490876,0
"147.32.84.165",32234,"117.195.3.169",17716,4,560,4,560,0,0,223.672641,6.898497999999989,649.4167281051624,0
"147.32.84.165",32234,"180.98.190.214",4041,4,416,4,416,0,0,223.730511,10.873541999999986,306.0640221925849,0
"147.32.84.165",32234,"178.215.113.177",20513,4,560,4,560,0,0,224.60217,5.956788999999986,752.0830433980473,0
"147.32.84.165",32234,"79.11.130.30",31630,4,560,4,560,0,0,224.602293,5.956761,752.0865785953138,0
"147.32.84.165",32234,"122.236.151.118",4041,4,560,4,560,0,0,225.634217,5.998465999999979,746.8576132631268,0
"147.32.84.165",32234,"190.33.243.25",10000,4,416,4,416,0,0,244.532023,10.01378299999999,332.3419331135899,0
"147.32.84.165",32234,"66.91.22.232",38415,7,728,6,624,1,104,254.565544,1951.795669,2.5576447777228877,0.4262741296204813
"147.32.84.165",7600,"110.232.49.151",10744,2,180,2,180,0,0,254.695159,9.900000000584441e-05,0,0
"147.32.84.165",32234,"178.151.113.184",35691,5,530,4,416,1,114,254.986814,1981.517685,1.6795207154560419,0.46025327298554997
"147.32.84.165",32234,"114.77.119.245",51413,6,897,4,488,2,409,255.226857,1919.661826,2.0336915320834223,1.7044668783240158
"147.32.84.165",32234,"190.80.200.134",20008,4,416,4,416,0,0,264.494142,10.129466999999977,328.5464082167411,0
"147.32.84.165",32234,"94.237.231.213",43151,6,644,4,416,2,228,284.57447,1921.6737939999998,1.7318235854550037,0.9491725420282232
"147.32.84.165",32234,"82.154.202.59",52755,6,935,4,488,2,447,285.219356,1889.400771,2.0662635793959883,1.8926635655532924
"147.32.84.165",32234,"213.141.137.135",17507,6,935,4,488,2,447,285.540205,1889.031882,2.066667078094344,1.8930331637462539
"147.32.84.165",32234,"188.51.118.119",61436,4,416,4,416,0,0,285.629766,9.921479999999974,335.4338264049324,0
"147.32.84.165",32234,"98.166.212.42",65535,6,915,4,488,2,427,286.260596,1888.444555,2.0673098342566907,1.8088961049746044
"147.32.84.165",32234,"74.232.184.16",5000,8,852,6,624,2,228,286.471493,1929.9579560000002,2.58658484475296,0.9450983086597353
"147.32.84.165",32234,"98.154.217.142",11192,6,606,4,416,2,190,286.702338,1930.083964,1.724277317502235,0.7875305055899631
"147.32.84.165",32234,"178.45.153.4",36401,4,416,4,416,0,0,305.532103,9.934223999999972,335.00351914754583,0
"147.32.84.165",32234,"93.163.18.126",9089,6,915,4,488,2,427,325.487567,1849.098967,2.111298567395717,1.8473862464712525
"147.32.84.165",32234,"178.136.243.31",10001,6,935,4,488,2,447,325.688614,1849.027167,2.111380551716902,1.9339899725767524
"147.32.84.165",32234,"68.59.131.61",51413,6,897,4,488,2,409,326.112931,1848.5917319999999,2.111877886512153,1.7699960155398986
"147.32.84.165",7600,"112.235.183.44",7600,5,449,4,360,1,89,401.382112,0.0012580000000070868,0,0
"147.32.84.165",7600,"60.207.0.54",7600,6,540,6,540,0,0,672.754848,9.518835999999965,453.8370027595828,0
"147.32.84.165",32234,"90.9.154.44",36447,9,1518,6,768,3,750,874.957667,719.102307,8.543985939402639,8.34373626894789
"147.32.84.165",32234,"82.42.242.172",46658,12,1775,10,1328,2,447,874.957768,725.3559110000001,14.646602914358823,4.929993601444574
"147.32.84.165",32234,"60.26.225.3",42101,4,416,4,416,0,0,874.957885,9.328891999999996,356.74118641313476,0
"147.32.84.165",32234,"60.161.251.173",16881,17,3682,12,2814,5,868,875.187464,2649.698378,8.496061358120361,2.620675642803296
"147.32.84.165",32234,"194.44.188.91",35691,18,3186,16,2896,2,290,884.520022,2211.7727689999997,10.474855430322917,1.048932346268524
"147.32.84.165",32234,"41.145.40.71",17555,40,7674,34,6616,6,1058,884.740587,2876.8948250000003,18.39761382309136,2.9420609771509456
"147.32.84.165",32234,"183.83.19.45",25040,6,1206,4,560,2,646,894.266438,6.283356000000026,712.9947754034598,822.4904016261339
"147.32.84.165",32234,"95.26.68.100",27811,9,936,6,624,3,312,965.253867,1930.566988,2.585768860147939,1.2928844300739695
"147.32.84.165",32234,"188.51.152.93",35329,13,2891,10,2456,3,435,965.960779,2690.333254,7.303184455229575,1.2935200480557267
"147.32.84.165",32234,"88.114.156.129",16961,6,606,4,416,2,190,985.559049,613.755396,5.422355586100623,2.476556637882496
"147.32.84.165",32234,"82.157.154.107",7555,6,606,4,416,2,190,986.380045,613.276045,5.426593826928297,2.4784923728759045
"147.32.84.165",32234,"77.44.172.241",60987,12,2585,8,1848,4,737,986.580383,2110.323363,7.005561450536811,2.793884626106942
"147.32.84.165",32234,"66.177.130.139",10308,10,2066,8,1776,2,290,986.870319,1909.6732469999997,7.440016255304435,1.2148675191657017
"147.32.84.165",32234,"46.0.71.91",17112,12,2585,8,1848,4,737,1006.158738,2343.581235,6.308294237558187,2.515807820930944
"147.32.84.165",7600,"221.11.228.99",65023,5,449,4,360,1,89,1307.151125,0.027184999999917636,105940.77616364634,26190.914107123677
"147.32.84.165",32234,"85.248.45.192",28761,3,312,2,208,1,104,1645.200319,0.02459299999986797,67661.52970393743,33830.76485196871
"147.32.84.165",32234,"24.160.19.40",45028,3,613,2,280,1,333,2174.975334,0.16116399999964415,13898.885607238253,16529.74609717978
"147.32.84.165",32234,"117.198.83.101",15919,6,1188,4,560,2,628,2174.975442,33.62449199999992,133.23621365045489,149.41489673658154
"147.32.84.165",32234,"86.208.11.150",14503,3,594,2,280,1,314,2174.975537,0.17580399999997098,12741.462082776101,14288.639621398914
"147.32.84.165",32234,"217.211.245.37",17251,3,613,2,280,1,333,2174.975645,0.11391300000013871,19664.12964277363,23386.268468012924
"147.32.84.165",32234,"77.170.212.54",62811,4,560,4,560,0,0,2174.975741,5.298152999999729,845.5776947174287,0
"147.32.84.165",32234,"80.251.115.48",27737,3,613,2,280,1,333,2174.975846,0.068815000000086,32551.04265054422,38712.49000939723
"147.32.84.165",32234,"98.207.104.93",7195,3,594,2,280,1,314,2174.975943,0.30010300000003554,7464.103990962219,8370.45947557906
"147.32.84.165",32234,"188.230.166.49",15860,3,613,2,280,1,333,2174.995642,0.031189000000267697,71820.19301615229,85414.72955135255
"147.32.84.165",32234,"66.229.91.207",51856,3,613,2,280,1,333,2174.995749,0.223117000000002,10039.575648650618,11939.923896430913
"147.32.84.165",32234,"24.87.40.232",25783,3,594,2,280,1,314,2174.995861,0.17449600000009013,12836.970474961277,14395.745461206574
"147.32.84.165",32234,"188.226.113.152",49502,3,613,2,280,1,333,2174.995965,0.1147569999998268,19519.506435366737,23214.270153489728
"147.32.84.165",32234,"118.95.22.225",55749,3,613,2,280,1,333,2175.516188,0.7396009999997659,3028.660047783479,3601.9421282567805
"147.32.84.165",32234,"178.148.245.252",38643,3,613,2,280,1,333,2175.535749,0.11664599999994607,19203.40174546093,22838.331361566034
"147.32.84.165",32234,"114.239.188.235",11004,4,560,4,560,0,0,2175.535862,5.7416519999997035,780.2632413110776,0
"147.32.84.165",32234,"112.254.70.74",16001,6,1178,4,560,2,618,2175.536074,6.281930000000102,713.1566254319814,787.019275923151
"147.32.84.165",32234,"188.233.18.25",30293,4,560,4,560,0,0,2175.536262,5.74154899999985,780.2772387730414,0
"147.32.84.165",32234,"175.141.99.219",25074,6,1188,4,560,2,628,2175.555551,105.36579800000027,42.51854097854399,47.68150666879576
"147.32.84.165",32234,"122.109.106.112",19339,3,613,2,280,1,333,2175.55576,0.5069809999999961,4418.311534357337,5254.634789074976
"147.32.84.165",32234,"84.72.81.232",18338,5,893,4,560,1,333,2176.000503,5.487193999999818,816.4464387444929,485.49404303913593
"147.32.84.165",32234,"123.116.153.78",1580,4,560,4,560,0,0,2176.000621,5.2772799999997915,848.922172028048,0
"147.32.84.165",32234,"93.144.171.217",41386,4,560,4,560,0,0,2176.296556,6.01020200000039,745.3992394930668,0
"147.32.84.165",32234,"117.195.11.112",17716,4,560,4,560,0,0,2176.296682,6.0101709999999,745.403084205104,0
"147.32.84.165",32234,"83.227.20.81",50946,3,613,2,280,1,333,2176.537216,0.042388999999730004,52843.89818146849,62846.49319438931
"147.32.84.165",32234,"71.64.122.40",10531,4,560,4,560,0,0,2176.783124,5.523533999999927,811.0749386172076,0
"147.32.84.165",32234,"88.172.213.82",51413,4,560,4,560,0,0,2181.684293,5.620143000000098,797.1327419960527,0
"147.32.84.165",32234,"79.101.255.187",24724,4,560,4,560,0,0,2184.322114,5.834847000000082,767.8007666696209,0
"147.32.84.165",32234,"223.206.123.74",26775,4,560,4,560,0,0,2184.322223,5.8348369999998795,767.8020825603342,0
"147.32.84.165",32234,"99.17.249.169",47992,4,560,4,560,0,0,2184.322343,5.8348110000001725,767.8055038971901,0
"147.32.84.165",32234,"213.182.182.13",20613,4,560,4,560,0,0,2185.370413,5.817226000000119,770.1265173469121,0
"147.32.84.165",32234,"124.82.44.132",50828,4,560,4,560,0,0,2185.370607,5.817262000000028,770.1217514356373,0
"147.32.84.165",32234,"92.44.154.114",56092,4,560,4,560,0,0,2185.37084,5.817215999999917,770.1278412216539,0
"147.32.84.165",32234,"188.107.127.230",47302,4,560,4,560,0,0,2185.371025,5.817129000000023,770.139359123716,0
"147.32.84.165",32234,"97.107.202.49",8994,4,560,4,560,0,0,2185.371171,5.817078000000038,770.1461111575212,0
"147.32.84.165",32234,"95.71.244.6",34749,6,1226,4,560,2,666,2186.240791,20.97044599999981,213.63398756516864,254.07184949714699
"147.32.84.165",32234,"178.205.132.80",62938,4,560,4,560,0,0,2186.240937,5.98918999999978,748.0143391677612,0
"147.32.84.165",32234,"79.100.218.206",49435,4,560,4,560,0,0,2191.187765,5.95897100000002,751.8076526970823,0
"147.32.84.165",32234,"95.154.121.225",64984,4,560,4,560,0,0,2191.188453,5.978652999999667,749.33266740857,0
"147.32.84.165",32234,"87.15.9.179",60860,4,560,4,560,0,0,2194.293025,5.941037000000051,754.0771080873527,0
"147.32.84.165",32234,"189.69.169.173",45115,4,560,4,560,0,0,2194.293136,5.941036000000167,754.0772350142086,0
"147.32.84.165",32234,"178.162.239.194",54598,4,560,4,560,0,0,2194.293259,5.941009000000122,754.0806620558743,0
"147.32.84.165",32234,"74.56.255.218",51413,3,303,2,208,1,95,2194.312685,0.14364000000023225,11584.516847656012,5291.005290996736
"147.32.84.165",32234,"120.144.14.112",52308,4,560,4,560,0,0,2195.203952,6.059928000000127,739.2827109496856,0
"147.32.84.165",32234,"122.89.206.85",16881,3,624,2,280,1,344,2195.204081,1.4405420000002778,1554.9702820185514,1910.392060765649
"147.32.84.165",32234,"122.169.2.87",12641,4,560,4,560,0,0,2195.204179,6.059933000000001,739.2821009737236,0
"147.32.84.165",32234,"24.126.12.92",56785,3,613,2,280,1,333,2195.204277,0.14641100000017104,15299.396903220271,18195.354174186967
"147.32.84.165",32234,"81.154.74.68",47611,4,560,4,560,0,0,2195.204394,6.059905999999955,739.2853948559653,0
"147.32.84.165",32234,"85.98.65.172",13902,4,560,4,560,0,0,2195.204585,6.059896000000208,739.2866148197669,0
"147.32.84.165",32234,"189.120.34.53",56649,5,530,4,416,1,114,2195.204687,10.274265999999898,323.9160831537779,88.76546509502568
"147.32.84.165",32234,"188.35.11.47",59837,3,613,2,280,1,333,2196.155547,0.05035100000031889,44487.69637119051,52908.58175573729
"147.32.84.165",32234,"95.27.247.130",29596,3,613,2,280,1,333,2196.155679,0.056524999999965075,39628.48297216071,47129.58867760541
"147.32.84.165",32234,"79.116.131.161",50892,3,603,2,280,1,323,2196.175847,0.09343200000012075,23974.655364298153,27656.477438101083
"147.32.84.165",32234,"42.2.15.36",57043,3,322,2,208,1,114,2196.175973,0.3360230000002957,4952.041973312945,2714.099927681133
"147.32.84.165",32234,"79.183.217.135",63773,3,613,2,280,1,333,2196.425966,0.5186650000000554,4318.779944665171,5136.263291333935
"147.32.84.165",32234,"79.6.181.73",18404,5,883,4,560,1,323,2196.426182,5.895281999999952,759.9297200710732,438.31660639813686
"147.32.84.165",32234,"95.55.137.245",15527,8,976,8,976,0,0,2196.426324,29.713291000000027,262.77802751637284,0
"147.32.84.165",32234,"112.192.171.251",8015,6,1178,4,560,2,618,2196.92631,5.74254000000019,780.1425849884985,860.9430670051644
"147.32.84.165",32234,"78.63.74.32",36207,4,560,4,560,0,0,2197.166987,6.00019999999995,746.641778607386,0
"147.32.84.165",32234,"88.114.157.205",42221,4,560,4,560,0,0,2201.264003,5.998139000000265,746.8983296318745,0
"147.32.84.165",32234,"83.149.2.53",35570,4,560,4,560,0,0,2201.264594,5.997827999999572,746.9370578816731,0
"147.32.84.165",32234,"195.69.86.250",24201,4,560,4,560,0,0,2201.705422,5.556908000000021,806.2037377620761,0
"147.32.84.165",32234,"24.207.102.210",14015,4,560,4,560,0,0,2202.557026,5.747603000000254,779.455366002106,0
"147.32.84.165",32234,"24.6.237.196",14816,4,560,4,560,0,0,2204.189096,6.1406590000001415,729.5633905090474,0
"147.32.84.165",32234,"78.138.213.244",26681,4,560,4,560,0,0,2205.209535,5.939510000000155,754.2709752151075,0
"147.32.84.165",32234,"109.248.153.130",6881,4,560,4,560,0,0,2205.219531,5.929619000000002,755.5291495119667,0
"147.32.84.165",32234,"93.28.65.169",49103,4,560,4,560,0,0,2205.219736,5.92951499999981,755.5424010227048,0
"147.32.84.165",32234,"109.86.10.125",20989,4,560,4,560,0,0,2206.341096,5.8287820000000465,768.5996834329992,0
"147.32.84.165",32234,"94.50.195.81",39846,4,560,4,560,0,0,2212.170007,6.031860999999935,742.7226854199804,0
"147.32.84.165",32234,"65.26.239.50",29143,3,322,2,208,1,114,2236.274575,0.16291700000010678,10213.789843901553,5597.94251059989
"147.32.84.165",32234,"109.248.153.185",35691,10,1040,8,832,2,208,2324.29232,1441.4687170000002,4.617512625492516,1.154378156373129
"147.32.84.165",32234,"77.126.160.155",22651,9,936,6,624,3,312,2324.53301,1451.4225769999998,3.439384283464953,1.7196921417324764
"147.32.84.165",32234,"176.8.25.196",49088,15,2616,10,1984,5,632,2324.773201,1451.42823,10.935435643276692,3.4834653863663654
"147.32.84.165",32234,"92.113.133.157",33111,9,966,6,624,3,342,2325.013419,1452.003573,3.4380080688685744,1.8842928838991224
"147.32.84.165",32234,"95.37.20.133",10000,4,416,4,416,0,0,2344.982392,10.104795000000195,329.3485914360396,0
"147.32.84.165",32234,"92.241.165.234",61338,6,644,4,416,2,228,2365.302197,711.345718,4.678456502636879,2.5641540447144435
"147.32.84.165",32234,"91.149.71.18",57443,12,2274,8,1776,4,498,2365.53213,1365.846286,10.402341863526509,2.916872887407771
"147.32.84.165",32234,"84.215.144.204",55142,3,613,2,280,1,333,2895.130915,0.044879000000037195,49911.98556113424,59359.61139949179
"147.32.84.165",32234,"2.95.153.234",6881,3,603,2,280,1,323,2895.131027,0.11736300000029587,19086.08334819622,22017.160433812067
"147.32.84.165",32234,"94.21.25.147",39697,3,613,2,280,1,333,2895.131124,0.05280399999992369,42421.02871000752,50450.723430116086
"147.32.84.165",32234,"186.13.179.109",21512,3,594,2,280,1,314,2895.462285,0.4200999999998203,5332.063794336963,5979.528683649309
"147.32.84.165",32234,"99.246.144.251",38562,4,560,4,560,0,0,2895.462394,5.999167999999827,746.7702188036957,0
"147.32.84.165",32234,"216.252.84.122",48578,3,603,2,280,1,323,2895.462499,0.37298799999962284,6005.5551385091885,6927.836820494527
"147.32.84.165",32234,"24.218.225.166",57148,3,613,2,280,1,333,2895.462598,0.12299899999970876,18211.530175085194,21658.712672512036
"147.32.84.165",32234,"46.63.171.155",64387,3,613,2,280,1,333,2895.462693,0.1451640000000225,15430.823069078097,18351.65743572502
"147.32.84.165",32234,"111.164.134.64",2373,4,560,4,560,0,0,2895.802468,5.659196000000065,791.6318855187112,0
"147.32.84.165",32234,"116.126.99.248",52659,4,560,4,560,0,0,2895.802575,5.6816429999998945,788.5043111649364,0
"147.32.84.165",32234,"70.128.126.237",50828,3,603,2,280,1,323,2896.085736,0.4958689999998569,4517.32211531805,5211.053725884752
"147.32.84.165",32234,"178.65.186.196",54640,4,560,4,560,0,0,2905.527227,5.918622000000141,756.9329482436779,0
"147.32.84.165",32234,"109.165.120.190",15948,3,603,2,280,1,323,2905.546145,0.11797100000012506,18987.717320338266,21903.688194533068
"147.32.84.165",32234,"123.116.153.78",1572,3,603,2,280,1,323,2905.947807,0.43387299999994866,5162.801096173915,5955.65983594348
"147.32.84.165",32234,"188.230.95.143",35691,5,883,4,560,1,323,2905.947908,5.559158000000025,805.8774368348552,464.81859303153254
"147.32.84.165",32234,"210.213.137.131",63410,4,560,4,560,0,0,2906.57765,5.898811000000023,759.4750874371093,0
"147.32.84.165",32234,"176.45.35.30",45770,4,560,4,560,0,0,2906.577763,5.898793000000296,759.4774049538228,0
"147.32.84.165",7600,"112.234.148.154",2235,8,929,6,680,2,249,2910.141905,0.8745650000000751,6220.235202643066,2277.7037727325346
"147.32.84.165",32234,"112.104.122.243",30266,5,893,4,560,1,333,2911.646771,6.176663999999619,725.3106207493684,431.3007798384637
"147.32.84.165",32234,"58.195.14.212",9427,4,560,4,560,0,0,2915.430894,6.190821000000142,723.6520002758757,0
"147.32.84.165",32234,"58.111.72.119",11555,4,560,4,560,0,0,2916.453558,5.99757099999988,746.969064643018,0
"147.32.84.165",32234,"81.154.102.198",34465,3,613,2,280,1,333,2917.894057,0.07868099999996048,28469.389052009064,33858.237693996496
"147.32.84.165",32234,"178.79.3.207",64523,4,560,4,560,0,0,2918.094271,5.3793470000000525,832.8148379347821,0
"147.32.84.165",32234,"123.67.100.118",4041,4,560,4,560,0,0,2925.516147,6.0892430000003515,735.7236359264595,0
"147.32.84.165",32234,"78.176.0.136",26604,4,560,4,560,0,0,2925.516252,6.089242000000013,735.7237567500175,0
"147.32.84.165",32234,"182.113.244.145",16001,5,506,4,416,1,90,3056.305287,10.155541999999969,327.7028444173645,70.89724999414135
"147.32.84.165",32234,"67.169.60.76",17156,3,594,2,280,1,314,3074.80159,0.2812519999997676,7964.387808804386,8931.492042730633
"147.32.84.165",32234,"178.149.28.237",16950,6,935,4,488,2,447,3075.021885,99.96646999999984,39.05309450258678,35.77199434970551
"147.32.84.165",32234,"79.119.94.10",27135,7,872,6,768,1,104,3075.032057,99.43251200000032,61.79065454969076,8.367484470270623
"147.32.84.165",32234,"115.74.71.148",27031,3,613,2,280,1,333,3075.253057,0.34792300000026444,6438.2061548052225,7656.866605536211
"147.32.84.165",32234,"95.14.154.18",24159,3,613,2,280,1,333,3075.866789,0.1295949999998811,17284.6174621093,20556.34862457999
"147.32.84.165",32234,"207.204.187.236",12570,4,560,4,560,0,0,3076.074047,5.207090999999764,860.3652211955203,0
"147.32.84.165",32234,"125.27.129.182",27015,3,603,2,280,1,323,3076.324238,2.6337329999996655,850.5038285962489,981.1169165592443
"147.32.84.165",32234,"62.16.149.233",33452,6,606,4,416,2,190,3076.344163,701.1291509999996,4.746629055792892,2.1679315399054073
"147.32.84.165",32234,"123.116.153.78",1563,4,560,4,560,0,0,3079.137889,5.177889999999934,865.2172989383816,0
"147.32.84.165",32234,"195.24.143.134",37629,6,1226,4,560,2,666,3084.315896,20.913017999999738,214.22063520435242,254.76954115374772
"147.32.84.165",32234,"117.254.217.141",7163,6,1188,4,560,2,628,3084.316002,17.17748699999993,260.806484673807,292.47584352705496
"147.32.84.165",32234,"95.68.45.72",24956,3,613,2,280,1,333,3084.316098,0.05849000000034721,38297.144810851474,45546.24722147694
"147.32.84.165",32234,"85.105.198.26",24242,4,560,4,560,0,0,3084.545331,5.719817000000148,783.2418414784745,0
"147.32.84.165",32234,"83.83.42.20",4398,4,560,4,560,0,0,3085.388063,5.9170280000003,757.1368599235583,0
"147.32.84.165",32234,"218.9.51.203",16001,6,1178,4,560,2,618,3088.448028,6.5311970000002475,685.9385806307528,756.9822193389379
"147.32.84.165",32234,"62.122.105.24",42719,4,560,4,560,0,0,3094.379963,6.0087680000001455,745.5771299540756,0
"147.32.84.165",32234,"46.138.147.156",16011,4,560,4,560,0,0,3094.380071,6.008762999999817,745.5777503622853,0
"147.32.84.165",32234,"121.7.216.8",40825,4,560,4,560,0,0,3094.380169,6.008760000000166,745.5781226076389,0
"147.32.84.165",32234,"190.87.136.25",38679,4,560,4,560,0,0,3095.261284,6.150103999999828,728.4429661677469,0
"147.32.84.165",32234,"86.124.211.182",53381,3,613,2,280,1,333,3098.335308,0.05250899999964531,42659.35363490317,50734.1598586527
"147.32.84.165",32234,"112.222.10.181",55131,4,560,4,560,0,0,3098.545719,5.711291999999958,784.4109528982292,0
"147.32.84.165",32234,"90.180.206.206",13391,4,560,4,560,0,0,3104.257141,6.117780000000039,732.2917790440276,0
"147.32.84.165",32234,"83.26.110.164",60696,4,560,4,560,0,0,3104.25724,6.117780999999923,732.2916593451215,0
"147.32.84.165",32234,"92.112.130.127",25929,4,560,4,560,0,0,3104.257335,6.117782000000261,732.2915396462,0
"147.32.84.165",7600,"175.18.22.69",30947,2,180,2,180,0,0,3116.053655,7.999999979801942e-06,0,0
"147.32.84.165",7600,"113.167.233.61",10029,6,820,4,500,2,320,3126.090882,2.179022000000259,1835.685917810616,1174.8389873987942
"147.32.84.165",32234,"70.74.200.77",10444,3,322,2,208,1,114,3175.190791,0.17093000000022585,9734.979231251398,5335.517463282016
"147.32.84.165",32234,"188.4.244.80",4041,3,303,2,208,1,95,3175.416896,0.3507729999996627,4743.808673990301,2166.6433847551857
"147.32.84.165",32234,"95.84.234.99",56894,3,322,2,208,1,114,3176.028513,0.0524729999997362,31711.54689094135,17380.3670459967
"147.32.84.165",7600,"112.92.145.163",13245,2,180,2,180,0,0,3239.21691,7.999999979801942e-06,0,0
"147.32.84.165",7600,"112.234.216.135",26211,133,121294,116,119584,17,1710,3404.978553,3.082945000000109,310311.0824228023,4437.315618669654
"147.32.84.165",32234,"129.105.36.197",16881,3,624,2,280,1,344,3434.477756,0.19352799999978743,11574.552519544772,14220.164524012147
"147.32.84.165",32234,"111.253.47.115",9371,6,933,4,488,2,445,3434.895095,120.2649980000001,32.461647735611294,29.601297627760296
"147.32.84.165",32234,"72.53.81.66",51413,6,897,4,488,2,409,3434.89522,100.12352099999998,38.991836893151216,32.67963378954682
"147.32.84.165",32234,"41.34.96.82",27736,3,594,2,280,1,314,3435.215004,0.43085500000006505,5198.964848962323,5830.267723479177
"147.32.84.165",32234,"85.99.148.18",35929,4,560,4,560,0,0,3435.476042,5.447332000000188,822.4209576357464,0
"147.32.84.165",32234,"62.122.133.3",28610,3,613,2,280,1,333,3435.696503,0.074579999999969,30034.861893281457,35720.032180224014
"147.32.84.165",32234,"50.12.156.156",37773,5,893,4,560,1,333,3435.916123,6.338996999999836,706.736412716415,420.25575970458243
"147.32.84.165",32234,"88.132.171.233",48115,4,560,4,560,0,0,3436.61791,5.327426000000287,840.9314366825103,0
"147.32.84.165",32234,"79.133.155.238",35691,4,560,4,560,0,0,3442.346274,5.567066000000068,804.7326904333352,0
"147.32.84.165",32234,"188.232.44.199",37719,5,883,4,560,1,323,3443.959596,6.100304999999935,734.3895100327029,423.5853781081483
"147.32.84.165",32234,"195.43.40.130",35691,4,560,4,560,0,0,3443.959698,5.991420999999718,747.7358042441368,0
"147.32.84.165",32234,"115.117.199.6",29479,4,560,4,560,0,0,3444.979808,5.988502000000153,748.1002761625336,0
"147.32.84.165",32234,"68.149.39.6",26277,3,603,2,280,1,323,3446.060325,0.16096199999992677,13916.328077440756,16053.478460762015
"147.32.84.165",32234,"95.53.189.251",56642,4,560,4,560,0,0,3446.261237,5.729062999999769,781.9777858962592,0
"147.32.84.165",32234,"188.80.20.181",33585,4,560,4,560,0,0,3450.151611,5.777490000000398,775.4232374265799,0
"147.32.84.165",32234,"92.46.126.59",24042,4,560,4,560,0,0,3452.009258,5.968687999999929,750.5837128695708,0
"147.32.84.165",32234,"142.162.100.4",21089,3,613,2,280,1,333,3454.052875,0.26235300000007555,8538.114677550304,10154.257812943755
"147.32.84.165",32234,"59.94.237.195",37504,4,560,4,560,0,0,3454.473373,5.447290000000066,822.4272987118266,0
"147.32.84.165",32234,"62.205.129.67",62477,4,560,4,560,0,0,3454.883483,6.099515999999767,734.4845066395712,0
"147.32.84.165",32234,"89.176.44.198",27184,4,560,4,560,0,0,3455.938971,6.104185000000143,733.9227104027639,0
"147.32.84.165",32234,"174.89.160.38",51157,3,613,2,280,1,333,3459.920779,0.320100999999795,6997.791322118439,8322.373250948
"147.32.84.165",32234,"109.182.13.191",61991,8,976,8,976,0,0,3460.361217,84.4932530000001,92.40974542665545,0
"147.32.84.165",32234,"222.158.164.194",1042,4,560,4,560,0,0,3462.0433,5.855217000000266,765.1296271341944,0
"147.32.84.165",32234,"78.36.32.208",35691,3,613,2,280,1,333,3464.106233,0.11740099999997256,19079.905622614147,22691.459186894685
"147.32.84.165",32234,"83.192.42.220",8881,4,560,4,560,0,0,3464.307059,5.599303999999847,800.0994409305375,0
"147.32.84.165",32234,"24.214.248.23",14600,4,560,4,560,0,0,3464.927341,6.018420999999762,744.3812920365951,0
"147.32.84.165",32234,"95.96.56.252",51413,3,303,2,208,1,95,3555.209471,0.04483299999992596,37115.517587552655,16951.798898161065
"147.32.84.165",32234,"76.238.197.98",17927,3,312,2,208,1,104,3555.410256,0.16866699999991397,9865.59315100671,4932.796575503355
"147.32.84.165",32234,"60.223.56.83",39927,3,312,2,208,1,104,3555.629942,0.524829999999838,3170.550463960737,1585.2752319803685
"147.32.84.165",32234,"76.15.234.178",11562,3,322,2,208,1,114,3556.451477,0.10308299999996962,16142.331907302761,8847.239603040936
"147.32.84.165",32234,"59.126.160.42",3329,3,594,2,280,1,314,3614.284814,0.3808690000000752,5881.287266749349,6595.443577711771
"147.32.84.165",32234,"2.96.105.231",13798,3,603,2,280,1,323,3614.494354,0.0609230000000025,36767.72319156818,42414.194967416144
"147.32.84.165",32234,"77.37.163.73",48447,3,613,2,280,1,333,3614.695944,0.053452000000106636,41906.75746455757,49839.10798463454
"147.32.84.165",32234,"69.151.103.158",13139,3,603,2,280,1,323,3614.696044,0.1789450000001125,12517.812735748928,14440.191120167514
"147.32.84.165",32234,"114.41.192.69",26434,6,1188,4,560,2,628,3614.965372,49.08416899999975,91.27179070710199,102.35479386439293
"147.32.84.165",32234,"117.253.191.146",31668,3,603,2,280,1,323,3614.96548,0.5033430000003136,4450.245657530957,5133.676240651782
"147.32.84.165",32234,"207.67.149.91",25023,4,560,4,560,0,0,3615.626342,5.148201999999856,870.2067246001858,0
"147.32.84.165",32234,"209.202.3.210",7456,4,560,4,560,0,0,3620.152497,5.579253999999764,802.9747346150917,0
"147.32.84.165",32234,"188.131.103.210",10539,4,560,4,560,0,0,3623.798083,6.009283999999752,745.5131093821135,0
"147.32.84.165",32234,"92.114.197.235",1047,3,613,2,280,1,333,3623.798202,0.0876299999999901,25562.022138539916,30400.547757620687
"147.32.84.165",32234,"24.84.44.142",44991,4,560,4,560,0,0,3624.078421,5.729057999999895,781.9784683625269,0
"147.32.84.165",32234,"31.176.235.102",25229,3,613,2,280,1,333,3624.889854,0.4427860000000692,5058.877200272028,6016.450384609233
"147.32.84.165",32234,"220.95.56.154",58598,4,560,4,560,0,0,3624.889968,5.929364999999962,755.5615145972679,0
"147.32.84.165",32234,"79.100.131.7",22590,4,560,4,560,0,0,3625.512878,5.306574000000182,844.2358478370123,0
"147.32.84.165",32234,"180.168.144.122",16881,4,560,4,560,0,0,3629.807604,5.9406880000001365,754.1214081601149,0
"147.32.84.165",32234,"76.187.60.160",14807,4,560,4,560,0,0,3633.884549,5.912654000000202,757.6969665398731,0
"147.32.84.165",32234,"89.189.191.24",25564,4,560,4,560,0,0,3633.884668,5.912637999999788,757.6990169193786,0
"147.32.84.165",32234,"175.211.210.40",56052,4,560,4,560,0,0,3634.72708,6.073517999999694,737.6285045998424,0
"147.32.84.165",32234,"213.60.194.95",56031,4,560,4,560,0,0,3634.727199,6.073433000000023,737.6388279906905,0
"147.32.84.165",32234,"78.224.234.29",36518,3,322,2,208,1,114,3673.673278,0.3064479999998184,5429.95875320115,2976.0350858890915
"147.32.84.165",32234,"75.51.146.178",64844,3,322,2,208,1,114,3674.094609,0.20823299999983647,7991.048488958555,4379.7092679869
"147.32.84.165",32234,"187.24.212.160",63107,4,416,4,416,0,0,3674.515046,9.15023999999994,363.70630715697314,0
"147.32.84.165",32234,"109.182.79.228",43093,3,322,2,208,1,114,3693.77437,0.04411200000004101,37722.16177000483,20674.646354714187
"147.32.84.171",138,"147.32.84.165",138,1,230,1,230,0,0,175.736121,0,0,0
"147.32.84.171",137,"147.32.84.165",137,2,208,2,208,0,0,178.058145,1920.8096369999998,0.8663013595657008,0
"147.32.84.171",138,"147.32.84.191",138,1,230,1,230,0,0,463.544473,0,0,0
"147.32.84.171",137,"147.32.84.191",137,2,208,2,208,0,0,465.795691,1920.1125869999998,0.8666158491257263,0
"147.32.84.171",138,"147.32.84.192",138,1,230,1,230,0,0,615.816273,0,0,0
"147.32.84.171",137,"147.32.84.192",137,2,208,2,208,0,0,618.065941,1920.066154,0.8666368065149488,0
"147.32.84.191",137,"147.32.84.255",137,84,8304,84,8304,0,0,315.866898,2070.037193,32.09217700273465,0
"147.32.84.191",1025,"147.32.80.9",53,104,13084,72,5466,32,7618,317.012975,102.42094600000001,426.9439182879642,595.0345352209497
"147.32.84.191",123,"65.55.56.40",123,4,360,4,360,0,0,322.500367,3.0057280000000333,958.170533062196,0
"147.32.84.191",138,"147.32.84.255",138,28,6666,28,6666,0,0,325.494871,3318.371496,16.07053341203121,0
"147.32.84.191",1038,"239.255.255.250",1900,6,1050,6,1050,0,0,335.197938,6.028408999999954,1393.4024715310566,0
"147.32.84.191",1044,"147.32.80.9",53,110,14118,74,5568,36,8550,351.717163,1089.485531,40.88535251965636,62.78192601348094
"147.32.84.191",1151,"221.123.176.126",53,12,720,12,720,0,0,414.641779,0.7018060000000332,8207.396345998362,0
"147.32.84.191",1157,"221.123.176.74",10986,37,4033,34,3844,3,189,416.353047,3061.310431,10.04537131830653,0.4939061340166322
"147.32.84.191",1154,"221.123.176.39",3999,3,522,2,252,1,270,418.368116,0.3729060000000004,5406.188154655591,5792.344451416705
"147.32.84.191",1156,"221.123.176.75",9567,3,682,2,396,1,286,418.559836,0.4376949999999624,7237.916814220569,5227.384365825967
"147.32.84.191",1156,"221.123.176.75",9732,3,674,2,396,1,278,418.560237,0.43731800000000476,7244.156426216085,5085.54415779816
"147.32.84.191",29676,"58.48.111.62",82,258,21460,258,21460,0,0,418.575232,3328.637549,51.576657858581406,0
"147.32.84.191",7600,"221.123.176.136",5555,27,1861,24,1650,3,211,418.579158,9.79780999999997,1347.2398423729426,172.28339802466115
"147.32.84.191",29676,"67.215.242.138",6881,17,2422,12,1464,5,958,418.583876,2172.31357,5.391486828487658,3.5280357798436994
"147.32.84.191",29676,"221.123.176.138",554,6,624,6,624,0,0,418.584926,5.016876000000025,995.0415358083347,0
"147.32.84.191",1156,"221.123.176.20",8000,3,426,2,284,1,142,418.661062,0.3983159999999657,5704.01389851323,2852.006949256615
"147.32.84.191",1156,"221.123.176.72",8000,19,4378,16,3056,3,1322,419.059753,3150.703005,7.759538097117472,3.35671117944676
"147.32.84.191",1165,"147.32.80.9",53,3,372,2,152,1,220,419.434746,0.0005429999999932988,0,0
"147.32.84.191",1168,"147.32.80.9",53,3,372,2,152,1,220,419.435345,0.0003670000000397522,0,0
"147.32.84.191",1171,"117.79.93.14",4999,6,2244,4,2008,2,236,420.054594,0.8146340000000123,19719.284979511973,2317.6052067553915
"147.32.84.191",29676,"67.215.242.139",6881,11,1507,8,976,3,531,423.601437,2166.89392,3.6033143699069496,1.960409764775195
"147.32.84.191",29676,"85.246.137.217",23197,8,976,8,976,0,0,424.001877,9.704665000000034,804.5615175794294,0
"147.32.84.191",29676,"70.180.78.226",60228,9,1227,6,696,3,531,424.001991,2347.745773,2.3716366840201313,1.809395228756738
"147.32.84.191",29676,"99.74.180.45",12175,12,1794,8,976,4,818,424.002097,2547.290774,3.065217398694979,2.569003926365259
"147.32.84.191",29676,"183.91.8.47",12439,14,2369,10,1256,4,1113,424.002201,3246.5672640000003,3.0949612877018153,2.742589102875892
"147.32.84.191",29676,"189.90.114.12",6967,2,280,2,280,0,0,424.002317,8.999999977277184e-06,0,0
"147.32.84.191",29676,"122.152.86.246",20530,9,1491,6,768,3,723,424.403854,85.36460899999997,71.97362082452696,67.75641647933983
"147.32.84.191",29676,"95.68.143.116",18495,9,1257,6,696,3,561,424.403956,2347.637342,2.371746223484632,1.9117092404811475
"147.32.84.191",29676,"77.50.44.158",8995,5,874,4,560,1,314,424.404048,64.766164,69.17192131372795,38.785684450911745
"147.32.84.191",29676,"71.203.133.70",53047,3,603,2,280,1,323,424.604289,0.15842900000001237,14138.825593798012,16310.14523855985
"147.32.84.191",29676,"89.34.110.122",27333,3,594,2,280,1,314,424.604393,0.11225600000000213,19954.389965792096,22377.42303306685
"147.32.84.191",29676,"221.127.104.178",16881,3,624,2,280,1,344,424.804601,0.40689500000002,5505.105739809755,6763.415623194841
"147.32.84.191",29676,"83.5.4.66",30688,3,613,2,280,1,333,424.804722,0.141303999999991,15852.346713469844,18852.969484233778
"147.32.84.191",29676,"60.54.244.97",19501,4,560,4,560,0,0,425.005507,5.630309999999952,795.6933099598492,0
"147.32.84.191",29676,"222.75.243.10",16881,3,624,2,280,1,344,425.407548,0.5717469999999594,3917.8167965903785,4813.317778668179
"147.32.84.191",29676,"78.70.100.74",31815,4,560,4,560,0,0,426.210211,5.430413999999985,824.9831412485332,0
"147.32.84.191",7600,"221.123.176.44",10019,281,31514,172,12838,109,18676,428.396985,3388.979032,30.30529225180523,44.08643387558144
"147.32.84.191",29676,"189.106.109.26",29866,6,768,6,768,0,0,428.818817,19.79195999999996,310.4290833247446,0
"147.32.84.191",29676,"2.80.233.173",13874,9,1548,6,768,3,780,428.818926,2522.027874,2.4361348513787284,2.474199458431521
"147.32.84.191",29676,"120.6.154.200",9669,11,1465,8,976,3,489,428.819024,10.95109199999996,712.9882572441204,357.22464937743325
"147.32.84.191",29676,"74.68.22.123",10250,14,2365,10,1328,4,1037,428.819119,2883.28845,3.6846816349574736,2.8772702224780873
"147.32.84.191",29676,"77.78.161.102",24251,12,2085,8,1048,4,1037,428.819215,2881.230425,2.909867925610288,2.879325418757509
"147.32.84.191",29676,"177.18.112.5",26583,9,1257,6,696,3,561,428.819317,2523.139514,2.2067745240027974,1.7787363620194963
"147.32.84.191",29676,"94.68.144.117",41297,9,1257,6,696,3,561,428.819421,2542.1344369999997,2.1902854227374604,1.7654455778099356
"147.32.84.191",29676,"113.205.228.52",1284,8,976,8,976,0,0,428.819517,9.735445999999968,802.0176990350545,0
"147.32.84.191",29676,"206.116.134.182",60000,9,1200,6,696,3,504,428.819709,2542.956168,2.189577653782037,1.5855562320490613
"147.32.84.191",29676,"68.151.34.13",9090,6,1188,4,560,2,628,428.819811,2341.716123,1.9131268542749833,2.145435115151231
"147.32.84.191",29676,"88.191.116.31",12345,6,1188,4,560,2,628,428.819907,2341.542755,1.9132685023297813,2.145593963326969
"147.32.84.191",29676,"217.114.233.200",19424,6,1226,4,560,2,666,428.820002,2341.6005720000003,1.9132212613757422,2.2753667144218648
"147.32.84.191",29676,"178.140.37.82",47333,6,935,4,488,2,447,428.820093,2341.7606800000003,1.6671216804272242,1.5270561294077238
"147.32.84.191",29676,"87.202.37.190",24681,6,935,4,488,2,447,428.820184,2342.025561,1.6669331304535664,1.5268834207228366
"147.32.84.191",29676,"94.175.87.108",6112,6,768,6,768,0,0,428.820287,19.79077699999999,310.44763932209446,0
"147.32.84.191",29676,"121.216.116.77",45807,11,1828,8,1048,3,780,428.820382,2161.6598980000003,3.8785009648173614,2.8866705654175018
"147.32.84.191",29676,"60.229.71.159",22115,8,976,8,976,0,0,428.820478,9.734634000000028,802.0845981471905,0
"147.32.84.191",29676,"94.23.238.184",53000,9,1518,6,768,3,750,429.0192,44.583282,137.80950446851355,134.57959420753278
"147.32.84.191",29676,"124.129.130.12",62323,9,1491,6,768,3,723,429.019314,2522.528651,2.4356512254337916,2.2929372864435305
"147.32.84.191",29676,"122.82.8.185",16881,3,624,2,280,1,344,429.019431,0.713766000000021,3138.283415012671,3855.605338444139
"147.32.84.191",29676,"184.148.101.30",17122,3,613,2,280,1,333,429.019532,0.13937299999997776,16071.979508228691,19114.175629429123
"147.32.84.191",29676,"89.215.31.126",16960,6,1188,4,560,2,628,429.019635,2341.6193399999997,1.913205926971888,2.14552378953276
"147.32.84.191",29676,"193.201.98.4",46747,4,560,4,560,0,0,429.019732,5.636212,794.8600939780122,0
"147.32.84.191",29676,"174.1.229.199",38485,9,1548,6,768,3,780,429.21969,2521.494431,2.4366502358537234,2.4747228957889376
"147.32.84.191",29676,"85.90.186.182",50606,3,613,2,280,1,333,429.219863,0.2098450000000298,10674.545497865956,12695.08446710487
"147.32.84.191",29676,"175.181.197.169",46155,3,613,2,280,1,333,429.22001,0.36503199999998515,6136.448311381169,7297.990313178319
"147.32.84.191",29676,"222.158.168.86",15896,4,560,4,560,0,0,429.220179,5.43587100000002,824.1549514328032,0
"147.32.84.191",29676,"74.130.66.251",57438,4,560,4,560,0,0,429.220324,5.435833000000002,824.1607128107133,0
"147.32.84.191",29676,"222.221.44.22",43974,5,869,4,560,1,309,429.220472,5.435796000000039,824.1663226508074,454.7632030341062
"147.32.84.191",7600,"218.59.159.246",37218,3,268,2,178,1,90,429.396313,1.3914209999999798,1023.4141931162608,517.4566144969858
"147.32.84.191",7600,"218.247.141.243",7600,17,4018,12,1412,5,2606,429.396411,1.6637309999999843,6789.5591294506785,12530.871877725544
"147.32.84.191",7600,"113.96.152.57",25177,2,178,2,178,0,0,429.396512,1.4000000021496817e-05,0,0
"147.32.84.191",7600,"222.185.238.58",12539,22,6426,16,1784,6,4642,429.39662,1.0722939999999994,13309.78257828544,34632.293009193396
"147.32.84.191",7600,"110.7.48.70",16660,2,178,2,178,0,0,429.396719,5.999999984851456e-06,0,0
"147.32.84.191",7600,"59.48.59.202",41918,2,178,2,178,0,0,429.396832,6.999999982326699e-06,0,0
"147.32.84.191",7600,"117.95.26.132",7600,17,4834,12,1290,5,3544,429.396934,0.8190890000000195,12599.36343913757,34614.06513821981
"147.32.84.191",7600,"222.243.197.38",18029,2,178,2,178,0,0,429.397031,7.999999979801942e-06,0,0
"147.32.84.191",7600,"202.127.20.25",33982,25,10536,16,1662,9,8874,429.397132,0.9295399999999745,14303.849215741511,76373.25989199168
"147.32.84.191",7600,"121.17.178.99",29233,8,1068,6,818,2,250,429.397229,1.0723280000000273,6102.610395326647,1865.1009765668239
"147.32.84.191",7600,"61.190.33.222",12194,18,7114,10,1214,8,5900,429.397332,1.5848970000000122,6127.843008094485,29781.11511347402
"147.32.84.191",7600,"1.202.133.61",7600,2,178,2,178,0,0,429.397428,4.9999999873762135e-06,0,0
"147.32.84.191",7600,"125.211.74.26",1134,3,268,2,178,1,90,429.397524,14.947353000000021,95.26770392055356,48.16906378005517
"147.32.84.191",7600,"219.147.222.82",7600,2,178,2,178,0,0,429.397626,5.999999984851456e-06,0,0
"147.32.84.191",7600,"112.254.100.88",7600,8,1068,6,818,2,250,429.397724,1.256418999999994,5208.453549333488,1591.8256568867628
"147.32.84.191",7600,"116.54.223.86",7600,2,178,2,178,0,0,429.397841,7.999999979801942e-06,0,0
"147.32.84.191",7600,"58.17.91.177",7600,21,8410,12,1412,9,6998,429.397951,1.2169450000000097,9282.260085706346,46003.722436099866
"147.32.84.191",7600,"49.140.2.102",7600,39,16162,24,2576,15,13586,429.398051,2.247318000000007,9170.0418009378,48363.42698274105
"147.32.84.191",7600,"222.90.74.85",18855,2,178,2,178,0,0,429.39815,5.999999984851456e-06,0,0
"147.32.84.191",7600,"123.184.243.39",47388,2,178,2,178,0,0,429.398249,4.9999999873762135e-06,0,0
"147.32.84.191",7600,"113.9.190.57",29781,5,3472,2,178,3,3294,429.398412,2.322338000000002,613.1751708838243,11347.185465681558
"147.32.84.191",7600,"58.46.13.7",7600,5,446,4,356,1,90,429.398513,4.606767000000048,618.2209779656689,156.29182027221967
"147.32.84.191",7600,"219.217.52.17",7600,45,20732,26,2754,19,17978,429.398622,4.606885000000034,4782.407201395267,31219.35971920266
"147.32.84.191",7600,"124.235.104.26",7600,16,3646,12,1270,4,2376,429.398719,5.049767999999972,2011.9736193821293,3764.133322560582
"147.32.84.191",7600,"121.28.55.234",7600,19,4126,14,1590,5,2536,429.398817,5.10723200000001,2490.5858985845903,3972.4061879311453
"147.32.84.191",7600,"112.227.84.98",7600,22,6604,14,1712,8,4892,429.398917,2.5293589999999995,5414.8106298868615,15472.694860634654
"147.32.84.191",7600,"219.157.79.14",47110,7,766,6,676,1,90,429.399015,0.9939269999999851,5441.043456913919,724.3992768080661
"147.32.84.191",7600,"123.137.151.88",62757,17,4956,12,1412,5,3544,429.399112,1.0011789999999792,11282.697699412627,28318.612356032827
"147.32.84.191",7600,"202.127.20.52",31452,22,11262,12,1290,10,9972,429.399211,1.98738400000002,5192.755904243919,40141.210757457644
"147.32.84.191",7600,"121.30.232.18",33325,12,1464,10,1214,2,250,429.399309,1.06983299999996,9078.05236892147,1869.4506525785564
"147.32.84.191",7600,"147.32.84.165",7600,10895,10625667,1341,149969,9554,10475698,429.399624,5.711069000000009,210074.85638853218,14674237.695254577
"147.32.84.191",29676,"201.10.94.209",19869,4,560,4,560,0,0,429.422629,5.233106000000021,856.0881434467374,0
"147.32.84.191",29676,"216.110.98.73",51413,5,874,4,560,1,314,429.630055,7.932534999999973,564.7627145672872,316.67052209665746
"147.32.84.191",29676,"213.93.14.163",6881,3,603,2,280,1,323,429.630357,0.03498899999999594,64020.12060934179,73851.78198863356
"147.32.84.191",29676,"84.43.155.205",11290,5,893,4,560,1,333,429.630564,6.09504800000002,735.0229235274252,437.0761313118439
"147.32.84.191",29676,"109.201.69.11",51413,3,603,2,280,1,323,429.630677,0.08574700000002622,26123.362916478887,30135.16507865243
"147.32.84.191",29676,"77.50.37.119",44285,6,624,4,416,2,208,429.631243,2521.764169,1.3197110344064056,0.6598555172032028
"147.32.84.191",29676,"116.55.87.207",16001,4,560,4,560,0,0,429.83418,5.82548300000002,769.0349452568971,0
"147.32.84.191",29676,"64.183.30.88",40896,4,560,4,560,0,0,429.834288,5.825518999999986,769.0301928463389,0
"147.32.84.191",29676,"123.116.153.78",1574,9,1443,8,1120,1,323,429.834407,2372.3289990000003,3.776879178131228,1.089224977264631
"147.32.84.191",7600,"221.193.216.228",61256,6,536,4,356,2,180,430.390685,5.731448,496.9075877509488,251.24540953699656
"147.32.84.191",7600,"180.112.12.135",7600,23,5436,18,1962,5,3474,430.390795,3.931927999999971,3991.93474549893,7068.288127351317
"147.32.84.191",7600,"218.29.210.178",64317,2,178,2,178,0,0,430.390899,1.9999999949504854e-06,0,0
"147.32.84.191",7600,"117.32.153.172",60102,2,178,2,178,0,0,430.390997,6.999999982326699e-06,0,0
"147.32.84.191",7600,"125.77.120.41",45937,4,356,4,356,0,0,430.391097,3.617611000000011,787.2598795171707,0
"147.32.84.191",7600,"221.11.161.85",3948,21,10408,10,1214,11,9194,430.391194,1.3123540000000276,7400.442258719671,56045.85348160516
"147.32.84.191",7600,"71.9.108.6",63468,55,35606,22,2256,33,33350,430.3913,0.7294190000000071,24742.980372049293,365770.5653403563
"147.32.84.191",7600,"221.203.55.198",21770,2,178,2,178,0,0,430.391399,6.000000041694875e-06,0,0
"147.32.84.191",7600,"211.147.147.10",46178,36,19856,16,1788,20,18068,430.391497,4.001421999999991,3574.729183775176,36123.15821725385
"147.32.84.191",7600,"218.87.253.131",18649,4,356,4,356,0,0,430.391609,3.6172980000000052,787.3280000707699,0
"147.32.84.191",7600,"218.242.176.202",50218,6,536,4,356,2,180,430.391708,5.389601000000027,528.425016991051,267.1811883662617
"147.32.84.191",7600,"14.136.42.123",7600,4,356,4,356,0,0,430.39182,3.617381000000023,787.3099350054589,0
"147.32.84.191",7600,"123.203.12.1",7600,2,178,2,178,0,0,430.391918,7.000000039170118e-06,0,0
"147.32.84.191",7600,"123.163.207.90",7600,2,178,2,178,0,0,430.392019,6.999999982326699e-06,0,0
"147.32.84.191",7600,"14.198.178.180",7600,4,356,4,356,0,0,430.392119,3.6171810000000164,787.3534666913232,0
"147.32.84.191",7600,"75.76.69.212",7600,2,178,2,178,0,0,430.392218,9.999999974752427e-06,0,0
"147.32.84.191",7600,"168.70.71.225",7600,4,356,4,356,0,0,430.392323,3.617078000000049,787.3758873875436,0
"147.32.84.191",7600,"113.255.1.77",7600,4,356,4,356,0,0,430.392424,3.6170769999999948,787.3761050704766,0
"147.32.84.191",7600,"61.50.187.136",57140,4,356,4,356,0,0,430.392524,3.6170759999999973,787.3763227535176,0
"147.32.84.191",7600,"60.178.67.193",1040,2,178,2,178,0,0,430.392623,6.999999982326699e-06,0,0
"147.32.84.191",7600,"124.200.52.157",21101,2,178,2,178,0,0,430.392737,6.999999982326699e-06,0,0
"147.32.84.191",7600,"61.189.183.111",11036,2,178,2,178,0,0,430.393034,5.999999984851456e-06,0,0
"147.32.84.191",7600,"14.136.14.237",7600,2,178,2,178,0,0,430.393135,7.000000039170118e-06,0,0
"147.32.84.191",7600,"61.163.70.129",63141,21,10408,10,1214,11,9194,430.393234,1.1525649999999814,8426.422804787719,63815.92361385361
"147.32.84.191",7600,"222.16.30.81",7600,2,178,2,178,0,0,430.393417,6.999999982326699e-06,0,0
"147.32.84.191",7600,"220.178.76.98",7600,2,178,2,178,0,0,430.393518,6.000000041694875e-06,0,0
"147.32.84.191",7600,"123.5.50.48",5439,22,10446,12,1412,10,9034,430.393616,1.1993170000000077,9418.694140081336,60260.965199358914
"147.32.84.191",7600,"60.170.30.9",13350,2,178,2,178,0,0,430.393714,7.000000039170118e-06,0,0
"147.32.84.191",29676,"85.156.129.114",23105,3,603,2,280,1,323,431.239608,0.36727200000001403,6099.02197826111,7035.657496351209
"147.32.84.191",7600,"218.56.166.158",13581,3,268,2,178,1,90,431.386473,0.5595299999999952,2544.9931192250856,1286.7942737654928
"147.32.84.191",7600,"222.133.178.34",7600,2,178,2,178,0,0,431.386572,5.999999984851456e-06,0,0
"147.32.84.191",7600,"119.247.248.3",1536,2,178,2,178,0,0,431.386742,1.9999999949504854e-06,0,0
"147.32.84.191",7600,"116.236.217.138",41173,112,60150,60,5938,52,54212,431.386831,4.270297000000028,11124.284797989389,101561.08579801292
"147.32.84.191",7600,"218.28.77.140",4955,166,119498,60,5994,106,113504,431.386922,3.926288999999997,12213.059201704215,231269.7817200926
"147.32.84.191",7600,"221.202.225.87",7091,2,178,2,178,0,0,431.387015,5.999999984851456e-06,0,0
"147.32.84.191",7600,"117.57.65.37",9670,2,178,2,178,0,0,431.387106,4.9999999873762135e-06,0,0
"147.32.84.191",7600,"61.163.195.84",10541,2,178,2,178,0,0,431.387196,4.9999999873762135e-06,0,0
"147.32.84.191",7600,"140.109.58.74",7600,2,178,2,178,0,0,431.387286,4.9999999873762135e-06,0,0
"147.32.84.191",7600,"119.189.196.33",7600,2,178,2,178,0,0,431.387376,4.9999999873762135e-06,0,0
"147.32.84.191",7600,"118.125.99.154",7600,3,268,2,178,1,90,431.387643,0.6394109999999955,2227.0495815680524,1126.0363052872176
"147.32.84.191",7600,"180.208.69.222",51454,2,178,2,178,0,0,431.387734,2.999999992425728e-06,0,0
"147.32.84.191",7600,"222.243.158.17",7600,2,178,2,178,0,0,431.387996,5.999999984851456e-06,0,0
"147.32.84.191",7600,"121.15.124.209",21454,112,59026,62,6072,50,52954,431.388088,4.419905000000028,10990.281465325541,95846.40393854557
"147.32.84.191",7600,"89.249.132.125",7600,3,268,2,178,1,90,431.388177,0.17111900000003288,8321.694259548773,4207.598221120165
"147.32.84.191",7600,"114.249.150.185",11955,2,178,2,178,0,0,431.388266,4.9999999873762135e-06,0,0
"147.32.84.191",7600,"218.76.254.13",7600,2,178,2,178,0,0,431.388354,4.9999999873762135e-06,0,0
"147.32.84.191",7600,"222.83.220.242",57629,191,118944,88,8734,103,110210,431.388443,4.414760000000001,15826.907917984212,199711.87561724754
"147.32.84.191",7600,"218.89.50.116",7600,2,178,2,178,0,0,431.388532,4.9999999873762135e-06,0,0
"147.32.84.191",7600,"118.253.114.174",7600,3,268,2,178,1,90,431.38865499999997,1.4596820000000434,975.554949639687,493.2581206043361
"147.32.84.191",7600,"218.60.51.89",31160,2,178,2,178,0,0,431.388748,4.9999999873762135e-06,0,0
"147.32.84.191",7600,"121.22.42.22",7600,2,178,2,178,0,0,431.388839,4.9999999873762135e-06,0,0
"147.32.84.191",7600,"110.187.76.160",7600,84,45406,44,4370,40,41036,431.388929,3.7164569999999912,9406.808689028308,88333.592989237
"147.32.84.191",7600,"123.97.153.139",1880,53,26348,30,3040,23,23308,431.389019,4.1737529999999765,5826.890091483645,44675.37968825684
"147.32.84.191",7600,"222.74.115.68",13484,2,178,2,178,0,0,431.389109,3.999999989900971e-06,0,0
"147.32.84.191",7600,"113.83.16.230",1593,3,268,2,178,1,90,431.389199,0.5876759999999877,2423.103887175978,1225.1648867743709
"147.32.84.191",7600,"59.44.159.230",7600,2,178,2,178,0,0,431.389288,4.9999999873762135e-06,0,0
"147.32.84.191",7600,"117.136.9.74",61265,2,178,2,178,0,0,431.38938,4.9999999873762135e-06,0,0
"147.32.84.191",7600,"60.171.199.30",7600,2,178,2,178,0,0,431.38947,6.999999982326699e-06,0,0
"147.32.84.191",29676,"91.73.102.192",27757,3,613,2,280,1,333,431.640741,0.14850899999999,15083.260947149,17938.306769287916
"147.32.84.191",29676,"178.129.69.194",34356,3,613,2,280,1,333,431.841084,0.10633199999995213,21066.094872672464,25053.605687856892
"147.32.84.191",7600,"113.68.224.179",18647,2,178,2,178,0,0,431.973463,5.000000044219632e-06,0,0
"147.32.84.191",7600,"222.89.163.158",7600,2,178,2,178,0,0,431.99712,6.999999982326699e-06,0,0
"147.32.84.191",29676,"122.89.13.255",16001,5,869,4,560,1,309,432.042152,5.508145000000013,813.3409705082181,448.7899283697132
"147.32.84.191",7600,"222.168.32.43",7600,2,178,2,178,0,0,432.046675,1.6000000016447302e-05,0,0
"147.32.84.191",7600,"183.179.171.167",7600,51,19226,34,3444,17,15782,432.402638,1.8581629999999905,14827.547421835512,67946.67636800466
"147.32.84.191",7600,"58.246.92.86",7600,2,178,2,178,0,0,432.402791,9.000000034120603e-06,0,0
"147.32.84.191",7600,"119.247.67.79",7600,2,178,2,178,0,0,432.402944,1.1000000029071089e-05,0,0
"147.32.84.191",7600,"111.240.100.103",7600,93,65342,34,3444,59,61898,432.40399,2.0296679999999583,13574.63388100939,243972.90591368155
"147.32.84.191",7600,"173.71.91.244",7600,2,178,2,178,0,0,432.40408,8.999999977277184e-06,0,0
"147.32.84.191",7600,"219.146.155.151",14521,50,16978,26,2652,24,14326,432.404184,2.517374000000018,8427.829952958857,45526.806902748336
"147.32.84.191",7600,"182.99.78.102",21693,73,43382,34,3444,39,39938,432.404288,1.956124999999986,14084.989456195386,163335.16518627506
"147.32.84.191",7600,"219.138.156.254",23395,2,178,2,178,0,0,432.404388,6.000000041694875e-06,0,0
"147.32.84.191",7600,"114.36.12.114",7600,2,178,2,178,0,0,432.404486,5.999999984851456e-06,0,0
"147.32.84.191",7600,"59.175.226.15",2283,2,178,2,178,0,0,432.404583,6.999999982326699e-06,0,0
"147.32.84.191",7600,"218.3.215.50",48202,2,178,2,178,0,0,432.404683,1.3000000024021574e-05,0,0
"147.32.84.191",7600,"58.250.10.59",54286,2,178,2,178,0,0,432.404791,7.000000039170118e-06,0,0
"147.32.84.191",7600,"222.184.78.134",33980,2,178,2,178,0,0,432.404891,5.999999984851456e-06,0,0
"147.32.84.191",7600,"61.209.253.11",22993,118,84800,42,4236,76,80564,432.404992,2.0585080000000175,16462.40869600687,313096.6700153677
"147.32.84.191",7600,"59.48.47.86",7600,2,178,2,178,0,0,432.405091,6.999999982326699e-06,0,0
"147.32.84.191",7600,"118.160.158.81",7600,2,178,2,178,0,0,432.405246,7.000000039170118e-06,0,0
"147.32.84.191",7600,"122.206.190.88",21297,2,178,2,178,0,0,432.405345,5.999999984851456e-06,0,0
"147.32.84.191",7600,"222.75.213.202",11988,56,27628,32,3222,24,24406,432.405442,2.247993000000008,11466.227875264694,86854.36298066733
"147.32.84.191",7600,"121.26.221.182",42811,2,178,2,178,0,0,432.40554,6.000000041694875e-06,0,0
"147.32.84.191",7600,"117.69.61.17",61858,56,25654,34,3444,22,22210,432.405637,2.0197239999999965,13641.4678441213,87972.4160330819
"147.32.84.191",7600,"221.224.10.147",1305,2,178,2,178,0,0,432.405736,5.999999984851456e-06,0,0
"147.32.84.191",7600,"124.119.3.114",13003,2,178,2,178,0,0,432.405836,5.999999984851456e-06,0,0
"147.32.84.191",7600,"112.2.9.200",7600,2,178,2,178,0,0,432.405933,5.999999984851456e-06,0,0
"147.32.84.191",7600,"218.14.17.168",43007,2,178,2,178,0,0,432.406037,6.999999982326699e-06,0,0
"147.32.84.191",7600,"87.120.254.94",7600,281,205776,100,9922,181,195854,432.406136,2.016664999999989,39360.03252895272,776942.1297042436
"147.32.84.191",7600,"114.40.101.141",7600,2,178,2,178,0,0,432.406234,6.000000041694875e-06,0,0
"147.32.84.191",7600,"58.20.233.62",15696,2,178,2,178,0,0,432.406333,5.999999984851456e-06,0,0
"147.32.84.191",7600,"121.33.190.182",7600,2,178,2,178,0,0,432.406431,5.999999984851456e-06,0,0
"147.32.84.191",7600,"61.49.54.199",1188,2,178,2,178,0,0,432.406528,6.000000041694875e-06,0,0
"147.32.84.191",7600,"60.216.37.114",12554,2,178,2,178,0,0,432.406627,5.999999984851456e-06,0,0
"147.32.84.191",7600,"111.14.46.38",7600,2,178,2,178,0,0,432.863782,8.999999977277184e-06,0,0
"147.32.84.191",29676,"95.42.248.161",19218,4,560,4,560,0,0,433.706178,5.851842999999974,765.5707783001047,0
"147.32.84.191",29676,"95.59.128.250",33243,4,560,4,560,0,0,433.706296,5.851829000000009,765.5726098626589,0
"147.32.84.191",29676,"114.161.80.252",57542,4,560,4,560,0,0,433.706403,5.851816999999983,765.5741797804021,0
"147.32.84.191",7600,"218.14.17.167",46799,2,178,2,178,0,0,434.005392,1.0000000031595846e-05,0,0
"147.32.84.191",7600,"128.208.152.139",7600,2,178,2,178,0,0,434.005603,5.999999984851456e-06,0,0
"147.32.84.191",7600,"202.82.119.59",8035,2,178,2,178,0,0,434.005709,5.999999984851456e-06,0,0
"147.32.84.191",7600,"119.145.141.50",39101,2,178,2,178,0,0,434.005814,1.1000000029071089e-05,0,0
"147.32.84.191",7600,"61.133.100.198",29652,3,268,2,178,1,90,434.005939,0.4814159999999674,2957.940741479503,1495.5880153548048
"147.32.84.191",7600,"124.68.0.212",24302,2,178,2,178,0,0,434.006041,6.000000041694875e-06,0,0
"147.32.84.191",7600,"123.97.209.210",7600,2,178,2,178,0,0,434.006146,6.999999982326699e-06,0,0
"147.32.84.191",7600,"218.66.78.211",18570,2,178,2,178,0,0,434.006252,9.999999974752427e-06,0,0
"147.32.84.191",7600,"218.22.56.106",25859,2,178,2,178,0,0,434.006408,7.999999979801942e-06,0,0
"147.32.84.191",7600,"124.16.131.244",7600,2,178,2,178,0,0,434.006655,7.999999979801942e-06,0,0
"147.32.84.191",7600,"58.241.40.74",43431,2,178,2,178,0,0,434.006767,7.999999979801942e-06,0,0
"147.32.84.191",7600,"218.58.174.166",7600,2,178,2,178,0,0,434.008082,9.999999974752427e-06,0,0
"147.32.84.191",7600,"119.97.196.169",46499,2,178,2,178,0,0,434.008188,5.999999984851456e-06,0,0
"147.32.84.191",7600,"119.97.196.169",14711,2,178,2,178,0,0,434.008288,5.999999984851456e-06,0,0
"147.32.84.191",7600,"112.2.11.117",22060,3,268,2,178,1,90,434.009098,32.50563699999998,43.80778632333835,22.15000432078905
"147.32.84.191",29676,"183.106.67.25",24980,4,560,4,560,0,0,434.654885,5.906706000000042,758.4599605939364,0
"147.32.84.191",29676,"79.31.6.111",13833,4,560,4,560,0,0,435.057127,5.504576000000043,813.8683161064477,0
"147.32.84.191",29676,"121.137.144.214",21018,6,935,4,488,2,447,435.057276,2156.38643,1.8104361749299267,1.6583298569542566
"147.32.84.191",29676,"82.229.213.41",6881,6,1206,4,560,2,646,435.257237,23.060090000000002,194.27504402628088,224.11014007317402
"147.32.84.191",29676,"108.95.8.107",20030,3,613,2,280,1,333,435.457539,0.15888799999999037,14097.980967726548,16766.527365189075
"147.32.84.191",29676,"122.61.129.22",22985,4,560,4,560,0,0,435.659187,5.905926000000022,758.5601309599855,0
"147.32.84.191",29676,"178.150.24.161",47479,3,613,2,280,1,333,435.660092,0.04758399999997209,47074.64694017556,55985.2051109945
"147.32.84.191",29676,"49.203.231.69",64765,4,560,4,560,0,0,435.860156,5.705218000000002,785.2460677225653,0
"147.32.84.191",29676,"92.100.161.131",51984,6,1226,4,560,2,666,435.860339,19.464026999999987,230.16819695122715,273.73574851699516
"147.32.84.191",29676,"95.165.138.252",38600,4,560,4,560,0,0,436.273336,5.29214300000001,846.5379714796051,0
"147.32.84.191",29676,"218.212.64.145",16881,4,560,4,560,0,0,437.751584,5.820312000000001,769.7181869288105,0
"147.32.84.191",29676,"111.252.164.50",16001,6,1178,4,560,2,618,438.553647,6.357200999999975,704.7126557741399,777.7007522650329
"147.32.84.191",29676,"116.235.12.10",16881,5,904,4,560,1,344,438.553755,6.753104999999948,663.3985403751362,407.51624623044086
"147.32.84.191",29676,"67.68.118.251",48100,4,560,4,560,0,0,438.553857,6.022086999999999,743.9281431835841,0
"147.32.84.191",29676,"71.72.19.172",62567,4,560,4,560,0,0,438.553954,6.022134000000051,743.9223371648592,0
"147.32.84.191",29676,"223.255.226.205",38289,4,560,4,560,0,0,438.554073,6.02215799999999,743.9193724243049,0
"147.32.84.191",29676,"60.241.104.189",30791,8,1120,8,1120,0,0,438.554189,2353.556128,3.8070050224865506,0
"147.32.84.191",29676,"109.86.163.157",11298,4,560,4,560,0,0,438.554288,6.022232000000031,743.9102312896575,0
"147.32.84.191",29676,"151.25.236.217",23548,8,1120,8,1120,0,0,438.554385,2347.686332,3.8165234758456648,0
"147.32.84.191",29676,"195.130.124.237",10005,8,1120,8,1120,0,0,438.554483,2357.568745,3.800525443426677,0
"147.32.84.191",29676,"66.222.212.49",22255,3,613,2,280,1,333,438.554597,1.398569000000009,1601.6371019234557,1904.8041247875383
"147.32.84.191",29676,"69.251.4.13",6881,3,603,2,280,1,323,438.554695,0.5365639999999985,4174.711683974338,4815.828121156111
"147.32.84.191",29676,"80.200.2.29",54546,4,560,4,560,0,0,439.156281,5.420671000000027,826.4659485882795,0
"147.32.84.191",29676,"88.161.71.104",50509,4,560,4,560,0,0,439.55835,6.02379099999996,743.7177020251913,0
"147.32.84.191",29676,"82.95.207.6",15258,4,560,4,560,0,0,439.558451,6.023785000000032,743.7184428063047,0
"147.32.84.191",29676,"178.122.61.5",49445,3,613,2,280,1,333,439.959162,0.165237999999988,13556.203778792787,16122.19949406428
"147.32.84.191",29676,"90.178.37.223",28570,8,1120,8,1120,0,0,440.360502,2183.604823,4.103306562443876,0
"147.32.84.191",29676,"123.195.171.63",16001,6,1178,4,560,2,618,441.565259,6.739670999999987,664.7208743572214,733.5669649156479
"147.32.84.191",29676,"85.222.113.178",20304,3,613,2,280,1,333,443.571576,0.23653200000001107,9470.177396715435,11262.746689665142
"147.32.84.191",29676,"95.78.117.239",60000,3,613,2,280,1,333,443.571683,0.09308399999997619,24064.286021234293,28619.311589539357
"147.32.84.191",29676,"121.235.138.81",11935,4,560,4,560,0,0,443.571782,6.056926000000033,739.6491223435743,0
"147.32.84.191",29676,"108.64.112.206",32752,6,644,4,416,2,228,443.572652,2327.83349,1.4296555205930987,0.7835611987866022
"147.32.84.191",29676,"77.109.199.163",51769,6,768,6,768,0,0,443.772828,29.794745999999975,206.21085341690798,0
"147.32.84.191",29676,"173.86.36.103",60989,4,560,4,560,0,0,443.973887,5.655015999999989,792.2170335150261,0
"147.32.84.191",29676,"222.153.249.197",46409,4,560,4,560,0,0,444.57549,6.061597000000006,739.0791568624564,0
"147.32.84.191",29676,"112.201.134.163",17199,4,560,4,560,0,0,444.576658,6.060649000000012,739.194762805104,0
"147.32.84.191",29676,"121.54.32.135",32830,4,560,4,560,0,0,444.576767,6.060634999999991,739.1964703368553,0
"147.32.84.191",29676,"178.140.101.203",45932,4,560,4,560,0,0,445.379724,5.257481999999982,852.1189421095527,0
"147.32.84.191",29676,"68.42.33.237",64172,4,560,4,560,0,0,445.581996,6.065418000000022,738.6135629893906,0
"147.32.84.191",29676,"115.242.55.6",64657,4,560,4,560,0,0,445.582443,6.065206999999987,738.6392583138563,0
"147.32.84.191",29676,"109.95.202.110",16254,8,1120,8,1120,0,0,445.582563,2350.54077,3.8118887850645535,0
"147.32.84.191",29676,"59.104.228.246",16881,6,1248,4,560,2,688,445.582775,2172.7044640000004,2.061946331970163,2.5332483507062005
"147.32.84.191",29676,"95.22.145.129",54278,4,560,4,560,0,0,446.391207,5.256642999999997,852.2549467407246,0
"147.32.84.191",29676,"202.2.108.235",64216,4,560,4,560,0,0,447.599864,5.8896009999999706,760.6627341988061,0
"147.32.84.191",29676,"122.108.7.20",10415,4,560,4,560,0,0,448.609788,5.883938999999998,761.3947051456519,0
"147.32.84.191",29676,"178.93.31.71",56409,4,560,4,560,0,0,448.609899,5.883933000000013,761.3954815596966,0
"147.32.84.191",29676,"109.201.71.72",59343,4,560,4,560,0,0,448.609999,5.8839399999999955,761.394575743465,0
"147.32.84.191",29676,"82.141.75.111",45964,5,893,4,560,1,333,448.610121,5.944399000000033,753.6506213664284,448.1529587768226
"147.32.84.191",29676,"80.223.238.197",1042,4,560,4,560,0,0,448.61024,5.884025000000008,761.3835767183167,0
"147.32.84.191",29676,"86.208.201.202",60492,4,560,4,560,0,0,448.610343,5.884013999999979,761.3850001036734,0
"147.32.84.191",29676,"99.30.12.168",14412,3,594,2,280,1,314,448.610443,0.24297500000000127,9219.055458380444,10338.512192612354
"147.32.84.191",29676,"115.133.208.55",42296,3,613,2,280,1,333,448.610542,0.3211289999999849,6975.389952324784,8295.731621871975
"147.32.84.191",29676,"72.81.237.132",28046,4,560,4,560,0,0,448.610659,5.883978000000013,761.389658492943,0
"147.32.84.191",29676,"221.1.81.41",27398,6,897,4,488,2,409,448.610917,2502.465683,1.5600613532968877,1.3075104374967768
"147.32.84.191",29676,"83.230.224.165",27353,6,1188,4,560,2,628,449.026704,103.40628000000004,43.32425458105638,48.58505692304179
"147.32.84.191",29676,"86.192.79.77",34864,3,613,2,280,1,333,449.026815,0.07603299999999535,29460.891981115263,35037.41796325494
"147.32.84.191",29676,"108.81.25.26",36462,6,915,4,488,2,427,449.226883,2501.4819690000004,1.5606748513005169,1.3655904948879523
"147.32.84.191",29676,"85.223.4.57",46722,5,893,4,560,1,333,449.22707,5.285804999999982,847.5530217251705,503.9913504187175
"147.32.84.191",29676,"85.73.156.80",24528,4,416,4,416,0,0,449.627981,9.947424000000012,334.55897727894137,0
"147.32.84.191",29676,"94.240.223.27",6881,5,893,4,560,1,333,449.629024,13.06495000000001,342.90219250743377,203.9043394731704
"147.32.84.191",29676,"82.81.167.95",58757,4,560,4,560,0,0,449.629124,5.876090000000033,762.4117397793387,0
"147.32.84.191",29676,"124.169.34.12",46393,4,560,4,560,0,0,449.629245,5.876336999999978,762.3796933361747,0
"147.32.84.191",29676,"88.162.250.183",56888,4,560,4,560,0,0,451.647539,5.867514000000028,763.5260861755044,0
"147.32.84.191",29676,"46.236.160.7",51656,3,603,2,280,1,323,453.489147,0.12764299999997775,17548.945104709153,20243.96167436092
"147.32.84.191",29676,"78.157.82.223",12047,4,560,4,560,0,0,453.489258,6.083617000000004,736.4040175441678,0
"147.32.84.191",29676,"183.216.209.107",16001,4,560,4,560,0,0,453.489358,6.083614000000011,736.4043806855582,0
"147.32.84.191",29676,"112.207.194.116",23799,6,606,4,416,2,190,453.489572,20.76950999999997,160.23488276805784,73.18420126425718
"147.32.84.191",29676,"69.225.44.250",57496,4,560,4,560,0,0,453.689925,5.884929,761.2666185097561,0
"147.32.84.191",29676,"184.32.141.87",62902,4,560,4,560,0,0,454.494055,6.085458000000017,736.1812373037474,0
"147.32.84.191",29676,"79.119.242.242",13676,9,1453,8,1120,1,333,454.494747,2142.52168,4.181988020769993,1.2433946526039354
"147.32.84.191",29676,"41.95.10.107",48443,4,560,4,560,0,0,454.494847,6.085097000000019,736.2249114516968,0
"147.32.84.191",29676,"60.241.74.112",58620,8,976,8,976,0,0,454.697442,44.93885399999999,173.74719880484716,0
"147.32.84.191",29676,"93.81.225.234",35691,8,976,8,976,0,0,454.697619,38.86558600000001,200.89752409753962,0
"147.32.84.191",29676,"95.56.135.184",44357,4,560,4,560,0,0,455.50535,6.083703999999955,736.3934865996165,0
"147.32.84.191",29676,"84.2.120.95",34346,4,560,4,560,0,0,455.505476,6.083680000000015,736.396391657679,0
"147.32.84.191",29676,"14.102.20.93",42618,4,560,4,560,0,0,455.505715,6.08355899999998,736.4110383412103,0
"147.32.84.191",29676,"94.142.46.115",4388,4,560,4,560,0,0,457.515215,6.09135299999997,735.4687866554478,0
"147.32.84.191",29676,"111.242.129.238",16001,6,1178,4,560,2,618,458.528605,6.489729999999952,690.3214771646946,761.8190587281808
"147.32.84.191",29676,"87.109.16.249",12678,4,560,4,560,0,0,458.528719,6.088045999999963,735.8682900884828,0
"147.32.84.191",29676,"98.119.101.123",58481,8,1120,8,1120,0,0,458.528851,2317.6571559999998,3.8659730050254253,0
"147.32.84.191",29676,"212.174.52.186",35287,4,560,4,560,0,0,458.528956,6.088180000000023,735.8520937291577,0
"147.32.84.191",29676,"123.129.191.202",4041,6,1248,4,560,2,688,458.52906,2312.960817,1.936911324685013,2.3796339131844446
"147.32.84.191",29676,"27.37.243.238",17791,8,1528,6,840,2,688,458.529183,2139.208542,3.141348712882991,2.572914183885117
"147.32.84.191",29676,"178.187.57.3",10616,6,644,4,416,2,228,458.529295,2493.9100470000003,1.3344506968097554,0.7313816319053467
"147.32.84.191",29676,"200.54.83.52",4041,4,416,4,416,0,0,458.529447,10.11985199999998,328.85856433473595,0
"147.32.84.191",29676,"41.130.235.204",33302,12,1536,12,1536,0,0,459.371445,2137.5921070000004,5.748524220201005,0
"147.32.84.191",29676,"95.223.253.154",55000,4,560,4,560,0,0,459.575027,6.055709000000036,739.7977676932583,0
"147.32.84.191",29676,"188.142.56.126",1203,4,560,4,560,0,0,459.575129,6.055708999999979,739.7977676932652,0
"147.32.84.191",29676,"190.134.29.245",22692,12,1536,12,1536,0,0,459.575292,2156.531064,5.698039877620794,0
"147.32.84.191",29676,"74.96.231.83",55988,6,935,4,488,2,447,459.775454,2491.021758,1.5672283822741304,1.4355555058945415
"147.32.84.191",29676,"99.238.56.160",28901,6,935,4,488,2,447,459.975838,2490.699446,1.5674311913746657,1.4357412757058925
"147.32.84.191",29676,"175.139.52.40",24166,6,1188,4,560,2,628,464.616935,726.7989949999999,6.164015127731431,6.912502678955962
"147.32.84.191",29676,"46.50.226.188",35691,8,1120,8,1120,0,0,464.617372,2158.3396359999997,4.15133922879967,0
"147.32.84.191",29676,"89.42.9.104",36558,4,560,4,560,0,0,464.61747,6.12435499999998,731.5056034472226,0
"147.32.84.191",29676,"46.176.253.194",10747,5,893,4,560,1,333,465.630954,6.280699000000027,713.2964021998158,424.15661059381904
"147.32.84.191",29676,"50.15.114.129",47659,4,560,4,560,0,0,467.646443,5.920971000000009,756.6326536644063,0
"147.32.84.191",29676,"92.32.209.88",10407,6,644,4,416,2,228,469.657822,2482.959465,1.3403360171246292,0.7346072401548448
"147.32.84.191",29676,"221.212.152.222",17856,6,596,4,416,2,180,469.657983,10.505552000000023,316.78487717732423,137.07037954788066
"147.32.84.191",29676,"24.186.180.244",30833,6,644,4,416,2,228,470.730597,2482.212095,1.3407395793065782,0.7348284232737977
"147.32.84.191",29676,"94.4.60.168",18273,4,416,4,416,0,0,471.142488,9.485442999999975,350.8534076900793,0
"147.32.84.191",29676,"85.115.224.201",47939,8,976,8,976,0,0,472.147788,47.44629599999996,164.56500629680357,0
"147.32.84.191",29676,"111.93.14.158",52342,4,560,4,560,0,0,472.14794,5.462358999999992,820.1584699943754,0
"147.32.84.191",29676,"178.168.40.212",39568,8,1120,8,1120,0,0,472.148093,2485.2447089999996,3.605278774984408,0
"147.32.84.191",29676,"92.255.65.68",7412,4,560,4,560,0,0,474.584349,6.0434660000000235,741.2964679539824,0
"147.32.84.191",29676,"96.245.57.136",14837,4,560,4,560,0,0,477.614528,6.037936999999999,741.9752806297913,0
"147.32.84.191",29676,"27.45.174.76",1058,4,416,4,416,0,0,478.620445,10.09829099999996,329.5607147783732,0
"147.32.84.191",29676,"46.208.75.177",26413,4,560,4,560,0,0,481.635952,6.072223000000008,737.7858158371315,0
"147.32.84.191",29676,"176.8.65.209",30538,4,560,4,560,0,0,481.636063,6.07223700000003,737.7841148163318,0
"147.32.84.191",29676,"201.29.181.128",28578,9,1257,6,696,3,561,490.730097,2470.746975,2.2535694898503316,1.8164547181121207
"147.32.84.191",29676,"118.111.205.145",57423,15,1995,12,1464,3,531,492.139484,2468.5926940000004,4.74440357393361,1.720818509398051
"147.32.84.191",29676,"190.45.219.41",64184,8,852,6,624,2,228,492.551173,2461.004657,2.0284398836064454,0.741160726702355
"147.32.84.191",29676,"78.105.149.40",23254,6,644,4,416,2,228,498.619162,2092.945445,1.5901035585760337,0.8714990657580184
"147.32.84.191",29676,"210.49.72.89",26033,4,416,4,416,0,0,498.823712,9.886933999999997,336.60586790606686,0
"147.32.84.191",29676,"24.242.162.181",62121,6,935,4,488,2,447,503.669429,2266.821459,1.7222353284595409,1.577539327502899
"147.32.84.191",29676,"85.220.113.25",23622,6,935,4,488,2,447,503.882065,2266.8681420000003,1.722199861415671,1.5775068402721413
"147.32.84.191",29676,"201.66.143.138",22104,4,416,4,416,0,0,518.590791,10.07742200000007,330.24319116535725,0
"147.32.84.191",29676,"24.63.87.168",13052,11,1298,10,1184,1,114,529.717401,2430.692116,3.896832485550383,0.3752017764803578
"147.32.84.191",29676,"190.23.77.90",61670,4,416,4,416,0,0,529.920165,9.693167000000017,343.33463975189886,0
"147.32.84.191",29676,"46.161.141.250",56763,6,935,4,488,2,447,549.697028,2401.194465,1.6258574875567189,1.4892588052005191
"147.32.84.191",29676,"82.74.58.93",6881,6,915,4,488,2,427,578.778564,2011.3576960000003,1.9409774838975233,1.698355298410333
"147.32.84.191",29676,"79.105.176.89",44724,6,935,4,488,2,447,578.979164,2011.4295230000002,1.9409081726996207,1.7778400680260869
"147.32.84.191",29676,"99.169.73.113",31140,6,935,4,488,2,447,579.37991,2010.912127,1.9414075570891418,1.7782974959402589
"147.32.84.191",29676,"188.187.34.5",52687,6,935,4,488,2,447,579.78119,2010.3995799999998,1.941902514722969,1.778750869018785
"147.32.84.191",7600,"111.161.11.11",14345,2,180,2,180,0,0,648.269403,1.099999997222767e-05,0,0
"147.32.84.191",29676,"79.179.213.90",62619,9,1257,6,696,3,561,1139.829523,802.695919,6.936624278514614,5.591158362423418
"147.32.84.191",29676,"107.10.111.148",47729,6,915,4,488,2,427,1139.829646,1991.1186180000002,1.9607068934554053,1.7156185317734796
"147.32.84.191",29676,"178.130.35.22",11226,6,935,4,488,2,447,1140.235552,1990.5804789999997,1.961236956348149,1.7964609005893906
"147.32.84.191",29676,"78.88.0.222",23233,3,594,2,280,1,314,1140.242071,0.0914700000000721,24488.90346559784,27462.556029277577
"147.32.84.191",29676,"124.167.201.120",16001,6,1178,4,560,2,618,1140.242197,5.998319000000038,746.8759164025741,824.2309220299835
"147.32.84.191",29676,"207.195.65.190",1142,3,603,2,280,1,323,1140.242308,4.663829999999962,480.2919488917946,554.051069614463
"147.32.84.191",29676,"24.193.143.160",39447,6,624,4,416,2,208,1140.442733,1992.44842,1.6703067274383947,0.8351533637191974
"147.32.84.191",29676,"82.208.156.215",19711,9,2253,6,1640,3,613,1140.44293,2222.3156179999996,5.903751876525759,2.2067072562867622
"147.32.84.191",29676,"201.171.101.178",19795,30,6849,20,4728,10,2121,1140.642872,2259.585468,16.739353538805815,7.509341974578497
"147.32.84.191",29676,"74.40.88.232",22401,39,7197,34,6472,5,725,1141.044329,2453.3194299999996,21.104467427627235,2.364143832668378
"147.32.84.191",29676,"110.168.181.170",11739,8,1120,8,1120,0,0,1141.044438,735.1761080000001,12.187556018890644,0
"147.32.84.191",29676,"76.238.220.66",50187,6,644,4,416,2,228,1143.457905,798.790585,4.166298479845002,2.283452051453511
"147.32.84.191",29676,"89.212.70.71",13349,6,644,4,416,2,228,1143.658807,1989.3179899999998,1.6729351550276788,0.9168971522747855
"147.32.84.191",29676,"207.47.212.176",11875,6,644,4,416,2,228,1143.864068,1989.4789089999997,1.6727998396689716,0.9168229890493402
"147.32.84.191",29676,"91.76.109.108",23007,6,644,4,416,2,228,1144.065576,1989.9566479999999,1.6723982421148706,0.9166028826975733
"147.32.84.191",29676,"58.9.196.170",10000,38,8875,26,6424,12,2451,1145.069638,2450.5047130000003,20.972006186057882,8.00161693057719
"147.32.84.191",29676,"221.6.194.103",16001,6,596,4,416,2,180,1147.293087,9.521173999999974,349.5367272985463,151.24185315802484
"147.32.84.191",29676,"88.112.249.77",51413,16,2240,16,2240,0,0,1147.494178,2158.265634,8.302963137483752,0
"147.32.84.191",29676,"92.141.96.65",40446,29,6354,20,4328,9,2026,1149.306694,2536.179591,13.652030054523058,6.390714623489768
"147.32.84.191",29676,"90.190.220.202",26124,24,5249,16,3368,8,1881,1150.31521,2299.670943,11.7164588620886,6.543544869236538
"147.32.84.191",29676,"82.135.206.90",41351,33,7724,22,5408,11,2316,1150.315314,2159.551765,20.033786965046424,8.579558175119733
"147.32.84.191",29676,"82.224.123.190",51413,23,3472,22,3336,1,136,1150.515538,2279.324392,11.708732681346218,0.47733442585823915
"147.32.84.191",29676,"88.160.52.104",51413,33,5520,30,5112,3,408,1150.515648,2219.306798,18.427375627765727,1.4707295101972646
"147.32.84.191",29676,"58.11.178.51",10074,4,560,4,560,0,0,1151.118345,5.227102999999943,857.0713069935773,0
"147.32.84.191",29676,"82.236.117.61",51413,22,3904,20,3600,2,304,1155.54242,2588.9339389999996,11.124269942215781,0.9393827951204438
"147.32.84.191",29676,"221.158.254.234",54616,29,6354,20,4328,9,2026,1157.348533,2421.512681,14.298500384355409,6.693336825024043
"147.32.84.191",29676,"77.227.194.62",23779,41,8431,34,7416,7,1015,1157.953299,2291.8321560000004,25.886712447366495,3.5430168735271024
"147.32.84.191",29676,"93.174.180.195",46897,4,560,4,560,0,0,1160.360997,6.037160999999969,742.0706520829945,0
"147.32.84.191",29676,"182.20.166.92",60001,6,644,4,416,2,228,1166.398316,1968.0561409999998,1.6910086712815986,0.9268028294524145
"147.32.84.191",29676,"201.29.119.223",40462,6,935,4,488,2,447,1166.799386,1964.267017,1.9875098274380891,1.820526419804971
"147.32.84.191",29676,"70.176.11.104",33785,6,897,4,488,2,409,1167.200766,1963.735158,1.9880481255813012,1.666212465907279
"147.32.84.191",29676,"125.27.236.249",10288,10,1204,8,976,2,228,1167.601952,1968.9924620000002,3.9654798840971894,0.9263621040718844
"147.32.84.191",7600,"121.18.127.108",7600,2,180,2,180,0,0,1515.12495,9.000000090964022e-06,0,0
"147.32.84.191",29676,"86.160.65.132",23258,24,5170,16,3696,8,1474,1859.700248,1881.1606109999998,15.717956152761484,6.268470608541782
"147.32.84.191",29676,"92.104.104.221",6881,3,312,2,208,1,104,1859.700365,0.057369999999991705,29004.706292491555,14502.353146245778
"147.32.84.191",29676,"190.247.31.250",6881,3,312,2,208,1,104,1859.900263,0.27322000000003754,6090.330136885189,3045.1650684425945
"147.32.84.191",29676,"93.174.180.195",8292,4,560,4,560,0,0,1879.234252,5.863221000000067,764.0851334104494,0
"147.32.84.191",29676,"188.26.110.25",10594,12,2294,8,1776,4,518,1941.289422,1235.191235,11.502672296731445,3.3549460865466716
"147.32.84.191",29676,"72.208.2.199",35169,9,1469,6,1096,3,373,1941.489205,1809.2336269999998,4.84625084850913,1.6493171227134173
"147.32.84.191",29676,"79.113.82.96",40497,6,644,4,416,2,228,1941.890807,699.0303879999999,4.760880295235463,2.6093286233502058
"147.32.84.191",29676,"98.177.201.179",56024,8,1123,6,696,2,427,1943.321623,637.095384,8.73966464023227,5.361834484740201
"147.32.84.191",29676,"84.228.7.146",31468,6,935,4,488,2,447,1953.40039,626.9753410000001,6.226720166973839,5.70357359556825
"147.32.84.191",7600,"119.62.72.34",7600,2,180,2,180,0,0,2024.300954,8.999999863590347e-06,0,0
"147.32.84.191",7600,"116.63.133.82",52868,2,180,2,180,0,0,2073.414072,8.999999863590347e-06,0,0
"147.32.84.191",29676,"93.174.180.195",9008,12,1536,12,1536,0,0,2589.904798,820.0032449999999,14.985306552049074,0
"147.32.84.191",29676,"2.123.152.89",64439,3,613,2,280,1,333,2590.308747,0.14034899999978734,15960.213467879315,18981.25387429933
"147.32.84.191",29676,"117.19.193.91",16881,3,624,2,280,1,344,2590.308858,0.609595000000354,3674.5708216089356,4514.472723690978
"147.32.84.191",29676,"82.2.200.94",61330,5,874,4,560,1,314,2590.509843,6.5301580000000286,686.0477189066452,384.6767566726546
"147.32.84.191",29676,"95.211.11.164",49824,3,603,2,280,1,323,2590.509958,0.017511999999896943,127912.28871706157,147555.96162718174
"147.32.84.191",29676,"178.120.8.235",18021,3,613,2,280,1,333,2590.510064,0.06491300000016054,34507.725725116085,41039.5452373702
"147.32.84.191",29676,"108.41.36.142",7888,5,893,4,560,1,333,2590.51017,19.152690999999777,233.909689244193,139.09272592556476
"147.32.84.191",29676,"84.236.212.246",24288,3,594,2,280,1,314,2590.710484,0.14661999999998443,15277.588323559117,17132.724048562726
"147.32.84.191",29676,"60.210.51.53",11935,3,603,2,280,1,323,2590.710632,0.5204450000001088,4304.009069161067,4964.981890496517
"147.32.84.191",29676,"67.224.38.191",32880,4,560,4,560,0,0,2597.163884,5.836112999999841,767.6342113321182,0
"147.32.84.191",29676,"31.181.167.252",44519,4,560,4,560,0,0,2597.163989,5.83615699999973,767.6284239783487,0
"147.32.84.191",29676,"50.40.217.20",50837,4,560,4,560,0,0,2597.973577,6.029853000000003,742.9700193354628,0
"147.32.84.191",29676,"91.212.239.12",24213,4,560,4,560,0,0,2599.982554,6.04096699999991,741.6031241356006,0
"147.32.84.191",29676,"196.205.193.15",40395,4,560,4,560,0,0,2600.991508,6.0416989999998805,741.5132730048433,0
"147.32.84.191",29676,"115.66.118.42",14420,4,560,4,560,0,0,2607.033376,6.0562300000001414,739.734125024957,0
"147.32.84.191",29676,"188.123.238.78",58729,4,560,4,560,0,0,2607.033506,6.056196,739.738277955337,0
"147.32.84.191",29676,"109.253.7.161",56282,4,560,4,560,0,0,2608.036595,6.056340000000091,739.7206893932528,0
"147.32.84.191",29676,"203.206.100.237",46393,4,560,4,560,0,0,2611.079222,6.030134000000089,742.9353974555016,0
"147.32.84.191",29676,"79.134.5.14",62206,4,560,4,560,0,0,2618.521697,5.44350200000008,822.9996057684803,0
"147.32.84.191",29676,"222.55.87.14",16001,15,1478,10,986,5,492,2641.678369,893.2885609999998,8.830293305412653,4.406190979982783
"147.32.84.191",29676,"188.123.248.53",20126,4,560,4,560,0,0,2770.530097,5.655807000000095,792.1062370055988,0
"147.32.84.191",29676,"81.14.41.206",24947,3,594,2,280,1,314,2770.530199,0.1403280000004088,15962.60190406387,17900.91784955734
"147.32.84.191",29676,"174.3.3.253",50509,3,603,2,280,1,323,2770.732232,0.1617260000002716,13850.586794926223,15977.641195575607
"147.32.84.191",29676,"187.18.215.28",7851,3,613,2,280,1,333,2770.732356,0.5356889999998202,4181.530701583852,4973.034727240794
"147.32.84.191",29676,"82.157.57.84",59308,3,613,2,280,1,333,2770.73247,0.07815100000016173,28662.461132875644,34087.85556159853
"147.32.84.191",29676,"68.55.227.113",34167,4,560,4,560,0,0,2770.932615,5.2534859999996115,852.7670959816646,0
"147.32.84.191",29676,"178.123.169.55",34897,3,613,2,280,1,333,2771.338239,0.1005129999998644,22285.674489897046,26504.03430405613
"147.32.84.191",29676,"70.25.72.49",15815,5,893,4,560,1,333,2771.539417,5.890135999999984,760.5936433386279,452.28157719957693
"147.32.84.191",29676,"77.121.179.177",11777,3,603,2,280,1,323,2771.539521,0.061657999999624735,36329.43008228669,41908.5925592093
"147.32.84.191",29676,"81.182.224.47",34346,4,560,4,560,0,0,2771.739601,5.4507659999999305,821.9028298041151,0
"147.32.84.191",29676,"178.219.92.26",57917,4,560,4,560,0,0,2777.591323,5.634732999999869,795.0687281899789,0
"147.32.84.191",29676,"93.116.238.160",14251,4,560,4,560,0,0,2780.206319,6.034507000000303,742.3970176850859,0
"147.32.84.191",29676,"96.23.45.89",16115,5,893,4,560,1,333,2780.206556,6.313654999999926,709.5731394889415,421.9425990175312
"147.32.84.191",29676,"78.113.179.96",16881,4,560,4,560,0,0,2781.213135,6.03921500000024,741.8182661156826,0
"147.32.84.191",29676,"92.113.92.110",38047,4,560,4,560,0,0,2787.252477,5.86012699999992,764.4885511866997,0
"147.32.84.191",29676,"80.223.238.197",45112,4,560,4,560,0,0,2791.097559,6.038285999999971,741.9323960474912,0
"147.32.84.191",29676,"111.240.162.110",25089,3,624,2,280,1,344,2796.123459,0.42726900000025125,5242.598924796049,6440.907250463716
"147.32.84.191",29676,"188.73.212.163",55857,4,560,4,560,0,0,2797.135978,6.030152000000271,742.9331797937762,0
"147.32.84.191",29676,"93.190.4.40",43695,3,613,2,280,1,333,2950.938357,0.04882399999996778,45879.07586435929,54563.32951011301
"147.32.84.191",29676,"123.194.41.154",14622,6,1188,4,560,2,628,2950.938463,62.55270299999984,71.61960690971279,80.31627346303505
"147.32.84.191",29676,"204.237.105.205",49354,3,613,2,280,1,333,2950.93856,0.1689579999997477,13257.732690984416,15767.232093206467
"147.32.84.191",29676,"59.38.181.230",16001,4,560,4,560,0,0,2950.938655,5.448221999999987,822.2866102005407,0
"147.32.84.191",29676,"77.122.172.10",16431,3,613,2,280,1,333,2950.938772,0.06417199999987133,34906.18961547858,41513.43264983702
"147.32.84.191",29676,"81.131.89.13",44898,4,560,4,560,0,0,2950.938872,5.448273999999856,822.278762044662,0
"147.32.84.191",29676,"108.48.14.168",19366,3,594,2,280,1,314,2951.138928,0.20330600000033883,11017.874533935383,12355.759298770394
"147.32.84.191",29676,"77.70.10.95",19888,3,613,2,280,1,333,2951.139035,0.047233999999662046,47423.46614760611,56400.050811260124
"147.32.84.191",29676,"66.199.112.86",34173,4,560,4,560,0,0,2951.139143,5.248098000000027,853.6425958509114,0
"147.32.84.191",29676,"98.203.105.178",53532,4,560,4,560,0,0,2951.139239,5.248095999999805,853.642921166108,0
"147.32.84.191",29676,"77.77.14.158",1183,3,613,2,280,1,333,2951.339345,0.1517389999999068,14762.190340000763,17556.46208292948
"147.32.84.191",29676,"206.71.208.231",39843,3,603,2,280,1,323,2951.339469,0.28710399999999936,7802.050824788247,9000.222915737872
"147.32.84.191",29676,"79.183.217.135",63773,3,613,2,280,1,333,2951.547179,0.5964890000000196,3755.308144827359,4466.134329383966
"147.32.84.191",29676,"95.71.244.6",34749,5,893,4,560,1,333,2951.547278,20.98302199999989,213.5059478086628,126.95978682193699
"147.32.84.191",29676,"88.172.213.82",51413,4,560,4,560,0,0,2952.348778,6.0492199999998775,740.5913489673198,0
"147.32.84.191",29676,"213.182.182.13",20613,4,560,4,560,0,0,2960.408618,6.022903000000042,743.8273536864148,0
"147.32.84.191",29676,"78.63.74.32",36207,4,560,4,560,0,0,2960.408733,6.0229089999998,743.8266126883453,0
"147.32.84.191",29676,"79.100.218.206",49435,4,560,4,560,0,0,2960.408832,6.022938999999951,743.8229077199746,0
"147.32.84.191",29676,"1.55.218.113",27482,4,560,4,560,0,0,2960.408946,6.022965000000113,743.8196967772378,0
"147.32.84.191",29676,"95.132.10.54",10387,4,560,4,560,0,0,2960.409043,6.023005999999896,743.8146334239211,0
"147.32.84.191",29676,"109.78.2.111",13859,4,560,4,560,0,0,2960.40914,6.023048999999901,743.8093231517913,0
"147.32.84.191",29676,"74.109.13.68",23788,3,613,2,280,1,333,2960.409237,0.1575950000001285,14213.648910169572,16904.089596737384
"147.32.84.191",29676,"220.121.217.251",57572,4,560,4,560,0,0,2960.81005,5.622281999999814,796.8294724455566,0
"147.32.84.191",29676,"83.227.20.81",50946,3,613,2,280,1,333,2961.413753,0.04171600000017861,53696.423434423465,63860.38929879648
"147.32.84.191",29676,"27.2.210.224",6800,4,560,4,560,0,0,2961.413878,6.025222000000213,743.5410678643611,0
"147.32.84.191",29676,"71.64.122.40",10531,4,560,4,560,0,0,2961.614008,5.824989000000187,769.1001648243209,0
"147.32.84.191",29676,"79.101.255.187",24724,3,613,2,280,1,333,2962.416568,0.04530699999986609,49440.48381059484,58798.86110331458
"147.32.84.191",29676,"87.15.9.179",60860,4,560,4,560,0,0,2962.617646,5.8370310000000245,767.5134841668618,0
"147.32.84.191",29676,"86.99.249.3",14752,4,560,4,560,0,0,2970.469451,5.8336920000001555,767.9527818746483,0
"147.32.84.191",29676,"120.144.14.112",52942,4,560,4,560,0,0,2970.46956,5.833697999999913,767.9519920297669,0
"147.32.84.191",29676,"84.72.81.232",18338,3,613,2,280,1,333,2970.469678,0.23177299999997558,9664.628753134471,11494.004909977783
"147.32.84.191",29676,"210.222.19.104",50754,4,560,4,560,0,0,2970.469794,5.833720000000085,767.949095945629,0
"147.32.84.191",29676,"85.181.67.62",52444,4,560,4,560,0,0,2970.469892,5.833725999999842,767.9483061083296,0
"147.32.84.191",29676,"117.4.51.102",6800,4,560,4,560,0,0,2970.469988,5.833746000000247,767.9456733289057,0
"147.32.84.191",29676,"95.96.204.232",6881,4,560,4,560,0,0,2970.470086,5.833753000000343,767.9447518603782,0
"147.32.84.191",29676,"58.96.36.163",35455,3,312,2,208,1,104,2970.470193,0.35734499999989566,4656.5643845597,2328.28219227985
"147.32.84.191",29676,"223.206.123.74",26775,4,560,4,560,0,0,2970.871131,5.432246000000305,824.70491947525,0
"147.32.84.191",29676,"189.69.169.173",45115,4,560,4,560,0,0,2971.473758,5.832448000000113,768.1165781503604,0
"147.32.84.191",29676,"80.60.17.28",51842,4,560,4,560,0,0,2971.473878,5.832465000000411,768.1143393058825,0
"147.32.84.191",29676,"77.30.83.89",54961,4,560,4,560,0,0,2980.329906,6.078211999999894,737.0588587565024,0
"147.32.84.191",29676,"188.20.41.238",58990,4,560,4,560,0,0,2980.33002,6.078240000000278,737.0554634235889,0
"147.32.84.191",29676,"94.214.110.194",44743,3,613,2,280,1,333,2980.330118,0.12326800000028015,18171.788298625022,21611.448226579043
"147.32.84.191",29676,"41.135.75.141",55400,4,560,4,560,0,0,2980.731428,5.677009999999882,789.1478084414318,0
"147.32.84.191",29676,"112.168.58.159",59188,4,560,4,560,0,0,2980.731545,5.6770299999998315,789.145028298271,0
"147.32.84.191",29676,"180.4.170.104",52387,4,560,4,560,0,0,2981.334569,6.07965699999977,736.8836761679432,0
"147.32.84.191",29676,"219.89.217.227",30899,4,560,4,560,0,0,2990.445222,6.0402100000001155,741.6960668585884,0
"147.32.84.191",29676,"188.142.56.126",1207,4,560,4,560,0,0,2990.445332,6.040216000000328,741.6953301007376,0
"147.32.84.191",29676,"175.139.47.61",17824,4,560,4,560,0,0,2990.445431,6.040234999999939,741.6929970439967,0
"147.32.84.191",29676,"46.242.40.26",51957,4,560,4,560,0,0,3131.147256,5.447292999999718,822.4268457746319,0
"147.32.84.191",29676,"92.52.36.232",10442,3,613,2,280,1,333,3131.147385,0.01892699999962133,118349.44788105962,140751.3076585459
"147.32.84.191",29676,"212.2.141.3",38216,3,613,2,280,1,333,3131.1475,0.05337099999997008,41970.35843437926,49914.7477094582
"147.32.84.191",29676,"217.153.148.30",6728,3,613,2,280,1,333,3131.147608,0.06429399999979069,34839.953961602834,41434.659532906226
"147.32.84.191",29676,"89.240.14.111",51119,3,613,2,280,1,333,3131.347815,0.06508600000006481,34416.00344156607,40930.46123586251
"147.32.84.191",29676,"2.49.80.10",13637,3,613,2,280,1,333,3131.347943,0.1602639999996427,13976.938052245008,16622.572754991386
"147.32.84.191",29676,"210.139.110.232",27017,4,560,4,560,0,0,3131.348066,5.246610000000146,853.8846988817304,0
"147.32.84.191",29676,"77.30.110.76",24530,3,613,2,280,1,333,3131.549275,0.13434499999993932,16673.489895426042,19829.5433399174
"147.32.84.191",29676,"88.226.60.238",56484,4,560,4,560,0,0,3131.549399,6.048004000000219,740.7402508331406,0
"147.32.84.191",29676,"115.87.239.99",46658,3,613,2,280,1,333,3131.74906,0.5209469999999783,4299.861598204987,5113.763972150931
"147.32.84.191",29676,"222.215.45.47",34845,4,560,4,560,0,0,3132.356716,5.240797000000384,854.8318127948232,0
"147.32.84.191",29676,"2.158.72.15",56457,4,560,4,560,0,0,3140.611937,6.038779999999861,741.8717025624552,0
"147.32.84.191",29676,"186.251.85.103",41797,4,560,4,560,0,0,3140.612046,6.038779999999861,741.8717025624552,0
"147.32.84.191",29676,"90.192.49.57",16583,4,560,4,560,0,0,3140.612144,6.038781999999628,741.8714568600549,0
"147.32.84.191",29676,"94.39.234.162",32544,3,603,2,280,1,323,3141.616217,0.07337300000017422,30528.941163570813,35217.31427083348
"147.32.84.191",29676,"79.114.176.217",64351,4,560,4,560,0,0,3141.616325,6.043314000000009,741.3151128668795,0
"147.32.84.191",29676,"93.81.131.74",21795,4,560,4,560,0,0,3141.823252,5.836499999999887,767.5833119164031,0
"147.32.84.191",29676,"114.79.51.126",7630,4,560,4,560,0,0,3150.487005,6.041075000000092,741.5898660420426,0
"147.32.84.191",29676,"95.59.72.64",31685,3,613,2,280,1,333,3150.48712,0.3198250000000371,7003.830219650559,8329.555225512986
"147.32.84.191",29676,"118.110.170.250",17179,3,603,2,280,1,323,3150.487245,0.39860300000009374,5619.626545709573,6482.640622372115
"147.32.84.191",29676,"31.4.24.82",51569,4,560,4,560,0,0,3150.89012,5.638061000000107,794.5994199069352,0
"147.32.84.191",29676,"213.122.78.65",57673,4,560,4,560,0,0,3151.090725,5.4375529999997525,823.9000153194285,0
"147.32.84.191",29676,"118.68.34.201",58689,7,1241,6,1096,1,145,3300.11858,350.6570160000001,25.004490427763173,3.3080758321402004
"147.32.84.191",29676,"124.133.131.151",16001,10,1371,8,958,2,413,3310.001754,5.828868000000057,1314.8350588827755,566.8339032553092
"147.32.84.191",29676,"115.177.46.145",15016,3,613,2,280,1,333,3310.202136,0.30312899999989895,7389.593209494132,8788.337638434092
"147.32.84.191",29676,"203.161.80.144",19700,4,560,4,560,0,0,3310.604929,5.225879000000077,857.272049352833,0
"147.32.84.191",29676,"221.126.234.245",24998,3,303,2,208,1,95,3310.605053,0.40920799999958035,4066.391663901259,1857.2461926472097
"147.32.84.191",29676,"82.193.121.72",35693,3,322,2,208,1,114,3311.20874,0.06938099999979386,23983.51133602779,13144.809097630616
"147.32.84.191",29676,"77.46.186.123",23329,3,603,2,280,1,323,3312.212799,0.06119200000011915,36606.092299575736,42227.74218843915
"147.32.84.191",29676,"219.90.225.12",20082,3,603,2,280,1,323,3312.4134,0.362521999999899,6178.935347373744,7127.8432757204255
"147.32.84.191",29676,"183.34.46.115",4494,4,560,4,560,0,0,3312.821293,5.833758000000216,767.9440936699524,0
"147.32.84.191",29676,"109.237.149.42",20058,3,613,2,280,1,333,3319.659614,0.13024999999970532,17197.696737083053,20452.975048030916
"147.32.84.191",29676,"79.103.187.59",62532,4,560,4,560,0,0,3319.659723,6.050783999999567,740.3999217292042,0
"147.32.84.191",29676,"89.139.19.205",21463,3,613,2,280,1,333,3319.659821,0.21512099999972634,10412.744455459251,12383.728227385467
"147.32.84.191",29676,"116.75.164.50",61202,4,560,4,560,0,0,3319.659919,6.050694000000021,740.4109346795565,0
"147.32.84.191",29676,"67.149.149.224",54333,2,208,2,208,0,0,3319.660028,6.000000212225132e-06,0,0
"147.32.84.191",29676,"67.247.239.182",22645,4,560,4,560,0,0,3320.061411,5.6493109999996705,793.0170599565613,0
"147.32.84.191",29676,"99.255.238.18",1024,4,560,4,560,0,0,3320.061513,5.649309999999787,793.0172003306898,0
"147.32.84.191",29676,"178.178.252.111",52224,4,560,4,560,0,0,3322.683265,6.045110000000022,741.0948684143024,0
"147.32.84.191",29676,"24.85.179.151",22255,4,560,4,560,0,0,3329.742702,6.040215999999873,741.6953301007934,0
"147.32.84.191",29676,"89.252.234.171",26092,4,560,4,560,0,0,3329.742809,6.040213000000222,741.69569847948,0
"147.32.84.191",29676,"76.252.165.137",51984,4,560,4,560,0,0,3329.742907,6.040209000000232,741.6961896516873,0
"147.32.84.191",29676,"89.122.173.88",50238,4,560,4,560,0,0,3329.743006,6.0402030000000195,741.6969264112457,0
"147.32.84.191",29676,"77.35.191.163",26952,4,560,4,560,0,0,3332.767336,6.030224999999973,742.9241860792955,0
"147.32.84.191",29676,"109.229.63.85",43227,5,893,4,560,1,333,3339.804815,6.149868999999853,728.4708015731891,433.1799587926285
"147.32.84.191",29676,"186.78.128.24",46472,4,560,4,560,0,0,3339.804928,6.04200499999979,741.4757187390867,0
"147.32.84.191",29676,"212.113.45.11",25152,8,976,8,976,0,0,3346.047839,43.70103700000027,178.66852907861093,0
"147.32.84.191",29676,"88.253.190.167",16881,8,976,8,976,0,0,3346.047959,23.774609000000055,328.41759879205506,0
"147.32.84.191",29676,"201.13.5.164",3057,3,312,2,208,1,104,3359.733721,0.3028039999999237,5495.303892948637,2747.6519464743187
"147.32.84.191",29676,"86.148.26.26",10000,3,322,2,208,1,114,3360.335035,0.13811399999985952,12048.01830373237,6603.240801084087
"147.32.84.191",29676,"46.50.239.248",15635,3,322,2,208,1,114,3399.827848,0.13346799999999348,12467.407918003426,6833.0985704441855
"147.32.84.191",29676,"76.97.210.75",49752,3,613,2,280,1,333,3490.077567,0.15605800000003,14353.637750064523,17070.57632418388
"147.32.84.191",29676,"79.80.129.30",26829,6,897,4,488,2,409,3490.282036,81.54304300000013,47.876555207781415,40.12604729504631
"147.32.84.191",29676,"95.10.202.106",26069,6,935,4,488,2,447,3490.282141,80.95655599999964,48.2233952738802,44.17183952341075
"147.32.84.191",29676,"110.230.154.146",1077,4,416,4,416,0,0,3490.282246,9.667309999999816,344.2529514415141,0
"147.32.84.191",29676,"74.58.185.129",49622,3,613,2,280,1,333,3490.48196,0.15640799999982846,14321.518080932285,17032.376860537323
"147.32.84.191",29676,"95.76.138.118",21842,4,560,4,560,0,0,3490.682907,5.243846000000303,854.3347764216838,0
"147.32.84.191",29676,"213.136.49.4",59819,3,613,2,280,1,333,3490.883463,0.04018199999973149,55746.35408926805,66298.3425418795
"147.32.84.191",29676,"99.99.233.184",10838,4,560,4,560,0,0,3491.085667,5.845004000000245,766.4665413402305,0
"147.32.84.191",29676,"27.41.211.30",16881,3,624,2,280,1,344,3491.895127,1.1895660000000134,1883.0396968305874,2313.448770391865
"147.32.84.191",29676,"82.48.43.167",21918,3,613,2,280,1,333,3493.306752,0.1289280000000872,17374.03822287234,20662.695457916034
"147.32.84.191",29676,"112.204.203.205",59358,4,560,4,560,0,0,3493.509936,5.436102000000119,824.1199300528029,0
"147.32.84.191",29676,"92.238.112.214",35970,3,613,2,280,1,333,3499.949168,0.5463049999998475,4100.273656658141,4876.396884525574
"147.32.84.191",29676,"42.49.25.50",12802,6,1178,4,560,2,618,3499.949281,6.823687000000064,656.5365615392321,724.534991127224
"147.32.84.191",29676,"122.173.21.176",38870,4,560,4,560,0,0,3499.949378,6.032180000000153,742.6834079884695,0
"147.32.84.191",29676,"122.107.124.207",30897,4,560,4,560,0,0,3500.957395,6.032694999999876,742.6200064813639,0
"147.32.84.191",29676,"81.1.232.13",56784,4,560,4,560,0,0,3500.957504,6.039318999999978,741.8054916456667,0
"147.32.84.191",29676,"173.180.122.89",61248,4,560,4,560,0,0,3502.970201,6.041460999999799,741.5424845083248,0
"147.32.84.191",29676,"112.135.6.210",42479,4,560,4,560,0,0,3506.584089,5.244760000000042,854.1858922047842,0
"147.32.84.191",29676,"178.167.232.70",58114,3,603,2,280,1,323,3509.814133,0.0877810000001773,25518.050603154163,29436.894088638554
"147.32.84.191",29676,"70.174.71.40",6881,6,624,4,416,2,208,3509.814257,23.751464999999826,140.11767274145086,70.05883637072543
"147.32.84.191",29676,"180.191.86.252",1134,4,560,4,560,0,0,3510.01443,5.827544999999645,768.7628323762875,0
"147.32.84.191",29676,"122.176.51.249",51718,4,560,4,560,0,0,3510.820165,6.030191999999715,742.9282517041268,0
"147.32.84.191",29676,"75.72.155.202",44330,5,883,4,560,1,323,3510.820276,6.213709000000108,720.9864510874137,415.8546851807761
"147.32.84.191",29676,"194.38.103.42",48666,3,603,2,280,1,323,3512.831673,0.034492999999656604,64940.712609001836,74913.75061681283
"147.32.84.191",29676,"180.158.76.119",56074,4,560,4,560,0,0,3513.03217,5.84249200000022,766.7960863275176,0
"147.32.84.191",29676,"178.151.83.17",43964,3,322,2,208,1,114,3571.426812,0.047743999999966036,34852.54691691487,19101.876675616804
"147.32.84.191",29676,"95.104.66.100",63681,3,322,2,208,1,114,3572.028899,0.08076100000016595,20604.004408025914,11292.579339014203
"147.32.84.191",29676,"124.184.91.137",58864,3,312,2,208,1,104,3572.228712,0.35587200000009034,4675.8385037304915,2337.9192518652458
"147.32.84.191",29676,"77.56.229.31",47852,3,613,2,280,1,333,3670.341024,0.08058500000015556,27796.736365274875,33058.26146298762
"147.32.84.191",29676,"84.237.188.75",29564,3,603,2,280,1,323,3670.341205,0.0627399999998488,35702.900860780974,41185.84635011519
"147.32.84.191",29676,"91.117.111.31",35771,3,312,2,208,1,104,3670.341316,0.07487200000014127,22224.596644898764,11112.298322449382
"147.32.84.191",29676,"218.148.123.11",64865,5,893,4,560,1,333,3670.54172,5.7498139999997875,779.1556387737352,463.31933519938184
"147.32.84.191",29676,"85.127.216.94",6881,3,603,2,280,1,323,3670.541832,0.05243800000016563,42717.11354347848,49277.241694798395
"147.32.84.191",29676,"95.88.89.154",43772,3,613,2,280,1,333,3670.742245,0.0604710000002342,37042.54932101875,44054.17472821158
"147.32.84.191",29676,"125.27.129.182",27015,5,883,4,560,1,323,3670.742356,10.060051999999814,445.32572992665274,256.85751922555147
"147.32.84.191",29676,"195.24.143.134",37629,4,560,4,560,0,0,3670.94279,6.032243000000108,742.6756514947956,0
"147.32.84.191",29676,"117.254.217.141",7163,5,874,4,560,1,314,3670.9429,15.772495000000163,284.0387649512619,159.26459320481473
"147.32.84.191",29676,"123.116.153.78",1563,4,560,4,560,0,0,3676.374021,5.684064000000035,788.1684653796954,0
"147.32.84.191",29676,"95.68.45.72",24956,3,613,2,280,1,333,3680.031488,0.06096299999990151,36743.59857624491,43698.636878176985
"147.32.84.191",29676,"218.9.51.203",16001,6,1178,4,560,2,618,3680.031605,6.640117999999802,674.6868052646254,744.5650815241759
"147.32.84.191",29676,"85.105.198.26",24242,4,560,4,560,0,0,3680.232577,5.855810999999903,765.0520141445949,0
"147.32.84.191",29676,"207.204.187.236",12570,4,560,4,560,0,0,3681.036939,6.057596000000103,739.5673135019113,0
"147.32.84.191",29676,"190.87.136.25",38679,4,560,4,560,0,0,3681.037047,6.057699000000412,739.5547385236036,0
"147.32.84.191",29676,"86.124.211.182",53381,5,893,4,560,1,333,3686.088517,6.0851229999998395,736.2217657720506,437.78901428945153
"147.32.84.191",29676,"183.30.124.224",54702,6,1178,4,560,2,618,3690.108014,6.807354000000032,658.1118008553659,726.2733802296717
"147.32.84.191",29676,"87.119.179.171",44864,3,613,2,280,1,333,3690.108136,0.3115370000000439,7190.1571883907345,8551.151227621838
"147.32.84.191",29676,"121.7.216.8",40825,8,976,8,976,0,0,3690.509949,59.6055080000001,130.99460539787677,0
"147.32.84.191",29676,"83.81.196.238",26429,4,560,4,560,0,0,3691.114119,6.046143000000029,740.968250337443,0
"147.32.84.191",29676,"112.222.10.181",55131,4,560,4,560,0,0,3692.317875,5.844963999999891,766.4717866525925,0
"147.32.84.191",29676,"90.180.206.206",13391,4,560,4,560,0,0,3692.317997,5.844945999999709,766.4741470665808,0
"147.32.84.191",29676,"83.26.110.164",60696,4,560,4,560,0,0,3699.974698,6.04075499999999,741.6291506608044,0
"147.32.84.191",29676,"92.112.130.127",25929,4,560,4,560,0,0,3699.974809,6.04074700000001,741.6301328295974,0
"147.32.84.191",29676,"91.124.63.137",36108,3,312,2,208,1,104,3740.056814,0.7315610000000561,2274.5881751485826,1137.2940875742913
"147.32.84.191",29676,"178.65.55.213",19129,4,416,4,416,0,0,3760.19207,9.8497440000001,337.8768016711872,0
"147.32.84.192",137,"147.32.84.255",137,156,14928,156,14928,0,0,469.545672,2160.780397,55.26892050937095,0
"147.32.84.192",1025,"147.32.80.9",53,113,15050,78,6024,35,9026,470.701568,195.02827999999994,247.1026253218252,370.24374106155284
"147.32.84.192",123,"65.55.56.40",123,4,360,4,360,0,0,475.668372,3.004312000000027,958.6221404434606,0
"147.32.84.192",138,"147.32.84.255",138,26,6180,26,6180,0,0,478.632377,3165.2339660000002,15.61969842705776,0
"147.32.84.192",1038,"239.255.255.250",1900,6,1050,6,1050,0,0,488.466309,6.108615999999984,1375.1068981910178,0
"147.32.84.192",1046,"147.32.80.9",53,58,7738,40,3004,18,4734,535.987024,101.78187200000002,236.11277261632597,372.08983540801836
"147.32.84.192",1135,"221.123.176.126",53,12,720,12,720,0,0,633.36631,0.7020700000000488,8204.310111526771,0
"147.32.84.192",1140,"221.123.176.74",10986,39,4159,34,3844,5,315,634.922136,3062.27328,10.042212823017547,0.8229180643211569
"147.32.84.192",1137,"221.123.176.39",3999,3,522,2,252,1,270,636.941841,0.38086200000009285,5293.255824943178,5671.345526724833
"147.32.84.192",1142,"147.32.80.9",53,9,1036,6,468,3,568,637.304745,0.9688109999999597,3864.530852767109,4690.285308486577
"147.32.84.192",31037,"67.215.242.139",6881,15,2142,10,1184,5,958,637.305547,2324.06782,4.075612561082662,3.297666244524654
"147.32.84.192",1143,"147.32.80.9",53,6,554,4,302,2,252,637.322189,0.31795599999998103,7598.535646442099,6340.4999433887715
"147.32.84.192",1139,"221.123.176.75",9567,3,682,2,396,1,286,637.325267,0.4394089999999551,7209.683916352018,5206.993939587568
"147.32.84.192",1139,"221.123.176.75",9732,3,674,2,396,1,278,637.332312,0.4390879999999697,7214.954633240303,5065.043909193951
"147.32.84.192",1146,"147.32.80.9",53,38,4781,26,1924,12,2857,637.43261,1993.6443530000001,7.720534495953802,11.464431941237013
"147.32.84.192",1139,"221.123.176.20",8000,3,426,2,284,1,142,637.433661,0.38488699999993514,5903.031279311545,2951.5156396557727
"147.32.84.192",31037,"58.48.111.62",82,242,20132,242,20132,0,0,637.607059,3120.193389,51.617313390827135,0
"147.32.84.192",31037,"221.123.176.138",554,4,416,4,416,0,0,637.617575,0.0007190000000036889,0,0
"147.32.84.192",7600,"221.123.176.136",5555,27,1793,24,1582,3,211,637.769781,8.451413000000002,1497.5010687561946,199.72991498581356
"147.32.84.192",1139,"221.123.176.75",8000,17,3982,14,2660,3,1322,637.818869,2700.809923,7.879117970791016,3.915862389994633
"147.32.84.192",31037,"46.235.249.98",22470,3,613,2,280,1,333,638.219462,0.13229899999998906,16931.34490812618,20136.20662287863
"147.32.84.192",31037,"76.10.169.207",32755,8,1123,6,696,2,427,638.219581,1991.636719,2.795690572925212,1.7151722336768185
"147.32.84.192",31037,"174.89.78.33",48272,6,935,4,488,2,447,638.219705,2061.928288,1.89337331599769,1.7342989185470643
"147.32.84.192",31037,"31.42.23.203",55191,6,935,4,488,2,447,638.21982,2062.6448739999996,1.8927155368384567,1.7336964036204716
"147.32.84.192",31037,"189.229.86.245",40437,10,1328,10,1328,0,0,638.219932,1987.476463,5.345472108868944,0
"147.32.84.192",31037,"92.155.235.67",21485,6,1226,4,560,2,666,638.220052,1982.0511339999998,2.2602847742675847,2.688124392253949
"147.32.84.192",31037,"50.103.230.227",31586,8,976,8,976,0,0,638.220164,10.035926000000018,778.0049394545143,0
"147.32.84.192",31037,"187.74.225.204",35269,8,976,8,976,0,0,638.220276,10.035604000000035,778.0299023357212,0
"147.32.84.192",31037,"82.131.229.206",26190,6,1188,4,560,2,628,638.220388,719.990399,6.222305194933578,6.977870825746941
"147.32.84.192",31037,"115.170.17.1",16881,6,768,6,768,0,0,638.2205,2182.514131,2.8151020480151017,0
"147.32.84.192",31037,"113.8.98.147",1045,11,1465,8,976,3,489,638.420902,52.99925900000005,147.32281445670765,73.8123527349693
"147.32.84.192",31037,"115.242.116.75",26208,9,1518,6,768,3,750,638.421011,721.1567699999999,8.519645457949457,8.319966267528766
"147.32.84.192",31037,"182.33.147.69",16001,10,1156,8,976,2,180,638.421111,32.74733900000001,238.43158676190444,43.97303854215451
"147.32.84.192",31037,"89.215.9.34",8086,3,594,2,280,1,314,638.421218,0.06538299999999708,34259.6699447884,38419.77272379842
"147.32.84.192",31037,"50.131.9.190",16249,9,1257,6,696,3,561,638.421316,2006.2930310000002,2.7752675775505895,2.2369613663877597
"147.32.84.192",31037,"89.215.99.121",8792,3,594,2,280,1,314,638.6229,0.059195000000045184,37841.033871075095,42436.01655541993
"147.32.84.192",1152,"117.79.93.14",4999,6,2244,4,2008,2,236,638.683178,1.0153719999999566,15820.80262209386,1859.417041242107
"147.32.84.192",31037,"222.58.112.176",21057,6,1188,4,560,2,628,638.823296,93.538007,47.894969581723075,53.710787316646595
"147.32.84.192",31037,"78.128.121.163",25666,3,613,2,280,1,333,638.823404,0.0766800000000103,29212.310902447825,34741.78403755402
"147.32.84.192",31037,"180.30.164.161",26094,3,594,2,280,1,314,639.023943,0.3385359999999764,6616.726138431824,7420.185740955689
"147.32.84.192",31037,"222.75.243.10",16881,3,624,2,280,1,344,639.024063,0.5111960000000408,4381.880922385584,5383.453704645146
"147.32.84.192",31037,"86.69.52.39",12267,3,613,2,280,1,333,639.425353,0.3890089999999873,5758.22153214983,6848.170607878191
"147.32.84.192",31037,"66.110.122.226",22205,4,560,4,560,0,0,639.626099,5.6178409999999985,797.4593798578495,0
"147.32.84.192",31037,"83.44.243.197",13239,4,560,4,560,0,0,640.027082,5.21675300000004,858.7717302314229,0
"147.32.84.192",7600,"221.123.176.44",10021,261,27315,160,11940,101,15375,641.571713,3121.590792,30.599782727703538,39.40298655263332
"147.32.84.192",31037,"2.93.236.84",60000,7,1029,6,696,1,333,642.434951,728.577978,7.642284241536601,3.6564377190110458
"147.32.84.192",7600,"202.207.7.107",7600,2,178,2,178,0,0,642.563415,9.000000090964022e-06,0,0
"147.32.84.192",7600,"202.166.98.226",7600,343,256306,116,11890,227,244416,642.56352,3.9392199999999775,24146.91233289853,496374.4091469913
"147.32.84.192",7600,"221.0.78.69",5378,10,1246,8,996,2,250,642.56361,3.3886289999999235,2351.393439647769,590.2091966987372
"147.32.84.192",7600,"168.70.20.14",7600,345,258518,116,11906,229,246612,642.563705,3.954872000000023,24083.712443790708,498852.04881472484
"147.32.84.192",7600,"220.170.146.105",27695,7,766,6,676,1,90,642.563797,2.024868999999967,2670.790060986705,355.5785584153897
"147.32.84.192",7600,"61.158.174.206",62556,165,111338,66,6528,99,104810,642.563889,4.0463119999999435,12906.567758492358,207220.79760532844
"147.32.84.192",7600,"123.171.103.79",7600,301,231956,96,9750,205,222206,642.563981,3.7761150000000043,20656.150567448265,470761.0864605548
"147.32.84.192",7600,"122.195.24.46",53625,6,748,4,498,2,250,642.564074,0.9980940000000373,3991.6080048571084,2003.8192795467412
"147.32.84.192",7600,"221.224.16.172",25025,48,22848,28,2834,20,20014,642.564174,3.938186999999971,5756.963800855614,40656.27152799021
"147.32.84.192",7600,"221.7.233.67",43172,11,1336,8,996,3,340,642.564269,2.7412030000000414,2906.7529840000466,992.2650748594536
"147.32.84.192",7600,"210.22.150.26",7600,226,163251,82,8132,144,155119,642.564361,3.989708000000064,16305.955222787972,311038.30154988286
"147.32.84.192",7600,"218.28.32.12",1459,119,83876,44,4410,75,79466,642.564455,3.7557990000000245,9393.47393191163,169265.71416627883
"147.32.84.192",7600,"60.211.194.82",51185,6,748,4,498,2,250,642.564548,1.1561000000000377,3446.0686791798894,1729.954156214804
"147.32.84.192",7600,"219.148.93.228",7600,85,34768,54,5560,31,29208,642.56464,3.8989039999999022,11408.3342395712,59930.68821392008
"147.32.84.192",7600,"218.93.39.242",53922,76,38632,42,4184,34,34448,642.564732,3.931520999999975,8513.753328546436,70096.02644879723
"147.32.84.192",7600,"222.88.236.221",30189,34,5494,30,3048,4,2446,642.564823,1.599275999999918,15246.899221898691,12235.536580303215
"147.32.84.192",7600,"60.223.230.56",37150,6,748,4,498,2,250,642.564924,1.033461999999986,3855.003860809642,1935.2429020128725
"147.32.84.192",7600,"218.17.158.164",17319,6,748,4,498,2,250,642.565016,1.088249000000019,3660.926865083203,1837.814691306829
"147.32.84.192",7600,"123.4.53.217",7600,2,178,2,178,0,0,642.565114,5.999999984851456e-06,0,0
"147.32.84.192",7600,"113.59.117.21",7600,373,283954,124,12498,249,271456,642.56525,4.140126000000009,24149.98963799647,524536.6928446128
"147.32.84.192",7600,"222.88.197.190",5176,70,35930,40,3998,30,31932,642.565344,4.270228999999972,7489.9964381301825,59822.55284201425
"147.32.84.192",7600,"123.96.135.146",7600,66,31692,38,3832,28,27860,642.565436,3.819517000000019,8026.145714235556,58352.927870199004
"147.32.84.192",7600,"220.172.104.208",19741,6,748,4,498,2,250,642.565526,1.1330800000000636,3516.0800649554985,1765.1004342146077
"147.32.84.192",7600,"218.84.116.249",2600,2,178,2,178,0,0,642.565622,5.999999984851456e-06,0,0
"147.32.84.192",7600,"58.62.173.26",21664,2,178,2,178,0,0,642.565741,6.999999982326699e-06,0,0
"147.32.84.192",7600,"115.152.184.254",7600,68,31842,40,3982,28,27860,642.565836,3.931626000000051,8102.500085206371,56689.01365490947
"147.32.84.192",7600,"221.2.200.54",62628,6,748,4,498,2,250,642.56593,1.1302319999999781,3524.9400123161236,1769.5481989538773
"147.32.84.192",7600,"202.196.125.94",7600,2,178,2,178,0,0,642.56603,5.000000101063051e-06,0,0
"147.32.84.192",7600,"113.255.79.168",7600,2,178,2,178,0,0,642.566129,5.999999984851456e-06,0,0
"147.32.84.192",7600,"221.0.233.10",4999,6,748,4,498,2,250,642.566221,1.2145869999999377,3280.1273189983135,1646.650260541322
"147.32.84.192",31037,"76.126.152.146",37002,3,613,2,280,1,333,642.635495,0.2109140000000025,10620.44245521859,12630.740491384966
"147.32.84.192",31037,"60.238.213.2",9253,15,2913,10,1736,5,1177,643.037057,3058.052351,4.5414526652751865,3.0790839787032804
"147.32.84.192",7600,"217.174.59.236",7600,45,28208,18,2006,27,26202,643.571214,0.9377029999999422,17114.160880365092,223541.99570654344
"147.32.84.192",7600,"112.227.84.98",7600,3,268,2,178,1,90,643.571313,0.49869200000000546,2855.469909282652,1443.776920423813
"147.32.84.192",7600,"219.157.79.14",47110,2,178,2,178,0,0,643.571405,5.999999984851456e-06,0,0
"147.32.84.192",7600,"61.189.183.111",11036,2,178,2,178,0,0,643.571499,4.9999999873762135e-06,0,0
"147.32.84.192",7600,"220.178.76.98",7600,2,178,2,178,0,0,643.57159,4.9999999873762135e-06,0,0
"147.32.84.192",7600,"123.5.50.48",5439,3,268,2,178,1,90,643.571681,0.4716959999999517,3018.8935246432993,1526.4068383027918
"147.32.84.192",7600,"60.170.30.9",13350,2,178,2,178,0,0,643.571771,4.9999999873762135e-06,0,0
"147.32.84.192",7600,"119.177.85.15",7600,3,268,2,178,1,90,643.571862,0.5119339999999966,2781.6085667293237,1406.4312977844895
"147.32.84.192",7600,"222.184.3.218",29355,2,178,2,178,0,0,643.57196,4.9999999873762135e-06,0,0
"147.32.84.192",7600,"221.3.166.99",47731,3,268,2,178,1,90,643.572054,0.514870999999971,2765.741321612754,1398.408533399707
"147.32.84.192",7600,"124.160.19.210",7600,2,178,2,178,0,0,643.572146,4.9999999873762135e-06,0,0
"147.32.84.192",7600,"89.208.180.60",7600,43,21492,24,2576,19,18916,643.572238,1.0589449999999943,19460.87851588148,142904.49456770733
"147.32.84.192",7600,"59.72.91.66",7600,8,1068,6,818,2,250,643.572329,0.47456099999999424,13789.586586339963,4214.421328343509
"147.32.84.192",7600,"222.174.56.106",53966,2,178,2,178,0,0,643.572419,4.9999999873762135e-06,0,0
"147.32.84.192",7600,"61.190.36.146",7600,2,178,2,178,0,0,643.57251,3.999999989900971e-06,0,0
"147.32.84.192",7600,"211.157.216.82",2308,2,178,2,178,0,0,643.5726,4.9999999873762135e-06,0,0
"147.32.84.192",7600,"125.75.140.152",38636,3,268,2,178,1,90,643.572691,0.357825000000048,3979.5989659744537,2012.156780548881
"147.32.84.192",7600,"115.204.61.238",24592,3,268,2,178,1,90,643.57281,0.3601979999999685,3953.381195898158,1998.9006046676077
"147.32.84.192",7600,"115.161.104.194",7600,3,268,2,178,1,90,643.572944,0.37270300000000134,3820.7366187017406,1931.833121815487
"147.32.84.192",7600,"203.69.6.104",55336,2,178,2,178,0,0,643.573082,7.999999979801942e-06,0,0
"147.32.84.192",7600,"218.201.101.132",43917,3,268,2,178,1,90,643.573177,0.4102189999999837,3471.316540677191,1755.1600486570067
"147.32.84.192",7600,"222.206.194.26",7600,2,178,2,178,0,0,643.573269,4.9999999873762135e-06,0,0
"147.32.84.192",7600,"124.227.108.43",10679,3,268,2,178,1,90,643.573385,0.5387329999999793,2643.238858581254,1336.4690857995106
"147.32.84.192",7600,"123.137.151.88",62757,3,268,2,178,1,90,643.573476,0.40990099999999074,3474.0095779225526,1756.5216967024141
"147.32.84.192",7600,"221.195.83.181",38785,2,178,2,178,0,0,643.573568,4.9999999873762135e-06,0,0
"147.32.84.192",7600,"61.175.198.111",45555,2,178,2,178,0,0,643.573673,5.999999984851456e-06,0,0
"147.32.84.192",7600,"218.21.229.234",53412,2,178,2,178,0,0,643.573815,5.999999984851456e-06,0,0
"147.32.84.192",7600,"202.127.20.52",31452,2,178,2,178,0,0,643.573921,7.999999979801942e-06,0,0
"147.32.84.192",7600,"218.56.155.142",7600,2,178,2,178,0,0,643.574016,7.999999979801942e-06,0,0
"147.32.84.192",7600,"122.159.212.26",7158,2,178,2,178,0,0,643.574109,4.9999999873762135e-06,0,0
"147.32.84.192",7600,"147.32.84.165",7600,4594,4273237,763,79002,3831,4194235,643.574489,4.772032000000081,132441.69360138182,7031361.0637982795
"147.32.84.192",31037,"71.33.74.224",64731,37,7928,26,5424,11,2504,643.639041,2876.356471,15.085751866114927,6.9643662744748855
"147.32.84.192",31037,"59.17.30.86",50005,8,1120,8,1120,0,0,644.039973,721.8905409999999,12.411854001561162,0
"147.32.84.192",7600,"114.222.241.172",7600,24,7684,16,1784,8,5900,644.58689,1.5472669999999198,9224.005940798026,30505.40081317733
"147.32.84.192",7600,"123.158.53.28",57279,29,15196,14,1610,15,13586,644.587,1.7989029999999957,7159.919128491103,60419.04427309325
"147.32.84.192",7600,"114.221.63.111",7600,2,178,2,178,0,0,644.5871,6.999999982326699e-06,0,0
"147.32.84.192",7600,"111.225.239.41",1089,2,178,2,178,0,0,644.5872,6.999999982326699e-06,0,0
"147.32.84.192",7600,"58.58.198.23",22241,2,178,2,178,0,0,644.5873,6.999999982326699e-06,0,0
"147.32.84.192",7600,"49.140.195.54",7600,46,26662,22,2256,24,24406,644.587401,1.6564939999999524,10895.300556476823,117868.22047046691
"147.32.84.192",7600,"125.45.61.120",20920,2,178,2,178,0,0,644.587514,5.999999984851456e-06,0,0
"147.32.84.192",7600,"123.157.108.50",46648,2,178,2,178,0,0,644.587613,7.999999979801942e-06,0,0
"147.32.84.192",7600,"113.162.101.33",7600,2,178,2,178,0,0,644.587719,1.1999999969702912e-05,0,0
"147.32.84.192",7600,"218.87.210.157",7600,2,178,2,178,0,0,644.587831,6.999999982326699e-06,0,0
"147.32.84.192",7600,"125.127.208.65",38604,49,27142,24,2576,25,24566,644.587931,0.9861489999999549,20897.45058809667,199288.3428366393
"147.32.84.192",7600,"220.163.110.196",31933,2,178,2,178,0,0,644.588031,6.999999982326699e-06,0,0
"147.32.84.192",7600,"218.75.249.249",7600,2,178,2,178,0,0,644.588235,8.999999977277184e-06,0,0
"147.32.84.192",7600,"59.140.167.20",7600,2,178,2,178,0,0,644.588364,8.00000009348878e-06,0,0
"147.32.84.192",7600,"124.118.206.206",52250,2,178,2,178,0,0,644.588855,5.999999984851456e-06,0,0
"147.32.84.192",7600,"1.202.238.50",22821,2,178,2,178,0,0,644.588954,7.000000096013537e-06,0,0
"147.32.84.192",7600,"220.243.127.243",9732,2,178,2,178,0,0,644.589052,5.999999984851456e-06,0,0
"147.32.84.192",7600,"222.190.153.250",1177,2,178,2,178,0,0,644.589151,6.999999982326699e-06,0,0
"147.32.84.192",7600,"58.52.202.37",12338,2,178,2,178,0,0,644.589346,6.999999982326699e-06,0,0
"147.32.84.192",7600,"221.10.129.155",10330,27,14998,12,1412,15,13586,644.589445,1.8582529999999906,6078.827802242245,58489.34456180108
"147.32.84.192",7600,"58.222.239.7",12790,2,178,2,178,0,0,644.589543,6.999999982326699e-06,0,0
"147.32.84.192",7600,"124.128.200.253",48723,2,178,2,178,0,0,644.589842,6.999999982326699e-06,0,0
"147.32.84.192",7600,"116.9.204.114",29059,2,178,2,178,0,0,645.607915,4.9999999873762135e-06,0,0
"147.32.84.192",7600,"147.32.84.191",7600,5703,5525738,740,81418,4963,5444320,645.607999,2.6293570000000273,247719.87980331056,16564719.054886632
"147.32.84.192",7600,"222.84.118.25",7600,2,178,2,178,0,0,645.608181,1.0000001111620804e-06,0,0
"147.32.84.192",7600,"114.102.56.69",7600,2,178,2,178,0,0,645.608273,4.9999999873762135e-06,0,0
"147.32.84.192",7600,"125.90.133.101",1617,20,10248,10,1214,10,9034,645.608374,1.302679000000012,7455.405360798716,55479.515675004615
"147.32.84.192",7600,"113.69.59.225",7600,2,178,2,178,0,0,645.608483,1.099999997222767e-05,0,0
"147.32.84.192",7600,"120.14.220.104",18641,2,178,2,178,0,0,645.6085869999999,5.000000101063051e-06,0,0
"147.32.84.192",7600,"14.109.198.246",7600,20,10248,10,1214,10,9034,645.608678,2.1528659999999036,4511.195773448248,33570.13395167337
"147.32.84.192",7600,"218.28.180.50",7600,2,178,2,178,0,0,645.608767,5.000000101063051e-06,0,0
"147.32.84.192",7600,"111.121.34.159",7600,2,178,2,178,0,0,645.608858,4.9999999873762135e-06,0,0
"147.32.84.192",7600,"222.85.97.138",7600,2,178,2,178,0,0,645.60895,3.999999989900971e-06,0,0
"147.32.84.192",7600,"222.91.127.58",44183,2,178,2,178,0,0,645.609042,5.999999984851456e-06,0,0
"147.32.84.192",7600,"221.215.107.126",7600,2,178,2,178,0,0,645.609136,4.9999999873762135e-06,0,0
"147.32.84.192",7600,"221.224.58.138",7600,2,178,2,178,0,0,645.609228,4.9999999873762135e-06,0,0
"147.32.84.192",7600,"113.140.87.158",7600,2,178,2,178,0,0,645.60932,3.999999989900971e-06,0,0
"147.32.84.192",7600,"219.154.17.49",7600,2,178,2,178,0,0,645.609417,4.9999999873762135e-06,0,0
"147.32.84.192",7600,"120.87.222.168",7600,2,178,2,178,0,0,645.60951,4.9999999873762135e-06,0,0
"147.32.84.192",7600,"60.177.217.206",1348,22,8448,14,1610,8,6838,645.609602,2.1134550000000445,6094.286369948605,25883.683352614014
"147.32.84.192",7600,"125.83.9.122",26476,3,268,2,178,1,90,645.609693,0.9228369999999586,1543.0677356890371,780.20278770794
"147.32.84.192",7600,"110.86.15.158",36741,26,11902,14,1610,12,10292,645.609784,1.0836830000000646,11885.394529580359,75977.93819778948
"147.32.84.192",7600,"112.112.81.121",3802,2,178,2,178,0,0,645.609893,4.9999999873762135e-06,0,0
"147.32.84.192",7600,"119.187.192.65",45206,2,178,2,178,0,0,645.609987,8.999999977277184e-06,0,0
"147.32.84.192",7600,"125.78.90.147",16413,24,10644,14,1610,10,9034,645.610082,1.0701159999999845,12036.078331695056,67536.60350840568
"147.32.84.192",7600,"14.153.94.64",45630,14,3660,10,1214,4,2446,645.610173,1.2455739999999196,7797.2083553451075,15710.026060275233
"147.32.84.192",7600,"14.221.2.202",14737,16,5856,10,1214,6,4642,645.610264,1.3648999999999205,7115.539599971108,27207.854055243726
"147.32.84.192",7600,"58.17.57.165",7600,27,14998,12,1412,15,13586,645.610355,1.4442980000000034,7821.100631587092,75253.16797502991
"147.32.84.192",7600,"125.115.187.163",7600,30,14272,16,1784,14,12488,645.610445,1.5504290000000083,9205.1941752895,64436.3592270265
"147.32.84.192",7600,"117.23.97.91",6912,33,19588,14,1610,19,17978,645.610535,1.0105569999999489,12745.446323166978,142321.51179993537
"147.32.84.192",7600,"113.134.234.45",7600,2,178,2,178,0,0,645.610628,4.9999999873762135e-06,0,0
"147.32.84.192",7600,"119.189.196.33",7600,2,178,2,178,0,0,646.604025,9.999999974752427e-06,0,0
"147.32.84.192",7600,"218.56.166.158",13581,3,268,2,178,1,90,646.604133,0.5638469999998961,2525.507806196118,1276.9421492002843
"147.32.84.192",7600,"222.133.178.34",7600,2,178,2,178,0,0,646.604229,4.9999999873762135e-06,0,0
"147.32.84.192",7600,"119.247.248.3",1536,2,178,2,178,0,0,646.604321,4.9999999873762135e-06,0,0
"147.32.84.192",7600,"116.236.217.138",41173,52,30192,26,2652,26,27540,646.604415,1.8168489999999338,11677.36008881353,121264.89322998666
"147.32.84.192",7600,"218.28.77.140",4955,67,44786,26,2652,41,42134,646.604507,1.6931749999999965,12530.305491163077,199076.88218878774
"147.32.84.192",7600,"221.202.225.87",7091,2,178,2,178,0,0,646.604599,4.9999999873762135e-06,0,0
"147.32.84.192",7600,"117.57.65.37",9670,2,178,2,178,0,0,646.60469,5.999999984851456e-06,0,0
"147.32.84.192",7600,"61.163.195.84",10541,2,178,2,178,0,0,646.604782,4.9999999873762135e-06,0,0
"147.32.84.192",7600,"140.109.58.74",7600,2,178,2,178,0,0,646.604875,4.9999999873762135e-06,0,0
"147.32.84.192",7600,"60.173.129.159",1230,106,75620,38,3840,68,71780,646.6054,1.8012639999999465,17054.690484016177,318798.35493298987
"147.32.84.192",7600,"61.133.215.228",41206,2,178,2,178,0,0,646.605562,5.999999984851456e-06,0,0
"147.32.84.192",7600,"202.86.165.199",7600,2,178,2,178,0,0,646.605656,5.000000101063051e-06,0,0
"147.32.84.192",7600,"124.193.135.218",12836,2,178,2,178,0,0,646.605747,5.000000101063051e-06,0,0
"147.32.84.192",7600,"111.243.156.224",7600,94,66440,34,3444,60,62996,646.605841,1.9022019999999884,14484.266129464782,264939.26512536686
"147.32.84.192",7600,"220.136.251.164",7600,80,51068,34,3444,46,47624,646.605931,1.9735629999998991,13960.537363135309,193047.8023757131
"147.32.84.192",7600,"183.28.189.213",7600,2,178,2,178,0,0,646.606028,5.999999984851456e-06,0,0
"147.32.84.192",7600,"118.101.204.48",7600,2,178,2,178,0,0,646.606122,4.9999999873762135e-06,0,0
"147.32.84.192",7600,"113.230.150.164",39591,40,23278,18,2006,22,21272,646.606213,2.9526959999999463,5435.032932614902,57634.10794744975
"147.32.84.192",7600,"118.118.173.174",1229,58,34912,26,2660,32,32252,646.606305,1.7966900000000123,11844.002025947633,143606.29824844477
"147.32.84.192",7600,"180.171.33.84",7600,2,178,2,178,0,0,646.606397,3.999999989900971e-06,0,0
"147.32.84.192",7600,"117.25.228.30",7600,3,268,2,178,1,90,646.606487,0.32317199999999957,4406.322329904824,2227.915784783338
"147.32.84.192",7600,"125.116.251.176",18634,2,178,2,178,0,0,646.606577,3.999999989900971e-06,0,0
"147.32.84.192",7600,"118.182.169.168",1231,2,178,2,178,0,0,646.606667,3.999999989900971e-06,0,0
"147.32.84.192",7600,"119.246.59.239",7600,94,66440,34,3444,60,62996,646.606786,1.847582999999986,14912.455895080335,272771.5074234845
"147.32.84.192",7600,"24.6.51.208",7600,2,178,2,178,0,0,646.606879,3.999999989900971e-06,0,0
"147.32.84.192",7600,"113.236.139.159",7600,59,36002,26,2652,33,33350,646.606969,1.690313999999944,12551.51409738114,157840.49590786613
"147.32.84.192",7600,"119.129.221.139",7600,2,178,2,178,0,0,646.607059,3.999999989900971e-06,0,0
"147.32.84.192",7600,"116.237.145.184",7600,2,178,2,178,0,0,646.933496,6.999999982326699e-06,0,0
"147.32.84.192",7600,"221.221.219.230",1024,2,178,2,178,0,0,647.168348,5.999999984851456e-06,0,0
"147.32.84.192",31037,"41.35.187.129",10001,12,1680,12,1680,0,0,648.254707,1436.9664269999998,9.353036889010074,0
"147.32.84.192",31037,"14.210.171.217",4041,20,2656,20,2656,0,0,648.254882,2168.647653,9.797811078533927,0
"147.32.84.192",31037,"77.221.65.148",28109,27,5862,18,3648,9,2214,648.254985,2871.53937,10.16318992694152,6.168120202370758
"147.32.84.192",31037,"78.70.100.74",31815,4,560,4,560,0,0,648.255097,6.024260000000027,743.6598021997689,0
"147.32.84.192",31037,"122.61.129.22",22985,3,624,2,280,1,344,648.255284,1.0604000000000724,2112.4104111654538,2595.2470765747003
"147.32.84.192",31037,"95.78.117.239",60000,3,613,2,280,1,333,648.255556,0.09539100000006329,23482.2991686691,27927.162939881462
"147.32.84.192",31037,"121.235.138.81",11935,4,560,4,560,0,0,648.255694,6.023793000000069,743.7174550984652,0
"147.32.84.192",31037,"59.180.154.162",10455,24,4367,18,2776,6,1591,648.456497,3095.9558159999997,7.17322898641781,4.111169782921735
"147.32.84.192",31037,"78.157.82.223",12047,4,560,4,560,0,0,648.456614,5.916439000000082,757.2122352651548,0
"147.32.84.192",31037,"95.78.64.209",18223,12,1680,12,1680,0,0,648.858219,2886.805827,4.655664705362949,0
"147.32.84.192",31037,"61.173.107.69",24001,108,26223,78,21976,30,4247,649.258833,3005.431124,58.496765604135,11.304867287985136
"147.32.84.192",31037,"69.225.44.250",57496,4,560,4,560,0,0,649.258951,6.116482000000019,732.4471812391479,0
"147.32.84.192",31037,"77.109.199.163",51769,4,560,4,560,0,0,649.459342,5.916185000000041,757.244744713015,0
"147.32.84.192",31037,"95.154.117.173",64964,4,560,4,560,0,0,653.276225,6.009506000000101,745.4855690301207,0
"147.32.84.192",31037,"91.149.105.206",20286,30,6627,20,4328,10,2299,658.282129,2861.85905,12.098429515597562,6.426591833724306
"147.32.84.192",31037,"125.58.238.115",16001,59,8329,40,4772,19,3557,658.282281,2966.432664,12.869329704764874,9.592666756045402
"147.32.84.192",31037,"177.17.97.200",10014,12,1680,12,1680,0,0,658.282409,2877.381729,4.670913095938408,0
"147.32.84.192",31037,"46.53.145.31",32333,4,560,4,560,0,0,658.282579,6.029331999999954,743.0342200429557,0
"147.32.84.192",31037,"68.42.33.237",64172,4,560,4,560,0,0,658.282726,6.029289999999946,743.0393960151262,0
"147.32.84.192",31037,"46.109.87.117",12366,4,560,4,560,0,0,658.28286,6.029260000000022,743.0430931822452,0
"147.32.84.192",31037,"188.17.113.175",62992,6,935,4,488,2,447,658.283006,700.0339230000001,5.576872593929994,5.10832387189899
"147.32.84.192",31037,"93.96.76.67",25537,6,935,4,488,2,447,658.283212,1961.627045,1.9901846326756778,1.822976497553336
"147.32.84.192",31037,"188.244.2.45",6881,6,624,4,416,2,208,658.68424,1971.5106460000002,1.6880456652629203,0.8440228326314602
"147.32.84.192",31037,"94.137.244.164",47904,6,935,4,488,2,447,658.6844,699.585013,5.580451163838754,5.111601783270334
"147.32.84.192",31037,"122.127.97.108",32150,6,927,4,488,2,439,658.884623,1962.1181230000002,1.9896865302028504,1.789902431883302
"147.32.84.192",31037,"89.133.142.247",46500,6,935,4,488,2,447,658.884791,699.3719290000001,5.582151410598007,5.113159181428912
"147.32.84.192",31037,"119.112.40.111",54312,6,644,4,416,2,228,659.085367,700.640002,4.749942895781164,2.60333408711083
"147.32.84.192",31037,"90.207.204.165",43626,12,1680,12,1680,0,0,659.285854,2876.3783759999997,4.672542427707363,0
"147.32.84.192",31037,"95.78.66.92",17778,4,560,4,560,0,0,659.285986,6.033299000000056,742.545662000169,0
"147.32.84.192",31037,"71.60.172.138",34361,4,560,4,560,0,0,659.286092,6.033293999999955,742.5462773735266,0
"147.32.84.192",31037,"95.138.71.29",60426,8,1120,8,1120,0,0,659.486573,2883.0348369999997,3.107836188800101,0
"147.32.84.192",31037,"174.6.16.84",54836,6,644,4,416,2,228,659.686737,700.52352,4.750732709160144,2.6037669655973863
"147.32.84.192",31037,"78.26.138.126",44093,6,935,4,488,2,447,660.088026,1959.820787,1.992018875346279,1.824656633770055
"147.32.84.192",31037,"50.18.3.51",21094,12,1212,8,832,4,380,660.288743,1983.390739,3.355869254162127,1.532728745891356
"147.32.84.192",31037,"173.175.75.162",43669,6,644,4,416,2,228,660.489724,700.1118389999999,4.753526243397808,2.6052980372468753
"147.32.84.192",31037,"95.59.128.250",33243,4,560,4,560,0,0,668.356828,5.89024100000006,760.5800849235123,0
"147.32.84.192",31037,"114.161.80.252",57542,3,613,2,280,1,333,668.356939,0.31824299999993855,7038.64656881827,8370.961812201727
"147.32.84.192",31037,"173.86.36.103",60967,4,560,4,560,0,0,668.758369,5.488798999999972,816.2076986240565,0
"147.32.84.192",31037,"212.107.243.2",64752,4,560,4,560,0,0,668.758486,5.48877600000003,816.2111188359619,0
"147.32.84.192",31037,"212.30.216.153",54610,4,560,4,560,0,0,669.367084,5.883751000000075,761.4190335382892,0
"147.32.84.192",31037,"115.177.40.94",19605,6,915,4,488,2,427,674.246911,1945.9530430000002,2.0062149053614133,1.7554380421912368
"147.32.84.192",31037,"110.18.224.196",16001,4,416,4,416,0,0,674.849689,9.479870000000005,351.05966643002466,0
"147.32.84.192",31037,"119.14.204.28",11041,6,606,4,416,2,190,680.288905,680.7731729999999,4.888559261720498,2.232755432035804
"147.32.84.192",31037,"80.116.118.227",12963,4,416,4,416,0,0,694.368525,9.97497199999998,333.6350217323925,0
"147.32.84.192",31037,"92.154.116.8",60401,6,644,4,416,2,228,714.292418,1929.984069,1.724366565224741,0.9450855213250985
"147.32.84.192",31037,"46.146.22.144",36505,3,613,2,280,1,333,1358.374324,0.10032400000000052,22327.658386826566,26553.96515290445
"147.32.84.192",31037,"119.154.183.167",29739,3,613,2,280,1,333,1358.374429,0.9858990000000176,2272.0380079500637,2702.102345169183
"147.32.84.192",31037,"71.193.113.27",17200,6,1188,4,560,2,628,1358.374532,37.63564900000006,119.0360766729436,133.49045741180103
"147.32.84.192",31037,"173.181.41.88",30464,3,613,2,280,1,333,1358.374627,0.2078910000000178,10774.87721931112,12814.407550109296
"147.32.84.192",31037,"83.109.21.23",64167,3,322,2,208,1,114,1358.374732,0.5642459999999119,2949.0683141754835,1616.3162875769476
"147.32.84.192",31037,"188.231.190.230",63481,6,1438,4,960,2,478,1358.575293,1954.3446769999998,3.929705998324266,1.9566661116656243
"147.32.84.192",31037,"95.154.117.173",61912,4,560,4,560,0,0,1368.967903,6.113458000000037,732.809483601584,0
"147.32.84.192",31037,"31.16.12.29",42850,6,935,4,488,2,447,1380.947377,698.470491,5.589355671147459,5.119758165989578
"147.32.84.192",31037,"124.149.33.202",57461,8,832,6,624,2,208,1381.148229,738.4891400000001,6.759747340360346,2.2532491134534487
"147.32.84.192",31037,"61.120.169.8",46890,6,644,4,416,2,228,1381.758519,738.4266860000002,4.506879373533365,2.4701165797250173
"147.32.84.192",31037,"46.184.46.171",43256,6,644,4,416,2,228,1382.171367,738.365652,4.50725191642582,2.4703207618872285
"147.32.84.192",31037,"46.203.188.237",54340,8,832,6,624,2,208,1383.185705,737.6431409999998,6.767500058676749,2.2558333528922496
"147.32.84.192",31037,"70.74.189.184",39949,8,852,6,624,2,228,1393.475287,736.8613040000002,6.774680625650005,2.4753640747567327
"147.32.84.192",31037,"175.138.141.227",37517,3,322,2,208,1,114,1393.87676,0.32708499999989726,5087.362612166631,2788.2660470528654
"147.32.84.192",31037,"94.75.188.68",6881,4,416,4,416,0,0,1414.342127,9.744871000000103,341.5129866778087,0
"147.32.84.192",7600,"183.68.183.41",44408,2,180,2,180,0,0,2017.379897,7.999999979801942e-06,0,0
"147.32.84.192",31037,"95.154.117.173",53789,4,560,4,560,0,0,2089.244853,5.843379999999797,766.6795587485591,0
"147.32.84.192",31037,"123.131.126.227",9252,18,2328,12,1320,6,1008,2089.84756,1173.512894,8.998622898812393,6.871675668184009
"147.32.84.192",31037,"95.56.68.143",15040,12,1870,8,976,4,894,2090.248978,1471.141846,5.307441985441287,4.861529851418556
"147.32.84.192",31037,"183.105.54.117",32115,12,1536,12,1536,0,0,2090.449905,1440.1646110000001,8.532357972237383,0
"147.32.84.192",31037,"219.75.74.205",23170,3,322,2,208,1,114,2140.221563,0.5519309999999678,3014.869612324905,1652.38046060115
"147.32.84.192",31037,"81.18.60.69",42991,6,935,4,488,2,447,2141.031543,659.3625980000002,5.920869657820656,5.423419543126708
"147.32.84.192",31037,"78.83.119.16",13058,6,644,4,416,2,228,2141.434115,719.6858090000001,4.624240131432131,2.5344393028041488
"147.32.84.192",7600,"180.208.72.107",40034,4,360,4,360,0,0,2425.078152,10.003157000000101,287.90910709488725,0
"147.32.84.192",31037,"41.129.74.131",14584,8,976,8,976,0,0,2619.847006,9.877491000000191,790.4841421773858,0
"147.32.84.192",31037,"68.44.87.113",60344,3,613,2,280,1,333,2619.847102,0.12689899999986665,17651.833347799067,20993.073231489605
"147.32.84.192",31037,"113.170.137.207",63627,6,768,6,768,0,0,2619.847305,19.95095100000026,307.9552448402044,0
"147.32.84.192",31037,"98.193.36.116",25517,3,594,2,280,1,314,2620.050199,0.24384900000040943,9186.012655357368,10301.457049222192
"147.32.84.192",31037,"24.36.132.66",9084,6,897,4,488,2,409,2620.050306,23.988188999999693,162.7467584151538,136.40045940942193
"147.32.84.192",31037,"99.126.136.22",42132,10,1403,8,976,2,427,2620.050686,69.85976299999993,111.7667690913868,48.89796147748173
"147.32.84.192",31037,"68.148.114.49",49853,6,897,4,488,2,409,2620.050788,49.92863500000021,78.19160287478284,65.53353601595529
"147.32.84.192",31037,"24.3.101.16",14651,3,613,2,280,1,333,2620.252445,0.25943099999994956,8634.280405967042,10268.62633995366
"147.32.84.192",31037,"119.24.54.140",25460,3,594,2,280,1,314,2620.255547,0.29520400000001246,7587.973062695307,8509.36979173688
"147.32.84.192",31037,"83.252.252.56",18069,3,613,2,280,1,333,2620.45563,0.09358000000020184,23936.738619311483,28467.621286538302
"147.32.84.192",31037,"90.225.75.12",24778,3,603,2,280,1,323,2620.455754,0.0393989999997757,56854.234879381525,65585.42095014369
"147.32.84.192",31037,"88.81.136.110",15644,3,613,2,280,1,333,2620.455863,0.11019699999997101,20327.232138811305,24174.88679365773
"147.32.84.192",31037,"24.224.249.220",51413,3,594,2,280,1,314,2620.656013,0.14387699999997494,15568.853951641959,17459.357645769913
"147.32.84.192",31037,"120.65.7.168",45583,4,560,4,560,0,0,2620.656146,6.045239000000038,741.0790541118345,0
"147.32.84.192",31037,"201.6.80.230",43897,3,613,2,280,1,333,2620.65626,1.1217289999999593,1996.9172589815198,2374.9051687173073
"147.32.84.192",31037,"187.146.33.147",10001,3,613,2,280,1,333,2620.656371,0.26870099999996455,8336.403660575494,9914.365782041568
"147.32.84.192",31037,"92.44.154.114",56092,4,560,4,560,0,0,2620.656494,6.045423000000028,741.0564984451839,0
"147.32.84.192",31037,"58.111.72.119",11555,4,560,4,560,0,0,2620.856606,5.844874000000345,766.4835888677387,0
"147.32.84.192",31037,"123.67.100.118",4041,4,560,4,560,0,0,2621.057444,5.644131000000016,793.7448652414317,0
"147.32.84.192",31037,"78.131.107.6",20913,4,560,4,560,0,0,2621.057559,5.64411199999995,793.747537256532,0
"147.32.84.192",31037,"95.103.190.216",10004,4,560,4,560,0,0,2621.859564,5.846731000000091,766.2401434237236,0
"147.32.84.192",31037,"123.243.72.24",51413,3,594,2,280,1,314,2626.097312,0.341417999999976,6560.872596055736,7357.549982719647
"147.32.84.192",31037,"123.116.153.78",1580,4,560,4,560,0,0,2626.499304,5.245484999999917,854.0678316685818,0
"147.32.84.192",31037,"93.144.171.217",41386,4,560,4,560,0,0,2629.722936,6.049780999999712,740.5226734654053,0
"147.32.84.192",31037,"178.234.104.158",20001,5,883,4,560,1,323,2629.723054,6.338780999999926,706.7604954328051,407.6493571871358
"147.32.84.192",31037,"99.17.249.169",47992,4,560,4,560,0,0,2629.723169,6.049743999999919,740.5272024733708,0
"147.32.84.192",31037,"95.80.208.154",59459,4,560,4,560,0,0,2630.73796,6.03746799999999,742.0329184353453,0
"147.32.84.192",31037,"112.203.95.173",45864,4,560,4,560,0,0,2630.738084,6.0374400000000605,742.0363597816219,0
"147.32.84.192",31037,"223.207.102.141",51297,4,560,4,560,0,0,2630.738196,6.037428000000091,742.0378346540832,0
"147.32.84.192",31037,"79.124.6.20",25522,3,594,2,280,1,314,2630.738307,0.14830799999981537,15103.70310436921,16937.724195614042
"147.32.84.192",31037,"180.183.171.113",28424,3,624,2,280,1,344,2630.739236,1.350500000000011,1658.6449463161657,2037.7637911884322
"147.32.84.192",31037,"123.116.153.78",1572,3,603,2,280,1,323,2630.939822,0.4685240000003432,4780.971732501129,5515.192391420946
"147.32.84.192",31037,"178.79.3.207",64523,4,560,4,560,0,0,2631.541352,5.234363999999914,855.8823956454066,0
"147.32.84.192",31037,"79.117.35.3",27483,4,560,4,560,0,0,2631.744662,6.0358870000000024,742.2272815909241,0
"147.32.84.192",31037,"178.77.225.2",1601,4,560,4,560,0,0,2632.153316,5.62733500000013,796.1139686903119,0
"147.32.84.192",31037,"59.16.141.216",55632,3,603,2,280,1,323,2635.773025,0.3081219999999121,7269.847657748032,8386.288548045051
"147.32.84.192",31037,"175.139.237.183",61730,3,322,2,208,1,114,2636.173237,0.32663200000024517,5094.4181831503065,2792.133042688149
"147.32.84.192",31037,"72.84.99.67",39606,4,560,4,560,0,0,2636.173365,5.63648000000012,794.8223004428127,0
"147.32.84.192",31037,"112.205.94.236",44708,4,560,4,560,0,0,2636.173467,5.636473000000024,794.8232875416917,0
"147.32.84.192",31037,"212.74.223.198",16051,3,322,2,208,1,114,2636.7753,0.14070200000014665,11826.41327058795,6481.784196379934
"147.32.84.192",31037,"76.200.133.129",12011,3,322,2,208,1,114,2636.975488,0.760291000000052,2188.6356671325666,1199.5407021784258
"147.32.84.192",31037,"157.157.235.145",49185,3,322,2,208,1,114,2637.984071,0.18416000000024724,9035.621198945299,4952.215464806557
"147.32.84.192",31037,"122.107.139.183",45153,3,312,2,208,1,104,2638.384913,0.3767720000000736,4416.46406845433,2208.232034227165
"147.32.84.192",31037,"77.71.134.59",4565,3,312,2,208,1,104,2638.98846,0.08057599999983722,20651.310563981355,10325.655281990677
"147.32.84.192",31037,"24.207.102.210",14015,4,560,4,560,0,0,2639.798008,6.0380889999996725,741.9566024946374,0
"147.32.84.192",31037,"24.6.237.196",1027,4,560,4,560,0,0,2639.798119,6.038077000000158,741.9580770500083,0
"147.32.84.192",31037,"188.55.122.72",12626,4,560,4,560,0,0,2640.80413,5.842771000000084,766.7594708058788,0
"147.32.84.192",31037,"176.45.35.30",45770,4,560,4,560,0,0,2640.80424,5.842764999999872,766.7602581996877,0
"147.32.84.192",31037,"123.53.168.130",19679,4,560,4,560,0,0,2640.806007,5.8410979999998744,766.9790850966883,0
"147.32.84.192",31037,"95.65.35.125",56388,4,560,4,560,0,0,2640.806111,5.841093000000001,766.9797416339715,0
"147.32.84.192",31037,"121.24.21.25",16001,6,1178,4,560,2,618,2641.809722,6.332531999999901,707.4579330984936,780.7303618836947
"147.32.84.192",31037,"93.94.219.50",62454,4,560,4,560,0,0,2641.810048,5.844696000000113,766.5069320970524,0
"147.32.84.192",31037,"77.68.216.74",16930,4,560,4,560,0,0,2645.83631,5.8481950000000325,766.0483277318857,0
"147.32.84.192",31037,"124.180.55.77",49557,4,560,4,560,0,0,2645.83641,5.848199999999906,766.0476727882207,0
"147.32.84.192",31037,"79.6.181.73",18404,4,560,4,560,0,0,2649.67285,6.040551999999934,741.6540739985434,0
"147.32.84.192",31037,"76.91.222.142",8142,4,560,4,560,0,0,2650.678647,6.0420899999999165,741.4652876736463,0
"147.32.84.192",31037,"71.68.229.246",56206,4,560,4,560,0,0,2650.678758,6.0420899999999165,741.4652876736463,0
"147.32.84.192",31037,"95.26.160.245",34439,4,560,4,560,0,0,2650.678858,6.042120999999952,741.4614834757589,0
"147.32.84.192",31037,"83.26.208.221",29685,4,560,4,560,0,0,2650.678956,6.042128999999932,741.4605017536121,0
"147.32.84.192",31037,"207.161.166.99",25040,5,520,4,416,1,104,2670.215283,9.63214599999992,345.50971299646284,86.37742824911571
"147.32.84.192",31037,"109.185.252.188",19623,5,530,4,416,1,114,2690.154403,9.73663600000009,341.8018297079165,93.66684756418866
"147.32.84.192",7600,"116.10.194.114",14372,2,180,2,180,0,0,2740.711211,0,0,0
"147.32.84.192",31037,"84.13.64.4",39440,3,613,2,280,1,333,2799.97327,0.07540100000005623,29707.828808614337,35331.096404530625
"147.32.84.192",31037,"95.154.117.173",62220,8,976,8,976,0,0,2800.172462,70.76830599999994,110.33187653241278,0
"147.32.84.192",31037,"62.85.109.162",49580,4,560,4,560,0,0,2800.172571,5.647167000000081,793.3181363327728,0
"147.32.84.192",31037,"120.0.233.53",4041,4,416,4,416,0,0,2800.172677,9.680777000000035,343.7740586318627,0
"147.32.84.192",31037,"180.0.191.79",24967,3,303,2,208,1,95,2800.172816,0.5330630000003111,3121.5822520021625,1425.7226631740646
"147.32.84.192",31037,"114.151.202.78",48976,3,322,2,208,1,114,2800.779437,0.33160099999986414,5018.078956338135,2750.293274146862
"147.32.84.192",31037,"203.100.211.128",21626,4,560,4,560,0,0,2800.982029,5.842667000000347,766.7731191936377,0
"147.32.84.192",31037,"99.101.8.186",8500,5,530,4,416,1,114,2801.383278,9.720176000000265,342.38063179101994,93.82546159657758
"147.32.84.192",31037,"202.63.112.151",13563,4,560,4,560,0,0,2809.852213,6.041941999999835,741.4834501887178,0
"147.32.84.192",31037,"110.54.55.22",9684,9,1200,6,696,3,504,2809.852518,752.7760749999998,7.396621897155806,5.3561744772507565
"147.32.84.192",31037,"178.179.19.204",12417,3,613,2,280,1,333,2809.852944,0.18040799999971568,12416.300829251088,14766.529200502186
"147.32.84.192",31037,"76.233.247.48",57602,6,935,4,488,2,447,2809.853049,151.30535800000007,25.80212658430773,23.63432496554417
"147.32.84.192",31037,"95.14.143.87",38903,8,976,8,976,0,0,2809.853146,141.25454500000023,55.276097487694905,0
"147.32.84.192",31037,"90.222.142.247",30392,8,1195,6,768,2,427,2809.853243,131.28722800000014,46.7981546537032,26.019286506681336
"147.32.84.192",31037,"218.56.241.80",16001,11,1684,8,976,3,708,2809.85334,121.13570499999969,64.45663563851814,46.75747749187586
"147.32.84.192",31037,"99.122.170.69",13259,6,935,4,488,2,447,2810.053749,80.07099999999991,48.756728403541906,44.66036392701482
"147.32.84.192",31037,"85.228.31.237",46766,6,915,4,488,2,427,2810.255963,59.71657000000005,65.37548958354435,57.2035533856013
"147.32.84.192",31037,"60.18.222.131",11935,3,603,2,280,1,323,2810.46285,0.5606339999999363,3995.4765497637572,4609.06759133462
"147.32.84.192",31037,"97.107.202.49",9732,4,560,4,560,0,0,2810.462969,5.431759000000056,824.778860770508,0
"147.32.84.192",31037,"69.204.108.140",20302,5,893,4,560,1,333,2810.463158,5.5745459999998275,803.6528894012425,477.8864503046674
"147.32.84.192",31037,"99.88.152.78",41816,3,613,2,280,1,333,2810.863637,0.30502000000024054,7343.780735683672,8733.853517795224
"147.32.84.192",31037,"70.73.115.236",50982,3,613,2,280,1,333,2811.063793,0.5974370000003546,3749.3493037737376,4459.047564845195
"147.32.84.192",31037,"112.206.89.232",22992,4,416,4,416,0,0,2811.264901,9.673784000000069,344.0225665572,0
"147.32.84.192",31037,"31.181.92.234",22587,4,560,4,560,0,0,2816.094435,5.855974999999944,765.0305884161122,0
"147.32.84.192",31037,"41.139.220.214",12728,4,560,4,560,0,0,2816.300968,5.64955400000008,792.9829505125425,0
"147.32.84.192",31037,"58.183.225.177",26788,6,1188,4,560,2,628,2819.929385,123.6316569999999,36.23667358919248,40.63684109645157
"147.32.84.192",31037,"84.2.148.57",63362,3,603,2,280,1,323,2819.929496,0.027085999999599153,82699.54958403418,95399.837555868
"147.32.84.192",31037,"112.118.223.239",22642,4,560,4,560,0,0,2819.929594,5.862684999999601,764.1549904182648,0
"147.32.84.192",31037,"222.64.76.226",4041,3,303,2,208,1,95,2819.930068,0.6465259999999944,2573.7557344948455,1175.5134364279343
"147.32.84.192",31037,"99.43.234.113",29912,6,768,6,768,0,0,2820.130218,50.008871,122.85820249771285,0
"147.32.84.192",31037,"173.200.48.34",13763,4,560,4,560,0,0,2825.792497,6.062498000000232,738.969315948612,0
"147.32.84.192",31037,"92.152.168.58",61109,4,560,4,560,0,0,2825.792597,6.06249600000001,738.9695597324918,0
"147.32.84.192",31037,"94.251.103.230",17773,3,613,2,280,1,333,2829.826823,0.12440400000014051,18005.85190184777,21414.10244041181
"147.32.84.192",31037,"77.71.31.246",59654,3,613,2,280,1,333,2829.826933,0.07901600000013786,28348.688873090156,33714.69069549651
"147.32.84.192",31037,"58.114.204.68",16562,5,874,4,560,1,314,2829.827042,6.463496000000305,693.1233499641353,388.644164087033
"147.32.84.192",31037,"188.52.2.150",14381,6,768,6,768,0,0,2830.231077,49.789131,123.40042649067324,0
"147.32.84.192",31037,"2.61.123.114",52185,3,613,2,280,1,333,2830.231188,0.20170899999993708,11105.106861868824,13207.144946436852
"147.32.84.192",31037,"95.154.121.225",51359,4,560,4,560,0,0,2830.445258,5.43912599999976,823.6617427138474,0
"147.32.84.192",31037,"175.139.81.3",16237,6,606,4,416,2,190,2830.845995,731.0246699999998,4.552513939098664,2.079273193338332
"147.32.84.192",31037,"113.68.217.21",16601,4,560,4,560,0,0,2835.884502,6.05824100000018,739.4885743237793,0
"147.32.84.192",31037,"90.150.241.58",49767,4,560,4,560,0,0,2835.8846,6.058285000000069,739.4832035798826,0
"147.32.84.192",31037,"2.225.121.98",50746,4,560,4,560,0,0,2836.489735,5.4533369999999195,821.5153400569351,0
"147.32.84.192",31037,"92.115.92.170",24201,4,560,4,560,0,0,2839.920685,6.042615999999725,741.4007443134238,0
"147.32.84.192",31037,"121.145.170.23",57966,4,560,4,560,0,0,2839.9208,6.042746000000079,741.384794264055,0
"147.32.84.192",31037,"114.198.38.158",10049,4,416,4,416,0,0,2840.930739,10.06590499999993,330.6210420225527,0
"147.32.84.192",31037,"78.138.213.244",26681,5,893,4,560,1,333,2845.963675,6.5431109999999535,684.6895918470635,407.14577515191456
"147.32.84.192",31037,"78.90.39.3",55048,5,893,4,560,1,333,2845.963787,6.089575999999852,735.6834039020301,437.4688812488858
"147.32.84.192",31037,"114.17.219.93",22429,4,560,4,560,0,0,2845.963897,6.04192699999976,741.4852910338337,0
"147.32.84.192",31037,"82.230.162.188",51413,8,976,8,976,0,0,2852.206198,57.81409299999996,135.05357595076353,0
"147.32.84.192",31037,"109.248.153.130",6881,7,1101,6,768,1,333,2852.206307,38.10369900000023,161.24418786742888,69.914472083143
"147.32.84.192",31037,"68.127.103.81",56848,3,603,2,280,1,323,2852.611058,0.31041800000002695,7216.076387322273,8324.259546803909
"147.32.84.192",31037,"188.107.127.230",47335,4,560,4,560,0,0,2852.611167,5.24453799999992,854.2220496829402,0
"147.32.84.192",31037,"94.179.155.18",35691,4,560,4,560,0,0,2853.01326,5.845468999999866,766.4055698524965,0
"147.32.84.192",31037,"117.195.11.112",17716,4,560,4,560,0,0,2855.829953,6.052406000000246,740.2015000315275,0
"147.32.84.192",31037,"46.45.4.207",49206,6,624,4,416,2,208,2860.879604,701.341578,4.745191365226603,2.3725956826133014
"147.32.84.192",31037,"119.67.188.74",52509,4,560,4,560,0,0,2861.882492,6.043907999999647,741.2422558384843,0
"147.32.84.192",31037,"87.16.4.100",63090,4,560,4,560,0,0,2861.882608,6.043893999999909,741.243972842685,0
"147.32.84.192",31037,"79.103.225.135",48951,3,312,2,208,1,104,2919.904381,0.08981900000026144,18526.147028971114,9263.073514485557
"147.32.84.192",31037,"182.243.237.56",4041,3,303,2,208,1,95,2920.311625,0.6128700000003846,2715.0945551241794,1240.0672246961396
"147.32.84.192",7600,"114.132.243.222",41876,4,360,4,360,0,0,3113.309333,4.153614999999718,693.371918196606,0
"147.32.84.192",31037,"95.154.117.173",52202,8,976,8,976,0,0,3519.946746,63.67951099999982,122.61400688205696,0
"147.32.84.192",31037,"203.118.175.185",1025,4,560,4,560,0,0,3539.492597,6.048181000000113,740.7185730717907,0
"147.32.84.192",31037,"61.156.151.89",3151,4,416,4,416,0,0,3540.50771,10.065398000000187,330.63769559831997,0
"147.243.236.28",55121,"147.32.84.191",7600,6,749,2,249,4,500,2682.78634,0.5010400000001027,3975.730480599536,7983.394539356498
"149.5.33.173",42269,"147.32.84.192",31037,1,145,1,145,0,0,3803.043723,0,0,0
"149.7.96.227",1045,"147.32.84.191",29676,1,136,1,136,0,0,3796.416415,0,0,0
"151.29.159.126",25502,"147.32.84.191",29676,3,825,1,145,2,680,2609.093893,0.1543429999996988,7515.727956578942,35246.17248602538
"151.33.28.226",48606,"147.32.84.192",31037,3,825,1,145,2,680,1357.923216,0.24763700000016797,4684.275774618547,21967.638115452497
"151.45.30.115",43334,"147.32.84.165",32234,3,825,1,145,2,680,3333.387619,0.058717999999771564,19755.44126170021,92646.20729624925
"151.52.16.20",20077,"147.32.84.165",32234,1,143,1,143,0,0,252.252879,0,0,0
"151.62.158.89",55195,"147.32.84.191",29676,12,2152,4,768,8,1384,1673.342868,1240.770746,4.951760846882507,8.923485692819519
"151.66.141.112",7600,"147.32.84.192",7600,394,379801,46,4585,348,375216,2451.792175,0.8515959999999723,43072.06703648349,3524826.3260984058
"151.76.90.1",11230,"147.32.84.165",32234,3,825,1,145,2,680,3431.307516,0.12236200000006647,9480.06734116286,44458.24684131548
"151.76.146.199",59483,"147.32.84.165",32234,3,825,1,145,2,680,583.363246,0.3092460000000301,3751.0590274405718,17591.173370066128
"151.83.137.199",34731,"147.32.84.165",32234,3,825,1,145,2,680,1506.20506,0.2748819999999341,4219.992578634752,19790.310023942286
"154.5.55.34",29976,"147.32.84.165",32234,3,825,1,145,2,680,2728.349725,0.1301130000001649,8915.327446131669,41809.81147151403
"154.5.246.162",62711,"147.32.84.192",31037,3,825,1,145,2,680,3232.039487,0.10732400000006237,10808.393276427694,50687.637434281605
"156.34.62.53",1099,"147.32.84.192",31037,3,825,1,145,2,680,2502.91356,0.14492699999982506,8004.029614919237,37536.13888375918
"156.34.207.171",30425,"147.32.84.191",29676,3,825,1,145,2,680,2231.824066,0.12116199999991295,9573.9588319839,44898.56555689002
"157.157.58.35",2007,"147.32.84.165",32234,3,825,1,145,2,680,3274.309396,0.22032899999976507,5264.853923002586,24690.349432012128
"157.157.74.130",59727,"147.32.84.165",32234,3,825,1,145,2,680,684.51203,0.21283100000005106,5450.33383294596,25560.18625105692
"158.64.148.123",49890,"147.32.84.192",31037,3,825,1,145,2,680,1833.254776,0.2482190000000628,4673.292536025471,21916.130513774624
"159.148.159.134",62853,"147.32.84.192",31037,3,825,1,145,2,680,1601.11097,0.007978000000093743,145399.849584654,681875.1566728601
"159.226.5.129",64759,"147.32.84.191",7600,6,749,2,249,4,500,3630.0043,0.22281100000009246,8940.312641652223,17952.435023398037
"161.200.133.204",42759,"147.32.84.165",32234,3,825,1,145,2,680,960.097787,0.24607399999990776,4714.029113195359,22107.171013605825
"161.200.133.204",52199,"147.32.84.165",32234,6,1650,2,290,4,1360,1904.083227,1.130324999999857,2052.50702231685,9625.550173623848
"161.200.133.204",61435,"147.32.84.165",32234,3,825,1,145,2,680,2778.113662,0.15890799999988303,7299.821280242995,34233.64462458784
"161.200.133.204",25723,"147.32.84.165",32234,3,825,1,145,2,680,3593.581419,0.16514999999981228,7023.917650628632,32939.7517408791
"163.142.21.105",16224,"147.32.84.192",7600,6,749,2,249,4,500,3384.941938,0.6172120000001087,3227.416187630262,6480.755396847916
"164.8.253.70",47689,"147.32.84.191",29676,12,2794,4,688,8,2106,1157.807327,1403.319556,3.9221287670846086,12.005818580639804
"164.77.232.90",19188,"147.32.84.191",29676,3,828,1,148,2,680,2477.873439,0.136098999999831,8699.549592586796,39970.9035335069
"164.132.19.96",30131,"147.32.84.165",32234,3,825,1,145,2,680,3481.176418,0.10521999999991749,11024.520053230466,51701.19749101184
"168.131.240.118",59339,"147.32.84.165",32234,1,143,1,143,0,0,2732.391198,0,0,0
"171.4.44.219",24643,"147.32.84.165",32234,6,1650,2,290,4,1360,2370.155844,908.201039,2.5545004909425124,11.979726440282127
"171.36.128.244",7600,"147.32.84.165",7600,45,36761,7,805,38,35956,1823.444136,1.0218629999999393,6302.214680441882,281493.7031676625
"171.36.133.181",62806,"147.32.84.165",7600,6,749,2,249,4,500,3601.166143,1.417171000000053,1405.6172473187255,2822.524593009489
"171.96.21.203",12508,"147.32.84.165",32234,3,828,1,140,2,688,3583.105837,0.07544999999981883,14844.267727007149,72948.9728298637
"171.237.28.202",7600,"147.32.84.191",7600,6,749,2,249,4,500,1449.202469,1.7029999999999745,1169.700528479172,2348.796241926048
"173.8.59.254",63238,"147.32.84.165",32234,3,825,1,145,2,680,1785.659717,0.25430600000004233,4561.433863140495,21391.551909900256
"173.13.77.153",15932,"147.32.84.192",31037,3,825,1,145,2,680,908.8978,0.035255000000006476,32903.134307184424,154304.35399231318
"173.45.195.2",55000,"147.32.84.192",31037,3,825,1,145,2,680,2794.302768,0.22581099999979415,5137.039382497122,24090.943311020983
"173.51.127.210",44636,"147.32.84.191",29676,3,825,1,145,2,680,2885.051198,0.031921999999667605,36338.57527761665,170415.38750882293
"173.52.254.76",7600,"147.32.84.192",7600,601,571296,83,8300,518,562996,1357.958694,19.217620000000124,3455.1625019122853,234366.5864971818
"173.53.68.238",61188,"147.32.84.165",32234,3,825,1,145,2,680,395.428231,0.3542980000000284,3274.0800117412655,15354.306261959038
"173.57.39.214",58230,"147.32.84.165",32234,3,825,1,145,2,680,2076.40886,0.18545499999981985,6254.886630185904,29333.261438113204
"173.63.22.89",25402,"147.32.84.191",29676,3,825,1,145,2,680,2604.360757,0.2525150000001304,4593.786507729842,21543.27465693995
"173.70.106.35",22340,"147.32.84.192",31037,1,143,1,143,0,0,1015.548367,0,0,0
"173.71.23.8",18904,"147.32.84.165",32234,3,825,1,145,2,680,1928.954978,0.13667899999995825,8487.03897453416,39801.28622540157
"173.79.7.225",25980,"147.32.84.165",32234,3,825,1,145,2,680,1957.152932,0.10004200000003038,11595.130045377418,54377.16159211479
"173.89.142.160",42602,"147.32.84.191",29676,3,825,1,145,2,680,3276.935421,0.059922999999798776,19358.176326350404,90783.17173736742
"173.168.171.165",55110,"147.32.84.192",31037,3,825,1,145,2,680,3473.143661,0.09759799999983443,11885.489456771325,55738.84710761726
"173.171.53.20",39478,"147.32.84.165",32234,3,825,1,145,2,680,1561.258667,0.13045499999998356,8891.955080297008,41700.20313518597
"173.175.173.103",58857,"147.32.84.165",32234,3,825,1,145,2,680,1830.542728,0.1122250000000804,10336.377812422981,48474.0476720526
"173.180.21.88",61775,"147.32.84.191",29676,3,825,1,145,2,680,3076.650819,0.17901800000026924,6479.795327834382,30388.00567536124
"173.184.40.222",32671,"147.32.84.191",29676,3,825,1,145,2,680,1925.034536,0.1329600000001392,8724.42839950952,40914.5607701136
"173.192.81.163",18767,"147.32.84.191",29676,1,143,1,143,0,0,3688.22373,0,0,0
"173.193.9.80",29413,"147.32.84.165",32234,1,107,1,107,0,0,1252.414981,0,0,0
"173.193.32.145",53187,"147.32.84.165",32234,1,143,1,143,0,0,1302.607868,0,0,0
"173.193.51.10",15014,"147.32.84.165",32234,3,321,3,321,0,0,2974.353345,30.031129999999848,85.5112678077719,0
"173.218.88.70",38284,"147.32.84.165",32234,3,825,1,145,2,680,2853.476674,0.08486099999981889,13669.41233313861,64104.83025196038
"173.221.156.51",44253,"147.32.84.191",29676,9,1593,1,145,8,1448,1197.051101,693.0802899999999,1.6736877627843092,16.713792279390894
"174.1.78.45",24720,"147.32.84.165",32234,3,825,1,145,2,680,1750.321127,0.2213000000001557,5241.753276092109,24582.015363742306
"174.3.48.16",44306,"147.32.84.165",32234,3,825,1,145,2,680,3108.032399,0.10720499999979438,10820.390840000233,50743.901870345915
"174.3.63.65",51585,"147.32.84.191",29676,3,825,1,145,2,680,1814.113008,0.2639689999998609,4394.455409539041,20608.48054128654
"174.34.144.211",58006,"147.32.84.165",32234,3,825,1,145,2,680,2197.279868,0.08803699999998571,13176.27815577755,61792.20100640507
"174.53.161.157",44884,"147.32.84.165",32234,3,828,1,148,2,680,3724.389052,0.1184889999999541,9992.48875423422,45911.434816751826
"174.53.252.61",55083,"147.32.84.165",32234,3,825,1,145,2,680,2921.755246,0.08503499999960695,13641.441759338646,63973.65790586399
"174.66.155.118",64794,"147.32.84.191",29676,3,825,1,145,2,680,1355.210878,0.12396499999999833,9357.479933852423,43883.3541725493
"174.66.207.71",15645,"147.32.84.165",32234,4,970,2,290,2,680,2949.807388,828.8221059999996,2.7991531393830864,6.563531499243099
"174.79.107.216",6881,"147.32.84.165",32234,1,143,1,143,0,0,3649.968414,0,0,0
"174.93.11.172",61362,"147.32.84.192",31037,3,825,1,145,2,680,1232.385406,0.2111779999997907,5492.996429557765,25760.25911792607
"174.94.28.39",33187,"147.32.84.192",31037,12,3300,4,580,8,2720,750.733746,2867.919316,1.6178976772859812,7.587382210720464
"174.102.200.74",54191,"147.32.84.192",31037,3,825,1,145,2,680,3534.741901,0.10337600000002567,11221.173193001392,52623.43290510998
"174.106.243.9",20034,"147.32.84.165",32234,3,825,1,145,2,680,2611.217388,0.10329799999999523,11229.646266143136,52663.16869639539
"174.112.128.219",24914,"147.32.84.165",32234,3,825,1,145,2,680,1203.033268,0.29959200000007513,3871.932494858705,18158.028251751166
"174.112.146.207",57594,"147.32.84.192",31037,3,825,1,145,2,680,3102.616905,0.15173400000003312,7644.957623207368,35852.215060558694
"174.115.244.233",32090,"147.32.84.192",31037,3,825,1,145,2,680,2992.992817,0.017356000000290805,66835.67642201913,313436.27563429653
"174.117.203.18",63306,"147.32.84.165",32234,3,825,1,145,2,680,1185.794531,0.17715100000009443,6548.086096038869,30708.265829699525
"174.126.53.232",12302,"147.32.84.191",29676,6,1212,2,334,4,878,2706.753898,40.0422309999999,66.72954861081558,175.4148014380122
"174.252.182.87",58367,"147.32.84.165",32234,3,282,1,100,2,182,787.903478,0.22832000000005337,3503.854239662811,6377.014716186316
"174.252.185.79",50314,"147.32.84.165",32234,1,143,1,143,0,0,2471.725011,0,0,0
"175.17.242.26",7600,"147.32.84.192",7600,6,749,2,249,4,500,2803.689134,1.1617069999997511,1714.7180829593235,3443.2090019263524
"175.18.22.69",33931,"147.32.84.165",7600,6,749,2,249,4,500,3116.039604,0.5555960000001505,3585.3389873207516,7199.4758781541195
"175.42.104.168",7601,"147.32.84.165",7600,6,749,2,249,4,500,2014.924117,0.7773879999999735,2562.4269991305086,5145.4357412259205
"175.44.0.2",7600,"147.32.84.192",7600,6,749,2,249,4,500,3523.679502,0.5151329999998779,3866.9625125947514,7764.984965049702
"175.96.118.199",7600,"147.32.84.192",7600,954,946115,96,9799,858,936316,1921.467306,10.169495999999981,7708.54327490764,736568.2625766326
"175.112.240.226",20679,"147.32.84.192",31037,3,825,1,145,2,680,1913.144174,0.2185899999999492,5306.738643123059,24886.774326370207
"175.124.66.182",65535,"147.32.84.192",31037,3,825,1,145,2,680,1543.94051,0.2397320000000036,4838.73658919119,22692.00607344834
"175.137.149.198",14593,"147.32.84.165",7600,6,749,2,249,4,500,2725.782551,0.317138000000341,6281.1772792849115,12612.805781696608
"175.137.205.66",7600,"147.32.84.165",7600,6,749,2,249,4,500,2751.582962,0.3400280000000748,5858.3410777923045,11763.737104000611
"175.138.37.194",7600,"147.32.84.192",7600,6,749,2,249,4,500,2253.729359,0.3231470000000627,6164.377202943594,12378.26747579035
"175.138.58.198",7600,"147.32.84.165",7600,108,98865,14,1421,94,97444,477.374668,1.3512560000000349,8412.91361518447,576909.1867121995
"175.138.131.56",7600,"147.32.84.192",7600,876,817289,138,13133,738,804156,3034.385086,31.258572000000186,3361.126029685533,205807.48218440567
"175.138.187.220",10010,"147.32.84.191",7600,6,749,2,249,4,500,1644.312246,0.4172470000000885,4774.150563094708,9586.647717057645
"175.140.27.96",7600,"147.32.84.192",7600,428,380043,84,8099,344,371944,1100.196422,83.96013199999993,771.6995966609492,35440.05862210891
"175.140.59.75",36940,"147.32.84.191",29676,6,1650,2,290,4,1360,1368.16644,898.399484,2.582370138583027,12.110425477492816
"175.141.7.191",7600,"147.32.84.192",7600,6,749,2,249,4,500,3666.047236,0.34954100000004473,5698.902274696659,11443.57886485273
"175.141.80.239",7600,"147.32.84.191",7600,6,749,2,249,4,500,820.14024,0.4218180000000302,4722.415828627174,9482.762708086695
"175.141.150.231",10271,"147.32.84.191",7600,6,749,2,249,4,500,912.85718,0.3828490000000784,5203.095737482904,10447.983408600208
"175.141.153.32",7600,"147.32.84.165",7600,3,267,3,267,0,0,50.224356,9.883263999999997,216.12293266677898,0
"175.141.237.6",16817,"147.32.84.165",7600,24,2152,8,712,16,1440,412.820111,21.01574499999998,271.034883607505,548.1604387567517
"175.144.240.184",7600,"147.32.84.192",7600,6,749,2,249,4,500,2736.580144,0.3336760000001959,5969.862980852175,11987.67666837786
"175.144.240.184",7600,"147.32.84.191",7600,6,749,2,249,4,500,2890.343713,0.3232329999996182,6162.737096776484,12374.974089912617
"175.145.46.140",7600,"147.32.84.192",7600,6,749,2,249,4,500,3512.31423,0.6740030000000843,2955.476459303224,5934.69168534784
"175.145.60.123",7600,"147.32.84.191",7600,6,749,2,249,4,500,2887.866818,0.25284400000009555,7878.375599180709,15820.031323656043
"175.145.125.136",7600,"147.32.84.191",7600,6,749,2,249,4,500,1135.52226,0.3005080000000362,6628.775273868782,13310.793722628077
"175.145.209.243",7600,"147.32.84.191",7600,6,749,2,249,4,500,1680.440692,0.28042600000003404,7103.478279473937,14264.012609385416
"175.145.232.112",7600,"147.32.84.192",7600,6,749,2,249,4,500,1395.58947,0.2917860000000019,6826.921099710017,13708.676907048228
"175.147.210.228",7600,"147.32.84.191",7600,295,281174,37,3658,258,277516,502.461249,5.680091000000004,5152.030134728471,390861.343594671
"175.148.153.139",7600,"147.32.84.165",7600,7,909,3,409,4,500,430.264091,1.1595899999999801,2821.6869755689995,3449.495080157701
"175.157.75.16",29911,"147.32.84.165",32234,3,825,1,145,2,680,1050.946121,0.24975100000006023,4644.626047542233,21781.694567784267
"175.165.29.34",7600,"147.32.84.165",7600,18,1616,4,356,14,1260,537.156683,12.195363999999927,233.53136486947147,826.5435947627361
"175.171.128.190",10122,"147.32.84.191",7600,393,374736,51,4988,342,369748,2927.785519,4.013051999999789,9943.554182702368,737090.8724831265
"175.181.158.157",7600,"147.32.84.165",7600,6,749,2,249,4,500,3383.637859,0.35135700000000725,5669.447314269984,11384.432357971857
"175.199.172.86",45761,"147.32.84.165",32234,7,1241,1,145,6,1096,1453.819682,1991.179293,0.5825693367131656,4.403420641638824
"175.200.244.36",17238,"147.32.84.192",31037,3,825,1,145,2,680,3565.808557,0.3097600000000966,3744.8347107426334,17561.983471068903
"175.211.226.195",58132,"147.32.84.165",32234,19,2381,3,429,16,1952,1863.132797,1213.191567,2.8289019585643063,12.871833620320572
"175.215.68.210",7600,"147.32.84.191",7600,7,909,3,409,4,500,2877.335338,1.017536000000291,3215.611044718874,3931.064846844589
"176.8.34.94",41706,"147.32.84.165",32234,3,825,1,145,2,680,2901.176519,0.08421700000008059,13773.941128262582,64595.034256679704
"176.8.160.179",50495,"147.32.84.192",31037,3,825,1,145,2,680,1602.288684,0.25358799999980874,4574.348943959789,21452.119185466596
"176.14.92.73",20065,"147.32.84.192",31037,3,825,1,145,2,680,1117.243169,0.35079399999995076,3306.7840384959914,15507.676870188097
"176.16.11.183",17520,"147.32.84.192",31037,3,825,1,145,2,680,2033.292652,0.1453679999999622,7979.747950032343,37422.26624842754
"176.44.51.144",53692,"147.32.84.165",32234,3,825,1,145,2,680,2330.415504,0.1681340000000091,6899.25892442895,32355.14530077025
"176.44.51.150",58088,"147.32.84.192",31037,3,825,1,145,2,680,1699.758056,0.1621460000001207,7154.046353281219,33550.010484353304
"176.45.70.240",48020,"147.32.84.192",31037,3,825,1,145,2,680,890.992644,0.3403619999999137,3408.1360433899617,15982.982824173614
"176.45.84.132",11974,"147.32.84.192",31037,3,825,1,145,2,680,932.112705,0.06876599999998234,16868.801442577696,79108.86193760575
"176.62.178.234",37894,"147.32.84.165",32234,3,825,1,145,2,680,1758.756286,0.2580249999998614,4495.688402289015,21083.22836935538
"176.62.187.125",63163,"147.32.84.192",31037,12,3300,4,580,8,2720,1451.611091,1893.1417439999998,2.4509522410066302,11.494120854375922
"177.9.169.232",56256,"147.32.84.191",29676,3,825,1,145,2,680,1325.801594,0.11912899999992987,9737.34355195362,45664.78355398939
"177.9.169.232",59170,"147.32.84.191",29676,3,825,1,145,2,680,3080.530524,0.12902500000018335,8990.505715933747,42162.37163334446
"177.17.34.195",10618,"147.32.84.165",32234,3,825,1,145,2,680,1783.401152,0.06931600000007165,16734.952968994185,78481.15875114514
"177.19.67.205",18445,"147.32.84.192",31037,3,825,1,145,2,680,1637.279378,0.259412999999995,4471.634035302865,20970.421682799646
"178.17.205.164",6881,"147.32.84.191",29676,1,143,1,143,0,0,3188.685955,0,0,0
"178.19.26.44",37009,"147.32.84.192",31037,3,825,1,145,2,680,3415.079739,0.18273900000031063,6347.851307044628,29769.233715795493
"178.22.220.139",5461,"147.32.84.191",29676,3,825,1,145,2,680,1286.114209,0.2064989999998943,5617.460617245574,26343.953239496484
"178.23.226.99",14146,"147.32.84.192",31037,1,107,1,107,0,0,3104.532009,0,0,0
"178.35.225.242",15680,"147.32.84.165",32234,3,825,1,145,2,680,1357.083287,0.1368200000001707,8478.292647263213,39760.268966475756
"178.37.49.240",20321,"147.32.84.165",32234,3,825,1,145,2,680,810.685339,0.06769699999995282,17135.175857140028,80358.06608865668
"178.37.137.191",16058,"147.32.84.191",29676,3,825,1,145,2,680,1376.54166,0.15623999999979787,7424.475166420255,34818.22836666051
"178.44.241.89",57336,"147.32.84.165",32234,3,825,1,145,2,680,2864.083456,0.2135710000002291,5431.44902631329,25471.62301995198
"178.45.148.49",41847,"147.32.84.192",31037,3,825,1,145,2,680,2696.299402,0.09907199999997829,11708.656330751919,54909.56072352624
"178.46.72.122",35691,"147.32.84.192",31037,3,825,1,145,2,680,3406.842363,0.17074400000001333,6793.796560932797,31860.56318230553
"178.46.94.83",52921,"147.32.84.165",32234,3,825,1,145,2,680,3379.550867,0.1131439999999202,10252.421692717406,48080.32242101956
"178.47.8.154",25833,"147.32.84.191",29676,9,1696,3,492,6,1204,1358.48535,1418.504402,2.7747534617802336,6.790250341429677
"178.47.231.150",21028,"147.32.84.191",29676,1,145,1,145,0,0,3780.58589,0,0,0
"178.48.156.115",38512,"147.32.84.165",32234,1,143,1,143,0,0,3766.577147,0,0,0
"178.48.251.114",63088,"147.32.84.165",32234,3,825,1,145,2,680,2138.819814,0.13405199999988326,8653.358398241056,40581.26697106151
"178.61.185.151",39918,"147.32.84.165",32234,9,2475,3,435,6,2040,3597.042287,115.27014299999973,30.189951269514847,141.58046112600067
"178.64.121.166",20153,"147.32.84.192",31037,3,825,1,145,2,680,3329.859472,0.18849700000009761,6153.9440945977885,28859.875753975834
"178.65.115.146",16769,"147.32.84.191",29676,1,107,1,107,0,0,1559.291824,0,0,0
"178.65.195.232",27064,"147.32.84.165",32234,3,825,1,145,2,680,3630.762363,0.056837999999970634,20408.88138218444,95710.61613714084
"178.67.88.252",30144,"147.32.84.165",32234,3,828,1,148,2,680,697.9073,0.20309900000006564,5829.66927458834,26784.96693729778
"178.67.213.153",54680,"147.32.84.165",32234,3,825,1,145,2,680,474.678082,0.18540799999999535,6256.472212633916,29340.697273041813
"178.68.137.190",49096,"147.32.84.191",29676,3,825,1,145,2,680,1413.981776,0.23652299999980642,4904.385620007142,22999.877390378326
"178.73.120.156",55623,"147.32.84.165",32234,3,825,1,145,2,680,2781.296498,0.232028999999784,4999.37507811989,23445.345193941554
"178.73.220.217",52276,"147.32.84.165",32234,4,1007,2,327,2,680,3445.529481,44.06640800000014,59.36494755823964,123.45004385199681
"178.73.222.39",10000,"147.32.84.165",32234,3,825,1,145,2,680,3717.218882,0.16884499999969194,6870.206402334191,32218.898990256894
"178.76.227.44",37729,"147.32.84.165",32234,1,143,1,143,0,0,1824.833965,0,0,0
"178.77.171.170",32431,"147.32.84.165",32234,3,825,1,145,2,680,1951.205401,0.2990429999999833,3879.0408068407046,18191.36378380468
"178.89.65.0",39568,"147.32.84.192",31037,3,828,1,148,2,680,1181.722082,0.23632399999996778,5010.07091958566,23019.24476566384
"178.90.71.229",35884,"147.32.84.165",32234,3,825,1,145,2,680,928.844089,0.25307999999995445,4583.5308993211975,21495.1793899201
"178.90.97.85",38693,"147.32.84.165",32234,1,143,1,143,0,0,2530.485444,0,0,0
"178.90.138.45",41215,"147.32.84.191",29676,3,825,1,145,2,680,2496.967012,0.3415899999999965,3395.88395444835,15925.52475189571
"178.90.177.14",19280,"147.32.84.191",29676,3,825,1,145,2,680,2110.512295,0.3164639999999963,3665.50381717988,17189.948935740125
"178.90.218.55",10006,"147.32.84.192",31037,7,1241,1,145,6,1096,1431.899341,1221.800093,0.94941881789495,7.176296720088725
"178.91.169.142",57167,"147.32.84.191",29676,3,825,1,145,2,680,2776.857284,0.1323469999997542,8764.83788829482,41104.06733821019
"178.91.243.12",35691,"147.32.84.192",31037,3,825,1,145,2,680,3205.696621,0.038294999999834545,30291.16072607421,142055.09857745146
"178.93.135.239",44375,"147.32.84.165",32234,3,825,1,145,2,680,414.835307,0.2211849999999913,5244.478603883833,24594.796211317287
"178.93.139.101",47995,"147.32.84.191",29676,12,2010,4,688,8,1322,1742.981378,1455.8890649999998,3.780507823238579,7.264289741746223
"178.93.147.89",35691,"147.32.84.165",32234,3,825,1,145,2,680,3701.73653,0.1990339999997559,5828.149964334851,27332.013625846193
"178.93.184.107",1036,"147.32.84.191",29676,7,1241,1,145,6,1096,1365.220989,1984.4581710000002,0.5845424292392404,4.418334499629017
"178.94.212.185",56847,"147.32.84.165",32234,4,1007,2,327,2,680,1761.824036,34.15761300000008,76.58614786694824,159.2617142187303
"178.95.47.79",63728,"147.32.84.192",31037,2,286,2,286,0,0,1895.61267,926.1392190000001,2.4704709109181993,0
"178.95.64.50",28996,"147.32.84.191",29676,12,2378,4,688,8,1690,1351.920749,1521.2841470000003,3.6179960271419294,8.887228613182938
"178.95.72.136",26135,"147.32.84.191",29676,6,980,2,344,4,636,3276.738074,41.31489499999998,66.61035929051741,123.15171078130545
"178.95.201.11",31177,"147.32.84.165",32234,1,107,1,107,0,0,3393.549531,0,0,0
"178.115.111.229",51422,"147.32.84.165",32234,3,825,1,145,2,680,1987.544838,0.30409899999995105,3814.547236262489,17888.911176955124
"178.120.57.39",62209,"147.32.84.192",31037,3,825,1,145,2,680,2418.586954,0.2789379999999255,4158.630233242906,19502.54178348397
"178.120.112.206",44662,"147.32.84.165",32234,3,825,1,145,2,680,1585.977906,0.1609809999999925,7205.819320292793,33792.80784689034
"178.121.240.73",13662,"147.32.84.191",29676,3,825,1,145,2,680,2226.994878,0.10386500000004162,11168.343522837677,52375.67996916979
"178.122.128.60",44995,"147.32.84.192",31037,3,825,1,145,2,680,3721.968868,0.2995490000002974,3872.4883074183135,18160.634820996227
"178.123.81.38",15265,"147.32.84.165",32234,3,825,1,145,2,680,1752.107688,0.04010300000004463,28925.516794222603,135650.69944876808
"178.123.95.103",15719,"147.32.84.165",32234,3,825,1,145,2,680,2604.15754,0.24221799999986615,4789.074304967596,22459.107085365275
"178.123.145.254",20816,"147.32.84.192",31037,3,825,1,145,2,680,918.231897,0.2254130000000032,5146.10958551629,24133.47943552467
"178.124.213.219",20310,"147.32.84.165",32234,3,825,1,145,2,680,3603.806728,0.12315399999988585,9419.101287827234,44172.33707394841
"178.124.232.121",11011,"147.32.84.192",31037,3,825,1,145,2,680,1754.989435,0.22814100000005055,5084.574890088774,23844.90293283011
"178.125.228.160",30409,"147.32.84.192",31037,3,825,1,145,2,680,2466.690091,0.10321699999985867,11238.458781030144,52704.49635241723
"178.126.22.58",27015,"147.32.84.192",31037,3,825,1,145,2,680,3472.803327,0.2351579999999558,4932.8536558408305,23133.382661874242
"178.126.45.200",15840,"147.32.84.165",32234,3,825,1,145,2,680,624.321591,0.23603700000001027,4914.483746192121,23047.234120073394
"178.126.88.234",18534,"147.32.84.192",31037,3,825,1,145,2,680,2952.147787,0.16588099999989936,6992.964836242269,32794.59371479133
"178.126.107.146",17800,"147.32.84.192",31037,3,825,1,145,2,680,2698.945557,0.26392100000020946,4395.254640589719,20612.228659317305
"178.126.178.42",64668,"147.32.84.165",32234,6,1650,2,290,4,1360,1545.411162,1802.2100389999998,1.2873083324334984,6.037032179688131
"178.128.211.167",59889,"147.32.84.191",29676,3,825,1,145,2,680,2262.843049,0.10186100000009901,11388.06805351285,53406.112250956816
"178.134.94.157",64930,"147.32.84.191",29676,12,3300,4,580,8,2720,1843.876448,1749.483965,2.6522106477266285,12.43795338244212
"178.134.210.77",58771,"147.32.84.192",31037,3,825,1,145,2,680,1796.926086,0.12206700000001547,9502.977872806352,44565.68933454013
"178.140.96.151",6882,"147.32.84.165",32234,1,143,1,143,0,0,3823.509212,0,0,0
"178.148.14.98",40714,"147.32.84.192",31037,1,145,1,145,0,0,3817.072364,0,0,0
"178.150.102.28",32865,"147.32.84.191",29676,3,825,1,145,2,680,3032.650315,0.25145800000018426,4613.096421665447,21633.831494706923
"178.150.122.161",13490,"147.32.84.165",32234,3,825,1,145,2,680,3300.63125,0.13758300000017698,8431.274212646242,39539.768721375476
"178.150.165.238",64422,"147.32.84.165",32234,3,825,1,145,2,680,2665.399079,0.2401110000000699,4831.09895006752,22656.188179626988
"178.150.189.141",2048,"147.32.84.165",32234,3,825,1,145,2,680,3093.281348,0.2686499999999796,4317.885724921228,20249.395123768518
"178.151.17.221",35691,"147.32.84.192",31037,3,825,1,145,2,680,2573.737618,0.1633480000000418,7101.403139308122,33303.13196365188
"178.158.112.93",28490,"147.32.84.165",32234,1,143,1,143,0,0,1446.200491,0,0,0
"178.162.55.113",12311,"147.32.84.165",32234,1,143,1,143,0,0,2373.541038,0,0,0
"178.163.68.119",22997,"147.32.84.191",29676,3,825,1,145,2,680,3058.521963,0.19019899999966583,6098.875388419698,28601.622511209618
"178.168.12.117",35691,"147.32.84.191",29676,12,2264,4,688,8,1576,2391.171776,1338.193433,4.113007779197494,9.421657354673329
"178.168.24.175",29518,"147.32.84.191",29676,6,1132,2,384,4,748,2517.62399,36.23132899999973,84.78849892588877,165.1609301993875
"178.168.49.247",35691,"147.32.84.191",29676,9,1744,3,492,6,1252,1868.964707,1243.658433,3.164856117692566,8.053658250713601
"178.168.64.180",55438,"147.32.84.165",32234,1,107,1,107,0,0,2321.372817,0,0,0
"178.168.72.195",51704,"147.32.84.165",32234,3,825,1,145,2,680,3374.642652,0.10439300000007279,11111.856158930112,52110.77371084466
"178.168.110.250",28270,"147.32.84.165",32234,3,825,1,145,2,680,3655.499341,0.1930619999998271,6008.432524272197,28177.47666555237
"178.175.88.184",26647,"147.32.84.192",31037,3,825,1,145,2,680,3132.956506,0.22908400000005713,5063.644776587237,23746.747917788423
"178.176.76.216",61258,"147.32.84.191",29676,1,143,1,143,0,0,2667.843435,0,0,0
"178.176.207.196",22457,"147.32.84.192",31037,3,825,1,145,2,680,2129.538473,0.21917600000006132,5292.550279226172,24820.23579223308
"178.177.5.69",32882,"147.32.84.165",32234,3,825,1,145,2,680,1069.929869,0.22812599999997474,5084.9092168368725,23846.47080999361
"178.178.6.158",44601,"147.32.84.165",32234,3,825,1,145,2,680,3181.309146,0.16743499999984124,6928.0616358652605,32490.220085437086
"178.178.32.179",40345,"147.32.84.191",29676,10,2146,4,688,6,1458,2536.772275,1258.9958800000004,4.371737896394068,9.264525949044405
"178.178.247.137",28148,"147.32.84.192",31037,3,825,1,145,2,680,992.18026,0.14560500000004595,7966.759383260423,37361.35434908336
"178.179.198.90",57333,"147.32.84.192",31037,3,825,1,145,2,680,849.042806,0.15889399999991838,7300.4644605875355,34236.66091861741
"178.187.46.88",45359,"147.32.84.165",32234,1,145,1,145,0,0,3813.088746,0,0,0
"178.187.79.233",48897,"147.32.84.191",29676,3,825,1,145,2,680,2428.888914,0.16987599999993108,6828.510207448201,32023.35821423984
"178.187.106.96",30255,"147.32.84.165",32234,3,825,1,145,2,680,3718.515628,0.07628799999974945,15205.536912801617,71308.72483244896
"178.187.143.145",33231,"147.32.84.165",32234,1,143,1,143,0,0,2503.475909,0,0,0
"178.187.167.176",61108,"147.32.84.191",29676,3,825,1,145,2,680,2951.305524,0.23477700000012192,4940.858772364404,23170.92389798479
"178.187.176.26",19083,"147.32.84.191",29676,3,825,1,145,2,680,3571.657732,0.16963600000008228,6838.171142914461,32068.66467021954
"178.187.188.70",14706,"147.32.84.165",32234,4,1007,2,327,2,680,2408.811446,36.976001,70.74859176902338,147.12245383160825
"178.188.198.110",13543,"147.32.84.192",31037,3,825,1,145,2,680,2061.552005,0.09601000000020576,12082.074783850785,56660.7645035761
"178.205.33.211",61819,"147.32.84.191",29676,3,825,1,145,2,680,1841.324253,0.24531099999990147,4728.691334675029,22175.93177640703
"178.206.112.131",17438,"147.32.84.165",32234,3,825,1,145,2,680,1256.686784,0.15318600000000515,7572.4935699082225,35512.38363819029
"178.206.147.90",34105,"147.32.84.165",32234,6,1650,2,290,4,1360,1673.781786,1868.8507319999999,1.241404655960506,5.821759765883753
"178.209.80.9",47580,"147.32.84.165",32234,3,825,1,145,2,680,1292.58961,0.14115900000001602,8217.683605011855,38538.10242350387
"178.210.221.8",35288,"147.32.84.165",32234,3,825,1,145,2,680,247.536521,0.07026899999999614,16507.99072137164,77416.7840726394
"178.212.103.35",49201,"147.32.84.191",29676,3,825,1,145,2,680,2987.233271,0.18083500000011554,6414.687422231641,30082.67204908632
"178.213.7.7",12005,"147.32.84.192",31037,4,1007,2,327,2,680,2104.428204,37.92291900000009,68.98203168379506,143.4488732262405
"178.214.164.90",1041,"147.32.84.165",32234,3,825,1,145,2,680,2020.865274,0.02917200000001685,39764.157411193264,186480.18648007876
"178.215.87.30",58855,"147.32.84.192",31037,3,825,1,145,2,680,2525.587553,0.19840800000019954,5846.538446024522,27418.249264115002
"178.216.78.19",43939,"147.32.84.165",32234,1,143,1,143,0,0,2281.02648,0,0,0
"178.216.120.222",59006,"147.32.84.192",31037,3,825,1,145,2,680,1904.934489,0.17627199999992627,6580.7388581311,30861.396024338952
"178.216.122.249",41532,"147.32.84.192",31037,3,825,1,145,2,680,3185.421101,0.17665100000021994,6566.620058751752,30795.18372380132
"178.217.24.18",21919,"147.32.84.191",29676,3,828,1,148,2,680,1985.09258,0.11035900000001675,10728.622042604775,49293.668844400316
"178.217.24.18",22003,"147.32.84.191",29676,6,1060,2,344,4,716,3471.253137,34.93057699999963,78.78484228874974,163.98240429867678
"178.219.95.44",51529,"147.32.84.165",32234,3,825,1,145,2,680,1263.372353,0.14776200000005701,7850.46222979895,36815.96080181577
"178.222.88.148",56730,"147.32.84.192",31037,3,825,1,145,2,680,1277.299967,0.20654899999999543,5616.100779960328,26337.576071538086
"178.222.149.176",40611,"147.32.84.191",29676,3,825,1,145,2,680,2933.351534,0.08715100000017628,13310.231666850106,62420.39678246946
"178.223.64.190",53611,"147.32.84.165",32234,3,825,1,145,2,680,970.243266,0.13375100000007478,8672.832352650457,40672.59310208491
"178.223.251.16",44617,"147.32.84.191",29676,3,825,1,145,2,680,2824.60593,0.08989199999996345,12904.374137859562,60517.064922375874
"178.234.158.174",18116,"147.32.84.191",29676,6,1650,2,290,4,1360,1371.556653,1904.4356109999999,1.2182086842945514,5.712978657381345
"178.234.201.223",62054,"147.32.84.192",31037,3,825,1,145,2,680,876.778568,0.12301700000000437,9429.591032133434,44221.530357591284
"178.235.35.76",45355,"147.32.84.165",32234,3,825,1,145,2,680,2757.892649,0.13087700000005498,8863.283846661467,41565.74493606757
"178.235.82.79",52382,"147.32.84.192",31037,9,1358,3,492,6,866,1563.968574,1323.11951,2.974787969077714,5.236110530937602
"178.235.194.241",51896,"147.32.84.192",31037,12,2232,4,548,8,1684,735.888695,2882.162206,1.5210802469318065,4.674268496045916
"178.235.248.60",52879,"147.32.84.192",31037,6,884,2,296,4,588,1224.89738,1356.646778,1.7454801341075386,3.4673726988352453
"178.236.80.225",2800,"147.32.84.192",31037,3,825,1,145,2,680,3610.749041,0.26086499999973967,4446.744484699587,20853.698273073922
"178.237.185.155",16661,"147.32.84.191",29676,3,825,1,145,2,680,1995.689888,0.1825059999998757,6355.955420648033,29807.239214073536
"180.9.12.245",24950,"147.32.84.165",32234,3,828,1,140,2,688,2989.221682,0.22830900000008114,4905.632279058653,24107.67862851681
"180.14.73.103",7600,"147.32.84.191",7600,7,909,3,409,4,500,3006.817902,3.7680240000004233,868.3596495138121,1061.5643637088167
"180.25.161.25",6881,"147.32.84.192",31037,1,143,1,143,0,0,881.646899,0,0,0
"180.32.230.11",7600,"147.32.84.192",7600,517,500966,61,6046,456,494920,2544.3232,3.514436000000387,13762.663482844664,1126598.976336335
"180.73.113.160",7600,"147.32.84.191",7600,490,466181,66,6397,424,459784,1472.276343,19.65373199999999,2603.8820515106254,187153.86980956094
"180.74.252.215",7600,"147.32.84.192",7600,527,491878,81,7938,446,483940,1939.856261,28.232472000000143,2249.324820015749,137130.03948077874
"180.75.41.28",13746,"147.32.84.191",29676,6,1650,2,290,4,1360,1949.030381,1726.7415889999997,1.3435710443179696,6.300884897491168
"180.75.59.17",18158,"147.32.84.165",7600,6,749,2,249,4,500,2908.205066,0.910511999999926,2187.7800622069362,4393.132655034008
"180.75.230.129",7600,"147.32.84.191",7600,6,749,2,249,4,500,3367.827534,1.1064069999997628,1800.4224485206864,3615.306121527483
"180.94.130.146",7600,"147.32.84.165",7600,6,749,2,249,4,500,759.773339,0.39374400000008336,5059.124710470707,10158.884960784553
"180.99.83.164",7600,"147.32.84.165",7600,13,1167,3,267,10,900,556.183104,8.160503000000062,261.7485711358704,882.2985543905743
"180.106.77.66",2767,"147.32.84.165",7600,425,401800,59,5700,366,396100,3418.634413,7.449057999999695,6121.579399704213,425396.07021453313
"180.107.246.102",7600,"147.32.84.192",7600,84,73379,12,1211,72,72168,1911.064276,3.0743539999998575,3151.231120424144,187793.59826487995
"180.110.119.46",3531,"147.32.84.165",7600,74,65533,10,1029,64,64504,2467.667286,1.2498279999999795,6586.506303267438,412882.41261998325
"180.113.192.235",7600,"147.32.84.191",7600,204,190227,28,2747,176,187480,2290.603534,6.75020399999994,3255.605312076523,222191.80338846255
"180.115.67.203",1112,"147.32.84.192",7600,374,338737,66,6321,308,332416,2558.378451,25.25623399999995,2002.1987442783472,105293.92466034347
"180.115.142.226",1048,"147.32.84.165",7600,134,121377,18,1793,116,119584,3404.615805,1.8075010000002294,7935.818569393975,529278.8219756883
"180.115.149.149",7600,"147.32.84.165",7600,626,599109,82,7965,544,591144,2858.649746,13.677012999999988,4658.912000741687,345773.7446034455
"180.116.42.86",7600,"147.32.84.165",7600,3,269,1,89,2,180,894.094852,0.0007220000001098015,0,0
"180.117.34.165",55317,"147.32.84.192",7600,6,749,2,249,4,500,2142.127375,1.2387439999997696,1608.080442771364,3229.077194320008
"180.118.55.38",7600,"147.32.84.192",7600,6,749,2,249,4,500,1940.451806,0.41230300000006537,4831.398267778028,9701.602947345436
"180.119.23.21",7600,"147.32.84.165",7600,11,1198,3,338,8,860,2907.762776,5.121200999999928,528.0011466060477,1343.434870062725
"180.120.47.182",5110,"147.32.84.192",7600,6,749,2,249,4,500,2945.465164,0.7443999999995867,2675.9806555630116,5373.455131652634
"180.120.67.194",7600,"147.32.84.165",7600,6,749,2,249,4,500,2892.890503,0.34166499999992084,5830.272342793267,11707.374182315796
"180.121.112.250",7600,"147.32.84.192",7600,161,150046,21,2094,140,147952,1355.084414,1.6477480000000924,10166.603145626068,718323.4329520859
"180.121.163.43",7600,"147.32.84.192",7600,395,372868,55,5316,340,367552,2410.19088,13.51553100000001,3146.602231166498,217558.30385058478
"180.123.185.202",7600,"147.32.84.165",7600,3,269,1,89,2,180,351.262099,0.0012340000000108375,0,0
"180.123.225.115",7600,"147.32.84.165",7600,600,578827,74,7265,526,571562,1942.448038,34.275707999999895,1695.6615454887228,133403.40044908813
"180.124.134.154",7600,"147.32.84.191",7600,152,137319,22,2157,130,135162,3673.90904,4.405834000000141,3916.625093001563,245423.68141876554
"180.125.137.22",7600,"147.32.84.192",7600,199,187547,27,2583,172,184964,1620.991244,6.77526499999999,3049.917604698861,218399.13272765008
"180.127.99.228",7600,"147.32.84.165",7600,3,269,1,89,2,180,2264.098343,0.0002129999998032872,0,0
"180.131.121.23",19053,"147.32.84.165",32234,3,825,1,145,2,680,2729.569039,0.14348800000016126,8084.299732372716,37912.57805526515
"180.142.150.127",7600,"147.32.84.192",7600,294,272987,44,4255,250,268732,1656.566733,19.239747999999963,1769.2539424113072,111740.34088180386
"180.143.94.13",16224,"147.32.84.165",7600,6,538,2,178,4,360,2827.281446,4.024236000000201,353.8559865773103,715.6637930777063
"180.148.44.182",24008,"147.32.84.192",31037,3,825,1,145,2,680,3446.845532,0.2183460000001105,5312.668883329271,24914.585108026924
"180.151.40.133",7600,"147.32.84.192",7600,12,1287,4,427,8,860,2705.193939,6.339929000000211,538.8072957914649,1085.1856542872595
"180.151.46.176",22993,"147.32.84.165",32234,3,825,1,145,2,680,603.934352,0.22829999999999018,5081.033727551686,23828.2961016217
"180.156.51.27",29237,"147.32.84.192",31037,3,828,1,140,2,688,1061.780714,0.28262199999994664,3962.8903623929186,19474.775495188056
"180.157.29.61",7600,"147.32.84.191",7600,6,749,2,249,4,500,2307.505899,0.557390999999825,3573.7929030081673,7176.290969895918
"180.157.77.134",7600,"147.32.84.191",7600,7,909,3,409,4,500,600.870147,1.0814070000000129,3025.687830761185,3698.8848786811554
"180.159.174.121",7600,"147.32.84.191",7600,6,749,2,249,4,500,913.15496,0.7866460000000188,2532.2699155655177,5084.879348525136
"180.168.143.198",7600,"147.32.84.192",7600,6,538,2,178,4,360,2741.565052,10.116750000000138,140.75666592531994,284.6764029950291
"180.171.148.182",45331,"147.32.84.191",29676,6,1212,2,334,4,878,3201.647462,22.75293099999999,117.43541963890284,308.7074803681338
"180.171.227.210",40098,"147.32.84.191",7600,847,825074,97,9618,750,815456,2079.555829,66.77965100000029,1152.2072794300718,97689.15983103853
"180.174.63.38",7600,"147.32.84.165",7600,6,749,2,249,4,500,630.24082,0.6894810000000007,2889.129649693027,5801.465160026159
"180.176.176.25",33418,"147.32.84.192",7600,6,749,2,249,4,500,1672.091394,0.41675199999986035,4779.821092641829,9598.034322573954
"180.176.185.21",7600,"147.32.84.191",7600,262,241823,40,3835,222,237988,1671.296985,4.28011400000014,7168.0333748117455,444825.5350207817
"180.180.163.245",52224,"147.32.84.191",7600,68,58933,10,1017,58,57916,864.230744,0.7909750000000031,10286.039381775616,585768.1974777941
"180.180.237.191",22027,"147.32.84.165",32234,3,828,1,140,2,688,2321.721193,0.05996800000002622,18676.627534676998,91782.2838846984
"180.183.65.220",27809,"147.32.84.192",31037,3,828,1,140,2,688,3659.038713,0.3033770000001823,3691.7762388029646,18142.443230688856
"180.184.200.211",7600,"147.32.84.191",7600,16,1647,4,427,12,1220,1925.828327,10.249700999999959,333.27801464647735,952.2228989899353
"180.189.174.212",7600,"147.32.84.165",7600,6,749,2,249,4,500,1702.00576,2.4252670000000762,821.3528654782906,1649.3029427274912
"180.192.186.25",11497,"147.32.84.192",31037,3,825,1,145,2,680,746.849744,0.19755799999995816,5871.693376123699,27536.217212166313
"180.194.46.221",9465,"147.32.84.165",7600,6,749,2,249,4,500,2640.502275,0.5420020000001387,3675.2631909097945,7380.046568091957
"180.194.229.143",55688,"147.32.84.165",32234,3,825,1,145,2,680,3563.563694,0.16976000000022395,6833.176248812852,32045.24033926027
"180.197.58.252",25876,"147.32.84.192",31037,6,1662,2,286,4,1376,1597.447396,53.88673799999992,42.459426658930504,204.28031847093837
"180.211.223.7",7600,"147.32.84.192",7600,291,274740,39,3812,252,270928,1338.902975,11.169076000000132,2730.3959611340847,194055.80193025587
"180.212.135.196",3139,"147.32.84.191",7600,1085,1083500,99,10260,986,1073240,969.201947,6.104607999999985,13445.580780944527,1406465.4110468717
"180.215.243.108",50587,"147.32.84.191",29676,3,825,1,145,2,680,2049.473195,0.1521020000000135,7626.461190516213,35765.47316931741
"180.217.9.123",7600,"147.32.84.192",7600,16,1436,4,356,12,1080,1584.849435,40.87457399999994,69.67656714905468,211.37834977803104
"180.217.143.74",7600,"147.32.84.165",7600,18,1616,4,356,14,1260,1451.554401,14.202340999999933,200.53032102242958,709.7421474389362
"180.227.84.59",14352,"147.32.84.191",29676,3,825,1,145,2,680,3597.573588,0.22183699999959572,5229.0645834649495,24522.509770732177
"180.231.228.217",54172,"147.32.84.191",29676,1,143,1,143,0,0,3760.405182,0,0,0
"180.242.115.141",10976,"147.32.84.165",7600,208,192607,28,2751,180,189856,3064.664975,31.215267999999924,705.0395979300915,48657.21479629788
"182.20.185.102",7600,"147.32.84.191",7600,6,749,2,249,4,500,495.623738,0.29518300000000863,6748.356104518017,13550.915872526139
"182.32.3.63",16224,"147.32.84.191",7600,6,749,2,249,4,500,2102.211436,0.3615859999999884,5509.0628508848895,11062.3752025801
"182.32.3.63",16224,"147.32.84.165",7600,6,749,2,249,4,500,3286.03823,0.40334200000006604,4938.736853587461,9917.142276280043
"182.32.10.16",7600,"147.32.84.191",7600,6,749,2,249,4,500,1312.934129,0.45388600000001134,4388.767223487726,8812.785589332785
"182.32.86.59",7600,"147.32.84.192",7600,6,749,2,249,4,500,2723.549132,0.3827809999997953,5204.020053244715,10449.839464346816
"182.33.55.65",1678,"147.32.84.192",31037,3,831,1,143,2,688,2812.24886,0.22465599999986807,5092.229898158393,24499.679510020796
"182.35.70.191",7600,"147.32.84.191",7600,306,280213,48,4713,258,275500,535.089963,6.632869000000028,5684.418009763172,332284.56645231356
"182.37.129.102",7600,"147.32.84.191",7600,6,749,2,249,4,500,604.118195,0.5886970000000247,3383.7440992563515,6794.66686597661
"182.37.129.176",7600,"147.32.84.192",7600,1207,1187334,133,13850,1074,1173484,3263.259849,18.92514200000005,5854.64563489139,496052.9226147933
"182.37.152.136",7600,"147.32.84.192",7600,6,749,2,249,4,500,1797.964862,0.38495499999999083,5174.630801002838,10390.824901612124
"182.37.184.26",1617,"147.32.84.165",7600,2043,1946090,289,27566,1754,1918524,1163.496704,82.86225400000012,2661.3806571083583,185225.37414924748
"182.37.185.195",8607,"147.32.84.191",7600,6,749,2,249,4,500,3415.341337,0.3818810000002486,5216.2846541166045,10474.467176940974
"182.38.19.24",7600,"147.32.84.191",7600,90,79979,12,1223,78,78756,2420.916687,1.2982390000001942,7536.362719035968,485309.71569942497
"182.40.223.97",7600,"147.32.84.192",7600,8,929,2,249,6,680,3596.177113,0.5081289999998262,3920.2643423238615,10705.942782249902
"182.48.192.166",31542,"147.32.84.192",31037,3,825,1,145,2,680,2232.926344,0.20030799999994997,5791.081734130887,27158.176408337953
"182.48.218.122",49433,"147.32.84.165",32234,3,825,1,145,2,680,2589.928477,0.2832229999999072,4095.7125657181095,19207.4796185401
"182.53.40.101",80,"147.32.84.165",32234,3,825,1,145,2,680,2875.753284,0.05891700000029232,19688.71463235135,92333.28241378565
"182.53.108.193",13155,"147.32.84.192",31037,9,2475,3,435,6,2040,3534.413622,69.15521499999977,50.32158456885734,235.99087935739993
"182.53.184.190",20063,"147.32.84.191",29676,3,828,1,140,2,688,2776.582744,0.20597600000019156,5437.526702134998,26721.559793349134
"182.53.185.245",4555,"147.32.84.192",31037,3,825,1,145,2,680,1837.272504,0.12061199999993732,9617.616820885176,45103.30647035807
"182.53.210.208",14438,"147.32.84.191",7600,6,749,2,249,4,500,649.726629,0.46758299999999053,4260.2062093789555,8554.630942528023
"182.53.227.166",29640,"147.32.84.192",31037,3,825,1,145,2,680,851.211117,0.2442510000000766,4749.212899843343,22272.17084064464
"182.64.7.145",11142,"147.32.84.192",31037,3,825,1,145,2,680,1531.297868,0.13078299999983756,8869.654312880426,41595.620225922
"182.64.18.111",10015,"147.32.84.165",32234,6,1147,2,259,4,888,1242.571099,2411.787861,0.8591137029526662,2.945532695837713
"182.68.120.16",10026,"147.32.84.192",31037,3,825,1,145,2,680,3336.358287,0.13265799999999217,8744.289827979228,41007.70402086811
"182.71.25.126",20978,"147.32.84.191",29676,3,825,1,145,2,680,3030.373148,0.11172099999976126,10383.007670916648,48692.72562912635
"182.72.130.18",46208,"147.32.84.191",29676,3,825,1,145,2,680,3217.225807,0.1372519999999895,8451.607262554198,39635.12371404727
"182.86.26.91",55595,"147.32.84.192",7600,193,177110,29,2806,164,174304,2339.270403,8.200228000000152,2737.4848601770077,170047.95476418146
"182.88.124.214",7600,"147.32.84.191",7600,126,114597,18,1781,108,112816,572.765688,9.315543000000048,1529.4867942748938,96884.10004655611
"182.89.63.33",7600,"147.32.84.192",7600,6,749,2,249,4,500,687.618561,0.60794199999998,3276.628362574169,6579.575025249335
"182.89.131.32",7600,"147.32.84.192",7600,481,431072,89,8440,392,422632,2053.658788,35.86067099999991,1882.842627233611,94283.12147310373
"182.89.134.101",1155,"147.32.84.191",7600,282,267891,36,3551,246,264340,2385.168237,7.4641850000002705,3805.9078117703366,283315.5930620588
"182.96.2.76",11935,"147.32.84.192",31037,1,107,1,107,0,0,988.049792,0,0,0
"182.112.221.127",25306,"147.32.84.192",31037,3,825,1,145,2,680,994.288097,0.25601700000004257,4530.949116659468,21248.588960885783
"182.113.160.215",7600,"147.32.84.165",7600,13,1378,3,338,10,1040,549.259941,4.952807000000007,545.9530322905771,1679.8554839710064
"182.113.249.25",7600,"147.32.84.165",7600,3,269,1,89,2,180,2122.565919,0.00021999999989930075,0,0
"182.114.79.103",15858,"147.32.84.192",7600,289,260000,47,4532,242,255468,2042.958359,6.202906000000212,5845.002326328782,329481.69777196855
"182.114.245.53",5910,"147.32.84.165",7600,16,1647,4,427,12,1220,2431.161673,9.581628999999793,356.51557788347617,1018.6159368099319
"182.116.222.196",45910,"147.32.84.192",7600,468,446433,62,6413,406,440020,1028.46232,5.670998999999938,9046.730567224675,620730.1394339936
"182.117.81.253",7600,"147.32.84.165",7600,11,987,3,267,8,720,354.75509,9.18053900000001,232.6660776671171,627.4141420236866
"182.119.140.89",3666,"147.32.84.165",7600,12,1076,4,356,8,720,2520.146594,14.804117000000133,192.3789172971258,389.0809563312657
"182.121.27.122",7600,"147.32.84.192",7600,8,929,2,249,6,680,1802.636553,0.6758689999999206,2947.3167137422106,8048.897049577121
"182.123.12.111",7600,"147.32.84.192",7600,6,749,2,249,4,500,1953.948297,0.6453590000000986,3086.6540948521606,6198.100592072612
"182.124.147.247",7600,"147.32.84.191",7600,6,749,2,249,4,500,2051.12994,0.6215879999999743,3204.695071333556,6435.1306653284255
"182.124.148.68",16224,"147.32.84.191",7600,6,749,2,249,4,500,3630.226723,0.7242889999997715,2750.2833813583093,5522.6573922857615
"182.128.81.163",7600,"147.32.84.165",7600,267,254442,33,3278,234,251164,863.085758,2.0597399999999197,12731.70400147641,975517.2982998234
"182.129.158.146",16224,"147.32.84.191",7600,375,354536,51,4952,324,349584,912.66737,7.961665000000039,4975.843620649676,351267.2286512917
"182.130.44.91",7600,"147.32.84.191",7600,623,590927,85,8127,538,582800,3199.705551,16.55260300000009,3927.841439802528,281671.7104856544
"182.130.164.71",7600,"147.32.84.192",7600,148,134729,22,2149,126,132580,3201.289136,5.065888000000086,3393.6794496837883,209369.01881762524
"182.132.24.144",16224,"147.32.84.191",7600,241,221998,35,3388,206,218610,633.996677,10.548346000000038,2569.5023655841305,165796.60925039754
"182.132.107.200",7600,"147.32.84.192",7600,6,749,2,249,4,500,913.947419,3.67656199999999,541.8105284230228,1087.972948640608
"182.144.96.221",7600,"147.32.84.191",7600,9,1018,3,338,6,680,2296.275024,8.688818999999967,311.204549202833,626.0919924790724
"182.144.96.221",7600,"147.32.84.192",7600,215,203137,29,2801,186,200336,2298.861647,32.19786699999986,695.9467221850472,49776.21654254324
"182.145.36.230",7600,"147.32.84.191",7600,283,265940,39,3796,244,262144,3085.790376,4.9481479999999465,6137.245692731974,423825.64143191004
"182.150.26.208",4292,"147.32.84.192",7600,130,121031,16,1627,114,119404,2150.29531,6.015045999999984,2163.9069759400068,158807.09806708086
"182.150.39.5",7600,"147.32.84.165",7600,36,27878,6,706,30,27172,2683.83301,1.0205890000002,5534.059254017918,212990.73378211737
"182.150.186.125",40504,"147.32.84.192",7600,304,283991,44,4279,260,279712,1900.441819,10.135236000000077,3377.523720217244,220783.8080928735
"182.151.205.201",7600,"147.32.84.165",7600,149,138880,19,1908,130,136972,1642.718697,4.4400909999999385,3437.7673790920526,246791.33828563764
"182.169.173.103",15783,"147.32.84.191",29676,3,825,1,145,2,680,1373.635949,0.04838399999994181,23974.86772489656,112433.86243399767
"182.177.26.33",32935,"147.32.84.165",32234,3,825,1,145,2,680,2590.983754,0.23886100000027,4856.380907719087,22774.75184309641
"182.177.74.93",44564,"147.32.84.165",32234,6,1650,2,290,4,1360,2793.628113,961.5243689999998,2.4128353630941626,11.315365840717453
"182.177.137.2",51051,"147.32.84.165",32234,3,825,1,145,2,680,2353.235166,0.17021400000021458,6814.95059159962,31959.768291639593
"182.177.234.145",7600,"147.32.84.192",7600,228,214593,30,2957,198,211636,2956.515431,4.941788999999972,4786.930401115898,342606.2909606237
"182.179.64.107",47331,"147.32.84.165",32234,3,825,1,145,2,680,3492.902792,0.23024600000007922,5038.089695367567,23626.903398965143
"182.182.55.125",10021,"147.32.84.191",29676,10,1854,2,478,8,1376,1204.974921,1384.9302440000001,2.761149896586416,7.948414765068845
"182.185.160.49",14629,"147.32.84.165",32234,3,825,1,145,2,680,3685.680488,0.19290899999987232,6013.197932708001,28199.824787872003
"182.185.186.196",13899,"147.32.84.192",31037,3,825,1,145,2,680,1381.637416,0.13296599999989667,8724.034715648373,40912.71452855788
"182.213.24.172",1024,"147.32.84.165",32234,1,143,1,143,0,0,2917.586374,0,0,0
"182.235.111.55",14754,"147.32.84.165",32234,3,831,1,143,2,688,2843.730963,0.2563329999998132,4462.944685236914,21472.06953456641
"182.240.228.187",7600,"147.32.84.165",7600,6,749,2,249,4,500,1620.556466,4.347373999999945,458.2076444308737,920.0956715479391
"183.1.194.71",7600,"147.32.84.192",7600,303,257910,67,6566,236,251344,2144.138295,16.16520300000002,3249.448831542662,124387.67394384083
"183.3.203.246",7600,"147.32.84.191",7600,6,749,2,249,4,500,1302.812381,2.667067999999972,746.8875934171986,1499.7742839702782
"183.4.76.172",32851,"147.32.84.165",7600,114,105465,14,1433,100,104032,2587.801624,1.7874619999997776,6413.5629177019855,465607.6604706022
"183.4.218.149",16001,"147.32.84.165",32234,3,429,1,143,2,286,3380.428702,0.08698299999969095,13151.995217503014,26303.990435006028
"183.5.227.15",7600,"147.32.84.191",7600,3,269,1,89,2,180,1890.424063,0.0002620000000206346,0,0
"183.7.81.213",24688,"147.32.84.165",7600,2,178,2,178,0,0,36.334513,4.202035000000002,338.8834219610259,0
"183.8.101.57",7600,"147.32.84.191",7600,426,408019,50,4971,376,403048,1921.45965,19.971553000000085,1991.2322291611388,161448.83675295487
"183.15.87.149",7600,"147.32.84.191",7600,3,269,1,89,2,180,886.618759,0.00021500000002561137,0,0
"183.16.23.218",7600,"147.32.84.191",7600,6,749,2,249,4,500,3312.892634,0.7202310000002399,2765.7793124696614,5553.773719818597
"183.16.199.206",27758,"147.32.84.192",7600,9,1018,3,338,6,680,1866.23477,6.4790069999999105,417.3479053194475,839.6348391042138
"183.17.86.4",4900,"147.32.84.192",7600,393,344530,81,7722,312,336808,3456.215907,44.856100000000424,1377.2039923221014,60069.0652999252
"183.18.238.150",7600,"147.32.84.192",7600,12,1076,4,356,8,720,1462.413154,13.108496999999943,217.26365730564018,439.4096439889352
"183.18.246.73",3087,"147.32.84.192",7600,3,269,1,89,2,180,1865.894846,0.00023099999998521525,0,0
"183.19.12.182",7600,"147.32.84.191",7600,368,344199,52,5015,316,339184,3140.113127,28.429057999999714,1411.2321273536536,95447.13018630541
"183.19.27.173",7600,"147.32.84.165",7600,81,72293,11,1201,70,71092,2842.555,2.289320000000316,4196.879422710094,248430.101514826
"183.22.225.233",16224,"147.32.84.191",7600,6,749,2,249,4,500,3356.929079,1.2333419999999933,1615.1237856166504,3243.220453045483
"183.25.15.208",7600,"147.32.84.191",7600,6,749,2,249,4,500,1734.894377,0.9868830000000344,2018.4763543398058,4053.1653701602527
"183.25.33.42",4307,"147.32.84.165",7600,6,749,2,249,4,500,862.995018,0.6499130000000832,3065.02562650654,6154.6699327440565
"183.32.68.186",16224,"147.32.84.192",7600,6,749,2,249,4,500,1870.353912,3.2897659999998723,605.5141915869024,1215.8919509777156
"183.32.202.240",7600,"147.32.84.192",7600,11,1198,3,338,8,860,1797.108043,4.876367000000073,554.511176045601,1410.8864242580382
"183.38.72.40",55100,"147.32.84.192",7600,6,749,2,249,4,500,3507.054181,0.7962569999999687,2501.704851574402,5023.5037180208865
"183.38.189.221",7600,"147.32.84.192",7600,6,749,2,249,4,500,1926.639548,1.0161639999998897,1960.3134927041465,3936.3724753095307
"183.42.66.68",7600,"147.32.84.191",7600,6,749,2,249,4,500,2637.608076,1.5115240000000085,1317.8752040986374,2646.335751202083
"183.45.106.102",1114,"147.32.84.192",7600,110,101065,14,1425,96,99640,1218.864533,1.5158420000000206,7520.572724597844,525859.5552834591
"183.45.122.146",16224,"147.32.84.165",7600,9,807,3,267,6,540,2058.568078,12.690529000000424,168.31449658244574,340.41134140269924
"183.47.232.155",56263,"147.32.84.165",32234,9,1191,3,525,6,666,3726.563897,2.5868099999997867,1623.621371496301,2059.6796826981645
"183.59.69.202",16224,"147.32.84.191",7600,9,1018,3,338,6,680,3708.012453,5.1483320000002095,525.2186533424592,1056.652912049918
"183.66.185.29",16224,"147.32.84.165",7600,6,749,2,249,4,500,1332.262921,1.7844860000000153,1116.2878274192024,2241.5418221269124
"183.66.210.19",7600,"147.32.84.192",7600,352,318637,62,5985,290,312652,2984.767158,34.6472060000001,1381.9296136028938,72190.98705967786
"183.67.28.5",53385,"147.32.84.191",7600,8,929,2,249,6,680,3553.937164,0.9453020000000834,2107.2630757152997,5754.774664604031
"183.67.96.231",7600,"147.32.84.165",7600,345,321936,51,4892,294,317044,1405.781324,25.23634900000002,1550.7789973898352,100503.91996084688
"183.69.158.20",30829,"147.32.84.165",7600,2,178,2,178,0,0,3818.515214,3.971215999999913,358.5803441565584,0
"183.70.165.101",7600,"147.32.84.191",7600,3,269,1,89,2,180,1356.748813,0.0002369999999700667,0,0
"183.81.114.29",19187,"147.32.84.192",31037,3,825,1,145,2,680,1053.325904,0.19233600000006845,6031.112220279028,28283.83661923958
"183.83.34.234",14243,"147.32.84.165",32234,3,825,1,145,2,680,3124.293621,0.1700170000003709,6822.8471270371165,31996.8003198982
"183.83.101.36",60248,"147.32.84.165",32234,3,825,1,145,2,680,1651.254991,0.23351000000002387,4967.667337586748,23296.646824544747
"183.88.49.235",1691,"147.32.84.192",7600,6,749,2,249,4,500,2421.772797,0.4448170000000573,4478.24611019755,8992.462068669778
"183.88.82.9",18638,"147.32.84.165",32234,3,825,1,145,2,680,1008.929619,0.09542899999996735,12155.63403158785,57005.73201020509
"183.89.172.141",11718,"147.32.84.191",29676,3,825,1,145,2,680,2701.18172,0.1422509999997601,8154.599967676546,38242.26191737966
"183.89.226.86",19462,"147.32.84.165",32234,3,825,1,145,2,680,2549.582228,0.34097899999960646,3401.969036220233,15954.061687101783
"183.93.31.6",10000,"147.32.84.191",7600,288,274491,36,3563,252,270928,2159.155818,4.095146999999997,6960.433898954059,529266.470776263
"183.98.63.88",10139,"147.32.84.191",29676,9,1294,3,492,6,802,2379.444866,1384.9690650000002,2.8419407331672057,4.6325944471546725
"183.98.120.155",62998,"147.32.84.191",29676,3,825,1,145,2,680,2160.868881,0.12254299999995055,9466.064973115299,44392.5805635752
"183.99.145.30",54020,"147.32.84.165",32234,3,825,1,145,2,680,1085.48411,0.08616799999981595,13462.074087857183,63132.48537753713
"183.101.142.138",14884,"147.32.84.165",32234,7,1241,1,145,6,1096,1478.206813,1986.7206589999998,0.5838767492274817,4.413302876919447
"183.144.25.52",7600,"147.32.84.192",7600,6,749,2,249,4,500,1960.343111,0.8310210000001916,2397.051338052276,4813.3561005065785
"183.163.11.163",11935,"147.32.84.191",29676,1,143,1,143,0,0,1983.657048,0,0,0
"183.163.20.26",7600,"147.32.84.165",7600,339,317370,49,4718,290,312652,2202.438945,11.367163000000346,3320.441520896538,220038.72030337946
"183.163.55.20",7600,"147.32.84.165",7600,6,749,2,249,4,500,2341.829853,0.30649999999968713,6499.1843393214795,13050.57096249293
"183.178.70.214",7600,"147.32.84.165",7600,1,90,1,90,0,0,164.193229,0,0,0
"183.178.99.236",7600,"147.32.84.192",7600,6,749,2,249,4,500,829.065815,0.3563699999999699,5589.6961023659915,11224.289362180705
"183.178.169.140",7600,"147.32.84.165",7600,6,749,2,249,4,500,2649.384749,0.3667120000000068,5432.055673116677,10907.742315495336
"183.179.75.22",26188,"147.32.84.191",29676,6,1122,2,244,4,878,2326.678584,592.0756460000002,3.296876021142743,11.863348961325116
"183.179.203.123",10613,"147.32.84.191",29676,1,143,1,143,0,0,2894.144735,0,0,0
"183.179.243.76",7600,"147.32.84.192",7600,3,269,1,89,2,180,3128.445008,0.0002779999999802385,0,0
"183.184.211.238",7600,"147.32.84.165",7600,7,909,3,409,4,500,1337.818865,2.9843450000000757,1096.387984633116,1340.3276095759365
"183.188.88.245",7600,"147.32.84.165",7600,668,668083,60,6267,608,661816,1696.020631,10.439458999999943,4802.547718229486,507164.97856833664
"183.191.5.177",1330,"147.32.84.191",7600,160,149963,20,2011,140,147952,1575.862713,5.396126999999979,2981.397583859695,219345.46759184962
"183.191.158.33",7600,"147.32.84.191",7600,193,179144,27,2644,166,176500,2230.830574,3.606064999999944,5865.673525019745,391562.5480960609
"183.191.196.236",11935,"147.32.84.165",32234,1,143,1,143,0,0,2583.829001,0,0,0
"183.191.248.96",18656,"147.32.84.192",7600,11,1198,3,338,8,860,2558.378273,5.347335000000385,505.67245179137,1286.6222146170953
"183.200.6.29",7600,"147.32.84.191",7600,6,749,2,249,4,500,1377.262881,0.415997999999945,4788.484560022556,9615.430843418788
"183.200.67.14",25087,"147.32.84.165",7600,6,749,2,249,4,500,1602.691459,0.3978910000000724,5006.396224090612,10053.004466045406
"183.200.68.94",7600,"147.32.84.165",7600,6,749,2,249,4,500,2781.880796,0.42178899999998976,4722.740517178135,9483.414693128785
"183.200.93.133",7600,"147.32.84.192",7600,6,749,2,249,4,500,2925.619036,0.4237399999997251,4700.995893711456,9439.750790585253
"183.200.122.121",46389,"147.32.84.191",7600,6,749,2,249,4,500,2156.540803,0.4139210000003004,4812.512532581228,9663.679784299653
"183.200.134.33",7600,"147.32.84.191",7600,6,749,2,249,4,500,2035.172102,0.4084900000000289,4876.496364659744,9792.161374818765
"183.200.194.146",7600,"147.32.84.191",7600,86,74685,12,1217,74,73468,3438.018185,1.4874110000000655,6545.601720035398,395145.65913521824
"183.208.119.226",7600,"147.32.84.191",7600,6,749,2,249,4,500,3310.253192,0.40682799999967756,4896.4181423146365,9832.1649444069
"183.217.102.62",7600,"147.32.84.191",7600,6,749,2,249,4,500,1714.625839,0.48418100000003506,4114.163918038617,8261.373329394813
"184.9.221.169",34431,"147.32.84.191",29676,3,825,1,145,2,680,1683.57005,0.03192500000000109,36335.1605324968,170399.37353170913
"184.36.211.50",53561,"147.32.84.165",32234,3,825,1,145,2,680,2333.084011,0.1328590000002805,8731.060748594758,40945.66420030645
"184.58.19.189",47624,"147.32.84.165",32234,3,825,1,145,2,680,606.212867,0.2112210000000232,5491.878174991467,25755.014889615155
"184.99.96.67",43186,"147.32.84.165",32234,3,825,1,145,2,680,3565.694529,0.0594890000002124,19499.40325095158,91445.47731480739
"184.145.174.138",63436,"147.32.84.165",32234,3,825,1,145,2,680,3583.074712,0.1064369999999144,10898.4657590963,51110.04631852058
"184.163.60.6",3997,"147.32.84.191",29676,3,825,1,145,2,680,1457.754788,0.14501100000006772,7999.393149481475,37514.395459637264
"184.166.84.161",5452,"147.32.84.191",29676,3,825,1,145,2,680,2384.752191,0.2252800000001116,5149.147727270176,24147.72727271531
"184.171.194.234",55427,"147.32.84.165",32234,3,825,1,145,2,680,2774.177669,0.05764299999964351,20123.865864149575,94373.99163877043
"186.19.100.114",32879,"147.32.84.192",31037,3,825,1,145,2,680,3533.484826,0.15395699999999124,7534.5713413489875,35334.541462878005
"186.32.140.232",12079,"147.32.84.165",32234,3,825,1,145,2,680,982.923514,0.1419540000000552,8171.661242371112,38322.27341249901
"186.44.135.84",1054,"147.32.84.165",32234,3,825,1,145,2,680,3435.605173,0.0911869999999908,12721.111561956386,59657.626635381675
"186.45.179.107",62437,"147.32.84.165",32234,3,825,1,145,2,680,514.765053,0.2069490000000087,5605.245736872133,26286.669662572764
"186.62.1.54",24517,"147.32.84.165",32234,1,137,1,137,0,0,1520.268352,0,0,0
"186.62.1.54",24748,"147.32.84.165",32234,2,274,2,274,0,0,2424.385529,895.190677,2.4486403358733817,0
"186.82.86.92",61605,"147.32.84.165",32234,3,825,1,145,2,680,819.085361,0.2550969999999779,4547.289854447918,21325.22138637644
"186.93.204.96",1413,"147.32.84.192",31037,3,825,1,145,2,680,3068.061475,0.07948100000021441,14594.683005962064,68444.03064864968
"186.106.36.31",52144,"147.32.84.192",31037,3,825,1,145,2,680,1105.239301,0.2026299999999992,5724.719932882616,26846.962443863304
"186.128.16.247",22916,"147.32.84.165",32234,3,825,1,145,2,680,3291.737291,0.22846600000002582,5077.341923961854,23810.98281582111
"186.191.198.249",49578,"147.32.84.191",29676,3,825,1,145,2,680,2059.702874,0.18529300000000148,6260.355221190173,29358.90724420219
"186.204.66.20",59969,"147.32.84.165",32234,3,825,1,145,2,680,1849.920436,0.2353619999998955,4928.578105218833,23113.331803784873
"186.205.24.45",48185,"147.32.84.165",32234,3,825,1,145,2,680,1088.879508,0.17596099999991566,6592.369900151488,30915.941600710426
"186.221.95.99",58689,"147.32.84.192",31037,3,825,1,145,2,680,3591.361259,0.11408200000005309,10168.124682241372,47684.998509821606
"187.7.253.50",10921,"147.32.84.165",32234,3,825,1,145,2,680,2269.141223,0.05262899999979709,22041.080013005612,103365.06488857804
"187.20.112.100",45432,"147.32.84.192",31037,3,825,1,145,2,680,3698.252544,0.21623300000010204,5364.583574197522,25158.047106581478
"187.33.216.161",12842,"147.32.84.192",31037,45,11225,23,3745,22,7480,3137.278899,658.592126,45.4909781293073,90.86048502195423
"187.58.189.187",1412,"147.32.84.192",31037,3,825,1,145,2,680,3214.466625,0.13374900000007983,8672.962040832512,40673.20129493868
"187.59.70.170",59430,"147.32.84.165",32234,3,825,1,145,2,680,1484.225845,0.06945100000007187,16702.423291224022,78328.60577953335
"187.67.62.102",20354,"147.32.84.165",32234,8,1718,2,478,6,1240,1592.251901,2027.7271759999999,1.885855279379064,4.892176875376651
"187.78.12.84",44290,"147.32.84.192",31037,3,825,1,145,2,680,3361.575254,0.3054930000002969,3797.141014684044,17807.281999897587
"187.106.48.237",7600,"147.32.84.165",7600,186,174495,24,2387,162,172108,2357.971702,1.627762999999959,11731.43756185666,845862.696227912
"187.123.219.153",52197,"147.32.84.165",32234,3,825,1,145,2,680,419.086181,0.12451199999998153,9316.37111282585,43690.56797739019
"187.126.90.32",18739,"147.32.84.165",32234,1,145,1,145,0,0,3789.935428,0,0,0
"187.150.52.109",6885,"147.32.84.165",32234,3,831,1,143,2,688,2375.468556,0.06906000000026324,16565.30553135881,79698.81262639762
"187.150.52.109",55599,"147.32.84.165",32234,15,3253,5,809,10,2444,3459.124143,83.70874400000002,77.31569834568296,233.571775966439
"188.0.211.66",47352,"147.32.84.192",31037,3,825,1,145,2,680,1850.052225,0.1806410000001506,6421.576497024667,30114.979434322577
"188.2.224.21",21063,"147.32.84.191",29676,3,825,1,145,2,680,2559.876887,0.04422800000020288,26227.729040306567,122999.00515454114
"188.2.236.229",41387,"147.32.84.192",31037,3,825,1,145,2,680,2150.953292,0.15977399999974295,7260.25511035504,34048.09293132019
"188.4.242.110",37171,"147.32.84.165",32234,6,1438,2,478,4,960,1549.383725,1884.9634680000001,2.028686531552451,4.074349519435885
"188.17.41.133",62718,"147.32.84.165",32234,3,825,1,145,2,680,1654.297602,0.255333999999948,4543.069078149547,21305.427400977183
"188.17.252.138",57114,"147.32.84.192",31037,1,143,1,143,0,0,3501.989467,0,0,0
"188.18.194.176",28810,"147.32.84.165",32234,3,825,1,145,2,680,2098.901883,0.10366400000020803,11189.998456529482,52477.23414096584
"188.24.7.6",12102,"147.32.84.192",31037,3,828,1,140,2,688,3102.695662,0.07692599999973027,14559.446741074893,71549.28112756804
"188.24.54.77",44010,"147.32.84.192",31037,3,825,1,145,2,680,3685.077387,0.08390600000029735,13824.994636806534,64834.457607092714
"188.24.154.217",24826,"147.32.84.192",31037,3,825,1,145,2,680,1235.626358,0.20578599999998914,5636.923794621895,26435.228829950953
"188.26.42.144",30320,"147.32.84.191",29676,3,825,1,145,2,680,3692.297837,0.22041499999977532,5262.799718717793,24680.715922262756
"188.26.76.71",39005,"147.32.84.192",31037,3,825,1,145,2,680,2313.492096,0.20553400000017064,5643.835083241882,26467.640390375724
"188.26.191.108",27579,"147.32.84.165",32234,3,828,1,148,2,680,1859.011059,0.12691800000015974,9328.85800279322,42862.32055337425
"188.27.57.177",63565,"147.32.84.192",31037,3,825,1,145,2,680,1727.087761,0.02986800000007861,38837.55189490247,182134.7261278185
"188.27.117.171",26848,"147.32.84.191",29676,3,825,1,145,2,680,1629.280712,0.16152899999997317,7181.373004229536,33678.163054317825
"188.29.206.188",23904,"147.32.84.191",29676,3,825,1,145,2,680,3573.095935,0.13605900000038673,8525.713109729624,39982.65458355961
"188.35.19.54",36698,"147.32.84.165",32234,1,143,1,143,0,0,3687.495884,0,0,0
"188.35.19.60",36074,"147.32.84.165",32234,3,825,1,145,2,680,2885.369036,0.17063199999984136,6798.25589573514,31881.475924826867
"188.36.2.70",50136,"147.32.84.192",31037,3,825,1,145,2,680,3698.803587,0.2671460000001389,4342.194904656618,20363.396794251727
"188.36.23.55",40954,"147.32.84.165",32234,3,825,1,145,2,680,992.413821,0.1649929999999813,7030.601298237692,32971.09574345952
"188.36.33.183",61000,"147.32.84.191",29676,4,1007,2,327,2,680,2056.397219,33.80653200000006,77.38149538674938,160.9156478990507
"188.36.107.192",14518,"147.32.84.191",29676,3,825,1,145,2,680,3627.208153,0.20376699999997072,5692.776553613523,26697.159010049625
"188.36.168.244",27183,"147.32.84.165",32234,3,825,1,145,2,680,3714.215956,0.12191399999983332,9514.903948698147,44621.618518032694
"188.48.33.234",16881,"147.32.84.192",31037,3,831,1,143,2,688,3443.573886,0.26845800000000963,4261.374218685824,20502.275961229698
"188.49.21.198",35566,"147.32.84.165",32234,3,825,1,145,2,680,1589.974696,0.3256930000000011,3561.6362648260665,16702.845931598105
"188.49.134.21",56271,"147.32.84.192",31037,3,825,1,145,2,680,2424.807409,0.09891299999981129,11727.477682430146,54997.82637277586
"188.50.93.34",58616,"147.32.84.192",31037,3,825,1,145,2,680,3089.972589,0.1151239999999234,10076.091866168408,47253.396337893224
"188.52.158.112",35572,"147.32.84.165",32234,6,1254,2,296,4,958,1851.126843,1354.1144129999998,1.7487444024421595,5.659787626822935
"188.53.119.216",19643,"147.32.84.192",31037,3,825,1,145,2,680,2276.857037,0.21744499999977052,5334.682333469264,25017.82059833862
"188.54.51.94",31554,"147.32.84.165",32234,3,825,1,145,2,680,1129.113933,0.21198299999991832,5472.136916641651,25662.43519528498
"188.75.200.34",45338,"147.32.84.165",32234,3,825,1,145,2,680,2210.919194,0.028743999999733205,40356.24826088112,189256.88839585628
"188.81.32.187",63062,"147.32.84.191",29676,3,825,1,145,2,680,1149.653814,0.2598570000000109,4463.993658050203,20934.5909480975
"188.81.85.206",13438,"147.32.84.191",29676,3,825,1,145,2,680,2943.194086,0.11774300000024596,9851.965721933168,46202.322006307266
"188.83.35.52",63703,"147.32.84.191",7600,12,1076,4,356,8,720,1259.895546,2.651986000000079,1073.91215489068,2171.9571671946337
"188.94.140.35",55963,"147.32.84.165",32234,3,825,1,145,2,680,3483.120917,0.2043389999998908,5676.840935898776,26622.426458008053
"188.112.140.5",24419,"147.32.84.191",29676,3,828,1,140,2,688,3120.496742,0.17277600000034,6482.381812275988,31856.276334613427
"188.114.26.108",55102,"147.32.84.165",32234,3,825,1,145,2,680,3584.607398,0.1948139999999512,5954.397527899898,27924.071165323658
"188.114.39.231",11591,"147.32.84.192",31037,10,1410,4,640,6,770,1099.767987,2695.416078,1.899521206313736,2.2853614513462137
"188.121.198.16",42209,"147.32.84.165",32234,9,1632,3,492,6,1140,1027.554407,1938.183043,2.0307679474420004,4.705437926999757
"188.123.230.174",43358,"147.32.84.165",32234,3,825,1,145,2,680,1290.71549,0.1904629999999088,6090.421761709915,28561.97791698443
"188.123.239.207",55645,"147.32.84.192",31037,3,825,1,145,2,680,1343.84772,0.07915000000002692,14655.716993046184,68730.25900187176
"188.123.241.27",1736,"147.32.84.192",31037,3,825,1,145,2,680,3402.825357,0.1456289999996443,7965.446442692275,37355.19711055688
"188.123.245.43",42680,"147.32.84.165",32234,3,825,1,145,2,680,2034.950329,0.17371499999990192,6677.604121697349,31315.660708649637
"188.123.245.44",23263,"147.32.84.191",29676,3,825,1,145,2,680,2377.964664,0.11649099999976897,9957.850821113223,46698.88660935857
"188.123.253.92",11310,"147.32.84.192",31037,3,825,1,145,2,680,1837.157058,0.018679000000020096,62101.825579461,291236.14754505845
"188.124.38.34",30851,"147.32.84.191",29676,9,1792,3,492,6,1300,1684.931079,1526.7930810000003,2.577952473705243,6.811663040278081
"188.126.26.188",16051,"147.32.84.192",31037,3,825,1,145,2,680,1172.143336,0.14184199999999691,8178.1136757802715,38352.53310021093
"188.126.33.59",14427,"147.32.84.191",29676,3,825,1,145,2,680,2616.51875,0.1893249999998261,6127.030239012626,28733.65905192128
"188.128.6.150",64439,"147.32.84.192",31037,3,825,1,145,2,680,2791.569925,0.13372800000024654,8674.324000941175,40679.58841820689
"188.134.33.192",63148,"147.32.84.165",32234,3,825,1,145,2,680,1957.938698,0.11669800000004216,9940.187492498422,46616.05168895812
"188.134.35.96",65053,"147.32.84.192",31037,1,143,1,143,0,0,2483.765932,0,0,0
"188.134.36.89",29791,"147.32.84.192",31037,3,825,1,145,2,680,1202.490839,0.14184000000000196,8178.228990411618,38353.073886068276
"188.134.42.81",39897,"147.32.84.165",32234,1,143,1,143,0,0,1371.647644,0,0,0
"188.135.70.161",26981,"147.32.84.192",31037,3,825,1,145,2,680,2158.602506,0.16197199999987788,7161.731657328887,33586.051910232025
"188.135.201.13",18287,"147.32.84.165",32234,3,825,1,145,2,680,1865.228904,0.045096999999941545,25722.331862463216,120628.86666534473
"188.137.76.98",1025,"147.32.84.192",31037,9,1920,3,444,6,1476,812.700777,2823.269393,1.258115859863324,4.182385155761861
"188.140.130.16",56324,"147.32.84.165",32234,3,825,1,145,2,680,898.586471,0.17186900000001515,6749.326521943444,31652.01403394167
"188.140.133.171",56180,"147.32.84.192",31037,3,825,1,145,2,680,3375.925081,0.056956000000354834,20366.59877787719,95512.3253031482
"188.153.189.214",33349,"147.32.84.165",32234,6,1650,2,290,4,1360,2503.731609,824.1169669999999,2.815134371575194,13.202009466697463
"188.162.218.219",57184,"147.32.84.165",32234,1,143,1,143,0,0,3291.582433,0,0,0
"188.163.64.228",48985,"147.32.84.165",32234,15,4125,5,725,10,3400,953.382253,2666.991328,2.1747352303351772,10.198758321571866
"188.163.93.156",36183,"147.32.84.165",32234,3,825,1,145,2,680,3306.909864,0.08811599999989994,13164.465023393223,61736.80148901649
"188.167.112.178",14675,"147.32.84.192",31037,3,825,1,145,2,680,1962.756296,0.18073699999990822,6418.165621873712,30098.983606028443
"188.168.206.168",7600,"147.32.84.165",7600,15,1345,5,445,10,900,600.891237,12.102251999999908,294.1601282141561,594.9305963881809
"188.173.125.163",50100,"147.32.84.165",32234,12,3300,4,580,8,2720,435.744987,2799.581759,1.6573904245101918,7.7725895770133135
"188.173.145.48",58436,"147.32.84.165",32234,3,825,1,145,2,680,1029.57609,0.10668600000008155,10873.02926343769,50990.75792508709
"188.173.242.218",27093,"147.32.84.191",29676,9,1648,3,492,6,1156,1847.280078,1307.2295649999999,3.0109478131333423,7.074503398337691
"188.175.220.53",61899,"147.32.84.191",29676,1,143,1,143,0,0,3391.071636,0,0,0
"188.176.8.174",34074,"147.32.84.192",31037,21,4636,7,1548,14,3088,1342.88895,2176.929036,5.688747678589923,11.348096144370597
"188.187.101.146",52917,"147.32.84.191",29676,6,1650,2,290,4,1360,2605.151281,931.2242329999999,2.4913441014372744,11.683544751567908
"188.190.38.14",30219,"147.32.84.192",31037,3,825,1,145,2,680,1117.612158,0.18200600000000122,6373.416261002341,29889.12453435581
"188.190.77.127",34380,"147.32.84.165",32234,3,825,1,145,2,680,2266.385371,0.14427400000022317,8040.256733702578,37706.031578743125
"188.192.157.53",6881,"147.32.84.191",29676,1,107,1,107,0,0,2392.390931,0,0,0
"188.198.85.85",39296,"147.32.84.165",32234,1,145,1,145,0,0,3816.800483,0,0,0
"188.213.88.58",45499,"147.32.84.165",32234,3,825,1,145,2,680,3053.172278,0.2286380000000463,5073.522336618432,23793.07026827954
"188.216.206.9",58593,"147.32.84.165",32234,3,825,1,145,2,680,2060.251762,0.08933999999999287,12984.105663757473,60890.97828520746
"188.220.87.193",53235,"147.32.84.165",32234,1,143,1,143,0,0,2635.679067,0,0,0
"188.221.233.127",45722,"147.32.84.165",32234,3,825,1,145,2,680,3646.887705,0.046608000000105676,24888.431170558055,116718.15997227226
"188.222.16.43",29943,"147.32.84.191",29676,3,825,1,145,2,680,2043.284543,0.10901100000000952,10641.127959562784,49903.22077588065
"188.223.107.207",20969,"147.32.84.192",31037,3,825,1,145,2,680,1037.21518,0.27700300000014977,4187.680277828662,19638.776475334413
"188.223.226.151",39056,"147.32.84.165",32234,3,825,1,145,2,680,1272.638781,0.3501779999999144,3312.601020053469,15534.956507836958
"188.227.8.52",63870,"147.32.84.165",32234,3,825,1,145,2,680,679.746898,0.0922729999999774,12571.391414609736,58955.4907719629
"188.230.156.200",38103,"147.32.84.191",29676,12,3144,4,688,8,2456,1842.985842,1238.0754499999998,4.44560951434745,15.869792103542641
"188.230.177.97",50100,"147.32.84.191",29676,12,3176,4,688,8,2488,2087.502798,1364.090263,4.034923603878844,14.59140977681768
"188.230.205.92",27785,"147.32.84.191",29676,12,3144,4,688,8,2456,1869.297117,1422.1737039999998,3.8701320271352735,13.815471306168941
"188.232.7.116",1201,"147.32.84.165",32234,1,143,1,143,0,0,2233.467537,0,0,0
"188.232.10.41",12573,"147.32.84.165",32234,3,825,1,145,2,680,2609.055201,0.22347899999977017,5190.64431110392,24342.331941728728
"188.232.37.101",23649,"147.32.84.165",32234,3,825,1,145,2,680,3050.062199,0.09462299999995594,12259.175887474928,57491.30761022725
"188.233.34.111",38603,"147.32.84.191",29676,3,825,1,145,2,680,3552.132212,0.14493099999981496,8003.808708982075,37535.10291108835
"188.233.148.128",50610,"147.32.84.192",31037,3,825,1,145,2,680,2283.776323,0.12823600000001534,9045.821766117637,42421.78483420685
"188.233.156.201",61341,"147.32.84.165",32234,3,825,1,145,2,680,1488.47201,0.06055000000014843,19157.720891777975,89843.10487178637
"188.235.195.242",39190,"147.32.84.165",32234,1,143,1,143,0,0,3505.277726,0,0,0
"188.237.28.163",60411,"147.32.84.191",29676,6,1350,2,296,4,1054,1620.237324,1337.356263,1.7706575768285016,6.304976641815002
"188.237.86.238",10010,"147.32.84.191",29676,12,2072,4,688,8,1384,1698.345747,1391.9636560000001,3.9541262275600673,7.954230667068508
"188.237.91.6",54006,"147.32.84.165",32234,3,825,1,145,2,680,3748.259805,0.1432609999997112,8097.109471540324,37972.651314809795
"188.238.176.61",40797,"147.32.84.165",32234,3,825,1,145,2,680,426.405109,0.34791300000000547,3334.166875052044,15636.09293127855
"188.242.210.168",52292,"147.32.84.191",29676,3,825,1,145,2,680,1264.158366,0.14075200000002042,8241.445947480901,38649.5396157725
"188.244.26.47",7573,"147.32.84.191",29676,12,2168,4,688,8,1480,2123.192846,1483.081631,3.711191538586321,7.983377146958945
"188.244.34.2",7600,"147.32.84.191",7600,379,364395,45,4551,334,359844,729.100754,1.0558249999999134,34482.987237471156,2726542.7509295917
"188.244.133.173",33440,"147.32.84.165",32234,3,825,1,145,2,680,437.174477,0.2183409999999526,5312.790543233987,24915.15565102835
"188.249.33.163",39215,"147.32.84.165",32234,3,825,1,145,2,680,1929.093536,0.19920200000001387,5823.234706478445,27308.962761416158
"188.249.140.85",1053,"147.32.84.191",29676,3,825,1,145,2,680,2090.531497,0.16393199999993158,7076.1047263529035,33184.49113048258
"188.254.187.44",24384,"147.32.84.165",32234,6,1212,2,334,4,878,2951.659086,51.99013599999989,51.394364500219915,135.10255099159608
"189.7.123.245",62178,"147.32.84.191",29676,3,825,1,145,2,680,3587.94625,0.16939000000002125,6848.102013104992,32115.237026975134
"189.7.149.242",8642,"147.32.84.165",32234,3,825,1,145,2,680,388.689291,0.12836499999997386,9036.73119620018,42379.15319597326
"189.15.228.26",28953,"147.32.84.192",31037,3,825,1,145,2,680,2275.39428,0.07569599999987986,15324.455717631594,71866.41302061712
"189.18.183.249",51007,"147.32.84.192",31037,3,825,1,145,2,680,3192.913678,0.323221999999987,3588.864619363925,16830.53752529289
"189.29.98.228",1287,"147.32.84.192",31037,3,825,1,145,2,680,2943.36129,0.11629400000038004,9974.719246016211,46777.99370545533
"189.31.73.114",43574,"147.32.84.192",31037,3,825,1,145,2,680,1813.131363,0.18239900000003217,6359.683989494435,29824.72491624976
"189.32.85.250",12122,"147.32.84.165",32234,3,825,1,145,2,680,685.398018,0.1384570000000167,8378.052391716274,39290.17673356597
"189.59.19.4",48088,"147.32.84.192",31037,3,825,1,145,2,680,2994.552517,0.06940399999984947,16713.7340787637,78381.64947282287
"189.72.69.128",21169,"147.32.84.191",29676,3,825,1,145,2,680,2191.537258,0.10414500000024418,11138.316769862022,52234.864851766724
"189.79.210.20",12772,"147.32.84.165",32234,3,825,1,145,2,680,568.990609,0.17164800000000469,6758.016405667227,31692.766592094587
"189.79.226.202",38891,"147.32.84.192",31037,3,825,1,145,2,680,885.193578,0.22825699999998506,5081.990913751061,23832.78497483256
"189.90.114.12",37419,"147.32.84.191",29676,7,977,3,561,4,416,424.242022,2167.719177,2.0703788791549727,1.5352542134197302
"189.102.138.132",24298,"147.32.84.165",32234,3,825,1,145,2,680,1766.3786,0.3371509999999489,3440.5948669889035,16135.203514154857
"189.115.149.214",63170,"147.32.84.165",32234,3,825,1,145,2,680,3460.506914,0.05496499999981097,21104.339124970244,98972.07313779148
"189.124.150.66",40546,"147.32.84.165",32234,3,825,1,145,2,680,3335.606399,0.15332400000033886,7565.677910812634,35480.42054725925
"189.172.173.48",13984,"147.32.84.192",31037,3,831,1,143,2,688,3223.862766,0.2163980000000265,5286.555328606825,25434.615846723747
"189.234.68.11",33238,"147.32.84.192",31037,1,143,1,143,0,0,3570.030439,0,0,0
"190.18.234.49",54377,"147.32.84.191",29676,3,825,1,145,2,680,1878.678442,0.15117800000007264,7673.074124538243,35984.07175645521
"190.80.142.21",29631,"147.32.84.165",32234,3,825,1,145,2,680,677.074527,0.12831900000003316,9039.970698023677,42394.34534245587
"190.95.3.103",19350,"147.32.84.165",32234,3,825,1,145,2,680,3392.387974,0.04536599999983082,25569.809989955604,119913.59167703318
"190.107.125.134",54614,"147.32.84.165",32234,3,825,1,145,2,680,366.204734,0.09073000000000775,12785.18681803043,59958.11749145305
"190.163.59.117",7600,"147.32.84.191",7600,1463,1490716,111,11988,1352,1478728,2233.840408,6.996939000000111,13706.565113687353,1690714.182301691
"190.166.11.81",61700,"147.32.84.165",32234,3,825,1,145,2,680,1550.678452,0.19318399999997382,6004.638065265018,28159.68196124284
"190.176.249.235",23783,"147.32.84.191",29676,3,825,1,145,2,680,3756.502795,0.05307100000027276,21857.51163524407,102504.19249631703
"190.203.74.91",50321,"147.32.84.165",32234,6,1650,2,290,4,1360,2226.820908,832.3794349999998,2.787190435573412,13.070962042689104
"190.219.156.72",26023,"147.32.84.165",32234,6,1650,2,290,4,1360,1152.393618,1823.084836,1.2725683161790065,5.967906586218788
"190.234.194.237",60279,"147.32.84.191",29676,3,825,1,145,2,680,3590.515904,0.23024100000020553,5038.199104412179,23627.416489657116
"190.253.241.230",13821,"147.32.84.191",29676,3,825,1,145,2,680,1215.839599,0.0937290000001667,12376.10558096146,58039.66755209513
"192.121.86.11",49001,"147.32.84.165",32234,3,855,1,175,2,680,2214.199662,0.20314800000005562,6891.52735936173,26778.50631066272
"192.167.1.10",7600,"147.32.84.192",7600,4,640,2,320,2,320,1749.856119,0.002600999999913256,0,0
"193.37.137.110",44475,"147.32.84.192",31037,3,825,1,145,2,680,928.526929,0.22269900000003418,5208.824467105025,24427.590604354602
"193.71.118.32",19577,"147.32.84.192",31037,3,825,1,145,2,680,2321.475147,0.2741619999997056,4231.075057817078,19842.283029762846
"193.77.114.123",35204,"147.32.84.191",29676,12,3176,4,688,8,2488,2039.309933,1471.914272,3.73934821117082,13.522526670629361
"193.77.150.111",17090,"147.32.84.191",29676,10,3096,4,790,6,2306,2277.410582,1496.997378,4.221784281575408,12.323334877611256
"193.77.152.84",53260,"147.32.84.191",29676,10,2994,4,688,6,2306,2505.028109,1289.530138,4.268221298446303,14.305985921827288
"193.77.211.109",29418,"147.32.84.191",29676,12,3176,4,688,8,2488,2212.262068,1249.217717,4.405957364435938,15.933171399297406
"193.109.100.122",56388,"147.32.84.192",31037,3,825,1,145,2,680,773.032864,0.05438200000003235,21330.58732667629,100033.09918717157
"193.110.115.71",28044,"147.32.84.165",32234,3,825,1,145,2,680,1834.936272,0.20500800000013442,5658.315773039293,26535.54983218427
"193.110.115.79",35691,"147.32.84.165",32234,3,825,1,145,2,680,2002.602301,0.24054000000000997,4822.482747152041,22615.781159057846
"193.145.150.137",52517,"147.32.84.192",31037,3,825,1,145,2,680,2051.791828,0.17559699999992517,6606.035410630559,30980.02813261228
"193.219.64.37",10329,"147.32.84.192",31037,15,2496,3,444,12,2052,840.133586,2816.185617,1.2612804988983082,5.829161224638127
"193.238.72.179",60162,"147.32.84.165",32234,3,825,1,145,2,680,840.416698,0.16689599999995153,6950.436199791109,32595.14907488244
"193.238.96.13",50999,"147.32.84.192",31037,3,825,1,145,2,680,2008.56625,0.10416699999996126,11135.964364918173,52223.83288375419
"194.0.206.2",10724,"147.32.84.165",32234,3,825,1,145,2,680,1036.901949,0.16892299999994975,6867.034092458369,32204.021950839247
"194.22.192.176",36316,"147.32.84.165",32234,3,825,1,145,2,680,639.582462,0.04471200000000408,25943.818214347248,121667.56128107675
"194.28.28.2",50942,"147.32.84.165",32234,3,825,1,145,2,680,807.963947,0.1351720000000114,8581.65892344496,40245.02115822464
"194.28.108.48",38216,"147.32.84.191",29676,6,1588,2,344,4,1244,2458.102261,37.59856600000012,73.19428086698815,264.6909459259688
"194.44.15.178",31718,"147.32.84.192",31037,3,825,1,145,2,680,2042.866287,0.24611099999992803,4713.32041233565,22103.847450953395
"194.44.18.117",26944,"147.32.84.165",32234,1,143,1,143,0,0,2162.581145,0,0,0
"194.44.78.223",54087,"147.32.84.192",31037,3,825,1,145,2,680,3619.825709,0.03643499999998312,31837.518869233907,149306.98504192452
"194.125.224.106",60072,"147.32.84.165",32234,1,143,1,143,0,0,3531.365926,0,0,0
"194.146.137.34",61191,"147.32.84.192",31037,3,825,1,145,2,680,2865.317444,0.18420500000001994,6297.331777095488,29532.3145408616
"194.150.251.134",29520,"147.32.84.192",31037,3,828,1,148,2,680,880.741739,0.2150179999999864,5506.515733566841,25300.207424496297
"194.150.251.134",29527,"147.32.84.192",31037,3,666,1,148,2,518,3607.433871,0.15305099999977756,7735.983430371058,27075.942006298705
"194.152.20.222",30587,"147.32.84.191",29676,12,3160,4,688,8,2472,1897.419249,1498.166427,3.6738241498452693,13.20013560816498
"194.213.106.147",35691,"147.32.84.191",29676,9,1968,3,540,6,1428,2201.386678,1472.3720720000001,2.9340409819998268,7.758908374621764
"195.12.56.49",35691,"147.32.84.165",32234,3,825,1,145,2,680,918.26395,0.056508000000007996,20528.066822393925,96269.55475329564
"195.13.38.165",58337,"147.32.84.192",31037,6,900,2,344,4,556,2743.706019,37.13572199999999,74.10654355932546,119.77685528774697
"195.39.211.233",25512,"147.32.84.165",32234,3,825,1,145,2,680,1345.729962,0.21503000000006978,5394.5961028676165,25298.795516896407
"195.54.53.91",59086,"147.32.84.192",31037,1,143,1,143,0,0,1241.693281,0,0,0
"195.54.53.91",62893,"147.32.84.192",31037,1,143,1,143,0,0,2187.899262,0,0,0
"195.54.53.91",53666,"147.32.84.192",31037,1,143,1,143,0,0,3113.234061,0,0,0
"195.95.139.177",13976,"147.32.84.192",31037,3,825,1,145,2,680,3072.404649,0.16784000000006927,6911.344137270741,32411.820781683477
"195.112.229.82",40699,"147.32.84.165",32234,3,828,1,148,2,680,1924.16116,0.08120399999984329,14580.562533893464,66991.77380437538
"195.132.76.123",32351,"147.32.84.165",32234,6,884,2,296,4,588,2038.159629,1403.384776,1.687349072397234,3.351896130302613
"195.135.192.72",26822,"147.32.84.192",31037,3,825,1,145,2,680,2206.86834,0.24264799999991737,4780.587517722771,22419.30697966541
"195.138.217.171",60897,"147.32.84.191",29676,3,825,1,145,2,680,3437.549131,0.14968499999986307,7749.607509109538,36342.98693927231
"195.174.61.102",62840,"147.32.84.165",32234,3,825,1,145,2,680,1155.61739,0.06925700000010693,16749.209466165285,78548.01680684408
"195.174.141.242",11594,"147.32.84.165",32234,12,2460,4,640,8,1820,369.80153,2652.1431949999997,1.9305141629051445,5.4898996507615045
"195.182.199.95",27474,"147.32.84.165",7600,393,379718,45,4502,348,375216,399.092383,0.5397270000000276,66730.03203471043,5561567.236769415
"195.182.213.217",10179,"147.32.84.165",32234,3,825,1,145,2,680,954.192344,0.1314319999999043,8825.856716787728,41390.22460286659
"195.198.88.2",40039,"147.32.84.191",29676,1,145,1,145,0,0,3795.127699,0,0,0
"195.210.226.15",11041,"147.32.84.191",29676,6,1588,2,344,4,1244,3530.362819,35.230057000000215,78.11511630537478,282.48606012757625
"195.210.226.55",11065,"147.32.84.191",29676,10,1284,2,344,8,940,1278.180519,2421.794406,1.1363474922486876,3.1051355892842047
"195.210.226.55",11047,"147.32.84.191",29676,3,1210,1,148,2,1062,2729.853436,0.23363999999992302,5067.625406610127,36363.636363648344
"195.218.9.88",11248,"147.32.84.191",29676,6,804,2,344,4,460,2526.73956,38.2037220000002,72.03486613162941,96.32569308299283
"195.222.67.145",35691,"147.32.84.192",31037,3,825,1,145,2,680,3678.688631,0.040300999999999476,28783.404878291236,134984.2435671589
"195.225.52.147",61116,"147.32.84.165",32234,3,825,1,145,2,680,908.12981,0.23501299999998082,4935.897163136059,23147.65566160359
"195.225.145.17",50719,"147.32.84.165",32234,7,1241,1,145,6,1096,1578.287917,1936.705841,0.5989551822702434,4.527275032884047
"195.228.9.135",31946,"147.32.84.165",32234,3,825,1,145,2,680,2956.893194,0.0779789999996865,14875.79989490329,69762.37192092577
"195.230.130.137",7934,"147.32.84.165",32234,3,825,1,145,2,680,1038.255476,0.051201999999875625,22655.36502485875,106245.84977175138
"195.230.130.137",34689,"147.32.84.165",32234,6,1650,2,290,4,1360,2714.069726,884.1623889999996,2.623952374431979,12.305431824922383
"195.244.25.92",31927,"147.32.84.191",29676,3,825,1,145,2,680,2285.393311,0.26394200000004275,4394.904941236378,20610.588689936118
"195.249.185.108",7600,"147.32.84.191",7600,1715,1727460,149,15570,1566,1711890,3000.992925,1.7164739999998346,72567.36775506765,7978635.272075965
"196.15.161.122",27531,"147.32.84.165",32234,3,825,1,145,2,680,1779.855345,0.17291300000010779,6708.575989077032,31460.908086706084
"196.28.52.1",14523,"147.32.84.165",32234,1,107,1,107,0,0,3481.425541,0,0,0
"196.46.120.253",30196,"147.32.84.165",32234,3,825,1,145,2,680,1516.539172,0.2847839999999451,4073.2625428402707,19102.196752630236
"196.46.120.253",38096,"147.32.84.165",32234,3,825,1,145,2,680,2442.659622,0.17807799999991403,6513.9994833756,30548.411370313155
"196.201.228.198",60564,"147.32.84.165",32234,3,825,1,145,2,680,1031.432303,0.1341820000000098,8644.97473580596,40541.95048515899
"196.202.207.168",55117,"147.32.84.165",32234,3,825,1,145,2,680,928.606879,0.07736099999999624,14994.63553987224,70319.67011802155
"196.210.137.220",12920,"147.32.84.192",31037,1,143,1,143,0,0,913.661044,0,0,0
"196.210.254.137",63700,"147.32.84.165",32234,3,825,1,145,2,680,1025.021835,0.15375799999992523,7544.322897023661,35380.27289638682
"196.215.21.212",17326,"147.32.84.192",31037,21,4818,7,1330,14,3488,677.832922,2883.115079,3.6904527597595767,9.678420470707822
"196.215.118.238",40934,"147.32.84.191",29676,3,825,1,145,2,680,2575.08834,0.301792000000205,3843.706923971517,18025.660057245736
"196.215.128.221",44277,"147.32.84.165",32234,3,825,1,145,2,680,2952.646051,0.23923899999999776,4848.707777578116,22738.7675086422
"196.218.154.124",57052,"147.32.84.165",32234,3,825,1,145,2,680,3747.645954,0.14788599999974394,7843.879745222729,36785.091218975555
"197.1.120.165",37740,"147.32.84.192",31037,3,825,1,145,2,680,2605.450368,0.10905100000036327,10637.224784698314,49884.91623168864
"197.176.13.51",26568,"147.32.84.165",32234,3,825,1,145,2,680,1709.538161,0.2353480000001582,4928.871288471626,23114.706732142797
"199.58.229.140",60960,"147.32.84.165",32234,11,1801,1,145,10,1656,1081.703156,2542.125559,0.45631105666405836,5.211386964384004
"200.52.173.212",16880,"147.32.84.165",32234,2,292,2,292,0,0,2210.179682,900.7296569999999,2.5934529654328906,0
"200.71.155.154",29774,"147.32.84.191",29676,3,825,1,145,2,680,3648.067695,0.09467799999993076,12252.05433153265,57457.90996856691
"200.87.239.251",43261,"147.32.84.191",29676,3,825,1,145,2,680,1760.587486,0.16945400000008704,6845.515597149693,32103.107628012356
"200.112.85.139",19025,"147.32.84.191",29676,1,143,1,143,0,0,3388.427642,0,0,0
"200.158.219.161",53248,"147.32.84.191",29676,3,825,1,145,2,680,3518.923384,0.15200599999980113,7631.27771273185,35788.06099763902
"200.160.86.51",40490,"147.32.84.165",32234,6,1650,2,290,4,1360,1457.016818,867.7762669999997,2.6735001730578567,12.537793915029948
"200.199.90.7",23985,"147.32.84.165",32234,3,825,1,145,2,680,1706.411645,0.1360410000002048,8526.841172868868,39987.94481069538
"200.232.209.223",61603,"147.32.84.191",29676,3,831,1,143,2,688,3127.477812,0.033426999999846885,34223.831034949,164657.312951363
"201.1.136.178",58883,"147.32.84.165",32234,1,145,1,145,0,0,3790.268966,0,0,0
"201.2.10.124",61330,"147.32.84.165",32234,1,107,1,107,0,0,2178.619655,0,0,0
"201.18.103.18",51141,"147.32.84.192",31037,3,825,1,145,2,680,1431.374021,0.1980109999999513,5858.260399676206,27473.221184688417
"201.26.158.80",6447,"147.32.84.165",32234,25,5620,7,1172,18,4448,2374.627837,1387.0078520000002,6.7598752137417595,25.65522606717009
"201.58.250.213",44835,"147.32.84.192",31037,3,825,1,145,2,680,1675.804615,0.08590099999992162,13503.917300160165,63328.71561454423
"201.67.151.112",55491,"147.32.84.191",29676,3,825,1,145,2,680,1393.46484,0.1565729999999803,7408.684766850899,34744.176837645595
"201.74.45.182",38451,"147.32.84.165",32234,3,825,1,145,2,680,3020.811901,0.31590700000015204,3671.9667497062164,17220.25786069122
"201.79.71.189",32998,"147.32.84.192",31037,3,825,1,145,2,680,3660.816826,0.13367799999969066,8677.568485485153,40694.80393193038
"201.87.75.80",53715,"147.32.84.165",32234,3,825,1,145,2,680,2664.315523,0.08321999999998297,13938.956981497684,65368.90170633397
"201.141.219.54",55696,"147.32.84.165",32234,1,143,1,143,0,0,3776.000576,0,0,0
"201.160.130.234",16237,"147.32.84.191",29676,6,1656,2,280,4,1376,1841.329473,1806.4313610000002,1.2400139016408493,6.093782602349317
"201.227.10.67",7696,"147.32.84.192",7600,255,239916,31,3092,224,236824,1002.475768,4.925934999999981,5021.584734674756,384615.71255000465
"201.229.245.189",18828,"147.32.84.191",29676,3,825,1,145,2,680,2660.157055,0.03373299999975643,34387.69157822832,161266.41567720866
"201.239.138.68",21562,"147.32.84.165",32234,3,831,1,143,2,688,2149.695704,0.23369199999979173,4895.332317755933,23552.368074238337
"201.252.237.20",20197,"147.32.84.165",32234,3,825,1,145,2,680,2690.391878,0.054795000000012806,21169.814764115865,99279.13130757786
"202.7.216.169",7600,"147.32.84.191",7600,511,498434,57,5710,454,492724,1491.688959,14.276368999999931,3199.6931432635442,276106.0603014687
"202.57.48.28",7600,"147.32.84.165",7600,6,749,2,249,4,500,1256.357372,0.6328600000001643,3147.6155863847976,6320.513225672284
"202.63.112.151",26840,"147.32.84.192",31037,30,6486,6,870,24,5616,666.791455,2976.83134,2.3380565457228757,15.0925581158387
"202.78.236.37",12786,"147.32.84.192",31037,3,828,1,140,2,688,1548.862542,0.184481999999889,6071.053002464597,29834.889040683163
"202.88.239.106",23849,"147.32.84.165",32234,3,825,1,145,2,680,1852.453338,0.1345690000000559,8620.113101825222,40425.35799476656
"202.94.222.119",56880,"147.32.84.191",29676,3,825,1,145,2,680,2880.691649,0.1736590000000433,6679.757455701753,31325.759102601325
"202.119.99.27",61847,"147.32.84.191",7600,6,749,2,249,4,500,886.139764,0.362280999999939,5498.494262741726,11041.153138035595
"202.128.6.125",6890,"147.32.84.192",31037,1,143,1,143,0,0,1236.982416,0,0,0
"202.133.49.154",60565,"147.32.84.191",29676,3,825,1,145,2,680,2402.16585,0.11848700000018653,9790.103555648922,45912.209778215634
"202.133.58.75",48939,"147.32.84.191",29676,3,825,1,145,2,680,3042.055742,0.10428499999989072,11123.363858668223,52164.74085444408
"202.142.18.125",62597,"147.32.84.192",7600,3,269,1,89,2,180,790.530749,0.0003440000000409782,0,0
"202.152.194.118",35271,"147.32.84.165",32234,3,825,1,145,2,680,3205.570652,0.07213900000033391,16080.067647106707,75409.97241401765
"202.152.243.51",21206,"147.32.84.191",29676,3,825,1,145,2,680,2427.917676,0.131898000000092,8794.674672847132,41243.99156921413
"202.153.86.206",22309,"147.32.84.191",29676,3,825,1,145,2,680,3492.990304,0.10818000000017491,10722.869291903535,50286.55943789244
"202.156.230.210",7600,"147.32.84.192",7600,225,208242,33,3194,192,205048,2468.780129,1.9976289999999608,12791.163924833141,821165.4916904151
"202.158.233.33",34873,"147.32.84.165",32234,3,828,1,140,2,688,2472.092496,0.10678699999971286,10488.168035463226,51541.854345705
"202.177.252.118",20597,"147.32.84.165",32234,3,825,1,145,2,680,3348.784933,0.11395100000027014,10179.814130610965,47739.81799183073
"202.179.10.30",2361,"147.32.84.165",32234,3,825,1,145,2,680,2150.191809,0.13844400000016321,8378.839097386903,39293.866111883406
"202.179.85.214",52473,"147.32.84.165",32234,3,825,1,145,2,680,3063.903215,0.054270999999971536,21374.214589755273,100237.69600712818
"202.215.223.141",16571,"147.32.84.165",32234,3054,461063,1018,153785,2036,307278,945.605614,2578.043514,477.2145983258217,953.5230831639097
"202.225.216.173",7600,"147.32.84.191",7600,6,749,2,249,4,500,1813.192041,0.30708000000004176,6486.908948807246,13025.921583950292
"203.76.116.238",58392,"147.32.84.192",31037,3,825,1,145,2,680,2297.796806,0.19289700000035737,6013.572009921621,28201.57908101174
"203.82.92.71",27790,"147.32.84.191",7600,6,749,2,249,4,500,3311.489981,3.7393279999996594,532.7160388177184,1069.7109213207198
"203.82.95.82",29767,"147.32.84.192",7600,6,749,2,249,4,500,3545.144049,1.583643999999822,1257.858458087944,2525.820196963743
"203.82.95.92",15345,"147.32.84.191",7600,6,749,2,249,4,500,1412.404926,2.4196900000001733,823.2459529939196,1653.104323280963
"203.87.176.27",7600,"147.32.84.165",7600,6,538,2,178,4,360,2263.188463,3.0206389999998464,471.4234306052701,953.440646167962
"203.88.11.5",9463,"147.32.84.192",31037,3,825,1,145,2,680,1324.288784,0.19481599999994614,5954.336399476022,27923.78449409445
"203.91.35.124",62061,"147.32.84.192",7600,3,269,1,89,2,180,1542.963187,0.00023399999986395414,0,0
"203.114.103.210",11478,"147.32.84.192",31037,3,828,1,140,2,688,2489.923657,0.26396199999999226,4243.034982308184,20851.486198771647
"203.118.175.185",32178,"147.32.84.192",31037,15,4125,5,725,10,3400,3366.081512,89.84528,64.55542238835473,302.742670510905
"203.144.211.230",20111,"147.32.84.191",29676,6,1212,2,334,4,878,1568.260153,127.01558999999997,21.03678768881836,55.30029817599557
"203.156.87.18",17260,"147.32.84.192",7600,6,749,2,249,4,500,2650.21863,1.1184920000000602,1780.96937662486,3576.2437281623693
"203.158.201.241",5659,"147.32.84.192",7600,12,1287,4,427,8,860,2756.55469,6.264766000000236,545.2717627441905,1098.2054237939199
"203.176.133.150",19946,"147.32.84.191",29676,3,828,1,140,2,688,3210.513348,0.2078799999999319,5387.723686744116,26476.81354628537
"203.198.233.122",28479,"147.32.84.165",32234,7,1241,1,145,6,1096,1043.752049,2060.5053989999997,0.5629686777637025,4.255266695372537
"203.214.95.35",6881,"147.32.84.191",29676,1,107,1,107,0,0,2445.492671,0,0,0
"203.214.152.204",24500,"147.32.84.165",32234,3,825,1,145,2,680,2034.381161,0.11294300000008661,10270.667504839701,48165.888988213774
"203.219.243.18",9403,"147.32.84.191",29676,3,828,1,140,2,688,1652.268542,0.13066800000001422,8571.341108763263,42122.01916306518
"203.222.42.57",51413,"147.32.84.165",32234,6,1656,2,296,4,1360,1634.921801,1657.695147,1.428489432623042,6.563329825565328
"204.63.255.84",48205,"147.32.84.165",32234,3,825,1,145,2,680,556.177478,0.25331100000005335,4579.351074370065,21475.57745221824
"204.96.111.2",36029,"147.32.84.192",31037,3,825,1,145,2,680,1601.779074,0.15053599999987455,7705.797948669864,36137.53520755523
"204.96.111.2",51964,"147.32.84.192",31037,3,825,1,145,2,680,3505.775391,0.28372399999989284,4088.480354148532,19173.56304014484
"204.212.241.52",64237,"147.32.84.191",29676,3,825,1,145,2,680,2631.130194,0.0772730000003321,15011.71172330587,70399.75152998616
"205.200.18.149",60195,"147.32.84.165",32234,3,825,1,145,2,680,1313.712544,0.23528299999998126,4930.232953507446,23121.092471621127
"205.250.0.165",5564,"147.32.84.191",29676,3,825,1,145,2,680,1358.003781,0.14459800000008727,8022.240971516203,37621.54386642081
"206.248.164.157",14267,"147.32.84.165",32234,3,825,1,145,2,680,3757.901579,0.2252320000002328,5150.245080622652,24152.87348154071
"207.81.139.12",37930,"147.32.84.165",32234,3,825,1,145,2,680,3108.928353,0.24249100000042745,4783.6826933698785,22433.822286148396
"207.119.3.86",50144,"147.32.84.165",32234,3,825,1,145,2,680,2216.95927,0.2175760000000082,5331.470382762604,25002.75765709359
"207.144.34.66",34297,"147.32.84.165",32234,3,825,1,145,2,680,2835.834888,0.03683500000033746,31491.78770162543,147685.62508348477
"207.216.30.36",48973,"147.32.84.165",32234,6,1650,2,290,4,1360,319.458845,947.020363,2.449788928139447,11.4886653181712
"208.43.172.146",16230,"147.32.84.165",32234,1,143,1,143,0,0,3609.103985,0,0,0
"208.103.241.132",63708,"147.32.84.192",31037,3,825,1,145,2,680,1170.967979,0.09766700000000128,11877.092569649778,55699.46860249551
"208.138.36.66",7052,"147.32.84.165",32234,3,825,1,145,2,680,879.691663,0.18330500000001848,6328.250729657582,29677.31376667004
"209.65.59.45",24814,"147.32.84.191",29676,3,825,1,145,2,680,1989.845443,0.18510700000001634,6266.645777846854,29388.407785764557
"209.127.24.40",5067,"147.32.84.191",29676,3,825,1,145,2,680,2401.569867,0.10848899999973582,10692.328254503449,50143.33250387824
"209.169.108.217",1493,"147.32.84.165",32234,3,825,1,145,2,680,293.640679,0.08069100000000162,14375.828778921772,67417.67979080555
"209.169.173.226",55865,"147.32.84.165",32234,3,825,1,145,2,680,2526.529214,0.1495399999998881,7757.12184031609,36378.22656148235
"209.237.232.113",56352,"147.32.84.165",32234,3,825,1,145,2,680,3157.859951,0.05242900000030204,22125.159739711176,103759.36981381793
"210.6.146.119",7600,"147.32.84.165",7600,7,909,3,409,4,500,788.762485,0.9012690000000703,3630.436639893023,4438.186601336214
"210.7.63.187",23876,"147.32.84.192",31037,3,825,1,145,2,680,3313.809079,0.11914799999976822,9735.790781232221,45657.50159474421
"210.24.208.13",55670,"147.32.84.191",29676,3,825,1,145,2,680,3590.355308,0.19004599999971106,6103.785399333654,28624.648769288862
"210.35.99.254",26712,"147.32.84.165",49153,1,92,1,92,0,0,1566.002392,0,0,0
"210.49.65.34",10825,"147.32.84.192",31037,3,825,1,145,2,680,1608.800737,0.2373170000000755,4887.976841101274,22922.925875509423
"210.56.105.243",36902,"147.32.84.165",32234,3,825,1,145,2,680,1948.086062,0.1335990000000038,8682.699720806047,40718.86765619388
"210.56.111.96",58153,"147.32.84.165",32234,3,825,1,145,2,680,535.77069,0.2387180000000626,4859.290040967568,22788.394674882387
"210.56.122.83",49554,"147.32.84.191",29676,3,825,1,145,2,680,1476.714995,0.29137100000002647,3981.1786347985717,18670.354976986404
"210.56.223.159",51863,"147.32.84.191",7600,3,269,1,89,2,180,2263.565968,0.0002110000000357104,0,0
"210.73.90.23",21104,"147.32.84.165",7600,6,538,2,178,4,360,608.061597,4.43276000000003,321.24455192701396,649.7080825490169
"210.89.36.205",1208,"147.32.84.192",31037,3,825,1,145,2,680,982.959047,0.21583399999997255,5374.500773743467,25204.555352727984
"210.96.163.210",56983,"147.32.84.192",31037,3,825,1,145,2,680,896.558231,0.2254760000000715,5144.6717167220995,24126.736326696744
"210.101.217.93",33773,"147.32.84.165",32234,3,825,1,145,2,680,2663.126713,0.0486759999998867,23831.046100803273,111759.38861066362
"210.107.38.16",19236,"147.32.84.191",29676,3,825,1,145,2,680,2472.888106,0.09847700000000259,11779.400266051662,55241.32538562159
"210.148.58.84",24612,"147.32.84.165",32234,3,828,1,140,2,688,3736.694398,0.18253699999968376,6135.74234265897,30152.790941066938
"210.174.41.147",16795,"147.32.84.192",31037,1,145,1,145,0,0,3806.012481,0,0,0
"210.183.57.225",60343,"147.32.84.192",31037,3,825,1,145,2,680,2127.405121,0.12673000000040702,9153.318077773805,42925.90546818061
"210.192.71.45",1054,"147.32.84.165",32234,3,825,1,145,2,680,3349.175861,0.14371699999992416,8071.418134254209,37852.167802019736
"211.1.206.88",31592,"147.32.84.165",32234,3,828,1,140,2,688,3431.235448,0.194206000000122,5767.0720780990105,28341.039926657995
"211.27.213.229",31796,"147.32.84.191",29676,6,1428,2,468,4,960,1346.137944,2144.309091,1.7460169411742703,3.5815732126651696
"211.30.199.127",56697,"147.32.84.165",32234,3,825,1,145,2,680,3694.909541,0.09701499999982843,11956.913879318161,56073.803020250685
"211.38.100.217",16881,"147.32.84.192",31037,9,1416,3,348,6,1068,826.991102,1800.5142850000002,1.5462248887406076,4.745310865445313
"211.76.41.95",7600,"147.32.84.192",7600,6,749,2,249,4,500,2912.938405,0.34439900000006674,5783.988919827334,11614.435581982598
"211.117.15.110",2353,"147.32.84.192",31037,1,145,1,145,0,0,3802.19967,0,0,0
"211.133.88.176",47799,"147.32.84.192",31037,12,1624,4,688,8,936,1197.002043,1527.37637,3.6035649811709476,4.902524451127917
"211.139.95.71",49096,"147.32.84.191",7600,6,749,2,249,4,500,1099.079025,0.42364900000006855,4702.0056697872005,9441.778453387953
"211.140.65.202",7600,"147.32.84.165",7600,107,100585,13,1265,94,99320,3312.895645,2.1142719999998008,4786.517534168241,375807.84307793644
"211.140.142.34",16224,"147.32.84.165",7600,6,538,2,178,4,360,371.528106,9.445104000000015,150.76594180434623,304.91988230092494
"211.140.199.130",7600,"147.32.84.165",7600,6,749,2,249,4,500,914.192516,0.4472200000000157,4454.183623272505,8944.14382183234
"211.141.82.17",62127,"147.32.84.191",7600,3,269,1,89,2,180,3139.628542,0.0043450000002849265,0,0
"211.141.115.70",2619,"147.32.84.165",7600,6,749,2,249,4,500,2876.995961,0.38265099999989616,5205.788041846332,10453.389642261709
"211.141.217.199",49540,"147.32.84.191",29676,1,143,1,143,0,0,3226.145762,0,0,0
"211.142.14.59",7600,"147.32.84.192",7600,6,749,2,249,4,500,3164.312823,0.3949999999999818,5043.037974683776,10126.582278481479
"211.142.67.196",12724,"147.32.84.191",7600,6,749,2,249,4,500,1370.452019,0.40804800000000796,4881.778614280578,9802.768301768228
"211.142.88.74",16224,"147.32.84.165",7600,10,1178,4,498,6,680,695.512798,1771.957169,2.248361342869456,3.0700516328337955
"211.142.93.29",28530,"147.32.84.191",7600,6,749,2,249,4,500,3270.814268,0.4079790000000685,4882.6042516886055,9804.426208210052
"211.142.95.90",16730,"147.32.84.191",7600,6,749,2,249,4,500,3298.472772,0.42912799999976414,4641.971626184017,9321.228165028146
"211.199.27.137",2472,"147.32.84.165",32234,3,825,1,145,2,680,3011.162114,0.1977799999999661,5865.1026392971935,27505.308929117873
"211.229.47.242",42355,"147.32.84.192",31037,3,825,1,145,2,680,2201.035746,0.029618000000027678,39165.372408633804,183672.091295662
"211.244.172.85",29065,"147.32.84.192",31037,3,828,1,148,2,680,3626.454984,0.25980100000015227,4557.334267378902,20939.10339065982
"212.2.150.221",53054,"147.32.84.165",32234,3,828,1,148,2,680,2794.812797,0.27249299999994037,4345.065744809074,19963.81558425791
"212.5.131.210",53461,"147.32.84.191",29676,24,6600,8,1160,16,5440,3045.284514,44.2213999999999,209.85314802335566,984.1389010750472
"212.5.131.211",53461,"147.32.84.191",29676,3,825,1,145,2,680,2227.028876,0.0699970000000576,16572.13880593519,77717.6164692133
"212.13.4.74",6881,"147.32.84.165",32234,1,107,1,107,0,0,1974.018086,0,0,0
"212.22.204.125",58296,"147.32.84.165",32234,1,143,1,143,0,0,1404.18336,0,0,0
"212.25.39.146",7600,"147.32.84.191",7600,445,432850,49,4930,396,427920,668.000935,1.0565920000000233,37327.55879279716,3240001.8171630343
"212.36.208.23",44736,"147.32.84.191",7600,538,514933,68,6657,470,508276,2234.229126,34.84116199999971,1528.5368496033639,116707.01453642773
"212.49.22.58",40562,"147.32.84.165",32234,3,825,1,145,2,680,923.106725,0.2715739999999869,4271.395641703757,20031.372664541756
"212.52.61.84",36129,"147.32.84.165",32234,3,825,1,145,2,680,837.50057,0.22158300000000963,5235.0586461955545,24550.61985802053
"212.54.221.179",34347,"147.32.84.165",32234,3,825,1,145,2,680,783.180264,0.13388500000007753,8664.15207080202,40631.885573416366
"212.58.195.202",36556,"147.32.84.192",31037,3,825,1,145,2,680,3521.515575,0.23829999999998108,4867.813680235385,22828.36760386249
"212.64.103.157",38789,"147.32.84.165",32234,1,145,1,145,0,0,3818.067603,0,0,0
"212.72.115.95",60909,"147.32.84.191",29676,12,2952,4,688,8,2264,1655.984873,1302.4129889999997,4.226002079590748,13.90649521539746
"212.74.223.59",27707,"147.32.84.191",29676,6,1028,2,344,4,684,3447.221339,35.1921269999998,78.19930861240685,155.48932293862293
"212.76.113.24",20863,"147.32.84.191",29676,3,825,1,145,2,680,1881.591711,0.2594420000000355,4471.1342034051595,20968.07764355523
"212.85.181.154",25168,"147.32.84.191",29676,12,2488,4,688,8,1800,1301.489029,1443.0911199999998,3.8140349723723617,9.978579869578853
"212.87.186.99",14394,"147.32.84.191",29676,3,825,1,145,2,680,1405.252295,0.08595900000000256,13494.805663164596,63285.98517897879
"212.90.33.132",3635,"147.32.84.192",31037,1,143,1,143,0,0,978.289586,0,0,0
"212.106.45.67",6881,"147.32.84.165",32234,1,143,1,143,0,0,2751.318896,0,0,0
"212.108.211.151",17543,"147.32.84.165",32234,3,825,1,145,2,680,378.178148,0.2947309999999561,3935.7922987407933,18457.508711336133
"212.124.0.28",43416,"147.32.84.192",31037,3,825,1,145,2,680,3075.776382,0.02955599999995684,39247.53011238645,184057.38259601922
"212.124.23.165",41761,"147.32.84.165",32234,3,825,1,145,2,680,1573.425082,0.12217099999998027,9494.888312285137,44527.75208519926
"212.160.115.40",55279,"147.32.84.165",32234,1,143,1,143,0,0,3661.396546,0,0,0
"212.164.169.71",52646,"147.32.84.165",32234,6,1650,2,290,4,1360,3282.653855,42.951394000000164,54.01454490627222,253.30958990527662
"212.198.156.119",41994,"147.32.84.191",29676,3,825,1,145,2,680,2545.069016,0.13160100000004604,8814.522685994743,41337.07190673397
"212.219.39.66",4377,"147.32.84.165",32234,3,825,1,145,2,680,3505.270703,0.15816499999982625,7334.113109735241,34394.46148013768
"212.225.223.249",1030,"147.32.84.192",31037,3,825,1,145,2,680,2046.001868,0.13148999999998523,8821.96364742665,41371.96745000085
"212.233.131.250",7600,"147.32.84.165",7600,486,460661,66,6389,420,454272,1880.042232,0.5929940000000897,86193.11493875532,6128520.693294452
"213.5.25.9",1073,"147.32.84.165",32234,3,825,1,145,2,680,3479.278508,0.15424800000027972,7520.356827951717,35267.88029660116
"213.5.49.43",35988,"147.32.84.165",32234,3,825,1,145,2,680,3496.435763,0.2076879999999619,5585.3010284668,26193.135857637408
"213.10.129.162",59623,"147.32.84.165",32234,3,426,1,148,2,278,1885.837992,0.3191420000000562,3709.9472961872502,6968.684786081457
"213.16.4.198",64777,"147.32.84.165",32234,3,825,1,145,2,680,1104.295004,0.20376899999996567,5692.720678808825,26696.896976482763
"213.22.9.153",38187,"147.32.84.165",32234,3,825,1,145,2,680,3707.312867,0.14041099999985818,8261.460996653906,38743.4032946528
"213.25.16.86",55002,"147.32.84.192",31037,3,426,1,148,2,278,1755.765818,0.25823300000001836,4585.006563839307,8612.3771942387
"213.25.16.86",43219,"147.32.84.192",31037,6,1003,2,399,4,604,3075.632138,32.564812000000074,98.01991179927563,148.3810193653195
"213.33.185.113",35554,"147.32.84.192",31037,3,825,1,145,2,680,2806.938488,0.08667600000035236,13383.17411965578,62762.47173355814
"213.35.223.21",49794,"147.32.84.165",32234,3,825,1,145,2,680,401.112583,0.20334200000002056,5704.674882709341,26752.958070636905
"213.37.61.151",50351,"147.32.84.191",29676,3,825,1,145,2,680,3222.618142,0.17210900000009133,6739.914821417732,31607.876403890055
"213.47.89.48",25168,"147.32.84.165",32234,9,2484,3,444,6,2040,876.176396,2742.9350050000003,1.2949632395682666,5.949831100719063
"213.49.98.139",52340,"147.32.84.192",31037,3,825,1,145,2,680,1493.256198,0.21442999999999302,5409.690808189329,25369.58447978444
"213.49.234.159",30923,"147.32.84.165",32234,3,825,1,145,2,680,1879.848477,0.2101230000000669,5520.576043553684,25889.597997355206
"213.49.234.159",30963,"147.32.84.165",32234,3,825,1,145,2,680,3548.843445,0.26554399999986344,4368.390925799855,20486.247100302764
"213.55.72.13",24571,"147.32.84.192",7600,36,28034,6,862,30,27172,1062.982405,15.147958000000017,455.2428782810193,14350.185021637884
"213.55.108.97",8546,"147.32.84.192",31037,9,2475,3,435,6,2040,1268.409913,1882.915086,1.8481980551724146,8.667411569084427
"213.64.0.33",64629,"147.32.84.165",32234,3,825,1,145,2,680,3422.55356,0.06330400000024383,18324.276506943195,85934.5381015267
"213.64.21.46",63969,"147.32.84.165",32234,4,1007,2,327,2,680,3421.066301,34.074129000000084,76.77378928746774,159.65191656109496
"213.65.238.247",33336,"147.32.84.192",31037,1,143,1,143,0,0,1934.333928,0,0,0
"213.79.104.83",60695,"147.32.84.191",29676,3,825,1,145,2,680,1712.187485,0.2370290000001205,4893.915934334661,22950.77817481082
"213.80.217.90",42897,"147.32.84.192",31037,3,825,1,145,2,680,3530.235773,0.1779989999999998,6516.890544328909,30561.969449266602
"213.87.129.166",44827,"147.32.84.192",31037,3,825,1,145,2,680,3497.890961,0.11637199999995573,9968.033547592559,46746.64008526166
"213.87.139.50",56625,"147.32.84.192",31037,3,825,1,145,2,680,2427.666509,0.05779899999970439,20069.551376424035,94119.27542047133
"213.89.238.153",47357,"147.32.84.191",29676,1,145,1,145,0,0,3782.815211,0,0,0
"213.93.81.133",28741,"147.32.84.191",29676,3,828,1,148,2,680,2179.936784,0.039390999999795895,30057.627376967706,138102.61227255434
"213.96.27.154",20767,"147.32.84.192",31037,3,825,1,145,2,680,2407.463851,0.12723099999993792,9117.2748779823,42756.87528984802
"213.107.104.223",55473,"147.32.84.165",32234,3,825,1,145,2,680,1380.228087,0.16046400000004724,7229.035796188918,33901.685113161824
"213.109.2.118",23703,"147.32.84.165",32234,3,825,1,145,2,680,3172.577997,0.14433000000008178,8037.137116326077,37691.401648977466
"213.109.7.25",41106,"147.32.84.165",32234,6,1650,2,290,4,1360,1226.786815,1845.9521020000002,1.2568040077997646,5.893977415888551
"213.109.7.42",21782,"147.32.84.165",32234,3,825,1,145,2,680,845.193991,0.057054999999991196,20331.259311194095,95346.59539042748
"213.109.18.248",40005,"147.32.84.192",31037,6,1650,2,290,4,1360,1330.13572,1809.2953169999998,1.2822671778351815,6.013390902951197
"213.111.74.140",50889,"147.32.84.165",32234,3,825,1,145,2,680,2058.378103,0.15004200000021228,7731.16860611268,36256.514842459466
"213.112.13.93",40367,"147.32.84.191",29676,3,825,1,145,2,680,3001.937729,0.1753099999996266,6616.850151174895,31030.74553654433
"213.114.126.173",10826,"147.32.84.192",31037,3,825,1,145,2,680,975.282489,0.17586399999993318,6596.006004642455,30932.993676943926
"213.118.57.62",18192,"147.32.84.191",29676,6,1650,2,290,4,1360,2447.935801,890.2596039999999,2.605981434601856,12.221154313994912
"213.118.127.164",59406,"147.32.84.191",29676,3,825,1,145,2,680,3768.76007,0.07808999999997468,14854.654885393471,69663.20911770732
"213.123.14.1",63320,"147.32.84.165",32234,3,825,1,145,2,680,2856.051956,0.13310500000034153,8714.924307854879,40869.98985752633
"213.123.112.4",54340,"147.32.84.192",31037,3,825,1,145,2,680,1016.11217,0.1311879999999519,8842.272159042179,41467.20736654263
"213.138.94.43",56331,"147.32.84.191",29676,3,429,3,429,0,0,1717.065246,1875.419658,1.829990415937082,0
"213.138.176.38",18625,"147.32.84.192",31037,3,825,1,145,2,680,652.851529,0.21955700000000888,5283.36605072921,24777.16492755767
"213.149.5.97",58779,"147.32.84.192",31037,3,825,1,145,2,680,2254.323214,0.17683900000020003,6559.638993653481,30762.444935754254
"213.149.24.77",48739,"147.32.84.192",31037,3,825,1,145,2,680,926.431326,0.2905919999999469,3991.8511177190426,18720.40524171689
"213.155.206.68",6881,"147.32.84.192",31037,1,143,1,143,0,0,1451.736853,0,0,0
"213.156.99.181",63061,"147.32.84.192",31037,6,996,2,344,4,652,3430.764583,32.21884399999999,85.41585166742794,161.8928351371018
"213.161.27.188",15509,"147.32.84.191",29676,12,2776,4,688,8,2088,1562.150609,1249.46833,4.405073636400212,13.368886268609947
"213.162.68.19",20496,"147.32.84.192",31037,3,825,1,145,2,680,2626.679589,0.021684000000277592,53495.66500577154,250876.22209603203
"213.168.37.44",59993,"147.32.84.191",29676,9,1968,3,540,6,1428,2274.968728,1377.2151860000004,3.136764714704503,8.295000023329685
"213.174.4.40",29724,"147.32.84.191",29676,3,825,1,145,2,680,3615.604528,0.13991299999997864,8290.866467020056,38881.30481085268
"213.191.12.31",15631,"147.32.84.165",32234,1,143,1,143,0,0,3634.58976,0,0,0
"213.195.175.169",50710,"147.32.84.165",32234,3,825,1,145,2,680,2912.372924,0.10342000000036933,11216.399149060699,52601.04428525017
"213.198.193.134",24210,"147.32.84.165",32234,3,825,1,145,2,680,1433.24148,0.24182300000006762,4796.8969039325275,22495.792377062888
"213.202.82.230",57696,"147.32.84.165",32234,3,825,1,145,2,680,1886.224057,0.13329400000020541,8702.567257327504,40812.039551604845
"213.207.46.242",37809,"147.32.84.165",32234,3,825,1,145,2,680,3384.0855,0.16562199999998484,7003.900448008756,32845.877963075545
"213.227.219.114",64617,"147.32.84.192",31037,1,143,1,143,0,0,1475.283854,0,0,0
"213.230.119.12",51538,"147.32.84.165",32234,3,825,1,145,2,680,808.655998,0.2837080000000469,4088.7109281367043,19174.6443526411
"213.231.6.123",35691,"147.32.84.165",32234,3,825,1,145,2,680,675.494374,0.0885960000000523,13093.141902561236,61402.320646494074
"213.233.185.69",58396,"147.32.84.165",32234,3,825,1,145,2,680,538.813086,0.24380900000005568,4757.822721883667,22312.54793710961
"213.234.12.206",44600,"147.32.84.192",31037,3,825,1,145,2,680,1497.42738,0.12727499999982683,9114.122962102363,42742.09389123867
"213.248.17.82",16809,"147.32.84.191",29676,9,1680,3,492,6,1188,1402.970582,1334.974028,2.9483719663795585,7.119239626136007
"216.40.69.23",57458,"147.32.84.165",32234,3,506,1,148,2,358,1581.546913,0.33132799999998497,3573.498164960564,8644.002317945147
"216.195.247.73",42640,"147.32.84.165",32234,6,1650,2,290,4,1360,1387.908007,979.7264540000001,2.3680079174426374,11.105140578351678
"216.197.170.253",56364,"147.32.84.165",32234,3,825,1,145,2,680,3475.40458,0.12763300000005984,9088.558601611308,42622.20585583235
"216.221.58.127",38777,"147.32.84.165",32234,3,825,1,145,2,680,1991.891335,0.20053499999994528,5784.526391903241,27127.43411375313
"217.12.35.215",58010,"147.32.84.191",29676,3,825,1,145,2,680,2202.446377,0.06656999999995605,17425.266636634606,81718.49181318299
"217.15.199.132",63617,"147.32.84.191",29676,3,825,1,145,2,680,2452.747329,0.10118000000011307,11464.716347091358,53765.56631739396
"217.15.199.144",65090,"147.32.84.191",29676,3,825,1,145,2,680,3429.506295,0.13252799999963827,8752.867318628261,41047.92949425667
"217.18.249.74",20429,"147.32.84.191",29676,3,825,1,145,2,680,3429.928338,0.12555199999997058,9239.199694152796,43328.6606346476
"217.43.57.174",40243,"147.32.84.165",4041,1,145,1,145,0,0,1082.8528,0,0,0
"217.66.16.85",52390,"147.32.84.191",29676,3,825,1,145,2,680,3454.925371,0.31395900000006804,3694.749951425978,17327.103220480447
"217.67.65.133",40500,"147.32.84.165",32234,3,825,1,145,2,680,1588.903589,0.2851670000000013,4067.7918552988067,19076.541114504747
"217.67.76.190",50420,"147.32.84.192",31037,9,1728,3,444,6,1284,857.354092,2849.170965,1.2466784351075262,3.605259258283927
"217.72.70.168",40607,"147.32.84.191",29676,12,3080,4,688,8,2392,1738.833727,1420.314513,3.8751980280581697,13.473072213830148
"217.85.113.86",7600,"147.32.84.165",7600,3,269,1,89,2,180,188.358218,0.00019100000000094042,0,0
"217.87.198.115",38709,"147.32.84.165",32234,3,825,1,145,2,680,714.79452,0.0676539999999477,17146.06675142485,80409.1406273717
"217.112.25.102",64664,"147.32.84.165",32234,3,825,1,145,2,680,3430.34256,0.26650999999992564,4352.55712731351,20411.992045332325
"217.113.225.35",55555,"147.32.84.165",32234,3,825,1,145,2,680,2458.337519,0.2112789999996494,5490.370552690637,25747.94466089402
"217.118.90.237",35454,"147.32.84.191",29676,3,825,1,145,2,680,3196.815029,0.04463900000018839,25986.245211476613,121866.52926761446
"217.123.241.73",35969,"147.32.84.192",31037,3,825,1,145,2,680,1202.740599,0.09800500000005741,11836.130809645636,55507.372072820915
"217.132.203.4",55808,"147.32.84.192",31037,3,825,1,145,2,680,2692.09226,0.0841920000002574,13778.031166814586,64614.21512713047
"217.148.240.52",44507,"147.32.84.191",29676,3,825,1,145,2,680,2296.123433,0.02581899999995585,44928.153685347366,210697.54831749108
"217.153.78.94",16907,"147.32.84.165",32234,3,825,1,145,2,680,3413.812962,0.14395500000000538,8058.0737035876255,37789.58702372128
"217.164.61.33",26833,"147.32.84.191",29676,3,825,1,145,2,680,3355.277863,0.03310600000031627,35038.96574605565,164320.66694701958
"217.165.18.89",44096,"147.32.84.191",29676,1,143,1,143,0,0,2221.734095,0,0,0
"217.170.101.66",58432,"147.32.84.191",29676,1,143,1,143,0,0,2603.615155,0,0,0
"217.171.60.134",25246,"147.32.84.165",32234,3,825,1,145,2,680,2174.996835,0.4186840000002121,2770.5859311543127,12993.092642654708
"217.174.225.134",59501,"147.32.84.191",29676,3,825,1,145,2,680,3554.602646,0.09260600000015984,12526.186208215428,58743.493941975794
"217.208.244.166",60070,"147.32.84.191",29676,3,825,1,145,2,680,2225.065744,0.2159830000000511,5370.793071675666,25187.167508547955
"217.216.237.50",24602,"147.32.84.191",29676,3,828,1,140,2,688,2978.311841,0.2094849999998587,5346.444852857033,26273.957562611704
"217.229.81.189",16148,"147.32.84.165",32234,1,143,1,143,0,0,324.13356,0,0,0
"217.233.205.46",15758,"147.32.84.165",32234,3,506,1,148,2,358,1314.055804,0.09284699999989243,12752.162159266016,30846.446304170495
"217.233.205.46",16890,"147.32.84.165",32234,3,490,1,148,2,342,2738.297343,0.16020399999979418,7390.577014316254,17078.225262811884
"217.233.205.46",16904,"147.32.84.165",32234,3,374,1,196,2,178,2767.895903,0.2547609999996894,6154.788213274056,5589.552561034602
"218.14.203.88",7600,"147.32.84.165",7600,917,905398,101,15198,816,890200,2828.185888,10.992481000000225,11060.651367056946,647861.0242764899
"218.14.203.88",7600,"147.32.84.192",7600,617,575998,101,15198,516,560800,2828.191606,11.345839000000069,10716.175330885557,395422.49806294387
"218.14.203.88",7600,"147.32.84.191",7600,724,705795,88,13235,636,692560,2828.199848,11.119846999999936,9521.713743003893,498251.45975479984
"218.16.251.6",7600,"147.32.84.165",7600,1100,1029379,172,16203,928,1013176,1130.41627,96.78784800000017,1339.2590359070673,83744.06671382947
"218.16.251.6",7600,"147.32.84.191",7600,1106,1038013,170,16053,936,1021960,1130.484463,99.83899199999996,1286.3110637174707,81888.64727320167
"218.16.251.6",7600,"147.32.84.192",7600,754,673655,146,13855,608,659800,1130.582351,98.79306999999994,1121.9410430306505,53428.84880488078
"218.26.15.106",15345,"147.32.84.165",7600,579,566472,67,10064,512,556408,1400.226788,10.76259600000003,7480.723052319327,413586.46185362595
"218.26.15.106",15221,"147.32.84.192",7600,201,177944,39,5836,162,172108,1400.23265,10.851260000000138,4302.541824635978,126885.17278177672
"218.26.15.106",16104,"147.32.84.191",7600,733,727988,75,11272,658,716716,1400.23646,10.72168899999997,8410.61515587705,534778.4290329645
"218.27.143.34",19827,"147.32.84.165",7600,500,481289,58,5773,442,475516,457.111159,6.767098000000033,6824.78663675327,562150.5703035454
"218.28.109.237",40560,"147.32.84.192",7600,6,749,2,249,4,500,1393.495004,0.6412379999999303,3106.4908817010482,6237.933497391663
"218.29.176.166",7600,"147.32.84.165",7600,967,898486,157,14874,810,883612,270.022629,217.851387,546.2072178590261,32448.24876878108
"218.29.202.56",21841,"147.32.84.165",7600,295,283208,35,3496,260,279712,362.697345,12.009426000000019,2328.837364916521,186328.30578247423
"218.48.4.222",37697,"147.32.84.192",31037,3,825,1,145,2,680,3688.309535,0.26887600000009115,4314.256385841826,20232.374774982356
"218.56.40.164",28389,"147.32.84.165",32234,1,107,1,107,0,0,2208.822282,0,0,0
"218.65.113.243",5089,"147.32.84.165",7600,303,283872,43,4160,260,279712,440.547825,17.954218000000026,1853.6034262255228,124633.44268182534
"218.65.113.243",5089,"147.32.84.191",7600,191,174910,29,2802,162,172108,440.849993,18.52162900000002,1210.2607173483486,74338.16971498558
"218.88.1.237",35685,"147.32.84.165",32234,3,825,1,145,2,680,2515.151877,0.2841490000000704,4082.3652379551318,19144.88525385855
"218.106.90.244",7600,"147.32.84.165",7600,6,749,2,249,4,500,1230.167569,0.41451200000005883,4805.650982359298,9649.901571002607
"218.109.61.202",45193,"147.32.84.165",32234,1,143,1,143,0,0,3776.03978,0,0,0
"218.111.1.65",7600,"147.32.84.165",7600,6,749,2,249,4,500,431.245089,0.30360100000001466,6561.243210661045,13175.187170002098
"218.111.10.99",7600,"147.32.84.165",7600,6,749,2,249,4,500,2256.679346,0.276969999999892,7192.11466946159,14441.997328236124
"218.111.172.69",7600,"147.32.84.165",7600,6,749,2,249,4,500,3646.96266,0.26416100000005827,7540.855765989531,15142.280654597453
"218.151.9.98",62946,"147.32.84.165",32234,3,825,1,145,2,680,1129.592734,0.13591599999995196,8534.683186677139,40024.721151313475
"218.161.48.13",56131,"147.32.84.191",29676,3,825,1,145,2,680,2433.878479,0.2179639999999381,5321.979776478361,24958.249986243347
"218.200.52.56",7600,"147.32.84.192",7600,68,58933,10,1017,58,57916,775.812256,1.1747449999999162,6925.758356069257,394407.2969027602
"218.205.128.26",56018,"147.32.84.192",7600,6,749,2,249,4,500,1549.139936,0.4137860000000728,4814.08264175117,9666.832613958171
"218.206.226.194",7600,"147.32.84.191",7600,6,749,2,249,4,500,1082.277725,0.7186730000000807,2771.7752023518015,5565.813659340967
"218.217.140.30",18156,"147.32.84.192",31037,3,831,1,143,2,688,3702.232297,0.27345400000012887,4183.518983081106,20127.699722795813
"218.239.43.116",32663,"147.32.84.192",31037,3,825,1,145,2,680,1653.389309,0.17007200000011835,6820.640669829207,31986.452796440415
"218.242.45.226",58247,"147.32.84.165",7600,6,749,2,249,4,500,2181.811423,0.3698460000000523,5386.025534951624,10815.312319179968
"219.64.188.140",46240,"147.32.84.192",31037,3,825,1,145,2,680,2130.515577,0.24762199999986478,4684.559530254312,21968.968831537466
"219.73.9.76",7600,"147.32.84.165",7600,6,749,2,249,4,500,3675.841769,0.6352830000000722,3135.610428737702,6296.40648340904
"219.74.76.76",7600,"147.32.84.191",7600,1184,1188101,106,11025,1078,1177076,1353.51891,5.264513000000079,16753.68642835504,1788694.9847022619
"219.75.44.98",7600,"147.32.84.192",7600,154,143363,20,1999,134,141364,1466.548598,1.4109589999998207,11334.135152050509,801520.1008676678
"219.78.197.9",7600,"147.32.84.192",7600,6,749,2,249,4,500,2769.615972,0.4699689999997645,4238.577438088466,8511.199674876438
"219.88.193.92",58462,"147.32.84.165",32234,6,1650,2,290,4,1360,2876.23333,876.0549030000002,2.6482358492090987,12.419312948015083
"219.94.88.214",48500,"147.32.84.165",7600,6,749,2,249,4,500,648.732475,0.7117200000000139,2798.8534817062346,5620.187714269547
"219.95.193.114",7600,"147.32.84.191",7600,6,749,2,249,4,500,2948.985497,0.29897699999992255,6662.719874774702,13378.95557183675
"219.112.221.208",33841,"147.32.84.165",32234,3,825,1,145,2,680,2086.968308,0.3138850000000275,3695.6210076935768,17331.18817401126
"219.134.244.130",2329,"147.32.84.191",29676,1,143,1,143,0,0,3792.825462,0,0,0
"219.140.69.36",44335,"147.32.84.191",7600,3,269,1,89,2,180,2756.33403,0.00021900000001551234,0,0
"219.140.231.71",25979,"147.32.84.165",32234,3,825,1,145,2,680,855.647869,0.15963299999998526,7266.667919541117,34078.166795089375
"219.141.250.133",7600,"147.32.84.165",7600,3,269,1,89,2,180,571.511533,0.013553000000001703,52534.49420791784,106249.5388474743
"219.142.132.196",55579,"147.32.84.165",7600,3,267,3,267,0,0,79.586707,9.472819999999999,225.4872361134277,0
"219.144.136.206",7600,"147.32.84.165",7600,1195,1120658,185,17446,1010,1103212,3567.805975,49.09837099999959,2842.619768382971,179755.3731466992
"219.144.136.206",7600,"147.32.84.191",7600,863,806308,135,12732,728,793576,3568.577798,48.579919000000245,2096.6687902464287,130683.79138301914
"219.144.136.206",7600,"147.32.84.192",7600,601,540902,113,10846,488,530056,3572.229888,41.59989900000028,2085.774294788538,101934.0936380632
"219.152.79.188",2480,"147.32.84.191",7600,614,577439,96,14443,518,562996,885.119975,44.87365800000009,2574.8736597315014,100369.97652386597
"219.152.79.188",2480,"147.32.84.165",7600,546,516033,82,12329,464,503704,885.134643,42.87949400000002,2300.213710544251,93975.73581441978
"219.152.79.188",2480,"147.32.84.192",7600,696,637171,128,19275,568,617896,885.154985,44.85687799999994,3437.599915000777,110198.66340229935
"219.153.62.169",7600,"147.32.84.191",7600,1326,1231217,216,20221,1110,1210996,2376.931146,106.37888000000021,1520.6777886738391,91070.40796067774
"219.153.62.169",7600,"147.32.84.192",7600,862,743827,196,18327,666,725500,2376.94518,106.99980899999991,1370.2454366063412,54243.08748065153
"219.185.27.16",26092,"147.32.84.165",32234,3,825,1,145,2,680,3641.751725,0.07417099999975107,15639.53566763146,73344.02933785788
"219.233.194.178",7600,"147.32.84.165",7600,6,749,2,249,4,500,1713.69404,0.3978149999998095,5007.352663929098,10054.925027970075
"219.234.174.139",13990,"147.32.84.192",31037,9,1416,3,348,6,1068,705.100594,4.305987999999957,646.541513817509,1984.213611370976
"219.234.174.139",13051,"147.32.84.192",31037,12,2244,4,488,8,1756,2836.865041,21.190881999999874,184.23017975372724,662.9266304252973
"219.237.213.98",41296,"147.32.84.165",32234,2,286,2,286,0,0,1089.294488,873.7074950000001,2.618725389324948,0
"220.104.200.195",39158,"147.32.84.191",29676,3,825,1,145,2,680,2395.314171,0.3189860000002227,3636.5232329920127,17054.03998920392
"220.108.23.104",54941,"147.32.84.165",32234,3,828,1,140,2,688,2822.140023,0.12609100000008766,8882.473768938476,43651.01395021194
"220.114.204.221",7600,"147.32.84.192",7600,600,565191,84,8143,516,557048,2966.567281,856.7582319999997,76.03545267132026,5201.44870927835
"220.135.247.91",6884,"147.32.84.165",32234,1,107,1,107,0,0,3684.66716,0,0,0
"220.135.252.249",16371,"147.32.84.191",29676,3,831,1,143,2,688,1881.78388,0.06739900000002308,16973.545601560978,81662.93268443322
"220.136.41.27",12437,"147.32.84.191",29676,3,828,1,140,2,688,1944.335317,0.20309099999985847,5514.7692413784,27101.151700488135
"220.136.139.216",23625,"147.32.84.192",31037,9,2493,3,429,6,2064,2799.657681,34.01350400000001,100.90110092744337,485.4542478187485
"220.151.50.178",20912,"147.32.84.165",32234,3,426,1,148,2,278,3127.788227,0.08634100000017497,13713.067951466865,25758.33034126884
"220.167.144.114",7600,"147.32.84.191",7600,717,716898,65,6770,652,710128,1131.907048,5.5519409999999425,9755.146893672061,1023250.0669585752
"220.167.144.114",7600,"147.32.84.165",7600,643,641600,59,6136,584,635464,1131.933812,5.546372999999903,8850.468585506394,916583.1436147711
"220.167.144.114",7600,"147.32.84.192",7600,714,714615,64,6683,650,707932,1131.946635,5.457883000000038,9795.739483605572,1037665.3365416519
"220.170.159.79",7600,"147.32.84.165",7600,651,597712,111,10560,540,587152,346.047402,48.02703300000002,1759.009347922866,97803.58491019002
"220.171.166.170",7808,"147.32.84.165",7600,774,731799,112,10691,662,721108,3590.905759,30.187921999999617,2833.186066931042,191098.4134648312
"220.171.166.170",7808,"147.32.84.191",7600,950,933569,100,10069,850,923500,3595.41205,25.25376600000027,3189.7024784342716,292550.4259443887
"220.171.166.170",7808,"147.32.84.192",7600,343,307702,59,5670,284,302032,3596.219388,25.46256600000015,1781.4386813960434,94894.44229619221
"220.184.211.27",52188,"147.32.84.192",31037,9,2484,3,420,6,2064,1581.429189,1957.2577959999999,1.7166875037446525,8.43629287554515
"220.212.125.31",14933,"147.32.84.191",29676,3,828,1,140,2,688,2573.13153,0.25243000000000393,4436.873588717595,21804.06449312647
"220.220.18.148",63881,"147.32.84.192",31037,3,825,1,145,2,680,2953.25477,0.06387200000017401,18161.322645241104,85170.34068113069
"220.242.59.73",1065,"147.32.84.192",7600,6,749,2,249,4,500,715.691067,0.8809590000000753,2261.172199841116,4540.506425383767
"220.244.207.174",18169,"147.32.84.165",32234,3,825,1,145,2,680,3773.67443,0.11372100000016871,10200.402740024085,47836.37147045778
"221.1.148.131",26516,"147.32.84.165",7600,1,90,1,90,0,0,164.216906,0,0,0
"221.3.234.79",4720,"147.32.84.192",7600,642,613041,86,8321,556,604720,1653.527072,177.794177,374.4104622729011,27209.89000669015
"221.6.70.126",17722,"147.32.84.191",7600,3,269,1,89,2,180,951.687119,0.000275999999985288,0,0
"221.7.196.52",41724,"147.32.84.192",31037,3,828,1,140,2,688,1448.489849,0.27136700000005476,4127.25202401093,20282.495660853714
"221.7.196.52",42390,"147.32.84.192",31037,3,828,1,140,2,688,3421.136976,0.16459600000007413,6804.539599987214,33439.451748508596
"221.11.250.9",7600,"147.32.84.165",7600,834,793731,116,11135,718,782596,1884.136977,24.56243500000005,3626.676263977892,254891.9925894964
"221.12.22.160",20071,"147.32.84.165",7600,1272,1226715,164,15899,1108,1210816,3580.916132,87.97868800000015,1445.7137619510738,110100.8462413077
"221.12.22.160",20071,"147.32.84.191",7600,1699,1662854,197,19426,1502,1643428,3581.861871,85.95672100000002,1807.9796226754622,152953.99646526764
"221.12.22.160",20071,"147.32.84.192",7600,908,867127,124,12063,784,855064,3587.656686,81.36564799999996,1186.05335755453,84071.25326403107
"221.91.224.201",8098,"147.32.84.165",4041,1,140,1,140,0,0,999.674429,0,0,0
"221.99.6.175",54211,"147.32.84.165",32234,3,828,1,148,2,680,2502.756314,0.10834099999965474,10928.457370743976,50211.83116287773
"221.120.6.92",57278,"147.32.84.165",32234,9,1593,1,145,8,1448,216.382272,679.146105,1.7080271703833152,17.05671270837959
"221.120.6.92",50544,"147.32.84.165",32234,3,825,1,145,2,680,1153.941503,0.12130600000000413,9562.593771123938,44845.2673404433
"221.120.6.92",49888,"147.32.84.165",32234,3,825,1,145,2,680,2124.897103,0.05678600000010192,20427.57017571088,95798.26013436826
"221.123.176.37",10010,"147.32.84.165",7600,54,5454,36,3636,18,1818,40.619876,523.723535,55.54075395905208,27.77037697952604
"221.123.176.61",6666,"147.32.84.165",7600,3,192,1,64,2,128,154.518233,0.00015899999999646752,0,0
"221.123.176.61",6666,"147.32.84.191",7600,3,192,1,64,2,128,428.790847,0.00021500000002561137,0,0
"221.123.176.61",6666,"147.32.84.192",7600,3,192,1,64,2,128,641.95499,0.00020200000005843322,0,0
"221.131.37.30",27421,"147.32.84.192",7600,6,749,2,249,4,500,823.971825,0.4103340000000344,4854.5818772020675,9748.15637992383
"221.131.37.30",33003,"147.32.84.191",7600,6,749,2,249,4,500,2605.999075,0.4070560000000114,4893.675563067352,9826.657757163359
"221.131.59.194",45154,"147.32.84.165",7600,6,749,2,249,4,500,901.853985,0.41019200000005185,4856.262433201399,9751.530990364256
"221.131.60.183",13995,"147.32.84.191",7600,6,749,2,249,4,500,985.881797,0.4125209999999697,4828.845076978254,9696.476058189264
"221.136.74.35",30359,"147.32.84.165",7600,288,276525,34,3401,254,273124,1489.840921,2.2484329999999773,12100.872029542476,971784.34936688
"221.137.174.133",7600,"147.32.84.191",7600,6,749,2,249,4,500,588.490154,0.6426160000000891,3099.8294471344066,6224.557122759852
"221.157.210.11",29101,"147.32.84.165",32234,3,825,1,145,2,680,3685.173792,0.29823899999973946,3889.498020047725,18240.40450781002
"221.160.113.171",53703,"147.32.84.165",32234,3,825,1,145,2,680,830.41263,0.0398609999999735,29101.126414309,136474.24801193186
"221.175.209.140",16001,"147.32.84.165",32234,15,4155,5,715,10,3440,2862.629476,649.7454870000001,8.803447064188687,42.3550460151176
"221.176.205.214",46368,"147.32.84.191",7600,6,749,2,249,4,500,1671.391457,0.6250340000001415,3187.0266257508374,6399.651858937425
"221.180.47.35",14062,"147.32.84.165",7600,6,749,2,249,4,500,1943.161682,0.46123099999999795,4318.87709195611,8672.443959751226
"221.180.61.198",7600,"147.32.84.192",7600,6,749,2,249,4,500,1374.8536,0.4060220000001209,4906.138091037941,9851.682913730805
"221.181.34.206",6236,"147.32.84.165",32234,1,143,1,143,0,0,3181.359752,0,0,0
"221.182.46.4",13808,"147.32.84.165",7600,6,749,2,249,4,500,3291.69211,0.5634749999999258,3535.205643551644,7098.806513155911
"221.182.46.100",10910,"147.32.84.165",7600,2143,2124812,223,22420,1920,2102392,2739.194251,44.14758100000017,4062.736755610671,380975.2566057908
"221.182.46.100",7600,"147.32.84.192",7600,973,891344,171,16516,802,874828,2739.195374,43.008260000000064,3072.1540466877714,162727.4388687194
"221.188.34.1",34505,"147.32.84.191",29676,3,825,1,145,2,680,2373.904093,0.15285499999981766,7588.891433066526,35589.28396196715
"221.202.225.87",31716,"147.32.84.165",7600,1287,1104074,977,1069862,310,34212,165.034035,18.795536,455368.551341127,14561.755514713708
"221.207.13.60",19464,"147.32.84.191",7600,9,1089,3,409,6,680,1752.646747,1.0406129999998939,3144.300522865209,5227.687910876142
"221.213.170.154",7600,"147.32.84.191",7600,6,538,2,178,4,360,2714.745825,4.937348999999813,288.4138836448576,583.308978158139
"221.215.186.130",12510,"147.32.84.165",7600,12,1076,4,356,8,720,432.529195,13.156025999999997,216.47874517730511,437.822181257471
"221.218.123.94",42635,"147.32.84.191",29676,1,143,1,143,0,0,1970.437535,0,0,0
"221.223.106.61",11935,"147.32.84.165",32234,1,143,1,143,0,0,1597.959915,0,0,0
"221.236.79.231",22947,"147.32.84.192",7600,3,269,1,89,2,180,760.268982,0.0002479999999422944,0,0
"221.236.79.231",22959,"147.32.84.191",7600,3,269,1,89,2,180,760.271039,0.00020900000004075991,0,0
"221.237.0.147",20367,"147.32.84.191",29676,6,1212,2,334,4,878,2211.79022,27.223938999999973,98.14891224961981,258.0082184286413
"221.238.113.23",7600,"147.32.84.192",7600,7,909,3,409,4,500,1328.781834,0.8593380000002071,3807.5821155345293,4654.74586251165
"221.238.220.34",7600,"147.32.84.191",7600,202,190061,26,2581,176,187480,2147.855302,4.929986000000099,4188.247187720124,304228.0444609721
"221.238.220.34",7600,"147.32.84.165",7600,804,811609,66,7053,738,804556,2147.859907,5.629097999999885,10023.630784186233,1143424.3994331118
"222.35.126.161",7600,"147.32.84.165",7600,4511,4603538,345,37038,4166,4566500,3184.693697,56.76393599999983,5219.934008804479,643577.640563898
"222.36.9.140",7600,"147.32.84.191",7600,3,269,1,89,2,180,1655.712782,0.0002660000000105356,0,0
"222.38.244.30",60098,"147.32.84.192",7600,6,749,2,249,4,500,1067.033087,0.4364530000000286,4564.065317456563,9164.789794089484
"222.39.116.120",7600,"147.32.84.191",7600,6,749,2,249,4,500,3090.694981,0.7691890000000967,2589.7406229154985,5200.282375332326
"222.39.158.197",17003,"147.32.84.165",7600,119,109948,15,1524,104,108424,1098.327092,3.967924999999923,3072.638721750093,218600.9060151129
"222.52.143.16",7600,"147.32.84.165",7600,12,1076,4,356,8,720,770.931189,13.886291000000028,205.09436249031467,414.7975870590634
"222.52.143.16",7600,"147.32.84.192",7600,6,749,2,249,4,500,1370.442883,0.4228760000000875,4710.600743479384,9459.037637508802
"222.55.123.100",7600,"147.32.84.165",7600,3,269,1,89,2,180,1481.572602,0.00021500000002561137,0,0
"222.56.50.66",7600,"147.32.84.165",7600,1,89,1,89,0,0,92.07159,0,0,0
"222.58.199.76",16224,"147.32.84.192",7600,4,429,2,249,2,180,3766.078103,0.7172430000000531,2777.301416674478,2007.687771089984
"222.62.56.178",7600,"147.32.84.191",7600,6,749,2,249,4,500,3396.495355,0.4996569999998428,3986.7349001427515,8005.491767354923
"222.62.57.77",7600,"147.32.84.165",7600,6,749,2,249,4,500,3407.975352,0.47723099999984697,4174.079219498814,8381.685179716495
"222.62.91.3",7600,"147.32.84.191",7600,10,1178,4,498,6,680,648.195952,1012.572932,3.93453140420309,5.372452519795384
"222.66.128.146",12393,"147.32.84.192",7600,3,269,1,89,2,180,2737.761571,0.00018600000021251617,0,0
"222.66.128.146",12392,"147.32.84.191",7600,3,269,1,89,2,180,2737.766955,0.0003609999998843705,0,0
"222.66.128.146",12389,"147.32.84.165",7600,3,269,1,89,2,180,2737.774119,0.009140999999999622,77890.82157313527,157531.99868723986
"222.72.138.150",26710,"147.32.84.165",7600,6,749,2,249,4,500,1566.077832,1.3832600000000639,1440.0763413963448,2891.719561036837
"222.72.138.150",26710,"147.32.84.165",49153,1,92,1,92,0,0,1566.323827,0,0,0
"222.73.25.82",62073,"147.32.84.165",7600,1,90,1,90,0,0,163.431193,0,0,0
"222.82.135.93",19071,"147.32.84.165",32234,1,143,1,143,0,0,1566.740334,0,0,0
"222.105.229.79",58187,"147.32.84.191",29676,1,143,1,143,0,0,3675.759799,0,0,0
"222.110.201.209",59177,"147.32.84.165",32234,3,825,1,145,2,680,3320.14354,0.08240900000009788,14076.132461243582,66012.20740445265
"222.111.141.238",16018,"147.32.84.165",32234,1,143,1,143,0,0,2979.190687,0,0,0
"222.118.130.202",41045,"147.32.84.165",32234,3,825,1,145,2,680,1534.687604,0.25134400000001733,4615.188745304921,21643.643771085146
"222.127.241.97",10824,"147.32.84.192",31037,4,1007,2,327,2,680,1025.904163,40.002917000000025,65.39523105277543,135.99008292320275
"222.148.174.231",18896,"147.32.84.191",29676,6,1212,2,334,4,878,1978.706337,46.34379799999988,57.65604277836717,151.56289089642627
"222.149.59.229",42851,"147.32.84.165",32234,3,825,1,145,2,680,3405.499762,0.24318900000025678,4769.952588311046,22369.432827941462
"222.149.197.154",65535,"147.32.84.165",32234,1,143,1,143,0,0,3821.729068,0,0,0
"222.160.205.81",11935,"147.32.84.165",32234,1,143,1,143,0,0,1103.926081,0,0,0
"222.160.227.154",32243,"147.32.84.165",32234,3,831,1,143,2,688,1304.394955,0.20430899999996655,5599.361751074046,26939.58660656604
"222.160.227.154",33489,"147.32.84.165",32234,15,3692,5,762,10,2930,1353.30497,62.271122000000105,97.89449433719838,376.4184624776788
"222.160.227.154",35150,"147.32.84.165",32234,9,2493,3,429,6,2064,1460.518478,2.1075009999999565,1628.4689781879442,7834.871727225914
"222.160.227.154",53619,"147.32.84.165",32234,81,14701,27,3955,54,10746,2485.198708,212.00660199999993,149.2406354402115,405.4968061796492
"222.160.227.154",28767,"147.32.84.165",32234,68,9818,36,5242,32,4576,3682.392575,140.24930700000004,299.0103901190755,261.0208975934547
"222.162.99.87",5878,"147.32.84.192",31037,3,825,1,145,2,680,2928.90191,0.07359600000017963,15761.726180732223,73917.06070964078
"222.166.153.98",7600,"147.32.84.192",7600,1,89,1,89,0,0,3820.07123,0,0,0
"222.170.58.235",17275,"147.32.84.192",31037,3,831,1,143,2,688,1638.649455,0.10705099999995582,10686.49522190799,51414.74624246641
"222.173.21.99",17581,"147.32.84.165",7600,6,749,2,249,4,500,618.091867,0.34510899999997946,5772.089397842764,11590.540959523623
"222.179.22.10",11935,"147.32.84.165",32234,1,143,1,143,0,0,3217.418853,0,0,0
"222.180.41.174",7600,"147.32.84.165",7600,821,778414,117,11190,704,767224,3015.081172,32.474151999999776,2756.6539689781775,189005.45886463925
"222.180.41.174",7600,"147.32.84.191",7600,6,749,2,249,4,500,3026.668438,0.5803359999999884,3432.49427917627,6892.558793526647
"222.180.41.174",7600,"147.32.84.192",7600,6,749,2,249,4,500,3026.697739,0.5645559999998113,3528.4365058571084,7085.213867182949
"222.184.76.210",59604,"147.32.84.165",7600,29,2862,1,90,28,2772,163.05694,3.134555000000006,229.69767638468574,7074.688432648321
"222.185.238.58",12284,"147.32.84.191",7600,1,160,1,160,0,0,430.013788,0,0,0
"222.222.77.102",7600,"147.32.84.192",7600,3,269,1,89,2,180,1128.881496,0.0052339999999730935,136033.62629034393,275124.1880029428
"222.230.162.176",29891,"147.32.84.165",32234,3,825,1,145,2,680,292.942573,0.1692600000000084,6853.361692071029,32139.903107643448
"222.237.250.84",51746,"147.32.84.192",31037,3,825,1,145,2,680,2776.649809,0.1708440000002156,6789.819952696824,31841.914260923033
"222.254.164.164",13215,"147.32.84.192",31037,1,143,1,143,0,0,1658.397175,0,0,0
"222.254.187.129",43306,"147.32.84.192",31037,3,825,1,145,2,680,3581.280606,0.11685600000009799,9926.747449844486,46553.022523408625
"223.167.51.224",7600,"147.32.84.191",7600,3,269,1,89,2,180,1392.471852,0.00032300000020768493,0,0
"223.199.233.195",7600,"147.32.84.165",7600,6,749,2,249,4,500,2693.763451,0.5555790000003071,3585.448694063128,7199.6961728175265
"223.204.108.226",10058,"147.32.84.191",7600,6,749,2,249,4,500,2769.488398,0.5333060000002661,3735.19142855885,7500.384394696486
"223.204.173.238",10009,"147.32.84.165",32234,4,970,2,290,2,680,2821.100931,967.8599690000001,2.397040971120069,5.620647794350506
"223.205.34.65",10232,"147.32.84.165",32234,3,825,1,145,2,680,2217.146546,0.03049300000020594,38041.51772512268,178401.60036609255
"223.205.222.42",13265,"147.32.84.165",32234,3,825,1,145,2,680,3024.315777,0.06305900000006659,18395.47090817766,86268.41529352282
"223.206.44.120",26807,"147.32.84.192",7600,83,74416,11,1128,72,73288,1605.481802,0.8804869999999028,10248.873634705562,665886.038067643
"223.206.156.165",10287,"147.32.84.192",7600,134,124265,18,2665,116,121600,1323.844229,0.9650489999999081,22092.142471524276,1008031.7165243346
"223.206.215.93",13882,"147.32.84.165",32234,3,825,1,145,2,680,2696.776263,0.20861100000001898,5560.588847183967,26077.244248862742
"223.207.57.142",19740,"147.32.84.192",7600,6,749,2,249,4,500,1117.627573,0.33304900000007365,5981.101879902235,12010.244738759508
"223.207.142.156",16013,"147.32.84.165",32234,3,825,1,145,2,680,1337.186169,0.2462749999999687,4710.181707441468,22089.12800731171
"223.207.148.219",12744,"147.32.84.165",32234,3,825,1,145,2,680,2532.956821,0.05101799999965806,22737.07319000695,106629.0328910671
"223.207.153.74",14403,"147.32.84.192",7600,86,76699,12,1215,74,75484,1499.025356,3.238783999999896,3001.1263486544062,186450.22329368658
"223.207.154.87",50243,"147.32.84.191",29676,3,825,1,145,2,680,2646.703399,0.2001909999999043,5794.466284700883,27174.04878342483
"223.207.195.136",10007,"147.32.84.192",31037,3,825,1,145,2,680,3014.439566,0.12266399999998612,9456.727320160204,44348.79019109613
"223.214.178.94",7600,"147.32.84.192",7600,553,496378,103,9856,450,486522,2985.444625,67.03914399999985,1176.1486692013873,58058.259216436425
"223.242.118.210",7600,"147.32.84.191",7600,7,909,3,409,4,500,1545.528538,1.100003999999899,2974.534638056135,3636.3504132715584
