"Address A","Port A","Address B","Port B","Packets","Bytes","Packets A → B","Bytes A → B","Packets B → A","Bytes B → A","Rel Start","Duration","Bits/s A → B","Bits/s B → A"
"58.221.28.5",6000,"147.32.84.165",1433,3,180,1,60,2,120,49380.239235,0.0002590000003692694,0,0
"94.63.149.150",80,"147.32.84.165",1042,244,15250,122,7564,122,7686,47687.909492,5699.972257000001,10.6161920219325,10.787420925512057
"96.16.227.191",80,"147.32.84.165",43744,3,180,1,60,2,120,54711.980692,0.0002769999991869554,0,0
"147.32.84.165",17457,"184.173.217.40",443,9,552,6,372,3,180,47599.26811,1.3079350000043632,2275.3424290886564,1100.9721431074145
"147.32.84.165",17458,"184.173.217.40",443,9,552,6,372,3,180,47601.571458,1.3078969999987748,2275.408537524582,1101.0041310602815
"147.32.84.165",17459,"184.173.217.40",443,9,552,6,372,3,180,47603.874854,1.3078529999984312,2275.4850889232735,1101.0411720596485
"147.32.84.165",17460,"184.173.217.40",443,9,552,6,372,3,180,47606.178,1.3073569999978645,2276.3483883934236,1101.4588976097211
"147.32.84.165",17461,"184.173.217.40",443,9,552,6,372,3,180,47608.481047,1.3084410000010394,2274.4625091980733,1100.5463754184225
"147.32.84.165",17462,"184.173.217.40",443,9,552,6,372,3,180,47610.784746,1.3076990000045043,2275.7530593735632,1101.1708351807563
"147.32.84.165",17463,"184.173.217.40",443,9,552,6,372,3,180,47613.087962,1.3078480000040145,2275.4937882619884,1101.0453814170912
"147.32.84.165",17464,"184.173.217.40",443,9,552,6,372,3,180,47615.390831,1.3080360000021756,2275.166738526348,1100.8871315450072
"147.32.84.165",17465,"184.173.217.40",443,9,552,6,372,3,180,47617.694861,1.3076809999984107,2275.784384726563,1101.1859926096274
"147.32.84.165",17466,"184.173.217.40",443,9,552,6,372,3,180,47619.997604,1.208174000006693,2463.221357174971,1191.8813018588571
"147.32.84.165",17467,"173.192.170.88",80,21,3861,14,1286,7,2575,47620.965059,37.37982699999702,275.2286681262816,551.0993937987364
"147.32.84.165",17469,"184.173.217.40",443,9,552,6,372,3,180,47622.200737,1.3079389999984414,2275.3354705407105,1100.9687760680856
"147.32.84.165",17470,"184.173.217.40",443,9,552,6,372,3,180,47624.504385,1.307888000003004,2275.4241953387177,1101.0117074219602
"147.32.84.165",17471,"184.173.217.40",443,9,552,6,372,3,180,47626.807812,1.30775800000265,2275.6503879111956,1101.121155440901
"147.32.84.165",17472,"184.173.217.40",443,9,552,6,372,3,180,47629.111082,1.3075889999963692,2275.9445055046067,1101.2634704054549
"147.32.84.165",17473,"184.173.217.40",443,9,552,6,372,3,180,47631.414509,1.299072999994678,2290.864331729004,1108.4827411591953
"147.32.84.165",17475,"98.126.71.122",80,18,4863,14,1430,4,3433,47631.774105,15.992221000000427,715.3477931551655,1717.3349467843939
"147.32.84.165",17476,"195.113.232.88",80,17,5757,12,2556,5,3201,47632.355727,19.419277000000875,1052.9743203106418,1318.6896710932567
"147.32.84.165",17477,"195.113.232.99",80,52,40498,42,3628,10,36870,47632.750991,19.0241989999995,1525.635849372726,15504.463551921832
"147.32.84.165",17478,"184.173.217.40",443,9,552,6,372,3,180,47633.7143,1.3072709999978542,2276.4981400221413,1101.5313580752297
"147.32.84.165",17479,"184.173.217.40",443,9,552,6,372,3,180,47636.02246,1.3076189999992494,2275.8922897279012,1101.238204707049
"147.32.84.165",17480,"184.173.217.40",443,9,552,6,372,3,180,47638.330661,1.3066669999971054,2277.5504394054433,1102.0405351961822
"147.32.84.165",17481,"184.173.217.40",443,9,552,6,372,3,180,47640.636903,1.3076619999992545,2275.817451299875,1101.2019925644554
"147.32.84.165",17482,"184.173.217.40",443,9,552,6,372,3,180,47642.944624,1.3074869999982184,2276.1220570484106,1101.3493824427794
"147.32.84.165",17483,"184.173.217.40",443,9,552,6,372,3,180,47645.253002,1.3277070000040112,2241.458394051556,1084.5766422830109
"147.32.84.165",17484,"184.173.217.40",443,9,552,6,372,3,180,47647.581178,1.3864289999983157,2146.5217476002126,1038.6395552904255
"147.32.84.165",17485,"184.173.217.40",443,9,552,6,372,3,180,47649.9676,1.307394999996177,2276.2822253478885,1101.4268832328491
"147.32.84.165",17486,"184.173.217.40",443,9,552,6,372,3,180,47652.28524,1.3078329999989364,2275.5198867152153,1101.0580097009106
"147.32.84.165",17487,"184.173.217.40",443,9,552,6,372,3,180,47654.588727,1.3077889999985928,2275.596445606441,1101.0950543256974
"147.32.84.165",17488,"184.173.217.40",443,9,552,6,372,3,180,47656.891623,1.3078379999933532,2275.5111871769477,1101.0538002469102
"147.32.84.165",17489,"173.192.170.88",80,11,1283,8,846,3,437,47658.144696,0.5234049999999115,12930.713309962925,6679.340090370919
"147.32.84.165",17490,"184.173.217.40",443,9,552,6,372,3,180,47659.194846,1.3078539999987697,2275.4833490609803,1101.040330190797
"147.32.84.165",17491,"184.173.217.40",443,9,552,6,372,3,180,47661.498301,1.3076440000004368,2275.8487784129366,1101.2171508449692
"147.32.84.165",17492,"184.173.217.40",443,9,552,6,372,3,180,47663.801963,1.3073589999985415,2276.3449060306466,1101.4572125954742
"147.32.84.165",17493,"184.173.217.40",443,9,552,6,372,3,180,47666.105023,1.307635000004666,2275.8644422865564,1101.2247301386562
"147.32.84.165",17494,"184.173.217.40",443,9,552,6,372,3,180,47668.407953,1.3077999999950407,2275.577305407008,1101.0857929388749
"147.32.84.165",17495,"184.173.217.40",443,9,552,6,372,3,180,47670.711813,1.307608999995864,2275.9096947248095,1101.2466264797465
"147.32.84.165",17496,"184.173.217.40",443,9,552,6,372,3,180,47673.015154,1.3075669999961974,2275.982798593613,1101.28199931949
"147.32.84.165",17497,"184.173.217.40",443,9,552,6,372,3,180,47675.318058,1.3080620000037015,2275.1215156403737,1100.8652495034066
"147.32.84.165",17498,"184.173.217.40",443,9,552,6,372,3,180,47677.621268,1.3080789999949047,2275.0919478193537,1100.8509424932356
"147.32.84.165",17499,"184.173.217.40",443,9,552,6,372,3,180,47679.925249,1.3070040000020526,2276.9631921519185,1101.7563832993155
"147.32.84.165",17500,"184.173.217.40",443,9,552,6,372,3,180,47682.227977,1.3081939999974566,2274.891950280911,1100.7541694907634
"147.32.84.165",17501,"184.173.217.40",443,9,552,6,372,3,180,47684.531814,1.3077740000007907,2275.6225464019017,1101.1076837428557
"147.32.84.165",17502,"184.173.217.40",443,9,552,6,372,3,180,47686.835279,1.30705499999749,2276.874347296567,1101.7133938531776
"147.32.84.165",17503,"184.173.217.40",443,9,552,6,372,3,180,47689.137918,1.308353000000352,2274.615489855719,1100.6203983172834
"147.32.84.165",17504,"184.173.217.40",443,9,552,6,372,3,180,47691.441353,1.3081810000003316,2274.9145569300013,1100.765108191936
"147.32.84.165",17505,"184.173.217.40",443,9,552,6,372,3,180,47693.745178,1.3071080000008806,2276.782025661227,1101.6687220941421
"147.32.84.165",17506,"184.173.217.40",443,9,552,6,372,3,180,47696.047956,1.308149999997113,2274.9684669239523,1100.7911936728801
"147.32.84.165",17507,"94.100.176.20",25,6,372,6,372,0,0,47696.180614,8.94040700000187,332.87075185720045,0
"147.32.84.165",17508,"184.173.217.40",443,9,552,6,372,3,180,47698.351074,1.3076900000014575,2275.768721942267,1101.1784138430323
"147.32.84.165",17509,"184.173.217.40",443,9,552,6,372,3,180,47700.654604,1.308017999996082,2275.1980477401034,1100.9022811645661
"147.32.84.165",17510,"184.173.217.40",443,9,552,6,372,3,180,47702.957934,1.3078260000038426,2275.532066185606,1101.063902993035
"147.32.84.165",17511,"184.173.217.40",443,9,552,6,372,3,180,47705.261551,1.308179999999993,2274.9162959225914,1100.7659496399638
"147.32.84.165",17512,"184.173.217.40",443,9,552,6,372,3,180,47707.564453,1.3079670000006445,2275.2867618208516,1100.9452073326702
"147.32.84.165",17513,"184.173.217.40",443,9,552,6,372,3,180,47709.867893,1.3076030000011087,2275.920137838072,1101.251679599067
"147.32.84.165",17514,"184.173.217.40",443,9,552,6,372,3,180,47712.170934,1.3079429999997956,2275.3285120226687,1100.9654090432266
"147.32.84.165",17515,"184.173.217.40",443,9,552,6,372,3,180,47714.474214,1.3077839999969,2275.6051458092884,1101.0992641012685
"147.32.84.165",17516,"184.173.217.40",443,9,552,6,372,3,180,47716.777704,1.308004999998957,2275.220660473296,1100.9132228096591
"147.32.84.165",17517,"74.125.93.27",25,6,372,6,372,0,0,47717.138407,9.012759000004735,330.1985551814307,0
"147.32.84.165",17518,"184.173.217.40",443,9,552,6,372,3,180,47719.081022,1.3080780000018422,2275.0936870705027,1100.8517840663721
"147.32.84.165",17519,"184.173.217.40",443,9,552,6,372,3,180,47721.384628,1.307420999997703,2276.236958107013,1101.4049797291998
"147.32.84.165",17520,"184.173.217.40",443,9,552,6,372,3,180,47723.688166,1.3075469999967027,2276.0176116097587,1101.2988443273025
"147.32.84.165",17521,"184.173.217.40",443,9,552,6,372,3,180,47725.991564,1.3070949999964796,2276.8046699038823,1101.6796789857497
"147.32.84.165",17522,"184.173.217.40",443,9,552,6,372,3,180,47728.294278,1.308204000000842,2274.874560846844,1100.745755248473
"147.32.84.165",17523,"184.173.217.40",443,9,552,6,372,3,180,47730.597641,1.3085019999998622,2274.3564778657683,1100.495069935049
"147.32.84.165",17524,"184.173.217.40",443,9,552,6,372,3,180,47732.90132,1.3079500000021653,2275.3163347185086,1100.9595167992784
"147.32.84.165",17525,"184.173.217.40",443,9,552,6,372,3,180,47735.204695,1.3072979999997187,2276.451122850827,1101.5086078310453
"147.32.84.165",17526,"184.173.217.40",443,9,552,6,372,3,180,47737.507483,1.3083819999956177,2274.565073510617,1100.596003311589
"147.32.84.165",17527,"74.125.39.27",25,6,372,6,372,0,0,47738.0686,9.012390000003506,330.2120747103534,0
"147.32.84.165",17528,"184.173.217.40",443,9,552,6,372,3,180,47739.810929,1.3077350000021397,2275.690411279908,1101.1405215870523
"147.32.84.165",17529,"184.173.217.40",443,9,552,6,372,3,180,47742.114522,1.3076269999946817,2275.8783659347077,1101.2314673877618
"147.32.84.165",17530,"184.173.217.40",443,9,552,6,372,3,180,47744.417339,1.3077229999980773,2275.7112936029844,1101.150625936928
"147.32.84.165",17531,"184.173.217.40",443,9,552,6,372,3,180,47746.72058,1.3080499999996391,2275.1423875240403,1100.875348801955
"147.32.84.165",17532,"184.173.217.40",443,9,552,6,372,3,180,47749.024027,1.308271000001696,2274.758058533853,1100.6893831615416
"147.32.84.165",17533,"184.173.217.40",443,9,552,6,372,3,180,47751.327217,1.3083840000035707,2274.5615965892875,1100.5943209303005
"147.32.84.165",17534,"184.173.217.40",443,9,552,6,372,3,180,47753.630619,1.308310000000347,2274.69024925225,1100.6565722188304
"147.32.84.165",17535,"184.173.217.40",443,9,552,6,372,3,180,47755.933948,1.307955000003858,2275.30763672391,1100.9553080922146
"147.32.84.165",17536,"184.173.217.40",443,9,552,6,372,3,180,47758.237306,1.308017999996082,2275.1980477401034,1100.9022811645661
"147.32.84.165",17537,"66.111.4.71",25,6,372,6,372,0,0,47759.09847,9.013446000004478,330.17338762539003,0
"147.32.84.165",17538,"184.173.217.40",443,9,552,6,372,3,180,47760.54066,1.3079070000021602,2275.3911401919895,1100.995712996124
"147.32.84.165",17539,"184.173.217.40",443,9,552,6,372,3,180,47762.844429,1.3072400000019115,2276.5521250846427,1101.5574798796658
"147.32.84.165",17540,"184.173.217.40",443,9,552,6,372,3,180,47765.147739,1.3077849999972386,2275.603405763397,1101.098422143579
"147.32.84.165",17541,"184.173.217.40",443,9,552,6,372,3,180,47767.450602,1.3075260000041453,2276.0541664108896,1101.3165321343015
"147.32.84.165",17542,"184.173.217.40",443,9,552,6,372,3,180,47769.753706,1.3083799999949406,2274.568550429927,1100.5976856919
"147.32.84.165",17543,"184.173.217.40",443,9,552,6,372,3,180,47772.057123,1.3079740000030142,2275.274584963571,1100.9393153049537
"147.32.84.165",17544,"184.173.217.40",443,9,552,6,372,3,180,47774.36086,1.307263000002422,2276.51207139993,1101.5380990644821
"147.32.84.165",17545,"184.173.217.40",443,9,552,6,372,3,180,47776.664073,1.307355999997526,2276.350129578808,1101.459740118778
"147.32.84.165",17546,"184.173.217.40",443,9,552,6,372,3,180,47778.967556,1.30763499999739,2275.8644422992197,1101.2247301447837
"147.32.84.165",17547,"216.157.130.15",25,6,372,6,372,0,0,47780.129338,9.012067000003299,330.22390978661286,0
"147.32.84.165",17548,"184.173.217.40",443,9,552,6,372,3,180,47781.270259,1.3078420000019833,2275.50422757144,1101.050432695858
"147.32.84.165",17549,"184.173.217.40",443,9,552,6,372,3,180,47783.573575,1.3077139999950305,2275.7269555967964,1101.1582043210306
"147.32.84.165",17550,"184.173.217.40",443,9,552,6,372,3,180,47785.876944,1.3079979999965872,2275.2328367533933,1100.9191145580935
"147.32.84.165",17551,"184.173.217.40",443,9,552,6,372,3,180,47788.180564,1.3080279999994673,2275.1806536260783,1100.89386465778
"147.32.84.165",17552,"184.173.217.40",443,9,552,6,372,3,180,47790.484175,1.3076140000048326,2275.900992180415,1101.2424155711685
"147.32.84.165",17553,"184.173.217.40",443,9,552,6,372,3,180,47792.787248,1.3075059999973746,2276.08898162301,1101.3333782046823
"147.32.84.165",17554,"184.173.217.40",443,9,552,6,372,3,180,47795.090739,1.3072069999980158,2276.6095958823025,1101.5852883301463
"147.32.84.165",17555,"184.173.217.40",443,9,552,6,372,3,180,47797.393497,1.3077570000023115,2275.652128028938,1101.1219974333571
"147.32.84.165",17556,"184.173.217.40",443,9,552,6,372,3,180,47799.696837,1.308233999996446,2274.822394165023,1100.7205133056561
"147.32.84.165",17557,"184.173.217.40",443,9,552,6,372,3,180,47802.000053,1.2083819999970729,2462.797360443311,1191.6761421499891
"147.32.84.165",17558,"184.173.217.40",443,9,552,6,372,3,180,47804.203231,1.3081789999996545,2274.918034917841,1100.7667910892778
"147.32.84.165",17559,"184.173.217.40",443,9,552,6,372,3,180,47806.50703,1.3081010000023525,2275.0536846884515,1100.8324280750571
"147.32.84.165",17560,"184.173.217.40",443,9,552,6,372,3,180,47808.810211,1.3079559999969206,2275.3058971456276,1100.9544663607876
"147.32.84.165",17561,"184.173.217.40",443,9,552,6,372,3,180,47811.113396,1.307673999996041,2275.7965670411813,1101.191887277991
"147.32.84.165",17562,"184.173.217.40",443,9,552,6,372,3,180,47813.416616,1.3078889999960666,2275.4224555822016,1101.0108656042912
"147.32.84.165",17563,"184.173.217.40",443,9,552,6,372,3,180,47815.720351,1.3078999999997905,2275.4033182968706,1101.0016056275178
"147.32.84.165",17564,"184.173.217.40",443,9,552,6,372,3,180,47818.023532,1.307544000002963,2276.02283364327,1101.3013711177114
"147.32.84.165",17565,"184.173.217.40",443,9,552,6,372,3,180,47820.32682,1.30742299999838,2276.2334760851595,1101.4032948799158
"147.32.84.165",17566,"184.173.217.40",443,9,552,6,372,3,180,47822.630078,1.3078180000011344,2275.5459857544543,1101.0706382682843
"147.32.84.165",17567,"184.173.217.40",443,9,552,6,372,3,180,47824.93313,1.3081470000033733,2274.9736841443096,1100.7937181343432
"147.32.84.165",17568,"184.173.217.40",443,9,552,6,372,3,180,47827.236943,1.3071149999959744,2276.769832806727,1101.6628223258358
"147.32.84.165",17569,"184.173.217.40",443,9,552,6,372,3,180,47829.540128,1.307780000002822,2275.6121060068044,1101.1026319387763
"147.32.84.165",17570,"184.173.217.40",443,9,552,6,372,3,180,47831.843632,1.3076940000028117,2275.761760774005,1101.1750455358087
"147.32.84.165",17571,"184.173.217.40",443,9,552,6,372,3,180,47834.146756,1.3073159999985364,2276.4197791531133,1101.4934415257
"147.32.84.165",17572,"184.173.217.40",443,9,552,6,372,3,180,47836.449996,1.3073489999951562,2276.3623179510796,1101.4656377182644
"147.32.84.165",17573,"184.173.217.40",443,9,552,6,372,3,180,47838.753014,1.3082260000010137,2274.8363050403323,1100.7272443743543
"147.32.84.165",17574,"184.173.217.40",443,9,552,6,372,3,180,47841.05652,1.3081070000043837,2275.0432495124837,1100.8273787963633
"147.32.84.165",17575,"184.173.217.40",443,9,552,6,372,3,180,47843.359551,1.3081420000016806,2274.9823795858374,1100.7979256060505
"147.32.84.165",17576,"184.173.217.40",443,9,552,6,372,3,180,47845.663175,1.3075429999953485,2276.0245743433193,1101.3022133919287
"147.32.84.165",17577,"184.173.217.40",443,9,552,6,372,3,180,47847.966215,1.3081529999981285,2274.963249714871,1100.7886692168731
"147.32.84.165",17578,"184.173.217.40",443,9,552,6,372,3,180,47850.269943,1.3073640000002342,2276.336200170317,1101.4530000824116
"147.32.84.165",17579,"184.173.217.40",443,9,552,6,372,3,180,47852.573149,1.3076969999965513,2275.756539938417,1101.1725193250406
"147.32.84.165",17580,"184.173.217.40",443,9,552,6,372,3,180,47854.876539,1.3077600000033271,2275.6469076836947,1101.1194714598523
"147.32.84.165",17581,"184.173.217.40",443,9,552,6,372,3,180,47857.179726,1.3077809999958845,2275.610365962929,1101.1017899820624
"147.32.84.165",17582,"184.173.217.40",443,9,552,6,372,3,180,47859.482685,1.3081509999974514,2274.9667278515994,1100.790352186258
"147.32.84.165",17583,"184.173.217.40",443,9,552,6,372,3,180,47861.786226,1.3077880000055302,2275.598185629028,1101.0958962721104
"147.32.84.165",17584,"184.173.217.40",443,9,552,6,372,3,180,47864.08938,1.3082800000047428,2274.7424098734305,1100.6818112290791
"147.32.84.165",17585,"184.173.217.40",443,9,552,6,372,3,180,47866.393558,1.3070759999973234,2276.8377661330283,1101.695693290175
"147.32.84.165",17586,"184.173.217.40",443,9,552,6,372,3,180,47868.69628,1.307979000004707,2275.265887288168,1100.9351067523394
"147.32.84.165",17587,"184.173.217.40",443,9,552,6,372,3,180,47870.999382,1.2112679999991087,2456.9294326294344,1188.8368222400488
"147.32.84.165",17588,"184.173.217.40",443,9,552,6,372,3,180,47873.202649,1.3075190000017756,2276.0663516139794,1101.3224282003125
"147.32.84.165",17589,"184.173.217.40",443,9,552,6,372,3,180,47875.505952,1.3078430000023218,2275.50248767988,1101.049590812845
"147.32.84.165",17590,"184.173.217.40",443,9,552,6,372,3,180,47877.809195,1.3084810000000289,2274.392979340116,1100.512731938766
"147.32.84.165",17591,"184.173.217.40",443,9,552,6,372,3,180,47880.112739,1.3079260000013164,2275.358086005634,1100.979719034984
"147.32.84.165",17592,"184.173.217.40",443,9,552,6,372,3,180,47882.416383,1.3069929999983287,2276.982355685,1101.765655976613
"147.32.84.165",17593,"184.173.217.40",443,9,552,6,372,3,180,47884.719653,1.3074239999987185,2276.2317350782278,1101.4024524572071
"147.32.84.165",17594,"184.173.217.40",443,9,552,6,372,3,180,47887.022391,1.307782000003499,2275.6086258963937,1101.1009480143841
"147.32.84.165",17595,"184.173.217.40",443,9,552,6,372,3,180,47889.326038,1.308098000001337,2275.0589023123334,1100.8349527317741
"147.32.84.165",17596,"184.173.217.40",443,9,552,6,372,3,180,47891.629421,1.3073780000049737,2276.3118241156562,1101.441205217253
"147.32.84.165",17597,"184.173.217.40",443,9,552,6,372,3,180,47893.932447,1.3077290000001085,2275.700852393541,1101.1455737388103
"147.32.84.165",17598,"184.173.217.40",443,9,552,6,372,3,180,47896.236039,1.3078199999945355,2275.5425058589367,1101.0689544478726
"147.32.84.165",17599,"184.173.217.40",443,9,552,6,372,3,180,47898.539507,1.3071409999975003,2276.7245461703756,1101.6409094372787
"147.32.84.165",17600,"184.173.217.40",443,9,552,6,372,3,180,47900.842722,1.3075429999953485,2276.0245743433193,1101.3022133919287
"147.32.84.165",17601,"184.173.217.40",443,9,552,6,372,3,180,47903.145973,1.3073520000034478,2276.357094334312,1101.463110161764
"147.32.84.165",17602,"184.173.217.40",443,9,552,6,372,3,180,47905.449132,1.3075299999982235,2276.047203508939,1101.3131629881964
"147.32.84.165",17603,"184.173.217.40",443,9,552,6,372,3,180,47907.752764,1.3073810000059893,2276.3066007432926,1101.4386777790126
"147.32.84.165",17604,"184.173.217.40",443,9,552,6,372,3,180,47910.056119,1.3070050000023912,2276.9614500285425,1101.7555403363915
"147.32.84.165",17605,"184.173.217.40",443,9,552,6,372,3,180,47912.359175,1.3079250000009779,2275.3598256763767,1100.98056081115
"147.32.84.165",17606,"184.173.217.40",443,9,552,6,372,3,180,47914.662307,1.3079090000028373,2275.387660757395,1100.9940293987397
"147.32.84.165",17607,"184.173.217.40",443,9,552,6,372,3,180,47916.965807,1.3075220000027912,2276.0611293681077,1101.319901307149
"147.32.84.165",17608,"184.173.217.40",443,9,552,6,372,3,180,47919.268638,1.3080629999967641,2275.119776346676,1100.8644079096819
"147.32.84.165",17609,"173.192.170.88",80,18,1800,12,1166,6,634,47920.975596,601.1453120000006,15.51704689996816,8.437227902727113
"147.32.84.165",17610,"94.100.176.20",25,6,372,6,372,0,0,47921.332359,9.012417999998434,330.21104879961376,0
"147.32.84.165",17611,"184.173.217.40",443,9,552,6,372,3,180,47921.572473,1.3077629999970668,2275.641687375063,1101.1169455040629
"147.32.84.165",17612,"184.173.217.40",443,9,552,6,372,3,180,47923.876031,1.3070349999979953,2276.909187592195,1101.7302520607395
"147.32.84.165",17613,"184.173.217.40",443,9,552,6,372,3,180,47926.178754,1.3076470000014524,2275.8435571654236,1101.2146244348824
"147.32.84.165",17614,"184.173.217.40",443,9,552,6,372,3,180,47928.482582,1.3073280000025989,2276.3988838256996,1101.483330883403
"147.32.84.165",17615,"184.173.217.40",443,9,552,6,372,3,180,47930.785431,1.3077350000021397,2275.690411279908,1101.1405215870523
"147.32.84.165",17616,"184.173.217.40",443,9,552,6,372,3,180,47933.088603,1.3077720000001136,2275.62602655489,1101.10936768785
"147.32.84.165",17617,"184.173.217.40",443,9,552,6,372,3,180,47935.391964,1.3080859999972745,2275.0797730471854,1100.8450514744445
"147.32.84.165",17618,"184.173.217.40",443,9,552,6,372,3,180,47937.695708,1.307308000003104,2276.433709571833,1101.500182050887
"147.32.84.165",17619,"184.173.217.40",443,9,552,6,372,3,180,47939.99856,1.308102000002691,2275.051945485809,1100.8315865253915
"147.32.84.165",17620,"74.125.93.27",25,6,372,6,372,0,0,47942.261979,9.0129769999985,330.1905685547068,0
"147.32.84.165",17621,"184.173.217.40",443,9,552,6,372,3,180,47942.302084,1.307944000000134,2275.3267723998083,1100.9645672902298
"147.32.84.165",17622,"184.173.217.40",443,9,552,6,372,3,180,47944.605148,1.3079759999964153,2275.2711058980867,1100.9376318861712
"147.32.84.165",17623,"184.173.217.40",443,9,552,6,372,3,180,47946.908521,1.3082280000016908,2274.832827302392,1100.7255615979316
"147.32.84.165",17624,"184.173.217.40",443,9,552,6,372,3,180,47949.212424,1.307316999998875,2276.4180378611777,1101.492598965086
"147.32.84.165",17625,"184.173.217.40",443,9,552,6,372,3,180,47951.515527,1.307831999998598,2275.5216266333828,1101.0588515967981
"147.32.84.165",17626,"184.173.217.40",443,9,552,6,372,3,180,47953.818807,1.307675999996718,2275.7930863665533,1101.1902030805904
"147.32.84.165",17627,"184.173.217.40",443,9,552,6,372,3,180,47956.122301,1.3072729999985313,2276.4946572011686,1101.5296728392752
"147.32.84.165",17628,"184.173.217.40",443,9,552,6,372,3,180,47958.42528,1.3082069999945816,2274.869344081117,1100.7432310069923
"147.32.84.165",17629,"184.173.217.40",443,9,552,6,372,3,180,47960.728902,1.3071989999953075,2276.623528636943,1101.5920299856175
"147.32.84.165",17630,"184.173.217.40",443,9,552,6,372,3,180,47963.032061,1.3073409999997239,2276.376247666545,1101.472377903167
"147.32.84.165",17631,"74.125.39.27",25,6,372,6,372,0,0,47963.29231,9.012790000000678,330.1974194450083,0
"147.32.84.165",17632,"184.173.217.40",443,9,552,6,372,3,180,47965.335457,1.307848999997077,2275.4920483990513,1101.0445395479283
"147.32.84.165",17633,"184.173.217.40",443,9,552,6,372,3,180,47967.63858,1.307451000000583,2276.1847289104317,1101.3797075373056
"147.32.84.165",17634,"184.173.217.40",443,9,552,6,372,3,180,47969.941663,1.3091540000023087,2273.2237765723144,1099.9469886640231
"147.32.84.165",17635,"184.173.217.40",443,9,552,6,372,3,180,47972.245353,1.307278000000224,2276.48595019536,1101.5254597719486
"147.32.84.165",17636,"184.173.217.40",443,9,552,6,372,3,180,47974.548755,1.3073779999976978,2276.3118241283246,1101.441205223383
"147.32.84.165",17637,"184.173.217.40",443,9,552,6,372,3,180,47976.852197,1.3072949999987031,2276.4563468864735,1101.511135590229
"147.32.84.165",17638,"184.173.217.40",443,9,552,6,372,3,180,47979.154914,1.3076280000022962,2275.876625458291,1101.2306252217538
"147.32.84.165",17639,"184.173.217.40",443,9,552,6,372,3,180,47981.45812,1.3083950000000186,2274.542473794196,1100.5850679649338
"147.32.84.165",17640,"184.173.217.40",443,9,552,6,372,3,180,47983.761634,1.3079619999989518,2275.29545965585,1100.949415962508
"147.32.84.165",17641,"66.111.4.71",25,6,372,6,372,0,0,47984.322353,9.013357999996515,330.1766112031887,0
"147.32.84.165",17642,"184.173.217.40",443,9,552,6,372,3,180,47986.06488,1.3075650000027963,2275.9862798359054,1101.2836837915672
"147.32.84.165",17643,"184.173.217.40",443,9,552,6,372,3,180,47988.36807,1.3077290000001085,2275.700852393541,1101.1455737388103
"147.32.84.165",17644,"184.173.217.40",443,9,552,6,372,3,180,47990.671784,1.3079990000042017,2275.2310972641726,1100.9182728697608
"147.32.84.165",17645,"184.173.217.40",443,9,552,6,372,3,180,47992.974676,1.3081210000018473,2275.0189011534844,1100.8155973323312
"147.32.84.165",17646,"184.173.217.40",443,9,552,6,372,3,180,47995.278485,1.3072739999988698,2276.4929157946785,1101.5288302232316
"147.32.84.165",17647,"184.173.217.40",443,9,552,6,372,3,180,47997.581401,1.3077080000002752,2275.7373970331096,1101.163256628924
"147.32.84.165",17648,"184.173.217.40",443,9,552,6,372,3,180,47999.885075,1.3074469999992289,2276.1916926665135,1101.3830770967002
"147.32.84.165",17649,"184.173.217.40",443,9,552,6,372,3,180,48002.188039,1.3083090000000084,2274.691987901926,1100.6574135009319
"147.32.84.165",17650,"184.173.217.40",443,9,552,6,372,3,180,48004.491728,1.3073680000015884,2276.3292355299996,1101.449630095161
"147.32.84.165",17651,"216.157.130.15",25,6,372,6,372,0,0,48005.352375,8.912928999998257,333.89697146702076,0
"147.32.84.165",17652,"184.173.217.40",443,9,552,6,372,3,180,48006.795073,1.3076149999978952,2275.899251694719,1101.2415734006706
"147.32.84.165",17653,"184.173.217.40",443,9,552,6,372,3,180,48009.09815,1.3077310000007856,2275.6973720116844,1101.1438896830732
"147.32.84.165",17654,"184.173.217.40",443,9,552,6,372,3,180,48011.401275,1.3081120000060764,2275.034553605636,1100.8231710995015
"147.32.84.165",17655,"184.173.217.40",443,9,552,6,372,3,180,48013.704425,1.3081579999998212,2274.9545544195785,1100.784461815925
"147.32.84.165",17656,"184.173.217.40",443,9,552,6,372,3,180,48016.007803,1.407813999998325,2113.9156166961975,1022.8623951755795
"147.32.84.165",17657,"184.173.217.40",443,9,552,6,372,3,180,48018.411517,1.3075969999990775,2275.9305810598366,1101.256732770889
"147.32.84.165",17658,"184.173.217.40",443,9,552,6,372,3,180,48020.714699,1.3077340000018012,2275.6921514588603,1101.1413636091258
"147.32.84.165",17659,"184.173.217.40",443,9,552,6,372,3,180,48023.018022,1.3082910000011907,2274.7232840379484,1100.6725567925557
"147.32.84.165",17660,"184.173.217.40",443,9,552,6,372,3,180,48025.321345,1.307663000006869,2275.815710916626,1101.2011504435286
"147.32.84.165",17661,"184.173.217.40",443,9,552,6,372,3,180,48027.62478,1.3076829999990878,2275.780904089199,1101.1843084302575
"147.32.84.165",17662,"184.173.217.40",443,9,552,6,372,3,180,48029.92848,1.3073309999963385,2276.3936600664524,1101.4808032579608
"147.32.84.165",17663,"184.173.217.40",443,9,552,6,372,3,180,48032.231122,1.3080430000045453,2275.154562953709,1100.8812401388916
"147.32.84.165",17664,"184.173.217.40",443,9,552,6,372,3,180,48034.534601,1.3078660000028322,2275.462470920993,1101.0302278649967
"147.32.84.165",17665,"184.173.217.40",443,9,552,6,372,3,180,48036.837849,1.3076309999960358,2275.8714040956675,1101.2280987559682
"147.32.84.165",17666,"184.173.217.40",443,9,552,6,372,3,180,48039.141606,1.307745000005525,2275.6730096367614,1101.1321014371426
"147.32.84.165",17667,"184.173.217.40",443,9,552,6,372,3,180,48041.444657,1.3074280000000726,2276.2247710771335,1101.3990827792582
"147.32.84.165",17668,"184.173.217.40",443,9,552,6,372,3,180,48043.747713,1.3077160000029835,2275.723475122435,1101.1565202205331
"147.32.84.165",17669,"184.173.217.40",443,9,552,6,372,3,180,48046.05132,1.3076490000021295,2275.8400763470577,1101.212940167931
"147.32.84.165",17670,"184.173.217.40",443,9,552,6,372,3,180,48048.354779,1.3078669999958947,2275.4607311059467,1101.0293860190066
"147.32.84.165",17671,"184.173.217.40",443,9,552,6,372,3,180,48050.658218,1.3070700000025681,2276.8482177650417,1101.7007505314716
"147.32.84.165",17672,"184.173.217.40",443,9,552,6,372,3,180,48052.960991,1.3079690000013215,2275.2832827054717,1100.9435238897443
"147.32.84.165",17673,"184.173.217.40",443,9,552,6,372,3,180,48055.264998,1.3073750000039581,2276.317047511992,1101.4437326670927
"147.32.84.165",17674,"184.173.217.40",443,9,552,6,372,3,180,48057.568134,1.3073519999961718,2276.357094346981,1101.463110167894
"147.32.84.165",17675,"184.173.217.40",443,9,552,6,372,3,180,48059.871639,1.3074540000015986,2276.179506121333,1101.3771803812901
"147.32.84.165",17676,"184.173.217.40",443,9,552,6,372,3,180,48062.174202,1.3085949999949662,2274.1948425688984,1100.4168593075315
"147.32.84.165",17677,"184.173.217.40",443,9,552,6,372,3,180,48064.47772,1.3077159999957075,2275.723475135097,1101.1565202266597
"147.32.84.165",17678,"184.173.217.40",443,9,552,6,372,3,180,48066.781031,1.307831999998598,2275.5216266333828,1101.0588515967981
"147.32.84.165",17679,"184.173.217.40",443,9,552,6,372,3,180,48069.084098,1.3077370000028168,2275.686930929988,1101.1388375467684
"147.32.84.165",17680,"184.173.217.40",443,9,552,6,372,3,180,48071.387495,1.3082379999978002,2274.815438784842,1100.7171477991171
"147.32.84.165",17681,"184.173.217.40",443,9,552,6,372,3,180,48073.69134,1.3074350000024424,2276.212584177753,1101.3931858924611
"147.32.84.165",17682,"184.173.217.40",443,9,552,6,372,3,180,48075.994305,1.3078089999980875,2275.5616454729643,1101.0782155514344
"147.32.84.165",17683,"184.173.217.40",443,9,552,6,372,3,180,48078.297419,1.3076979999968898,2275.7547996609906,1101.171677255318
"147.32.84.165",17684,"184.173.217.40",443,9,552,6,372,3,180,48080.601147,1.3072899999970105,2276.465053665832,1101.5153485479832
"147.32.84.165",17685,"184.173.217.40",443,9,552,6,372,3,180,48082.904631,1.3075470000039786,2276.0176115970935,1101.298844321174
"147.32.84.165",17686,"184.173.217.40",443,9,552,6,372,3,180,48085.207284,1.3077310000007856,2275.6973720116844,1101.1438896830732
"147.32.84.165",17687,"184.173.217.40",443,9,552,6,372,3,180,48087.511192,1.3073740000036196,2276.3187886494306,1101.4445751529504
"147.32.84.165",17688,"184.173.217.40",443,9,552,6,372,3,180,48089.814614,1.317520999997214,2258.7875259721045,1092.9617061155345
"147.32.84.165",17689,"184.173.217.40",443,9,552,6,372,3,180,48092.127203,1.298374000005424,2292.0976544412993,1109.0795102135319
"147.32.84.165",17690,"184.173.217.40",443,9,552,6,372,3,180,48094.420998,1.307756000001973,2275.653868149341,1101.1228394271006
"147.32.84.165",17691,"184.173.217.40",443,9,552,6,372,3,180,48096.724348,1.3077529999936814,2275.6590885391806,1101.1253654221841
"147.32.84.165",17692,"184.173.217.40",443,9,552,6,372,3,180,48099.027125,1.3078939999977592,2275.4137567762364,1101.0066565046304
"147.32.84.165",17693,"184.173.217.40",443,9,552,6,372,3,180,48101.330601,1.3078539999987697,2275.4833490609803,1101.040330190797
"147.32.84.165",17694,"184.173.217.40",443,9,552,6,372,3,180,48103.63392,1.3084430000017164,2274.4590326029456,1100.5446931949737
"147.32.84.165",17695,"184.173.217.40",443,9,552,6,372,3,180,48105.93774,1.3073030000014114,2276.44241617803,1101.5043949248532
"147.32.84.165",17696,"184.173.217.40",443,9,552,6,372,3,180,48108.240571,1.3085549999959767,2274.264360312826,1100.450496925561
"147.32.84.165",17697,"184.173.217.40",443,9,552,6,372,3,180,48110.544097,1.3077610000036657,2275.645167573936,1101.1186294712593
"147.32.84.165",17698,"184.173.217.40",443,9,552,6,372,3,180,48112.847384,1.3077659999980824,2275.6364670777216,1101.1144195537363
"147.32.84.165",17699,"184.173.217.40",443,9,552,6,372,3,180,48115.150595,1.3081349999993108,2274.99455331565,1100.8038161204759
"147.32.84.165",17700,"184.173.217.40",443,9,552,6,372,3,180,48117.453638,1.307699999997567,2275.751319114122,1101.1699931197363
"147.32.84.165",17701,"184.173.217.40",443,9,552,6,372,3,180,48119.757348,1.3081380000003264,2274.9893359869197,1100.801291606574
"147.32.84.165",17702,"184.173.217.40",443,9,552,6,372,3,180,48122.060649,1.307941999999457,2275.330251648189,1100.9662507975108
"147.32.84.165",17703,"184.173.217.40",443,9,552,6,372,3,180,48124.364251,1.3077909999992698,2275.59296554393,1101.0933704244821
"147.32.84.165",17704,"184.173.217.40",443,9,552,6,372,3,180,48126.667266,1.3079770000040298,2275.2693663503496,1100.9367901695239
"147.32.84.165",17705,"184.173.217.40",443,9,552,6,372,3,180,48128.970604,1.3073139999978594,2276.423261744977,1101.4951266507953
"147.32.84.165",17706,"184.173.217.40",443,9,552,6,372,3,180,48131.273558,1.3077780000021448,2275.615586127859,1101.104315868319
"147.32.84.165",17707,"184.173.217.40",443,9,552,6,372,3,180,48133.576839,1.3076769999970566,2275.791346033232,1101.1893609838219
"147.32.84.165",17708,"184.173.217.40",443,9,552,6,372,3,180,48135.880723,1.307158999996318,2276.6931949429127,1101.625739488506
"147.32.84.165",17709,"184.173.217.40",443,9,552,6,372,3,180,48138.183506,1.3077239999984158,2275.7095533947568,1101.1497839006888
"147.32.84.165",17710,"184.173.217.40",443,9,552,6,372,3,180,48140.48697,1.3077960000009625,2275.5842654342187,1101.089160693977
"147.32.84.165",17711,"184.173.217.40",443,9,552,6,372,3,180,48142.790675,1.3075490000046557,2276.014130246288,1101.297159796591
"147.32.84.165",17712,"184.173.217.40",443,9,552,6,372,3,180,48145.093941,1.3074219999980414,2276.2352170947547,1101.4041373039136
"147.32.84.165",17713,"94.100.176.20",25,6,372,6,372,0,0,48146.486902,8.881415000003472,335.0817409161532,0
"147.32.84.165",17714,"184.173.217.40",443,9,552,6,372,3,180,48147.397124,1.3074539999943227,2276.179506134,1101.3771803874192
"147.32.84.165",17715,"184.173.217.40",443,9,552,6,372,3,180,48149.700586,1.2075990000012098,2464.394223576716,1192.4488178597012
"147.32.84.165",17716,"184.173.217.40",443,9,552,6,372,3,180,48151.903329,1.3083079999996698,2274.69372655426,1100.6582547843195
"147.32.84.165",17717,"184.173.217.40",443,9,552,6,372,3,180,48154.206768,1.307767000005697,2275.634726971269,1101.1135775667433
"147.32.84.165",17718,"184.173.217.40",443,9,552,6,372,3,180,48156.509797,1.3077919999996084,2275.5912255166654,1101.092528475806
"147.32.84.165",17719,"184.173.217.40",443,9,552,6,372,3,180,48158.813599,1.3078049999967334,2275.568605417041,1101.0815832663102
"147.32.84.165",17720,"184.173.217.40",443,9,552,6,372,3,180,48161.116901,1.30787699999928,2275.4433329752246,1101.0209675686572
"147.32.84.165",17721,"184.173.217.40",443,9,552,6,372,3,180,48163.419816,1.3080379999955767,2275.1632597906664,1100.8854482858064
"147.32.84.165",17722,"184.173.217.40",443,9,552,6,372,3,180,48165.723769,1.3398190000007162,2221.1955495469233,1074.77204010335
"147.32.84.165",17723,"74.125.93.27",25,6,372,6,372,0,0,48167.385426,9.013065999999526,330.1873080703233,0
"147.32.84.165",17724,"184.173.217.40",443,9,552,6,372,3,180,48168.056868,1.3780160000023898,2159.626593591685,1044.980609802428
"147.32.84.165",17725,"184.173.217.40",443,9,552,6,372,3,180,48170.429787,1.3078279999972438,2275.5285863326612,1101.0622191932232
"147.32.84.165",17726,"184.173.217.40",443,9,552,6,372,3,180,48172.73345,1.3077130000019679,2275.728695818977,1101.1590463640212
"147.32.84.165",17727,"184.173.217.40",443,9,552,6,372,3,180,48175.036854,1.3076250000012806,2275.881846857536,1101.2331517052594
"147.32.84.165",17728,"184.173.217.40",443,9,552,6,372,3,180,48177.340292,1.3073159999985364,2276.4197791531133,1101.4934415257
"147.32.84.165",17729,"184.173.217.40",443,9,552,6,372,3,180,48179.643471,1.3157689999934519,2261.7951935444676,1094.4170291344199
"147.32.84.165",17730,"184.173.217.40",443,9,552,6,372,3,180,48181.956343,1.2979190000041854,2292.901174873319,1109.4683104225737
"147.32.84.165",17731,"184.173.217.40",443,9,552,6,372,3,180,48184.249624,1.308563000005961,2274.250456406335,1100.4437692288718
"147.32.84.165",17732,"184.173.217.40",443,9,552,6,372,3,180,48186.553058,1.3080860000045504,2275.0797730345307,1100.8450514683213
"147.32.84.165",17733,"74.125.39.27",25,6,372,6,372,0,0,48188.415866,9.013287999994645,330.1791754575875,0
"147.32.84.165",17734,"184.173.217.40",443,9,552,6,372,3,180,48188.85652,1.3080659999977797,2275.1145584435735,1100.861883117858
"147.32.84.165",17735,"184.173.217.40",443,9,552,6,372,3,180,48191.159799,1.308233999996446,2274.822394165023,1100.7205133056561
"147.32.84.165",17736,"184.173.217.40",443,9,552,6,372,3,180,48193.463613,1.3073950000034529,2276.28222533522,1101.4268832267194
"147.32.84.165",17737,"184.173.217.40",443,9,552,6,372,3,180,48195.766871,1.307318999999552,2276.4145552852974,1101.4909138477246
"147.32.84.165",17738,"184.173.217.40",443,9,552,6,372,3,180,48198.069538,1.3084019999951124,2274.530304914787,1100.5791797974775
"147.32.84.165",17739,"184.173.217.40",443,9,552,6,372,3,180,48200.373163,1.3073940000031143,2276.2839664193893,1101.4277256868013
"147.32.84.165",17740,"184.173.217.40",443,9,552,6,372,3,180,48202.676728,1.3071490000002086,2276.7106121792735,1101.6341671835194
"147.32.84.165",17741,"184.173.217.40",443,9,552,6,372,3,180,48204.979548,1.3076599999985774,2275.8209320490323,1101.203676797919
"147.32.84.165",17742,"184.173.217.40",443,9,552,6,372,3,180,48207.282783,1.3083520000000135,2274.617228391113,1100.6212395440868
"147.32.84.165",17743,"66.111.4.71",25,6,372,6,372,0,0,48209.446524,9.012885000003735,330.1939390105129,0
"147.32.84.165",17744,"184.173.217.40",443,9,552,6,372,3,180,48209.586602,1.3074909999995725,2276.1150937184066,1101.3460130895514
"147.32.84.165",17745,"184.173.217.40",443,9,552,6,372,3,180,48211.889833,1.3079260000013164,2275.358086005634,1100.979719034984
"147.32.84.165",17746,"184.173.217.40",443,9,552,6,372,3,180,48214.192812,1.307809999998426,2275.5599054935974,1101.0773736259341
"147.32.84.165",17747,"184.173.217.40",443,9,552,6,372,3,180,48216.496748,1.3071320000017295,2276.7402221015645,1101.6484945652733
"147.32.84.165",17748,"184.173.217.40",443,9,552,6,372,3,180,48218.799527,1.2077269999936107,2464.133036700963,1192.3224371133692
"147.32.84.165",17749,"173.192.170.88",80,21,3861,14,1286,7,2575,48220.996042,33.32519200000388,308.71540064941865,618.150977194598
"147.32.84.165",17750,"184.173.217.40",443,9,552,6,372,3,180,48221.002467,1.3079580000048736,2275.302417959071,1100.9527828834216
"147.32.84.165",17752,"184.173.217.40",443,9,552,6,372,3,180,48223.305969,1.3076319999963744,2275.8696636425625,1101.22725660124
"147.32.84.165",17753,"184.173.217.40",443,9,552,6,372,3,180,48225.609788,1.3074149999956717,2276.2474042364915,1101.4100343079797
"147.32.84.165",17754,"184.173.217.40",443,9,552,6,372,3,180,48227.913001,1.3075339999995776,2276.0402406369253,1101.3097938565768
"147.32.84.165",17755,"184.173.217.40",443,9,552,6,372,3,180,48230.216077,1.307689000001119,2275.7704622409865,1101.179255923058
"147.32.84.165",17756,"216.157.130.15",25,6,372,6,372,0,0,48230.376624,9.016707000002498,330.0539764682578,0
"147.32.84.165",17758,"98.126.71.122",80,18,4863,14,1430,4,3433,48231.79645,16.7073739999978,684.7275939355585,1643.82505593061
"147.32.84.165",17759,"195.113.232.88",80,17,5748,12,2556,5,3192,48232.404137,22.311116000004404,916.4938230788619,1144.5415818731326
"147.32.84.165",17760,"184.173.217.40",443,9,552,6,372,3,180,48232.510549,1.3102030000009108,2271.4037443036927,1099.0663278888835
"147.32.84.165",17761,"195.113.232.99",80,51,38512,42,3596,9,34916,48232.667235,22.048204999999143,1304.7774183885317,12668.967836611228
"147.32.84.165",17762,"64.236.79.229",80,14,2274,10,1560,4,714,48232.750205,0.361774000004516,34496.67471914569,15788.862659916682
"147.32.84.165",17763,"74.125.232.217",80,13,1871,10,1156,3,715,48232.75145,21.964204999996582,421.04870174001013,260.42372123192666
"147.32.84.165",17764,"68.67.185.209",80,16,2170,12,1370,4,800,48232.782752,15.720826000004308,697.1643856370522,407.10329088295015
"147.32.84.165",17765,"64.236.79.229",80,14,2078,10,1378,4,700,48232.82483,0.3560280000019702,30963.856775138458,15729.099958343193
"147.32.84.165",17766,"77.238.175.247",80,14,2274,10,1276,4,998,48232.874388,0.13898100000369595,73448.8886950629,57446.701346138536
"147.32.84.165",17767,"64.236.79.229",80,14,2061,10,1404,4,657,48232.889547,0.36368400000355905,30883.954201697303,14452.106773871175
"147.32.84.165",17768,"64.236.79.229",80,14,2043,10,1386,4,657,48232.985119,0.3554420000000391,31194.962891269966,14787.222669238361
"147.32.84.165",17769,"195.113.232.82",80,16,2147,12,1426,4,721,48233.015598,21.700234000003547,525.7086167825718,265.8035853437828
"147.32.84.165",17770,"77.238.167.32",80,13,2342,10,1390,3,952,48233.04002,0.1402479999960633,79288.11819285931,54303.804690361205
"147.32.84.165",17771,"77.238.175.247",80,14,3055,10,1368,4,1687,48233.1348,0.140519000000495,77882.70625297254,96043.95135143616
"147.32.84.165",17772,"74.217.252.37",80,12,2075,10,1278,2,797,48233.232759,21.483249000004434,475.9056695752998,296.7893729667558
"147.32.84.165",17773,"64.236.79.229",80,14,2089,10,1432,4,657,48233.261552,0.35612399999808986,32168.570498089,14758.904201986363
"147.32.84.165",17774,"184.173.217.40",443,9,552,6,372,3,180,48234.822535,1.3060530000002473,2278.621158558984,1102.5586251091856
"147.32.84.165",17775,"184.173.217.40",443,9,552,6,372,3,180,48237.127659,1.3080950000003213,2275.0641199601473,1100.8374774000713
"147.32.84.165",17776,"184.173.217.40",443,9,552,6,372,3,180,48239.43666,1.3064129999984289,2277.993253284818,1102.254799976525
"147.32.84.165",17777,"184.173.217.40",443,9,552,6,372,3,180,48241.744129,1.30869900000107,2274.014116307544,1100.3294111165535
"147.32.84.165",17778,"184.173.217.40",443,9,552,6,372,3,180,48244.052984,1.3076789999977336,2275.7878653745743,1101.1876767941487
"147.32.84.165",17779,"184.173.217.40",443,9,552,6,372,3,180,48246.360197,1.3081679999959306,2274.937164041054,1100.7760471166391
"147.32.84.165",17780,"184.173.217.40",443,9,552,6,372,3,180,48248.668514,1.3084080000044196,2274.519874526866,1100.5741328355803
"147.32.84.165",17781,"184.173.217.40",443,9,552,6,372,3,180,48250.977416,1.306390999998257,2278.031615346378,1102.2733622643766
"147.32.84.165",17782,"184.173.217.40",443,9,552,6,372,3,180,48253.284831,1.3077269999994314,2275.7043327860433,1101.1472577996983
"147.32.84.165",17783,"173.192.170.88",80,11,1283,8,846,3,437,48254.121004,0.4954409999991185,13660.556958370506,7056.339705446703
"147.32.84.165",17784,"184.173.217.40",443,9,552,6,372,3,180,48255.606098,1.3080170000030193,2275.1997871534777,1100.903122816199
"147.32.84.165",17785,"184.173.217.40",443,9,552,6,372,3,180,48257.909795,1.307980999998108,2275.2624082492825,1100.933423346427
"147.32.84.165",17786,"184.173.217.40",443,9,552,6,372,3,180,48260.213208,1.3075079999980517,2276.0855000538695,1101.3316935744529
"147.32.84.165",17787,"184.173.217.40",443,9,552,6,372,3,180,48262.516396,1.3076169999985723,2275.8957707059863,1101.2398890512836
"147.32.84.165",17788,"184.173.217.40",443,9,552,6,372,3,180,48264.819775,1.3073919999951613,2276.2874486083856,1101.4294106169607
"147.32.84.165",17789,"184.173.217.40",443,9,552,6,372,3,180,48267.123049,1.3079579999975977,2275.3024179717286,1100.9527828895461
"147.32.84.165",17790,"184.173.217.40",443,9,552,6,372,3,180,48269.426256,1.3077649999977439,2275.6382071741746,1101.1152615358908
"147.32.84.165",17791,"184.173.217.40",443,9,552,6,372,3,180,48271.729706,1.3074580000029528,2276.172542439818,1101.3738108579762
"147.32.84.165",17792,"184.173.217.40",443,9,552,6,372,3,180,48274.033138,1.3079130000041914,2275.38070192013,1100.9906622194178
"147.32.84.165",17793,"184.173.217.40",443,9,552,6,372,3,180,48276.33662,1.3071060000002035,2276.785509361549,1101.6704077555883
"147.32.84.165",17794,"184.173.217.40",443,9,552,6,372,3,180,48278.639318,1.3082270000013523,2274.834566170033,1100.7264029854998
"147.32.84.165",17795,"184.173.217.40",443,9,552,6,372,3,180,48280.942546,1.3077290000001085,2275.700852393541,1101.1455737388103
"147.32.84.165",17796,"184.173.217.40",443,9,552,6,372,3,180,48283.24608,1.3077620000040042,2275.6434274668386,1101.117787483954
"147.32.84.165",17797,"184.173.217.40",443,9,552,6,372,3,180,48285.549354,1.3079389999984414,2275.3354705407105,1100.9687760680856
"147.32.84.165",17798,"184.173.217.40",443,9,552,6,372,3,180,48287.852639,1.308273000002373,2274.7545810351526,1100.6877005008803
"147.32.84.165",17799,"184.173.217.40",443,9,552,6,372,3,180,48290.155946,1.3079369999977644,2275.338949815692,1100.970459588238
"147.32.84.165",17800,"184.173.217.40",443,9,552,6,372,3,180,48292.459818,1.3073179999992135,2276.4162965719056,1101.4917564057607
"147.32.84.165",17801,"184.173.217.40",443,9,552,6,372,3,180,48294.762681,1.308153999998467,2274.961510650495,1100.7878277341104
"147.32.84.165",17802,"184.173.217.40",443,9,552,6,372,3,180,48297.066055,1.3074299999934738,2276.221289105233,1101.3973979541452
"147.32.84.165",17803,"184.173.217.40",443,9,552,6,372,3,180,48299.369443,1.3072009999959846,2276.6200454322952,1101.5903445640138
"147.32.84.165",17804,"184.173.217.40",443,9,552,6,372,3,180,48301.672671,1.3076920000021346,2275.7652413528126,1101.1767296868447
"147.32.84.165",17805,"184.173.217.40",443,9,552,6,372,3,180,48303.975653,1.3080110000009881,2275.2102237655126,1100.9081727897642
"147.32.84.165",17806,"184.173.217.40",443,9,552,6,372,3,180,48306.279388,1.3076319999963744,2275.8696636425625,1101.22725660124
"147.32.84.165",17807,"184.173.217.40",443,9,552,6,372,3,180,48308.582706,1.307487999998557,2276.1203162119155,1101.3485401025396
"147.32.84.165",17808,"184.173.217.40",443,9,552,6,372,3,180,48310.88554,1.3084559999988414,2274.4364350063242,1100.5337588740279
"147.32.84.165",17809,"184.173.217.40",443,9,552,6,372,3,180,48313.189326,1.3073539999968489,2276.353611957567,1101.4614251407581
"147.32.84.165",17810,"184.173.217.40",443,9,552,6,372,3,180,48315.49292,1.3158430000039516,2261.667995339157,1094.3554816157214
"147.32.84.165",17811,"184.173.217.40",443,9,552,6,372,3,180,48317.806,1.297576000004483,2293.5072781784793,1109.7615862153932
"147.32.84.165",17812,"184.173.217.40",443,9,552,6,372,3,180,48320.099124,1.3078390000009676,2275.509447262085,1101.0529583526218
"147.32.84.165",17813,"184.173.217.40",443,9,552,6,372,3,180,48322.40235,1.3078260000038426,2275.532066185606,1101.063902993035
"147.32.84.165",17814,"184.173.217.40",443,9,552,6,372,3,180,48324.705862,1.3074149999956717,2276.2474042364915,1101.4100343079797
"147.32.84.165",17815,"184.173.217.40",443,9,552,6,372,3,180,48327.009267,1.3077510000002803,2275.6625687912774,1101.1270494151343
"147.32.84.165",17816,"184.173.217.40",443,9,552,6,372,3,180,48329.312668,1.3072880000036093,2276.468536383554,1101.5170337339778
"147.32.84.165",17817,"184.173.217.40",443,9,552,6,372,3,180,48331.615521,1.3083150000020396,2274.6815560437362,1100.6523658276142
"147.32.84.165",17818,"184.173.217.40",443,9,552,6,372,3,180,48333.919149,1.3076949999958742,2275.7600205012554,1101.1742034683493
"147.32.84.165",17819,"184.173.217.40",443,9,552,6,372,3,180,48336.222548,1.307849000004353,2275.492048386392,1101.0445395418028
"147.32.84.165",17820,"184.173.217.40",443,9,552,6,372,3,180,48338.525781,1.3072810000012396,2276.480726023845,1101.5229319470218
"147.32.84.165",17821,"184.173.217.40",443,9,552,6,372,3,180,48340.829192,1.3073720000029425,2276.322270932299,1101.4462601285318
"147.32.84.165",17822,"184.173.217.40",443,9,552,6,372,3,180,48343.13223,1.3078279999972438,2275.5285863326612,1101.0622191932232
"147.32.84.165",17823,"184.173.217.40",443,9,552,6,372,3,180,48345.435603,1.307725999999093,2275.7060729862865,1101.148099832074
"147.32.84.165",17824,"184.173.217.40",443,9,552,6,372,3,180,48347.739069,1.3076619999992545,2275.817451299875,1101.2019925644554
"147.32.84.165",17825,"184.173.217.40",443,9,552,6,372,3,180,48350.042465,1.307249999998021,2276.5347102730966,1101.54905335795
"147.32.84.165",17826,"184.173.217.40",443,9,552,6,372,3,180,48352.34581,1.3077290000001085,2275.700852393541,1101.1455737388103
"147.32.84.165",17827,"184.173.217.40",443,9,552,6,372,3,180,48354.649216,1.3069920000052662,2276.9840978276907,1101.7664989488826
"147.32.84.165",17828,"184.173.217.40",443,9,552,6,372,3,180,48356.951999,1.30772799999977,2275.7025925884614,1101.1464157686103
"147.32.84.165",17829,"184.173.217.40",443,9,552,6,372,3,180,48359.255604,1.3072690000044531,2276.5016228411005,1101.53304331021
"147.32.84.165",17830,"184.173.217.40",443,9,552,6,372,3,180,48361.558985,1.3077159999957075,2275.723475135097,1101.1565202266597
"147.32.84.165",17831,"184.173.217.40",443,9,552,6,372,3,180,48363.862191,1.3077629999970668,2275.641687375063,1101.1169455040629
"147.32.84.165",17832,"184.173.217.40",443,9,552,6,372,3,180,48366.165069,1.3078419999947073,2275.504227584099,1101.0504327019835
"147.32.84.165",17833,"184.173.217.40",443,9,552,6,372,3,180,48368.468376,1.308285999999498,2274.7319775654114,1100.6767633381023
"147.32.84.165",17834,"184.173.217.40",443,9,552,6,372,3,180,48370.772283,1.3079330000036862,2275.3459083849193,1100.9738266378642
"147.32.84.165",17835,"94.100.176.20",25,6,372,6,372,0,0,48371.627002,8.918918999996094,333.672724239485,0
"147.32.84.165",17836,"184.173.217.40",443,9,552,6,372,3,180,48373.075642,1.3077369999955408,2275.6869309426497,1101.138837552895
"147.32.84.165",17837,"184.173.217.40",443,9,552,6,372,3,180,48375.37845,1.3082229999999981,2274.8415216671806,1100.7297685486358
"147.32.84.165",17838,"184.173.217.40",443,9,552,6,372,3,180,48377.681903,1.3081500000043889,2274.968466911299,1100.7911936667574
"147.32.84.165",17839,"184.173.217.40",443,9,552,6,372,3,180,48379.98549,1.3079100000031758,2275.3859210440887,1100.9931876019782
"147.32.84.165",17840,"184.173.217.40",443,9,552,6,372,3,180,48382.288313,1.3077200000043376,2275.7165142309736,1101.1531520472454
"147.32.84.165",17841,"184.173.217.40",443,9,552,6,372,3,180,48384.591895,1.3074689999994007,2276.1533925480176,1101.364544781299
"147.32.84.165",17842,"184.173.217.40",443,9,552,6,372,3,180,48386.895271,1.3075659999958589,2275.9845392197603,1101.2828415579486
"147.32.84.165",17843,"184.173.217.40",443,9,552,6,372,3,180,48389.198298,1.3080009999976028,2275.227618331679,1100.9165895153285
"147.32.84.165",17844,"184.173.217.40",443,9,552,6,372,3,180,48391.50211,1.3076619999992545,2275.817451299875,1101.2019925644554
"147.32.84.165",17845,"74.125.93.27",25,6,372,6,372,0,0,48392.563334,8.912819000004674,333.90109234782386,0
"147.32.84.165",17846,"184.173.217.40",443,9,552,6,372,3,180,48393.805197,1.3078979999991134,2275.4067977793507,1101.003289248073
"147.32.84.165",17847,"184.173.217.40",443,9,552,6,372,3,180,48396.108228,1.3077220000050147,2275.7130338012116,1101.1514679683282
"147.32.84.165",17848,"184.173.217.40",443,9,552,6,372,3,180,48398.411912,1.3074710000000778,2276.1499107818245,1101.3628600557215
"147.32.84.165",17849,"184.173.217.40",443,9,552,6,372,3,180,48400.715301,1.3070580000057817,2276.869121329609,1101.710865159488
"147.32.84.165",17850,"184.173.217.40",443,9,552,6,372,3,180,48403.018552,1.3075729999982286,2275.972354892638,1101.2769459157926
"147.32.84.165",17851,"184.173.217.40",443,9,552,6,372,3,180,48405.321791,1.3074219999980414,2276.2352170947547,1101.4041373039136
"147.32.84.165",17852,"184.173.217.40",443,9,552,6,372,3,180,48407.625286,1.3077989999947022,2275.579045412984,1101.0866348772506
"147.32.84.165",17853,"184.173.217.40",443,9,552,6,372,3,180,48409.928251,1.3077390000034939,2275.6834505907136,1101.1371535116355
"147.32.84.165",17854,"184.173.217.40",443,9,552,6,372,3,180,48412.231628,1.3077879999982542,2275.598185641689,1101.0958962782365
"147.32.84.165",17855,"74.125.39.27",25,6,372,6,372,0,0,48413.493709,9.013005000000703,330.18954277732763,0
"147.32.84.165",17856,"184.173.217.40",443,9,552,6,372,3,180,48414.535409,1.3071000000054482,2276.7959605138058,1101.6754647647447
"147.32.84.165",17857,"184.173.217.40",443,9,552,6,372,3,180,48416.838538,1.3074389999965206,2276.2056203065076,1101.3898162773423
"147.32.84.165",17858,"184.173.217.40",443,9,552,6,372,3,180,48419.141788,1.3072089999986929,2276.606112720289,1101.583602929172
"147.32.84.165",17859,"184.173.217.40",443,9,552,6,372,3,180,48421.444965,1.3074500000002445,2276.1864698454574,1101.3805499252214
"147.32.84.165",17860,"184.173.217.40",443,9,552,6,372,3,180,48423.747988,1.3077909999992698,2275.59296554393,1101.0933704244821
"147.32.84.165",17861,"184.173.217.40",443,9,552,6,372,3,180,48426.051578,1.3075060000046506,2276.0889816103445,1101.3333781985536
"147.32.84.165",17862,"184.173.217.40",443,9,552,6,372,3,180,48428.354773,1.3075240000034682,2276.0576478841735,1101.3182167181485
"147.32.84.165",17863,"184.173.217.40",443,9,552,6,372,3,180,48430.657924,1.3077489999996033,2275.666049066681,1101.1287334193617
"147.32.84.165",17864,"184.173.217.40",443,9,552,6,372,3,180,48432.96137,1.3077750000011292,2275.6208063293993,1101.10684177229
"147.32.84.165",17865,"66.111.4.71",25,6,372,6,372,0,0,48434.524018,9.012264000004507,330.21669138836944,0
"147.32.84.165",17866,"184.173.217.40",443,9,552,6,372,3,180,48435.264444,1.3078440000026603,2275.50074779098,1101.0487489311195
"147.32.84.165",17867,"184.173.217.40",443,9,552,6,372,3,180,48437.568298,1.307213000000047,2276.5991464282356,1101.5802321426945
"147.32.84.165",17868,"184.173.217.40",443,9,552,6,372,3,180,48439.871285,1.307848999997077,2275.4920483990513,1101.0445395479283
"147.32.84.165",17869,"184.173.217.40",443,9,552,6,372,3,180,48442.174767,1.3074840000044787,2276.1272795612076,1101.3519094651003
"147.32.84.165",17870,"184.173.217.40",443,9,552,6,372,3,180,48444.477847,1.307795000000624,2275.586005450839,1101.0900026375027
"147.32.84.165",17871,"184.173.217.40",443,9,552,6,372,3,180,48446.781518,1.3077959999936866,2275.5842654468793,1101.0891607001029
"147.32.84.165",17872,"184.173.217.40",443,9,552,6,372,3,180,48449.084816,1.3071710000003804,2276.6722945958363,1101.61562641734
"147.32.84.165",17873,"184.173.217.40",443,9,552,6,372,3,180,48451.387913,1.307754000001296,2275.657348398132,1101.124523418451
"147.32.84.165",17874,"184.173.217.40",443,9,552,6,372,3,180,48453.691075,1.3076619999992545,2275.817451299875,1101.2019925644554
"147.32.84.165",17875,"216.157.130.15",25,6,372,6,372,0,0,48455.554026,8.912672999998904,333.90656203816366,0
"147.32.84.165",17876,"184.173.217.40",443,9,552,6,372,3,180,48455.994692,1.307559000000765,2275.996723664675,1101.2887372571008
"147.32.84.165",17877,"184.173.217.40",443,9,552,6,372,3,180,48458.297688,1.3080380000028526,2275.163259778011,1100.8854482796826
"147.32.84.165",17878,"184.173.217.40",443,9,552,6,372,3,180,48460.60138,1.4076140000033774,2114.2159711347426,1023.0077279684238
"147.32.84.165",17879,"184.173.217.40",443,9,552,6,372,3,180,48463.00467,1.307448999999906,2276.1882107831466,1101.3813923144257
"147.32.84.165",17880,"184.173.217.40",443,9,552,6,372,3,180,48465.308295,1.3071789999958128,2276.658361256976,1101.608884479182
"147.32.84.165",17881,"184.173.217.40",443,9,552,6,372,3,180,48467.611224,1.307903000000806,2275.3980990931022,1100.9990802063398
"147.32.84.165",17882,"184.173.217.40",443,9,552,6,372,3,180,48469.91452,1.308249000001524,2274.7963117086524,1100.7078927622513
"147.32.84.165",17883,"184.173.217.40",443,9,552,6,372,3,180,48472.217777,1.3079710000019986,2275.2798036007316,1100.941840451967
"147.32.84.165",17884,"184.173.217.40",443,9,552,6,372,3,180,48474.520897,1.3079839999991236,2275.257189691918,1100.9308982380248
"147.32.84.165",17885,"184.173.217.40",443,9,552,6,372,3,180,48476.824638,1.307581000000937,2275.958430107097,1101.270208116337
"147.32.84.165",17886,"184.173.217.40",443,9,552,6,372,3,180,48479.127856,1.3076579999979003,2275.824412808837,1101.2053610365342
"147.32.84.165",17887,"184.173.217.40",443,9,552,6,372,3,180,48481.431341,1.307398999997531,2276.275261037847,1101.4235134054097
"147.32.84.165",17888,"184.173.217.40",443,9,552,6,372,3,180,48483.734397,1.3081660000025295,2274.9406420853666,1100.7777300413063
"147.32.84.165",17889,"184.173.217.40",443,9,552,6,372,3,180,48486.037773,1.3081340000062482,2274.996292417891,1100.8046576215602
"147.32.84.165",17890,"184.173.217.40",443,9,552,6,372,3,180,48488.34067,1.3094380000038655,2272.7307440224085,1099.708424526972
"147.32.84.165",17891,"184.173.217.40",443,9,552,6,372,3,180,48490.644683,1.3076720000026398,2275.800047713794,1101.1935714744163
"147.32.84.165",17892,"184.173.217.40",443,9,552,6,372,3,180,48492.947981,1.3072860000029323,2276.4720191246024,1101.5187189312592
"147.32.84.165",17893,"184.173.217.40",443,9,552,6,372,3,180,48495.251041,1.307954999996582,2275.3076367365675,1100.955308098339
"147.32.84.165",17894,"184.173.217.40",443,9,552,6,372,3,180,48497.553946,1.3081590000001597,2274.9528153684964,1100.783620339595
"147.32.84.165",17895,"184.173.217.40",443,9,552,6,372,3,180,48499.85757,1.3080859999972745,2275.0797730471854,1100.8450514744445
"147.32.84.165",17896,"184.173.217.40",443,9,552,6,372,3,180,48502.160755,1.3075750000061817,2275.9688736676144,1101.2752614520714
"147.32.84.165",17897,"184.173.217.40",443,9,552,6,372,3,180,48504.464243,1.3080359999948996,2275.1667385390037,1100.8871315511308
"147.32.84.165",17898,"184.173.217.40",443,9,552,6,372,3,180,48506.767952,1.3075779999999213,2275.9636518817074,1101.2727347814714
"147.32.84.165",17899,"184.173.217.40",443,9,552,6,372,3,180,48509.070607,1.3081939999974566,2274.891950280911,1100.7541694907634
"147.32.84.165",17900,"184.173.217.40",443,9,552,6,372,3,180,48511.373883,1.3080960000006598,2275.06238074155,1100.8366358426856
"147.32.84.165",17901,"184.173.217.40",443,9,552,6,372,3,180,48513.677719,1.30763499999739,2275.8644422992197,1101.2247301447837
"147.32.84.165",17902,"184.173.217.40",443,9,552,6,372,3,180,48515.981008,1.307448999999906,2276.1882107831466,1101.3813923144257
"147.32.84.165",17903,"184.173.217.40",443,9,552,6,372,3,180,48518.28407,1.3081400000010035,2274.985857781061,1100.7996086037392
"147.32.84.165",17904,"184.173.217.40",443,9,552,6,372,3,180,48520.587485,1.307291000004625,2276.463312291962,1101.5145059477236
"147.32.84.165",17905,"173.192.170.88",80,27,4359,18,1526,9,2833,48521.014216,34.70350899999903,351.7799885884837,653.0751688539806
"147.32.84.165",17906,"173.192.170.88",80,26,4090,18,1526,8,2564,48521.920481,34.79856999999902,350.8190135399341,589.4495089884607
"147.32.84.165",17908,"184.173.217.40",443,9,552,6,372,3,180,48522.890567,1.3078289999975823,2275.5268464038504,1101.0613772921859
"147.32.84.165",17910,"184.173.217.40",443,9,552,6,372,3,180,48525.194058,1.3076670000009472,2275.808749473562,1101.1977820033364
"147.32.84.165",17911,"184.173.217.40",443,9,552,6,372,3,180,48527.497178,1.307544000002963,2276.02283364327,1101.3013711177114
"147.32.84.165",17912,"184.173.217.40",443,9,552,6,372,3,180,48529.800299,1.308420000001206,2274.499014075952,1100.564039069009
"147.32.84.165",17914,"184.173.217.40",443,9,552,6,372,3,180,48532.103461,1.2008229999992182,2478.300299046519,1199.1775640547671
"147.32.84.165",17915,"98.126.71.122",80,18,4967,14,1534,4,3433,48532.199793,15.996144999997341,767.184843598382,1716.913668887383
"147.32.84.165",17916,"95.100.248.97",80,21,8143,14,4176,7,3967,48532.796327,19.396942000006675,1722.3333451215406,1636.134190636291
"147.32.84.165",17917,"195.113.232.89",80,13,2900,10,1878,3,1022,48532.937016,19.256336999998894,780.2106911610896,424.5875007277069
"147.32.84.165",17919,"95.100.248.97",80,13,3217,10,1540,3,1677,48533.117784,20.085846000001766,613.3672437794712,667.9330310507619
"147.32.84.165",17920,"195.113.232.99",80,45,33819,36,3324,9,30495,48533.184275,19.00890000000072,1398.923662074028,12833.988289695391
"147.32.84.165",17921,"195.113.232.99",80,13,1911,10,1538,3,373,48533.352863,19.85099199999968,619.8178912167311,150.31994370860903
"147.32.84.165",17922,"184.173.217.40",443,9,552,6,372,3,180,48534.304594,1.306771999996272,2277.36743671313,1101.9519855063531
"147.32.84.165",17923,"184.173.217.40",443,9,552,6,372,3,180,48536.610638,1.3083430000042426,2274.6328753166026,1100.6288106370657
"147.32.84.165",17924,"184.173.217.40",443,9,552,6,372,3,180,48538.919347,1.3066479999979492,2277.5835573196996,1102.056559993403
"147.32.84.165",17925,"184.173.217.40",443,9,552,6,372,3,180,48541.22536,1.307795000000624,2275.586005450839,1101.0900026375027
"147.32.84.165",17926,"184.173.217.40",443,9,552,6,372,3,180,48543.532777,1.3090579999989131,2273.3904838459953,1100.0276534738687
"147.32.84.165",17927,"184.173.217.40",443,9,552,6,372,3,180,48545.841286,1.3077249999987544,2275.707813189191,1101.1489418657375
"147.32.84.165",17928,"184.173.217.40",443,9,552,6,372,3,180,48548.148717,1.3080900000059046,2275.0728160803665,1100.8416852001774
"147.32.84.165",17929,"184.173.217.40",443,9,552,6,372,3,180,48550.455954,1.3076940000028117,2275.761760774005,1101.1750455358087
"147.32.84.165",17930,"184.173.217.40",443,9,552,6,372,3,180,48552.764315,1.315309999998135,2262.5844857898287,1094.798944737014
"147.32.84.165",17931,"184.173.217.40",443,9,552,6,372,3,180,48555.075592,1.3077599999960512,2275.646907696356,1101.1194714659784
"147.32.84.165",17932,"173.192.170.88",80,11,1283,8,846,3,437,48555.517202,0.49431299999559997,13691.729734116327,7072.441954856779
"147.32.84.165",17933,"173.192.170.88",80,11,1283,8,846,3,437,48556.518525,0.7750729999970645,8732.08072017169,4510.5428779137455
"147.32.84.165",17934,"184.173.217.40",443,9,552,6,372,3,180,48557.378693,1.307557000000088,2276.000204962231,1101.2904217559183
"147.32.84.165",17935,"184.173.217.40",443,9,552,6,372,3,180,48559.682203,1.3076320000036503,2275.869663629899,1101.2272565951125
"147.32.84.165",17936,"184.173.217.40",443,9,552,6,372,3,180,48561.985274,1.3075360000002547,2276.0367592168936,1101.308109298497
"147.32.84.165",17937,"184.173.217.40",443,9,552,6,372,3,180,48564.288512,1.3081880000027013,2274.902384056309,1100.7592180917625
"147.32.84.165",17938,"184.173.217.40",443,9,552,6,372,3,180,48566.592066,1.3076180000061868,2275.8940302029487,1101.2390468723945
"147.32.84.165",17939,"184.173.217.40",443,9,552,6,372,3,180,48568.895427,1.3076519999958691,2275.8348551521362,1101.2104137832916
"147.32.84.165",17940,"184.173.217.40",443,9,552,6,372,3,180,48571.198601,1.3080670000053942,2275.112819135203,1100.8610415170338
"147.32.84.165",17941,"184.173.217.40",443,9,552,6,372,3,180,48573.502285,1.307530999998562,2276.0454627869417,1101.3123207033589
"147.32.84.165",17942,"184.173.217.40",443,9,552,6,372,3,180,48575.805289,1.3075339999995776,2276.0402406369253,1101.3097938565768
"147.32.84.165",17943,"184.173.217.40",443,9,552,6,372,3,180,48578.108257,1.3082619999986491,2274.7737074095808,1100.6969551981842
"147.32.84.165",17944,"184.173.217.40",443,9,552,6,372,3,180,48580.411861,1.3079730000026757,2275.276324506631,1100.9401570193377
"147.32.84.165",17945,"184.173.217.40",443,9,552,6,372,3,180,48582.71589,1.3069259999974747,2277.0990859511176,1101.822138363444
"147.32.84.165",17946,"184.173.217.40",443,9,552,6,372,3,180,48585.018467,1.3081899999961024,2274.898906128977,1100.7575352236986
"147.32.84.165",17947,"184.173.217.40",443,9,552,6,372,3,180,48587.321883,1.3075630000021192,2275.989761101512,1101.2853682749253
"147.32.84.165",17948,"184.173.217.40",443,9,552,6,372,3,180,48589.625173,1.3077790000024834,2275.613846066001,1101.1034739029037
"147.32.84.165",17949,"184.173.217.40",443,9,552,6,372,3,180,48591.928845,1.3079619999989518,2275.29545965585,1100.949415962508
"147.32.84.165",17950,"184.173.217.40",443,9,552,6,372,3,180,48594.231808,1.307479000002786,2276.1359838235708,1101.3561212049535
"147.32.84.165",17951,"184.173.217.40",443,9,552,6,372,3,180,48596.535067,1.3080180000033579,2275.1980477274474,1100.9022811584423
"147.32.84.165",17952,"94.100.176.20",25,6,372,6,372,0,0,48596.775059,8.932920999999624,333.14970545470237,0
"147.32.84.165",17953,"184.173.217.40",443,9,552,6,372,3,180,48598.838086,1.3078249999962281,2275.5338061350585,1101.0647449040605
"147.32.84.165",17954,"184.173.217.40",443,9,552,6,372,3,180,48601.141709,1.3078069999974105,2275.5651254396807,1101.0798994062973
"147.32.84.165",17955,"184.173.217.40",443,9,552,6,372,3,180,48603.444956,1.308004999998957,2275.220660473296,1100.9132228096591
"147.32.84.165",17956,"184.173.217.40",443,9,552,6,372,3,180,48605.748353,1.3079670000006445,2275.2867618208516,1100.9452073326702
"147.32.84.165",17957,"184.173.217.40",443,9,552,6,372,3,180,48608.05142,1.3082719999947585,2274.7563197958248,1100.6885418366894
"147.32.84.165",17958,"184.173.217.40",443,9,552,6,372,3,180,48610.354774,1.3075640000024578,2275.9880204673777,1101.2845260326021
"147.32.84.165",17959,"184.173.217.40",443,9,552,6,372,3,180,48612.658446,1.307622000000265,2275.887068280739,1101.2356782003578
"147.32.84.165",17960,"184.173.217.40",443,9,552,6,372,3,180,48614.961441,1.3081309999979567,2275.001509791182,1100.8071821570236
"147.32.84.165",17961,"184.173.217.40",443,9,552,6,372,3,180,48617.26517,1.3078190000014729,2275.5442457990353,1101.0697963543719
"147.32.84.165",17962,"74.125.93.27",25,6,372,6,372,0,0,48617.725259,9.012908000004245,330.19309639004393,0
"147.32.84.165",17963,"184.173.217.40",443,9,552,6,372,3,180,48619.568384,1.3077850000045146,2275.6034057507363,1101.098422137453
"147.32.84.165",17964,"184.173.217.40",443,9,552,6,372,3,180,48621.871549,1.3079909999942174,2275.245013163819,1100.92500636959
"147.32.84.165",17965,"184.173.217.40",443,9,552,6,372,3,180,48624.174743,1.3074399999968591,2276.203879342187,1101.3889738752518
"147.32.84.165",17966,"184.173.217.40",443,9,552,6,372,3,180,48626.478341,1.3076680000012857,2275.807009116285,1101.1969398949766
"147.32.84.165",17967,"184.173.217.40",443,9,552,6,372,3,180,48628.78157,1.3078910000040196,2275.418976039176,1101.00918195444
"147.32.84.165",17968,"184.173.217.40",443,9,552,6,372,3,180,48631.084727,1.3080730000001495,2275.102383429411,1100.8559919819731
"147.32.84.165",17969,"184.173.217.40",443,9,552,6,372,3,180,48633.388182,1.3072179999944638,2276.590438635793,1101.5760186947384
"147.32.84.165",17970,"184.173.217.40",443,9,552,6,372,3,180,48635.691324,1.3080750000008265,2275.0989048778697,1100.8543088118724
"147.32.84.165",17971,"184.173.217.40",443,9,552,6,372,3,180,48637.99472,1.3075619999945047,2275.9915017509743,1101.286210524665
"147.32.84.165",17972,"74.125.39.27",25,6,372,6,372,0,0,48638.75597,8.91223500000342,333.922972183617,0
"147.32.84.165",17973,"184.173.217.40",443,9,552,6,372,3,180,48640.297744,1.308348999998998,2274.6224440132405,1100.6237632322132
"147.32.84.165",17974,"184.173.217.40",443,9,552,6,372,3,180,48642.601617,1.3076119999968796,2275.9044731977847,1101.244099934412
"147.32.84.165",17975,"184.173.217.40",443,9,552,6,372,3,180,48644.904518,1.3081889999957639,2274.9006450976403,1100.7583766601485
"147.32.84.165",17976,"184.173.217.40",443,9,552,6,372,3,180,48647.207889,1.3077680000060354,2275.632986880139,1101.112735587164
"147.32.84.165",17977,"184.173.217.40",443,9,552,6,372,3,180,48649.51119,1.3076380000056815,2275.859220967171,1101.2222036937924
"147.32.84.165",17978,"184.173.217.40",443,9,552,6,372,3,180,48651.814911,1.3078150000001187,2275.551205636676,1101.0731640177466
"147.32.84.165",17979,"184.173.217.40",443,9,552,6,372,3,180,48654.117707,1.3077350000021397,2275.690411279908,1101.1405215870523
"147.32.84.165",17980,"184.173.217.40",443,9,552,6,372,3,180,48656.421015,1.3077029999985825,2275.7460983137807,1101.1674669260228
"147.32.84.165",17981,"184.173.217.40",443,9,552,6,372,3,180,48658.7245,1.3076940000028117,2275.761760774005,1101.1750455358087
"147.32.84.165",17982,"66.111.4.71",25,6,372,6,372,0,0,48659.68562,9.01334200000565,330.17719731461807,0
"147.32.84.165",17983,"184.173.217.40",443,9,552,6,372,3,180,48661.027995,1.307559000000765,2275.996723664675,1101.2887372571008
"147.32.84.165",17984,"184.173.217.40",443,9,552,6,372,3,180,48663.331095,1.3076690000016242,2275.8052687616696,1101.1960977879046
"147.32.84.165",17985,"184.173.217.40",443,9,552,6,372,3,180,48665.634371,1.3081299999976181,2275.003248916712,1100.8080236693768
"147.32.84.165",17986,"184.173.217.40",443,9,552,6,372,3,180,48667.937616,1.3078409999943688,2275.50596747832,1101.051274586284
"147.32.84.165",17987,"184.173.217.40",443,9,552,6,372,3,180,48670.241216,1.3080159999954049,2275.2015265948235,1100.9039644813663
"147.32.84.165",17988,"184.173.217.40",443,9,552,6,372,3,180,48672.544034,1.3084270000035758,2274.4868456489103,1100.5581511204405
"147.32.84.165",17989,"184.173.217.40",443,9,552,6,372,3,180,48674.847597,1.3076789999977336,2275.7878653745743,1101.1876767941487
"147.32.84.165",17990,"184.173.217.40",443,9,552,6,372,3,180,48677.150704,1.307831999998598,2275.5216266333828,1101.0588515967981
"147.32.84.165",17991,"184.173.217.40",443,9,552,6,372,3,180,48679.454028,1.3076450000007753,2275.847037994437,1101.2163087069855
"147.32.84.165",17992,"216.157.130.15",25,6,372,6,372,0,0,48680.715954,9.013069000000542,330.18719816744124,0
"147.32.84.165",17993,"184.173.217.40",443,9,552,6,372,3,180,48681.757395,1.307687000000442,2275.7739428464106,1101.180940086973
"147.32.84.165",17994,"184.173.217.40",443,9,552,6,372,3,180,48684.060655,1.3077159999957075,2275.723475135097,1101.1565202266597
"147.32.84.165",17995,"184.173.217.40",443,9,552,6,372,3,180,48686.364,1.3082109999959357,2274.8623884138306,1100.739865361531
"147.32.84.165",17996,"184.173.217.40",443,9,552,6,372,3,180,48688.66772,1.3079520000028424,2275.312855512689,1100.9578333125914
"147.32.84.165",17997,"184.173.217.40",443,9,552,6,372,3,180,48690.971005,1.3074090000009164,2276.2578504491817,1101.4150889270234
"147.32.84.165",17998,"184.173.217.40",443,9,552,6,372,3,180,48693.27422,1.3082940000022063,2274.7180679533662,1100.670032880661
"147.32.84.165",17999,"184.173.217.40",443,9,552,6,372,3,180,48695.577719,1.3077750000011292,2275.6208063293993,1101.10684177229
"147.32.84.165",18000,"184.173.217.40",443,9,552,6,372,3,180,48697.881014,1.3075989999997546,2275.9270999752666,1101.255048375129
"147.32.84.165",18001,"184.173.217.40",443,9,552,6,372,3,180,48700.184159,1.3078040000036708,2275.5703453970523,1101.0824251921222
"147.32.84.165",18002,"184.173.217.40",443,9,552,6,372,3,180,48702.487398,1.3074320000014268,2276.2178071186513,1101.3957131219279
"147.32.84.165",18003,"184.173.217.40",443,9,552,6,372,3,180,48704.790746,1.3078270000041812,2275.5303262514735,1101.0630610894225
"147.32.84.165",18004,"184.173.217.40",443,9,552,6,372,3,180,48707.094274,1.30763499999739,2275.8644422992197,1101.2247301447837
"147.32.84.165",18005,"184.173.217.40",443,9,552,6,372,3,180,48709.397293,1.307805999997072,2275.5668654270303,1101.08074133566
"147.32.84.165",18006,"184.173.217.40",443,9,552,6,372,3,180,48711.700593,1.3082159999976284,2274.853693889537,1100.735658333647
"147.32.84.165",18007,"184.173.217.40",443,9,552,6,372,3,180,48714.004071,1.3078679999962333,2275.4589912809024,1101.0285441681785
"147.32.84.165",18008,"184.173.217.40",443,9,552,6,372,3,180,48716.307039,1.3081079999974463,2275.0415103384503,1100.8265372605406
"147.32.84.165",18009,"184.173.217.40",443,9,552,6,372,3,180,48718.610638,1.3076980000041658,2275.754799648328,1101.1716772491911
"147.32.84.165",18010,"184.173.217.40",443,9,552,6,372,3,180,48720.913977,1.3074560000022757,2276.1760242752493,1101.375495617056
"147.32.84.165",18011,"184.173.217.40",443,9,552,6,372,3,180,48723.216857,1.308043999997608,2275.1528236094828,1100.8803985207176
"147.32.84.165",18012,"184.173.217.40",443,9,552,6,372,3,180,48725.520476,1.3078020000029937,2275.5738253903783,1101.0841090598606
"147.32.84.165",18013,"184.173.217.40",443,9,552,6,372,3,180,48727.824074,1.3071130000025732,2276.773316457063,1101.664507963095
"147.32.84.165",18014,"184.173.217.40",443,9,552,6,372,3,180,48730.127219,1.3075620000017807,2275.991501738309,1101.2862105185368
"147.32.84.165",18015,"184.173.217.40",443,9,552,6,372,3,180,48732.43014,1.3085460000002058,2274.280002383968,1100.458065669662
"147.32.84.165",18016,"184.173.217.40",443,9,552,6,372,3,180,48734.734039,1.307608999995864,2275.9096947248095,1101.2466264797465
"147.32.84.165",18017,"184.173.217.40",443,9,552,6,372,3,180,48737.037468,1.3071579999959795,2276.6949366558238,1101.626582252818
"147.32.84.165",18018,"184.173.217.40",443,9,552,6,372,3,180,48739.340683,1.3077419999972335,2275.678230114423,1101.1346274747207
"147.32.84.165",18019,"184.173.217.40",443,9,552,6,372,3,180,48741.643565,1.307619999999588,2275.8905492428516,1101.2373625368639
"147.32.84.165",18020,"184.173.217.40",443,9,552,6,372,3,180,48743.946946,1.3079120000038529,2275.382441625456,1100.9915040123174
"147.32.84.165",18021,"184.173.217.40",443,9,552,6,372,3,180,48746.250594,1.3075339999995776,2276.0402406369253,1101.3097938565768
"147.32.84.165",18022,"184.173.217.40",443,9,552,6,372,3,180,48748.553671,1.308139000000665,2274.987596882661,1100.8004501045134
"147.32.84.165",18023,"184.173.217.40",443,9,552,6,372,3,180,48750.856945,1.3080180000033579,2275.1980477274474,1100.9022811584423
"147.32.84.165",18024,"184.173.217.40",443,9,552,6,372,3,180,48753.160423,1.3073409999997239,2276.376247666545,1101.472377903167
"147.32.84.165",18025,"184.173.217.40",443,9,552,6,372,3,180,48755.463587,1.307369000001927,2276.327494376579,1101.4487876015705
"147.32.84.165",18026,"184.173.217.40",443,9,552,6,372,3,180,48757.767147,1.307597999999416,2275.9288405162206,1101.2558905723647
"147.32.84.165",18027,"184.173.217.40",443,9,552,6,372,3,180,48760.070183,1.3074869999982184,2276.1220570484106,1101.3493824427794
"147.32.84.165",18028,"184.173.217.40",443,9,552,6,372,3,180,48762.373589,1.3077510000002803,2275.6625687912774,1101.1270494151343
"147.32.84.165",18029,"184.173.217.40",443,9,552,6,372,3,180,48764.67709,1.3074500000002445,2276.1864698454574,1101.3805499252214
"147.32.84.165",18030,"184.173.217.40",443,9,552,6,372,3,180,48766.980291,1.3075360000002547,2276.0367592168936,1101.308109298497
"147.32.84.165",18031,"184.173.217.40",443,9,552,6,372,3,180,48769.283635,1.3078020000029937,2275.5738253903783,1101.0841090598606
"147.32.84.165",18032,"184.173.217.40",443,9,552,6,372,3,180,48771.586589,1.3084060000037425,2274.5233513079943,1100.5758151490295
"147.32.84.165",18033,"184.173.217.40",443,9,552,6,372,3,180,48773.889823,1.3078950000053737,2275.412017010366,1101.0058146824351
"147.32.84.165",18034,"184.173.217.40",443,9,552,6,372,3,180,48776.193368,1.3074580000029528,2276.172542439818,1101.3738108579762
"147.32.84.165",18035,"184.173.217.40",443,9,552,6,372,3,180,48778.496831,1.3074110000015935,2276.254368363409,1101.4134040468107
"147.32.84.165",18036,"184.173.217.40",443,9,552,6,372,3,180,48780.800092,1.307531000005838,2276.0454627742765,1101.3123206972305
"147.32.84.165",18037,"184.173.217.40",443,9,552,6,372,3,180,48783.103314,1.3080150000023423,2275.2032660135174,1100.904806135573
"147.32.84.165",18038,"184.173.217.40",443,9,552,6,372,3,180,48785.406452,1.308084999996936,2275.0815122923746,1100.8458930446975
"147.32.84.165",18039,"184.173.217.40",443,9,552,6,372,3,180,48787.709826,1.3080190000036964,2275.1963083040764,1100.9014395019726
"147.32.84.165",18040,"184.173.217.40",443,9,552,6,372,3,180,48790.013064,1.308216999997967,2274.851954992654,1100.7348169319293
"147.32.84.165",18041,"184.173.217.40",443,9,552,6,372,3,180,48792.316232,1.308100000002014,2275.055423893753,1100.8332696260095
"147.32.84.165",18042,"184.173.217.40",443,9,552,6,372,3,180,48794.620005,1.3078690000038478,2275.457251445859,1101.0277023125125
"147.32.84.165",18043,"184.173.217.40",443,9,552,6,372,3,180,48796.923245,1.307559000000765,2275.996723664675,1101.2887372571008
"147.32.84.165",18044,"184.173.217.40",443,9,552,6,372,3,180,48799.226913,1.3074449999985518,2276.1951745605334,1101.384761884129
"147.32.84.165",18045,"184.173.217.40",443,9,552,6,372,3,180,48801.530071,1.3078800000002957,2275.438113587888,1101.0184420586556
"147.32.84.165",18046,"184.173.217.40",443,9,552,6,372,3,180,48803.833505,1.307262999995146,2276.5120714126006,1101.538099070613
"147.32.84.165",18047,"184.173.217.40",443,9,552,6,372,3,180,48806.136577,1.3074810000034631,2276.132502110637,1101.3544365051469
"147.32.84.165",18048,"184.173.217.40",443,9,552,6,372,3,180,48808.43991,1.30782100000215,2275.54076589618,1101.0681125304095
"147.32.84.165",18049,"184.173.217.40",443,9,552,6,372,3,180,48810.743451,1.3077009999979055,2275.74957884468,1101.1691510538774
"147.32.84.165",18050,"147.32.84.171",139,33,4810,22,3278,11,1532,48811.048291,0.01648900000145659,1590393.5955899963,743283.4009895895
"147.32.84.165",18051,"184.173.217.40",443,9,552,6,372,3,180,48813.046653,1.3071750000017346,2276.665327898752,1101.61225543488
"147.32.84.165",18052,"184.173.217.40",443,9,552,6,372,3,180,48815.349837,1.3077459999985876,2275.6712694997454,1101.1312594353608
"147.32.84.165",18053,"184.173.217.40",443,9,552,6,372,3,180,48817.653079,1.3078549999991083,2275.481609201348,1101.039488323233
"147.32.84.165",18054,"184.173.217.40",443,9,552,6,372,3,180,48819.956416,1.3078180000011344,2275.5459857544543,1101.0706382682843
"147.32.84.165",18055,"173.192.170.88",80,30,4570,20,1646,10,2924,48821.044911,36.56683200000407,360.1077610441762,639.705402972765
"147.32.84.165",18056,"94.100.176.20",25,6,372,6,372,0,0,48821.919917,9.012218000003486,330.2183768744663,0
"147.32.84.165",18057,"184.173.217.40",443,9,552,6,372,3,180,48822.259228,1.3078279999972438,2275.5285863326612,1101.0622191932232
"147.32.84.165",18059,"184.173.217.40",443,9,552,6,372,3,180,48824.563183,1.3073530000037863,2276.355353138273,1101.4622676475517
"147.32.84.165",18060,"184.173.217.40",443,9,552,6,372,3,180,48826.866443,1.3077110000012908,2275.7321762966453,1101.1607304661188
"147.32.84.165",18061,"184.173.217.40",443,9,552,6,372,3,180,48829.169209,1.3078420000019833,2275.50422757144,1101.050432695858
"147.32.84.165",18062,"184.173.217.40",443,9,552,6,372,3,180,48831.473208,1.3077249999987544,2275.707813189191,1101.1489418657375
"147.32.84.165",18064,"98.126.71.122",80,18,4965,14,1532,4,3433,48833.15065,19.963507999993453,613.9201587218048,1375.7101206866553
"147.32.84.165",18065,"184.173.217.40",443,9,552,6,372,3,180,48833.76644,1.310667999998259,2270.597893596207,1098.676400127197
"147.32.84.165",18066,"95.100.248.96",80,17,5880,12,2760,5,3120,48833.884734,19.229661999997916,1148.2261102666491,1297.9947333449077
"147.32.84.165",18067,"195.113.232.99",80,13,2069,10,1696,3,373,48834.118936,18.995648000003712,714.2688683216992,157.0886131391473
"147.32.84.165",18068,"184.173.217.40",443,9,552,6,372,3,180,48836.07756,1.3071560000025784,2276.6984200769684,1101.6282677791783
"147.32.84.165",18069,"184.173.217.40",443,9,552,6,372,3,180,48838.385202,1.306521000005887,2277.8049491639176,1102.163685079315
"147.32.84.165",18070,"184.173.217.40",443,9,552,6,372,3,180,48840.692817,1.3077759999941918,2275.619066272219,1101.1059998091382
"147.32.84.165",18071,"74.125.93.27",25,6,372,6,372,0,0,48842.957853,8.931154999998398,333.21558073961694,0
"147.32.84.165",18072,"184.173.217.40",443,9,552,6,372,3,180,48843.001532,1.3062139999965439,2278.340302590444,1102.4227270598922
"147.32.84.165",18073,"184.173.217.40",443,9,552,6,372,3,180,48845.309391,1.306189999995695,2278.382164929917,1102.442983030605
"147.32.84.165",18074,"184.173.217.40",443,9,552,6,372,3,180,48847.616672,1.306328000006033,2278.1414774744594,1102.3265213586094
"147.32.84.165",18075,"184.173.217.40",443,9,552,6,372,3,180,48849.923047,1.3099180000062915,2271.8979355850565,1099.3054527024467
"147.32.84.165",18076,"184.173.217.40",443,9,552,6,372,3,180,48852.233062,1.3170529999988503,2259.5901607623973,1093.3500777882568
"147.32.84.165",18077,"184.173.217.40",443,9,552,6,372,3,180,48854.546288,1.3076990000045043,2275.7530593735632,1101.1708351807563
"147.32.84.165",18078,"184.173.217.40",443,9,552,6,372,3,180,48856.849088,1.3083049999986542,2274.69894252721,1100.6607786421982
"147.32.84.165",18079,"173.192.170.88",80,11,1283,8,846,3,437,48857.411171,2.0964590000003227,3228.3006727052416,1667.573751740178
"147.32.84.165",18080,"184.173.217.40",443,9,552,6,372,3,180,48859.15235,1.3076040000014473,2275.918397310429,1101.250837408272
"147.32.84.165",18081,"184.173.217.40",443,9,552,6,372,3,180,48861.456134,1.3076010000004317,2275.923618901345,1101.2533639845217
"147.32.84.165",18082,"184.173.217.40",443,9,552,6,372,3,180,48863.758794,1.3078349999996135,2275.516406886862,1101.0563259129979
"147.32.84.165",18083,"74.125.39.27",25,6,372,6,372,0,0,48863.919252,9.013059999997495,330.18752787630694,0
"147.32.84.165",18084,"184.173.217.40",443,9,552,6,372,3,180,48866.062392,1.3081470000033733,2274.9736841443096,1100.7937181343432
"147.32.84.165",18085,"184.173.217.40",443,9,552,6,372,3,180,48868.365477,1.308165000002191,2274.9423811178376,1100.778571508631
"147.32.84.165",18086,"184.173.217.40",443,9,552,6,372,3,180,48870.669493,1.3072350000002189,2276.5608325966655,1101.5616931919349
"147.32.84.165",18087,"184.173.217.40",443,9,552,6,372,3,180,48872.972808,1.3077439999979106,2275.6747498017617,1101.1329434524653
"147.32.84.165",18088,"184.173.217.40",443,9,552,6,372,3,180,48875.275947,1.3074609999966924,2276.16731971931,1101.37128373515
"147.32.84.165",18089,"184.173.217.40",443,9,552,6,372,3,180,48877.578749,1.308242999999493,2274.8067446194273,1100.7129409448842
"147.32.84.165",18090,"184.173.217.40",443,9,552,6,372,3,180,48879.882128,1.3077110000012908,2275.7321762966453,1101.1607304661188
"147.32.84.165",18091,"184.173.217.40",443,9,552,6,372,3,180,48882.185941,1.3072789999932866,2276.484208814861,1101.5246171684812
"147.32.84.165",18092,"184.173.217.40",443,9,552,6,372,3,180,48884.489163,1.3074730000007548,2276.1464290262834,1101.3611753352984
"147.32.84.165",18093,"66.111.4.71",25,6,372,6,372,0,0,48884.949393,9.012920999994094,330.1926201285854,0
"147.32.84.165",18094,"184.173.217.40",443,9,552,6,372,3,180,48886.792663,1.307227999997849,2276.5730232254027,1101.5675918832594
"147.32.84.165",18095,"184.173.217.40",443,9,552,6,372,3,180,48889.095372,1.3081309999979567,2275.001509791182,1100.8071821570236
"147.32.84.165",18096,"184.173.217.40",443,9,552,6,372,3,180,48891.398697,1.3083840000035707,2274.5615965892875,1100.5943209303005
"147.32.84.165",18097,"184.173.217.40",443,9,552,6,372,3,180,48893.702335,1.3080169999957434,2275.199787166134,1100.9031228223228
"147.32.84.165",18098,"184.173.217.40",443,9,552,6,372,3,180,48896.005152,1.3078940000050352,2275.413756763578,1101.0066564985054
"147.32.84.165",18099,"184.173.217.40",443,9,552,6,372,3,180,48898.308599,1.3079639999996289,2275.291980513871,1100.9477325067116
"147.32.84.165",18100,"184.173.217.40",443,9,552,6,372,3,180,48900.611872,1.3082979999962845,2274.711113223785,1100.6666676889283
"147.32.84.165",18101,"184.173.217.40",443,9,552,6,372,3,180,48902.915524,1.307875000005879,2275.446812567426,1101.022651242303
"147.32.84.165",18102,"184.173.217.40",443,9,552,6,372,3,180,48905.218648,1.3076639999999315,2275.8139705613644,1101.200308336144
"147.32.84.165",18103,"216.157.130.15",25,6,372,6,372,0,0,48905.880037,9.01246700000047,330.2092534707583,0
"147.32.84.165",18104,"184.173.217.40",443,9,552,6,372,3,180,48907.522359,1.3078559999994468,2275.4798693443763,1101.0386464569563
"147.32.84.165",18105,"184.173.217.40",443,9,552,6,372,3,180,48909.825396,1.3075519999983953,2276.008908252714,1101.2946330255065
"147.32.84.165",18106,"184.173.217.40",443,9,552,6,372,3,180,48912.128442,1.30787699999928,2275.4433329752246,1101.0209675686572
"147.32.84.165",18107,"184.173.217.40",443,9,552,6,372,3,180,48914.432363,1.3078049999967334,2275.568605417041,1101.0815832663102
"147.32.84.165",18108,"184.173.217.40",443,9,552,6,372,3,180,48916.73504,1.3077029999985825,2275.7460983137807,1101.1674669260228
"147.32.84.165",18109,"184.173.217.40",443,9,552,6,372,3,180,48919.038715,1.3080750000008265,2275.0989048778697,1100.8543088118724
"147.32.84.165",18110,"184.173.217.40",443,9,552,6,372,3,180,48921.341893,1.3076900000014575,2275.768721942267,1101.1784138430323
"147.32.84.165",18111,"184.173.217.40",443,9,552,6,372,3,180,48923.645124,1.3081969999984722,2274.886733422776,1100.751645204569
"147.32.84.165",18112,"184.173.217.40",443,9,552,6,372,3,180,48925.948349,1.3081500000043889,2274.968466911299,1100.7911936667574
"147.32.84.165",18113,"184.173.217.40",443,9,552,6,372,3,180,48928.252186,1.3076160000055097,2275.897511186358,1101.2407312192054
"147.32.84.165",18114,"184.173.217.40",443,9,552,6,372,3,180,48930.555183,1.3077740000007907,2275.6225464019017,1101.1076837428557
"147.32.84.165",18115,"184.173.217.40",443,9,552,6,372,3,180,48932.858416,1.3076029999938328,2275.920137850736,1101.2516796051948
"147.32.84.165",18116,"184.173.217.40",443,9,552,6,372,3,180,48935.162073,1.3079710000019986,2275.2798036007316,1100.941840451967
"147.32.84.165",18117,"184.173.217.40",443,9,552,6,372,3,180,48937.465178,1.3073760000042967,2276.315306377216,1101.442890182524
"147.32.84.165",18118,"184.173.217.40",443,9,552,6,372,3,180,48939.768417,1.3076120000041556,2275.904473185121,1101.2440999282844
"147.32.84.165",18119,"184.173.217.40",443,9,552,6,372,3,180,48942.071968,1.3075390000012703,2276.031537106816,1101.3055824710398
"147.32.84.165",18120,"184.173.217.40",443,9,552,6,372,3,180,48944.375195,1.307227999997849,2276.5730232254027,1101.5675918832594
"147.32.84.165",18121,"184.173.217.40",443,9,552,6,372,3,180,48946.678459,1.3074740000010934,2276.144688152507,1101.3603329770197
"147.32.84.165",18122,"184.173.217.40",443,9,552,6,372,3,180,48948.981889,1.3077080000002752,2275.7373970331096,1101.163256628924
"147.32.84.165",18123,"184.173.217.40",443,9,552,6,372,3,180,48951.285137,1.3074699999997392,2276.1516516635897,1101.3637024178659
"147.32.84.165",18124,"184.173.217.40",443,9,552,6,372,3,180,48953.588143,1.307978999997431,2275.2658873008245,1100.9351067584635
"147.32.84.165",18125,"184.173.217.40",443,9,552,6,372,3,180,48955.891775,1.3074330000017653,2276.2160661356884,1101.394870710817
"147.32.84.165",18126,"184.173.217.40",443,9,552,6,372,3,180,48958.194867,1.3080669999981183,2275.112819147858,1100.8610415231572
"147.32.84.165",18127,"184.173.217.40",443,9,552,6,372,3,180,48960.498042,1.3077649999977439,2275.6382071741746,1101.1152615358908
"147.32.84.165",18128,"184.173.217.40",443,9,552,6,372,3,180,48962.801584,1.3080189999964205,2275.1963083167325,1100.9014395080965
"147.32.84.165",18129,"184.173.217.40",443,9,552,6,372,3,180,48965.104786,1.3080809999955818,2275.088469299724,1100.8492593385758
"147.32.84.165",18130,"184.173.217.40",443,9,552,6,372,3,180,48967.408214,1.3079670000006445,2275.2867618208516,1100.9452073326702
"147.32.84.165",18131,"184.173.217.40",443,9,552,6,372,3,180,48969.711368,1.3075920000046608,2275.939283805187,1101.2609437767035
"147.32.84.165",18132,"184.173.217.40",443,9,552,6,372,3,180,48972.014731,1.3080669999981183,2275.112819147858,1100.8610415231572
"147.32.84.165",18133,"184.173.217.40",443,9,552,6,372,3,180,48974.317948,1.3077769999945303,2275.617326205039,1101.1051578411477
"147.32.84.165",18134,"184.173.217.40",443,9,552,6,372,3,180,48976.621234,1.3080550000013318,2275.133690859306,1100.8711407383742
"147.32.84.165",18135,"184.173.217.40",443,9,552,6,372,3,180,48978.924832,1.3073550000044634,2276.3518707541866,1101.4605826229936
"147.32.84.165",18136,"184.173.217.40",443,9,552,6,372,3,180,48981.228265,1.3074160000032862,2276.2456631955856,1101.4091918688318
"147.32.84.165",18137,"184.173.217.40",443,9,552,6,372,3,180,48983.53103,1.3084290000042529,2274.4833689793845,1100.5564688609925
"147.32.84.165",18138,"184.173.217.40",443,9,552,6,372,3,180,48985.834346,1.308350999999675,2274.6189669291643,1100.6220807721763
"147.32.84.165",18139,"184.173.217.40",443,9,552,6,372,3,180,48988.13795,1.3082510000022012,2274.7928340929934,1100.7062100449969
"147.32.84.165",18140,"184.173.217.40",443,9,552,6,372,3,180,48990.441284,1.3074239999987185,2276.2317350782278,1101.4024524572071
"147.32.84.165",18141,"184.173.217.40",443,9,552,6,372,3,180,48992.744541,1.3081579999998212,2274.9545544195785,1100.784461815925
"147.32.84.165",18142,"184.173.217.40",443,9,552,6,372,3,180,48995.047596,1.3084400000007008,2274.4642474996226,1100.5472165320755
"147.32.84.165",18143,"184.173.217.40",443,9,552,6,372,3,180,48997.351553,1.3077629999970668,2275.641687375063,1101.1169455040629
"147.32.84.165",18144,"184.173.217.40",443,9,552,6,372,3,180,48999.654429,1.3076289999953588,2275.8748850098636,1101.2297830692887
"147.32.84.165",18145,"184.173.217.40",443,9,552,6,372,3,180,49001.95789,1.3077230000053532,2275.711293590323,1101.1506259308012
"147.32.84.165",18146,"184.173.217.40",443,9,552,6,372,3,180,49004.260975,1.307875000005879,2275.446812567426,1101.022651242303
"147.32.84.165",18147,"184.173.217.40",443,9,552,6,372,3,180,49006.564539,1.308086999997613,2275.0780338046557,1100.8442099054785
"147.32.84.165",18148,"184.173.217.40",443,9,552,6,372,3,180,49008.867841,1.3080300000001444,2275.1771748351885,1100.8921813718655
"147.32.84.165",18149,"184.173.217.40",443,9,552,6,372,3,180,49011.171029,1.307570000004489,2275.97757671848,1101.2794726057161
"147.32.84.165",18150,"184.173.217.40",443,9,552,6,372,3,180,49013.474705,1.3073139999978594,2276.423261744977,1101.4951266507953
"147.32.84.165",18151,"184.173.217.40",443,9,552,6,372,3,180,49015.777651,1.3077940000002855,2275.5877454701204,1101.0908445823163
"147.32.84.165",18152,"184.173.217.40",443,9,552,6,372,3,180,49018.080899,1.3083019999976386,2274.7041585240804,1100.6633025116519
"147.32.84.165",18153,"184.173.217.40",443,9,552,6,372,3,180,49020.384653,1.3076319999963744,2275.8696636425625,1101.22725660124
"147.32.84.165",18154,"184.173.217.40",443,9,552,6,372,3,180,49022.68772,1.3075119999994058,2276.07853694754,1101.328324329455
"147.32.84.165",18155,"184.173.217.40",443,9,552,6,372,3,180,49024.991333,1.307701999998244,2275.7478385778995,1101.168308989306
"147.32.84.165",18156,"184.173.217.40",443,9,552,6,372,3,180,49027.293945,1.3084380000000237,2274.4677241106924,1100.5488987632382
"147.32.84.165",18157,"184.173.217.40",443,9,552,6,372,3,180,49029.597882,1.3075820000012754,2275.9566895208845,1101.269365897202
"147.32.84.165",18158,"184.173.217.40",443,9,552,6,372,3,180,49031.900702,1.3078739999982645,2275.448552386506,1101.0234930902448
"147.32.84.165",18159,"184.173.217.40",443,9,552,6,372,3,180,49034.20412,1.3076440000004368,2275.8487784129366,1101.2171508449692
"147.32.84.165",18160,"184.173.217.40",443,9,552,6,372,3,180,49036.507346,1.307831999998598,2275.5216266333828,1101.0588515967981
"147.32.84.165",18161,"184.173.217.40",443,9,552,6,372,3,180,49038.810748,1.3080549999940558,2275.133690871962,1100.8711407444976
"147.32.84.165",18162,"184.173.217.40",443,9,552,6,372,3,180,49041.114297,1.3078709999972489,2275.4537718217316,1101.0260186234186
"147.32.84.165",18163,"184.173.217.40",443,9,552,6,372,3,180,49043.41776,1.3074080000005779,2276.259591496063,1101.4159313690627
"147.32.84.165",18164,"184.173.217.40",443,9,552,6,372,3,180,49045.720525,1.3077480000065407,2275.6677891957133,1101.1295754172806
"147.32.84.165",18165,"94.100.176.20",25,6,372,6,372,0,0,49047.202052,8.993534000001091,330.90440309667355,0
"147.32.84.165",18166,"184.173.217.40",443,9,552,6,372,3,180,49048.024186,1.3073349999976926,2276.3866950745237,1101.477433100576
"147.32.84.165",18167,"184.173.217.40",443,9,552,6,372,3,180,49050.327596,1.3076399999990826,2275.855740113554,1101.2205194097842
"147.32.84.165",18168,"184.173.217.40",443,9,552,6,372,3,180,49052.630619,1.3078679999962333,2275.4589912809024,1101.0285441681785
"147.32.84.165",18169,"184.173.217.40",443,9,552,6,372,3,180,49054.934113,1.3079699999943841,2275.2815431644285,1100.9426821763363
"147.32.84.165",18170,"184.173.217.40",443,9,552,6,372,3,180,49057.237646,1.3070609999995213,2276.8638954119892,1101.708336489672
"147.32.84.165",18171,"184.173.217.40",443,9,552,6,372,3,180,49059.540404,1.3080259999987902,2275.1841324276065,1100.8955479488418
"147.32.84.165",18172,"184.173.217.40",443,9,552,6,372,3,180,49061.843703,1.3082300000023679,2274.829349575085,1100.723878826654
"147.32.84.165",18173,"184.173.217.40",443,9,552,6,372,3,180,49064.147714,1.3071820000041043,2276.653136281448,1101.6063562652168
"147.32.84.165",18174,"184.173.217.40",443,9,552,6,372,3,180,49066.450545,1.3077059999995981,2275.7408775373933,1101.1649407439
"147.32.84.165",18175,"74.125.93.27",25,6,372,6,372,0,0,49068.213199,9.01314000000275,330.1845971547199,0
"147.32.84.165",18176,"184.173.217.40",443,9,552,6,372,3,180,49068.754028,1.307396999996854,2276.278743187541,1101.425198316552
"147.32.84.165",18177,"184.173.217.40",443,9,552,6,372,3,180,49071.057439,1.3072190000020782,2276.588697070092,1101.5751760016574
"147.32.84.165",18178,"184.173.217.40",443,9,552,6,372,3,180,49073.360851,1.3075060000046506,2276.0889816103445,1101.3333781985536
"147.32.84.165",18179,"184.173.217.40",443,9,552,6,372,3,180,49075.663953,1.3075059999973746,2276.08898162301,1101.3333782046823
"147.32.84.165",18180,"184.173.217.40",443,9,552,6,372,3,180,49077.967552,1.307221999995818,2276.5834724396627,1101.5726479546756
"147.32.84.165",18181,"184.173.217.40",443,9,552,6,372,3,180,49080.270676,1.3076119999968796,2275.9044731977847,1101.244099934412
"147.32.84.165",18182,"184.173.217.40",443,9,552,6,372,3,180,49082.573515,1.3082350000040606,2274.8206553033383,1100.7196719209703
"147.32.84.165",18183,"184.173.217.40",443,9,552,6,372,3,180,49084.876819,1.3080580000023474,2275.128472892379,1100.8686159156673
"147.32.84.165",18184,"184.173.217.40",443,9,552,6,372,3,180,49087.180533,1.3078060000043479,2275.5668654143706,1101.080741329534
"147.32.84.165",18185,"74.125.39.27",25,6,372,6,372,0,0,49089.243084,9.01332900000125,330.17767353211974,0
"147.32.84.165",18186,"184.173.217.40",443,9,552,6,372,3,180,49089.483454,1.3077249999987544,2275.707813189191,1101.1489418657375
"147.32.84.165",18187,"184.173.217.40",443,9,552,6,372,3,180,49091.786647,1.3084660000022268,2274.419052535515,1100.5253480010558
"147.32.84.165",18188,"184.173.217.40",443,9,552,6,372,3,180,49094.090632,1.3076599999985774,2275.8209320490323,1101.203676797919
"147.32.84.165",18189,"184.173.217.40",443,9,552,6,372,3,180,49096.39385,1.30751600000076,2276.071573883815,1101.3249551050717
"147.32.84.165",18190,"184.173.217.40",443,9,552,6,372,3,180,49098.696659,1.3078519999980927,2275.486828788227,1101.0420139297871
"147.32.84.165",18191,"184.173.217.40",443,9,552,6,372,3,180,49101.000244,1.3074559999949997,2276.176024287916,1101.375495623185
"147.32.84.165",18192,"184.173.217.40",443,9,552,6,372,3,180,49103.303443,1.307838000000629,2275.5111871642885,1101.0538002407845
"147.32.84.165",18193,"184.173.217.40",443,9,552,6,372,3,180,49105.607271,1.3074389999965206,2276.2056203065076,1101.3898162773423
"147.32.84.165",18194,"184.173.217.40",443,9,552,6,372,3,180,49107.909978,1.3080969999937224,2275.0606415382667,1100.8357942927096
"147.32.84.165",18195,"66.111.4.71",25,6,372,6,372,0,0,49110.173531,9.012563999996928,330.20569951026306,0
"147.32.84.165",18196,"184.173.217.40",443,9,552,6,372,3,180,49110.213653,1.3077009999979055,2275.74957884468,1101.1691510538774
"147.32.84.165",18197,"184.173.217.40",443,9,552,6,372,3,180,49112.516572,1.3081049999964307,2275.046727906491,1100.8290618902377
"147.32.84.165",18198,"184.173.217.40",443,9,552,6,372,3,180,49114.819904,1.3081529999981285,2274.963249714871,1100.7886692168731
"147.32.84.165",18199,"184.173.217.40",443,9,552,6,372,3,180,49117.123136,1.3077619999967283,2275.6434274794997,1101.1177874900804
"147.32.84.165",18200,"184.173.217.40",443,9,552,6,372,3,180,49119.426525,1.3080409999965923,2275.158041688107,1100.8829233974711
"147.32.84.165",18201,"173.192.170.88",80,30,4257,20,1646,10,2611,49121.213908,40.81577300000208,322.62037521620204,511.7629402730884
"147.32.84.165",18202,"184.173.217.40",443,9,552,6,372,3,180,49121.729903,1.3076950000031502,2275.760020488593,1101.1742034622225
"147.32.84.165",18203,"184.173.217.40",443,9,552,6,372,3,180,49124.033588,1.3075910000043223,2275.9410243647767,1101.2617859829566
"147.32.84.165",18204,"184.173.217.40",443,9,552,6,372,3,180,49126.336804,1.3075779999999213,2275.9636518817074,1101.2727347814714
"147.32.84.165",18206,"184.173.217.40",443,9,552,6,372,3,180,49128.639999,1.3080239999981131,2275.187611239773,1100.8972312450514
"147.32.84.165",18207,"184.173.217.40",443,9,552,6,372,3,180,49130.943339,1.3078890000033425,2275.422455569543,1101.010865598166
"147.32.84.165",18208,"216.157.130.15",25,6,372,6,372,0,0,49131.204014,9.023246999997355,329.8147551542003,0
"147.32.84.165",18209,"184.173.217.40",443,9,552,6,372,3,180,49133.246528,1.3081119999988005,2275.0345536182904,1100.8231711056244
"147.32.84.165",18210,"184.173.217.40",443,9,552,6,372,3,180,49135.550084,1.3072560000000522,2276.524261506454,1101.543997503123
"147.32.84.165",18212,"98.126.71.122",80,18,4863,14,1430,4,3433,49136.569348,17.768238000004203,643.8454955408237,1545.6794309032502
"147.32.84.165",18213,"195.113.232.88",80,21,7703,14,3864,7,3839,49137.445956,27.82875999999669,1110.793294419287,1103.606484802185
"147.32.84.165",18214,"195.113.232.96",80,13,2800,10,1778,3,1022,49137.585142,27.689760999994178,513.6916855296437,295.27159876900777
"147.32.84.165",18215,"184.173.217.40",443,9,552,6,372,3,180,49137.844453,1.3267550000018673,2243.066730478356,1085.3548695863014
"147.32.84.165",18216,"195.113.232.83",80,13,1928,10,1596,3,332,49138.118691,27.15639299999748,470.16553339764914,97.80385782457363
"147.32.84.165",18217,"77.238.175.247",80,14,2274,10,1276,4,998,49138.405811,0.44700700000248617,22836.331421976,17861.01783631038
"147.32.84.165",18218,"74.125.232.217",80,13,1871,10,1156,3,715,49138.416815,26.85847300000023,344.32337236744326,212.9681758155034
"147.32.84.165",18219,"68.67.179.212",80,16,2170,12,1370,4,800,49138.44318,10.88682699999481,1006.7212421034361,587.8664187465321
"147.32.84.165",18220,"64.236.79.229",80,14,2078,10,1378,4,700,49138.759575,0.3554280000025756,31016.12703534926,15755.652340162902
"147.32.84.165",18221,"64.236.79.229",80,14,2274,10,1560,4,714,49138.759954,0.35552199999801815,35103.312875348274,16066.516277563249
"147.32.84.165",18222,"64.236.79.229",80,14,2061,10,1404,4,657,49138.825165,0.3554479999947944,31599.558867019918,14786.973059567012
"147.32.84.165",18223,"77.238.167.32",80,13,2342,10,1390,3,952,49138.875886,0.13992799999687122,79469.44142879653,54427.99153972252
"147.32.84.165",18224,"64.236.79.229",80,14,2043,10,1386,4,657,49138.904944,0.3567399999956251,31081.459887133424,14733.419297147662
"147.32.84.165",18225,"77.238.175.247",80,14,3055,10,1368,4,1687,49138.970453,0.14324299999861978,76401.63917333099,94217.51848348639
"147.32.84.165",18226,"195.113.232.96",80,13,1965,10,1306,3,659,49139.018497,26.25714600000356,397.91072495078424,200.78343625005115
"147.32.84.165",18227,"74.217.252.37",80,12,2075,10,1278,2,797,49139.029344,26.24612199999683,389.5432628104538,242.93112712044734
"147.32.84.165",18228,"64.236.79.229",80,14,2089,10,1432,4,657,49139.087853,0.35572900000261143,32204.290344379853,14775.292427554165
"147.32.84.165",18229,"184.173.217.40",443,9,552,6,372,3,180,49140.16709,1.308099999994738,2275.055423906407,1100.8332696321324
"147.32.84.165",18230,"184.173.217.40",443,9,552,6,372,3,180,49142.47009,1.3081849999944097,2274.907600998878,1100.761742418812
"147.32.84.165",18231,"184.173.217.40",443,9,552,6,372,3,180,49144.77361,1.3073370000056457,2276.383212581873,1101.475748023487
"147.32.84.165",18232,"184.173.217.40",443,9,552,6,372,3,180,49147.077078,1.3076030000011087,2275.920137838072,1101.251679599067
"147.32.84.165",18233,"184.173.217.40",443,9,552,6,372,3,180,49149.380409,1.3072430000029271,2276.5469006094017,1101.5549519077751
"147.32.84.165",18234,"184.173.217.40",443,9,552,6,372,3,180,49151.68364,1.3075469999967027,2276.0176116097587,1101.2988443273025
"147.32.84.165",18235,"184.173.217.40",443,9,552,6,372,3,180,49153.987258,1.307502999996359,2276.094203996692,1101.33590515969
"147.32.84.165",18236,"184.173.217.40",443,9,552,6,372,3,180,49156.290265,1.3079719999950612,2275.2780640650085,1100.9409987411332
"147.32.84.165",18237,"184.173.217.40",443,9,552,6,372,3,180,49158.593917,1.3071760000020731,2276.6635862311427,1101.6114126924883
"147.32.84.165",18238,"184.173.217.40",443,9,552,6,372,3,180,49160.896829,1.3077730000004522,2275.624286477065,1101.108525714709
"147.32.84.165",18239,"173.192.170.88",80,11,1283,8,846,3,437,49161.829187,3.3533879999959026,2018.2573564431761,1042.5277361296312
"147.32.84.165",18240,"184.173.217.40",443,9,552,6,372,3,180,49163.200421,1.3073250000015832,2276.4041076215904,1101.485858526576
"147.32.84.165",18241,"184.173.217.40",443,9,552,6,372,3,180,49165.503295,1.3077579999953741,2275.6503879238567,1101.1211554470274
"147.32.84.165",18242,"184.173.217.40",443,9,552,6,372,3,180,49167.806877,1.3080409999965923,2275.158041688107,1100.8829233974711
"147.32.84.165",18243,"184.173.217.40",443,9,552,6,372,3,180,49170.110061,1.2077799999970011,2464.0249052040845,1192.2701154213312
"147.32.84.165",18244,"184.173.217.40",443,9,552,6,372,3,180,49172.313498,1.30775399999402,2275.657348410793,1101.1245234245773
"147.32.84.165",18245,"184.173.217.40",443,9,552,6,372,3,180,49174.61673,1.3076129999972181,2275.902732694101,1101.2432577552102
"147.32.84.165",18246,"184.173.217.40",443,9,552,6,372,3,180,49176.919793,1.3076639999999315,2275.8139705613644,1101.200308336144
"147.32.84.165",18247,"184.173.217.40",443,9,552,6,372,3,180,49179.223093,1.307797000001301,2275.5825254202596,1101.0883187517386
"147.32.84.165",18248,"184.173.217.40",443,9,552,6,372,3,180,49181.526402,1.3081319999982952,2274.9997706683107,1100.8063406459567
"147.32.84.165",18249,"184.173.217.40",443,9,552,6,372,3,180,49183.829793,1.3075240000034682,2276.0576478841735,1101.3182167181485
"147.32.84.165",18250,"184.173.217.40",443,9,552,6,372,3,180,49186.132765,1.3081630000015139,2274.9458591907555,1100.7802544471397
"147.32.84.165",18251,"184.173.217.40",443,9,552,6,372,3,180,49188.436268,1.3077990000019781,2275.579045400324,1101.0866348711247
"147.32.84.165",18252,"184.173.217.40",443,9,552,6,372,3,180,49190.739717,1.3078190000014729,2275.5442457990353,1101.0697963543719
"147.32.84.165",18253,"184.173.217.40",443,9,552,6,372,3,180,49193.04335,1.3078390000009676,2275.509447262085,1101.0529583526218
"147.32.84.165",18254,"184.173.217.40",443,9,552,6,372,3,180,49195.34622,1.3078279999972438,2275.5285863326612,1101.0622191932232
"147.32.84.165",18255,"184.173.217.40",443,9,552,6,372,3,180,49197.649374,1.3082329999961075,2274.824133016714,1100.7213546855066
"147.32.84.165",18256,"184.173.217.40",443,9,552,6,372,3,180,49199.95286,1.3080790000021807,2275.091947806699,1100.8509424871122
"147.32.84.165",18257,"184.173.217.40",443,9,552,6,372,3,180,49202.256387,1.3077849999972386,2275.603405763397,1101.098422143579
"147.32.84.165",18258,"184.173.217.40",443,9,552,6,372,3,180,49204.559533,1.3081559999991441,2274.958032529719,1100.7861447724447
"147.32.84.165",18259,"184.173.217.40",443,9,552,6,372,3,180,49206.862798,1.3077789999952074,2275.6138460786615,1101.1034739090298
"147.32.84.165",18260,"184.173.217.40",443,9,552,6,372,3,180,49209.166569,1.3077229999980773,2275.7112936029844,1101.150625936928
"147.32.84.165",18261,"184.173.217.40",443,9,552,6,372,3,180,49211.469881,1.3072140000003856,2276.5974048618837,1101.5793894492986
"147.32.84.165",18262,"184.173.217.40",443,9,552,6,372,3,180,49213.772878,1.3078979999991134,2275.4067977793507,1101.003289248073
"147.32.84.165",18263,"184.173.217.40",443,9,552,6,372,3,180,49216.076495,1.307583000001614,2275.9549489373344,1101.2685236793554
"147.32.84.165",18264,"184.173.217.40",443,9,552,6,372,3,180,49218.379283,1.3076599999985774,2275.8209320490323,1101.203676797919
"147.32.84.165",18265,"184.173.217.40",443,9,552,6,372,3,180,49220.682639,1.3078720000048634,2275.4520319946705,1101.0251767716147
"147.32.84.165",18266,"184.173.217.40",443,9,552,6,372,3,180,49222.986387,1.3070930000030785,2276.8081536608265,1101.6813646745936
"147.32.84.165",18267,"184.173.217.40",443,9,552,6,372,3,180,49225.289561,1.3077630000043428,2275.6416873624025,1101.1169454979367
"147.32.84.165",18268,"184.173.217.40",443,9,552,6,372,3,180,49227.592653,1.3080730000001495,2275.102383429411,1100.8559919819731
"147.32.84.165",18269,"184.173.217.40",443,9,552,6,372,3,180,49229.896195,1.3075079999980517,2276.0855000538695,1101.3316935744529
"147.32.84.165",18270,"184.173.217.40",443,9,552,6,372,3,180,49232.199342,1.3080750000008265,2275.0989048778697,1100.8543088118724
"147.32.84.165",18271,"184.173.217.40",443,9,552,6,372,3,180,49234.502957,1.3073050000020885,2276.438933527559,1101.5027097713996
"147.32.84.165",18272,"184.173.217.40",443,9,552,6,372,3,180,49236.80626,1.307039999999688,2276.90047741516,1101.7260374589482
"147.32.84.165",18273,"184.173.217.40",443,9,552,6,372,3,180,49239.109347,1.3073910000020987,2276.2891896878764,1101.430253074779
"147.32.84.165",18274,"184.173.217.40",443,9,552,6,372,3,180,49241.412292,1.3081549999988056,2274.9597715887776,1100.7869862526343
"147.32.84.165",18275,"184.173.217.40",443,9,552,6,372,3,180,49243.715933,1.307652000003145,2275.8348551394733,1101.2104137771644
"147.32.84.165",18276,"184.173.217.40",443,9,552,6,372,3,180,49246.019116,1.3081869999950868,2274.904123042942,1100.7600595369074
"147.32.84.165",18277,"184.173.217.40",443,9,552,6,372,3,180,49248.322313,1.307743000004848,2275.6764899441005,1101.1337854568228
"147.32.84.165",18278,"184.173.217.40",443,9,552,6,372,3,180,49250.626093,1.3078929999974207,2275.4154965321086,1101.007498321988
"147.32.84.165",18279,"184.173.217.40",443,9,552,6,372,3,180,49252.929546,1.3072660000034375,2276.506847108526,1101.5355711815448
"147.32.84.165",18280,"184.173.217.40",443,9,552,6,372,3,180,49255.232894,1.307371000002604,2276.324012077729,1101.447102618256
"147.32.84.165",18281,"184.173.217.40",443,9,552,6,372,3,180,49257.535389,1.3077910000065458,2275.5929655312693,1101.0933704183562
"147.32.84.165",18282,"184.173.217.40",443,9,552,6,372,3,180,49259.839079,1.307613000004494,2275.902732681437,1101.2432577490824
"147.32.84.165",18283,"184.173.217.40",443,9,552,6,372,3,180,49262.142188,1.3076450000007753,2275.847037994437,1101.2163087069855
"147.32.84.165",18284,"184.173.217.40",443,9,552,6,372,3,180,49264.446071,1.3076660000006086,2275.810489833501,1101.1986241129844
"147.32.84.165",18285,"184.173.217.40",443,9,552,6,372,3,180,49266.748607,1.3080300000001444,2275.1771748351885,1100.8921813718655
"147.32.84.165",18286,"184.173.217.40",443,9,552,6,372,3,180,49269.052177,1.3077000000048429,2275.7513191014596,1101.1699931136095
"147.32.84.165",18287,"184.173.217.40",443,9,552,6,372,3,180,49271.355455,1.308037000002514,2275.16499915085,1100.8862899117014
"147.32.84.165",18288,"94.100.176.20",25,6,372,6,372,0,0,49272.418072,9.01180100000056,330.2336569571182,0
"147.32.84.165",18289,"184.173.217.40",443,9,552,6,372,3,180,49273.658682,1.3078559999994468,2275.4798693443763,1101.0386464569563
"147.32.84.165",18290,"184.173.217.40",443,9,552,6,372,3,180,49275.962641,1.3071469999995315,2276.714095661059,1101.6358527392222
"147.32.84.165",18291,"184.173.217.40",443,9,552,6,372,3,180,49278.265398,1.308123999995587,2275.0136837257323,1100.8130727705156
"147.32.84.165",18292,"184.173.217.40",443,9,552,6,372,3,180,49280.568911,1.3078069999974105,2275.5651254396807,1101.0798994062973
"147.32.84.165",18293,"184.173.217.40",443,9,552,6,372,3,180,49282.872027,1.3078010000026552,2275.575565391033,1101.0849509956608
"147.32.84.165",18294,"184.173.217.40",443,9,552,6,372,3,180,49285.175715,1.3077269999994314,2275.7043327860433,1101.1472577996983
"147.32.84.165",18295,"184.173.217.40",443,9,552,6,372,3,180,49287.478992,1.3074020000058226,2276.2700378206137,1101.4209860422325
"147.32.84.165",18296,"184.173.217.40",443,9,552,6,372,3,180,49289.781969,1.307636999998067,2275.8609614169677,1101.2230458469198
"147.32.84.165",18297,"184.173.217.40",443,9,552,6,372,3,180,49292.085358,1.308178000006592,2274.9197739030956,1100.767632533756
"147.32.84.165",18298,"74.125.93.27",25,6,372,6,372,0,0,49293.447253,9.013364999998885,330.1763547798595,0
"147.32.84.165",18299,"184.173.217.40",443,9,552,6,372,3,180,49294.388559,1.3081729999976233,2274.928468945168,1100.7718398121779
"147.32.84.165",18300,"184.173.217.40",443,9,552,6,372,3,180,49296.692035,1.3082219999996596,2274.8432605481134,1100.7306099426357
"147.32.84.165",18301,"184.173.217.40",443,9,552,6,372,3,180,49298.9957,1.3070700000025681,2276.8482177650417,1101.7007505314716
"147.32.84.165",18302,"184.173.217.40",443,9,552,6,372,3,180,49301.298587,1.30803300000116,2275.1719566688002,1100.8896564526453
"147.32.84.165",18303,"184.173.217.40",443,9,552,6,372,3,180,49303.602176,1.3079260000013164,2275.358086005634,1100.979719034984
"147.32.84.165",18304,"184.173.217.40",443,9,552,6,372,3,180,49305.905518,1.3072069999980158,2276.6095958823025,1101.5852883301463
"147.32.84.165",18305,"184.173.217.40",443,9,552,6,372,3,180,49308.208981,1.3073179999992135,2276.4162965719056,1101.4917564057607
"147.32.84.165",18306,"184.173.217.40",443,9,552,6,372,3,180,49310.512039,1.3075360000002547,2276.0367592168936,1101.308109298497
"147.32.84.165",18307,"184.173.217.40",443,9,552,6,372,3,180,49312.815047,1.3080230000050506,2275.18935063719,1100.8980728889628
"147.32.84.165",18308,"74.125.39.27",25,6,372,6,372,0,0,49314.377142,9.013489000004483,330.17181249109194,0
"147.32.84.165",18309,"184.173.217.40",443,9,552,6,372,3,180,49315.118288,1.3082639999993262,2274.7702298630343,1100.6952725143715
"147.32.84.165",18310,"184.173.217.40",443,9,552,6,372,3,180,49317.421825,1.3075400000016089,2276.0297964087813,1101.3047401977974
"147.32.84.165",18311,"184.173.217.40",443,9,552,6,372,3,180,49319.725065,1.308288000000175,2274.7285001464525,1100.6750807160254
"147.32.84.165",18312,"184.173.217.40",443,9,552,6,372,3,180,49322.028444,1.3079299999953946,2275.3511273619224,1100.9763519493172
"147.32.84.165",18313,"184.173.217.40",443,9,552,6,372,3,180,49324.331651,1.307848999997077,2275.4920483990513,1101.0445395479283
"147.32.84.165",18314,"184.173.217.40",443,9,552,6,372,3,180,49326.634914,1.30754199999501,2276.026315033366,1101.3030556613062
"147.32.84.165",18315,"184.173.217.40",443,9,552,6,372,3,180,49328.93863,1.3074320000014268,2276.2178071186513,1101.3957131219279
"147.32.84.165",18316,"184.173.217.40",443,9,552,6,372,3,180,49331.241628,1.3077339999945252,2275.692151471522,1101.1413636152524
"147.32.84.165",18317,"184.173.217.40",443,9,552,6,372,3,180,49333.545243,1.3079690000013215,2275.2832827054717,1100.9435238897443
"147.32.84.165",18318,"66.111.4.71",25,6,372,6,372,0,0,49335.408122,9.012391999996908,330.212001431032,0
"147.32.84.165",18319,"184.173.217.40",443,9,552,6,372,3,180,49335.848151,1.307795000000624,2275.586005450839,1101.0900026375027
"147.32.84.165",18320,"184.173.217.40",443,9,552,6,372,3,180,49338.151405,1.3083760000008624,2274.5755042877877,1100.6010504618328
"147.32.84.165",18321,"184.173.217.40",443,9,552,6,372,3,180,49340.455338,1.307568000003812,2275.9810579574632,1101.281157076192
"147.32.84.165",18322,"184.173.217.40",443,9,552,6,372,3,180,49342.758155,1.3080709999994724,2275.1058619915893,1100.8576751572207
"147.32.84.165",18323,"184.173.217.40",443,9,552,6,372,3,180,49345.061459,1.3077860000048531,2275.6016657075056,1101.0975801810512
"147.32.84.165",18324,"184.173.217.40",443,9,552,6,372,3,180,49347.364646,1.308233999996446,2274.822394165023,1100.7205133056561
"147.32.84.165",18325,"184.173.217.40",443,9,552,6,372,3,180,49349.667915,1.3082720000020345,2274.7563197831737,1100.6885418305678
"147.32.84.165",18326,"184.173.217.40",443,9,552,6,372,3,180,49351.971355,1.3076179999989108,2275.8940302156125,1101.2390468785222
"147.32.84.165",18327,"184.173.217.40",443,9,552,6,372,3,180,49354.275045,1.3072069999980158,2276.6095958823025,1101.5852883301463
"147.32.84.165",18328,"216.157.130.15",25,6,372,6,372,0,0,49356.437969,9.012900000001537,330.1933894750294,0
"147.32.84.165",18329,"184.173.217.40",443,9,552,6,372,3,180,49356.577802,1.3081759999986389,2274.9232519195402,1100.769315444939
"147.32.84.165",18330,"184.173.217.40",443,9,552,6,372,3,180,49358.881851,1.3075660000031348,2275.9845392070956,1101.2828415518204
"147.32.84.165",18331,"184.173.217.40",443,9,552,6,372,3,180,49361.185215,1.3070819999993546,2276.827314584295,1101.690636089175
"147.32.84.165",18332,"184.173.217.40",443,9,552,6,372,3,180,49363.487834,1.3078959999984363,2275.4102772724727,1101.0049728737772
"147.32.84.165",18333,"184.173.217.40",443,9,552,6,372,3,180,49365.791195,1.3082530000028783,2274.7893564879673,1100.7045273328874
"147.32.84.165",18334,"184.173.217.40",443,9,552,6,372,3,180,49368.094444,1.3081489999967744,2274.9702059989636,1100.7920351607888
"147.32.84.165",18335,"184.173.217.40",443,9,552,6,372,3,180,49370.398101,1.3077520000006189,2275.660828657568,1101.1262074149522
"147.32.84.165",18336,"184.173.217.40",443,9,552,6,372,3,180,49372.701693,1.3072679999968386,2276.503364273582,1101.53388593883
"147.32.84.165",18337,"184.173.217.40",443,9,552,6,372,3,180,49375.004349,1.3080229999977746,2275.189350649846,1100.8980728950867
"147.32.84.165",18338,"184.173.217.40",443,9,552,6,372,3,180,49377.30831,1.3075079999980517,2276.0855000538695,1101.3316935744529
"147.32.84.165",18339,"184.173.217.40",443,9,552,6,372,3,180,49379.611406,1.2076689999958035,2464.251380146664,1192.3797000709665
"147.32.84.165",18340,"184.173.217.40",443,9,552,6,372,3,180,49381.814225,1.3079040000011446,2275.3963593638337,1100.9982384018551
"147.32.84.165",18341,"184.173.217.40",443,9,552,6,372,3,180,49384.118131,1.3075779999999213,2275.9636518817074,1101.2727347814714
"147.32.84.165",18342,"184.173.217.40",443,9,552,6,372,3,180,49386.420965,1.3078779999996186,2275.4415931767853,1101.0201257307026
"147.32.84.165",18343,"184.173.217.40",443,9,552,6,372,3,180,49388.724717,1.3076820000060252,2275.782644393888,1101.1851505131715
"147.32.84.165",18344,"184.173.217.40",443,9,552,6,372,3,180,49391.028091,1.3073930000027758,2276.2857075062216,1101.4285681481717
"147.32.84.165",18345,"184.173.217.40",443,9,552,6,372,3,180,49393.330737,1.308327000006102,2274.6606926144,1100.642270619871
"147.32.84.165",18346,"184.173.217.40",443,9,552,6,372,3,180,49395.634747,1.3076540000038221,2275.831374347726,1101.2087295230933
"147.32.84.165",18347,"184.173.217.40",443,9,552,6,372,3,180,49397.937608,1.3077290000001085,2275.700852393541,1101.1455737388103
"147.32.84.165",18348,"184.173.217.40",443,9,552,6,372,3,180,49400.240971,1.3074839999972028,2276.1272795738737,1101.3519094712292
"147.32.84.165",18349,"184.173.217.40",443,9,552,6,372,3,180,49402.544226,1.3077049999992596,2275.7426177935276,1101.1657828033199
"147.32.84.165",18350,"184.173.217.40",443,9,552,6,372,3,180,49404.847415,1.307916000005207,2275.375482820114,1100.9881368484423
"147.32.84.165",18351,"184.173.217.40",443,9,552,6,372,3,180,49407.151233,1.307308000003104,2276.433709571833,1101.500182050887
"147.32.84.165",18352,"184.173.217.40",443,9,552,6,372,3,180,49409.454342,1.307901000000129,2275.4015785596207,1101.0007638191714
"147.32.84.165",18353,"184.173.217.40",443,9,552,6,372,3,180,49411.757372,1.308242999999493,2274.8067446194273,1100.7129409448842
"147.32.84.165",18354,"184.173.217.40",443,9,552,6,372,3,180,49414.061174,1.3076430000000983,2275.850518834098,1101.217992984241
"147.32.84.165",18355,"184.173.217.40",443,9,552,6,372,3,180,49416.364313,1.30733400000463,2276.388436305841,1101.4782756318584
"147.32.84.165",18356,"184.173.217.40",443,9,552,6,372,3,180,49418.667468,1.307742999997572,2275.6764899567615,1101.1337854629492
"147.32.84.165",18357,"184.173.217.40",443,9,552,6,372,3,180,49420.970856,1.3073700000022654,2276.325753225822,1101.4479451092689
"147.32.84.165",18358,"173.192.170.88",80,6,372,6,372,0,0,49421.095073,8.948737000006076,332.5608965821634,0
"147.32.84.165",18359,"184.173.217.40",443,9,552,6,372,3,180,49423.274188,1.3079909999942174,2275.245013163819,1100.92500636959
"147.32.84.165",18360,"184.173.217.40",443,9,552,6,372,3,180,49425.577749,1.307533000006515,2276.0419813382696,1101.3106361314208
"147.32.84.165",18361,"184.173.217.40",443,9,552,6,372,3,180,49427.880706,1.3075359999929788,2276.036759229559,1101.3081093046253
"147.32.84.165",18362,"184.173.217.40",443,9,552,6,372,3,180,49430.183611,1.3079250000009779,2275.3598256763767,1100.98056081115
"147.32.84.165",18363,"184.173.217.40",443,9,552,6,372,3,180,49432.487027,1.3083989999940968,2274.5355201382963,1100.5817032927241
"147.32.84.165",18364,"184.173.217.40",443,9,552,6,372,3,180,49434.790337,1.3093789999984438,2272.8331522069143,1099.7579768743133
"147.32.84.165",18365,"184.173.217.40",443,9,552,6,372,3,180,49437.093537,1.3078220000024885,2275.539025948743,1101.0672706203597
"147.32.84.165",18366,"184.173.217.40",443,9,552,6,372,3,180,49439.396902,1.3084620000008726,2274.4260054919555,1100.5287123348173
"147.32.84.165",18367,"184.173.217.40",443,9,552,6,372,3,180,49441.700702,1.3073809999987134,2276.306600755961,1101.4386777851423
"147.32.84.165",18368,"173.192.170.88",80,6,372,6,372,0,0,49442.343721,8.830181000004814,337.0259341227974,0
"147.32.84.165",18369,"184.173.217.40",443,9,552,6,372,3,180,49444.003763,1.308273000002373,2274.7545810351526,1100.6877005008803
"147.32.84.165",18370,"184.173.217.40",443,9,552,6,372,3,180,49446.307302,1.3080130000016652,2275.2067448841954,1100.9064894600947
"147.32.84.165",18371,"184.173.217.40",443,9,552,6,372,3,180,49448.610139,1.3081210000018473,2275.0189011534844,1100.8155973323312
"147.32.84.165",18372,"184.173.217.40",443,9,552,6,372,3,180,49450.914076,1.3073480000020936,2276.3640591451044,1101.4664802315021
"147.32.84.165",18373,"184.173.217.40",443,9,552,6,372,3,180,49453.217464,1.307530999998562,2276.0454627869417,1101.3123207033589
"147.32.84.165",18374,"184.173.217.40",443,9,552,6,372,3,180,49455.520354,1.3078909999967436,2275.4189760518343,1101.009181960565
"147.32.84.165",18375,"184.173.217.40",443,9,552,6,372,3,180,49457.823666,1.307626000001619,2275.880106388459,1101.2323095428028
"147.32.84.165",18376,"184.173.217.40",443,9,552,6,372,3,180,49460.127162,1.3074689999994007,2276.1533925480176,1101.364544781299
"147.32.84.165",18377,"184.173.217.40",443,9,552,6,372,3,180,49462.430135,1.3083039999983157,2274.7006811901756,1100.66161993073
"147.32.84.165",18378,"184.173.217.40",443,9,552,6,372,3,180,49464.733641,1.3077740000007907,2275.6225464019017,1101.1076837428557
"147.32.84.165",18379,"184.173.217.40",443,9,552,6,372,3,180,49467.036936,1.3079890000008163,2275.248492149508,1100.9266897497619
"147.32.84.165",18380,"184.173.217.40",443,9,552,6,372,3,180,49469.340151,1.3076430000000983,2275.850518834098,1101.217992984241
"147.32.84.165",18381,"184.173.217.40",443,9,552,6,372,3,180,49471.64346,1.3081470000033733,2274.9736841443096,1100.7937181343432
"147.32.84.165",18382,"184.173.217.40",443,9,552,6,372,3,180,49473.947219,1.3075529999987339,2276.0071675892923,1101.2937907690123
"147.32.84.165",18383,"184.173.217.40",443,9,552,6,372,3,180,49476.250021,1.3081139999994775,2275.031075274165,1100.8214880358862
"147.32.84.165",18384,"184.173.217.40",443,9,552,6,372,3,180,49478.553514,1.3074039999992237,2276.266555710222,1101.4193011501075
"147.32.84.165",18385,"184.173.217.40",443,9,552,6,372,3,180,49480.85692,1.3074960000012652,2276.1063896158153,1101.3418014270076
"147.32.84.165",18386,"184.173.217.40",443,9,552,6,372,3,180,49483.159896,1.3077570000023115,2275.652128028938,1101.1219974333571
"147.32.84.165",18387,"184.173.217.40",443,9,552,6,372,3,180,49485.463548,1.3075749999989057,2275.9688736802786,1101.2752614581993
"147.32.84.165",18388,"184.173.217.40",443,9,552,6,372,3,180,49487.766534,1.3078580000001239,2275.476389638415,1101.0369627282653
"147.32.84.165",18389,"184.173.217.40",443,9,552,6,372,3,180,49490.070449,1.3072820000015781,2276.4789846386684,1101.5220893412911
"147.32.84.165",18390,"184.173.217.40",443,9,552,6,372,3,180,49492.373645,1.3079599999982747,2275.2989388084693,1100.951099423453
"147.32.84.165",18391,"184.173.217.40",443,9,552,6,372,3,180,49494.676901,1.307699999997567,2275.751319114122,1101.1699931197363
"147.32.84.165",18392,"184.173.217.40",443,9,552,6,372,3,180,49496.979678,1.308097999994061,2275.0589023249877,1100.8349527378973
"147.32.84.165",18393,"94.100.176.20",25,6,372,6,372,0,0,49497.760334,8.993782999998075,330.89524174650836,0
"147.32.84.165",18394,"184.173.217.40",443,9,552,6,372,3,180,49499.283652,1.3078300000051968,2275.525106465041,1101.0605353863102
"147.32.84.165",18395,"184.173.217.40",443,9,552,6,372,3,180,49501.586899,1.307093999996141,2276.8064117873587,1101.680521832593
"147.32.84.165",18396,"184.173.217.40",443,9,552,6,372,3,180,49503.889906,1.307849000004353,2275.492048386392,1101.0445395418028
"147.32.84.165",18397,"184.173.217.40",443,9,552,6,372,3,180,49506.193517,1.3078460000033374,2275.4972680211627,1101.0470651715304
"147.32.84.165",18398,"184.173.217.40",443,9,552,6,372,3,180,49508.496325,1.3080990000016754,2275.0571631017133,1100.8341111782483
"147.32.84.165",18399,"184.173.217.40",443,9,552,6,372,3,180,49510.799565,1.308006999999634,2275.2171815600627,1100.9115394645464
"147.32.84.165",18400,"184.173.217.40",443,9,552,6,372,3,180,49513.103309,1.3074300000007497,2276.2212890925657,1101.3973979480159
"147.32.84.165",18401,"184.173.217.40",443,9,552,6,372,3,180,49515.406713,1.3077010000051814,2275.7495788320175,1101.1691510477506
"147.32.84.165",18402,"184.173.217.40",443,9,552,6,372,3,180,49517.709528,1.3077750000011292,2275.6208063293993,1101.10684177229
"147.32.84.165",18403,"74.125.93.27",25,6,372,6,372,0,0,49518.771124,9.013253000004624,330.18045759932323,0
"147.32.84.165",18404,"184.173.217.40",443,9,552,6,372,3,180,49520.012968,1.3083419999966281,2274.634613891222,1100.6296518828497
"147.32.84.165",18405,"184.173.217.40",443,9,552,6,372,3,180,49522.316212,1.3083259999984875,2274.6624312315435,1100.6431118862308
"147.32.84.165",18406,"184.173.217.40",443,9,552,6,372,3,180,49524.620054,1.3075559999997495,2276.0019456150026,1101.2912640072593
"147.32.84.165",18407,"184.173.217.40",443,9,552,6,372,3,180,49526.923057,1.3078999999997905,2275.4033182968706,1101.0016056275178
"147.32.84.165",18408,"184.173.217.40",443,9,552,6,372,3,180,49529.226469,1.3079040000011446,2275.3963593638337,1100.9982384018551
"147.32.84.165",18409,"184.173.217.40",443,9,552,6,372,3,180,49531.52945,1.3083629999964614,2274.598104660594,1100.6119861260938
"147.32.84.165",18410,"184.173.217.40",443,9,552,6,372,3,180,49533.833235,1.3077420000045095,2275.6782301017615,1101.1346274685943
"147.32.84.165",18411,"184.173.217.40",443,9,552,6,372,3,180,49536.136091,1.3082290000020294,2274.831088437409,1100.7247202116496
"147.32.84.165",18412,"184.173.217.40",443,9,552,6,372,3,180,49538.439608,1.3079060000018217,2275.3928799132773,1100.9965547967472
"147.32.84.165",18413,"74.125.39.27",25,6,372,6,372,0,0,49539.801379,9.01342800000566,330.17404698835236,0
"147.32.84.165",18414,"184.173.217.40",443,9,552,6,372,3,180,49540.743214,1.307237000000896,2276.557349583863,1101.5600078631596
"147.32.84.165",18415,"184.173.217.40",443,9,552,6,372,3,180,49543.046584,1.3079389999984414,2275.3354705407105,1100.9687760680856
"147.32.84.165",18416,"184.173.217.40",443,9,552,6,372,3,180,49545.349485,1.308009000000311,2275.2137026574683,1100.9098561245814
"147.32.84.165",18417,"184.173.217.40",443,9,552,6,372,3,180,49547.652622,1.3082680000006803,2274.763274801839,1100.69190716218
"147.32.84.165",18418,"184.173.217.40",443,9,552,6,372,3,180,49549.955923,1.307937999998103,2275.3372101768714,1100.9696178275183
"147.32.84.165",18419,"184.173.217.40",443,9,552,6,372,3,180,49552.259603,1.307316999998875,2276.4180378611777,1101.492598965086
"147.32.84.165",18420,"184.173.217.40",443,9,552,6,372,3,180,49554.562521,1.3083160000023781,2274.6798174100068,1100.6515245532291
"147.32.84.165",18421,"184.173.217.40",443,9,552,6,372,3,180,49556.865943,1.307596000006015,2275.932321593451,1101.2575749645732
"147.32.84.165",18422,"184.173.217.40",443,9,552,6,372,3,180,49559.169719,1.3071500000005472,2276.7088704423777,1101.6333244076022
"147.32.84.165",18423,"66.111.4.71",25,6,372,6,372,0,0,49560.832274,9.01221500000247,330.21848679810506,0
"147.32.84.165",18424,"184.173.217.40",443,9,552,6,372,3,180,49561.472728,1.3080110000009881,2275.2102237655126,1100.9081727897642
"147.32.84.165",18425,"184.173.217.40",443,9,552,6,372,3,180,49563.775955,1.3079740000030142,2275.274584963571,1100.9393153049537
"147.32.84.165",18426,"184.173.217.40",443,9,552,6,372,3,180,49566.079442,1.307835999999952,2275.514666976677,1101.0554840209727
"147.32.84.165",18427,"184.173.217.40",443,9,552,6,372,3,180,49568.382557,1.3081850000016857,2274.907600986225,1100.7617424126897
"147.32.84.165",18428,"184.173.217.40",443,9,552,6,372,3,180,49570.685871,1.3077720000001136,2275.62602655489,1101.10936768785
"147.32.84.165",18429,"184.173.217.40",443,9,552,6,372,3,180,49572.989216,1.3076359999977285,2275.8627018567627,1101.2238879952076
"147.32.84.165",18430,"184.173.217.40",443,9,552,6,372,3,180,49575.292286,1.3082289999947534,2274.831088450061,1100.7247202177716
"147.32.84.165",18431,"184.173.217.40",443,9,552,6,372,3,180,49577.596173,1.3072220000030939,2276.5834724269916,1101.5726479485443
"147.32.84.165",18432,"184.173.217.40",443,9,552,6,372,3,180,49579.899382,1.3076959999962128,2275.7582802185057,1101.173361396051
"147.32.84.165",18433,"216.157.130.15",25,6,372,6,372,0,0,49581.862074,8.9127820000067,333.9024784851422,0
"147.32.84.165",18434,"184.173.217.40",443,9,552,6,372,3,180,49582.202452,1.3076320000036503,2275.869663629899,1101.2272565951125
"147.32.84.165",18435,"184.173.217.40",443,9,552,6,372,3,180,49584.505844,1.3077699999994365,2275.6295067185224,1101.1110516379947
"147.32.84.165",18436,"184.173.217.40",443,9,552,6,372,3,180,49586.809553,1.307239000001573,2276.5538665817185,1101.5583225395412
"147.32.84.165",18437,"184.173.217.40",443,9,552,6,372,3,180,49589.112265,1.3090329999977257,2273.433901211941,1100.0486618767454
"147.32.84.165",18438,"184.173.217.40",443,9,552,6,372,3,180,49591.415499,1.3084219999946072,2274.495537381874,1100.5623567976809
"147.32.84.165",18439,"184.173.217.40",443,9,552,6,372,3,180,49593.719121,1.3074950000009267,2276.108130431008,1101.3426437569394
"147.32.84.165",18440,"184.173.217.40",443,9,552,6,372,3,180,49596.022794,1.3071940000008908,2276.6322366825216,1101.5962435560589
"147.32.84.165",18441,"184.173.217.40",443,9,552,6,372,3,180,49598.325898,1.30769099999452,2275.7669816588714,1101.1775717704215
"147.32.84.165",18442,"184.173.217.40",443,9,552,6,372,3,180,49600.62872,1.3085460000002058,2274.280002383968,1100.458065669662
"147.32.84.165",18443,"184.173.217.40",443,9,552,6,372,3,180,49602.93241,1.3076809999984107,2275.784384726563,1101.1859926096274
"147.32.84.165",18444,"184.173.217.40",443,9,552,6,372,3,180,49605.236046,1.307624000000942,2275.883587329275,1101.233993869004
"147.32.84.165",18445,"184.173.217.40",443,9,552,6,372,3,180,49607.538824,1.307941999999457,2275.330251648189,1100.9662507975108
"147.32.84.165",18446,"184.173.217.40",443,9,552,6,372,3,180,49609.842184,1.4079490000003716,2113.712925680699,1022.7643188777577
"147.32.84.165",18447,"184.173.217.40",443,9,552,6,372,3,180,49612.245561,1.3076569999975618,2275.8261531927324,1101.2062031577739
"147.32.84.165",18448,"184.173.217.40",443,9,552,6,372,3,180,49614.54892,1.3074809999961872,2276.1325021233033,1101.3544365112757
"147.32.84.165",18449,"184.173.217.40",443,9,552,6,372,3,180,49616.85278,1.3070999999981723,2276.7959605264796,1101.6754647708772
"147.32.84.165",18450,"184.173.217.40",443,9,552,6,372,3,180,49619.155808,1.3076119999968796,2275.9044731977847,1101.244099934412
"147.32.84.165",18451,"184.173.217.40",443,9,552,6,372,3,180,49621.458726,1.308498000005784,2274.363430426982,1100.498434077572
"147.32.84.165",18452,"184.173.217.40",443,9,552,6,372,3,180,49623.762541,1.3075500000049942,2276.012389574879,1101.2963175362318
"147.32.84.165",18453,"184.173.217.40",443,9,552,6,372,3,180,49626.065438,1.3081040000033681,2275.0484670885016,1100.8299034299203
"147.32.84.165",18454,"184.173.217.40",443,9,552,6,372,3,180,49628.368985,1.3079299999953946,2275.3511273619224,1100.9763519493172
"147.32.84.165",18455,"184.173.217.40",443,9,552,6,372,3,180,49630.672556,1.3076670000009472,2275.808749473562,1101.1977820033364
"147.32.84.165",18456,"184.173.217.40",443,9,552,6,372,3,180,49632.975999,1.30742299999838,2276.2334760851595,1101.4032948799158
"147.32.84.165",18457,"184.173.217.40",443,9,552,6,372,3,180,49635.27923,1.307795000000624,2275.586005450839,1101.0900026375027
"147.32.84.165",18458,"184.173.217.40",443,9,552,6,372,3,180,49637.582352,1.3077269999994314,2275.7043327860433,1101.1472577996983
"147.32.84.165",18459,"184.173.217.40",443,9,552,6,372,3,180,49639.885844,1.519865000002028,1958.0686442519757,947.4525697993431
"147.32.84.165",18460,"184.173.217.40",443,9,552,6,372,3,180,49642.399426,1.8616319999928237,1598.597359742136,773.5148514881303
"147.32.84.165",18461,"184.173.217.40",443,9,552,6,372,3,180,49645.253163,1.9143130000011297,1554.6047067528893,752.2280839126884
"147.32.84.165",18462,"184.173.217.40",443,9,552,6,372,3,180,49648.167718,1.9006490000028862,1565.7809516620275,757.6359443525939
"147.32.84.165",18463,"184.173.217.40",443,9,552,6,372,3,180,49651.061892,1.920347999999649,1549.7191134109776,749.864087134344
"147.32.84.165",18464,"184.173.217.40",443,9,552,6,372,3,180,49653.975527,1.8917939999955706,1573.1099686366317,761.1822428886927
"147.32.84.165",18465,"184.173.217.40",443,8,492,6,372,2,120,49656.860041,3.9209090000003926,759.0076688848688,244.841183511248
"147.32.84.165",18466,"184.173.217.40",443,8,492,6,372,2,120,49661.776674,4.115544000000227,723.1121815244438,233.26199404014318
"147.32.84.165",18467,"184.173.217.40",443,8,492,6,372,2,120,49666.884504,1.6018259999982547,1857.8796948003358,599.3160305807535
"147.32.84.165",18468,"184.173.217.40",443,9,552,6,372,3,180,49681.505428,1.447664999999688,2055.7242179652344,994.7052667573715
"147.32.84.165",18469,"184.173.217.40",443,9,552,6,372,3,180,49683.948827,1.3076549999968847,2275.8296339685085,1101.207887404117
"147.32.84.165",18470,"184.173.217.40",443,9,552,6,372,3,180,49686.252516,1.4091310000003432,2111.9399119026375,1021.9064089851471
"147.32.84.165",18471,"184.173.217.40",443,9,552,6,372,3,180,49688.65525,1.3082219999996596,2274.8432605481134,1100.7306099426357
"147.32.84.165",18472,"184.173.217.40",443,9,552,6,372,3,180,49690.958561,1.3083279999991646,2274.658954025214,1100.641429367039
"147.32.84.165",18473,"184.173.217.40",443,9,552,6,372,3,180,49693.262464,1.3075000000026193,2276.0994263816733,1101.3384321201645
"147.32.84.165",18474,"184.173.217.40",443,9,552,6,372,3,180,49695.565917,1.3072640000027604,2276.5103299667976,1101.5372564355473
"147.32.84.165",18475,"184.173.217.40",443,9,552,6,372,3,180,49697.868841,1.307887999995728,2275.424195351376,1101.0117074280852
"147.32.84.165",18476,"184.173.217.40",443,9,552,6,372,3,180,49700.172542,1.3076139999975567,2275.9009921930788,1101.2424155772962
"147.32.84.165",18477,"184.173.217.40",443,9,552,6,372,3,180,49702.4758,1.307780000002822,2275.6121060068044,1101.1026319387763
"147.32.84.165",18478,"184.173.217.40",443,9,552,6,372,3,180,49704.779077,1.3071100000015576,2276.778541971566,1101.6670364378544
"147.32.84.165",18479,"184.173.217.40",443,9,552,6,372,3,180,49707.081929,1.3075190000017756,2276.0663516139794,1101.3224282003125
"147.32.84.165",18480,"184.173.217.40",443,9,552,6,372,3,180,49709.385625,1.3075669999961974,2275.982798593613,1101.28199931949
"147.32.84.165",18481,"184.173.217.40",443,9,552,6,372,3,180,49711.689104,1.3072870000032708,2276.470277752746,1101.5178763319739
"147.32.84.165",18482,"184.173.217.40",443,9,552,6,372,3,180,49713.992095,1.3076179999989108,2275.8940302156125,1101.2390468785222
"147.32.84.165",18483,"184.173.217.40",443,9,552,6,372,3,180,49716.295133,1.3082460000005085,2274.801528152078,1100.7104168477797
"147.32.84.165",18484,"184.173.217.40",443,9,552,6,372,3,180,49718.598561,1.3077720000001136,2275.62602655489,1101.10936768785
"147.32.84.165",18485,"184.173.217.40",443,9,552,6,372,3,180,49720.902035,1.307992000001832,2275.2432736559795,1100.9241646722483
"147.32.84.165",18486,"173.192.170.88",80,43,6903,28,2568,15,4335,49721.109677,46.062254999997094,446.00508594295474,752.8940995181888
"147.32.84.165",18487,"94.100.176.20",25,6,372,6,372,0,0,49722.96512,8.912240999998176,333.9227473764017,0
"147.32.84.165",18488,"184.173.217.40",443,9,552,6,372,3,180,49723.205494,1.3077340000018012,2275.6921514588603,1101.1413636091258
"147.32.84.165",18489,"184.173.217.40",443,9,552,6,372,3,180,49725.508919,1.3081470000033733,2274.9736841443096,1100.7937181343432
"147.32.84.165",18490,"184.173.217.40",443,9,552,6,372,3,180,49727.811601,1.3079230000003008,2275.3633050258427,1100.9822443673434
"147.32.84.165",18492,"184.173.217.40",443,9,552,6,372,3,180,49730.115342,1.3078910000040196,2275.418976039176,1101.00918195444
"147.32.84.165",18493,"184.173.217.40",443,9,552,6,372,3,180,49732.418721,1.3075059999973746,2276.08898162301,1101.3333782046823
"147.32.84.165",18494,"184.173.217.40",443,9,552,6,372,3,180,49734.721843,1.3074029999988852,2276.26829677042,1101.4201435985904
"147.32.84.165",18495,"184.173.217.40",443,9,552,6,372,3,180,49737.025136,1.3080820000031963,2275.086730031243,1100.8484177570529
"147.32.84.165",18496,"184.173.217.40",443,9,552,6,372,3,180,49739.328725,1.298717999998189,2291.490531434961,1108.7857410169167
"147.32.84.165",18498,"98.126.71.122",80,18,4863,14,1430,4,3433,49739.750421,19.969495000004827,572.8737757262883,1375.2976727750683
"147.32.84.165",18499,"195.113.232.88",80,17,5745,12,2574,5,3171,49740.348585,19.371572000003653,1063.0009789601029,1309.5478260615719
"147.32.84.165",18500,"195.113.232.99",80,55,38462,44,3792,11,34670,49740.584132,19.136224999994738,1585.2656414736105,14493.97673784021
"147.32.84.165",18501,"184.173.217.40",443,9,552,6,372,3,180,49741.629445,1.306921000003058,2277.1077976350803,1101.8263536943937
"147.32.84.165",18502,"74.125.93.27",25,6,372,6,372,0,0,49743.893359,9.030547999995179,329.54810715823544,0
"147.32.84.165",18503,"184.173.217.40",443,9,552,6,372,3,180,49743.936806,1.3077269999994314,2275.7043327860433,1101.1472577996983
"147.32.84.165",18504,"184.173.217.40",443,9,552,6,372,3,180,49746.245192,1.307581000000937,2275.958430107097,1101.270208116337
"147.32.84.165",18505,"184.173.217.40",443,9,552,6,372,3,180,49748.553349,1.3067949999967823,2277.3273543343275,1101.9325908069327
"147.32.84.165",18506,"184.173.217.40",443,9,552,6,372,3,180,49750.860517,1.3066120000003139,2277.646309692001,1102.0869240445168
"147.32.84.165",18507,"184.173.217.40",443,9,552,6,372,3,180,49753.168289,1.3060269999987213,2278.666520679062,1102.5805745221269
"147.32.84.165",18508,"184.173.217.40",443,9,552,6,372,3,180,49755.47451,1.3076030000011087,2275.920137838072,1101.251679599067
"147.32.84.165",18509,"184.173.217.40",443,9,552,6,372,3,180,49757.781362,1.308218999998644,2274.8484772068628,1100.733134132353
"147.32.84.165",18510,"184.173.217.40",443,9,552,6,372,3,180,49760.100127,1.307689000001119,2275.7704622409865,1101.179255923058
"147.32.84.165",18511,"184.173.217.40",443,9,552,6,372,3,180,49762.403373,1.3085149999969872,2274.33388230693,1100.4841366001274
"147.32.84.165",18512,"184.173.217.40",443,9,552,6,372,3,180,49764.70693,1.307569999997213,2275.977576731145,1101.2794726118443
"147.32.84.165",18513,"74.125.39.27",25,6,372,6,372,0,0,49764.967115,8.913187999998627,333.88726906696667,0
"147.32.84.165",18514,"173.192.170.88",80,6,372,6,372,0,0,49766.971601,8.91131700000551,333.95737128397064,0
"147.32.84.165",18515,"184.173.217.40",443,9,552,6,372,3,180,49767.009897,1.30787699999928,2275.4433329752246,1101.0209675686572
"147.32.84.165",18516,"184.173.217.40",443,9,552,6,372,3,180,49769.313461,1.3074410000044736,2276.202138367863,1101.3881314683208
"147.32.84.165",18517,"184.173.217.40",443,9,552,6,372,3,180,49771.616438,1.308377000001201,2274.5737658161743,1100.6002092658907
"147.32.84.165",18518,"184.173.217.40",443,9,552,6,372,3,180,49773.91982,1.308350999999675,2274.6189669291643,1100.6220807721763
"147.32.84.165",18519,"184.173.217.40",443,9,552,6,372,3,180,49776.223499,1.3080639999971027,2275.1180370429825,1100.8635663111206
"147.32.84.165",18520,"184.173.217.40",443,9,552,6,372,3,180,49778.527454,1.3071509999936097,2276.70712872082,1101.6324816391066
"147.32.84.165",18521,"184.173.217.40",443,9,552,6,372,3,180,49780.830252,1.307626000001619,2275.880106388459,1101.2323095428028
"147.32.84.165",18522,"184.173.217.40",443,9,552,6,372,3,180,49783.133241,1.307662999999593,2275.8157109292883,1101.2011504496556
"147.32.84.165",18523,"184.173.217.40",443,9,552,6,372,3,180,49785.436588,1.3074740000010934,2276.144688152507,1101.3603329770197
"147.32.84.165",18524,"66.111.4.71",25,6,372,6,372,0,0,49785.897007,9.013400000003458,330.1750726694542,0
"147.32.84.165",18525,"184.173.217.40",443,9,552,6,372,3,180,49787.740197,1.307554999999411,2276.0036862704364,1101.2921062598887
"147.32.84.165",18526,"173.192.170.88",80,16,1583,12,1086,4,497,49787.901294,78.41133699999773,110.80030429783707,50.70695325600831
"147.32.84.165",18527,"184.173.217.40",443,9,552,6,372,3,180,49790.043594,1.3077759999941918,2275.619066272219,1101.1059998091382
"147.32.84.165",18528,"184.173.217.40",443,9,552,6,372,3,180,49792.346992,1.3070339999976568,2276.9109296355987,1101.7310949849673
"147.32.84.165",18529,"184.173.217.40",443,9,552,6,372,3,180,49794.649787,1.3081139999994775,2275.031075274165,1100.8214880358862
"147.32.84.165",18530,"184.173.217.40",443,9,552,6,372,3,180,49796.953167,1.3081210000018473,2275.0189011534844,1100.8155973323312
"147.32.84.165",18531,"184.173.217.40",443,9,552,6,372,3,180,49799.256469,1.308127999996941,2275.00672717575,1100.8097066979433
"147.32.84.165",18532,"184.173.217.40",443,9,552,6,372,3,180,49801.560055,1.3077369999955408,2275.6869309426497,1101.138837552895
"147.32.84.165",18534,"184.173.217.40",443,9,552,6,372,3,180,49803.863249,1.3080029999982798,2275.2241393971676,1100.9149061599198
"147.32.84.165",18535,"184.173.217.40",443,9,552,6,372,3,180,49806.166496,1.3080770000015036,2275.095426336966,1100.8526256469188
"147.32.84.165",18536,"216.157.130.15",25,6,372,6,372,0,0,49806.927967,9.012311999998929,330.214932638856,0
"147.32.84.165",18537,"184.173.217.40",443,9,552,6,372,3,180,49808.469863,1.3075559999997495,2276.0019456150026,1101.2912640072593
"147.32.84.165",18538,"184.173.217.40",443,9,552,6,372,3,180,49810.773019,1.3083090000000084,2274.691987901926,1100.6574135009319
"147.32.84.165",18539,"184.173.217.40",443,9,552,6,372,3,180,49813.076447,1.3077360000024782,2275.6886711036173,1101.1396795662665
"147.32.84.165",18541,"173.192.170.88",80,6,372,6,372,0,0,49813.789771,8.960661999997683,332.1183189367894,0
"147.32.84.165",18542,"184.173.217.40",443,9,552,6,372,3,180,49815.379936,1.3078979999991134,2275.4067977793507,1101.003289248073
"147.32.84.165",18543,"184.173.217.40",443,9,552,6,372,3,180,49817.682911,1.3079889999935403,2275.2484921621644,1100.926689755886
"147.32.84.165",18544,"184.173.217.40",443,9,552,6,372,3,180,49819.986518,1.3075910000043223,2275.9410243647767,1101.2617859829566
"147.32.84.165",18545,"184.173.217.40",443,9,552,6,372,3,180,49822.289297,1.308149999997113,2274.9684669239523,1100.7911936728801
"147.32.84.165",18546,"184.173.217.40",443,9,552,6,372,3,180,49824.593574,1.3073020000010729,2276.444157507261,1101.5052375035134
"147.32.84.165",18547,"184.173.217.40",443,9,552,6,372,3,180,49826.896206,1.307650000002468,2275.8383359418676,1101.2120980363875
"147.32.84.165",18548,"184.173.217.40",443,9,552,6,372,3,180,49829.199392,1.307742999997572,2275.6764899567615,1101.1337854629492
"147.32.84.165",18549,"184.173.217.40",443,9,552,6,372,3,180,49831.503055,1.3074569999953383,2276.1742833688686,1101.374653243001
"147.32.84.165",18550,"184.173.217.40",443,9,552,6,372,3,180,49833.806708,1.3073120000044582,2276.4267443348267,1101.4968117749163
"147.32.84.165",18551,"184.173.217.40",443,9,552,6,372,3,180,49836.109389,1.3076590000055148,2275.822672414941,1101.2045189104554
"147.32.84.165",18552,"184.173.217.40",443,9,552,6,372,3,180,49838.413053,1.307918000005884,2275.3720034334046,1100.9864532742279
"147.32.84.165",18553,"184.173.217.40",443,9,552,6,372,3,180,49840.716399,1.3096340000047348,2272.3906068330853,1099.543842016009
"147.32.84.165",18554,"184.173.217.40",443,9,552,6,372,3,180,49843.019601,1.307901000000129,2275.4015785596207,1101.0007638191714
"147.32.84.165",18555,"184.173.217.40",443,9,552,6,372,3,180,49845.32307,1.3075969999990775,2275.9305810598366,1101.256732770889
"147.32.84.165",18556,"173.192.170.88",80,6,372,6,372,0,0,49845.3243,8.970931999996537,331.73810703293134,0
"147.32.84.165",18557,"184.173.217.40",443,9,552,6,372,3,180,49847.626692,1.3069539999996778,2277.0503016944235,1101.798533077947
"147.32.84.165",18558,"184.173.217.40",443,9,552,6,372,3,180,49849.929387,1.3079510000025039,2275.3145951142687,1100.9586750552912
"147.32.84.165",18559,"184.173.217.40",443,9,552,6,372,3,180,49852.232335,1.3086889999976847,2274.031492589351,1100.337818994847
"147.32.84.165",18560,"184.173.217.40",443,9,552,6,372,3,180,49854.536206,1.308288000000175,2274.7285001464525,1100.6750807160254
"147.32.84.165",18561,"184.173.217.40",443,9,552,6,372,3,180,49856.839731,1.307782000003499,2275.6086258963937,1101.1009480143841
"147.32.84.165",18562,"184.173.217.40",443,9,552,6,372,3,180,49859.142354,1.3084079999971436,2274.519874539514,1100.5741328417005
"147.32.84.165",18563,"184.173.217.40",443,9,552,6,372,3,180,49861.445928,1.3075410000019474,2276.0280557134097,1101.3038979258436
"147.32.84.165",18564,"184.173.217.40",443,9,552,6,372,3,180,49863.749016,1.307608999995864,2275.9096947248095,1101.2466264797465
"147.32.84.165",18565,"184.173.217.40",443,9,552,6,372,3,180,49866.052546,1.3076950000031502,2275.760020488593,1101.1742034622225
"147.32.84.165",18566,"173.192.170.88",80,24,3151,20,2656,4,495,49866.316479,130.48388800000248,162.84002818799817,30.348574530519237
"147.32.84.165",18567,"184.173.217.40",443,9,552,6,372,3,180,49868.356202,1.307770999999775,2275.627766635376,1101.1102096622785
"147.32.84.165",18568,"184.173.217.40",443,9,552,6,372,3,180,49870.659605,1.3070569999981672,2276.870863324379,1101.7117080601836
"147.32.84.165",18569,"184.173.217.40",443,9,552,6,372,3,180,49872.962782,1.3072689999971772,2276.501622853771,1101.5330433163408
"147.32.84.165",18570,"184.173.217.40",443,9,552,6,372,3,180,49875.266178,1.3075260000041453,2276.0541664108896,1101.3165321343015
"147.32.84.165",18571,"184.173.217.40",443,9,552,6,372,3,180,49877.569476,1.307505000004312,2276.090722398909,1101.3342205156011
"147.32.84.165",18572,"184.173.217.40",443,9,552,6,372,3,180,49879.872153,1.3082530000028783,2274.7893564879673,1100.7045273328874
"147.32.84.165",18573,"184.173.217.40",443,9,552,6,372,3,180,49882.175662,1.3076509999955306,2275.8365955520026,1101.2112559122593
"147.32.84.165",18574,"184.173.217.40",443,9,552,6,372,3,180,49884.478946,1.3078219999952125,2275.5390259614032,1101.0672706264854
"147.32.84.165",18575,"184.173.217.40",443,9,552,6,372,3,180,49886.782584,1.3076660000006086,2275.810489833501,1101.1986241129844
"147.32.84.165",18576,"184.173.217.40",443,9,552,6,372,3,180,49889.085682,1.3074430000051507,2276.198656452538,1101.3864466705832
"147.32.84.165",18577,"184.173.217.40",443,9,552,6,372,3,180,49891.389233,1.3071599999966566,2276.6914532326664,1101.6248967254837
"147.32.84.165",18578,"184.173.217.40",443,9,552,6,372,3,180,49893.693002,1.3065829999977723,2277.696862736676,1102.1113851951657
"147.32.84.165",18579,"184.173.217.40",443,9,552,6,372,3,180,49895.995422,1.3083199999964563,2274.672862914318,1100.6481594746701
"147.32.84.165",18580,"184.173.217.40",443,9,552,6,372,3,180,49898.299271,1.3073409999997239,2276.376247666545,1101.472377903167
"147.32.84.165",18581,"184.173.217.40",443,9,552,6,372,3,180,49900.601989,1.308179999999993,2274.9162959225914,1100.7659496399638
"147.32.84.165",18582,"184.173.217.40",443,9,552,6,372,3,180,49902.905645,1.3076930000024731,2275.763501062078,1101.1758876106828
"147.32.84.165",18583,"184.173.217.40",443,9,552,6,372,3,180,49905.208847,1.3076969999965513,2275.756539938417,1101.1725193250406
"147.32.84.165",18584,"184.173.217.40",443,9,552,6,372,3,180,49907.512361,1.20774800000072,2464.0901909986405,1192.3017053219228
"147.32.84.165",18585,"184.173.217.40",443,9,552,6,372,3,180,49909.715724,1.3076539999965462,2275.831374360389,1101.2087295292206
"147.32.84.165",18586,"184.173.217.40",443,9,552,6,372,3,180,49912.018337,1.3081289999972796,2275.0049880449014,1100.808865183017
"147.32.84.165",18587,"184.173.217.40",443,9,552,6,372,3,180,49914.321836,1.3083759999935864,2274.5755043004365,1100.6010504679532
"147.32.84.165",18588,"184.173.217.40",443,9,552,6,372,3,180,49916.625642,1.3072790000005625,2276.484208802191,1101.5246171623505
"147.32.84.165",18589,"184.173.217.40",443,9,552,6,372,3,180,49918.928713,1.3072560000000522,2276.524261506454,1101.543997503123
"147.32.84.165",18590,"184.173.217.40",443,9,552,6,372,3,180,49921.232103,1.307463999997708,2276.1620970101026,1101.3687566177916
"147.32.84.165",18591,"184.173.217.40",443,9,552,6,372,3,180,49923.535494,1.307580999993661,2275.958430119761,1101.270208122465
"147.32.84.165",18592,"184.173.217.40",443,9,552,6,372,3,180,49925.838337,1.3079519999955664,2275.312855525346,1100.957833318716
"147.32.84.165",18593,"184.173.217.40",443,9,552,6,372,3,180,49928.14198,1.3076579999979003,2275.824412808837,1101.2053610365342
"147.32.84.165",18594,"184.173.217.40",443,9,552,6,372,3,180,49930.445163,1.3078530000057071,2275.485088910614,1101.041172053523
"147.32.84.165",18595,"184.173.217.40",443,9,552,6,372,3,180,49932.748519,1.30797000000166,2275.2815431517715,1100.942682170212
"147.32.84.165",18596,"184.173.217.40",443,9,552,6,372,3,180,49935.051461,1.30799599999591,2275.236315714502,1100.9207979263717
"147.32.84.165",18597,"184.173.217.40",443,9,552,6,372,3,180,49937.355387,1.307677999997395,2275.7896057025723,1101.1885188883414
"147.32.84.165",18598,"184.173.217.40",443,9,552,6,372,3,180,49939.65812,1.3083859999969718,2274.5581197038855,1100.592638566396
"147.32.84.165",18600,"184.173.217.40",443,9,552,6,372,3,180,49941.961344,1.308101999995415,2275.0519454984633,1100.8315865315146
"147.32.84.165",18601,"184.173.217.40",443,9,552,6,372,3,180,49944.264786,1.3077679999987595,2275.6329868927996,1101.1127355932902
"147.32.84.165",18602,"184.173.217.40",443,9,552,6,372,3,180,49946.568353,1.3074809999961872,2276.1325021233033,1101.3544365112757
"147.32.84.165",18603,"94.100.176.20",25,6,372,6,372,0,0,49948.253897,8.989732999994885,331.0443146644837,0
"147.32.84.165",18604,"184.173.217.40",443,9,552,6,372,3,180,49948.871509,1.3079170000055456,2275.373743125429,1100.9872950606914
"147.32.84.165",18606,"173.192.170.88",80,6,372,6,372,0,0,49949.870984,8.974589999997988,331.6028921656217,0
"147.32.84.165",18607,"184.173.217.40",443,9,552,6,372,3,180,49951.175056,1.3074970000016037,2276.1046488032857,1101.340959098364
"147.32.84.165",18608,"184.173.217.40",443,9,552,6,372,3,180,49953.47825,1.3081999999994878,2274.8815165885685,1100.7491209299524
"147.32.84.165",18609,"184.173.217.40",443,9,552,6,372,3,180,49955.782303,1.3067250000021886,2277.4493485584308,1101.9916202702084
"147.32.84.165",18610,"184.173.217.40",443,9,552,6,372,3,180,49958.084844,1.3079720000023372,2275.2780640523515,1100.9409987350089
"147.32.84.165",18611,"184.173.217.40",443,9,552,6,372,3,180,49960.388314,1.3078249999962281,2275.5338061350585,1101.0647449040605
"147.32.84.165",18612,"184.173.217.40",443,9,552,6,372,3,180,49962.691582,1.3080100000006496,2275.2119632101603,1100.9090144565293
"147.32.84.165",18613,"184.173.217.40",443,9,552,6,372,3,180,49964.994907,1.3078800000002957,2275.438113587888,1101.0184420586556
"147.32.84.165",18614,"184.173.217.40",443,9,552,6,372,3,180,49967.298138,1.3078680000035092,2275.458991268243,1101.0285441620533
"147.32.84.165",18615,"74.125.93.27",25,6,372,6,372,0,0,49969.260848,8.912597000002279,333.9094093449125,0
"147.32.84.165",18616,"184.173.217.40",443,9,552,6,372,3,180,49969.601271,1.3082389999981388,2274.8136999464423,1100.716306425698
"147.32.84.165",18617,"184.173.217.40",443,9,552,6,372,3,180,49971.904824,1.3075920000046608,2275.939283805187,1101.2609437767035
"147.32.84.165",18618,"184.173.217.40",443,9,552,6,372,3,180,49974.20811,1.307689000001119,2275.7704622409865,1101.179255923058
"147.32.84.165",18619,"173.192.170.88",80,6,372,6,372,0,0,49975.931466,8.851847999998427,336.20098311680556,0
"147.32.84.165",18620,"184.173.217.40",443,9,552,6,372,3,180,49976.511533,1.3076839999994263,2275.7791637745095,1101.1834663425045
"147.32.84.165",18621,"184.173.217.40",443,9,552,6,372,3,180,49978.814975,1.3072849999953178,2276.4737605117925,1101.5195615379641
"147.32.84.165",18622,"184.173.217.40",443,9,552,6,372,3,180,49981.118387,1.3073479999948177,2276.3640591577737,1101.4664802376324
"147.32.84.165",18623,"184.173.217.40",443,9,552,6,372,3,180,49983.421165,1.3082240000003367,2274.839782788906,1100.7289271559223
"147.32.84.165",18624,"184.173.217.40",443,9,552,6,372,3,180,49985.724634,1.3076670000009472,2275.808749473562,1101.1977820033364
"147.32.84.165",18625,"184.173.217.40",443,9,552,6,372,3,180,49988.028154,1.3074810000034631,2276.132502110637,1101.3544365051469
"147.32.84.165",18626,"74.125.39.27",25,6,372,6,372,0,0,49990.190767,9.013145999997505,330.18437735290473,0
"147.32.84.165",18627,"184.173.217.40",443,9,552,6,372,3,180,49990.331568,1.3074930000002496,2276.1116120693814,1101.3443284206685
"147.32.84.165",18628,"184.173.217.40",443,9,552,6,372,3,180,49992.634841,1.3074950000009267,2276.108130431008,1101.3426437569394
"147.32.84.165",18629,"184.173.217.40",443,9,552,6,372,3,180,49994.937623,1.3078700000041863,2275.455511626136,1101.0268604642592
"147.32.84.165",18630,"173.192.170.88",80,6,372,6,372,0,0,49996.801424,9.012032999999064,330.22515563361884,0
"147.32.84.165",18631,"184.173.217.40",443,9,552,6,372,3,180,49997.241408,1.3073939999958384,2276.2839664320572,1101.4277256929308
"147.32.84.165",18632,"184.173.217.40",443,9,552,6,372,3,180,49999.544105,1.3085730000020703,2274.233076790742,1100.4353597374559
"147.32.84.165",18633,"184.173.217.40",443,9,552,6,372,3,180,50001.848176,1.307699999997567,2275.751319114122,1101.1699931197363
"147.32.84.165",18634,"184.173.217.40",443,9,552,6,372,3,180,50004.151105,1.407615000003716,2114.214469149692,1023.0070012014638
"147.32.84.165",18635,"184.173.217.40",443,9,552,6,372,3,180,50006.555012,1.307568000003812,2275.9810579574632,1101.281157076192
"147.32.84.165",18636,"184.173.217.40",443,9,552,6,372,3,180,50008.858002,1.3075709999975516,2275.975836115647,1101.2786303785388
"147.32.84.165",18637,"184.173.217.40",443,9,552,6,372,3,180,50011.161114,1.3083960000003572,2274.5407353730734,1100.5842267934227
"147.32.84.165",18638,"66.111.4.71",25,6,372,6,372,0,0,50011.221326,9.012797000003047,330.19716298935765,0
"147.32.84.165",18639,"184.173.217.40",443,9,552,6,372,3,180,50013.4645,1.30803300000116,2275.1719566688002,1100.8896564526453
"147.32.84.165",18640,"184.173.217.40",443,9,552,6,372,3,180,50015.767491,1.3082460000005085,2274.801528152078,1100.7104168477797
"147.32.84.165",18642,"184.173.217.40",443,9,552,6,372,3,180,50018.071116,1.307966000000306,2275.288501382531,1100.9460490560634
"147.32.84.165",18643,"184.173.217.40",443,9,552,6,372,3,180,50020.374121,1.308249000001524,2274.7963117086524,1100.7078927622513
"147.32.84.165",18644,"173.192.170.88",80,6,372,6,372,0,0,50021.12353,8.924567000001844,333.461556174029,0
"147.32.84.165",18645,"184.173.217.40",443,9,552,6,372,3,180,50022.677819,1.307652000003145,2275.8348551394733,1101.2104137771644
"147.32.84.165",18646,"184.173.217.40",443,9,552,6,372,3,180,50024.981407,1.3075129999997444,2276.076796177615,1101.3274820214267
"147.32.84.165",18647,"184.173.217.40",443,9,552,6,372,3,180,50027.284792,1.307120000004943,2276.761123683171,1101.6586082337922
"147.32.84.165",18649,"173.192.170.88",80,6,372,6,372,0,0,50027.996823,8.961458999998285,332.08878152548255,0
"147.32.84.165",18650,"184.173.217.40",443,9,552,6,372,3,180,50029.5874,1.3078000000023167,2275.577305394348,1101.085792932749
"147.32.84.165",18651,"184.173.217.40",443,9,552,6,372,3,180,50031.891164,1.3078580000001239,2275.476389638415,1101.0369627282653
"147.32.84.165",18652,"216.157.130.15",25,6,372,6,372,0,0,50032.251314,9.013402999997197,330.1749627749836,0
"147.32.84.165",18653,"184.173.217.40",443,9,552,6,372,3,180,50034.194301,1.3080549999940558,2275.133690871962,1100.8711407444976
"147.32.84.165",18654,"184.173.217.40",443,9,552,6,372,3,180,50036.498116,1.307132999994792,2276.7384803320374,1101.6476517735666
"147.32.84.165",18655,"184.173.217.40",443,9,552,6,372,3,180,50038.801024,1.3076250000012806,2275.881846857536,1101.2331517052594
"147.32.84.165",18656,"184.173.217.40",443,9,552,6,372,3,180,50041.10422,1.3082250000006752,2274.83804391329,1100.7280857644953
"147.32.84.165",18657,"173.192.170.88",80,6,372,6,372,0,0,50042.06679,8.911624000000302,333.94586665684045,0
"147.32.84.165",18658,"184.173.217.40",443,9,552,6,372,3,180,50043.407746,1.307520000002114,2276.064610862693,1101.321585901303
"147.32.84.165",18659,"184.173.217.40",443,9,552,6,372,3,180,50045.71119,1.3071759999947972,2276.663586243815,1101.6114126986201
"147.32.84.165",18660,"184.173.217.40",443,9,552,6,372,3,180,50048.01401,1.3082980000035604,2274.7111132111345,1100.666667682807
"147.32.84.165",18661,"173.192.170.88",80,6,372,6,372,0,0,50050.197814,8.992676000001666,330.9359750089349,0
"147.32.84.165",18662,"184.173.217.40",443,9,552,6,372,3,180,50050.317683,1.3076319999963744,2275.8696636425625,1101.22725660124
"147.32.84.165",18663,"184.173.217.40",443,9,552,6,372,3,180,50052.620718,1.3081380000003264,2274.9893359869197,1100.801291606574
"147.32.84.165",18664,"184.173.217.40",443,9,552,6,372,3,180,50054.924811,1.3071770000024117,2276.6618445661984,1101.6105699513862
"147.32.84.165",18665,"184.173.217.40",443,9,552,6,372,3,180,50057.227095,1.308454999998503,2274.4381732680185,1100.534599968396
"147.32.84.165",18666,"184.173.217.40",443,9,552,6,372,3,180,50059.530514,1.3076460000011139,2275.8452975785995,1101.21546657029
"147.32.84.165",18667,"184.173.217.40",443,9,552,6,372,3,180,50061.834061,1.3075190000017756,2276.0663516139794,1101.3224282003125
"147.32.84.165",18668,"173.192.170.88",80,31,4741,22,2212,9,2529,50063.197009,51.04497799999808,346.6746523037127,396.35632715917245
"147.32.84.165",18669,"184.173.217.40",443,9,552,6,372,3,180,50064.137137,1.3080190000036964,2275.1963083040764,1100.9014395019726
"147.32.84.165",18670,"184.173.217.40",443,9,552,6,372,3,180,50066.440311,1.3082199999989825,2274.8467383179545,1100.7322927344942
"147.32.84.165",18671,"184.173.217.40",443,9,552,6,372,3,180,50068.744188,1.307555000006687,2276.0036862577717,1101.2921062537605
"147.32.84.165",18672,"184.173.217.40",443,9,552,6,372,3,180,50071.04745,1.3077200000043376,2275.7165142309736,1101.1531520472454
"147.32.84.165",18673,"173.192.170.88",80,6,372,6,372,0,0,50071.208484,9.012088999996195,330.2231036556848,0
"147.32.84.165",18674,"184.173.217.40",443,9,552,6,372,3,180,50073.350807,1.3074549999946612,2276.1777652096266,1101.376338004658
"147.32.84.165",18675,"184.173.217.40",443,9,552,6,372,3,180,50075.653895,1.3075039999966975,2276.0924632028023,1101.3350628400656
"147.32.84.165",18677,"184.173.217.40",443,9,552,6,372,3,180,50077.957578,1.3070890000017243,2276.8151212320463,1101.6847360800223
"147.32.84.165",18678,"184.173.217.40",443,9,552,6,372,3,180,50080.260859,1.3075119999994058,2276.07853694754,1101.328324329455
"147.32.84.165",18679,"184.173.217.40",443,9,552,6,372,3,180,50082.564122,1.307409999993979,2276.2561094176313,1101.4142464924023
"147.32.84.165",18680,"184.173.217.40",443,9,552,6,372,3,180,50084.867458,1.3073460000014165,2276.367541566483,1101.4681652741046
"147.32.84.165",18681,"184.173.217.40",443,9,552,6,372,3,180,50087.170768,1.3002869999982067,2288.725489068263,1107.447817291095
"147.32.84.165",18683,"98.126.71.122",80,18,4863,14,1430,4,3433,50087.556632,19.974521000003733,572.7296289106438,1374.9516196155525
"147.32.84.165",18684,"195.113.232.98",80,21,7917,14,3864,7,4053,50088.276281,19.255300000004354,1605.3761821416965,1683.900017137758
"147.32.84.165",18685,"195.113.232.89",80,13,2804,10,1782,3,1022,50088.413535,19.11824499999784,745.6751391145792,427.6543165965769
"147.32.84.165",18686,"195.113.232.99",80,13,2066,10,1694,3,372,50088.861402,18.669973999996728,725.8713911440035,159.4003291060031
"147.32.84.165",18687,"184.173.217.40",443,9,552,6,372,3,180,50089.470722,1.3128280000019004,2266.862071798965,1096.8687444188542
"147.32.84.165",18688,"184.173.217.40",443,9,552,6,372,3,180,50091.783829,1.3042310000018915,2281.8043736084205,1104.0988904556873
"147.32.84.165",18689,"184.173.217.40",443,9,552,6,372,3,180,50094.087985,1.30681700000423,2277.2890159757385,1101.9140399882606
"147.32.84.165",18690,"184.173.217.40",443,9,552,6,372,3,180,50096.39596,1.3072019999963231,2276.618303833968,1101.589501855146
"147.32.84.165",18691,"184.173.217.40",443,9,552,6,372,3,180,50098.703244,1.3077370000028168,2275.686930929988,1101.1388375467684
"147.32.84.165",18692,"184.173.217.40",443,9,552,6,372,3,180,50101.011704,1.2061850000027334,2467.283211110448,1193.8467150534427
"147.32.84.165",18693,"184.173.217.40",443,9,552,6,372,3,180,50103.218569,1.3067580000060843,2277.391835356006,1101.9637913012932
"147.32.84.165",18694,"184.173.217.40",443,9,552,6,372,3,180,50105.526036,1.3063459999975748,2278.1100872246134,1102.3113325280387
"147.32.84.165",18695,"184.173.217.40",443,9,552,6,372,3,180,50107.851673,1.2975450000012643,2293.5620729894536,1109.7880998336066
"147.32.84.165",18696,"184.173.217.40",443,9,552,6,372,3,180,50110.144889,1.3076559999972233,2275.8278935792896,1101.2070452803014
"147.32.84.165",18697,"184.173.217.40",443,9,552,6,372,3,180,50112.447894,1.3081900000033784,2274.8989061163247,1100.7575352175763
"147.32.84.165",18698,"173.192.170.88",80,15,1531,12,1094,3,437,50114.041661,42.42996999999741,206.26929502897443,82.39459042747882
"147.32.84.165",18699,"184.173.217.40",443,9,552,6,372,3,180,50114.75114,1.3078870000026654,2275.4259351105525,1101.0125492470415
"147.32.84.165",18700,"184.173.217.40",443,9,552,6,372,3,180,50117.054983,1.3074059999999008,2276.2630735978155,1101.4176162570075
"147.32.84.165",18701,"184.173.217.40",443,9,552,6,372,3,180,50119.358345,1.3078269999969052,2275.530326264133,1101.0630610955482
"147.32.84.165",18702,"184.173.217.40",443,9,552,6,372,3,180,50121.661233,1.3080570000020089,2275.1302122120287,1100.8694575219492
"147.32.84.165",18703,"184.173.217.40",443,9,552,6,372,3,180,50123.964647,1.3082300000023679,2274.829349575085,1100.723878826654
"147.32.84.165",18704,"184.173.217.40",443,9,552,6,372,3,180,50126.267902,1.3080800000025192,2275.090208545554,1100.8501009091392
"147.32.84.165",18705,"184.173.217.40",443,9,552,6,372,3,180,50128.571325,1.3076490000021295,2275.8400763470577,1101.212940167931
"147.32.84.165",18706,"184.173.217.40",443,9,552,6,372,3,180,50130.874497,1.3081040000033681,2275.0484670885016,1100.8299034299203
"147.32.84.165",18707,"184.173.217.40",443,9,552,6,372,3,180,50133.177715,1.3076270000019576,2275.878365922044,1101.2314673816343
"147.32.84.165",18708,"184.173.217.40",443,9,552,6,372,3,180,50135.481112,1.3077550000016345,2275.655608272406,1101.123681422132
"147.32.84.165",18709,"184.173.217.40",443,9,552,6,372,3,180,50137.784473,1.3074219999980414,2276.2352170947547,1101.4041373039136
"147.32.84.165",18710,"184.173.217.40",443,9,552,6,372,3,180,50140.087869,1.3077730000004522,2275.624286477065,1101.108525714709
"147.32.84.165",18711,"184.173.217.40",443,9,552,6,372,3,180,50142.391083,1.3081180000008317,2275.024118617822,1100.8181219118494
"147.32.84.165",18712,"184.173.217.40",443,9,552,6,372,3,180,50144.694402,1.3080130000016652,2275.2067448841954,1100.9064894600947
"147.32.84.165",18713,"184.173.217.40",443,9,552,6,372,3,180,50146.997976,1.3076270000019576,2275.878365922044,1101.2314673816343
"147.32.84.165",18714,"184.173.217.40",443,9,552,6,372,3,180,50149.300797,1.3123129999949015,2267.7516720565613,1097.2991961564007
"147.32.84.165",18715,"184.173.217.40",443,9,552,6,372,3,180,50151.614372,1.2983550000062678,2292.131196772557,1109.095740373818
"147.32.84.165",18716,"184.173.217.40",443,9,552,6,372,3,180,50153.90803,1.3073070000027656,2276.4354508877445,1101.501024623102
"147.32.84.165",18717,"184.173.217.40",443,9,552,6,372,3,180,50156.210788,1.307542000002286,2276.0263150207006,1101.3030556551778
"147.32.84.165",18718,"184.173.217.40",443,9,552,6,372,3,180,50158.514256,1.3081620000011753,2274.9475982312024,1100.7810959183237
"147.32.84.165",18719,"184.173.217.40",443,9,552,6,372,3,180,50160.817796,1.2073429999945802,2464.9167635157196,1192.7016597656707
"147.32.84.165",18720,"184.173.217.40",443,9,552,6,372,3,180,50163.020594,1.3080929999996442,2275.067598405319,1100.839160518703
"147.32.84.165",18721,"184.173.217.40",443,9,552,6,372,3,180,50165.324264,1.307619999999588,2275.8905492428516,1101.2373625368639
"147.32.84.165",18722,"184.173.217.40",443,9,552,6,372,3,180,50167.627867,1.3075239999961923,2276.057647896839,1101.318216724277
"147.32.84.165",18723,"184.173.217.40",443,9,552,6,372,3,180,50169.931171,1.306906000005256,2277.1339331122754,1101.8389998930365
"147.32.84.165",18724,"184.173.217.40",443,9,552,6,372,3,180,50172.234297,1.3078919999970822,2275.417236290641,1101.0083401406328
"147.32.84.165",18725,"94.100.176.20",25,6,372,6,372,0,0,50173.440327,8.9679810000016,331.8472686326464,0
"147.32.84.165",18726,"184.173.217.40",443,9,552,6,372,3,180,50174.537172,1.3080400000035297,2275.159781040312,1100.8837650195057
"147.32.84.165",18727,"184.173.217.40",443,9,552,6,372,3,180,50176.840639,1.3076589999982389,2275.8226724276037,1101.2045189165824
"147.32.84.165",18728,"184.173.217.40",443,9,552,6,372,3,180,50179.143952,1.3075989999997546,2275.9270999752666,1101.255048375129
"147.32.84.165",18729,"184.173.217.40",443,9,552,6,372,3,180,50181.447337,1.3078170000007958,2275.547725712534,1101.0714801834843
"147.32.84.165",18730,"184.173.217.40",443,9,552,6,372,3,180,50183.750708,1.3079349999970873,2275.3424291013143,1100.9721431135392
"147.32.84.165",18731,"184.173.217.40",443,9,552,6,372,3,180,50186.053748,1.3080279999994673,2275.1806536260783,1100.89386465778
"147.32.84.165",18732,"184.173.217.40",443,9,552,6,372,3,180,50188.356924,1.3077390000034939,2275.6834505907136,1101.1371535116355
"147.32.84.165",18733,"184.173.217.40",443,9,552,6,372,3,180,50190.660682,1.307569999997213,2275.977576731145,1101.2794726118443
"147.32.84.165",18734,"184.173.217.40",443,9,552,6,372,3,180,50192.964077,1.3076070000024629,2275.9131757434725,1101.2483108436156
"147.32.84.165",18735,"74.125.93.27",25,6,372,6,372,0,0,50194.425956,9.013114000001224,330.18554963352244,0
"147.32.84.165",18736,"184.173.217.40",443,9,552,6,372,3,180,50195.267231,1.308059000002686,2275.1267335753887,1100.8677743106718
"147.32.84.165",18737,"184.173.217.40",443,9,552,6,372,3,180,50197.570263,1.3081590000001597,2274.9528153684964,1100.783620339595
"147.32.84.165",18738,"184.173.217.40",443,9,552,6,372,3,180,50199.873596,1.3080950000003213,2275.0641199601473,1100.8374774000713
"147.32.84.165",18739,"184.173.217.40",443,9,552,6,372,3,180,50202.177266,1.307903000000806,2275.3980990931022,1100.9990802063398
"147.32.84.165",18740,"184.173.217.40",443,9,552,6,372,3,180,50204.480497,1.3078410000016447,2275.505967465661,1101.0512745801584
"147.32.84.165",18741,"184.173.217.40",443,9,552,6,372,3,180,50206.783639,1.308136999999988,2274.9910750938375,1100.8021331099214
"147.32.84.165",18742,"184.173.217.40",443,9,552,6,372,3,180,50209.087441,1.3072039999970002,2276.614820645308,1101.5878164412782
"147.32.84.165",18743,"184.173.217.40",443,9,552,6,372,3,180,50211.390703,1.3071490000002086,2276.7106121792735,1101.6341671835194
"147.32.84.165",18744,"184.173.217.40",443,9,552,6,372,3,180,50213.695101,1.306510000002163,2277.8241268685833,1102.1729646138308
"147.32.84.165",18745,"74.125.39.27",25,6,372,6,372,0,0,50215.456161,9.013191999998526,330.1826922138668,0
"147.32.84.165",18746,"184.173.217.40",443,9,552,6,372,3,180,50215.997375,1.30724100000225,2276.5503835902314,1101.5566372210797
"147.32.84.165",18747,"184.173.217.40",443,9,552,6,372,3,180,50218.300161,1.3080059999992955,2275.218921015349,1100.9123811364593
"147.32.84.165",18748,"184.173.217.40",443,9,552,6,372,3,180,50220.604043,1.3075210000024526,2276.062870114069,1101.3207436035818
"147.32.84.165",18749,"184.173.217.40",443,9,552,6,372,3,180,50222.906576,1.3080899999986286,2275.072816093021,1100.8416852063006
"147.32.84.165",18750,"184.173.217.40",443,9,552,6,372,3,180,50225.210588,1.3076639999999315,2275.8139705613644,1101.200308336144
"147.32.84.165",18751,"184.173.217.40",443,9,552,6,372,3,180,50227.513633,1.3075800000005984,2275.960170695971,1101.2710503367603
"147.32.84.165",18752,"184.173.217.40",443,9,552,6,372,3,180,50229.816714,1.30745300000126,2276.1812470483696,1101.3780227653401
"147.32.84.165",18753,"184.173.217.40",443,9,552,6,372,3,180,50232.120092,1.3080170000030193,2275.1997871534777,1100.903122816199
"147.32.84.165",18754,"184.173.217.40",443,9,552,6,372,3,180,50234.423203,1.3081270000038785,2275.008466296603,1100.8105482080337
"147.32.84.165",18755,"66.111.4.71",25,6,372,6,372,0,0,50236.386325,9.013184000003093,330.18298528011616,0
"147.32.84.165",18756,"184.173.217.40",443,9,552,6,372,3,180,50236.727193,1.307624000000942,2275.883587329275,1101.233993869004
"147.32.84.165",18757,"184.173.217.40",443,9,552,6,372,3,180,50239.030016,1.307741000004171,2275.679970262084,1101.1354694816537
"147.32.84.165",18758,"184.173.217.40",443,9,552,6,372,3,180,50241.33369,1.3070630000001984,2276.860411471787,1101.706650712155
"147.32.84.165",18759,"184.173.217.40",443,9,552,6,372,3,180,50243.63692,1.3071830000044429,2276.651394632492,1101.605513531851
"147.32.84.165",18760,"184.173.217.40",443,9,552,6,372,3,180,50245.940401,1.3075519999983953,2276.008908252714,1101.2946330255065
"147.32.84.165",18761,"184.173.217.40",443,9,552,6,372,3,180,50248.243329,1.3075360000002547,2276.0367592168936,1101.308109298497
"147.32.84.165",18762,"184.173.217.40",443,9,552,6,372,3,180,50250.546995,1.3071300000010524,2276.7437056739604,1101.6501801648196
"147.32.84.165",18763,"184.173.217.40",443,9,552,6,372,3,180,50252.84999,1.3073619999995572,2276.3396825064583,1101.45468508377
"147.32.84.165",18764,"184.173.217.40",443,9,552,6,372,3,180,50255.153494,1.3073090000034426,2276.4319682585856,1101.4993394799608
"147.32.84.165",18765,"216.157.130.15",25,6,372,6,372,0,0,50257.41665,9.012831000000006,330.1959173538257,0
"147.32.84.165",18766,"184.173.217.40",443,9,552,6,372,3,180,50257.456709,1.3079389999984414,2275.3354705407105,1100.9687760680856
"147.32.84.165",18767,"184.173.217.40",443,9,552,6,372,3,180,50259.759862,1.3075380000009318,2276.0332778075126,1101.3064247455704
"147.32.84.165",18768,"184.173.217.40",443,9,552,6,372,3,180,50262.063338,1.3078010000026552,2275.575565391033,1101.0849509956608
"147.32.84.165",18769,"184.173.217.40",443,9,552,6,372,3,180,50264.366247,1.307674000003317,2275.796567028519,1101.191887271864
"147.32.84.165",18770,"184.173.217.40",443,9,552,6,372,3,180,50266.66983,1.316023999999743,2261.3569357402152,1094.204968906556
"147.32.84.165",18771,"184.173.217.40",443,9,552,6,372,3,180,50268.982823,1.2981520000030287,2292.4896314091548,1109.2691764883007
"147.32.84.165",18772,"184.173.217.40",443,9,552,6,372,3,180,50271.276672,1.307373000003281,2276.3205297895333,1101.4454176400966
"147.32.84.165",18773,"184.173.217.40",443,9,552,6,372,3,180,50273.579463,1.308141000001342,2274.98411868212,1100.7987671042515
"147.32.84.165",18774,"60.190.223.75",888,13,3136,10,1236,3,1900,50274.493316,0.7545759999993606,13104.047836146894,20143.762854918365
"147.32.84.165",18775,"184.173.217.40",443,9,552,6,372,3,180,50275.883035,1.3076139999975567,2275.9009921930788,1101.2424155772962
"147.32.84.165",18776,"184.173.217.40",443,9,552,6,372,3,180,50278.186701,1.3075749999989057,2275.9688736802786,1101.2752614581993
"147.32.84.165",18777,"184.173.217.40",443,9,552,6,372,3,180,50280.48951,1.3079340000040247,2275.344168735458,1100.9729848719958
"147.32.84.165",18778,"184.173.217.40",443,9,552,6,372,3,180,50282.793126,1.3076080000028014,2275.911435226478,1101.247468657973
"147.32.84.165",18779,"184.173.217.40",443,9,552,6,372,3,180,50285.096243,1.3075279999975464,2276.050684960922,1101.3148475617365
"147.32.84.165",18780,"184.173.217.40",443,9,552,6,372,3,180,50287.399605,1.3076819999987492,2275.7826444065504,1101.1851505192985
"147.32.84.165",18781,"184.173.217.40",443,9,552,6,372,3,180,50289.702699,1.3079349999970873,2275.3424291013143,1100.9721431135392
"147.32.84.165",18782,"184.173.217.40",443,9,552,6,372,3,180,50292.005983,1.308288000000175,2274.7285001464525,1100.6750807160254
"147.32.84.165",18783,"184.173.217.40",443,9,552,6,372,3,180,50294.309195,1.3078299999979208,2275.525106477701,1101.060535392436
"147.32.84.165",18784,"184.173.217.40",443,9,552,6,372,3,180,50296.614198,1.3063309999997728,2278.136245714538,1102.323989861873
"147.32.84.165",18785,"184.173.217.40",443,9,552,6,372,3,180,50298.915949,1.307809999998426,2275.5599054935974,1101.0773736259341
"147.32.84.165",18786,"184.173.217.40",443,9,552,6,372,3,180,50301.219163,1.308192999997118,2274.8936892389397,1100.7550109220676
"147.32.84.165",18787,"184.173.217.40",443,9,552,6,372,3,180,50303.522848,1.3077629999970668,2275.641687375063,1101.1169455040629
"147.32.84.165",18788,"184.173.217.40",443,9,552,6,372,3,180,50305.825942,1.3076449999934994,2275.8470380071003,1101.216308713113
"147.32.84.165",18789,"184.173.217.40",443,9,552,6,372,3,180,50308.129703,1.307554999999411,2276.0036862704364,1101.2921062598887
"147.32.84.165",18790,"184.173.217.40",443,9,552,6,372,3,180,50310.432987,1.3073809999987134,2276.306600755961,1101.4386777851423
"147.32.84.165",18791,"184.173.217.40",443,9,552,6,372,3,180,50312.735942,1.3076179999989108,2275.8940302156125,1101.2390468785222
"147.32.84.165",18792,"184.173.217.40",443,9,552,6,372,3,180,50315.039108,1.3078680000035092,2275.458991268243,1101.0285441620533
"147.32.84.165",18793,"184.173.217.40",443,9,552,6,372,3,180,50317.34284,1.3079900000011548,2275.2467526490054,1100.9258480559704
"147.32.84.165",18794,"184.173.217.40",443,9,552,6,372,3,180,50319.646326,1.3073379999987083,2276.3814713585475,1101.4749054960712
"147.32.84.165",18795,"173.192.170.88",80,17,1726,12,1166,5,560,50321.160508,601.6444679999986,15.504173139010765,7.446258111360231
"147.32.84.165",18796,"184.173.217.40",443,9,552,6,372,3,180,50321.949213,1.307583000001614,2275.9549489373344,1101.2685236793554
"147.32.84.165",18797,"184.173.217.40",443,9,552,6,372,3,180,50324.252507,1.3081460000030347,2274.975423227297,1100.7945596261115
"147.32.84.165",18798,"184.173.217.40",443,9,552,6,372,3,180,50326.556364,1.3071320000017295,2276.7402221015645,1101.6484945652733
"147.32.84.165",18799,"184.173.217.40",443,9,552,6,372,3,180,50328.859673,1.3071150000032503,2276.769832794054,1101.6628223197035
"147.32.84.165",18800,"184.173.217.40",443,9,552,6,372,3,180,50331.162354,1.3081840000013472,2274.9093399681815,1100.7625838555716
"147.32.84.165",18801,"184.173.217.40",443,9,552,6,372,3,180,50333.466253,1.3071909999998752,2276.637461549448,1101.5987717174746
"147.32.84.165",18802,"184.173.217.40",443,9,552,6,372,3,180,50335.76908,1.3082639999993262,2274.7702298630343,1100.6952725143715
"147.32.84.165",18803,"184.173.217.40",443,9,552,6,372,3,180,50338.072555,1.3079060000018217,2275.3928799132773,1100.9965547967472
"147.32.84.165",18804,"184.173.217.40",443,9,552,6,372,3,180,50340.376068,1.307159000003594,2276.69319493024,1101.6257394823742
"147.32.84.165",18805,"184.173.217.40",443,9,552,6,372,3,180,50342.679224,1.3093010000011418,2272.96855344753,1099.8234936036436
"147.32.84.165",18806,"184.173.217.40",443,9,552,6,372,3,180,50344.982355,1.3081590000001597,2274.9528153684964,1100.783620339595
"147.32.84.165",18807,"184.173.217.40",443,9,552,6,372,3,180,50347.285901,1.3075129999997444,2276.076796177615,1101.3274820214267
"147.32.84.165",18808,"184.173.217.40",443,9,552,6,372,3,180,50349.588895,1.308004999998957,2275.220660473296,1100.9132228096591
"147.32.84.165",18809,"184.173.217.40",443,9,552,6,372,3,180,50351.892757,1.3070630000001984,2276.860411471787,1101.706650712155
"147.32.84.165",18810,"184.173.217.40",443,9,552,6,372,3,180,50354.195662,1.3076990000045043,2275.7530593735632,1101.1708351807563
"147.32.84.165",18811,"184.173.217.40",443,9,552,6,372,3,180,50356.498746,1.307847000003676,2275.4955281402454,1101.046223293667
"147.32.84.165",18812,"184.173.217.40",443,9,552,6,372,3,180,50358.802244,1.3081030000030296,2275.050206285826,1100.8307449770125
"147.32.84.165",18813,"184.173.217.40",443,9,552,6,372,3,180,50361.105477,1.3077269999994314,2275.7043327860433,1101.1472577996983
"147.32.84.165",18814,"184.173.217.40",443,9,552,6,372,3,180,50363.409117,1.3073679999943124,2276.329235542668,1101.449630101291
"147.32.84.165",18815,"184.173.217.40",443,9,552,6,372,3,180,50365.712547,1.3071619999973336,2276.687969820168,1101.6232112033072
"147.32.84.165",18816,"184.173.217.40",443,9,552,6,372,3,180,50368.015836,1.3071300000010524,2276.7437056739604,1101.6501801648196
"147.32.84.165",18817,"184.173.217.40",443,9,552,6,372,3,180,50370.318762,1.3080100000006496,2275.2119632101603,1100.9090144565293
"147.32.84.165",18818,"184.173.217.40",443,9,552,6,372,3,180,50372.622223,1.3092519999991055,2273.0536214586905,1099.8646555445275
"147.32.84.165",18819,"184.173.217.40",443,9,552,6,372,3,180,50374.925645,1.3078819999936968,2275.4346340222914,1101.016758397883
"147.32.84.165",18820,"184.173.217.40",443,9,552,6,372,3,180,50377.228448,1.3081219999949099,2275.0171620166775,1100.8147558145213
"147.32.84.165",18821,"60.190.223.75",888,13,3146,10,1222,3,1924,50378.139995,0.7452320000011241,13118.06256304782,20653.970843947634
"147.32.84.165",18822,"184.173.217.40",443,9,552,6,372,3,180,50379.532452,1.3078529999984312,2275.4850889232735,1101.0411720596485
"147.32.84.165",18823,"184.173.217.40",443,9,552,6,372,3,180,50381.835495,1.3076440000004368,2275.8487784129366,1101.2171508449692
"147.32.84.165",18824,"184.173.217.40",443,9,552,6,372,3,180,50384.138707,1.307873000005202,2275.4502921829285,1101.0243349272234
"147.32.84.165",18825,"184.173.217.40",443,9,552,6,372,3,180,50386.441783,1.3080289999998058,2275.1789142293037,1100.893023014179
"147.32.84.165",18826,"184.173.217.40",443,9,552,6,372,3,180,50388.745467,1.3073409999997239,2276.376247666545,1101.472377903167
"147.32.84.165",18827,"184.173.217.40",443,9,552,6,372,3,180,50391.048834,1.3072170000014012,2276.592180178815,1101.576861376846
"147.32.84.165",18828,"184.173.217.40",443,9,552,6,372,3,180,50393.351708,1.3082949999952689,2274.716329276472,1100.6691915853896
"147.32.84.165",18829,"184.173.217.40",443,9,552,6,372,3,180,50395.65522,1.3075190000017756,2276.0663516139794,1101.3224282003125
"147.32.84.165",18830,"184.173.217.40",443,9,552,6,372,3,180,50397.958977,1.3072719999981928,2276.496398610323,1101.5305154566079
"147.32.84.165",18831,"94.100.176.20",25,6,372,6,372,0,0,50398.654427,8.977913999995508,331.4801188785601,0
"147.32.84.165",18832,"184.173.217.40",443,9,552,6,372,3,180,50400.262149,1.3076769999970566,2275.791346033232,1101.1893609838219
"147.32.84.165",18833,"184.173.217.40",443,9,552,6,372,3,180,50402.565134,1.307648000001791,2275.84181675491,1101.2137823007627
"147.32.84.165",18834,"184.173.217.40",443,9,552,6,372,3,180,50404.86819,1.307770999999775,2275.627766635376,1101.1102096622785
"147.32.84.165",18835,"184.173.217.40",443,9,552,6,372,3,180,50407.17224,1.3076819999987492,2275.7826444065504,1101.1851505192985
"147.32.84.165",18836,"184.173.217.40",443,9,552,6,372,3,180,50409.475419,1.3077699999994365,2275.6295067185224,1101.1110516379947
"147.32.84.165",18837,"184.173.217.40",443,9,552,6,372,3,180,50411.778488,1.3079709999947227,2275.2798036133886,1100.9418404580913
"147.32.84.165",18838,"184.173.217.40",443,9,552,6,372,3,180,50414.081465,1.3080689999987953,2275.109340564405,1100.8593583376153
"147.32.84.165",18839,"184.173.217.40",443,9,552,6,372,3,180,50416.385082,1.307898999999452,2275.4050580367802,1101.002447437152
"147.32.84.165",18840,"184.173.217.40",443,9,552,6,372,3,180,50418.688085,1.307820999994874,2275.5407659088396,1101.0681125365352
"147.32.84.165",18841,"74.125.93.27",25,6,372,6,372,0,0,50419.649955,9.012581000002683,330.20507665885214,0
"147.32.84.165",18842,"184.173.217.40",443,9,552,6,372,3,180,50420.991585,1.3080929999996442,2275.067598405319,1100.839160518703
"147.32.84.165",18843,"184.173.217.40",443,9,552,6,372,3,180,50423.295023,1.3075490000046557,2276.014130246288,1101.297159796591
"147.32.84.165",18844,"184.173.217.40",443,9,552,6,372,3,180,50425.598228,1.308097999994061,2275.0589023249877,1100.8349527378973
"147.32.84.165",18845,"184.173.217.40",443,9,552,6,372,3,180,50427.901275,1.308076000001165,2275.0971656060883,1100.8534672287524
"147.32.84.165",18846,"184.173.217.40",443,9,552,6,372,3,180,50430.204617,1.308192999997118,2274.8936892389397,1100.7550109220676
"147.32.84.165",18847,"184.173.217.40",443,9,552,6,372,3,180,50432.508313,1.3074550000019372,2276.1777651969596,1101.3763379985287
"147.32.84.165",18848,"184.173.217.40",443,9,552,6,372,3,180,50434.811332,1.3077600000033271,2275.6469076836947,1101.1194714598523
"147.32.84.165",18849,"184.173.217.40",443,9,552,6,372,3,180,50437.115169,1.3074090000009164,2276.2578504491817,1101.4150889270234
"147.32.84.165",18850,"184.173.217.40",443,9,552,6,372,3,180,50439.418601,1.3073540000041248,2276.353611944898,1101.4614251346281
"147.32.84.165",18851,"74.125.39.27",25,6,372,6,372,0,0,50440.580052,9.012864000003901,330.1947083633695,0
"147.32.84.165",18852,"184.173.217.40",443,9,552,6,372,3,180,50441.721314,1.3078810000006342,2275.4363737974304,1101.017600224563
"147.32.84.165",18853,"184.173.217.40",443,9,552,6,372,3,180,50444.025176,1.307673999996041,2275.7965670411813,1101.191887277991
"147.32.84.165",18854,"184.173.217.40",443,9,552,6,372,3,180,50446.327894,1.3076419999997597,2275.8522592579216,1101.2188351248008
"147.32.84.165",18855,"184.173.217.40",443,9,552,6,372,3,180,50448.631745,1.3100740000008955,2271.6274042519476,1099.1745504444907
"147.32.84.165",18856,"184.173.217.40",443,9,552,6,372,3,180,50450.934969,1.3078939999977592,2275.4137567762364,1101.0066565046304
"147.32.84.165",18857,"184.173.217.40",443,9,552,6,372,3,180,50453.238277,1.3076790000050096,2275.787865361912,1101.1876767880217
"147.32.84.165",18858,"184.173.217.40",443,9,552,6,372,3,180,50455.541138,1.3082369999974617,2274.8171776258996,1100.7179891738224
"147.32.84.165",18859,"184.173.217.40",443,9,552,6,372,3,180,50457.844296,1.3081449999954202,2274.9771623255974,1100.7954011252891
"147.32.84.165",18860,"184.173.217.40",443,9,552,6,372,3,180,50460.148317,1.307462000004307,2276.165578800911,1101.3704413552796
"147.32.84.165",18861,"66.111.4.73",25,6,372,6,372,0,0,50461.609766,9.013494999999239,330.17159270629776,0
"147.32.84.165",18862,"184.173.217.40",443,9,552,6,372,3,180,50462.45158,1.3075140000000829,2276.0750554103524,1101.3266397146865
"147.32.84.165",18863,"184.173.217.40",443,9,552,6,372,3,180,50464.754548,1.3079890000008163,2275.248492149508,1100.9266897497619
"147.32.84.165",18864,"184.173.217.40",443,9,552,6,372,3,180,50467.05793,1.307766999998421,2275.6347269839302,1101.1135775728694
"147.32.84.165",18865,"184.173.217.40",443,9,552,6,372,3,180,50469.361185,1.3081479999964358,2274.971945076634,1100.792876649984
"147.32.84.165",18866,"184.173.217.40",443,9,552,6,372,3,180,50471.664232,1.3081679999959306,2274.937164041054,1100.7760471166391
"147.32.84.165",18867,"184.173.217.40",443,9,552,6,372,3,180,50473.968193,1.3073349999976926,2276.3866950745237,1101.477433100576
"147.32.84.165",18868,"184.173.217.40",443,9,552,6,372,3,180,50476.27095,1.3083650000044145,2274.5946276382806,1100.610303695942
"147.32.84.165",18869,"184.173.217.40",443,9,552,6,372,3,180,50478.574166,1.3077869999979157,2275.5999256795967,1101.096738232063
"147.32.84.165",18870,"184.173.217.40",443,9,552,6,372,3,180,50480.877486,1.307780000002822,2275.6121060068044,1101.1026319387763
"147.32.84.165",18871,"216.157.130.15",25,6,372,6,372,0,0,50482.640159,9.012831000000006,330.1959173538257,0
"147.32.84.165",18872,"184.173.217.40",443,9,552,6,372,3,180,50483.181208,1.307426999999734,2276.2265120734123,1101.3999251968123
"147.32.84.165",18873,"184.173.217.40",443,9,552,6,372,3,180,50485.484071,1.3079930000021704,2275.2415341634564,1100.9233229823176
"147.32.84.165",18874,"184.173.217.40",443,9,552,6,372,3,180,50487.787975,1.307849000004353,2275.492048386392,1101.0445395418028
"147.32.84.165",18875,"184.173.217.40",443,9,552,6,372,3,180,50490.090734,1.3078030000033323,2275.572085392385,1101.0832671253474
"147.32.84.165",18876,"184.173.217.40",443,9,552,6,372,3,180,50492.394241,1.3076289999953588,2275.8748850098636,1101.2297830692887
"147.32.84.165",18877,"184.173.217.40",443,9,552,6,372,3,180,50494.697524,1.3093359999984386,2272.907794487854,1099.7940941070262
"147.32.84.165",18878,"184.173.217.40",443,9,552,6,372,3,180,50497.001,1.3074710000000778,2276.1499107818245,1101.3628600557215
"147.32.84.165",18879,"184.173.217.40",443,9,552,6,372,3,180,50499.304194,1.3080650000047171,2275.1162977292934,1100.8627247077225
"147.32.84.165",18880,"184.173.217.40",443,9,552,6,372,3,180,50501.607787,1.3076539999965462,2275.831374360389,1101.2087295292206
"147.32.84.165",18881,"184.173.217.40",443,9,552,6,372,3,180,50503.910708,1.3081719999972847,2274.9302079590275,1100.7726812704973
"147.32.84.165",18882,"184.173.217.40",443,9,552,6,372,3,180,50506.214506,1.3076200000068638,2275.8905492301883,1101.2373625307362
"147.32.84.165",18883,"184.173.217.40",443,9,552,6,372,3,180,50508.517655,1.2074179999981425,2464.7636526907654,1192.6275738826284
"147.32.84.165",18884,"184.173.217.40",443,9,552,6,372,3,180,50510.721034,1.3074429999978747,2276.198656465205,1101.3864466767122
"147.32.84.165",18885,"184.173.217.40",443,9,552,6,372,3,180,50513.023754,1.3081329999986337,2274.998031548098,1100.8054991361764
"147.32.84.165",18886,"184.173.217.40",443,9,552,6,372,3,180,50515.327162,1.3080279999994673,2275.1806536260783,1100.89386465778
"147.32.84.165",18887,"184.173.217.40",443,9,552,6,372,3,180,50517.630559,1.30754600000364,2276.01935227649,1101.2996865853984
"147.32.84.165",18888,"184.173.217.40",443,9,552,6,372,3,180,50519.934105,1.3082649999996647,2274.7684910937483,1100.6944311743944
"147.32.84.165",18889,"184.173.217.40",443,9,552,6,372,3,180,50522.237241,1.3078849999947124,2275.4294146748616,1101.0142329071912
"147.32.84.165",18890,"184.173.217.40",443,9,552,6,372,3,180,50524.541021,1.3071710000003804,2276.6722945958363,1101.61562641734
"147.32.84.165",18891,"184.173.217.40",443,9,552,6,372,3,180,50526.844036,1.3077499999999418,2275.6643089276486,1101.1278914166041
"147.32.84.165",18892,"184.173.217.40",443,9,552,6,372,3,180,50529.147248,1.3074740000010934,2276.144688152507,1101.3603329770197
"147.32.84.165",18893,"184.173.217.40",443,9,552,6,372,3,180,50531.450778,1.3078870000026654,2275.4259351105525,1101.0125492470415
"147.32.84.165",18894,"184.173.217.40",443,9,552,6,372,3,180,50533.753472,1.3084950000047684,2274.3686448852727,1100.5009572025513
"147.32.84.165",18895,"184.173.217.40",443,9,552,6,372,3,180,50536.057146,1.3079599999982747,2275.2989388084693,1100.951099423453
"147.32.84.165",18896,"184.173.217.40",443,9,552,6,372,3,180,50538.360766,1.3074730000007548,2276.1464290262834,1101.3611753352984
"147.32.84.165",18897,"184.173.217.40",443,9,552,6,372,3,180,50540.663707,1.3076159999982337,2275.8975111990217,1101.240731225333
"147.32.84.165",18898,"184.173.217.40",443,9,552,6,372,3,180,50542.966768,1.30775800000265,2275.6503879111956,1101.121155440901
"147.32.84.165",18899,"184.173.217.40",443,9,552,6,372,3,180,50545.270594,1.307327999995323,2276.398883838369,1101.4833308895334
"147.32.84.165",18900,"184.173.217.40",443,9,552,6,372,3,180,50547.573631,1.3075759999992442,2275.9671330780925,1101.274419231335
"147.32.84.165",18901,"184.173.217.40",443,9,552,6,372,3,180,50549.87721,1.3072180000017397,2276.5904386231214,1101.576018688607
"147.32.84.165",18902,"184.173.217.40",443,9,552,6,372,3,180,50552.180365,1.308644999997341,2274.107951358884,1100.3748151736536
"147.32.84.165",18903,"184.173.217.40",443,9,552,6,372,3,180,50554.48384,1.3077809999958845,2275.610365962929,1101.1017899820624
"147.32.84.165",18904,"184.173.217.40",443,9,552,6,372,3,180,50556.78684,1.3077159999957075,2275.723475135097,1101.1565202266597
"147.32.84.165",18905,"184.173.217.40",443,9,552,6,372,3,180,50559.090177,1.3080259999987902,2275.1841324276065,1100.8955479488418
"147.32.84.165",18906,"184.173.217.40",443,9,552,6,372,3,180,50561.393498,1.3073850000000675,2276.299636296765,1101.4353078855315
"147.32.84.165",18907,"184.173.217.40",443,9,552,6,372,3,180,50563.696576,1.3079189999989467,2275.370263756698,1100.9856114951765
"147.32.84.165",18908,"184.173.217.40",443,9,552,6,372,3,180,50566.00047,1.3073020000010729,2276.444157507261,1101.5052375035134
"147.32.84.165",18909,"184.173.217.40",443,9,552,6,372,3,180,50568.303178,1.3078699999969103,2275.4555116387946,1101.0268604703845
"147.32.84.165",18910,"184.173.217.40",443,9,552,6,372,3,180,50570.606541,1.3081620000011753,2274.9475982312024,1100.7810959183237
"147.32.84.165",18911,"184.173.217.40",443,9,552,6,372,3,180,50572.910164,1.307381999999052,2276.3048596371664,1101.4378353083064
"147.32.84.165",18912,"184.173.217.40",443,9,552,6,372,3,180,50575.213367,1.3076230000006035,2275.8853278036763,1101.2348360340368
"147.32.84.165",18913,"184.173.217.40",443,9,552,6,372,3,180,50577.516561,1.3077380000031553,2275.6851907590203,1101.1379955285581
"147.32.84.165",18914,"184.173.217.40",443,9,552,6,372,3,180,50579.820477,1.307557000000088,2276.000204962231,1101.2904217559183
"147.32.84.165",18915,"184.173.217.40",443,9,552,6,372,3,180,50582.123018,1.3078440000026603,2275.50074779098,1101.0487489311195
"147.32.84.165",18916,"184.173.217.40",443,9,552,6,372,3,180,50584.426693,1.3079280000019935,2275.3546066721287,1100.978035486514
"147.32.84.165",18917,"184.173.217.40",443,9,552,6,372,3,180,50586.72967,1.3078830000013113,2275.4328942244956,1101.01591656024
"147.32.84.165",18918,"184.173.217.40",443,9,552,6,372,3,180,50589.033426,1.3076929999951972,2275.76350107474,1101.1758876168096
"147.32.84.165",18919,"184.173.217.40",443,9,552,6,372,3,180,50591.336353,1.3081860000020242,2274.905862006928,1100.760900971094
"147.32.84.165",18920,"184.173.217.40",443,9,552,6,372,3,180,50593.640262,1.3072939999983646,2276.458088237017,1101.5119781792018
"147.32.84.165",18921,"184.173.217.40",443,9,552,6,372,3,180,50595.943663,1.3071469999995315,2276.714095661059,1101.6358527392222
"147.32.84.165",18922,"184.173.217.40",443,9,552,6,372,3,180,50598.246648,1.368491000001086,2174.6580722837334,1052.253905943742
"147.32.84.165",18923,"184.173.217.40",443,9,552,6,372,3,180,50600.609628,1.3481140000003506,2207.528443439669,1068.1589242450011
"147.32.84.165",18924,"184.173.217.40",443,9,552,6,372,3,180,50602.953334,1.3077100000009523,2275.733916539472,1101.1615725190993
"147.32.84.165",18925,"184.173.217.40",443,9,552,6,372,3,180,50605.256783,1.307568000003812,2275.9810579574632,1101.281157076192
"147.32.84.165",18926,"184.173.217.40",443,9,552,6,372,3,180,50607.559798,1.3076619999992545,2275.817451299875,1101.2019925644554
"147.32.84.165",18927,"184.173.217.40",443,9,552,6,372,3,180,50609.863297,1.3073420000000624,2276.374506441205,1101.4715353747767
"147.32.84.165",18928,"184.173.217.40",443,9,552,6,372,3,180,50612.166876,1.3073029999941355,2276.4424161906995,1101.5043949309838
"147.32.84.165",18929,"184.173.217.40",443,9,552,6,372,3,180,50614.469784,1.3079060000018217,2275.3928799132773,1100.9965547967472
"147.32.84.165",18930,"184.173.217.40",443,9,552,6,372,3,180,50616.773247,1.307626000001619,2275.880106388459,1101.2323095428028
"147.32.84.165",18931,"184.173.217.40",443,9,552,6,372,3,180,50619.076321,1.3083110000006855,2274.6885106052314,1100.6557309380153
"147.32.84.165",18932,"173.192.170.88",80,6,372,6,372,0,0,50621.176544,8.97559000000183,331.56594719671835,0
"147.32.84.165",18933,"184.173.217.40",443,9,552,6,372,3,180,50621.380061,1.30747899999551,2276.1359838362373,1101.3561212110826
"147.32.84.165",18934,"184.173.217.40",443,9,552,6,372,3,180,50623.68283,1.3076460000011139,2275.8452975785995,1101.21546657029
"147.32.84.165",18935,"94.100.176.20",25,6,372,6,372,0,0,50623.846921,9.009450000005018,330.3198308440962,0
"147.32.84.165",18936,"184.173.217.40",443,9,552,6,372,3,180,50625.986408,1.3076950000031502,2275.760020488593,1101.1742034622225
"147.32.84.165",18937,"184.173.217.40",443,9,552,6,372,3,180,50628.289423,1.3086110000003828,2274.167036651174,1100.4034048312133
"147.32.84.165",18938,"184.173.217.40",443,9,552,6,372,3,180,50630.593252,1.3077489999996033,2275.666049066681,1101.1287334193617
"147.32.84.165",18939,"184.173.217.40",443,9,552,6,372,3,180,50632.896746,1.3079100000031758,2275.3859210440887,1100.9931876019782
"147.32.84.165",18940,"184.173.217.40",443,9,552,6,372,3,180,50635.199911,1.3074429999978747,2276.198656465205,1101.3864466767122
"147.32.84.165",18941,"184.173.217.40",443,9,552,6,372,3,180,50637.503316,1.307145999999193,2276.7158374059495,1101.6366955190078
"147.32.84.165",18942,"184.173.217.40",443,9,552,6,372,3,180,50639.806559,1.307414000002609,2276.249145254725,1101.4108767361572
"147.32.84.165",18943,"184.173.217.40",443,9,552,6,372,3,180,50642.109376,1.3080619999964256,2275.121515653029,1100.86524950953
"147.32.84.165",18944,"173.192.170.88",80,6,372,6,372,0,0,50642.174994,8.907552999997279,334.0984892260432,0
"147.32.84.165",18945,"184.173.217.40",443,9,552,6,372,3,180,50644.412804,1.3076169999985723,2275.8957707059863,1101.2398890512836
"147.32.84.165",18946,"74.125.93.27",25,6,372,6,372,0,0,50644.873208,9.013029000001552,330.18866354468486,0
"147.32.84.165",18947,"184.173.217.40",443,9,552,6,372,3,180,50646.716304,1.3072939999983646,2276.458088237017,1101.5119781792018
"147.32.84.165",18948,"184.173.217.40",443,9,552,6,372,3,180,50649.019354,1.3081830000010086,2274.911078952796,1100.76342529974
"147.32.84.165",18949,"184.173.217.40",443,9,552,6,372,3,180,50651.322966,1.3079849999994622,2275.2554501781165,1100.9300565377982
"147.32.84.165",18950,"184.173.217.40",443,9,552,6,372,3,180,50653.626578,1.3077419999972335,2275.678230114423,1101.1346274747207
"147.32.84.165",18951,"184.173.217.40",443,9,552,6,372,3,180,50655.929424,1.307898999999452,2275.4050580367802,1101.002447437152
"147.32.84.165",18952,"184.173.217.40",443,9,552,6,372,3,180,50658.233125,1.3070630000001984,2276.860411471787,1101.706650712155
"147.32.84.165",18953,"184.173.217.40",443,9,552,6,372,3,180,50660.536094,1.3075519999983953,2276.008908252714,1101.2946330255065
"147.32.84.165",18954,"184.173.217.40",443,9,552,6,372,3,180,50662.839476,1.3078889999960666,2275.4224555822016,1101.0108656042912
"147.32.84.165",18955,"173.192.170.88",80,6,372,6,372,0,0,50663.010744,9.002062999999907,330.5908878887018,0
"147.32.84.165",18956,"184.173.217.40",443,9,552,6,372,3,180,50665.143071,1.3076970000038273,2275.756539925755,1101.1725193189138
"147.32.84.165",18957,"74.125.39.27",25,6,372,6,372,0,0,50665.903932,9.01263199999812,330.2032081195172,0
"147.32.84.165",18958,"184.173.217.40",443,9,552,6,372,3,180,50667.445931,1.308153999998467,2274.961510650495,1100.7878277341104
"147.32.84.165",18959,"184.173.217.40",443,9,552,6,372,3,180,50669.749511,1.3079910000014934,2275.2450131511623,1100.9250063634656
"147.32.84.165",18960,"184.173.217.40",443,9,552,6,372,3,180,50672.052434,1.3083590000023833,2274.6050586991637,1100.6153509834662
"147.32.84.165",18961,"184.173.217.40",443,9,552,6,372,3,180,50674.355862,1.4079780000029132,2113.669389716205,1022.7432530884862
"147.32.84.165",18962,"184.173.217.40",443,9,552,6,372,3,180,50676.759115,1.3080899999986286,2275.072816093021,1100.8416852063006
"147.32.84.165",18963,"184.173.217.40",443,9,552,6,372,3,180,50679.062526,1.308100000002014,2275.055423893753,1100.8332696260095
"147.32.84.165",18964,"184.173.217.40",443,9,552,6,372,3,180,50681.365878,1.3083650000044145,2274.5946276382806,1100.610303695942
"147.32.84.165",18965,"184.173.217.40",443,9,552,6,372,3,180,50683.669339,1.3076559999972233,2275.8278935792896,1101.2070452803014
"147.32.84.165",18966,"173.192.170.88",80,24,4316,18,1968,6,2348,50684.033539,93.11107300000003,169.08837469846358,201.73755273983357
"147.32.84.165",18967,"184.173.217.40",443,9,552,6,372,3,180,50685.972722,1.3076010000004317,2275.923618901345,1101.2533639845217
"147.32.84.165",18968,"66.111.4.73",25,6,372,6,372,0,0,50686.933837,9.013502000001608,330.17133629076346,0
"147.32.84.165",18969,"184.173.217.40",443,9,552,6,372,3,180,50688.276153,1.3076950000031502,2275.760020488593,1101.1742034622225
"147.32.84.165",18971,"184.173.217.40",443,9,552,6,372,3,180,50690.579576,1.30733400000463,2276.388436305841,1101.4782756318584
"147.32.84.165",18972,"184.173.217.40",443,9,552,6,372,3,180,50692.882987,1.307862000001478,2275.4694302584194,1101.033595286332
"147.32.84.165",18973,"184.173.217.40",443,9,552,6,372,3,180,50695.186248,1.3078969999987748,2275.408537524582,1101.0041310602815
"147.32.84.165",18974,"184.173.217.40",443,9,552,6,372,3,180,50697.489205,1.3075739999985672,2275.9706142851273,1101.276103686352
"147.32.84.165",18975,"184.173.217.40",443,9,552,6,372,3,180,50699.792872,1.3077600000033271,2275.6469076836947,1101.1194714598523
"147.32.84.165",18977,"98.126.71.122",80,18,4863,14,1430,4,3433,50700.483875,16.28038500000548,702.6860851261287,1686.9379931734265
"147.32.84.165",18978,"195.113.232.88",80,17,5783,12,2556,5,3227,50701.11731,19.326428000000305,1058.0330726402042,1335.7874512558446
"147.32.84.165",18979,"195.113.232.83",80,48,35753,38,3440,10,32313,50701.518178,18.925837000002502,1454.0968518325694,13658.788248042389
"147.32.84.165",18980,"184.173.217.40",443,9,552,6,372,3,180,50702.100802,1.2973960000017541,2293.825478108439,1109.9155539234382
"147.32.84.165",18981,"184.173.217.40",443,9,552,6,372,3,180,50704.398273,1.30808899999829,2275.0745553275733,1100.8425267714065
"147.32.84.165",18982,"184.173.217.40",443,9,552,6,372,3,180,50706.706563,1.3067920000030426,2277.3325823796526,1101.9351205062835
"147.32.84.165",18983,"216.157.130.15",25,6,372,6,372,0,0,50707.967567,8.928562000000966,333.3123519778076,0
"147.32.84.165",18984,"184.173.217.40",443,9,552,6,372,3,180,50709.013828,1.3067509999964386,2277.404034898853,1101.9696943058964
"147.32.84.165",18985,"184.173.217.40",443,9,552,6,372,3,180,50711.321361,1.3067299999966053,2277.4406342608886,1101.9874036746237
"147.32.84.165",18986,"184.173.217.40",443,9,552,6,372,3,180,50713.62864,1.3066859999962617,2277.517322454296,1102.024510864982
"147.32.84.165",18987,"184.173.217.40",443,9,552,6,372,3,180,50715.934671,1.3079489999945508,2275.318074338066,1100.9603585506768
"147.32.84.165",18988,"184.173.217.40",443,9,552,6,372,3,180,50718.242137,1.3080169999957434,2275.199787166134,1100.9031228223228
"147.32.84.165",18989,"184.173.217.40",443,9,552,6,372,3,180,50720.563659,1.3078109999987646,2275.558165516891,1101.0765317017217
"147.32.84.165",18990,"184.173.217.40",443,9,552,6,372,3,180,50722.866697,1.308074000000488,2275.100644152311,1100.8551503962794
"147.32.84.165",18991,"173.192.170.88",80,15,1531,12,1094,3,437,50724.840291,52.305779000002076,167.3237674177389,66.83773890452642
"147.32.84.165",18992,"184.173.217.40",443,9,552,6,372,3,180,50725.169851,1.3077730000004522,2275.624286477065,1101.108525714709
"147.32.84.165",18993,"184.173.217.40",443,9,552,6,372,3,180,50727.473344,1.3082619999986491,2274.7737074095808,1100.6969551981842
"147.32.84.165",18994,"184.173.217.40",443,9,552,6,372,3,180,50729.776506,1.307766999998421,2275.6347269839302,1101.1135775728694
"147.32.84.165",18995,"147.32.84.171",139,33,4810,22,3278,11,1532,50731.072321,0.01594199999817647,1644962.991029961,768786.8524276695
"147.32.84.165",18996,"184.173.217.40",443,9,552,6,372,3,180,50732.08006,1.3074980000019423,2276.1029079934187,1101.3401167710092
"147.32.84.165",18997,"184.173.217.40",443,9,552,6,372,3,180,50734.382956,1.308233999996446,2274.822394165023,1100.7205133056561
"147.32.84.165",18998,"184.173.217.40",443,9,552,6,372,3,180,50736.686621,1.307980999998108,2275.2624082492825,1100.933423346427
"147.32.84.165",18999,"184.173.217.40",443,9,552,6,372,3,180,50738.990195,1.3074930000002496,2276.1116120693814,1101.3443284206685
"147.32.84.165",19000,"184.173.217.40",443,9,552,6,372,3,180,50741.293364,1.3072580000007292,2276.5207786055544,1101.542312228494
"147.32.84.165",19001,"184.173.217.40",443,9,552,6,372,3,180,50743.596811,1.307606999995187,2275.9131757561363,1101.2483108497433
"147.32.84.165",19002,"184.173.217.40",443,9,552,6,372,3,180,50745.900097,1.30751600000076,2276.071573883815,1101.3249551050717
"147.32.84.165",19003,"184.173.217.40",443,9,552,6,372,3,180,50748.203203,1.3079930000021704,2275.2415341634564,1100.9233229823176
"147.32.84.165",19004,"184.173.217.40",443,9,552,6,372,3,180,50750.506697,1.3071950000012293,2276.630495065542,1101.5954008381655
"147.32.84.165",19005,"184.173.217.40",443,9,552,6,372,3,180,50752.809341,1.3083740000001853,2274.578981238987,1100.6027328575744
"147.32.84.165",19006,"184.173.217.40",443,9,552,6,372,3,180,50755.113998,1.3064499999964028,2277.9287381898994,1102.2235829951126
"147.32.84.165",19007,"184.173.217.40",443,9,552,6,372,3,180,50757.416194,1.3077400000038324,2275.681710425068,1101.1363114960006
"147.32.84.165",19008,"184.173.217.40",443,9,552,6,372,3,180,50759.719839,1.3076280000022962,2275.876625458291,1101.2306252217538
"147.32.84.165",19009,"184.173.217.40",443,9,552,6,372,3,180,50762.02306,1.307619999999588,2275.8905492428516,1101.2373625368639
"147.32.84.165",19010,"184.173.217.40",443,9,552,6,372,3,180,50764.326137,1.3083080000069458,2274.69372654161,1100.6582547781984
"147.32.84.165",19011,"184.173.217.40",443,9,552,6,372,3,180,50766.629881,1.3070749999969848,2276.839508067146,1101.6965361615223
"147.32.84.165",19012,"184.173.217.40",443,9,552,6,372,3,180,50768.93314,1.3076710000023013,2275.801788060424,1101.1944135776246
"147.32.84.165",19013,"184.173.217.40",443,9,552,6,372,3,180,50771.236208,1.3074320000014268,2276.2178071186513,1101.3957131219279
"147.32.84.165",19014,"184.173.217.40",443,9,552,6,372,3,180,50773.539668,1.3079520000028424,2275.312855512689,1100.9578333125914
"147.32.84.165",19015,"184.173.217.40",443,9,552,6,372,3,180,50775.842972,1.3074150000029476,2276.2474042238237,1101.4100343018501
"147.32.84.165",19016,"184.173.217.40",443,9,552,6,372,3,180,50778.146492,1.3070189999998547,2276.9370605938634,1101.7437389970307
"147.32.84.165",19017,"184.173.217.40",443,9,552,6,372,3,180,50780.449282,1.3080409999965923,2275.158041688107,1100.8829233974711
"147.32.84.165",19018,"184.173.217.40",443,9,552,6,372,3,180,50782.752903,1.3076119999968796,2275.9044731977847,1101.244099934412
"147.32.84.165",19019,"184.173.217.40",443,9,552,6,372,3,180,50785.056068,1.3076580000051763,2275.8244127961743,1101.205361030407
"147.32.84.165",19020,"184.173.217.40",443,9,552,6,372,3,180,50787.359005,1.3077980000016396,2275.5807854089617,1101.0874768107878
"147.32.84.165",19021,"184.173.217.40",443,9,552,6,372,3,180,50789.662732,1.308310000000347,2274.69024925225,1100.6565722188304
"147.32.84.165",19022,"184.173.217.40",443,9,552,6,372,3,180,50791.965801,1.374786000000313,2164.7005424839376,1047.4357463631957
"147.32.84.165",19023,"184.173.217.40",443,9,552,6,372,3,180,50794.339651,1.337681999997585,2224.743997456326,1076.4890310272544
"147.32.84.165",19024,"184.173.217.40",443,9,552,6,372,3,180,50796.67238,1.3082009999998263,2274.8797776491497,1100.748279507653
"147.32.84.165",19025,"184.173.217.40",443,9,552,6,372,3,180,50798.976299,1.307239000001573,2276.5538665817185,1101.5583225395412
"147.32.84.165",19026,"184.173.217.40",443,9,552,6,372,3,180,50801.279469,1.3078299999979208,2275.525106477701,1101.060535392436
"147.32.84.165",19027,"184.173.217.40",443,9,552,6,372,3,180,50803.582923,1.3075859999953536,2275.9497272153226,1101.2659970396724
"147.32.84.165",19028,"184.173.217.40",443,9,552,6,372,3,180,50805.88568,1.3080899999986286,2275.072816093021,1100.8416852063006
"147.32.84.165",19029,"184.173.217.40",443,9,552,6,372,3,180,50808.189107,1.307835999999952,2275.514666976677,1101.0554840209727
"147.32.84.165",19030,"184.173.217.40",443,9,552,6,372,3,180,50810.492355,1.3082460000005085,2274.801528152078,1100.7104168477797
"147.32.84.165",19031,"184.173.217.40",443,9,552,6,372,3,180,50812.796187,1.3074760000017704,2276.141206412944,1101.3586482643277
"147.32.84.165",19032,"184.173.217.40",443,9,552,6,372,3,180,50815.099168,1.307781999996223,2275.6086259090544,1101.1009480205103
"147.32.84.165",19033,"184.173.217.40",443,9,552,6,372,3,180,50817.402806,1.3078030000033323,2275.572085392385,1101.0832671253474
"147.32.84.165",19034,"184.173.217.40",443,9,552,6,372,3,180,50819.705663,1.3083849999966333,2274.5598581515824,1100.5934797507655
"147.32.84.165",19035,"184.173.217.40",443,9,552,6,372,3,180,50822.009387,1.3077530000009574,2275.6590885265196,1101.1253654160578
"147.32.84.165",19036,"184.173.217.40",443,9,552,6,372,3,180,50824.312358,1.3078919999970822,2275.417236290641,1101.0083401406328
"147.32.84.165",19037,"184.173.217.40",443,9,552,6,372,3,180,50826.61597,1.307570000004489,2275.97757671848,1101.2794726057161
"147.32.84.165",19038,"184.173.217.40",443,9,552,6,372,3,180,50828.91947,1.3082009999998263,2274.8797776491497,1100.748279507653
"147.32.84.165",19039,"184.173.217.40",443,9,552,6,372,3,180,50831.222101,1.3078719999975874,2275.4520320073293,1101.02517677774
"147.32.84.165",19040,"184.173.217.40",443,9,552,6,372,3,180,50833.525639,1.307619999999588,2275.8905492428516,1101.2373625368639
"147.32.84.165",19041,"184.173.217.40",443,9,552,6,372,3,180,50835.829436,1.307131000001391,2276.74196388643,1101.6493373644016
"147.32.84.165",19042,"184.173.217.40",443,9,552,6,372,3,180,50838.132057,1.3083960000003572,2274.5407353730734,1100.5842267934227
"147.32.84.165",19043,"184.173.217.40",443,9,552,6,372,3,180,50840.435807,1.3095130000001518,2272.6005774663213,1099.6454407095105
"147.32.84.165",19044,"184.173.217.40",443,9,552,6,372,3,180,50842.738611,1.3082359999971231,2274.818916469616,1100.7188305498141
"147.32.84.165",19045,"184.173.217.40",443,9,552,6,372,3,180,50845.04236,1.310339000003296,2271.1679954519514,1098.9522558638473
"147.32.84.165",19046,"184.173.217.40",443,9,552,6,372,3,180,50847.345946,1.307372999996005,2276.3205298022017,1101.4454176462266
"147.32.84.165",19047,"94.100.176.20",25,6,372,6,372,0,0,50849.131119,8.989731000001484,331.044388313678,0
"147.32.84.165",19048,"184.173.217.40",443,9,552,6,372,3,180,50849.648777,1.3075509999980568,2276.0106489187974,1101.295475283289
"147.32.84.165",19049,"184.173.217.40",443,9,552,6,372,3,180,50851.951999,1.3080570000020089,2275.1302122120287,1100.8694575219492
"147.32.84.165",19050,"184.173.217.40",443,9,552,6,372,3,180,50854.255775,1.3135929999989457,2265.5419144304124,1096.2299585953608
"147.32.84.165",19051,"184.173.217.40",443,9,552,6,372,3,180,50856.569246,1.2976469999994151,2293.3817902721935,1109.7008662607388
"147.32.84.165",19052,"184.173.217.40",443,9,552,6,372,3,180,50858.862486,1.3070710000029067,2276.846475817597,1101.6999076536758
"147.32.84.165",19053,"184.173.217.40",443,9,552,6,372,3,180,50861.165808,1.3075880000033067,2275.946246059519,1101.2643126094447
"147.32.84.165",19054,"184.173.217.40",443,9,552,6,372,3,180,50863.468444,1.3082179999983055,2274.850216098429,1100.733975531498
"147.32.84.165",19055,"184.173.217.40",443,9,552,6,372,3,180,50865.771764,1.307784000004176,2275.6051457966278,1101.0992640951424
"147.32.84.165",19056,"184.173.217.40",443,9,552,6,372,3,180,50868.075285,1.307583000001614,2275.9549489373344,1101.2685236793554
"147.32.84.165",19057,"74.125.93.27",25,6,372,6,372,0,0,50870.138116,9.013487999996869,330.17184912223036,0
"147.32.84.165",19058,"184.173.217.40",443,9,552,6,372,3,180,50870.378655,1.3079329999964102,2275.3459083975767,1100.9738266439888
"147.32.84.165",19059,"184.173.217.40",443,9,552,6,372,3,180,50872.682415,1.3073159999985364,2276.4197791531133,1101.4934415257
"147.32.84.165",19060,"184.173.217.40",443,9,552,6,372,3,180,50874.985618,1.3076320000036503,2275.869663629899,1101.2272565951125
"147.32.84.165",19061,"184.173.217.40",443,9,552,6,372,3,180,50877.289027,1.3071229999986826,2276.7558982612954,1101.6560798038527
"147.32.84.165",19062,"184.173.217.40",443,9,552,6,372,3,180,50879.592232,1.3077749999938533,2275.62080634206,1101.106841778416
"147.32.84.165",19063,"184.173.217.40",443,9,552,6,372,3,180,50881.895161,1.3075349999999162,2276.038499925578,1101.3089515768927
"147.32.84.165",19064,"184.173.217.40",443,9,552,6,372,3,180,50884.198589,1.3073680000015884,2276.3292355299996,1101.449630095161
"147.32.84.165",19065,"184.173.217.40",443,9,552,6,372,3,180,50886.502165,1.307250000005297,2276.5347102604255,1101.5490533518189
"147.32.84.165",19066,"184.173.217.40",443,9,552,6,372,3,180,50888.805459,1.307991999994556,2275.243273668636,1100.9241646783723
"147.32.84.165",19067,"184.173.217.40",443,9,552,6,372,3,180,50891.108864,1.3071629999976722,2276.6862281179165,1101.622368444153
"147.32.84.165",19068,"74.125.39.27",25,6,372,6,372,0,0,50891.168534,8.912903000004007,333.89794548405405,0
"147.32.84.165",19069,"184.173.217.40",443,9,552,6,372,3,180,50893.41174,1.3075459999963641,2276.019352289155,1101.2996865915266
"147.32.84.165",19070,"184.173.217.40",443,9,552,6,372,3,180,50895.714843,1.3077399999965564,2275.6817104377296,1101.1363115021272
"147.32.84.165",19071,"184.173.217.40",443,9,552,6,372,3,180,50898.018136,1.2074910000010277,2464.61464308841,1192.5554724621338
"147.32.84.165",19072,"184.173.217.40",443,9,552,6,372,3,180,50900.221234,1.3080410000038682,2275.1580416754514,1100.8829233913475
"147.32.84.165",19073,"184.173.217.40",443,9,552,6,372,3,180,50902.524625,1.308006999999634,2275.2171815600627,1100.9115394645464
"147.32.84.165",19074,"184.173.217.40",443,9,552,6,372,3,180,50904.827921,1.3078540000060457,2275.483349048321,1101.0403301846716
"147.32.84.165",19075,"184.173.217.40",443,9,552,6,372,3,180,50907.131284,1.3082909999939147,2274.723284050599,1100.6725567986769
"147.32.84.165",19076,"184.173.217.40",443,9,552,6,372,3,180,50909.434638,1.3075580000004265,2275.9984643121215,1101.2895795058653
"147.32.84.165",19077,"184.173.217.40",443,9,552,6,372,3,180,50911.738452,1.30735999999888,2276.3431648532533,1101.4563700902838
"147.32.84.165",19078,"66.111.4.73",25,6,372,6,372,0,0,50912.098608,9.012588999998115,330.2047835533854,0
"147.32.84.165",19079,"184.173.217.40",443,9,552,6,372,3,180,50914.041747,1.3078409999943688,2275.50596747832,1101.051274586284
"147.32.84.165",19080,"184.173.217.40",443,9,552,6,372,3,180,50916.344798,1.3073980000044685,2276.277002098694,1101.4243558542069
"147.32.84.165",19081,"184.173.217.40",443,9,552,6,372,3,180,50918.647891,1.3078699999969103,2275.4555116387946,1101.0268604703845
"147.32.84.165",19082,"184.173.217.40",443,9,552,6,372,3,180,50920.951421,1.3080830000035348,2275.084990778076,1100.84757618294
"147.32.84.165",19083,"173.192.170.88",80,6,372,6,372,0,0,50921.305449,8.919087000002037,333.66643917693824,0
"147.32.84.165",19084,"173.192.170.88",80,6,372,6,372,0,0,50922.604785,8.921658999999636,333.5702474170019,0
"147.32.84.165",19085,"184.173.217.40",443,9,552,6,372,3,180,50923.254728,1.3079629999992903,2275.2937200835304,1100.9485742339664
"147.32.84.165",19086,"184.173.217.40",443,9,552,6,372,3,180,50925.558172,1.3077059999995981,2275.7408775373933,1101.1649407439
"147.32.84.165",19087,"184.173.217.40",443,9,552,6,372,3,180,50927.861107,1.3081810000003316,2274.9145569300013,1100.765108191936
"147.32.84.165",19088,"184.173.217.40",443,9,552,6,372,3,180,50930.164358,1.308298999996623,2274.709374544872,1100.66582639268
"147.32.84.165",19089,"184.173.217.40",443,9,552,6,372,3,180,50932.468101,1.3075910000043223,2275.9410243647767,1101.2617859829566
"147.32.84.165",19090,"216.157.130.15",25,6,372,6,372,0,0,50933.128598,9.01286099999561,330.19481827151776,0
"147.32.84.165",19091,"184.173.217.40",443,9,552,6,372,3,180,50934.771425,1.3076569999975618,2275.8261531927324,1101.2062031577739
"147.32.84.165",19092,"184.173.217.40",443,9,552,6,372,3,180,50937.07472,1.3074059999999008,2276.2630735978155,1101.4176162570075
"147.32.84.165",19093,"184.173.217.40",443,9,552,6,372,3,180,50939.378083,1.3073079999958281,2276.4337095845026,1101.5001820570174
"147.32.84.165",19094,"184.173.217.40",443,9,552,6,372,3,180,50941.681514,1.307370999995328,2276.3240120903974,1101.447102624386
"147.32.84.165",19095,"173.192.170.88",80,23,4034,16,1406,7,2628,50942.243453,84.9753669999991,132.36777194501695,247.41287672226497
"147.32.84.165",19096,"173.192.170.88",80,6,372,6,372,0,0,50943.544896,9.011829000002763,330.2326309120033,0
"147.32.84.165",19097,"184.173.217.40",443,9,552,6,372,3,180,50943.984159,1.3084939999971539,2274.3703830559966,1100.5017982529016
"147.32.84.165",19098,"184.173.217.40",443,9,552,6,372,3,180,50946.287938,1.3076959999962128,2275.7582802185057,1101.173361396051
"147.32.84.165",19100,"184.173.217.40",443,9,552,6,372,3,180,50948.590843,1.307831999998598,2275.5216266333828,1101.0588515967981
"147.32.84.165",19101,"184.173.217.40",443,9,552,6,372,3,180,50950.89461,1.30721099999937,2276.602629568933,1101.5819175333547
"147.32.84.165",19102,"184.173.217.40",443,9,552,6,372,3,180,50953.197784,1.3081379999930505,2274.9893359995735,1100.8012916126968
"147.32.84.165",19103,"184.173.217.40",443,9,552,6,372,3,180,50955.501281,1.3074720000004163,2276.1481699027227,1101.3620176948657
"147.32.84.165",19105,"98.126.71.122",80,18,4973,14,1540,4,3433,50956.713677,16.322556999999506,754.7837020878759,1682.5795125114792
"147.32.84.165",19106,"195.113.232.98",80,17,5927,12,2794,5,3133,50957.418381,19.39287399999739,1152.5883167189663,1292.4334990266718
"147.32.84.165",19107,"195.113.232.83",80,56,42696,46,3868,10,38828,50957.76953,19.041912000000593,1625.046896551094,16312.647595472048
"147.32.84.165",19108,"184.173.217.40",443,9,552,6,372,3,180,50957.794594,1.3114910000003874,2269.1730252049924,1097.986947679835
"147.32.84.165",19109,"184.173.217.40",443,9,552,6,372,3,180,50960.106006,1.307290999997349,2276.4633123046324,1101.5145059538543
"147.32.84.165",19110,"184.173.217.40",443,9,552,6,372,3,180,50962.413223,1.3080169999957434,2275.199787166134,1100.9031228223228
"147.32.84.165",19111,"184.173.217.40",443,9,552,6,372,3,180,50964.721756,1.3067829999999958,2277.3482666976915,1101.9427096924314
"147.32.84.165",19112,"184.173.217.40",443,9,552,6,372,3,180,50967.029069,1.306919000002381,2277.1112823324,1101.8280398382583
"147.32.84.165",19113,"184.173.217.40",443,9,552,6,372,3,180,50969.336055,1.3077879999982542,2275.598185641689,1101.0958962782365
"147.32.84.165",19114,"184.173.217.40",443,9,552,6,372,3,180,50971.644823,1.3065139999962412,2277.8171531331177,1102.169590225702
"147.32.84.165",19115,"184.173.217.40",443,9,552,6,372,3,180,50973.951737,1.307026999995287,2276.923124014065,1101.7369954906765
"147.32.84.165",19116,"184.173.217.40",443,9,552,6,372,3,180,50976.259319,1.3186180000047898,2256.9083692086638,1092.0524367138696
"147.32.84.165",19117,"184.173.217.40",443,9,552,6,372,3,180,50978.573108,1.3080680000057328,2275.111079842147,1100.8601999236193
"147.32.84.165",19118,"184.173.217.40",443,9,552,6,372,3,180,50980.876646,1.3082390000054147,2274.8136999337908,1100.716306419576
"147.32.84.165",19119,"173.192.170.88",80,18,2429,14,1930,4,499,50982.049662,45.17064400000527,341.8149185563571,88.375981533483
"147.32.84.165",19120,"184.173.217.40",443,9,552,6,372,3,180,50983.180133,1.3077919999996084,2275.5912255166654,1101.092528475806
"147.32.84.165",19121,"184.173.217.40",443,9,552,6,372,3,180,50985.483565,1.3078249999962281,2275.5338061350585,1101.0647449040605
"147.32.84.165",19122,"184.173.217.40",443,9,552,6,372,3,180,50987.786294,1.3083740000001853,2274.578981238987,1100.6027328575744
"147.32.84.165",19123,"184.173.217.40",443,9,552,6,372,3,180,50990.090096,1.3078759999989416,2275.4450727763247,1101.0218094078991
"147.32.84.165",19124,"184.173.217.40",443,9,552,6,372,3,180,50992.393354,1.3076510000028065,2275.8365955393397,1101.211255906132
"147.32.84.165",19125,"184.173.217.40",443,9,552,6,372,3,180,50994.696314,1.3082680000006803,2274.763274801839,1100.69190716218
"147.32.84.165",19126,"184.173.217.40",443,9,552,6,372,3,180,50997.000128,1.3071990000025835,2276.623528624271,1101.592029979486
"147.32.84.165",19127,"184.173.217.40",443,9,552,6,372,3,180,50999.303183,1.3081009999950766,2275.053684701106,1100.8324280811803
"147.32.84.165",19128,"184.173.217.40",443,9,552,6,372,3,180,51001.6069,1.3074540000015986,2276.179506121333,1101.3771803812901
"147.32.84.165",19129,"184.173.217.40",443,9,552,6,372,3,180,51003.909529,1.3080320000008214,2275.173696054937,1100.8904980910984
"147.32.84.165",19130,"184.173.217.40",443,9,552,6,372,3,180,51006.213052,1.308322999997472,2274.667647060971,1100.6456356746633
"147.32.84.165",19131,"184.173.217.40",443,9,552,6,372,3,180,51008.51629,1.3075430000026245,2276.024574330654,1101.3022133858005
"147.32.84.165",19132,"184.173.217.40",443,9,552,6,372,3,180,51010.81957,1.3077130000019679,2275.728695818977,1101.1590463640212
"147.32.84.165",19133,"184.173.217.40",443,9,552,6,372,3,180,51013.122966,1.308311999993748,2274.686771973521,1100.654889664607
"147.32.84.165",19134,"184.173.217.40",443,9,552,6,372,3,180,51015.426643,1.3084600000001956,2274.4294819861175,1100.5303945094117
"147.32.84.165",19135,"184.173.217.40",443,9,552,6,372,3,180,51017.729423,1.3081120000060764,2275.034553605636,1100.8231710995015
"147.32.84.165",19136,"184.173.217.40",443,9,552,6,372,3,180,51020.032758,1.307754000001296,2275.657348398132,1101.124523418451
"147.32.84.165",19137,"184.173.217.40",443,9,552,6,372,3,180,51022.336501,1.3081530000054045,2274.9632497022176,1100.7886692107504
"147.32.84.165",19138,"184.173.217.40",443,9,552,6,372,3,180,51024.639698,1.307381999999052,2276.3048596371664,1101.4378353083064
"147.32.84.165",19139,"184.173.217.40",443,9,552,6,372,3,180,51026.9427,1.3083580000020447,2274.6067972186124,1100.6161922025542
"147.32.84.165",19140,"184.173.217.40",443,9,552,6,372,3,180,51029.245938,1.3081999999994878,2274.8815165885685,1100.7491209299524
"147.32.84.165",19141,"184.173.217.40",443,9,552,6,372,3,180,51031.549591,1.307954999996582,2275.3076367365675,1100.955308098339
"147.32.84.165",19142,"184.173.217.40",443,9,552,6,372,3,180,51033.852591,1.307913999997254,2275.3789622301224,1100.9898204339302
"147.32.84.165",19143,"184.173.217.40",443,9,552,6,372,3,180,51036.156126,1.3076299999956973,2275.8731445514345,1101.2289409119844
"147.32.84.165",19144,"184.173.217.40",443,9,552,6,372,3,180,51038.459242,1.307901000000129,2275.4015785596207,1101.0007638191714
"147.32.84.165",19145,"184.173.217.40",443,9,552,6,372,3,180,51040.763181,1.3077579999953741,2275.6503879238567,1101.1211554470274
"147.32.84.165",19146,"184.173.217.40",443,9,552,6,372,3,180,51043.066405,1.3076100000034785,2275.907954200475,1101.2457842905526
"147.32.84.165",19147,"184.173.217.40",443,9,552,6,372,3,180,51045.369533,1.3076040000014473,2275.918397310429,1101.250837408272
"147.32.84.165",19148,"184.173.217.40",443,9,552,6,372,3,180,51047.6728,1.307396999996854,2276.278743187541,1101.425198316552
"147.32.84.165",19149,"184.173.217.40",443,9,552,6,372,3,180,51049.97583,1.3079639999996289,2275.291980513871,1100.9477325067116
"147.32.84.165",19150,"184.173.217.40",443,9,552,6,372,3,180,51052.279819,1.3071649999983492,2276.6827447214073,1101.6206829297132
"147.32.84.165",19151,"184.173.217.40",443,9,552,6,372,3,180,51054.582439,1.3082790000044042,2274.744148602845,1100.6826525497638
"147.32.84.165",19152,"184.173.217.40",443,9,552,6,372,3,180,51056.885712,1.3078639999948791,2275.465950597044,1101.031911579215
"147.32.84.165",19153,"184.173.217.40",443,9,552,6,372,3,180,51059.189761,1.307779999995546,2275.6121060194646,1101.1026319449024
"147.32.84.165",19154,"184.173.217.40",443,9,552,6,372,3,180,51061.492793,1.3077340000018012,2275.6921514588603,1101.1413636091258
"147.32.84.165",19155,"184.173.217.40",443,9,552,6,372,3,180,51063.795766,1.3082179999983055,2274.850216098429,1100.733975531498
"147.32.84.165",19156,"184.173.217.40",443,9,552,6,372,3,180,51066.099137,1.308037000002514,2275.16499915085,1100.8862899117014
"147.32.84.165",19157,"184.173.217.40",443,9,552,6,372,3,180,51068.402786,1.3073199999998906,2276.412814001353,1101.4900712909773
"147.32.84.165",19158,"184.173.217.40",443,9,552,6,372,3,180,51070.705761,1.3080530000006547,2275.1371695172215,1100.872823959946
"147.32.84.165",19159,"184.173.217.40",443,9,552,6,372,3,180,51073.009467,1.3071239999990212,2276.7541564551093,1101.655236994408
"147.32.84.165",19160,"94.100.176.20",25,6,372,6,372,0,0,51074.321509,8.862433000002056,335.7994356627925,0
"147.32.84.165",19161,"184.173.217.40",443,9,552,6,372,3,180,51075.312713,1.3076860000001034,2275.775683153115,1101.1817821708623
"147.32.84.165",19162,"184.173.217.40",443,9,552,6,372,3,180,51077.61594,1.307528999997885,2276.0489442335993,1101.3140052743222
"147.32.84.165",19163,"184.173.217.40",443,9,552,6,372,3,180,51079.918855,1.3076879999935045,2275.77220255503,1101.1800980104986
"147.32.84.165",19164,"184.173.217.40",443,9,552,6,372,3,180,51082.222415,1.3079580000048736,2275.302417959071,1100.9527828834216
"147.32.84.165",19165,"184.173.217.40",443,9,552,6,372,3,180,51084.52583,1.3074730000007548,2276.1464290262834,1101.3611753352984
"147.32.84.165",19166,"184.173.217.40",443,9,552,6,372,3,180,51086.82916,1.403587000000698,2120.281820790959,1025.9428165117545
"147.32.84.165",19167,"184.173.217.40",443,9,552,6,372,3,180,51089.232485,1.3075889999963692,2275.9445055046067,1101.2634704054549
"147.32.84.165",19168,"184.173.217.40",443,9,552,6,372,3,180,51091.535824,1.3078549999991083,2275.481609201348,1101.039488323233
"147.32.84.165",19169,"184.173.217.40",443,9,552,6,372,3,180,51093.838806,1.3082300000023679,2274.829349575085,1100.723878826654
"147.32.84.165",19170,"74.125.93.27",25,6,372,6,372,0,0,51095.201441,9.012460000005376,330.20950994492347,0
"147.32.84.165",19171,"184.173.217.40",443,9,552,6,372,3,180,51096.142675,1.3078889999960666,2275.4224555822016,1101.0108656042912
"147.32.84.165",19172,"184.173.217.40",443,9,552,6,372,3,180,51098.445545,1.3076419999997597,2275.8522592579216,1101.2188351248008
"147.32.84.165",19173,"184.173.217.40",443,9,552,6,372,3,180,51100.749128,1.307885999995051,2275.427674897706,1101.0133910795353
"147.32.84.165",19174,"184.173.217.40",443,9,552,6,372,3,180,51103.052024,1.3078740000055404,2275.448552373847,1101.0234930841195
"147.32.84.165",19175,"184.173.217.40",443,9,552,6,372,3,180,51105.355915,1.3076900000014575,2275.768721942267,1101.1784138430323
"147.32.84.165",19176,"184.173.217.40",443,9,552,6,372,3,180,51107.658991,1.3081710000042222,2274.931946962893,1100.7735227239805
"147.32.84.165",19177,"184.173.217.40",443,9,552,6,372,3,180,51109.962425,1.3076700000019628,2275.803528409716,1101.1952556821207
"147.32.84.165",19178,"184.173.217.40",443,9,552,6,372,3,180,51112.265873,1.307187000005797,2276.6444280633164,1101.602142611282
"147.32.84.165",19179,"184.173.217.40",443,9,552,6,372,3,180,51114.569044,1.3080519999930402,2275.138908862824,1100.8736655787857
"147.32.84.165",19180,"74.125.39.27",25,6,372,6,372,0,0,51116.231221,9.012808999999834,330.1967233522928,0
"147.32.84.165",19181,"184.173.217.40",443,9,552,6,372,3,180,51116.872116,1.308208000002196,2274.8676051476555,1100.7423895875752
"147.32.84.165",19182,"184.173.217.40",443,9,552,6,372,3,180,51119.175829,1.307622000000265,2275.887068280739,1101.2356782003578
"147.32.84.165",19183,"184.173.217.40",443,9,552,6,372,3,180,51121.479032,1.3077919999996084,2275.5912255166654,1101.092528475806
"147.32.84.165",19184,"184.173.217.40",443,9,552,6,372,3,180,51123.781929,1.307730000000447,2275.6991122012823,1101.1447317102977
"147.32.84.165",19185,"184.173.217.40",443,9,552,6,372,3,180,51126.085593,1.3073699999949895,2276.3257532384905,1101.4479451153986
"147.32.84.165",19186,"184.173.217.40",443,9,552,6,372,3,180,51128.388611,1.3083560000013676,2274.610274265482,1100.617874644588
"147.32.84.165",19187,"184.173.217.40",443,9,552,6,372,3,180,51130.692013,1.308074000000488,2275.100644152311,1100.8551503962794
"147.32.84.165",19188,"184.173.217.40",443,9,552,6,372,3,180,51132.995687,1.307619999999588,2275.8905492428516,1101.2373625368639
"147.32.84.165",19189,"184.173.217.40",443,9,552,6,372,3,180,51135.299187,1.307674000003317,2275.796567028519,1101.191887271864
"147.32.84.165",19190,"66.111.4.73",25,6,372,6,372,0,0,51137.261473,9.013064999999187,330.1873447046336,0
"147.32.84.165",19191,"184.173.217.40",443,9,552,6,372,3,180,51137.602356,1.3077619999967283,2275.6434274794997,1101.1177874900804
"147.32.84.165",19192,"184.173.217.40",443,9,552,6,372,3,180,51139.905612,1.307195999994292,2276.628753463899,1101.594558127693
"147.32.84.165",19193,"184.173.217.40",443,9,552,6,372,3,180,51142.208488,1.3076900000014575,2275.768721942267,1101.1784138430323
"147.32.84.165",19194,"184.173.217.40",443,9,552,6,372,3,180,51144.512115,1.308071999999811,2275.1041227091705,1100.8568335689536
"147.32.84.165",19195,"184.173.217.40",443,9,552,6,372,3,180,51146.815502,1.30721099999937,2276.602629568933,1101.5819175333547
"147.32.84.165",19196,"184.173.217.40",443,9,552,6,372,3,180,51149.118509,1.2076149999993504,2464.361572191138,1192.4330188021634
"147.32.84.165",19197,"184.173.217.40",443,9,552,6,372,3,180,51151.321505,1.3081079999974463,2275.0415103384503,1100.8265372605406
"147.32.84.165",19198,"184.173.217.40",443,9,552,6,372,3,180,51153.625358,1.3074450000058278,2276.1951745478664,1101.3847618779998
"147.32.84.165",19199,"184.173.217.40",443,9,552,6,372,3,180,51155.928118,1.3079719999950612,2275.2780640650085,1100.9409987411332
"147.32.84.165",19200,"216.157.130.15",25,6,372,6,372,0,0,51158.191322,9.01299999999901,330.18972595143975,0
"147.32.84.165",19201,"184.173.217.40",443,9,552,6,372,3,180,51158.231725,1.3074780000024475,2276.137724684032,1101.3569635567899
"147.32.84.165",19202,"184.173.217.40",443,9,552,6,372,3,180,51160.534814,1.308288000000175,2274.7285001464525,1100.6750807160254
"147.32.84.165",19203,"184.173.217.40",443,9,552,6,372,3,180,51162.838012,1.3078020000029937,2275.5738253903783,1101.0841090598606
"147.32.84.165",19204,"184.173.217.40",443,9,552,6,372,3,180,51165.141498,1.30803300000116,2275.1719566688002,1100.8896564526453
"147.32.84.165",19205,"184.173.217.40",443,9,552,6,372,3,180,51167.444883,1.307784000004176,2275.6051457966278,1101.0992640951424
"147.32.84.165",19206,"184.173.217.40",443,9,552,6,372,3,180,51169.748109,1.3083980000010342,2274.537258538799,1100.5825444542577
"147.32.84.165",19207,"184.173.217.40",443,9,552,6,372,3,180,51172.051887,1.307037999999011,2276.9039614779767,1101.7277232957954
"147.32.84.165",19208,"184.173.217.40",443,9,552,6,372,3,180,51174.354673,1.3077310000007856,2275.6973720116844,1101.1438896830732
"147.32.84.165",19209,"184.173.217.40",443,9,552,6,372,3,180,51176.658432,1.3074820000038017,2276.130761258164,1101.353594157176
"147.32.84.165",19210,"184.173.217.40",443,9,552,6,372,3,180,51178.961824,1.3163039999999455,2260.875907085387,1093.9722131058325
"147.32.84.165",19211,"184.173.217.40",443,9,552,6,372,3,180,51181.274517,1.2978760000041802,2292.9771411062497,1109.5050682772176
"147.32.84.165",19212,"184.173.217.40",443,9,552,6,372,3,180,51183.567817,1.308162999994238,2274.9458592034084,1100.7802544532622
"147.32.84.165",19213,"184.173.217.40",443,9,552,6,372,3,180,51185.871584,1.3075559999997495,2276.0019456150026,1101.2912640072593
"147.32.84.165",19214,"184.173.217.40",443,9,552,6,372,3,180,51188.174597,1.3077830000038375,2275.6068858451804,1101.1001060541194
"147.32.84.165",19215,"184.173.217.40",443,9,552,6,372,3,180,51190.478187,1.3080679999984568,2275.111079854802,1100.8601999297427
"147.32.84.165",19216,"184.173.217.40",443,9,552,6,372,3,180,51192.781225,1.3082419999991544,2274.808483447194,1100.7137823131582
"147.32.84.165",19217,"184.173.217.40",443,9,552,6,372,3,180,51195.084793,1.307636999998067,2275.8609614169677,1101.2230458469198
"147.32.84.165",19218,"184.173.217.40",443,9,552,6,372,3,180,51197.388242,1.307475000001432,2276.1429472813943,1101.3594906200294
"147.32.84.165",19219,"184.173.217.40",443,9,552,6,372,3,180,51199.691444,1.3075470000039786,2276.0176115970935,1101.298844321174
"147.32.84.165",19220,"184.173.217.40",443,9,552,6,372,3,180,51201.994863,1.307567999996536,2275.981057970128,1101.2811570823199
"147.32.84.165",19221,"184.173.217.40",443,9,552,6,372,3,180,51204.297819,1.3076900000014575,2275.768721942267,1101.1784138430323
"147.32.84.165",19222,"184.173.217.40",443,9,552,6,372,3,180,51206.601217,1.3077309999935096,2275.697372024346,1101.1438896891998
"147.32.84.165",19223,"184.173.217.40",443,9,552,6,372,3,180,51208.90453,1.3081860000020242,2274.905862006928,1100.760900971094
"147.32.84.165",19224,"184.173.217.40",443,9,552,6,372,3,180,51211.207558,1.3085139999966486,2274.3356204118736,1100.4849776186484
"147.32.84.165",19225,"184.173.217.40",443,9,552,6,372,3,180,51213.510914,1.308204000000842,2274.874560846844,1100.745755248473
"147.32.84.165",19226,"184.173.217.40",443,9,552,6,372,3,180,51215.814867,1.3073179999992135,2276.4162965719056,1101.4917564057607
"147.32.84.165",19227,"184.173.217.40",443,9,552,6,372,3,180,51218.117795,1.3074150000029476,2276.2474042238237,1101.4100343018501
"147.32.84.165",19228,"184.173.217.40",443,9,552,6,372,3,180,51220.420943,1.3078129999994417,2275.554685571462,1101.074847857159
"147.32.84.165",19229,"173.192.170.88",80,26,3997,18,1530,8,2467,51221.20773,43.47349199999735,281.55088162691754,453.9777941003958
"147.32.84.165",19230,"184.173.217.40",443,9,552,6,372,3,180,51222.724825,1.3070240000015474,2276.9283502035746,1101.7395242920522
"147.32.84.165",19231,"184.173.217.40",443,9,552,6,372,3,180,51225.027623,1.3077239999984158,2275.7095533947568,1101.1497839006888
"147.32.84.165",19232,"184.173.217.40",443,9,552,6,372,3,180,51227.330892,1.3076270000019576,2275.878365922044,1101.2314673816343
"147.32.84.165",19234,"184.173.217.40",443,9,552,6,372,3,180,51229.634134,1.308273000002373,2274.7545810351526,1100.6877005008803
"147.32.84.165",19235,"184.173.217.40",443,9,552,6,372,3,180,51231.937648,1.3080820000031963,2275.086730031243,1100.8484177570529
"147.32.84.165",19236,"184.173.217.40",443,9,552,6,372,3,180,51234.240675,1.3077940000002855,2275.5877454701204,1101.0908445823163
"147.32.84.165",19237,"184.173.217.40",443,9,552,6,372,3,180,51236.544361,1.307982999998785,2275.25892920838,1100.9317399395386
"147.32.84.165",19239,"98.126.71.122",80,18,4863,14,1430,4,3433,51238.346178,16.94504600000073,675.1235729899764,1620.7686895626496
"147.32.84.165",19240,"184.173.217.40",443,9,552,6,372,3,180,51238.847213,1.301086999999825,2287.3182193046277,1106.766880308691
"147.32.84.165",19241,"195.113.232.88",80,21,7810,14,3864,7,3946,51239.066268,59.541863999998895,519.1641296281987,530.18158786565
"147.32.84.165",19242,"195.113.232.96",80,13,2796,10,1774,3,1022,51239.197557,59.41075799999817,238.87929522798612,137.61817346279696
"147.32.84.165",19243,"195.113.232.83",80,46,35645,38,3440,8,32205,51239.576854,59.03163900000072,466.19068123789793,4364.439211996077
"147.32.84.165",19244,"77.238.175.247",80,14,2274,10,1276,4,998,51239.618684,0.20181900000170572,50579.97512579948,39560.19998083689
"147.32.84.165",19245,"74.125.232.217",80,13,1871,10,1156,3,715,51239.727731,58.88131599999906,157.0617069767963,97.14456789654788
"147.32.84.165",19246,"68.67.185.212",80,16,2170,12,1370,4,800,51239.754704,15.536298999999417,705.4447136992158,411.93851894844715
"147.32.84.165",19247,"64.236.79.229",80,14,2274,10,1560,4,714,51239.771462,0.355386000002909,35116.7462981036,16072.66465182434
"147.32.84.165",19248,"64.236.79.229",80,14,2078,10,1378,4,700,51239.786569,0.3549529999945662,31057.6329828703,15776.73663861336
"147.32.84.165",19249,"64.236.79.229",80,14,2061,10,1404,4,657,51239.832868,0.3558000000048196,31568.296795525166,14772.344013290622
"147.32.84.165",19250,"77.238.167.32",80,13,2342,10,1390,3,952,51239.838786,0.14000400000077207,79426.30210521612,54398.44575839262
"147.32.84.165",19251,"64.236.79.229",80,14,2043,10,1386,4,657,51239.916411,0.370799000003899,29902.99326557895,14174.795509008203
"147.32.84.165",19252,"77.238.175.247",80,14,3055,10,1368,4,1687,51239.933403,0.1431190000002971,76467.83445927712,94299.1496584799
"147.32.84.165",19253,"195.113.232.96",80,13,1965,10,1306,3,659,51240.029041,58.57983299999614,178.35489561741645,89.99684242869635
"147.32.84.165",19254,"64.236.79.229",80,14,2089,10,1432,4,657,51240.049838,0.35612899999978254,32168.11885582751,14758.69698902142
"147.32.84.165",19255,"74.217.252.37",80,12,2075,10,1278,2,797,51240.056389,58.552307000005385,174.6131027766175,108.89408678635692
"147.32.84.165",19256,"184.173.217.40",443,9,552,6,372,3,180,51241.147922,1.3077630000043428,2275.6416873624025,1101.1169454979367
"147.32.84.165",19257,"184.173.217.40",443,9,552,6,372,3,180,51243.456278,1.3071120000022347,2276.7750582925655,1101.6653507867254
"147.32.84.165",19258,"184.173.217.40",443,9,552,6,372,3,180,51245.763858,1.3071160000035889,2276.768090966547,1101.6619794999422
"147.32.84.165",19259,"184.173.217.40",443,9,552,6,372,3,180,51248.071308,1.306760999999824,2277.3866070386252,1101.9612614703026
"147.32.84.165",19260,"184.173.217.40",443,9,552,6,372,3,180,51250.378169,1.3072749999992084,2276.491174390853,1101.5279876084771
"147.32.84.165",19261,"184.173.217.40",443,9,552,6,372,3,180,51252.686203,1.3066650000037043,2277.5539254449786,1102.0422219895058
"147.32.84.165",19262,"184.173.217.40",443,9,552,6,372,3,180,51254.994351,1.3065029999997932,2277.836331030599,1102.1788698535158
"147.32.84.165",19263,"184.173.217.40",443,9,552,6,372,3,180,51257.301571,1.3076179999989108,2275.8940302156125,1101.2390468785222
"147.32.84.165",19264,"184.173.217.40",443,9,552,6,372,3,180,51259.61111,1.3069920000052662,2276.9840978276907,1101.7664989488826
"147.32.84.165",19265,"184.173.217.40",443,9,552,6,372,3,180,51261.91853,1.3066729999991367,2277.5399813128197,1102.035474828784
"147.32.84.165",19266,"173.192.170.88",80,34,5627,24,2770,10,2857,51263.096094,47.9312609999979,462.32875033271023,476.8495450182502
"147.32.84.165",19267,"184.173.217.40",443,9,552,6,372,3,180,51264.22564,1.3077460000058636,2275.6712694870844,1101.1312594292342
"147.32.84.165",19268,"173.192.170.88",80,11,1283,8,846,3,437,51264.480609,34.02761900000041,198.8972546095546,102.74007123448624
"147.32.84.165",19269,"184.173.217.40",443,9,552,6,372,3,180,51266.534065,1.3064329999979236,2277.958379805723,1102.2379257124464
"147.32.84.165",19270,"184.173.217.40",443,9,552,6,372,3,180,51268.840381,1.3075370000005933,2276.035018510872,1101.3072670213896
"147.32.84.165",19271,"184.173.217.40",443,9,552,6,372,3,180,51271.147567,1.307740999996895,2275.6799702747458,1101.13546948778
"147.32.84.165",19272,"184.173.217.40",443,9,552,6,372,3,180,51273.456355,1.3062109999955283,2278.345535300337,1102.4252590162919
"147.32.84.165",19274,"184.173.217.40",443,9,552,6,372,3,180,51275.762373,1.3075300000054995,2276.047203496274,1101.313162982068
"147.32.84.165",19275,"184.173.217.40",443,9,552,6,372,3,180,51278.069813,1.3073109999968437,2276.428485652752,1101.497654348106
"147.32.84.165",19276,"184.173.217.40",443,9,552,6,372,3,180,51280.376948,1.3080800000025192,2275.090208545554,1100.8501009091392
"147.32.84.165",19277,"184.173.217.40",443,9,552,6,372,3,180,51282.685371,1.3068570000032196,2277.219313201573,1101.880312839471
"147.32.84.165",19279,"98.126.71.122",80,18,4967,14,1534,4,3433,51284.421763,17.090644000003522,718.0536906624158,1606.9610952047412
"147.32.84.165",19280,"184.173.217.40",443,9,552,6,372,3,180,51284.994145,1.3064540000050329,2277.921763788496,1102.2202082847562
"147.32.84.165",19281,"195.113.232.98",80,21,8226,14,4176,7,4050,51285.024186,61.554072999999335,542.7423137377174,526.3664680645967
"147.32.84.165",19282,"195.113.232.89",80,13,2900,10,1878,3,1022,51285.161734,61.41632799999934,244.62550089285966,133.12420762114087
"147.32.84.165",19283,"195.113.232.99",80,13,2124,10,1792,3,332,51285.607298,60.97056699999666,235.12984552039322,43.56200262989428
"147.32.84.165",19284,"77.238.175.247",80,14,2274,10,1276,4,998,51285.874301,0.23752999999851454,42975.62413195739,33612.59630383501
"147.32.84.165",19285,"74.125.232.217",80,13,1871,10,1156,3,715,51285.879788,60.697869000003266,152.36119739227587,94.23724579193534
"147.32.84.165",19286,"68.67.185.208",80,16,2170,12,1370,4,800,51285.905626,15.606563000001188,702.2686545397065,410.08388586260236
"147.32.84.165",19287,"64.236.79.229",80,14,2170,10,1470,4,700,51286.018945,0.35517699999763863,33110.252071722505,15766.786700820243
"147.32.84.165",19288,"64.236.79.229",80,14,2366,10,1652,4,714,51286.020075,0.3567209999964689,37048.561761519006,16012.51398167347
"147.32.84.165",19289,"64.236.79.229",80,14,2153,10,1496,4,657,51286.048077,0.35561199999938253,33654.65732320838,14780.153650633629
"147.32.84.165",19290,"77.238.167.32",80,13,2342,10,1390,3,952,51286.066727,0.13987099999940256,79501.82668349764,54450.171944381116
"147.32.84.165",19291,"64.236.79.229",80,14,2135,10,1478,4,657,51286.147654,0.3553909999973257,33270.39795630439,14789.34469370229
"147.32.84.165",19292,"77.238.175.247",80,14,3055,10,1368,4,1687,51286.161273,0.14034299999912037,77980.37664912817,96164.39722739709
"147.32.84.165",19293,"74.217.252.37",80,12,2075,10,1278,2,797,51286.257691,60.31976500000019,169.49668156034707,105.70332958027903
"147.32.84.165",19294,"64.236.79.229",80,14,2181,10,1524,4,657,51286.258248,0.3563570000042091,34212.88202520504,14749.25425889745
"147.32.84.165",19295,"195.113.232.96",80,13,1965,10,1306,3,659,51286.261529,60.31571999999869,173.2218400111982,87.40673244056632
"147.32.84.165",19296,"184.173.217.40",443,9,552,6,372,3,180,51287.30146,1.3067879999944125,2277.3395531736783,1101.9384934711345
"147.32.84.165",19297,"184.173.217.40",443,9,552,6,372,3,180,51289.608257,1.3068290000010165,2277.268104700527,1101.9039216292872
"147.32.84.165",19298,"184.173.217.40",443,9,552,6,372,3,180,51291.915014,1.2069049999990966,2465.8113107512418,1193.1345052022139
"147.32.84.165",19299,"184.173.217.40",443,9,552,6,372,3,180,51294.122748,1.3079739999957383,2275.2745849762277,1100.939315311078
"147.32.84.165",19300,"184.173.217.40",443,9,552,6,372,3,180,51296.43169,1.3063160000019707,2278.162404805201,1102.3366474863874
"147.32.84.165",19301,"184.173.217.40",443,9,552,6,372,3,180,51298.74877,1.3073609999992186,2276.341423678524,1101.4555275863825
"147.32.84.165",19302,"94.100.176.20",25,6,372,6,372,0,0,51299.512977,9.00970999999845,330.3102985557262,0
"147.32.84.165",19303,"184.173.217.40",443,9,552,6,372,3,180,51301.052142,1.307343000000401,2276.372765218529,1101.4706928476753
"147.32.84.165",19304,"184.173.217.40",443,9,552,6,372,3,180,51303.35491,1.307944000000134,2275.3267723998083,1100.9645672902298
"147.32.84.165",19305,"184.173.217.40",443,9,552,6,372,3,180,51305.658699,1.3075220000027912,2276.0611293681077,1101.319901307149
"147.32.84.165",19306,"184.173.217.40",443,9,552,6,372,3,180,51307.961852,1.3079599999982747,2275.2989388084693,1100.951099423453
"147.32.84.165",19307,"184.173.217.40",443,9,552,6,372,3,180,51310.265427,1.3077909999992698,2275.59296554393,1101.0933704244821
"147.32.84.165",19308,"173.192.170.88",80,6,372,6,372,0,0,51310.826827,9.012007000004814,330.2261083461664,0
"147.32.84.165",19309,"184.173.217.40",443,9,552,6,372,3,180,51312.568506,1.3073229999936302,2276.4075901781735,1101.4875436346001
"147.32.84.165",19310,"184.173.217.40",443,9,552,6,372,3,180,51314.871968,1.3076310000033118,2275.871404083004,1101.2280987498407
"147.32.84.165",19311,"184.173.217.40",443,9,552,6,372,3,180,51317.176227,1.3065369999967515,2277.7770549225925,1102.1501878657705
"147.32.84.165",19312,"184.173.217.40",443,9,552,6,372,3,180,51319.47817,1.3078959999984363,2275.4102772724727,1101.0049728737772
"147.32.84.165",19313,"74.125.93.27",25,6,372,6,372,0,0,51320.539624,9.01276499999949,330.19833536103164,0
"147.32.84.165",19314,"184.173.217.40",443,9,552,6,372,3,180,51321.781377,1.3081989999991492,2274.883255530646,1100.7499623535384
"147.32.84.165",19315,"184.173.217.40",443,9,552,6,372,3,180,51324.084597,1.3079759999964153,2275.2711058980867,1100.9376318861712
"147.32.84.165",19316,"184.173.217.40",443,9,552,6,372,3,180,51326.388216,1.3074730000007548,2276.1464290262834,1101.3611753352984
"147.32.84.165",19317,"184.173.217.40",443,9,552,6,372,3,180,51328.69136,1.3088930000012624,2273.6770690936,1100.1663237549678
"147.32.84.165",19318,"184.173.217.40",443,9,552,6,372,3,180,51330.9946,1.3079780000043684,2275.267626817929,1100.935948460288
"147.32.84.165",19319,"173.192.170.88",80,6,372,6,372,0,0,51331.96451,9.004438000003574,330.5036916239324,0
"147.32.84.165",19320,"184.173.217.40",443,9,552,6,372,3,180,51333.298061,1.3077199999970617,2275.716514243635,1101.153152053372
"147.32.84.165",19321,"184.173.217.40",443,9,552,6,372,3,180,51335.601855,1.3072869999959948,2276.470277765416,1101.5178763381045
"147.32.84.165",19322,"184.173.217.40",443,9,552,6,372,3,180,51337.904468,1.3080709999994724,2275.1058619915893,1100.8576751572207
"147.32.84.165",19323,"184.173.217.40",443,9,552,6,372,3,180,51340.20794,1.3077479999992647,2275.6677892083744,1101.129575423407
"147.32.84.165",19324,"74.125.39.27",25,6,372,6,372,0,0,51341.569804,9.012948000003234,330.1916309734542,0
"147.32.84.165",19325,"184.173.217.40",443,9,552,6,372,3,180,51342.511106,1.3077650000050198,2275.6382071615135,1101.1152615297647
"147.32.84.165",19326,"184.173.217.40",443,9,552,6,372,3,180,51344.814674,1.3094060000003083,2272.786286300276,1099.7352998227143
"147.32.84.165",19327,"184.173.217.40",443,9,552,6,372,3,180,51347.118348,1.3072809999939636,2276.480726036515,1101.5229319531525
"147.32.84.165",19328,"184.173.217.40",443,9,552,6,372,3,180,51349.421458,1.3073760000042967,2276.315306377216,1101.442890182524
"147.32.84.165",19329,"184.173.217.40",443,9,552,6,372,3,180,51351.724555,1.307968000000983,2275.2850222618317,1100.9443656105636
"147.32.84.165",19330,"184.173.217.40",443,9,552,6,372,3,180,51354.028881,1.3066230000040377,2277.6271349814015,1102.0776459587426
"147.32.84.165",19331,"184.173.217.40",443,9,552,6,372,3,180,51356.331632,1.307797000001301,2275.5825254202596,1101.0883187517386
"147.32.84.165",19332,"184.173.217.40",443,9,552,6,372,3,180,51358.634663,1.3079639999996289,2275.291980513871,1100.9477325067116
"147.32.84.165",19333,"184.173.217.40",443,9,552,6,372,3,180,51360.937563,1.3084690000032424,2274.413837846082,1100.5228247642333
"147.32.84.165",19334,"66.111.4.73",25,6,372,6,372,0,0,51362.50041,9.01245000000199,330.20987633765986,0
"147.32.84.165",19335,"184.173.217.40",443,9,552,6,372,3,180,51363.2409,1.3076950000031502,2275.760020488593,1101.1742034622225
"147.32.84.165",19336,"184.173.217.40",443,9,552,6,372,3,180,51365.544768,1.307872999997926,2275.4502921955873,1101.0243349333487
"147.32.84.165",19337,"184.173.217.40",443,9,552,6,372,3,180,51367.848135,1.3076730000029784,2275.7983073698256,1101.1927293724962
"147.32.84.165",19338,"184.173.217.40",443,9,552,6,372,3,180,51370.151512,1.3076160000055097,2275.897511186358,1101.2407312192054
"147.32.84.165",19339,"184.173.217.40",443,9,552,6,372,3,180,51372.454577,1.3077760000014678,2275.619066259558,1101.105999803012
"147.32.84.165",19340,"184.173.217.40",443,9,552,6,372,3,180,51374.757501,1.3081489999967744,2274.9702059989636,1100.7920351607888
"147.32.84.165",19341,"184.173.217.40",443,9,552,6,372,3,180,51377.061099,1.3080709999994724,2275.1058619915893,1100.8576751572207
"147.32.84.165",19342,"184.173.217.40",443,9,552,6,372,3,180,51379.364346,1.3079069999948842,2275.391140204648,1100.995713002249
"147.32.84.165",19343,"184.173.217.40",443,9,552,6,372,3,180,51381.667974,1.3073509999958333,2276.3588355456836,1101.4639526833953
"147.32.84.165",19344,"216.157.130.15",25,6,372,6,372,0,0,51383.530486,9.012739999998303,330.19925128213623,0
"147.32.84.165",19345,"184.173.217.40",443,9,552,6,372,3,180,51383.971057,1.3075509999980568,2276.0106489187974,1101.295475283289
"147.32.84.165",19346,"184.173.217.40",443,9,552,6,372,3,180,51386.274418,1.307978999997431,2275.2658873008245,1100.9351067584635
"147.32.84.165",19347,"184.173.217.40",443,9,552,6,372,3,180,51388.577669,1.3075690000041504,2275.9793173366406,1101.28031484031
"147.32.84.165",19348,"184.173.217.40",443,9,552,6,372,3,180,51390.88122,1.3072289999981876,2276.571281699018,1101.5667492092025
"147.32.84.165",19349,"184.173.217.40",443,9,552,6,372,3,180,51393.184589,1.3074520000009215,2276.182987978069,1101.3788651506786
"147.32.84.165",19350,"184.173.217.40",443,9,552,6,372,3,180,51395.48798,1.3076189999992494,2275.8922897279012,1101.238204707049
"147.32.84.165",19351,"184.173.217.40",443,9,552,6,372,3,180,51397.791164,1.3078019999957178,2275.5738254030384,1101.0841090659865
"147.32.84.165",19352,"184.173.217.40",443,9,552,6,372,3,180,51400.094028,1.3078919999970822,2275.417236290641,1101.0083401406328
"147.32.84.165",19353,"184.173.217.40",443,9,552,6,372,3,180,51402.397797,1.3078050000040093,2275.568605404381,1101.0815832601843
"147.32.84.165",19354,"184.173.217.40",443,9,552,6,372,3,180,51404.70056,1.3079710000019986,2275.2798036007316,1100.941840451967
"147.32.84.165",19355,"184.173.217.40",443,9,552,6,372,3,180,51407.004037,1.3083449999976438,2274.6293982132843,1100.6271281677182
"147.32.84.165",19356,"184.173.217.40",443,9,552,6,372,3,180,51409.30746,1.3076589999982389,2275.8226724276037,1101.2045189165824
"147.32.84.165",19357,"184.173.217.40",443,9,552,6,372,3,180,51411.610892,1.3076970000038273,2275.756539925755,1101.1725193189138
"147.32.84.165",19358,"184.173.217.40",443,9,552,6,372,3,180,51413.914321,1.307213000000047,2276.5991464282356,1101.5802321426945
"147.32.84.165",19359,"184.173.217.40",443,9,552,6,372,3,180,51416.217648,1.3079219999999623,2275.3650447045666,1100.9830861473708
"147.32.84.165",19360,"184.173.217.40",443,9,552,6,372,3,180,51418.520674,1.3079500000021653,2275.3163347185086,1100.9595167992784
"147.32.84.165",19361,"184.173.217.40",443,9,552,6,372,3,180,51420.824289,1.3071770000024117,2276.6618445661984,1101.6105699513862
"147.32.84.165",19362,"184.173.217.40",443,9,552,6,372,3,180,51423.12771,1.3071879999988596,2276.642686440356,1101.6012998904948
"147.32.84.165",19363,"184.173.217.40",443,9,552,6,372,3,180,51425.431001,1.3072230000034324,2276.5817308846204,1101.5718052667517
"147.32.84.165",19364,"184.173.217.40",443,9,552,6,372,3,180,51427.73399,1.307730000000447,2275.6991122012823,1101.1447317102977
"147.32.84.165",19365,"184.173.217.40",443,9,552,6,372,3,180,51430.037253,1.3080100000006496,2275.2119632101603,1100.9090144565293
"147.32.84.165",19366,"184.173.217.40",443,9,552,6,372,3,180,51432.341182,1.3067280000032042,2277.4441199642943,1101.9890903053038
"147.32.84.165",19367,"184.173.217.40",443,9,552,6,372,3,180,51434.643959,1.3075539999990724,2276.0054269285333,1101.2929485138063
"147.32.84.165",19368,"184.173.217.40",443,9,552,6,372,3,180,51436.947012,1.3084780000062892,2274.398193921255,1100.515255123188
"147.32.84.165",19369,"184.173.217.40",443,9,552,6,372,3,180,51439.25074,1.3074939999933122,2276.1098712615294,1101.3434860942884
"147.32.84.165",19370,"184.173.217.40",443,9,552,6,372,3,180,51441.553906,1.3073719999956666,2276.322270944968,1101.4462601346618
"147.32.84.165",19371,"184.173.217.40",443,9,552,6,372,3,180,51443.85701,1.3079740000030142,2275.274584963571,1100.9393153049537
"147.32.84.165",19372,"184.173.217.40",443,9,552,6,372,3,180,51446.160652,1.3072880000036093,2276.468536383554,1101.5170337339778
"147.32.84.165",19373,"184.173.217.40",443,9,552,6,372,3,180,51448.463842,1.307475000001432,2276.1429472813943,1101.3594906200294
"147.32.84.165",19374,"184.173.217.40",443,9,552,6,372,3,180,51450.767319,1.3076100000034785,2275.907954200475,1101.2457842905526
"147.32.84.165",19375,"184.173.217.40",443,9,552,6,372,3,180,51453.070017,1.3078030000033323,2275.572085392385,1101.0832671253474
"147.32.84.165",19376,"184.173.217.40",443,9,552,6,372,3,180,51455.373649,1.3074550000019372,2276.1777651969596,1101.3763379985287
"147.32.84.165",19377,"184.173.217.40",443,9,552,6,372,3,180,51457.676861,1.3081610000008368,2274.949337274308,1100.7819373907944
"147.32.84.165",19378,"184.173.217.40",443,9,552,6,372,3,180,51459.980663,1.3071549999949639,2276.7001618105473,1101.6291105534906
"147.32.84.165",19379,"184.173.217.40",443,9,552,6,372,3,180,51462.283646,1.3079479999942123,2275.3198139476253,1100.961200297238
"147.32.84.165",19380,"184.173.217.40",443,9,552,6,372,3,180,51464.587127,1.3073670000012498,2276.3309766860834,1101.4504725900404
"147.32.84.165",19381,"184.173.217.40",443,9,552,6,372,3,180,51466.890385,1.3080780000018422,2275.0936870705027,1100.8517840663721
"147.32.84.165",19382,"184.173.217.40",443,9,552,6,372,3,180,51469.193746,1.3076839999994263,2275.7791637745095,1101.1834663425045
"147.32.84.165",19383,"184.173.217.40",443,9,552,6,372,3,180,51471.496668,1.308136999999988,2274.9910750938375,1100.8021331099214
"147.32.84.165",19384,"184.173.217.40",443,9,552,6,372,3,180,51473.800353,1.3074649999980466,2276.1603561123598,1101.367914247916
"147.32.84.165",19385,"184.173.217.40",443,9,552,6,372,3,180,51476.103818,1.3079409999991185,2275.331991276369,1100.967092553082
"147.32.84.165",19386,"184.173.217.40",443,9,552,6,372,3,180,51478.407052,1.3074199999973644,2276.238699121934,1101.4058221557746
"147.32.84.165",19387,"184.173.217.40",443,9,552,6,372,3,180,51480.710442,1.3076149999978952,2275.899251694719,1101.2415734006706
"147.32.84.165",19388,"184.173.217.40",443,9,552,6,372,3,180,51483.013741,1.3074940000005881,2276.1098712488633,1101.3434860881596
"147.32.84.165",19389,"184.173.217.40",443,9,552,6,372,3,180,51485.316731,1.3076710000023013,2275.801788060424,1101.1944135776246
"147.32.84.165",19390,"184.173.217.40",443,9,552,6,372,3,180,51487.619717,1.3080520000003162,2275.1389088501687,1100.8736655726623
"147.32.84.165",19391,"184.173.217.40",443,9,552,6,372,3,180,51489.923525,1.207369000003382,2464.8636829268135,1192.6759756097483
"147.32.84.165",19392,"184.173.217.40",443,9,552,6,372,3,180,51492.126411,1.3080250000057276,2275.185871819704,1100.8963895901795
"147.32.84.165",19393,"184.173.217.40",443,9,552,6,372,3,180,51494.429607,1.3078109999987646,2275.558165516891,1101.0765317017217
"147.32.84.165",19394,"184.173.217.40",443,9,552,6,372,3,180,51496.733357,1.307559000000765,2275.996723664675,1101.2887372571008
"147.32.84.165",19395,"184.173.217.40",443,9,552,6,372,3,180,51499.036155,1.308231999995769,2274.825871871063,1100.7221960666434
"147.32.84.165",19396,"184.173.217.40",443,9,552,6,372,3,180,51501.339564,1.3081400000010035,2274.985857781061,1100.7996086037392
"147.32.84.165",19397,"184.173.217.40",443,9,552,6,372,3,180,51503.642946,1.3075689999968745,2275.9793173493053,1101.280314846438
"147.32.84.165",19398,"184.173.217.40",443,9,552,6,372,3,180,51505.946009,1.3082500000018626,2274.7945728994937,1100.7070514029808
"147.32.84.165",19399,"184.173.217.40",443,9,552,6,372,3,180,51508.250183,1.3073420000000624,2276.374506441205,1101.4715353747767
"147.32.84.165",19400,"184.173.217.40",443,9,552,6,372,3,180,51510.552967,1.3079949999955716,2275.238055199046,1100.9216396124414
"147.32.84.165",19401,"184.173.217.40",443,9,552,6,372,3,180,51512.856495,1.3078840000016498,2275.4311544420193,1101.0150747300092
"147.32.84.165",19402,"184.173.217.40",443,9,552,6,372,3,180,51515.159277,1.3078270000041812,2275.5303262514735,1101.0630610894225
"147.32.84.165",19403,"184.173.217.40",443,9,552,6,372,3,180,51517.463064,1.307941999999457,2275.330251648189,1100.9662507975108
"147.32.84.165",19404,"184.173.217.40",443,9,552,6,372,3,180,51519.766634,1.3071800000034273,2276.656619587354,1101.6080417358164
"147.32.84.165",19405,"173.192.170.88",80,6,372,6,372,0,0,51521.234216,9.007253000003402,330.40040065476967,0
"147.32.84.165",19406,"184.173.217.40",443,9,552,6,372,3,180,51522.069223,1.3083299999998417,2274.6554768295155,1100.6397468529915
"147.32.84.165",19407,"184.173.217.40",443,9,552,6,372,3,180,51524.372535,1.3082649999996647,2274.7684910937483,1100.6944311743944
"147.32.84.165",19408,"94.100.176.20",25,6,372,6,372,0,0,51524.734169,9.012338999993517,330.2139433505709,0
"147.32.84.165",19409,"184.173.217.40",443,9,552,6,372,3,180,51526.676171,1.3077869999979157,2275.5999256795967,1101.096738232063
"147.32.84.165",19410,"184.173.217.40",443,9,552,6,372,3,180,51528.979181,1.3077359999952023,2275.688671116279,1101.139679572393
"147.32.84.165",19411,"184.173.217.40",443,9,552,6,372,3,180,51531.282575,1.307624000000942,2275.883587329275,1101.233993869004
"147.32.84.165",19412,"184.173.217.40",443,9,552,6,372,3,180,51533.586186,1.3077189999967231,2275.7182544625084,1101.1539940947623
"147.32.84.165",19413,"184.173.217.40",443,9,552,6,372,3,180,51535.890279,1.3072140000003856,2276.5974048618837,1101.5793894492986
"147.32.84.165",19414,"184.173.217.40",443,9,552,6,372,3,180,51538.192901,1.307489999999234,2276.116834546913,1101.3468554259257
"147.32.84.165",19415,"184.173.217.40",443,9,552,6,372,3,180,51540.49603,1.3075659999958589,2275.9845392197603,1101.2828415579486
"147.32.84.165",19416,"173.192.170.88",80,36,6165,24,1886,12,4279,51542.259317,87.8825480000014,171.68368855213163,389.5198851084683
"147.32.84.165",19417,"184.173.217.40",443,9,552,6,372,3,180,51542.799505,1.3077209999974002,2275.7147740274236,1101.1523100132695
"147.32.84.165",19418,"184.173.217.40",443,9,552,6,372,3,180,51545.102682,1.3079520000028424,2275.312855512689,1100.9578333125914
"147.32.84.165",19419,"74.125.93.27",25,6,372,6,372,0,0,51545.763829,9.012470999994548,330.20910691438564,0
"147.32.84.165",19420,"184.173.217.40",443,9,552,6,372,3,180,51547.405804,1.3080079999999725,2275.2154421074356,1100.9106977939205
"147.32.84.165",19422,"184.173.217.40",443,9,552,6,372,3,180,51549.709347,1.308164999994915,2274.9423811304905,1100.7785715147534
"147.32.84.165",19423,"184.173.217.40",443,9,552,6,372,3,180,51552.013011,1.307104999999865,2276.787251215708,1101.6712505882456
"147.32.84.165",19424,"184.173.217.40",443,9,552,6,372,3,180,51554.315981,1.307831999998598,2275.5216266333828,1101.0588515967981
"147.32.84.165",19425,"184.173.217.40",443,9,552,6,372,3,180,51556.618928,1.3081569999994827,2274.9562934733194,1100.7853032935416
"147.32.84.165",19427,"98.126.71.122",80,18,4863,14,1430,4,3433,51557.599112,19.991322999994736,572.2482699120519,1373.7960214042478
"147.32.84.165",19428,"195.113.232.88",80,17,5621,12,2574,5,3047,51558.184632,19.406033999999636,1061.1132599273187,1256.1041581190912
"147.32.84.165",19429,"195.113.232.99",80,13,1970,10,1598,3,372,51558.41234,19.17851900000096,666.579103422916,155.17360855652362
"147.32.84.165",19430,"184.173.217.40",443,9,552,6,372,3,180,51558.913649,1.3108849999989616,2270.2220255799384,1098.4945285064218
"147.32.84.165",19431,"184.173.217.40",443,9,552,6,372,3,180,51561.224492,1.307966000000306,2275.288501382531,1100.9460490560634
"147.32.84.165",19432,"184.173.217.40",443,9,552,6,372,3,180,51563.533475,1.307237000000896,2276.557349583863,1101.5600078631596
"147.32.84.165",19433,"173.192.170.88",80,6,372,6,372,0,0,51564.486281,8.937787000002572,332.9683287372079,0
"147.32.84.165",19434,"184.173.217.40",443,9,552,6,372,3,180,51565.841185,1.3076750000036554,2275.794826689874,1101.1910451725196
"147.32.84.165",19435,"74.125.39.27",25,6,372,6,372,0,0,51566.700831,9.030885000000126,329.5358096133389,0
"147.32.84.165",19436,"184.173.217.40",443,9,552,6,372,3,180,51568.148464,1.3084280000039143,2274.485107312819,1100.5573099900737
"147.32.84.165",19437,"184.173.217.40",443,9,552,6,372,3,180,51570.456404,1.308031000000483,2275.175435443733,1100.8913397308386
"147.32.84.165",19438,"184.173.217.40",443,9,552,6,372,3,180,51572.765199,1.3063039999979082,2278.183332520428,1102.346773800207
"147.32.84.165",19439,"184.173.217.40",443,9,552,6,372,3,180,51575.071739,1.3075210000024526,2276.062870114069,1101.3207436035818
"147.32.84.165",19440,"184.173.217.40",443,9,552,6,372,3,180,51577.380001,1.3175570000021253,2258.7258084433533,1092.9318427951712
"147.32.84.165",19441,"184.173.217.40",443,9,552,6,372,3,180,51579.693511,1.3077520000006189,2275.660828657568,1101.1262074149522
"147.32.84.165",19442,"184.173.217.40",443,9,552,6,372,3,180,51581.996447,1.3076490000021295,2275.8400763470577,1101.212940167931
"147.32.84.165",19443,"184.173.217.40",443,9,552,6,372,3,180,51584.300189,1.3070430000007036,2276.895251340926,1101.7235087133513
"147.32.84.165",19444,"173.192.170.88",80,22,2424,18,2178,4,246,51584.78161,45.35988999999972,384.1279156541188,43.38634860005198
"147.32.84.165",19445,"173.192.170.88",80,39,5550,28,2576,11,2974,51585.462463,110.62237800000003,186.29142107214506,215.0740241725774
"147.32.84.165",19446,"184.173.217.40",443,9,552,6,372,3,180,51586.60339,1.3076560000044992,2275.8278935666267,1101.207045274174
"147.32.84.165",19447,"66.111.4.73",25,6,372,6,372,0,0,51587.76508,9.012473000002501,330.20903363584824,0
"147.32.84.165",19448,"184.173.217.40",443,9,552,6,372,3,180,51588.906744,1.307847000003676,2275.4955281402454,1101.046223293667
"147.32.84.165",19449,"184.173.217.40",443,9,552,6,372,3,180,51591.209753,1.3076880000007804,2275.7722025423677,1101.1800980043715
"147.32.84.165",19450,"184.173.217.40",443,9,552,6,372,3,180,51593.512952,1.3078139999997802,2275.552945602739,1101.074005936809
"147.32.84.165",19451,"184.173.217.40",443,9,552,6,372,3,180,51595.81631,1.307911999996577,2275.382441638114,1100.9915040184421
"147.32.84.165",19452,"184.173.217.40",443,9,552,6,372,3,180,51598.120082,1.3071359999958077,2276.7332550014266,1101.6451233877872
"147.32.84.165",19453,"184.173.217.40",443,9,552,6,372,3,180,51600.422916,1.3079469999938738,2275.3215535598456,1100.9620420450865
"147.32.84.165",19454,"184.173.217.40",443,9,552,6,372,3,180,51602.726252,1.207817000002251,2463.949422797041,1192.2335916759876
"147.32.84.165",19455,"184.173.217.40",443,9,552,6,372,3,180,51604.929508,1.308249000001524,2274.7963117086524,1100.7078927622513
"147.32.84.165",19456,"184.173.217.40",443,9,552,6,372,3,180,51607.233033,1.30754600000364,2276.01935227649,1101.2996865853984
"147.32.84.165",19458,"216.157.130.15",25,6,372,6,372,0,0,51608.694827,9.01270199999999,330.2006434918189,0
"147.32.84.165",19459,"184.173.217.40",443,9,552,6,372,3,180,51609.536011,1.3081980000060867,2274.884994462729,1100.7508037722885
"147.32.84.165",19460,"184.173.217.40",443,9,552,6,372,3,180,51611.839384,1.3075349999999162,2276.038499925578,1101.3089515768927
"147.32.84.165",19461,"184.173.217.40",443,9,552,6,372,3,180,51614.152793,1.2975939999960246,2293.4754630563316,1109.7461918014508
"147.32.84.165",19462,"184.173.217.40",443,9,552,6,372,3,180,51616.446424,1.3076040000014473,2275.918397310429,1101.250837408272
"147.32.84.165",19464,"98.126.71.122",80,18,4967,14,1534,4,3433,51618.044037,20.099629999996978,610.5585028183028,1366.3933117178838
"147.32.84.165",19465,"195.113.232.88",80,18,5934,12,2764,6,3170,51618.608309,19.535605999997642,1131.8819595359707,1298.1424789178825
"147.32.84.165",19466,"184.173.217.40",443,9,552,6,372,3,180,51618.741307,1.3107360000067274,2270.480096666854,1098.619401612994
"147.32.84.165",19467,"195.113.232.99",80,13,2072,10,1700,3,372,51618.835185,19.30891499999416,704.3378667317203,154.1256978965882
"147.32.84.165",19468,"184.173.217.40",443,9,552,6,372,3,180,51621.052912,1.3078890000033425,2275.422455569543,1101.010865598166
"147.32.84.165",19469,"184.173.217.40",443,9,552,6,372,3,180,51623.361938,1.306032000000414,2278.6577970517237,1102.5763534121243
"147.32.84.165",19470,"184.173.217.40",443,9,552,6,372,3,180,51625.669325,1.3080359999948996,2275.1667385390037,1100.8871315511308
"147.32.84.165",19471,"184.173.217.40",443,9,552,6,372,3,180,51627.978111,1.3062500000014552,2278.2775119591843,1102.3923444963796
"147.32.84.165",19472,"173.192.170.88",80,6,372,6,372,0,0,51630.142956,9.041556999996828,329.14684937572633,0
"147.32.84.165",19473,"184.173.217.40",443,9,552,6,372,3,180,51630.284431,1.3085080000018934,2274.346049084678,1100.4900237506506
"147.32.84.165",19474,"184.173.217.40",443,9,552,6,372,3,180,51632.593947,1.3088070000012522,2273.82646944672,1100.2386142484127
"147.32.84.165",19475,"184.173.217.40",443,9,552,6,372,3,180,51634.903022,1.3070700000025681,2276.8482177650417,1101.7007505314716
"147.32.84.165",19476,"184.173.217.40",443,9,552,6,372,3,180,51637.210074,1.320103999998537,2254.3678376880143,1090.823147268394
"147.32.84.165",19477,"184.173.217.40",443,9,552,6,372,3,180,51639.525056,1.3081230000025243,2275.0154228572214,1100.8139142857524
"147.32.84.165",19478,"184.173.217.40",443,9,552,6,372,3,180,51641.828539,1.3077100000009523,2275.733916539472,1101.1615725190993
"147.32.84.165",19479,"184.173.217.40",443,9,552,6,372,3,180,51644.13208,1.3073879999938072,2276.2944129930033,1101.4327804804855
"147.32.84.165",19480,"173.192.170.88",80,23,2735,18,2174,5,561,51645.534501,50.55189199999586,344.04251377973003,88.78005990360099
"147.32.84.165",19481,"184.173.217.40",443,9,552,6,372,3,180,51646.435562,1.307068000001891,2276.851701667927,1101.7024362909326
"147.32.84.165",19482,"184.173.217.40",443,9,552,6,372,3,180,51648.738569,1.3080419999969308,2275.156302325906,1100.8820817705998
"147.32.84.165",19483,"184.173.217.40",443,9,552,6,372,3,180,51651.041548,1.3081339999989723,2274.9962924305446,1100.804657627683
"147.32.84.165",19485,"184.173.217.40",443,9,552,6,372,3,180,51653.345256,1.3077399999965564,2275.6817104377296,1101.1363115021272
"147.32.84.165",19486,"184.173.217.40",443,9,552,6,372,3,180,51655.648286,1.3081939999974566,2274.891950280911,1100.7541694907634
"147.32.84.165",19487,"184.173.217.40",443,9,552,6,372,3,180,51657.95148,1.3079319999960717,2275.3476480496984,1100.9746684111444
"147.32.84.165",19488,"184.173.217.40",443,9,552,6,372,3,180,51660.25533,1.3074629999973695,2276.163837910509,1101.3695989889559
"147.32.84.165",19490,"173.192.170.88",80,6,372,6,372,0,0,51661.258648,8.97077100000024,331.7440607947656,0
"147.32.84.165",19491,"184.173.217.40",443,9,552,6,372,3,180,51662.558405,1.3077359999952023,2275.688671116279,1101.139679572393
"147.32.84.165",19492,"184.173.217.40",443,9,552,6,372,3,180,51664.861331,1.307823000002827,2275.5372860039674,1101.0664287115972
"147.32.84.165",19493,"184.173.217.40",443,9,552,6,372,3,180,51667.164722,1.3078259999965667,2275.5320661982655,1101.0639029991607
"147.32.84.165",19494,"184.173.217.40",443,9,552,6,372,3,180,51669.468208,1.307613000004494,2275.902732681437,1101.2432577490824
"147.32.84.165",19495,"184.173.217.40",443,9,552,6,372,3,180,51671.771676,1.30766500000027,2275.8122301961016,1101.1994662239201
"147.32.84.165",19496,"184.173.217.40",443,9,552,6,372,3,180,51674.075061,1.3072399999946356,2276.552125097314,1101.557479885797
"147.32.84.165",19497,"184.173.217.40",443,9,552,6,372,3,180,51676.378332,1.3074449999985518,2276.1951745605334,1101.384761884129
"147.32.84.165",19498,"184.173.217.40",443,9,552,6,372,3,180,51678.681603,1.3075769999995828,2275.965392478569,1101.273577005759
"147.32.84.165",19499,"184.173.217.40",443,9,552,6,372,3,180,51680.984874,1.3079209999996237,2275.36678438595,1100.9839279286855
"147.32.84.165",19500,"184.173.217.40",443,9,552,6,372,3,180,51683.287867,1.3082219999996596,2274.8432605481134,1100.7306099426357
"147.32.84.165",19501,"184.173.217.40",443,9,552,6,372,3,180,51685.591421,1.3078260000038426,2275.532066185606,1101.063902993035
"147.32.84.165",19502,"184.173.217.40",443,9,552,6,372,3,180,51687.894816,1.3076070000024629,2275.9131757434725,1101.2483108436156
"147.32.84.165",19503,"173.192.170.88",80,21,2247,16,1692,5,555,51688.787013,83.92078000000038,161.29497366444807,52.907039233905834
"147.32.84.165",19504,"184.173.217.40",443,9,552,6,372,3,180,51690.198159,1.3077360000024782,2275.6886711036173,1101.1396795662665
"147.32.84.165",19505,"184.173.217.40",443,9,552,6,372,3,180,51692.501324,1.3079560000041965,2275.3058971329706,1100.954466354663
"147.32.84.165",19506,"184.173.217.40",443,9,552,6,372,3,180,51694.804896,1.3075630000021192,2275.989761101512,1101.2853682749253
"147.32.84.165",19507,"184.173.217.40",443,9,552,6,372,3,180,51697.10768,1.3078390000009676,2275.509447262085,1101.0529583526218
"147.32.84.165",19508,"184.173.217.40",443,9,552,6,372,3,180,51699.411458,1.3078479999967385,2275.4937882746476,1101.0453814232167
"147.32.84.165",19509,"184.173.217.40",443,9,552,6,372,3,180,51701.714805,1.3073779999976978,2276.3118241283246,1101.441205223383
"147.32.84.165",19510,"184.173.217.40",443,9,552,6,372,3,180,51704.017969,1.307410000001255,2276.2561094049634,1101.4142464862728
"147.32.84.165",19511,"184.173.217.40",443,9,552,6,372,3,180,51706.321064,1.3080649999974412,2275.116297741948,1100.8627247138459
"147.32.84.165",19512,"184.173.217.40",443,9,552,6,372,3,180,51708.624683,1.3079369999977644,2275.338949815692,1100.970459588238
"147.32.84.165",19513,"184.173.217.40",443,9,552,6,372,3,180,51710.927738,1.30754600000364,2276.01935227649,1101.2996865853984
"147.32.84.165",19514,"184.173.217.40",443,9,552,6,372,3,180,51713.231294,1.3077960000009625,2275.5842654342187,1101.089160693977
"147.32.84.165",19515,"184.173.217.40",443,9,552,6,372,3,180,51715.534132,1.2077769999959855,2464.0310256031466,1192.2730769047485
"147.32.84.165",19516,"184.173.217.40",443,9,552,6,372,3,180,51717.737532,1.3076930000024731,2275.763501062078,1101.1758876106828
"147.32.84.165",19517,"184.173.217.40",443,9,552,6,372,3,180,51720.041168,1.3078049999967334,2275.568605417041,1101.0815832663102
"147.32.84.165",19518,"184.173.217.40",443,9,552,6,372,3,180,51722.344461,1.307345000001078,2276.369282781168,1101.4690077973394
"147.32.84.165",19519,"184.173.217.40",443,9,552,6,372,3,180,51724.647915,1.3073699999949895,2276.3257532384905,1101.4479451153986
"147.32.84.165",19520,"184.173.217.40",443,9,552,6,372,3,180,51726.950796,1.30812600000354,2275.010205432769,1100.8113897255334
"147.32.84.165",19521,"184.173.217.40",443,9,552,6,372,3,180,51729.254149,1.3075539999990724,2276.0054269285333,1101.2929485138063
"147.32.84.165",19522,"184.173.217.40",443,9,552,6,372,3,180,51731.557442,1.308193000004394,2274.8936892262873,1100.7550109159454
"147.32.84.165",19523,"184.173.217.40",443,9,552,6,372,3,180,51733.860544,1.30763499999739,2275.8644422992197,1101.2247301447837
"147.32.84.165",19525,"184.173.217.40",443,9,552,6,372,3,180,51736.164173,1.3078700000041863,2275.455511626136,1101.0268604642592
"147.32.84.165",19526,"184.173.217.40",443,9,552,6,372,3,180,51738.467724,1.3074679999990622,2276.155133435109,1101.3653871460203
"147.32.84.165",19527,"184.173.217.40",443,9,552,6,372,3,180,51740.770998,1.307554999999411,2276.0036862704364,1101.2921062598887
"147.32.84.165",19528,"184.173.217.40",443,9,552,6,372,3,180,51743.074148,1.3081170000004931,2275.025857777919,1100.8189634409287
"147.32.84.165",19530,"173.192.170.88",80,6,372,6,372,0,0,51744.604119,8.94487599999411,332.70444442180747,0
"147.32.84.165",19531,"184.173.217.40",443,9,552,6,372,3,180,51745.377292,1.3081460000030347,2274.975423227297,1100.7945596261115
"147.32.84.165",19532,"184.173.217.40",443,9,552,6,372,3,180,51747.680707,1.3080960000006598,2275.06238074155,1100.8366358426856
"147.32.84.165",19533,"94.100.176.20",25,6,372,6,372,0,0,51749.955217,9.001419000000169,330.61453977422275,0
"147.32.84.165",19534,"184.173.217.40",443,9,552,6,372,3,180,51749.984014,1.3080469999986235,2275.147605554794,1100.8778736555455
"147.32.84.165",19535,"184.173.217.40",443,9,552,6,372,3,180,51752.287186,1.3076299999956973,2275.8731445514345,1101.2289409119844
"147.32.84.165",19536,"184.173.217.40",443,9,552,6,372,3,180,51754.590593,1.3076099999962025,2275.907954213139,1101.24578429668
"147.32.84.165",19537,"184.173.217.40",443,9,552,6,372,3,180,51756.893665,1.3082919999942533,2274.7215453530803,1100.671715493426
"147.32.84.165",19538,"184.173.217.40",443,9,552,6,372,3,180,51759.196931,1.3085819999978412,2274.217435365082,1100.4277913056849
"147.32.84.165",19539,"184.173.217.40",443,9,552,6,372,3,180,51761.500711,1.3074930000002496,2276.1116120693814,1101.3443284206685
"147.32.84.165",19540,"184.173.217.40",443,9,552,6,372,3,180,51763.804243,1.3070280000029015,2276.9213819393262,1101.7361525512868
"147.32.84.165",19541,"184.173.217.40",443,9,552,6,372,3,180,51766.107014,1.3083219999971334,2274.6693856760953,1100.646476940046
"147.32.84.165",19542,"184.173.217.40",443,9,552,6,372,3,180,51768.410718,1.3077489999996033,2275.666049066681,1101.1287334193617
"147.32.84.165",19543,"184.173.217.40",443,9,552,6,372,3,180,51770.714122,1.307479000002786,2276.1359838235708,1101.3561212049535
"147.32.84.165",19544,"74.125.93.27",25,6,372,6,372,0,0,51770.974015,9.013397000002442,330.1751825642645,0
"147.32.84.165",19545,"173.192.170.88",80,24,2431,18,1812,6,619,51772.507426,75.76074200000585,191.3392030927955,65.3636681647022
"147.32.84.165",19546,"184.173.217.40",443,9,552,6,372,3,180,51773.017241,1.3076470000014524,2275.8435571654236,1101.2146244348824
"147.32.84.165",19547,"184.173.217.40",443,9,552,6,372,3,180,51775.320337,1.3076820000060252,2275.782644393888,1101.1851505131715
"147.32.84.165",19548,"184.173.217.40",443,9,552,6,372,3,180,51777.623885,1.3079089999955613,2275.3876607700536,1100.9940294048645
"147.32.84.165",19549,"184.173.217.40",443,9,552,6,372,3,180,51779.927075,1.307343000000401,2276.372765218529,1101.4706928476753
"147.32.84.165",19550,"184.173.217.40",443,9,552,6,372,3,180,51782.230036,1.3078559999994468,2275.4798693443763,1101.0386464569563
"147.32.84.165",19551,"184.173.217.40",443,9,552,6,372,3,180,51784.533588,1.2077199999985169,2464.1473189180065,1192.3293478635514
"147.32.84.165",19552,"184.173.217.40",443,9,552,6,372,3,180,51786.736834,1.3077119999943534,2275.7304360691423,1101.1598884205528
"147.32.84.165",19553,"184.173.217.40",443,9,552,6,372,3,180,51789.039922,1.3079879999932018,2275.2502316653267,1100.9275314509646
"147.32.84.165",19554,"184.173.217.40",443,9,552,6,372,3,180,51791.343569,1.3080440000048839,2275.1528235968276,1100.880398514594
"147.32.84.165",19555,"74.125.39.27",25,6,372,6,372,0,0,51791.904908,9.012547000005725,330.20632236349053,0
"147.32.84.165",19556,"184.173.217.40",443,9,552,6,372,3,180,51793.647041,1.3080010000048787,2275.2276183190224,1100.9165895092044
"147.32.84.165",19557,"184.173.217.40",443,9,552,6,372,3,180,51795.950218,1.3075600000011036,2275.9949830198907,1101.2878950096244
"147.32.84.165",19558,"184.173.217.40",443,9,552,6,372,3,180,51798.253188,1.307944000000134,2275.3267723998083,1100.9645672902298
"147.32.84.165",19559,"184.173.217.40",443,9,552,6,372,3,180,51800.556547,1.3080189999964205,2275.1963083167325,1100.9014395080965
"147.32.84.165",19560,"184.173.217.40",443,9,552,6,372,3,180,51802.859762,1.3082369999974617,2274.8171776258996,1100.7179891738224
"147.32.84.165",19561,"184.173.217.40",443,9,552,6,372,3,180,51805.163115,1.3080759999938891,2275.097165618743,1100.8534672348756
"147.32.84.165",19562,"184.173.217.40",443,9,552,6,372,3,180,51807.466467,1.3080120000013267,2275.2084843235243,1100.907331124286
"147.32.84.165",19563,"184.173.217.40",443,9,552,6,372,3,180,51809.770413,1.3070020000013756,2276.966676406668,1101.7580692290328
"147.32.84.165",19564,"184.173.217.40",443,9,552,6,372,3,180,51812.073109,1.3083430000042426,2274.6328753166026,1100.6288106370657
"147.32.84.165",19565,"66.111.4.73",25,6,372,6,372,0,0,51812.934549,9.012960000000021,330.19119135112027,0
"147.32.84.165",19566,"184.173.217.40",443,9,552,6,372,3,180,51814.37663,1.3074090000009164,2276.2578504491817,1101.4150889270234
"147.32.84.165",19568,"184.173.217.40",443,9,552,6,372,3,180,51816.680088,1.3074950000009267,2276.108130431008,1101.3426437569394
"147.32.84.165",19569,"184.173.217.40",443,9,552,6,372,3,180,51818.983281,1.3075969999990775,2275.9305810598366,1101.256732770889
"147.32.84.165",19570,"173.192.170.88",80,53,7920,34,2932,19,4988,51821.268789,44.13013299999875,531.5189056874283,904.2347549689264
"147.32.84.165",19571,"184.173.217.40",443,9,552,6,372,3,180,51821.28624,1.3079890000008163,2275.248492149508,1100.9266897497619
"147.32.84.165",19572,"184.173.217.40",443,9,552,6,372,3,180,51823.589583,1.3077730000004522,2275.624286477065,1101.108525714709
"147.32.84.165",19573,"184.173.217.40",443,9,552,6,372,3,180,51825.894825,1.305994999995164,2278.7223534630834,1102.607590385363
"147.32.84.165",19575,"173.192.170.88",80,6,372,6,372,0,0,51825.911639,8.954538999998476,332.3454172236568,0
"147.32.84.165",19576,"184.173.217.40",443,9,552,6,372,3,180,51828.196478,1.3081750000055763,2274.924990912771,1100.7701568932764
"147.32.84.165",19577,"184.173.217.40",443,9,552,6,372,3,180,51830.499442,1.3079609999986133,2275.29719923083,1100.950257692337
"147.32.84.165",19578,"184.173.217.40",443,9,552,6,372,3,180,51832.803176,1.3077879999982542,2275.598185641689,1101.0958962782365
"147.32.84.165",19580,"216.157.130.15",25,6,372,6,372,0,0,51833.96508,9.014365999995789,330.1396903566363,0
"147.32.84.165",19581,"184.173.217.40",443,9,552,6,372,3,180,51835.106555,1.307622000000265,2275.887068280739,1101.2356782003578
"147.32.84.165",19582,"184.173.217.40",443,9,552,6,372,3,180,51837.409869,1.3080079999999725,2275.2154421074356,1100.9106977939205
"147.32.84.165",19583,"184.173.217.40",443,9,552,6,372,3,180,51839.713146,1.3076149999978952,2275.899251694719,1101.2415734006706
"147.32.84.165",19584,"184.173.217.40",443,9,552,6,372,3,180,51842.016654,1.3074439999982133,2276.1969155115376,1101.3856042797763
"147.32.84.165",19586,"98.126.71.122",80,18,4973,14,1540,4,3433,51842.984213,16.61273199999414,741.5998765286978,1653.1898546253374
"147.32.84.165",19587,"195.113.232.88",80,17,5981,12,2776,5,3205,51843.557085,55.402971999996225,400.84492218218026,462.7910574905936
"147.32.84.165",19588,"195.113.232.99",80,60,44434,46,3864,14,40570,51843.824121,55.13602700000047,560.6497544699719,5886.532230550403
"147.32.84.165",19589,"77.238.175.247",80,14,2274,10,1276,4,998,51843.861589,0.19664799999736715,51910.01179842496,40600.46377337626
"147.32.84.165",19590,"64.236.79.229",80,14,2274,10,1560,4,714,51843.889834,0.3558869999978924,35067.31069152261,16050.038354966118
"147.32.84.165",19591,"74.125.232.217",80,13,1871,10,1156,3,715,51843.9109,55.04947099999845,167.99434821090762,103.90653890207521
"147.32.84.165",19592,"68.67.185.216",80,16,2169,12,1370,4,799,51843.941933,15.654772999994748,700.1059676817848,408.3099767720774
"147.32.84.165",19593,"64.236.79.229",80,14,2078,10,1378,4,700,51843.978932,0.35529500000120606,31027.737513791577,15761.550260997174
"147.32.84.165",19594,"64.236.79.229",80,14,2061,10,1404,4,657,51844.03031,0.38524799999868264,29155.245452379786,13643.15973092131
"147.32.84.165",19595,"77.238.167.32",80,13,2342,10,1390,3,952,51844.075577,0.14009899999655318,79372.44377385694,54361.558613461726
"147.32.84.165",19596,"64.236.79.229",80,14,2043,10,1386,4,657,51844.129898,0.35504999999830034,31229.404309401718,14803.548796015099
"147.32.84.165",19597,"195.113.232.96",80,13,1965,10,1306,3,659,51844.148681,54.811782000004314,190.6159518769008,96.18370006652192
"147.32.84.165",19598,"77.238.175.247",80,14,3055,10,1368,4,1687,51844.170415,0.14061899999796879,77827.32063347119,95975.65051803061
"147.32.84.165",19599,"64.236.79.229",80,14,2089,10,1432,4,657,51844.297342,0.35508000000118045,32263.15196564694,14802.298073624328
"147.32.84.165",19600,"184.173.217.40",443,9,552,6,372,3,180,51844.310956,1.311785999998392,2268.6627239531813,1097.7400277192812
"147.32.84.165",19601,"74.217.252.37",80,12,2075,10,1278,2,797,51844.373597,54.58667400000559,187.29846042642117,116.80506491381665
"147.32.84.165",19602,"184.173.217.40",443,9,552,6,372,3,180,51846.623238,1.3080209999970975,2275.19282947797,1100.8997561990177
"147.32.84.165",19603,"173.192.170.88",80,18,2429,14,1930,4,499,51848.067507,46.64119799999753,331.03780910603575,85.58956826109423
"147.32.84.165",19604,"184.173.217.40",443,9,552,6,372,3,180,51848.931765,1.3059460000004037,2278.807852697646,1102.648960982732
"147.32.84.165",19605,"184.173.217.40",443,9,552,6,372,3,180,51851.237484,1.308020000004035,2275.1945688833653,1100.9005978467897
"147.32.84.165",19606,"184.173.217.40",443,9,552,6,372,3,180,51853.545706,1.3072480000046198,2276.538193203954,1101.5507386470747
"147.32.84.165",19607,"184.173.217.40",443,9,552,6,372,3,180,51855.853447,1.307184999997844,2276.647911355247,1101.6038280751195
"147.32.84.165",19608,"184.173.217.40",443,9,552,6,372,3,180,51858.160936,1.3065789999964181,2277.7038357482847,1102.114759233041
"147.32.84.165",19609,"184.173.217.40",443,9,552,6,372,3,180,51860.468319,1.3079599999982747,2275.2989388084693,1100.951099423453
"147.32.84.165",19610,"184.173.217.40",443,9,552,6,372,3,180,51862.776678,1.3079429999997956,2275.3285120226687,1100.9654090432266
"147.32.84.165",19611,"184.173.217.40",443,9,552,6,372,3,180,51865.085217,1.306486000001314,2277.865970241554,1102.1932114072035
"147.32.84.165",19612,"173.192.170.88",80,19,1767,14,1210,5,557,51865.198431,66.34197600000334,145.91063733162716,67.16712809398044
"147.32.84.165",19613,"184.173.217.40",443,9,552,6,372,3,180,51867.391195,1.3083740000001853,2274.578981238987,1100.6027328575744
"147.32.84.165",19614,"184.173.217.40",443,9,552,6,372,3,180,51869.699322,1.3091480000002775,2273.234195063789,1099.9520298695752
"147.32.84.165",19615,"184.173.217.40",443,9,552,6,372,3,180,51872.008257,1.3083419999966281,2274.634613891222,1100.6296518828497
"147.32.84.165",19616,"184.173.217.40",443,9,552,6,372,3,180,51874.318325,1.3077360000024782,2275.6886711036173,1101.1396795662665
"147.32.84.165",19617,"184.173.217.40",443,9,552,6,372,3,180,51876.626055,1.308660000002419,2274.0818852830366,1100.3622025563081
"147.32.84.165",19618,"184.173.217.40",443,9,552,6,372,3,180,51878.935741,1.3073759999970207,2276.3153063898844,1101.4428901886538
"147.32.84.165",19619,"184.173.217.40",443,9,552,6,372,3,180,51881.243898,1.3073129999975208,2276.4250030449048,1101.4959692152765
"147.32.84.165",19620,"184.173.217.40",443,9,552,6,372,3,180,51883.552171,1.3055139999996754,2279.5619196735843,1103.0138321001216
"147.32.84.165",19621,"184.173.217.40",443,9,552,6,372,3,180,51885.85721,1.3077349999948638,2275.6904112925695,1101.1405215931788
"147.32.84.165",19622,"184.173.217.40",443,9,552,6,372,3,180,51888.165519,1.3067799999989802,2277.3534948517135,1101.9452394443776
"147.32.84.165",19623,"184.173.217.40",443,9,552,6,372,3,180,51890.473043,1.3067819999996573,2277.350009413032,1101.9435529417897
"147.32.84.165",19624,"184.173.217.40",443,9,552,6,372,3,180,51892.779878,1.3075899999967078,2275.942764939693,1101.2626281966257
"147.32.84.165",19625,"184.173.217.40",443,9,552,6,372,3,180,51895.08769,1.3064830000002985,2277.8712007728536,1102.1957423094452
"147.32.84.165",19626,"184.173.217.40",443,9,552,6,372,3,180,51897.393708,1.3080129999943892,2275.2067448968514,1100.9064894662185
"147.32.84.165",19628,"184.173.217.40",443,9,552,6,372,3,180,51899.712427,1.3074170000036247,2276.243922170011,1101.408349437102
"147.32.84.165",19629,"184.173.217.40",443,9,552,6,372,3,180,51902.015703,1.3072560000000522,2276.524261506454,1101.543997503123
"147.32.84.165",19630,"184.173.217.40",443,9,552,6,372,3,180,51904.31833,1.3084009999947739,2274.5320433199663,1100.580020961274
"147.32.84.165",19631,"184.173.217.40",443,9,552,6,372,3,180,51906.621823,1.308312000001024,2274.686771960871,1100.654889658486
"147.32.84.165",19633,"173.192.170.88",80,18,2873,14,2344,4,529,51908.915064,12.499313000000257,1500.242453325204,338.57860828030414
"147.32.84.165",19634,"184.173.217.40",443,9,552,6,372,3,180,51908.925436,1.3079240000006394,2275.3615653497795,1100.981402588603
"147.32.84.165",19635,"184.173.217.40",443,9,552,6,372,3,180,51911.22893,1.3075109999990673,2276.0802777201284,1101.3291666387718
"147.32.84.165",19636,"184.173.217.40",443,9,552,6,372,3,180,51913.53164,1.2992210000011255,2290.603369247743,1108.3564689908435
"147.32.84.165",19637,"50.23.235.4",80,28,10451,20,3394,8,7057,51913.675968,55.22984899999574,491.618218981589,1022.2008754723258
"147.32.84.165",19638,"87.248.203.254",80,16,1813,12,1396,4,417,51914.341643,7.072611000003235,1579.0490951637084,471.67870536050606
"147.32.84.165",19639,"174.36.246.56",80,29,14501,22,2048,7,12453,51914.572484,0.4111960000009276,39844.74557136509,242278.62138682103
"147.32.84.165",19640,"74.125.232.207",80,33,9022,26,7176,7,1846,51914.870029,54.035985000002256,1062.4031374647395,273.2993578260743
"147.32.84.165",19641,"195.113.232.97",80,327,290668,244,16478,83,274190,51914.871363,54.03473700000177,2439.6158345324357,40594.62711921644
"147.32.84.165",19642,"195.113.232.97",80,207,176601,156,10718,51,165883,51914.871542,54.03468499999872,1586.8326057605784,24559.48433862493
"147.32.84.165",19643,"174.36.246.56",80,20,8234,14,1992,6,6242,51914.900176,0.40803299999970477,39055.664615390255,122382.25829782427
"147.32.84.165",19644,"95.172.94.17",80,13,2046,10,1470,3,576,51914.926977,0.07101399999373825,165601.1490837997,64888.61351855009
"147.32.84.165",19645,"174.36.246.56",80,19,8478,14,2218,5,6260,51915.210855,0.4028260000050068,44048.79526093017,124321.66741813475
"147.32.84.165",19646,"174.36.246.56",80,34,21865,26,2952,8,18913,51915.511815,0.38385399999970105,61523.391706269555,394170.7003186572
"147.32.84.165",19647,"174.36.246.56",80,16,5755,12,1892,4,3863,51915.802977,0.38377500000206055,39439.775910152384,80526.35007448132
"147.32.84.165",19648,"184.173.217.40",443,9,552,6,372,3,180,51915.830526,1.3077919999996084,2275.5912255166654,1101.092528475806
"147.32.84.165",19649,"174.36.246.56",80,17,7001,12,1648,5,5353,51916.084925,0.38551499999448424,34198.40991968829,111082.57785199721
"147.32.84.165",19650,"184.173.217.40",443,9,552,6,372,3,180,51918.13816,1.3076389999987441,2275.857480545363,1101.221361554208
"147.32.84.165",19651,"184.173.217.40",443,9,552,6,372,3,180,51920.44512,1.3081940000047325,2274.8919502682584,1100.7541694846411
"147.32.84.165",19652,"184.173.217.40",443,9,552,6,372,3,180,51922.753855,1.3065399999977672,2277.7718248236456,1102.1476571727317
"147.32.84.165",19653,"184.173.217.40",443,9,552,6,372,3,180,51925.060579,1.3081330000059097,2274.998031535444,1100.8054991300537
"147.32.84.165",19654,"184.173.217.40",443,9,552,6,372,3,180,51927.368849,1.3075749999989057,2275.9688736802786,1101.2752614581993
"147.32.84.165",19655,"184.173.217.40",443,9,552,6,372,3,180,51929.675949,1.307412000001932,2276.2526273245176,1101.4125616086376
"147.32.84.165",19656,"173.192.170.88",80,19,2125,14,1568,5,557,51931.340057,70.40440300000046,178.17067492213405,63.291496129865216
"147.32.84.165",19657,"184.173.217.40",443,9,552,6,372,3,180,51931.98338,1.3074459999988903,2276.1934336121917,1101.3839194897703
"147.32.84.165",19658,"184.173.217.40",443,9,552,6,372,3,180,51934.290958,1.3075950000056764,2275.9340621423917,1101.2584171656736
"147.32.84.165",19659,"184.173.217.40",443,9,552,6,372,3,180,51936.598642,1.3069920000052662,2276.9840978276907,1101.7664989488826
"147.32.84.165",19660,"184.173.217.40",443,9,552,6,372,3,180,51938.905232,1.3076700000019628,2275.803528409716,1101.1952556821207
"147.32.84.165",19661,"184.173.217.40",443,9,552,6,372,3,180,51941.212511,1.3091530000019702,2273.225512980928,1099.9478288617395
"147.32.84.165",19662,"184.173.217.40",443,9,552,6,372,3,180,51943.522356,1.3061929999967106,2278.3769320517677,1102.4404509927908
"147.32.84.165",19663,"184.173.217.40",443,9,552,6,372,3,180,51945.828787,1.3081139999994775,2275.031075274165,1100.8214880358862
"147.32.84.165",19664,"184.173.217.40",443,9,552,6,372,3,180,51948.136898,1.308046000005561,2275.149344891042,1100.8787152698592
"147.32.84.165",19665,"184.173.217.40",443,9,552,6,372,3,180,51950.445191,1.307200000002922,2276.6217870206146,1101.5911872680394
"147.32.84.165",19666,"184.173.217.40",443,9,552,6,372,3,180,51952.753002,1.306720000000496,2277.4580629353422,1101.9958369041979
"147.32.84.165",19667,"184.173.217.40",443,9,552,6,372,3,180,51955.060356,1.306085999996867,2278.5635861705423,1102.5307675018753
"147.32.84.165",19668,"184.173.217.40",443,9,552,6,372,3,180,51957.365933,1.3091819999972358,2273.1751582333727,1099.9234636613094
"147.32.84.165",19669,"184.173.217.40",443,9,552,6,372,3,180,51959.675062,1.3077449999982491,2275.673009649423,1101.132101443269
"147.32.84.165",19670,"184.173.217.40",443,9,552,6,372,3,180,51961.981911,1.308006999999634,2275.2171815600627,1100.9115394645464
"147.32.84.165",19671,"184.173.217.40",443,9,552,6,372,3,180,51964.290572,1.3075940000053379,2275.935802693995,1101.259259368062
"147.32.84.165",19672,"184.173.217.40",443,9,552,6,372,3,180,51966.598796,1.3074520000009215,2276.182987978069,1101.3788651506786
"147.32.84.165",19673,"184.173.217.40",443,9,552,6,372,3,180,51968.936799,1.3879089999973075,2144.232799128598,1037.5319995783539
"147.32.84.165",19675,"184.173.217.40",443,9,552,6,372,3,180,51971.319909,1.3079429999997956,2275.3285120226687,1100.9654090432266
"147.32.84.165",19676,"184.173.217.40",443,9,552,6,372,3,180,51973.623069,1.3080229999977746,2275.189350649846,1100.8980728950867
"147.32.84.165",19677,"94.100.176.20",25,6,372,6,372,0,0,51975.075692,8.92223300000478,333.5487876183468,0
"147.32.84.165",19678,"184.173.217.40",443,9,552,6,372,3,180,51975.926701,1.3077570000023115,2275.652128028938,1101.1219974333571
"147.32.84.165",19679,"184.173.217.40",443,9,552,6,372,3,180,51978.229879,1.3071830000044429,2276.651394632492,1101.605513531851
"147.32.84.165",19681,"173.192.170.88",80,12,3364,10,3244,2,120,51979.035734,9.368827000005695,2770.0372736079153,102.46747004714854
"147.32.84.165",19682,"184.173.217.40",443,9,552,6,372,3,180,51980.533326,1.307477000002109,2276.1394655471568,1101.3578059099145
"147.32.84.165",19683,"184.173.217.40",443,9,552,6,372,3,180,51982.83645,1.3077459999985876,2275.6712694997454,1101.1312594353608
"147.32.84.165",19684,"184.173.217.40",443,9,552,6,372,3,180,51985.139551,1.308031000000483,2275.175435443733,1100.8913397308386
"147.32.84.165",19685,"184.173.217.40",443,9,552,6,372,3,180,51987.443094,1.3074979999946663,2276.102908006085,1101.3401167771378
"147.32.84.165",19686,"184.173.217.40",443,9,552,6,372,3,180,51989.745912,1.2083590000038384,2462.8442375076834,1191.698824600492
"147.32.84.165",19687,"184.173.217.40",443,9,552,6,372,3,180,51991.949211,1.3078089999980875,2275.5616454729643,1101.0782155514344
"147.32.84.165",19688,"184.173.217.40",443,9,552,6,372,3,180,51994.252881,1.3078979999991134,2275.4067977793507,1101.003289248073
"147.32.84.165",19689,"74.125.93.27",25,6,372,6,372,0,0,51995.914841,9.013302999999723,330.1786259709777,0
"147.32.84.165",19690,"184.173.217.40",443,9,552,6,372,3,180,51996.556433,1.3072880000036093,2276.468536383554,1101.5170337339778
"147.32.84.165",19691,"184.173.217.40",443,9,552,6,372,3,180,51998.859893,1.3074320000014268,2276.2178071186513,1101.3957131219279
"147.32.84.165",19692,"184.173.217.40",443,9,552,6,372,3,180,52001.163102,1.3070070000030682,2276.9579657897884,1101.7538544144136
"147.32.84.165",19693,"173.192.170.88",80,6,372,6,372,0,0,52001.543993,8.991828999998688,330.96714806302856,0
"147.32.84.165",19694,"184.173.217.40",443,9,552,6,372,3,180,52003.465768,1.3080950000003213,2275.0641199601473,1100.8374774000713
"147.32.84.165",19695,"184.173.217.40",443,9,552,6,372,3,180,52005.769283,1.3077369999955408,2275.6869309426497,1101.138837552895
"147.32.84.165",19696,"184.173.217.40",443,9,552,6,372,3,180,52008.072606,1.3074960000012652,2276.1063896158153,1101.3418014270076
"147.32.84.165",19697,"184.173.217.40",443,9,552,6,372,3,180,52010.37561,1.3077449999982491,2275.673009649423,1101.132101443269
"147.32.84.165",19698,"184.173.217.40",443,9,552,6,372,3,180,52012.679179,1.3078549999991083,2275.481609201348,1101.039488323233
"147.32.84.165",19699,"184.173.217.40",443,9,552,6,372,3,180,52014.982306,1.3076570000048378,2275.8261531800695,1101.2062031516466
"147.32.84.165",19700,"74.125.39.27",25,6,372,6,372,0,0,52016.945643,9.01273200000287,330.1995443777816,0
"147.32.84.165",19701,"184.173.217.40",443,9,552,6,372,3,180,52017.286195,1.3076940000028117,2275.761760774005,1101.1750455358087
"147.32.84.165",19702,"184.173.217.40",443,9,552,6,372,3,180,52019.589209,1.3077650000050198,2275.6382071615135,1101.1152615297647
"147.32.84.165",19703,"184.173.217.40",443,9,552,6,372,3,180,52021.892771,1.3070760000045993,2276.837766120354,1101.6956932840424
"147.32.84.165",19704,"173.192.170.88",80,19,3320,18,3260,1,60,52022.554107,189.21199799999886,137.83481108846047,2.536837013898045
"147.32.84.165",19705,"184.173.217.40",443,9,552,6,372,3,180,52024.195734,1.3076490000021295,2275.8400763470577,1101.212940167931
"147.32.84.165",19706,"184.173.217.40",443,9,552,6,372,3,180,52026.498725,1.3082740000027115,2274.7528422897894,1100.6868591724788
"147.32.84.165",19707,"184.173.217.40",443,9,552,6,372,3,180,52028.802525,1.3078539999987697,2275.4833490609803,1101.040330190797
"147.32.84.165",19708,"184.173.217.40",443,9,552,6,372,3,180,52031.106057,1.3070860000007087,2276.8203469384466,1101.6872646476354
"147.32.84.165",19709,"184.173.217.40",443,9,552,6,372,3,180,52033.409368,1.3073260000019218,2276.4023663536295,1101.4850159775626
"147.32.84.165",19710,"184.173.217.40",443,9,552,6,372,3,180,52035.712476,1.3111310000022058,2269.7960768184057,1098.2884242669707
"147.32.84.165",19711,"66.111.4.73",25,6,372,6,372,0,0,52037.975207,9.013213999998698,330.1818862838972,0
"147.32.84.165",19712,"184.173.217.40",443,9,552,6,372,3,180,52038.015342,1.3077520000006189,2275.660828657568,1101.1262074149522
"147.32.84.165",19713,"184.173.217.40",443,9,552,6,372,3,180,52040.319136,1.3074689999994007,2276.1533925480176,1101.364544781299
"147.32.84.165",19714,"184.173.217.40",443,9,552,6,372,3,180,52042.621889,1.3078679999962333,2275.4589912809024,1101.0285441681785
"147.32.84.165",19715,"184.173.217.40",443,9,552,6,372,3,180,52044.925552,1.3081190000011702,2275.022379460384,1100.8172803840566
"147.32.84.165",19716,"184.173.217.40",443,9,552,6,372,3,180,52047.228721,1.3078410000016447,2275.505967465661,1101.0512745801584
"147.32.84.165",19717,"184.173.217.40",443,9,552,6,372,3,180,52049.532592,1.3072169999941252,2276.5921801914865,1101.5768613829773
"147.32.84.165",19718,"184.173.217.40",443,9,552,6,372,3,180,52051.835121,1.3079710000019986,2275.2798036007316,1100.941840451967
"147.32.84.165",19719,"184.173.217.40",443,9,552,6,372,3,180,52054.138441,1.3079569999972591,2275.304157557348,1100.9536246245232
"147.32.84.165",19720,"184.173.217.40",443,9,552,6,372,3,180,52056.442308,1.3078930000046967,2275.4154965194502,1101.007498315863
"147.32.84.165",19721,"184.173.217.40",443,9,552,6,372,3,180,52058.745513,1.3079900000011548,2275.2467526490054,1100.9258480559704
"147.32.84.165",19722,"216.157.130.15",25,6,372,6,372,0,0,52059.005956,8.912273000001733,333.92154840851725,0
"147.32.84.165",19723,"184.173.217.40",443,9,552,6,372,3,180,52061.049061,1.3073090000034426,2276.4319682585856,1101.4993394799608
"147.32.84.165",19724,"184.173.217.40",443,9,552,6,372,3,180,52063.352186,1.3075400000016089,2276.0297964087813,1101.3047401977974
"147.32.84.165",19725,"184.173.217.40",443,9,552,6,372,3,180,52065.655347,1.308247000000847,2274.7997893349443,1100.7095754846505
"147.32.84.165",19726,"184.173.217.40",443,9,552,6,372,3,180,52067.958519,1.307559000000765,2275.996723664675,1101.2887372571008
"147.32.84.165",19727,"184.173.217.40",443,9,552,6,372,3,180,52070.262399,1.3070300000035786,2276.9178978231957,1101.7344666886431
"147.32.84.165",19728,"184.173.217.40",443,9,552,6,372,3,180,52072.565464,1.3072699999975157,2276.499881436624,1101.5322006951408
"147.32.84.165",19729,"184.173.217.40",443,9,552,6,372,3,180,52074.868525,1.308061000003363,2275.123254949386,1100.8660911045415
"147.32.84.165",19730,"184.173.217.40",443,9,552,6,372,3,180,52077.171839,1.3081969999984722,2274.886733422776,1100.751645204569
"147.32.84.165",19731,"184.173.217.40",443,9,552,6,372,3,180,52079.475336,1.3078949999980978,2275.4120170230244,1101.0058146885601
"147.32.84.165",19732,"184.173.217.40",443,9,552,6,372,3,180,52081.778211,1.3079649999999674,2275.290240946871,1100.946890780744
"147.32.84.165",19733,"184.173.217.40",443,9,552,6,372,3,180,52084.081603,1.3080780000018422,2275.0936870705027,1100.8517840663721
"147.32.84.165",19734,"184.173.217.40",443,9,552,6,372,3,180,52086.38552,1.3074949999936507,2276.1081304436743,1101.342643763068
"147.32.84.165",19735,"184.173.217.40",443,9,552,6,372,3,180,52088.688695,1.3077090000006137,2275.73565678496,1101.1624145733676
"147.32.84.165",19736,"184.173.217.40",443,9,552,6,372,3,180,52090.992084,1.307678000004671,2275.78960568991,1101.1885188822143
"147.32.84.165",19737,"184.173.217.40",443,9,552,6,372,3,180,52093.294927,1.3080499999996391,2275.1423875240403,1100.875348801955
"147.32.84.165",19738,"184.173.217.40",443,9,552,6,372,3,180,52095.598279,1.3080840000038734,2275.0832515275683,1100.8467346101138
"147.32.84.165",19739,"184.173.217.40",443,9,552,6,372,3,180,52097.901544,1.30782100000215,2275.54076589618,1101.0681125304095
"147.32.84.165",19740,"184.173.217.40",443,9,552,6,372,3,180,52100.20466,1.3077989999947022,2275.579045412984,1101.0866348772506
"147.32.84.165",19741,"184.173.217.40",443,9,552,6,372,3,180,52102.508378,1.3080410000038682,2275.1580416754514,1100.8829233913475
"147.32.84.165",19742,"184.173.217.40",443,9,552,6,372,3,180,52104.811796,1.3073359999980312,2276.384953833201,1101.4765905644522
"147.32.84.165",19743,"184.173.217.40",443,9,552,6,372,3,180,52107.11536,1.3076019999934942,2275.9218783810416,1101.2525217972782
"147.32.84.165",19744,"184.173.217.40",443,9,552,6,372,3,180,52109.418009,1.3083469999983208,2274.6259211079473,1100.6254456973938
"147.32.84.165",19745,"184.173.217.40",443,9,552,6,372,3,180,52111.721633,1.3077730000004522,2275.624286477065,1101.108525714709
"147.32.84.165",19746,"184.173.217.40",443,9,552,6,372,3,180,52114.024697,1.3081420000016806,2274.9823795858374,1100.7979256060505
"147.32.84.165",19747,"184.173.217.40",443,9,552,6,372,3,180,52116.328398,1.307371000002604,2276.324012077729,1101.447102618256
"147.32.84.165",19748,"184.173.217.40",443,9,552,6,372,3,180,52118.631844,1.3076430000000983,2275.850518834098,1101.217992984241
"147.32.84.165",19749,"184.173.217.40",443,9,552,6,372,3,180,52120.935043,1.3078420000019833,2275.50422757144,1101.050432695858
"147.32.84.165",19750,"173.192.170.88",80,44,7337,28,2572,16,4765,52121.302334,47.61344300000201,432.1468623892444,800.6142298929819
"147.32.84.165",19751,"184.173.217.40",443,9,552,6,372,3,180,52123.238493,1.3073770000046352,2276.313565245104,1101.442047699244
"147.32.84.165",19752,"184.173.217.40",443,9,552,6,372,3,180,52125.541256,1.3081060000040452,2275.044988701831,1100.8282203395954
"147.32.84.165",19753,"184.173.217.40",443,9,552,6,372,3,180,52127.84477,1.3079339999967488,2275.3441687481154,1100.9729848781203
"147.32.84.165",19754,"184.173.217.40",443,9,552,6,372,3,180,52130.147818,1.308136999999988,2274.9910750938375,1100.8021331099214
"147.32.84.165",19755,"184.173.217.40",443,9,552,6,372,3,180,52132.451735,1.3082149999972899,2274.8554327890793,1100.7364997366512
"147.32.84.165",19756,"184.173.217.40",443,9,552,6,372,3,180,52134.754455,1.3082240000003367,2274.839782788906,1100.7289271559223
"147.32.84.165",19758,"184.173.217.40",443,9,552,6,372,3,180,52137.058116,1.3076100000034785,2275.907954200475,1101.2457842905526
"147.32.84.165",19759,"184.173.217.40",443,9,552,6,372,3,180,52139.361235,1.3077730000004522,2275.624286477065,1101.108525714709
"147.32.84.165",19760,"184.173.217.40",443,9,552,6,372,3,180,52141.664586,1.3078460000033374,2275.4972680211627,1101.0470651715304
"147.32.84.165",19761,"184.173.217.40",443,9,552,6,372,3,180,52143.968398,1.3072470000042813,2276.539934679715,1101.5515812966364
"147.32.84.165",19763,"98.126.71.122",80,18,4973,14,1540,4,3433,52145.607715,19.992301999998745,616.2371896943521,1373.7287481952667
"147.32.84.165",19764,"195.113.232.88",80,17,5893,12,2776,5,3117,52146.19548,19.404646999995748,1144.4681266299185,1285.0530081791987
"147.32.84.165",19765,"184.173.217.40",443,9,552,6,372,3,180,52146.262634,1.3120810000036727,2268.1526521546075,1097.4932187844877
"147.32.84.165",19766,"195.113.232.99",80,13,2078,10,1706,3,372,52146.467491,19.13272199999483,713.3328963857672,155.54503954015559
"147.32.84.165",19767,"184.173.217.40",443,9,552,6,372,3,180,52148.574718,1.3070959999968181,2276.802928023071,1101.678836140196
"147.32.84.165",19768,"184.173.217.40",443,9,552,6,372,3,180,52150.881016,1.307966000000306,2275.288501382531,1100.9460490560634
"147.32.84.165",19769,"184.173.217.40",443,9,552,6,372,3,180,52153.188639,1.3077720000001136,2275.62602655489,1101.10936768785
"147.32.84.165",19770,"184.173.217.40",443,9,552,6,372,3,180,52155.496726,1.306869000000006,2277.1984032064315,1101.8701950998864
"147.32.84.165",19771,"184.173.217.40",443,9,552,6,372,3,180,52157.803593,1.3075930000049993,2275.9375432482598,1101.2601015717387
"147.32.84.165",19772,"184.173.217.40",443,9,552,6,372,3,180,52160.111823,1.3068490000005113,2277.233253420124,1101.8870581065116
"147.32.84.165",19773,"184.173.217.40",443,9,552,6,372,3,180,52162.419383,1.306655000000319,2277.571355866142,1102.050656064262
"147.32.84.165",19774,"184.173.217.40",443,9,552,6,372,3,180,52164.725464,1.3208129999984521,2253.1577142286515,1090.237603659025
"147.32.84.165",19775,"184.173.217.40",443,9,552,6,372,3,180,52167.041942,1.307621999992989,2275.887068293403,1101.2356782064853
"147.32.84.165",19776,"173.192.170.88",80,26,2555,20,1936,6,619,52168.715477,91.16128900000331,169.89667620868588,54.32130298201269
"147.32.84.165",19777,"184.173.217.40",443,9,552,6,372,3,180,52169.345575,1.3078349999996135,2275.516406886862,1101.0563259129979
"147.32.84.165",19778,"184.173.217.40",443,9,552,6,372,3,180,52171.648997,1.3071730000010575,2276.6688112419642,1101.6139409235311
"147.32.84.165",19779,"184.173.217.40",443,9,552,6,372,3,180,52173.952415,1.3070650000008754,2276.856927542247,1101.7049649397968
"147.32.84.165",19780,"184.173.217.40",443,9,552,6,372,3,180,52176.25578,1.3075489999973797,2276.014130258953,1101.2971598027193
"147.32.84.165",19781,"184.173.217.40",443,9,552,6,372,3,180,52178.558741,1.3076430000000983,2275.850518834098,1101.217992984241
"147.32.84.165",19782,"184.173.217.40",443,9,552,6,372,3,180,52180.861806,1.3076519999958691,2275.8348551521362,1101.2104137832916
"147.32.84.165",19783,"184.173.217.40",443,9,552,6,372,3,180,52183.165145,1.3078460000033374,2275.4972680211627,1101.0470651715304
"147.32.84.165",19784,"184.173.217.40",443,9,552,6,372,3,180,52185.468491,1.3079060000018217,2275.3928799132773,1100.9965547967472
"147.32.84.165",19785,"184.173.217.40",443,9,552,6,372,3,180,52187.771839,1.3082539999959408,2274.787617702093,1100.7036859848836
"147.32.84.165",19786,"184.173.217.40",443,9,552,6,372,3,180,52190.075584,1.3077269999994314,2275.7043327860433,1101.1472577996983
"147.32.84.165",19787,"184.173.217.40",443,9,552,6,372,3,180,52192.378338,1.3079489999945508,2275.318074338066,1100.9603585506768
"147.32.84.165",19788,"184.173.217.40",443,9,552,6,372,3,180,52194.681478,1.3082260000010137,2274.8363050403323,1100.7272443743543
"147.32.84.165",19789,"184.173.217.40",443,9,552,6,372,3,180,52196.985066,1.3080449999979464,2275.1510842552607,1100.8795568977066
"147.32.84.165",19790,"184.173.217.40",443,9,552,6,372,3,180,52199.288424,1.3073460000014165,2276.367541566483,1101.4681652741046
"147.32.84.165",19791,"94.100.176.20",25,6,372,6,372,0,0,52200.140788,8.921379999999772,333.58067922228133,0
"147.32.84.165",19792,"184.173.217.40",443,9,552,6,372,3,180,52201.592077,1.3076769999970566,2275.791346033232,1101.1893609838219
"147.32.84.165",19793,"184.173.217.40",443,9,552,6,372,3,180,52203.895106,1.3075879999960307,2275.9462460721834,1101.2643126155726
"147.32.84.165",19794,"184.173.217.40",443,9,552,6,372,3,180,52206.198595,1.307699999997567,2275.751319114122,1101.1699931197363
"147.32.84.165",19795,"184.173.217.40",443,9,552,6,372,3,180,52208.501472,1.308179999999993,2274.9162959225914,1100.7659496399638
"147.32.84.165",19796,"184.173.217.40",443,9,552,6,372,3,180,52210.80518,1.3072089999986929,2276.606112720289,1101.583602929172
"147.32.84.165",19797,"184.173.217.40",443,9,552,6,372,3,180,52213.108411,1.3074679999990622,2276.155133435109,1101.3653871460203
"147.32.84.165",19798,"184.173.217.40",443,9,552,6,372,3,180,52215.411784,1.307357999998203,2276.3466472107034,1101.4580551019533
"147.32.84.165",19799,"184.173.217.40",443,9,552,6,372,3,180,52217.714997,1.307437999996182,2276.2073612734907,1101.3906586807213
"147.32.84.165",19800,"184.173.217.40",443,9,552,6,372,3,180,52220.017925,1.3078030000033323,2275.572085392385,1101.0832671253474
"147.32.84.165",19801,"74.125.93.27",25,6,372,6,372,0,0,52221.079526,9.013082999998005,330.1866852885587,0
"147.32.84.165",19802,"184.173.217.40",443,9,552,6,372,3,180,52222.321748,1.3079279999947175,2275.3546066847866,1100.9780354926386
"147.32.84.165",19803,"184.173.217.40",443,9,552,6,372,3,180,52224.624428,1.308272999995097,2274.7545810478036,1100.6877005070016
"147.32.84.165",19805,"184.173.217.40",443,9,552,6,372,3,180,52226.928339,1.3076900000014575,2275.768721942267,1101.1784138430323
"147.32.84.165",19806,"184.173.217.40",443,9,552,6,372,3,180,52229.231833,1.3072580000007292,2276.5207786055544,1101.542312228494
"147.32.84.165",19807,"184.173.217.40",443,9,552,6,372,3,180,52231.534912,1.3074309999938123,2276.219548116944,1101.3965555404568
"147.32.84.165",19808,"184.173.217.40",443,9,552,6,372,3,180,52233.838215,1.307781999996223,2275.6086259090544,1101.1009480205103
"147.32.84.165",19809,"184.173.217.40",443,9,552,6,372,3,180,52236.14263,1.3069809999942663,2277.003261725347,1101.7757718025873
"147.32.84.165",19811,"173.192.170.88",80,13,2536,12,2476,1,60,52236.159593,19.996443000003637,990.5761739723608,24.00426915926561
"147.32.84.165",19812,"184.173.217.40",443,9,552,6,372,3,180,52238.444978,1.3074610000039684,2276.167319706643,1101.371283729021
"147.32.84.165",19813,"184.173.217.40",443,9,552,6,372,3,180,52240.748123,1.307689000001119,2275.7704622409865,1101.179255923058
"147.32.84.165",19814,"74.125.39.27",25,6,372,6,372,0,0,52242.009769,9.012714000004053,330.2002038452193,0
"147.32.84.165",19815,"184.173.217.40",443,9,552,6,372,3,180,52243.051388,1.3073930000027758,2276.2857075062216,1101.4285681481717
"147.32.84.165",19816,"184.173.217.40",443,9,552,6,372,3,180,52245.354539,1.3080879999979516,2275.076294564785,1100.8433683377991
"147.32.84.165",19817,"184.173.217.40",443,9,552,6,372,3,180,52247.657874,1.3081060000040452,2275.044988701831,1100.8282203395954
"147.32.84.165",19818,"184.173.217.40",443,9,552,6,372,3,180,52249.961168,1.3081630000015139,2274.9458591907555,1100.7802544471397
"147.32.84.165",19819,"184.173.217.40",443,9,552,6,372,3,180,52252.264478,1.30818200000067,2274.912817940069,1100.7642667451948
"147.32.84.165",19820,"184.173.217.40",443,9,552,6,372,3,180,52254.56766,1.3076749999963795,2275.7948267025367,1101.1910451786468
"147.32.84.165",19821,"184.173.217.40",443,9,552,6,372,3,180,52256.871324,1.3077219999977387,2275.713033813873,1101.1514679744548
"147.32.84.165",19822,"184.173.217.40",443,9,552,6,372,3,180,52259.174632,1.3074730000007548,2276.1464290262834,1101.3611753352984
"147.32.84.165",19823,"173.192.170.88",80,29,2737,22,2056,7,681,52259.676351,87.35967399999936,188.27909087664545,62.36287008122352
"147.32.84.165",19824,"184.173.217.40",443,9,552,6,372,3,180,52261.477707,1.3082810000050813,2274.740671146674,1100.6809699096807
"147.32.84.165",19825,"66.111.4.73",25,6,372,6,372,0,0,52263.040055,9.012949000003573,330.1915943381928,0
"147.32.84.165",19826,"184.173.217.40",443,9,552,6,372,3,180,52263.781069,1.3080100000006496,2275.2119632101603,1100.9090144565293
"147.32.84.165",19827,"184.173.217.40",443,9,552,6,372,3,180,52266.084376,1.3076980000041658,2275.754799648328,1101.1716772491911
"147.32.84.165",19828,"184.173.217.40",443,9,552,6,372,3,180,52268.387757,1.3076770000043325,2275.7913460205696,1101.1893609776948
"147.32.84.165",19829,"184.173.217.40",443,9,552,6,372,3,180,52270.691436,1.3073339999973541,2276.3884363185102,1101.4782756379886
"147.32.84.165",19830,"184.173.217.40",443,9,552,6,372,3,180,52272.994591,1.3077179999963846,2275.7199946840433,1101.1548361374403
"147.32.84.165",19831,"184.173.217.40",443,9,552,6,372,3,180,52275.297586,1.3083150000020396,2274.6815560437362,1100.6523658276142
"147.32.84.165",19832,"184.173.217.40",443,9,552,6,372,3,180,52277.600751,1.3082720000020345,2274.7563197831737,1100.6885418305678
"147.32.84.165",19833,"184.173.217.40",443,9,552,6,372,3,180,52279.904456,1.3074070000002393,2276.2613325456077,1101.4167738123908
"147.32.84.165",19834,"184.173.217.40",443,9,552,6,372,3,180,52282.207349,1.308751000004122,2273.9237639479375,1100.2856922328729
"147.32.84.165",19835,"216.157.130.15",25,6,372,6,372,0,0,52284.070612,9.012840999996115,330.19555099233224,0
"147.32.84.165",19836,"184.173.217.40",443,9,552,6,372,3,180,52284.510589,1.3081090000050608,2275.0397711417677,1100.8256957137585
"147.32.84.165",19837,"184.173.217.40",443,9,552,6,372,3,180,52286.814141,1.3080019999979413,2275.2258788630934,1100.9157478369807
"147.32.84.165",19838,"184.173.217.40",443,9,552,6,372,3,180,52289.1176,1.3081680000032065,2274.937164028401,1100.7760471105166
"147.32.84.165",19839,"184.173.217.40",443,9,552,6,372,3,180,52291.420998,1.3078539999987697,2275.4833490609803,1101.040330190797
"147.32.84.165",19840,"184.173.217.40",443,9,552,6,372,3,180,52293.724433,1.3072589999937918,2276.5190371717717,1101.5414695992445
"147.32.84.165",19841,"184.173.217.40",443,9,552,6,372,3,180,52296.027747,1.308448000003409,2274.450341161625,1100.540487658851
"147.32.84.165",19842,"184.173.217.40",443,9,552,6,372,3,180,52298.331018,1.3074500000002445,2276.1864698454574,1101.3805499252214
"147.32.84.165",19843,"184.173.217.40",443,9,552,6,372,3,180,52300.633962,1.30775800000265,2275.6503879111956,1101.121155440901
"147.32.84.165",19844,"184.173.217.40",443,9,552,6,372,3,180,52302.937819,1.3076419999997597,2275.8522592579216,1101.2188351248008
"147.32.84.165",19845,"184.173.217.40",443,9,552,6,372,3,180,52305.241113,1.3071470000068075,2276.7140956483863,1101.6358527330901
"147.32.84.165",19846,"184.173.217.40",443,9,552,6,372,3,180,52307.544375,1.3075490000046557,2276.014130246288,1101.297159796591
"147.32.84.165",19847,"184.173.217.40",443,9,552,6,372,3,180,52309.847105,1.3083279999991646,2274.658954025214,1100.641429367039
"147.32.84.165",19848,"184.173.217.40",443,9,552,6,372,3,180,52312.150978,1.3075520000056713,2276.0089082400486,1101.2946330193784
"147.32.84.165",19850,"184.173.217.40",443,9,552,6,372,3,180,52314.453796,1.308272999995097,2274.7545810478036,1100.6877005070016
"147.32.84.165",19851,"184.173.217.40",443,9,552,6,372,3,180,52316.757184,1.3076129999972181,2275.902732694101,1101.2432577552102
"147.32.84.165",19852,"184.173.217.40",443,9,552,6,372,3,180,52319.060748,1.3080409999965923,2275.158041688107,1100.8829233974711
"147.32.84.165",19853,"184.173.217.40",443,9,552,6,372,3,180,52321.363614,1.3078869999953895,2275.425935123211,1101.0125492531665
"147.32.84.165",19855,"173.192.170.88",80,13,1570,12,1510,1,60,52323.043075,19.99837000000116,604.049230012211,24.001956159425603
"147.32.84.165",19856,"184.173.217.40",443,9,552,6,372,3,180,52323.667336,1.3080340000014985,2275.1702172853234,1100.888814815479
"147.32.84.165",19857,"184.173.217.40",443,9,552,6,372,3,180,52325.970696,1.3074290000004112,2276.223030083518,1101.3982403629927
"147.32.84.165",19858,"184.173.217.40",443,9,552,6,372,3,180,52328.274217,1.3071510000008857,2276.7071287081476,1101.6324816329745
"147.32.84.165",19859,"184.173.217.40",443,9,552,6,372,3,180,52330.577337,1.307838000000629,2275.5111871642885,1101.0538002407845
"147.32.84.165",19861,"184.173.217.40",443,9,552,6,372,3,180,52332.880602,1.3074370000031195,2276.2091022304703,1101.3915010792598
"147.32.84.165",19862,"184.173.217.40",443,9,552,6,372,3,180,52335.18405,1.3075239999961923,2276.057647896839,1101.318216724277
"147.32.84.165",19863,"184.173.217.40",443,9,552,6,372,3,180,52337.486808,1.3080530000006547,2275.1371695172215,1100.872823959946
"147.32.84.165",19864,"184.173.217.40",443,9,552,6,372,3,180,52339.790676,1.307373000003281,2276.3205297895333,1101.4454176400966
"147.32.84.165",19866,"173.192.170.88",80,23,7948,18,1650,5,6298,52341.891975,14.22612300000037,927.8705097657075,3541.653618487531
"147.32.84.165",19867,"184.173.217.40",443,9,552,6,372,3,180,52342.093494,1.30766500000027,2275.8122301961016,1101.1994662239201
"147.32.84.165",19868,"184.173.217.40",443,9,552,6,372,3,180,52344.396817,1.3084600000001956,2274.4294819861175,1100.5303945094117
"147.32.84.165",19869,"50.23.235.4",80,29,12824,20,4362,9,8462,52346.547721,61.207237999995414,570.1286504710866,1106.0129849349692
"147.32.84.165",19870,"184.173.217.40",443,9,552,6,372,3,180,52346.700172,1.3015070000037667,2286.5800952214527,1106.4097234942512
"147.32.84.165",19871,"173.192.170.88",80,6,372,6,372,0,0,52346.835498,8.94517800000176,332.69321191813225,0
"147.32.84.165",19872,"67.201.31.224",80,110,89747,88,6530,22,83217,52347.053366,19.06816699999763,2739.644560486936,34913.47647626973
"147.32.84.165",19873,"67.201.31.224",80,67,53163,54,3960,13,49203,52347.411107,18.710619999998016,1693.1560792749444,21037.464284991183
"147.32.84.165",19874,"69.16.175.10",80,34,6156,24,3500,10,2656,52347.450119,33.67577799999708,831.4581477524417,630.9579544087101
"147.32.84.165",19875,"68.67.185.206",80,39,10591,30,5656,9,4935,52347.567887,18.553444000004674,2438.7924958831686,2127.9068188089527
"147.32.84.165",19876,"68.67.185.207",80,41,19527,32,10588,9,8939,52347.648939,18.4721800000043,4585.490180367465,3871.3351645546627
"147.32.84.165",19877,"217.163.21.41",80,21,6619,14,1534,7,5085,52347.763567,0.18672700000024633,65721.61497792933,217858.15655982442
"147.32.84.165",19878,"217.163.21.41",80,15,2284,10,1406,5,878,52347.909224,0.13938299999426818,80698.50699484549,50393.52001527336
"147.32.84.165",19879,"195.113.232.96",80,16,1926,12,1320,4,606,52347.935104,59.82041900000331,176.52835230056505,81.04256173798669
"147.32.84.165",19880,"77.238.167.32",80,13,2563,10,1520,3,1043,52348.071381,0.14043099999980768,86590.56760983438,59417.08027437978
"147.32.84.165",19881,"217.163.21.41",80,17,4057,12,1618,5,2439,52348.166382,0.23757299999851966,54484.30587684903,82130.54513821681
"147.32.84.165",19882,"195.113.232.88",80,61,44739,52,6380,9,38359,52348.390414,59.3649099999966,859.7671587475315,5169.248972162471
"147.32.84.165",19883,"217.163.21.41",80,19,6946,12,1860,7,5086,52348.483643,0.18684500000381377,79638.20278678197,217763.38675998556
"147.32.84.165",19884,"217.163.21.41",80,15,3311,10,1872,5,1439,52348.629403,0.21207800000411225,70615.52824767119,54281.91514337545
"147.32.84.165",19885,"217.163.21.41",80,19,6969,12,1886,7,5083,52348.892525,0.18653499999345513,80885.62468453312,217996.62262538806
"147.32.84.165",19886,"173.241.240.4",80,26,14660,20,2860,6,11800,52348.907944,0.0728400000007241,314113.1246536594,1295991.2136060072
"147.32.84.165",19887,"173.241.240.4",80,14,2884,10,2040,4,844,52348.971304,0.07168300000193994,227669.0428631382,94192.48636102384
"147.32.84.165",19888,"195.113.232.88",80,13,3473,10,1422,3,2051,52348.973643,58.78223699999944,193.52785093905337,279.1319425288316
"147.32.84.165",19889,"184.173.217.40",443,9,552,6,372,3,180,52349.002128,1.3072459999966668,2276.541676170811,1101.5524239536182
"147.32.84.165",19890,"217.163.21.41",80,17,3823,12,2032,5,1791,52349.037627,0.2400259999994887,67725.99635053964,59693.53320069709
"147.32.84.165",19891,"67.88.220.20",80,23,7065,16,1702,7,5363,52349.215841,0.8147650000028079,16711.567138933406,52658.12841721495
"147.32.84.165",19892,"217.163.21.41",80,15,2467,10,1614,5,853,52349.258436,0.1449540000030538,89076.5346229009,47077.003738125444
"147.32.84.165",19893,"217.163.21.41",80,19,7003,12,1918,7,5085,52349.346201,0.18709099999978207,82013.56559117153,217434.2966794094
"147.32.84.165",19894,"217.163.21.41",80,17,4414,12,2122,5,2292,52349.495357,0.23315700000239303,72809.30874829306,78642.28824273689
"147.32.84.165",19895,"217.163.21.41",80,21,7221,14,2120,7,5101,52349.746006,0.18681500000093365,90785.00120394636,218440.70336855206
"147.32.84.165",19896,"217.163.21.41",80,14,3433,10,1860,4,1573,52349.893989,0.21644100000412436,68748.52731098293,58140.55562375062
"147.32.84.165",19897,"195.113.232.91",80,14,2016,10,1528,4,488,52350.037576,0.002812999999150634,0,0
"147.32.84.165",19898,"174.36.246.56",80,18,6487,14,1572,4,4915,52350.077283,0.40367300000070827,31153.929046475576,97405.573322791
"147.32.84.165",19899,"67.88.220.21",80,14,2554,10,1956,4,598,52350.284234,0.6214010000039707,25181.806916789657,7698.732380490908
"147.32.84.165",19900,"195.113.232.97",80,46,28716,36,3164,10,25552,52350.385903,57.369801000000734,441.2077357563028,3563.1289709371204
"147.32.84.165",19901,"195.113.232.97",80,107,79338,80,5756,27,73582,52350.386099,57.3701430000001,802.6474676906404,10260.668166715202
"147.32.84.165",19902,"174.36.246.56",80,18,8148,14,1998,4,6150,52350.386477,0.4536850000004051,35231.49321662768,108445.28692805817
"147.32.84.165",19903,"95.172.94.56",80,13,2050,10,1474,3,576,52350.534894,0.07044600000517676,167390.62543130142,65411.80478183828
"147.32.84.165",19904,"67.88.220.21",80,16,2378,12,1886,4,492,52350.709599,0.6120850000006612,24650.17113633515,6430.479426870039
"147.32.84.165",19905,"74.125.232.198",80,18,4242,14,3352,4,890,52350.736258,57.01980700000422,470.2927177567966,124.86888985786067
"147.32.84.165",19906,"174.36.246.56",80,18,7485,14,2228,4,5257,52350.743178,0.4235079999998561,42086.57215449544,99303.90925322376
"147.32.84.165",19907,"184.173.217.40",443,9,552,6,372,3,180,52351.309754,1.3075519999983953,2276.008908252714,1101.2946330255065
"147.32.84.165",19908,"184.173.217.40",443,9,552,6,372,3,180,52353.61797,1.3065809999970952,2277.7003492371437,1102.113072211521
"147.32.84.165",19909,"184.173.217.40",443,9,552,6,372,3,180,52355.923999,1.3071400000044378,2276.726287918583,1101.6417522186691
"147.32.84.165",19910,"184.173.217.40",443,9,552,6,372,3,180,52358.230688,1.3076549999968847,2275.8296339685085,1101.207887404117
"147.32.84.165",19911,"184.173.217.40",443,9,552,6,372,3,180,52360.539027,1.3080160000026808,2275.201526582168,1100.9039644752424
"147.32.84.165",19912,"184.173.217.40",443,9,552,6,372,3,180,52362.847804,1.3076430000000983,2275.850518834098,1101.217992984241
"147.32.84.165",19913,"184.173.217.40",443,9,552,6,372,3,180,52365.155623,1.3067000000010012,2277.4929210972064,1102.0127037567129
"147.32.84.165",19914,"173.192.170.88",80,6,372,6,372,0,0,52365.625199,9.01764600000024,330.01960822147163,0
"147.32.84.165",19915,"184.173.217.40",443,9,552,6,372,3,180,52367.46362,1.3060540000005858,2278.6194138976375,1102.5577809182118
"147.32.84.165",19916,"173.192.170.88",80,6,372,6,372,0,0,52367.722915,9.026970999999321,329.6786928860438,0
"147.32.84.165",19917,"184.173.217.40",443,9,552,6,372,3,180,52369.769284,1.3082179999983055,2274.850216098429,1100.733975531498
"147.32.84.165",19918,"184.173.217.40",443,9,552,6,372,3,180,52372.078168,1.3065310000019963,2277.787515179856,1102.1552492805756
"147.32.84.165",19919,"184.173.217.40",443,9,552,6,372,3,180,52374.384251,1.3074459999988903,2276.1934336121917,1101.3839194897703
"147.32.84.165",19920,"184.173.217.40",443,9,552,6,372,3,180,52376.691841,1.3076119999968796,2275.9044731977847,1101.244099934412
"147.32.84.165",19921,"184.173.217.40",443,9,552,6,372,3,180,52378.999995,1.3076710000023013,2275.801788060424,1101.1944135776246
"147.32.84.165",19922,"184.173.217.40",443,9,552,6,372,3,180,52381.309554,1.3068110000021989,2277.2994717637,1101.9190992405
"147.32.84.165",19923,"184.173.217.40",443,9,552,6,372,3,180,52383.618083,1.3067489999957616,2277.4075205029067,1101.9713808885033
"147.32.84.165",19924,"184.173.217.40",443,9,552,6,372,3,180,52385.924679,1.3068609999972978,2277.212343168978,1101.8769402430537
"147.32.84.165",19925,"173.192.170.88",80,6,372,6,372,0,0,52386.685576,8.927192999995896,333.36346598548596,0
"147.32.84.165",19926,"184.173.217.40",443,9,552,6,372,3,180,52388.231981,1.3077360000024782,2275.6886711036173,1101.1396795662665
"147.32.84.165",19928,"184.173.217.40",443,9,552,6,372,3,180,52390.539687,1.3073220000005676,2276.4093314414567,1101.4883861813498
"147.32.84.165",19929,"184.173.217.40",443,9,552,6,372,3,180,52392.847385,1.3067260000025271,2277.447605691051,1101.990776947283
"147.32.84.165",19930,"184.173.217.40",443,9,552,6,372,3,180,52395.154486,1.3080550000013318,2275.133690859306,1100.8711407383742
"147.32.84.165",19931,"184.173.217.40",443,9,552,6,372,3,180,52397.463043,1.3063659999970696,2278.075210168265,1102.2944565330315
"147.32.84.165",19933,"173.192.170.88",80,6,372,6,372,0,0,52398.833113,9.034020999999484,329.421417107639,0
"147.32.84.165",19934,"184.173.217.40",443,9,552,6,372,3,180,52399.769463,1.3077330000014626,2275.693891640474,1101.1422056324873
"147.32.84.165",19935,"184.173.217.40",443,9,552,6,372,3,180,52402.077452,1.3070980000047712,2276.799444256771,1101.6771504468247
"147.32.84.165",19936,"184.173.217.40",443,9,552,6,372,3,180,52404.384889,1.306920999995782,2277.1077976477573,1101.8263537005278
"147.32.84.165",19937,"184.173.217.40",443,9,552,6,372,3,180,52406.692194,1.3209779999961029,2252.876278037015,1090.10142485662
"147.32.84.165",19938,"184.173.217.40",443,9,552,6,372,3,180,52409.008722,1.3076120000041556,2275.904473185121,1101.2440999282844
"147.32.84.165",19939,"184.173.217.40",443,9,552,6,372,3,180,52411.311902,1.307968000000983,2275.2850222618317,1100.9443656105636
"147.32.84.165",19940,"184.173.217.40",443,9,552,6,372,3,180,52413.61575,1.3074600000036298,2276.1690606150382,1101.3721261040507
"147.32.84.165",19941,"184.173.217.40",443,9,552,6,372,3,180,52415.918595,1.3080429999972694,2275.1545629663647,1100.8812401450152
"147.32.84.165",19942,"184.173.217.40",443,9,552,6,372,3,180,52418.22218,1.3075559999997495,2276.0019456150026,1101.2912640072593
"147.32.84.165",19943,"184.173.217.40",443,9,552,6,372,3,180,52420.525457,1.3072119999997085,2276.600887997252,1101.58107483738
"147.32.84.165",19944,"173.192.170.88",80,6,372,6,372,0,0,52421.332721,8.96699400000216,331.8837951714123,0
"147.32.84.165",19945,"184.173.217.40",443,9,552,6,372,3,180,52422.828495,1.3083909999986645,2274.5494275052624,1100.5884326638366
"147.32.84.165",19946,"173.192.170.88",80,6,372,6,372,0,0,52422.889757,9.011989000005997,330.22676791971446,0
"147.32.84.165",19947,"184.173.217.40",443,9,552,6,372,3,180,52425.132145,1.30766500000027,2275.8122301961016,1101.1994662239201
"147.32.84.165",19948,"94.100.176.20",25,6,372,6,372,0,0,52425.258458,8.946529000000737,332.6429724868443,0
"147.32.84.165",19949,"184.173.217.40",443,9,552,6,372,3,180,52427.435387,1.308047999998962,2275.14586620855,1100.8770320363951
"147.32.84.165",19950,"184.173.217.40",443,9,552,6,372,3,180,52429.738437,1.3079369999977644,2275.338949815692,1100.970459588238
"147.32.84.165",19951,"184.173.217.40",443,9,552,6,372,3,180,52432.042156,1.307357999998203,2276.3466472107034,1101.4580551019533
"147.32.84.165",19952,"184.173.217.40",443,9,552,6,372,3,180,52434.345156,1.3079709999947227,2275.2798036133886,1100.9418404580913
"147.32.84.165",19953,"184.173.217.40",443,9,552,6,372,3,180,52436.648632,1.3073520000034478,2276.357094334312,1101.463110161764
"147.32.84.165",19954,"184.173.217.40",443,9,552,6,372,3,180,52438.951503,1.3077740000007907,2275.6225464019017,1101.1076837428557
"147.32.84.165",19955,"184.173.217.40",443,9,552,6,372,3,180,52441.255087,1.3074300000007497,2276.2212890925657,1101.3973979480159
"147.32.84.165",19956,"173.192.170.88",80,6,372,6,372,0,0,52442.317323,8.912321999996493,333.9197125060305,0
"147.32.84.165",19957,"184.173.217.40",443,9,552,6,372,3,180,52443.558274,1.3076319999963744,2275.8696636425625,1101.22725660124
"147.32.84.165",19958,"173.192.170.88",80,23,2377,18,1816,5,561,52443.819555,46.97199600000022,309.2906675713745,95.54629102838166
"147.32.84.165",19959,"184.173.217.40",443,9,552,6,372,3,180,52445.861921,1.3075169999938225,2276.069833137206,1101.3241128083255
"147.32.84.165",19960,"74.125.93.27",25,6,372,6,372,0,0,52446.122345,9.013012999996135,330.1892496994375,0
"147.32.84.165",19961,"184.173.217.40",443,9,552,6,372,3,180,52448.164755,1.3085019999998622,2274.3564778657683,1100.495069935049
"147.32.84.165",19962,"184.173.217.40",443,9,552,6,372,3,180,52450.468656,1.3073720000029425,2276.322270932299,1101.4462601285318
"147.32.84.165",19963,"184.173.217.40",443,9,552,6,372,3,180,52452.772069,1.3073110000041197,2276.4284856400823,1101.4976543419755
"147.32.84.165",19964,"184.173.217.40",443,9,552,6,372,3,180,52455.074902,1.308324999998149,2274.6641698386948,1100.6439531477556
"147.32.84.165",19965,"184.173.217.40",443,9,552,6,372,3,180,52457.378479,1.307227999997849,2276.5730232254027,1101.5675918832594
"147.32.84.165",19966,"184.173.217.40",443,9,552,6,372,3,180,52459.681754,1.307886000002327,2275.4276748850475,1101.01339107341
"147.32.84.165",19967,"184.173.217.40",443,9,552,6,372,3,180,52461.985063,1.3076020000007702,2275.9218783683773,1101.2525217911505
"147.32.84.165",19968,"184.173.217.40",443,9,552,6,372,3,180,52464.288285,1.3078839999943739,2275.4311544546777,1101.0150747361345
"147.32.84.165",19969,"184.173.217.40",443,9,552,6,372,3,180,52466.591954,1.3070909999951255,2276.81163745378,1101.6830503808612
"147.32.84.165",19970,"74.125.39.27",25,6,372,6,372,0,0,52467.152399,9.012722999999824,330.19987411130444,0
"147.32.84.165",19971,"184.173.217.40",443,9,552,6,372,3,180,52468.894545,1.3076860000001034,2275.775683153115,1101.1817821708623
"147.32.84.165",19972,"184.173.217.40",443,9,552,6,372,3,180,52471.198206,1.3077120000016293,2275.7304360564804,1101.159888414426
"147.32.84.165",19973,"184.173.217.40",443,9,552,6,372,3,180,52473.501239,1.3080650000047171,2275.1162977292934,1100.8627247077225
"147.32.84.165",19974,"184.173.217.40",443,9,552,6,372,3,180,52475.804798,1.3075870000029681,2275.9479866297575,1101.2651548208503
"147.32.84.165",19975,"184.173.217.40",443,9,552,6,372,3,180,52478.108376,1.3074910000068485,2276.1150937057405,1101.3460130834228
"147.32.84.165",19976,"184.173.217.40",443,9,552,6,372,3,180,52480.411648,1.3078109999987646,2275.558165516891,1101.0765317017217
"147.32.84.165",19977,"184.173.217.40",443,9,552,6,372,3,180,52482.714824,1.307677999997395,2275.7896057025723,1101.1885188883414
"147.32.84.165",19978,"184.173.217.40",443,9,552,6,372,3,180,52485.018033,1.3077059999995981,2275.7408775373933,1101.1649407439
"147.32.84.165",19979,"184.173.217.40",443,9,552,6,372,3,180,52487.321563,1.307732000001124,2275.6956318247485,1101.1430476571363
"147.32.84.165",19980,"66.111.4.73",25,6,372,6,372,0,0,52488.182262,9.012828999999329,330.19599062627526,0
"147.32.84.165",19981,"184.173.217.40",443,9,552,6,372,3,180,52489.624368,1.3078430000023218,2275.50248767988,1101.049590812845
"147.32.84.165",19982,"184.173.217.40",443,9,552,6,372,3,180,52491.927657,1.3078049999967334,2275.568605417041,1101.0815832663102
"147.32.84.165",19983,"184.173.217.40",443,9,552,6,372,3,180,52494.231432,1.3077219999977387,2275.713033813873,1101.1514679744548
"147.32.84.165",19984,"184.173.217.40",443,9,552,6,372,3,180,52496.534804,1.307321000000229,2276.4110727200728,1101.4892287355192
"147.32.84.165",19985,"184.173.217.40",443,9,552,6,372,3,180,52498.838031,1.3075860000026296,2275.9497272026583,1101.2659970335444
"147.32.84.165",19986,"184.173.217.40",443,9,552,6,372,3,180,52501.141344,1.3075369999933173,2276.035018523537,1101.307267027518
"147.32.84.165",19987,"184.173.217.40",443,9,552,6,372,3,180,52503.444517,1.3075509999980568,2276.0106489187974,1101.295475283289
"147.32.84.165",19988,"184.173.217.40",443,9,552,6,372,3,180,52505.747953,1.30782100000215,2275.54076589618,1101.0681125304095
"147.32.84.165",19989,"184.173.217.40",443,9,552,6,372,3,180,52508.051172,1.3080190000036964,2275.1963083040764,1100.9014395019726
"147.32.84.165",19990,"216.157.130.15",25,6,372,6,372,0,0,52509.213334,8.91188400000101,333.9361239441248,0
"147.32.84.165",19991,"184.173.217.40",443,9,552,6,372,3,180,52510.354817,1.3077639999974053,2275.6399472732883,1101.116103519333
"147.32.84.165",19992,"184.173.217.40",443,9,552,6,372,3,180,52512.658089,1.3078200000018114,2275.542505846277,1101.0689544417469
"147.32.84.165",19993,"184.173.217.40",443,9,552,6,372,3,180,52514.961015,1.3081479999964358,2274.971945076634,1100.792876649984
"147.32.84.165",19994,"184.173.217.40",443,9,552,6,372,3,180,52517.264095,1.30839399999968,2274.544212217977,1100.5859091377308
"147.32.84.165",19995,"184.173.217.40",443,9,552,6,372,3,180,52519.567459,1.3079360000047018,2275.3406894445156,1100.9713013441203
"147.32.84.165",19996,"184.173.217.40",443,9,552,6,372,3,180,52521.870651,1.3079800000050454,2275.264147761067,1100.9342650456776
"147.32.84.165",19997,"184.173.217.40",443,9,552,6,372,3,180,52524.1747,1.3076509999955306,2275.8365955520026,1101.2112559122593
"147.32.84.165",19998,"184.173.217.40",443,9,552,6,372,3,180,52526.477571,1.3074979999946663,2276.102908006085,1101.3401167771378
"147.32.84.165",19999,"184.173.217.40",443,9,552,6,372,3,180,52528.780661,1.3077870000051917,2275.5999256669365,1101.096738225937
"147.32.84.165",20000,"184.173.217.40",443,9,552,6,372,3,180,52531.08443,1.3075859999953536,2275.9497272153226,1101.2659970396724
"147.32.84.165",20001,"184.173.217.40",443,9,552,6,372,3,180,52533.38755,1.3077100000009523,2275.733916539472,1101.1615725190993
"147.32.84.165",20002,"184.173.217.40",443,9,552,6,372,3,180,52535.691199,1.307530999998562,2276.0454627869417,1101.3123207033589
"147.32.84.165",20003,"184.173.217.40",443,9,552,6,372,3,180,52537.994069,1.3081880000027013,2274.902384056309,1100.7592180917625
"147.32.84.165",20004,"184.173.217.40",443,9,552,6,372,3,180,52540.297928,1.3077160000029835,2275.723475122435,1101.1565202205331
"147.32.84.165",20005,"184.173.217.40",443,9,552,6,372,3,180,52542.600861,1.3078710000045248,2275.453771809073,1101.0260186172934
"147.32.84.165",20006,"184.173.217.40",443,9,552,6,372,3,180,52544.903902,1.307768999999098,2275.6312468043307,1101.1118936149987
"147.32.84.165",20007,"184.173.217.40",443,9,552,6,372,3,180,52547.207474,1.307982999998785,2275.25892920838,1100.9317399395386
"147.32.84.165",20008,"184.173.217.40",443,9,552,6,372,3,180,52549.51072,1.3077699999994365,2275.6295067185224,1101.1110516379947
"147.32.84.165",20009,"184.173.217.40",443,9,552,6,372,3,180,52551.813875,1.3078119999991031,2275.5564255428462,1101.0756897787967
"147.32.84.165",20010,"184.173.217.40",443,9,552,6,372,3,180,52554.117581,1.3078559999994468,2275.4798693443763,1101.0386464569563
"147.32.84.165",20011,"184.173.217.40",443,9,552,6,372,3,180,52556.42054,1.307689000001119,2275.7704622409865,1101.179255923058
"147.32.84.165",20012,"184.173.217.40",443,9,552,6,372,3,180,52558.724074,1.3081220000021858,2275.0171620040237,1100.8147558083986
"147.32.84.165",20013,"184.173.217.40",443,9,552,6,372,3,180,52561.027297,1.3076450000007753,2275.847037994437,1101.2163087069855
"147.32.84.165",20014,"184.173.217.40",443,9,552,6,372,3,180,52563.330763,1.3080679999984568,2275.111079854802,1100.8601999297427
"147.32.84.165",20015,"184.173.217.40",443,9,552,6,372,3,180,52565.633924,1.3080449999979464,2275.1510842552607,1100.8795568977066
"147.32.84.165",20016,"184.173.217.40",443,9,552,6,372,3,180,52567.937212,1.3075900000039837,2275.9427649270287,1101.2626281904977
"147.32.84.165",20017,"184.173.217.40",443,9,552,6,372,3,180,52570.240638,1.3078029999960563,2275.572085405045,1101.0832671314733
"147.32.84.165",20018,"184.173.217.40",443,9,552,6,372,3,180,52572.544125,1.307966000000306,2275.288501382531,1100.9460490560634
"147.32.84.165",20019,"184.173.217.40",443,9,552,6,372,3,180,52574.8469,1.3080670000053942,2275.112819135203,1100.8610415170338
"147.32.84.165",20020,"184.173.217.40",443,9,552,6,372,3,180,52577.150394,1.3076030000011087,2275.920137838072,1101.251679599067
"147.32.84.165",20021,"184.173.217.40",443,9,552,6,372,3,180,52579.45368,1.3080939999999828,2275.065859181404,1100.8383189587437
"147.32.84.165",20022,"184.173.217.40",443,9,552,6,372,3,180,52581.757313,1.2072059999991325,2465.196495049013,1192.8370137333934
"147.32.84.165",20023,"184.173.217.40",443,9,552,6,372,3,180,52583.960192,1.307559000000765,2275.996723664675,1101.2887372571008
"147.32.84.165",20024,"184.173.217.40",443,9,552,6,372,3,180,52586.263578,1.3081769999989774,2274.921512916315,1100.7684739917654
"147.32.84.165",20025,"184.173.217.40",443,9,552,6,372,3,180,52588.566814,1.3081759999986389,2274.9232519195402,1100.769315444939
"147.32.84.165",20026,"184.173.217.40",443,9,552,6,372,3,180,52590.870031,1.3082120000035502,2274.8606494910027,1100.7390239472595
"147.32.84.165",20027,"184.173.217.40",443,9,552,6,372,3,180,52593.173484,1.3084319999979925,2274.478154007672,1100.5539454875832
"147.32.84.165",20028,"184.173.217.40",443,9,552,6,372,3,180,52595.476738,1.3081989999991492,2274.883255530646,1100.7499623535384
"147.32.84.165",20029,"184.173.217.40",443,9,552,6,372,3,180,52597.78005,1.307532999999239,2276.0419813509347,1101.3106361375492
"147.32.84.165",20030,"184.173.217.40",443,9,552,6,372,3,180,52600.083536,1.3078580000001239,2275.476389638415,1101.0369627282653
"147.32.84.165",20031,"184.173.217.40",443,9,552,6,372,3,180,52602.386788,1.3076929999951972,2275.76350107474,1101.1758876168096
"147.32.84.165",20032,"184.173.217.40",443,9,552,6,372,3,180,52604.690519,1.3071779999954742,2276.660102916591,1101.6097272177053
"147.32.84.165",20033,"184.173.217.40",443,9,552,6,372,3,180,52606.993433,1.3076149999978952,2275.899251694719,1101.2415734006706
"147.32.84.165",20034,"184.173.217.40",443,9,552,6,372,3,180,52609.296868,1.3075260000041453,2276.0541664108896,1101.3165321343015
"147.32.84.165",20035,"184.173.217.40",443,9,552,6,372,3,180,52611.600387,1.3073460000014165,2276.367541566483,1101.4681652741046
"147.32.84.165",20036,"184.173.217.40",443,9,552,6,372,3,180,52613.903411,1.307438000003458,2276.2073612608237,1101.390658674592
"147.32.84.165",20037,"184.173.217.40",443,9,552,6,372,3,180,52616.20704,1.3075790000002598,2275.961911287508,1101.2718925584718
"147.32.84.165",20038,"184.173.217.40",443,9,552,6,372,3,180,52618.509777,1.3083110000006855,2274.6885106052314,1100.6557309380153
"147.32.84.165",20039,"184.173.217.40",443,9,552,6,372,3,180,52620.813181,1.307916000005207,2275.375482820114,1100.9881368484423
"147.32.84.165",20040,"184.173.217.40",443,9,552,6,372,3,180,52623.116941,1.30714799999987,2276.7123539188337,1101.635009960726
"147.32.84.165",20041,"184.173.217.40",443,9,552,6,372,3,180,52625.419788,1.3074730000007548,2276.1464290262834,1101.3611753352984
"147.32.84.165",20042,"184.173.217.40",443,9,552,6,372,3,180,52627.723203,1.3078979999991134,2275.4067977793507,1101.003289248073
"147.32.84.165",20043,"184.173.217.40",443,9,552,6,372,3,180,52630.026625,1.3081030000030296,2275.050206285826,1100.8307449770125
"147.32.84.165",20044,"184.173.217.40",443,9,552,6,372,3,180,52632.330073,1.3075020000032964,2276.0959447805794,1101.336747474474
"147.32.84.165",20045,"184.173.217.40",443,9,552,6,372,3,180,52634.6333,1.3076060000021243,2275.9149162631293,1101.2491530305463
"147.32.84.165",20046,"184.173.217.40",443,9,552,6,372,3,180,52636.936302,1.3075729999982286,2275.972354892638,1101.2769459157926
"147.32.84.165",20047,"184.173.217.40",443,9,552,6,372,3,180,52639.239697,1.3081730000048992,2274.9284689325145,1100.7718398060556
"147.32.84.165",20048,"184.173.217.40",443,9,552,6,372,3,180,52641.542813,1.307915999997931,2275.375482832772,1100.988136854567
"147.32.84.165",20049,"184.173.217.40",443,9,552,6,372,3,180,52643.846313,1.3074449999985518,2276.1951745605334,1101.384761884129
"147.32.84.165",20050,"184.173.217.40",443,9,552,6,372,3,180,52646.149777,1.3078119999991031,2275.5564255428462,1101.0756897787967
"147.32.84.165",20051,"184.173.217.40",443,9,552,6,372,3,180,52648.453399,1.3073619999995572,2276.3396825064583,1101.45468508377
"147.32.84.165",20052,"94.100.176.20",25,6,372,6,372,0,0,52650.337611,8.890500999994401,334.7392908455748,0
"147.32.84.165",20053,"184.173.217.40",443,9,552,6,372,3,180,52650.756736,1.2072789999947418,2465.047433122718,1192.7648869948634
"147.32.84.165",20054,"147.32.84.171",139,33,4810,22,3278,11,1532,52651.128445,0.049716999994416256,527465.4545315532,246515.276492477
"147.32.84.165",20055,"184.173.217.40",443,9,552,6,372,3,180,52652.959189,1.3083550000010291,2274.6120127929034,1100.6187158675339
"147.32.84.165",20056,"184.173.217.40",443,9,552,6,372,3,180,52655.262635,1.3081579999998212,2274.9545544195785,1100.784461815925
"147.32.84.165",20057,"184.173.217.40",443,9,552,6,372,3,180,52657.565865,1.3081850000016857,2274.907600986225,1100.7617424126897
"147.32.84.165",20058,"184.173.217.40",443,9,552,6,372,3,180,52659.869658,1.307500999995682,2276.097685592461,1101.3375898028037
"147.32.84.165",20059,"184.173.217.40",443,9,552,6,372,3,180,52662.172869,1.3079499999948894,2275.3163347311656,1100.9595168054027
"147.32.84.165",20060,"184.173.217.40",443,9,552,6,372,3,180,52664.476017,1.3081459999957588,2274.975423239951,1100.7945596322343
"147.32.84.165",20061,"184.173.217.40",443,9,552,6,372,3,180,52666.779479,1.3077360000024782,2275.6886711036173,1101.1396795662665
"147.32.84.165",20062,"184.173.217.40",443,9,552,6,372,3,180,52669.082679,1.3077659999980824,2275.6364670777216,1101.1144195537363
"147.32.84.165",20063,"74.125.93.27",25,6,372,6,372,0,0,52671.245554,9.01296100000036,330.19115471595643,0
"147.32.84.165",20064,"184.173.217.40",443,9,552,6,372,3,180,52671.386367,1.3074730000007548,2276.1464290262834,1101.3611753352984
"147.32.84.165",20065,"184.173.217.40",443,9,552,6,372,3,180,52673.689665,1.307263000002422,2276.51207139993,1101.5380990644821
"147.32.84.165",20066,"184.173.217.40",443,9,552,6,372,3,180,52675.992775,1.3078289999975823,2275.5268464038504,1101.0613772921859
"147.32.84.165",20067,"184.173.217.40",443,9,552,6,372,3,180,52678.295667,1.308377000001201,2274.5737658161743,1100.6002092658907
"147.32.84.165",20068,"184.173.217.40",443,9,552,6,372,3,180,52680.59944,1.3079320000033476,2275.347648037041,1100.9746684050199
"147.32.84.165",20069,"184.173.217.40",443,9,552,6,372,3,180,52682.902536,1.3080780000018422,2275.0936870705027,1100.8517840663721
"147.32.84.165",20070,"184.173.217.40",443,9,552,6,372,3,180,52685.206206,1.3075969999990775,2275.9305810598366,1101.256732770889
"147.32.84.165",20071,"184.173.217.40",443,9,552,6,372,3,180,52687.509337,1.307372999996005,2276.3205298022017,1101.4454176462266
"147.32.84.165",20072,"184.173.217.40",443,9,552,6,372,3,180,52689.812619,1.307466000005661,2276.158615204613,1101.3670718731998
"147.32.84.165",20073,"184.173.217.40",443,9,552,6,372,3,180,52692.115585,1.307569999997213,2275.977576731145,1101.2794726118443
"147.32.84.165",20074,"74.125.39.27",25,6,372,6,372,0,0,52692.275784,9.012780000004568,330.19778581064793,0
"147.32.84.165",20075,"184.173.217.40",443,9,552,6,372,3,180,52694.419263,1.3075499999977183,2276.012389587544,1101.29631754236
"147.32.84.165",20076,"184.173.217.40",443,9,552,6,372,3,180,52696.722055,1.3083450000049197,2274.6293982006346,1100.6271281615975
"147.32.84.165",20077,"184.173.217.40",443,9,552,6,372,3,180,52699.02602,1.3078200000018114,2275.542505846277,1101.0689544417469
"147.32.84.165",20078,"184.173.217.40",443,9,552,6,372,3,180,52701.328905,1.3077599999960512,2275.646907696356,1101.1194714659784
"147.32.84.165",20079,"184.173.217.40",443,9,552,6,372,3,180,52703.632523,1.3072289999981876,2276.571281699018,1101.5667492092025
"147.32.84.165",20080,"184.173.217.40",443,9,552,6,372,3,180,52705.936006,1.3070189999998547,2276.9370605938634,1101.7437389970307
"147.32.84.165",20081,"184.173.217.40",443,9,552,6,372,3,180,52708.238734,1.3082920000015292,2274.7215453404297,1100.6717154873047
"147.32.84.165",20082,"184.173.217.40",443,9,552,6,372,3,180,52710.541959,1.3081830000010086,2274.911078952796,1100.76342529974
"147.32.84.165",20083,"184.173.217.40",443,9,552,6,372,3,180,52712.845286,1.3079129999969155,2275.380701932788,1100.9906622255426
"147.32.84.165",20084,"66.111.4.73",25,6,372,6,372,0,0,52713.306597,8.912250999994285,333.9223726982003,0
"147.32.84.165",20085,"184.173.217.40",443,9,552,6,372,3,180,52715.148782,1.3082520000025397,2274.791095289151,1100.705368688299
"147.32.84.165",20086,"184.173.217.40",443,9,552,6,372,3,180,52717.45218,1.3080950000003213,2275.0641199601473,1100.8374774000713
"147.32.84.165",20087,"184.173.217.40",443,9,552,6,372,3,180,52719.755755,1.3077699999994365,2275.6295067185224,1101.1110516379947
"147.32.84.165",20088,"173.192.170.88",80,36,5485,26,2894,10,2591,52721.553211,58.812481000000844,393.6579380148861,352.44219675071525
"147.32.84.165",20089,"184.173.217.40",443,9,552,6,372,3,180,52722.059067,1.3075119999994058,2276.07853694754,1101.328324329455
"147.32.84.165",20090,"184.173.217.40",443,9,552,6,372,3,180,52724.362431,1.3077839999969,2275.6051458092884,1101.0992641012685
"147.32.84.165",20091,"184.173.217.40",443,9,552,6,372,3,180,52726.665923,1.3072529999990365,2276.529485877786,1101.5465254247351
"147.32.84.165",20092,"184.173.217.40",443,9,552,6,372,3,180,52728.968668,1.3080699999991339,2275.1076012766675,1100.8585167467747
"147.32.84.165",20093,"184.173.217.40",443,9,552,6,372,3,180,52731.272167,1.3074399999968591,2276.203879342187,1101.3889738752518
"147.32.84.165",20094,"184.173.217.40",443,9,552,6,372,3,180,52733.575134,1.3077810000031604,2275.6103659502683,1101.1017899759363
"147.32.84.165",20095,"216.157.130.15",25,6,372,6,372,0,0,52734.236368,9.013139000002411,330.18463378842864,0
"147.32.84.165",20096,"184.173.217.40",443,9,552,6,372,3,180,52735.878871,1.3076979999968898,2275.7547996609906,1101.171677255318
"147.32.84.165",20097,"184.173.217.40",443,9,552,6,372,3,180,52738.182177,1.3075489999973797,2276.014130258953,1101.2971598027193
"147.32.84.165",20098,"184.173.217.40",443,9,552,6,372,3,180,52740.485107,1.3082999999969616,2274.7076358686168,1100.6649850977178
"147.32.84.165",20099,"184.173.217.40",443,9,552,6,372,3,180,52742.788318,1.3084880000023986,2274.3808120476033,1100.506844539163
"147.32.84.165",20101,"184.173.217.40",443,9,552,6,372,3,180,52745.092326,1.3079060000018217,2275.3928799132773,1100.9965547967472
"147.32.84.165",20102,"184.173.217.40",443,9,552,6,372,3,180,52747.394977,1.3078889999960666,2275.4224555822016,1101.0108656042912
"147.32.84.165",20103,"184.173.217.40",443,9,552,6,372,3,180,52749.698576,1.307398999997531,2276.275261037847,1101.4235134054097
"147.32.84.165",20104,"184.173.217.40",443,9,552,6,372,3,180,52752.00204,1.3074160000032862,2276.2456631955856,1101.4091918688318
"147.32.84.165",20105,"184.173.217.40",443,9,552,6,372,3,180,52754.304848,1.3081569999994827,2274.9562934733194,1100.7853032935416
"147.32.84.165",20107,"98.126.71.122",80,18,4863,14,1430,4,3433,52755.066671,16.563626999995904,690.669984297692,1658.0909483174664
"147.32.84.165",20108,"195.113.232.98",80,21,7776,14,3864,7,3912,52756.072125,18.98225000000093,1628.4687010232444,1648.6981258806761
"147.32.84.165",20109,"195.113.232.89",80,13,2796,10,1774,3,1022,52756.18752,18.867041999998037,752.2111839259952,433.3482694319995
"147.32.84.165",20110,"184.173.217.40",443,9,552,6,372,3,180,52756.598091,1.313188000000082,2266.240629673599,1096.5680466162576
"147.32.84.165",20111,"195.113.232.83",80,49,38392,40,3476,9,34916,52756.617913,18.43682699999772,1508.285563454245,15150.546240957543
"147.32.84.165",20112,"184.173.217.40",443,9,552,6,372,3,180,52758.911823,1.3067010000013397,2277.4911781631367,1102.0118604015177
"147.32.84.165",20113,"184.173.217.40",443,9,552,6,372,3,180,52761.219295,1.306734999998298,2277.431920017353,1101.983187105171
"147.32.84.165",20114,"184.173.217.40",443,9,552,6,372,3,180,52763.526494,1.3069130000003497,2277.1217364883537,1101.8330983008163
"147.32.84.165",20115,"184.173.217.40",443,9,552,6,372,3,180,52765.83413,1.3064909999957308,2277.857252755453,1102.1889932687675
"147.32.84.165",20116,"184.173.217.40",443,9,552,6,372,3,180,52768.141152,1.306579000003694,2277.703835735601,1102.1147592269037
"147.32.84.165",20117,"184.173.217.40",443,9,552,6,372,3,180,52770.447774,1.207483999998658,2464.628930903687,1192.562385921139
"147.32.84.165",20118,"184.173.217.40",443,9,552,6,372,3,180,52772.655441,1.3070889999944484,2276.81512124472,1101.684736086155
"147.32.84.165",20119,"184.173.217.40",443,9,552,6,372,3,180,52774.973676,1.3085799999971641,2274.2209112216674,1100.4294731717746
"147.32.84.165",20120,"184.173.217.40",443,9,552,6,372,3,180,52777.277379,1.3077180000036606,2275.7199946713813,1101.1548361313137
"147.32.84.165",20121,"184.173.217.40",443,9,552,6,372,3,180,52779.580271,1.308301000004576,2274.7058971823694,1100.6641437979206
"147.32.84.165",20122,"173.192.170.88",80,23,2377,18,1816,5,561,52780.165329,57.25901299999532,253.7242477442143,78.38067344961686
"147.32.84.165",20123,"184.173.217.40",443,9,552,6,372,3,180,52781.883602,1.308538999997836,2274.2921685978954,1100.4639525473688
"147.32.84.165",20124,"184.173.217.40",443,9,552,6,372,3,180,52784.18765,1.3079090000028373,2275.387660757395,1100.9940293987397
"147.32.84.165",20125,"184.173.217.40",443,9,552,6,372,3,180,52786.490916,1.3075479999970412,2276.0158709330244,1101.2980020643668
"147.32.84.165",20126,"184.173.217.40",443,9,552,6,372,3,180,52788.793878,1.3083299999998417,2274.6554768295155,1100.6397468529915
"147.32.84.165",20127,"184.173.217.40",443,9,552,6,372,3,180,52791.096809,1.3083879999976489,2274.554642816464,1100.590956201515
"147.32.84.165",20128,"184.173.217.40",443,9,552,6,372,3,180,52793.400575,1.3077209999974002,2275.7147740274236,1101.1523100132695
"147.32.84.165",20129,"184.173.217.40",443,9,552,6,372,3,180,52795.703627,1.3082489999942482,2274.796311721304,1100.7078927683729
"147.32.84.165",20130,"184.173.217.40",443,9,552,6,372,3,180,52798.007488,1.3075609999941662,2275.9932423904334,1101.2870527695645
"147.32.84.165",20131,"184.173.217.40",443,9,552,6,372,3,180,52800.310515,1.3076680000012857,2275.807009116285,1101.1969398949766
"147.32.84.165",20132,"184.173.217.40",443,9,552,6,372,3,180,52802.614494,1.3068100000018603,2277.3012144043614,1101.9199424537233
"147.32.84.165",20133,"184.173.217.40",443,9,552,6,372,3,180,52804.91692,1.3080239999981131,2275.187611239773,1100.8972312450514
"147.32.84.165",20134,"184.173.217.40",443,9,552,6,372,3,180,52807.220424,1.3080150000023423,2275.2032660135174,1100.904806135573
"147.32.84.165",20135,"184.173.217.40",443,9,552,6,372,3,180,52809.524071,1.307215000000724,2276.595663298196,1101.5785467571916
"147.32.84.165",20136,"184.173.217.40",443,9,552,6,372,3,180,52811.826838,1.3076209999999264,2275.8888087604646,1101.2365203679667
"147.32.84.165",20137,"184.173.217.40",443,9,552,6,372,3,180,52814.130426,1.3080099999933736,2275.211963222817,1100.9090144626532
"147.32.84.165",20138,"184.173.217.40",443,9,552,6,372,3,180,52816.433913,1.307394999996177,2276.2822253478885,1101.4268832328491
"147.32.84.165",20139,"184.173.217.40",443,9,552,6,372,3,180,52818.737149,1.3073850000000675,2276.299636296765,1101.4353078855315
"147.32.84.165",20140,"184.173.217.40",443,9,552,6,372,3,180,52821.040602,1.3077029999985825,2275.7460983137807,1101.1674669260228
"147.32.84.165",20141,"184.173.217.40",443,9,552,6,372,3,180,52823.343681,1.3073850000000675,2276.299636296765,1101.4353078855315
"147.32.84.165",20142,"184.173.217.40",443,9,552,6,372,3,180,52825.646662,1.3078719999975874,2275.4520320073293,1101.02517677774
"147.32.84.165",20143,"184.173.217.40",443,9,552,6,372,3,180,52827.950191,1.3081589999928838,2274.9528153811493,1100.7836203457175
"147.32.84.165",20144,"184.173.217.40",443,9,552,6,372,3,180,52830.253279,1.307732000001124,2275.6956318247485,1101.1430476571363
"147.32.84.165",20145,"184.173.217.40",443,9,552,6,372,3,180,52832.556678,1.3078010000026552,2275.575565391033,1101.0849509956608
"147.32.84.165",20146,"184.173.217.40",443,9,552,6,372,3,180,52834.860228,1.3074630000046454,2276.163837897842,1101.3695989828268
"147.32.84.165",20147,"184.173.217.40",443,9,552,6,372,3,180,52837.163457,1.308021999997436,2275.191090062578,1100.8989145464088
"147.32.84.165",20148,"184.173.217.40",443,9,552,6,372,3,180,52839.466358,1.307916000005207,2275.375482820114,1100.9881368484423
"147.32.84.165",20149,"184.173.217.40",443,9,552,6,372,3,180,52841.770253,1.3075619999945047,2275.9915017509743,1101.286210524665
"147.32.84.165",20150,"184.173.217.40",443,9,552,6,372,3,180,52844.072989,1.3079070000021602,2275.3911401919895,1100.995712996124
"147.32.84.165",20151,"184.173.217.40",443,9,552,6,372,3,180,52846.376948,1.3074970000016037,2276.1046488032857,1101.340959098364
"147.32.84.165",20152,"184.173.217.40",443,9,552,6,372,3,180,52848.680107,1.3073900000017602,2276.2909307826994,1101.4310955400158
"147.32.84.165",20153,"184.173.217.40",443,9,552,6,372,3,180,52850.983499,1.3074479999995674,2276.1899517234983,1101.3822347049186
"147.32.84.165",20154,"184.173.217.40",443,9,552,6,372,3,180,52853.28667,1.307701999998244,2275.7478385778995,1101.168308989306
"147.32.84.165",20155,"184.173.217.40",443,9,552,6,372,3,180,52855.590128,1.3071270000000368,2276.748931052542,1101.6527085738107
"147.32.84.165",20156,"184.173.217.40",443,9,552,6,372,3,180,52857.893107,1.3077499999999418,2275.6643089276486,1101.1278914166041
"147.32.84.165",20157,"184.173.217.40",443,9,552,6,372,3,180,52860.196774,1.307780000002822,2275.6121060068044,1101.1026319387763
"147.32.84.165",20158,"184.173.217.40",443,9,552,6,372,3,180,52862.499867,1.3078569999997853,2275.4781294900654,1101.0378045919672
"147.32.84.165",20159,"184.173.217.40",443,9,552,6,372,3,180,52864.802972,1.3076970000038273,2275.756539925755,1101.1725193189138
"147.32.84.165",20160,"184.173.217.40",443,9,552,6,372,3,180,52867.106112,1.3078000000023167,2275.577305394348,1101.085792932749
"147.32.84.165",20161,"184.173.217.40",443,9,552,6,372,3,180,52869.409947,1.3074980000019423,2276.1029079934187,1101.3401167710092
"147.32.84.165",20162,"184.173.217.40",443,9,552,6,372,3,180,52871.713326,1.3075140000000829,2276.0750554103524,1101.3266397146865
"147.32.84.165",20163,"184.173.217.40",443,9,552,6,372,3,180,52874.016701,1.3072430000029271,2276.5469006094017,1101.5549519077751
"147.32.84.165",20164,"94.100.176.20",25,6,372,6,372,0,0,52875.41897,8.972232000000076,331.69004100651597,0
"147.32.84.165",20165,"184.173.217.40",443,9,552,6,372,3,180,52876.320103,1.3073110000041197,2276.4284856400823,1101.4976543419755
"147.32.84.165",20166,"184.173.217.40",443,9,552,6,372,3,180,52878.622986,1.3074909999995725,2276.1150937184066,1101.3460130895514
"147.32.84.165",20167,"184.173.217.40",443,9,552,6,372,3,180,52880.926628,1.3077520000006189,2275.660828657568,1101.1262074149522
"147.32.84.165",20168,"184.173.217.40",443,9,552,6,372,3,180,52883.22989,1.3073850000000675,2276.299636296765,1101.4353078855315
"147.32.84.165",20169,"184.173.217.40",443,9,552,6,372,3,180,52885.53306,1.3079849999994622,2275.2554501781165,1100.9300565377982
"147.32.84.165",20170,"184.173.217.40",443,9,552,6,372,3,180,52887.836188,1.3077009999979055,2275.74957884468,1101.1691510538774
"147.32.84.165",20171,"184.173.217.40",443,9,552,6,372,3,180,52890.139451,1.3076099999962025,2275.907954213139,1101.24578429668
"147.32.84.165",20172,"184.173.217.40",443,9,552,6,372,3,180,52892.442929,1.307572000005166,2275.9740954901467,1101.2777881403936
"147.32.84.165",20173,"184.173.217.40",443,9,552,6,372,3,180,52894.74646,1.3077339999945252,2275.692151471522,1101.1413636152524
"147.32.84.165",20174,"74.125.93.27",25,6,372,6,372,0,0,52896.408198,8.913236000000325,333.8854710006435,0
"147.32.84.165",20175,"184.173.217.40",443,9,552,6,372,3,180,52897.049199,1.6058980000016163,1853.1687566688574,896.6945596784793
"147.32.84.165",20176,"184.173.217.40",443,9,552,6,372,3,180,52899.653371,1.3079480000014883,2275.3198139349684,1100.9612002911135
"147.32.84.165",20177,"184.173.217.40",443,9,552,6,372,3,180,52901.956361,1.3082660000000033,2274.7667523271207,1100.6935898357035
"147.32.84.165",20178,"184.173.217.40",443,9,552,6,372,3,180,52904.260215,1.3073230000009062,2276.407590165504,1101.4875436284697
"147.32.84.165",20179,"184.173.217.40",443,9,552,6,372,3,180,52906.56284,1.3080239999981131,2275.187611239773,1100.8972312450514
"147.32.84.165",20180,"184.173.217.40",443,9,552,6,372,3,180,52908.866752,1.3072119999997085,2276.600887997252,1101.58107483738
"147.32.84.165",20181,"184.173.217.40",443,9,552,6,372,3,180,52911.169426,1.3087289999966742,2273.961989080675,1100.3041882648427
"147.32.84.165",20182,"184.173.217.40",443,9,552,6,372,3,180,52913.472888,1.3082640000066021,2274.770229850383,1100.69527250825
"147.32.84.165",20183,"184.173.217.40",443,9,552,6,372,3,180,52915.776626,1.3074570000026142,2276.1742833562016,1101.3746532368718
"147.32.84.165",20184,"74.125.39.27",25,6,372,6,372,0,0,52917.33837,9.012821000003896,330.1962837161321,0
"147.32.84.165",20185,"184.173.217.40",443,9,552,6,372,3,180,52918.079813,1.3074860000051558,2276.1237978749023,1101.3502247781787
"147.32.84.165",20186,"184.173.217.40",443,9,552,6,372,3,180,52920.382757,1.308043999997608,2275.1528236094828,1100.8803985207176
"147.32.84.165",20187,"184.173.217.40",443,9,552,6,372,3,180,52922.686093,1.3077100000009523,2275.733916539472,1101.1615725190993
"147.32.84.165",20188,"184.173.217.40",443,9,552,6,372,3,180,52924.989971,1.3076469999941764,2275.8435571780865,1101.2146244410096
"147.32.84.165",20189,"184.173.217.40",443,9,552,6,372,3,180,52927.293203,1.3073220000005676,2276.4093314414567,1101.4883861813498
"147.32.84.165",20190,"184.173.217.40",443,9,552,6,372,3,180,52929.59639,1.307518000001437,2276.068092367929,1101.3232705006105
"147.32.84.165",20191,"184.173.217.40",443,9,552,6,372,3,180,52931.899642,1.3077940000002855,2275.5877454701204,1101.0908445823163
"147.32.84.165",20192,"184.173.217.40",443,9,552,6,372,3,180,52934.202897,1.3077789999952074,2275.6138460786615,1101.1034739090298
"147.32.84.165",20193,"184.173.217.40",443,9,552,6,372,3,180,52936.506197,1.3078509999977541,2275.488568655841,1101.0428558012134
"147.32.84.165",20194,"66.111.4.73",25,6,372,6,372,0,0,52938.368716,9.01341500000126,330.1745231967666,0
"147.32.84.165",20195,"184.173.217.40",443,9,552,6,372,3,180,52938.809715,1.307554999999411,2276.0036862704364,1101.2921062598887
"147.32.84.165",20196,"184.173.217.40",443,9,552,6,372,3,180,52941.112792,1.30833800000255,2274.6415681530307,1100.6330168482407
"147.32.84.165",20197,"184.173.217.40",443,9,552,6,372,3,180,52943.415885,1.3081249999959255,2275.0119445842483,1100.8122312504427
"147.32.84.165",20198,"184.173.217.40",443,9,552,6,372,3,180,52945.719287,1.3080150000023423,2275.2032660135174,1100.904806135573
"147.32.84.165",20199,"184.173.217.40",443,9,552,6,372,3,180,52948.02266,1.3078160000004573,2275.549465673275,1101.0723220999716
"147.32.84.165",20200,"184.173.217.40",443,9,552,6,372,3,180,52950.32622,1.3074529999939841,2276.1812470610366,1101.3780227714692
"147.32.84.165",20201,"184.173.217.40",443,9,552,6,372,3,180,52952.629756,1.307411999994656,2276.2526273371855,1101.4125616147671
"147.32.84.165",20202,"184.173.217.40",443,9,552,6,372,3,180,52954.932739,1.307448999999906,2276.1882107831466,1101.3813923144257
"147.32.84.165",20203,"184.173.217.40",443,9,552,6,372,3,180,52957.236186,1.3072790000005625,2276.484208802191,1101.5246171623505
"147.32.84.165",20204,"216.157.130.15",25,6,372,6,372,0,0,52959.399183,9.012983000000531,330.19034874467474,0
"147.32.84.165",20205,"184.173.217.40",443,9,552,6,372,3,180,52959.539443,1.307608999995864,2275.9096947248095,1101.2466264797465
"147.32.84.165",20206,"184.173.217.40",443,9,552,6,372,3,180,52961.842461,1.3084369999996852,2274.469462420213,1100.5497398807481
"147.32.84.165",20207,"184.173.217.40",443,9,552,6,372,3,180,52964.145732,1.30824500000017,2274.8032669718696,1100.711258212195
"147.32.84.165",20208,"184.173.217.40",443,9,552,6,372,3,180,52966.449628,1.3078590000004624,2275.4746497894253,1101.036120865851
"147.32.84.165",20209,"184.173.217.40",443,9,552,6,372,3,180,52968.752588,1.3081429999947431,2274.9806405048676,1100.7970841152585
"147.32.84.165",20210,"184.173.217.40",443,9,552,6,372,3,180,52971.055955,1.307660999998916,2275.8191916731225,1101.2028346805432
"147.32.84.165",20211,"184.173.217.40",443,9,552,6,372,3,180,52973.358985,1.3082280000016908,2274.832827302392,1100.7255615979316
"147.32.84.165",20212,"184.173.217.40",443,9,552,6,372,3,180,52975.662439,1.30812600000354,2275.010205432769,1100.8113897255334
"147.32.84.165",20213,"184.173.217.40",443,9,552,6,372,3,180,52977.965754,1.3078630000018165,2275.467690420072,1101.032753429067
"147.32.84.165",20214,"184.173.217.40",443,9,552,6,372,3,180,52980.269283,1.3075909999970463,2275.941024377441,1101.2617859890843
"147.32.84.165",20215,"184.173.217.40",443,9,552,6,372,3,180,52982.572212,1.3077740000007907,2275.6225464019017,1101.1076837428557
"147.32.84.165",20216,"184.173.217.40",443,9,552,6,372,3,180,52984.876035,1.307636999998067,2275.8609614169677,1101.2230458469198
"147.32.84.165",20217,"184.173.217.40",443,9,552,6,372,3,180,52987.179095,1.3081190000011702,2275.022379460384,1100.8172803840566
"147.32.84.165",20218,"184.173.217.40",443,9,552,6,372,3,180,52989.482136,1.3077570000023115,2275.652128028938,1101.1219974333571
"147.32.84.165",20219,"184.173.217.40",443,9,552,6,372,3,180,52991.786021,1.3076139999975567,2275.9009921930788,1101.2424155772962
"147.32.84.165",20220,"184.173.217.40",443,9,552,6,372,3,180,52994.088977,1.3080170000030193,2275.1997871534777,1100.903122816199
"147.32.84.165",20221,"184.173.217.40",443,9,552,6,372,3,180,52996.392196,1.3077229999980773,2275.7112936029844,1101.150625936928
"147.32.84.165",20222,"184.173.217.40",443,9,552,6,372,3,180,52998.695793,1.3076100000034785,2275.907954200475,1101.2457842905526
"147.32.84.165",20223,"184.173.217.40",443,9,552,6,372,3,180,53000.999363,1.3070430000007036,2276.895251340926,1101.7235087133513
"147.32.84.165",20224,"184.173.217.40",443,9,552,6,372,3,180,53003.30193,1.3079619999989518,2275.29545965585,1100.949415962508
"147.32.84.165",20225,"184.173.217.40",443,9,552,6,372,3,180,53005.60559,1.3073979999971925,2276.277002111362,1101.4243558603364
"147.32.84.165",20226,"184.173.217.40",443,9,552,6,372,3,180,53007.909127,1.3076730000029784,2275.7983073698256,1101.1927293724962
"147.32.84.165",20227,"184.173.217.40",443,9,552,6,372,3,180,53010.212311,1.3079329999964102,2275.3459083975767,1100.9738266439888
"147.32.84.165",20228,"184.173.217.40",443,9,552,6,372,3,180,53012.515532,1.3080110000009881,2275.2102237655126,1100.9081727897642
"147.32.84.165",20229,"184.173.217.40",443,9,552,6,372,3,180,53014.818858,1.3079970000035246,2275.234576219961,1100.9199562354652
"147.32.84.165",20230,"184.173.217.40",443,9,552,6,372,3,180,53017.122006,1.308179999999993,2274.9162959225914,1100.7659496399638
"147.32.84.165",20231,"184.173.217.40",443,9,552,6,372,3,180,53019.425641,1.3076619999992545,2275.817451299875,1101.2019925644554
"147.32.84.165",20232,"173.192.170.88",80,26,4640,18,1968,8,2672,53021.374114,46.36112900000444,339.5948360101087,461.0759155584402
"147.32.84.165",20233,"184.173.217.40",443,9,552,6,372,3,180,53021.728533,1.3080340000014985,2275.1702172853234,1100.888814815479
"147.32.84.165",20234,"184.173.217.40",443,9,552,6,372,3,180,53024.032107,1.3074350000024424,2276.212584177753,1101.3931858924611
"147.32.84.165",20235,"184.173.217.40",443,9,552,6,372,3,180,53026.335348,1.3076519999958691,2275.8348551521362,1101.2104137832916
"147.32.84.165",20236,"184.173.217.40",443,9,552,6,372,3,180,53028.638427,1.3077230000053532,2275.711293590323,1101.1506259308012
"147.32.84.165",20237,"184.173.217.40",443,9,552,6,372,3,180,53030.942031,1.307944000000134,2275.3267723998083,1100.9645672902298
"147.32.84.165",20239,"184.173.217.40",443,9,552,6,372,3,180,53033.245244,1.3076419999997597,2275.8522592579216,1101.2188351248008
"147.32.84.165",20240,"184.173.217.40",443,9,552,6,372,3,180,53035.548738,1.3073770000046352,2276.313565245104,1101.442047699244
"147.32.84.165",20241,"184.173.217.40",443,9,552,6,372,3,180,53037.851706,1.3076399999990826,2275.855740113554,1101.2205194097842
"147.32.84.165",20242,"184.173.217.40",443,9,552,6,372,3,180,53040.15497,1.3079039999938686,2275.396359376492,1100.99823840798
"147.32.84.165",20244,"98.126.71.122",80,18,4863,14,1430,4,3433,53041.405956,20.089164999997593,569.461199606921,1367.1051036717201
"147.32.84.165",20245,"95.100.248.96",80,17,5619,12,2574,5,3045,53042.102699,19.39252999999735,1061.8521667880784,1256.153787051165
"147.32.84.165",20246,"195.113.232.83",80,13,1967,10,1594,3,373,53042.340497,19.154820000003383,665.7332201502153,155.7832441129425
"147.32.84.165",20247,"184.173.217.40",443,9,552,6,372,3,180,53042.448375,1.3124370000005001,2267.537413223542,1097.1955225275203
"147.32.84.165",20248,"184.173.217.40",443,9,552,6,372,3,180,53044.76081,1.3071080000008806,2276.782025661227,1101.6687220941421
"147.32.84.165",20249,"184.173.217.40",443,9,552,6,372,3,180,53047.068182,1.306563999998616,2277.72998490939,1102.1274120529306
"147.32.84.165",20250,"184.173.217.40",443,9,552,6,372,3,180,53049.374655,1.3075470000039786,2276.0176115970935,1101.298844321174
"147.32.84.165",20251,"184.173.217.40",443,9,552,6,372,3,180,53051.682608,1.307221999995818,2276.5834724396627,1101.5726479546756
"147.32.84.165",20252,"184.173.217.40",443,9,552,6,372,3,180,53053.990048,1.307131000001391,2276.74196388643,1101.6493373644016
"147.32.84.165",20253,"184.173.217.40",443,9,552,6,372,3,180,53056.297549,1.3072879999963334,2276.468536396224,1101.5170337401084
"147.32.84.165",20254,"184.173.217.40",443,9,552,6,372,3,180,53058.604886,1.3072299999985262,2276.5695401752982,1101.5659065364346
"147.32.84.165",20255,"184.173.217.40",443,9,552,6,372,3,180,53060.913693,1.3186040000000503,2256.9323314656153,1092.0640313543302
"147.32.84.165",20256,"184.173.217.40",443,9,552,6,372,3,180,53063.22732,1.308353000000352,2274.615489855719,1100.6203983172834
"147.32.84.165",20257,"173.192.170.88",80,37,4761,24,1886,13,2875,53063.261748,43.05609900000127,350.4265446806864,534.1868059156805
"147.32.84.165",20258,"184.173.217.40",443,9,552,6,372,3,180,53065.531094,1.3073020000010729,2276.444157507261,1101.5052375035134
"147.32.84.165",20259,"173.192.170.88",80,18,2945,14,1572,4,1373,53067.534996,9.42085799999768,1334.9102597664776,1165.9235284092708
"147.32.84.165",20260,"184.173.217.40",443,9,552,6,372,3,180,53067.833996,1.3075969999990775,2275.9305810598366,1101.256732770889
"147.32.84.165",20262,"184.173.217.40",443,9,552,6,372,3,180,53070.137598,1.3078569999997853,2275.4781294900654,1101.0378045919672
"147.32.84.165",20263,"184.173.217.40",443,9,552,6,372,3,180,53072.441078,1.3076029999938328,2275.920137850736,1101.2516796051948
"147.32.84.165",20264,"184.173.217.40",443,9,552,6,372,3,180,53074.743803,1.3081860000020242,2274.905862006928,1100.760900971094
"147.32.84.165",20265,"173.192.170.88",80,13,1407,10,970,3,437,53076.95695,16.668383000003814,465.55205744901735,209.73840113940267
"147.32.84.165",20266,"184.173.217.40",443,9,552,6,372,3,180,53077.047759,1.3074579999956768,2276.1725424524843,1101.3738108641053
"147.32.84.165",20267,"184.173.217.40",443,9,552,6,372,3,180,53079.35058,1.3078850000019884,2275.4294146622033,1101.014232901066
"147.32.84.165",20269,"98.126.71.122",80,18,4863,14,1430,4,3433,53079.968239,16.643898999995145,687.3389462411023,1650.0941275844086
"147.32.84.165",20270,"95.100.248.97",80,17,5670,12,2556,5,3114,53080.686584,47.86324699999386,427.2171505623641,520.4828665302042
"147.32.84.165",20271,"195.113.232.83",80,13,1968,10,1596,3,372,53080.934315,47.61571600000025,268.1467606199586,62.50037277608058
"147.32.84.165",20272,"77.238.175.247",80,14,2274,10,1276,4,998,53080.974276,0.14459599999827333,70596.69700490953,55215.911920767794
"147.32.84.165",20273,"74.125.232.217",80,13,1871,10,1156,3,715,53080.99507,47.555199000002176,194.4687477808594,120.28127566030663
"147.32.84.165",20274,"64.236.79.229",80,14,2274,10,1560,4,714,53081.011895,0.3562309999979334,35033.447398099546,16034.539386053255
"147.32.84.165",20275,"68.67.179.212",80,16,2170,12,1370,4,800,53081.026059,10.579115999993519,1036.003386294915,604.9654810481254
"147.32.84.165",20276,"64.236.79.229",80,14,2078,10,1378,4,700,53081.030378,0.35545899999851827,31013.422082563542,15754.278271258692
"147.32.84.165",20277,"64.236.79.229",80,14,2061,10,1404,4,657,53081.10647,0.35604800000146497,31546.30836278756,14762.054554381359
"147.32.84.165",20278,"77.238.167.32",80,13,2342,10,1390,3,952,53081.142103,0.14011300000129268,79364.51292811807,54356.12683997727
"147.32.84.165",20279,"64.236.79.229",80,14,2043,10,1386,4,657,53081.171149,0.3552789999957895,31209.274964552947,14794.006963716658
"147.32.84.165",20280,"77.238.175.247",80,14,3055,10,1368,4,1687,53081.236779,0.13982899999973597,78267.02615352084,96517.88970832576
"147.32.84.165",20281,"195.113.232.82",80,13,1965,10,1306,3,659,53081.270704,47.27978599999915,220.9823876952444,111.50642686919299
"147.32.84.165",20282,"74.217.252.37",80,12,2075,10,1278,2,797,53081.32749,47.22319599999901,216.5037707316594,135.0183922324981
"147.32.84.165",20283,"64.236.79.229",80,14,2089,10,1432,4,657,53081.362606,0.3552629999976489,32246.532850524305,14794.673242174908
"147.32.84.165",20284,"184.173.217.40",443,9,552,6,372,3,180,53081.670828,1.2980719999977737,2292.6309172411884,1109.337540600575
"147.32.84.165",20285,"184.173.217.40",443,9,552,6,372,3,180,53083.964076,1.3078780000068946,2275.441593164127,1101.0201257245774
"147.32.84.165",20286,"184.173.217.40",443,9,552,6,372,3,180,53086.267642,1.307438000003458,2276.2073612608237,1101.390658674592
"147.32.84.165",20287,"184.173.217.40",443,9,552,6,372,3,180,53088.571234,1.3076969999965513,2275.756539938417,1101.1725193250406
"147.32.84.165",20288,"184.173.217.40",443,9,552,6,372,3,180,53090.874044,1.307955000003858,2275.30763672391,1100.9553080922146
"147.32.84.165",20289,"184.173.217.40",443,9,552,6,372,3,180,53093.178059,1.3069130000003497,2277.1217364883537,1101.8330983008163
"147.32.84.165",20290,"184.173.217.40",443,9,552,6,372,3,180,53095.480641,1.307742999997572,2275.6764899567615,1101.1337854629492
"147.32.84.165",20291,"184.173.217.40",443,9,552,6,372,3,180,53097.783979,1.3079970000035246,2275.234576219961,1100.9199562354652
"147.32.84.165",20292,"184.173.217.40",443,9,552,6,372,3,180,53100.087621,1.307687000000442,2275.7739428464106,1101.180940086973
"147.32.84.165",20293,"94.100.176.20",25,6,372,6,372,0,0,53100.630107,8.931294000001799,333.210394820661,0
"147.32.84.165",20294,"184.173.217.40",443,9,552,6,372,3,180,53102.390734,1.307660999998916,2275.8191916731225,1101.2028346805432
"147.32.84.165",20295,"184.173.217.40",443,9,552,6,372,3,180,53104.694022,1.308391999999003,2274.54768907351,1100.5875914871822
"147.32.84.165",20296,"173.192.170.88",80,6,372,6,372,0,0,53106.117214,8.951756000002206,332.4487396661914,0
"147.32.84.165",20297,"184.173.217.40",443,9,552,6,372,3,180,53106.997881,1.3090509999965434,2273.4026405448362,1100.0335357475014
"147.32.84.165",20298,"184.173.217.40",443,9,552,6,372,3,180,53109.300652,1.3087440000017523,2273.9359263507727,1100.2915772665028
"147.32.84.165",20299,"184.173.217.40",443,9,552,6,372,3,180,53111.603913,1.3083029999979772,2274.702419855799,1100.6624612205478
"147.32.84.165",20300,"184.173.217.40",443,9,552,6,372,3,180,53113.907474,1.3075040000039735,2276.092463190136,1101.335062833937
"147.32.84.165",20301,"184.173.217.40",443,9,552,6,372,3,180,53116.210952,1.3076519999958691,2275.8348551521362,1101.2104137832916
"147.32.84.165",20302,"184.173.217.40",443,9,552,6,372,3,180,53118.513896,1.3076170000058482,2275.8957706933224,1101.239889045156
"147.32.84.165",20303,"184.173.217.40",443,9,552,6,372,3,180,53120.817212,1.3078269999969052,2275.530326264133,1101.0630610955482
"147.32.84.165",20304,"74.125.93.27",25,6,372,6,372,0,0,53121.57838,9.013208000003942,330.18210608239576,0
"147.32.84.165",20305,"184.173.217.40",443,9,552,6,372,3,180,53123.121043,1.307143999998516,2276.719320903725,1101.6383810824477
"147.32.84.165",20306,"184.173.217.40",443,9,552,6,372,3,180,53125.424109,1.3074290000004112,2276.223030083518,1101.3982403629927
"147.32.84.165",20307,"173.192.170.88",80,15,3192,10,966,5,2226,53127.087098,1.3646779999980936,5662.874319078051,13049.23212657116
"147.32.84.165",20308,"184.173.217.40",443,9,552,6,372,3,180,53127.727488,1.307559000000765,2275.996723664675,1101.2887372571008
"147.32.84.165",20309,"184.173.217.40",443,9,552,6,372,3,180,53130.030656,1.307887999995728,2275.424195351376,1101.0117074280852
"147.32.84.165",20310,"184.173.217.40",443,9,552,6,372,3,180,53132.334205,1.3077570000023115,2275.652128028938,1101.1219974333571
"147.32.84.165",20311,"184.173.217.40",443,9,552,6,372,3,180,53134.637591,1.3074110000015935,2276.254368363409,1101.4134040468107
"147.32.84.165",20312,"184.173.217.40",443,9,552,6,372,3,180,53136.940772,1.307860000000801,2275.472909943096,1101.0352790047239
"147.32.84.165",20313,"184.173.217.40",443,9,552,6,372,3,180,53139.243972,1.3078320000058739,2275.5216266207235,1101.0588515906727
"147.32.84.165",20314,"184.173.217.40",443,9,552,6,372,3,180,53141.547395,1.3073109999968437,2276.428485652752,1101.497654348106
"147.32.84.165",20315,"74.125.39.27",25,6,372,6,372,0,0,53142.608767,8.912302000004274,333.92046185133455,0
"147.32.84.165",20316,"184.173.217.40",443,9,552,6,372,3,180,53143.850609,1.3074469999992289,2276.1916926665135,1101.3830770967002
"147.32.84.165",20317,"184.173.217.40",443,9,552,6,372,3,180,53146.153989,1.3073700000022654,2276.325753225822,1101.4479451092689
"147.32.84.165",20318,"184.173.217.40",443,9,552,6,372,3,180,53148.456834,1.3081710000042222,2274.931946962893,1100.7735227239805
"147.32.84.165",20319,"184.173.217.40",443,9,552,6,372,3,180,53150.760311,1.3080830000035348,2275.084990778076,1100.84757618294
"147.32.84.165",20320,"184.173.217.40",443,9,552,6,372,3,180,53153.063447,1.3076710000023013,2275.801788060424,1101.1944135776246
"147.32.84.165",20321,"184.173.217.40",443,9,552,6,372,3,180,53155.366941,1.3078479999967385,2275.4937882746476,1101.0453814232167
"147.32.84.165",20322,"184.173.217.40",443,9,552,6,372,3,180,53157.670088,1.307792999999947,2275.5894854920625,1101.0916865284173
"147.32.84.165",20323,"184.173.217.40",443,9,552,6,372,3,180,53159.973481,1.3095259999972768,2272.578016783316,1099.6345242499915
"147.32.84.165",20324,"184.173.217.40",443,9,552,6,372,3,180,53162.276938,1.3081729999976233,2274.928468945168,1100.7718398121779
"147.32.84.165",20325,"66.111.4.73",25,6,372,6,372,0,0,53163.538687,9.013134000000719,330.18481695709426,0
"147.32.84.165",20326,"184.173.217.40",443,9,552,6,372,3,180,53164.580136,1.3078430000023218,2275.50248767988,1101.049590812845
"147.32.84.165",20327,"184.173.217.40",443,9,552,6,372,3,180,53166.884024,1.3074869999982184,2276.1220570484106,1101.3493824427794
"147.32.84.165",20328,"184.173.217.40",443,9,552,6,372,3,180,53169.187106,1.3074930000002496,2276.1116120693814,1101.3443284206685
"147.32.84.165",20329,"184.173.217.40",443,9,552,6,372,3,180,53171.490536,1.307426999999734,2276.2265120734123,1101.3999251968123
"147.32.84.165",20330,"184.173.217.40",443,9,552,6,372,3,180,53173.793462,1.307954999996582,2275.3076367365675,1100.955308098339
"147.32.84.165",20331,"184.173.217.40",443,9,552,6,372,3,180,53176.096602,1.3085740000024089,2274.2313388425277,1100.4345187947715
"147.32.84.165",20332,"184.173.217.40",443,9,552,6,372,3,180,53178.400251,1.3073110000041197,2276.4284856400823,1101.4976543419755
"147.32.84.165",20333,"184.173.217.40",443,9,552,6,372,3,180,53180.703439,1.3078569999997853,2275.4781294900654,1101.0378045919672
"147.32.84.165",20334,"184.173.217.40",443,9,552,6,372,3,180,53183.00656,1.3079219999999623,2275.3650447045666,1100.9830861473708
"147.32.84.165",20335,"216.157.130.15",25,6,372,6,372,0,0,53184.568887,9.012675999998464,330.2015960632011,0
"147.32.84.165",20336,"184.173.217.40",443,9,552,6,372,3,180,53185.310301,1.3076690000016242,2275.8052687616696,1101.1960977879046
"147.32.84.165",20337,"184.173.217.40",443,9,552,6,372,3,180,53187.61321,1.3075839999946766,2275.953208369111,1101.2676814689248
"147.32.84.165",20338,"184.173.217.40",443,9,552,6,372,3,180,53189.916572,1.3079429999997956,2275.3285120226687,1100.9654090432266
"147.32.84.165",20339,"184.173.217.40",443,9,552,6,372,3,180,53192.219816,1.308100000002014,2275.055423893753,1100.8332696260095
"147.32.84.165",20340,"184.173.217.40",443,9,552,6,372,3,180,53194.522983,1.307796999994025,2275.5825254329197,1101.0883187578645
"147.32.84.165",20341,"184.173.217.40",443,9,552,6,372,3,180,53196.826301,1.3089279999985592,2273.6162722497156,1100.1369059272818
"147.32.84.165",20342,"184.173.217.40",443,9,552,6,372,3,180,53199.130039,1.3080639999971027,2275.1180370429825,1100.8635663111206
"147.32.84.165",20343,"184.173.217.40",443,9,552,6,372,3,180,53201.433268,1.307833999999275,2275.5181467997086,1101.0571678063104
"147.32.84.165",20344,"184.173.217.40",443,9,552,6,372,3,180,53203.736207,1.307992000001832,2275.2432736559795,1100.9241646722483
"147.32.84.165",20345,"184.173.217.40",443,9,552,6,372,3,180,53206.039688,1.3079880000004778,2275.25023165267,1100.9275314448405
"147.32.84.165",20346,"184.173.217.40",443,9,552,6,372,3,180,53208.343416,1.3074189999970258,2276.2404401395193,1101.4066645836383
"147.32.84.165",20347,"184.173.217.40",443,9,552,6,372,3,180,53210.646414,1.3076569999975618,2275.8261531927324,1101.2062031577739
"147.32.84.165",20348,"184.173.217.40",443,9,552,6,372,3,180,53212.950082,1.3078069999974105,2275.5651254396807,1101.0798994062973
"147.32.84.165",20349,"184.173.217.40",443,9,552,6,372,3,180,53215.253322,1.307291000004625,2276.463312291962,1101.5145059477236
"147.32.84.165",20350,"184.173.217.40",443,9,552,6,372,3,180,53217.556883,1.3078779999996186,2275.4415931767853,1101.0201257307026
"147.32.84.165",20351,"184.173.217.40",443,9,552,6,372,3,180,53219.859528,1.3081349999993108,2274.99455331565,1100.8038161204759
"147.32.84.165",20352,"184.173.217.40",443,9,552,6,372,3,180,53222.163235,1.3077090000006137,2275.73565678496,1101.1624145733676
"147.32.84.165",20353,"184.173.217.40",443,9,552,6,372,3,180,53224.466643,1.3073539999968489,2276.353611957567,1101.4614251407581
"147.32.84.165",20354,"184.173.217.40",443,9,552,6,372,3,180,53226.770061,1.3071209999980056,2276.7593818816626,1101.657765426611
"147.32.84.165",20355,"184.173.217.40",443,9,552,6,372,3,180,53229.073051,1.307503000003635,2276.0942039840265,1101.3359051535613
"147.32.84.165",20356,"184.173.217.40",443,9,552,6,372,3,180,53231.376267,1.3079859999998007,2275.2537106669747,1100.9292148388588
"147.32.84.165",20357,"184.173.217.40",443,9,552,6,372,3,180,53233.679952,1.3074570000026142,2276.1742833562016,1101.3746532368718
"147.32.84.165",20358,"184.173.217.40",443,9,552,6,372,3,180,53235.982757,1.307595999998739,2275.9323216061152,1101.257574970701
"147.32.84.165",20359,"184.173.217.40",443,9,552,6,372,3,180,53238.286505,1.3078540000060457,2275.483349048321,1101.0403301846716
"147.32.84.165",20360,"184.173.217.40",443,9,552,6,372,3,180,53240.589309,1.30775399999402,2275.657348410793,1101.1245234245773
"147.32.84.165",20361,"184.173.217.40",443,9,552,6,372,3,180,53242.892559,1.3080899999986286,2275.072816093021,1100.8416852063006
"147.32.84.165",20362,"184.173.217.40",443,9,552,6,372,3,180,53245.196531,1.307581000000937,2275.958430107097,1101.270208116337
"147.32.84.165",20363,"184.173.217.40",443,9,552,6,372,3,180,53247.499325,1.3080270000064047,2275.1823930128567,1100.8947062965437
"147.32.84.165",20364,"184.173.217.40",443,9,552,6,372,3,180,53249.803115,1.3071519999939483,2276.7053869892543,1101.6316388657683
"147.32.84.165",20365,"184.173.217.40",443,9,552,6,372,3,180,53252.106435,1.3073959999965155,2276.2804842663827,1101.4260407740562
"147.32.84.165",20366,"184.173.217.40",443,9,552,6,372,3,180,53254.40916,1.3077489999996033,2275.666049066681,1101.1287334193617
"147.32.84.165",20367,"184.173.217.40",443,9,552,6,372,3,180,53256.713002,1.307864000002155,2275.465950584385,1101.0319115730895
"147.32.84.165",20368,"184.173.217.40",443,9,552,6,372,3,180,53259.01632,1.3075619999945047,2275.9915017509743,1101.286210524665
"147.32.84.165",20369,"184.173.217.40",443,9,552,6,372,3,180,53261.319307,1.3074980000019423,2276.1029079934187,1101.3401167710092
"147.32.84.165",20370,"184.173.217.40",443,9,552,6,372,3,180,53263.622609,1.308045999998285,2275.1493449036975,1100.8787152759826
"147.32.84.165",20371,"184.173.217.40",443,9,552,6,372,3,180,53265.92617,1.3076020000007702,2275.9218783683773,1101.2525217911505
"147.32.84.165",20372,"184.173.217.40",443,9,552,6,372,3,180,53268.22968,1.3071550000022398,2276.7001617978744,1101.6291105473586
"147.32.84.165",20373,"184.173.217.40",443,9,552,6,372,3,180,53270.532874,1.3075240000034682,2276.0576478841735,1101.3182167181485
"147.32.84.165",20374,"184.173.217.40",443,9,552,6,372,3,180,53272.836352,1.30751600000076,2276.071573883815,1101.3249551050717
"147.32.84.165",20375,"184.173.217.40",443,9,552,6,372,3,180,53275.139303,1.3078719999975874,2275.4520320073293,1101.02517677774
"147.32.84.165",20376,"184.173.217.40",443,9,552,6,372,3,180,53277.442612,1.3081490000040503,2274.9702059863102,1100.792035154666
"147.32.84.165",20377,"184.173.217.40",443,9,552,6,372,3,180,53279.745557,1.3081180000008317,2275.024118617822,1100.8181219118494
"147.32.84.165",20378,"184.173.217.40",443,9,552,6,372,3,180,53282.049535,1.308152000005066,2274.9649887692526,1100.7895106947997
"147.32.84.165",20379,"184.173.217.40",443,9,552,6,372,3,180,53284.352193,1.3081420000016806,2274.9823795858374,1100.7979256060505
"147.32.84.165",20380,"184.173.217.40",443,9,552,6,372,3,180,53286.655507,1.308047999998962,2275.14586620855,1100.8770320363951
"147.32.84.165",20381,"184.173.217.40",443,9,552,6,372,3,180,53288.958967,1.307593999998062,2275.9358027066587,1101.2592593741897
"147.32.84.165",20382,"184.173.217.40",443,9,552,6,372,3,180,53291.26215,1.3082289999947534,2274.831088450061,1100.7247202177716
"147.32.84.165",20383,"184.173.217.40",443,9,552,6,372,3,180,53293.566019,1.3076140000048326,2275.900992180415,1101.2424155711685
"147.32.84.165",20384,"184.173.217.40",443,9,552,6,372,3,180,53295.868671,1.3082280000016908,2274.832827302392,1100.7255615979316
"147.32.84.165",20385,"184.173.217.40",443,9,552,6,372,3,180,53298.171981,1.3077140000023064,2275.726955584135,1101.158204314904
"147.32.84.165",20386,"184.173.217.40",443,9,552,6,372,3,180,53300.475762,1.3075079999980517,2276.0855000538695,1101.3316935744529
"147.32.84.165",20387,"184.173.217.40",443,9,552,6,372,3,180,53302.779102,1.3073829999993904,2276.303118521036,1101.4369928327594
"147.32.84.165",20388,"184.173.217.40",443,9,552,6,372,3,180,53305.082398,1.3073369999983697,2276.3832125945423,1101.4757480296173
"147.32.84.165",20389,"184.173.217.40",443,9,552,6,372,3,180,53307.385509,1.307477000002109,2276.1394655471568,1101.3578059099145
"147.32.84.165",20390,"184.173.217.40",443,9,552,6,372,3,180,53309.688921,1.3073490000024321,2276.362317938411,1101.4656377121344
"147.32.84.165",20391,"184.173.217.40",443,9,552,6,372,3,180,53311.992054,1.3078459999960614,2275.4972680338224,1101.047065177656
"147.32.84.165",20392,"184.173.217.40",443,9,552,6,372,3,180,53314.295839,1.3079130000041914,2275.38070192013,1100.9906622194178
"147.32.84.165",20393,"184.173.217.40",443,9,552,6,372,3,180,53316.599113,1.3070450000013807,2276.891767304765,1101.7218228894023
"147.32.84.165",20394,"184.173.217.40",443,9,552,6,372,3,180,53318.902145,1.3079040000011446,2275.3963593638337,1100.9982384018551
"147.32.84.165",20395,"184.173.217.40",443,9,552,6,372,3,180,53321.205227,1.3079540000035195,2275.3093763175098,1100.9561498310532
"147.32.84.165",20396,"173.192.170.88",80,17,1726,12,1166,5,560,53321.402145,601.188678999999,15.515927571217649,7.451903464735748
"147.32.84.165",20397,"184.173.217.40",443,9,552,6,372,3,180,53323.508596,1.3081170000004931,2275.025857777919,1100.8189634409287
"147.32.84.165",20398,"94.100.176.20",25,6,372,6,372,0,0,53325.772654,9.012171000002127,330.22009901934814,0
"147.32.84.165",20399,"184.173.217.40",443,9,552,6,372,3,180,53325.812337,1.307675999996718,2275.7930863665533,1101.1902030805904
"147.32.84.165",20400,"184.173.217.40",443,9,552,6,372,3,180,53328.115633,1.3072449999963283,2276.5434176519007,1101.5532666057584
"147.32.84.165",20401,"184.173.217.40",443,9,552,6,372,3,180,53330.418947,1.3078119999991031,2275.5564255428462,1101.0756897787967
"147.32.84.165",20402,"184.173.217.40",443,9,552,6,372,3,180,53332.721791,1.3078739999982645,2275.448552386506,1101.0234930902448
"147.32.84.165",20403,"184.173.217.40",443,9,552,6,372,3,180,53335.025399,1.3078480000040145,2275.4937882619884,1101.0453814170912
"147.32.84.165",20404,"184.173.217.40",443,9,552,6,372,3,180,53337.328911,1.3074320000014268,2276.2178071186513,1101.3957131219279
"147.32.84.165",20405,"184.173.217.40",443,9,552,6,372,3,180,53339.631659,1.3083330000008573,2274.650261055901,1100.637223091565
"147.32.84.165",20406,"184.173.217.40",443,9,552,6,372,3,180,53341.934977,1.3077530000009574,2275.6590885265196,1101.1253654160578
"147.32.84.165",20407,"184.173.217.40",443,9,552,6,372,3,180,53344.238843,1.3076530000034836,2275.8331147422687,1101.2095716494848
"147.32.84.165",20408,"184.173.217.40",443,9,552,6,372,3,180,53346.542232,1.3079149999975925,2275.377222530117,1100.988978643605
"147.32.84.165",20409,"74.125.93.27",25,6,372,6,372,0,0,53346.80233,9.012750000001688,330.19888491297803,0
"147.32.84.165",20410,"184.173.217.40",443,9,552,6,372,3,180,53348.845408,1.3078029999960563,2275.572085405045,1101.0832671314733
"147.32.84.165",20411,"184.173.217.40",443,9,552,6,372,3,180,53351.148777,1.3072939999983646,2276.458088237017,1101.5119781792018
"147.32.84.165",20412,"184.173.217.40",443,9,552,6,372,3,180,53353.451689,1.3080379999955767,2275.1632597906664,1100.8854482858064
"147.32.84.165",20413,"184.173.217.40",443,9,552,6,372,3,180,53355.755242,1.3076569999975618,2275.8261531927324,1101.2062031577739
"147.32.84.165",20414,"184.173.217.40",443,9,552,6,372,3,180,53358.058221,1.2078130000008969,2463.957582835911,1192.2375400818923
"147.32.84.165",20415,"184.173.217.40",443,9,552,6,372,3,180,53360.261862,1.307770999999775,2275.627766635376,1101.1102096622785
"147.32.84.165",20416,"184.173.217.40",443,9,552,6,372,3,180,53362.564632,1.3083580000020447,2274.6067972186124,1100.6161922025542
"147.32.84.165",20417,"184.173.217.40",443,9,552,6,372,3,180,53364.868206,1.3081460000030347,2274.975423227297,1100.7945596261115
"147.32.84.165",20418,"184.173.217.40",443,9,552,6,372,3,180,53367.171847,1.307308000003104,2276.433709571833,1101.500182050887
"147.32.84.165",20419,"74.125.39.27",25,6,372,6,372,0,0,53367.732504,9.0128509999995,330.19518463138525,0
"147.32.84.165",20420,"184.173.217.40",443,9,552,6,372,3,180,53369.475251,1.3076259999943431,2275.8801064011227,1101.2323095489303
"147.32.84.165",20421,"184.173.217.40",443,9,552,6,372,3,180,53371.777922,1.3079819999984466,2275.260668727501,1100.9325816423393
"147.32.84.165",20422,"184.173.217.40",443,9,552,6,372,3,180,53374.081713,1.3072660000034375,2276.506847108526,1101.5355711815448
"147.32.84.165",20423,"184.173.217.40",443,9,552,6,372,3,180,53376.38447,1.3078139999997802,2275.552945602739,1101.074005936809
"147.32.84.165",20424,"184.173.217.40",443,9,552,6,372,3,180,53378.688022,1.3076839999994263,2275.7791637745095,1101.1834663425045
"147.32.84.165",20425,"184.173.217.40",443,9,552,6,372,3,180,53380.991093,1.3085009999995236,2274.3582160052483,1100.4959109702816
"147.32.84.165",20426,"184.173.217.40",443,9,552,6,372,3,180,53383.294658,1.3077100000009523,2275.733916539472,1101.1615725190993
"147.32.84.165",20427,"184.173.217.40",443,9,552,6,372,3,180,53385.598255,1.3072880000036093,2276.468536383554,1101.5170337339778
"147.32.84.165",20428,"184.173.217.40",443,9,552,6,372,3,180,53387.901278,1.3081640000018524,2274.944120152967,1100.7794129772421
"147.32.84.165",20429,"66.111.4.73",25,6,372,6,372,0,0,53388.762724,9.01265599999897,330.2023288140966,0
"147.32.84.165",20430,"184.173.217.40",443,9,552,6,372,3,180,53390.204836,1.3075670000034734,2275.9827985809484,1101.2819993133621
"147.32.84.165",20431,"184.173.217.40",443,9,552,6,372,3,180,53392.507933,1.3078850000019884,2275.4294146622033,1101.014232901066
"147.32.84.165",20432,"184.173.217.40",443,9,552,6,372,3,180,53394.811667,1.307426999999734,2276.2265120734123,1101.3999251968123
"147.32.84.165",20433,"184.173.217.40",443,9,552,6,372,3,180,53397.114513,1.3080269999991287,2275.1823930255127,1100.8947063026674
"147.32.84.165",20434,"184.173.217.40",443,9,552,6,372,3,180,53399.417934,1.3073070000027656,2276.4354508877445,1101.501024623102
"147.32.84.165",20435,"184.173.217.40",443,9,552,6,372,3,180,53401.721576,1.3072699999975157,2276.499881436624,1101.5322006951408
"147.32.84.165",20436,"184.173.217.40",443,9,552,6,372,3,180,53404.024616,1.3079099999958999,2275.3859210567466,1100.9931876081032
"147.32.84.165",20437,"184.173.217.40",443,9,552,6,372,3,180,53406.327803,1.3081289999972796,2275.0049880449014,1100.808865183017
"147.32.84.165",20438,"184.173.217.40",443,9,552,6,372,3,180,53408.631237,1.3078850000019884,2275.4294146622033,1101.014232901066
"147.32.84.165",20439,"216.157.130.15",25,6,372,6,372,0,0,53409.793324,9.012521000004199,330.20727496763817,0
"147.32.84.165",20440,"184.173.217.40",443,9,552,6,372,3,180,53410.934305,1.3077059999995981,2275.7408775373933,1101.1649407439
"147.32.84.165",20441,"184.173.217.40",443,9,552,6,372,3,180,53413.238063,1.3077380000031553,2275.6851907590203,1101.1379955285581
"147.32.84.165",20442,"184.173.217.40",443,9,552,6,372,3,180,53415.541365,1.307626000001619,2275.880106388459,1101.2323095428028
"147.32.84.165",20443,"184.173.217.40",443,9,552,6,372,3,180,53417.844465,1.307624000000942,2275.883587329275,1101.233993869004
"147.32.84.165",20444,"184.173.217.40",443,9,552,6,372,3,180,53420.147734,1.3074980000019423,2276.1029079934187,1101.3401167710092
"147.32.84.165",20445,"184.173.217.40",443,9,552,6,372,3,180,53422.451094,1.3078830000013113,2275.4328942244956,1101.01591656024
"147.32.84.165",20446,"184.173.217.40",443,9,552,6,372,3,180,53424.754233,1.3081319999982952,2274.9997706683107,1100.8063406459567
"147.32.84.165",20447,"184.173.217.40",443,9,552,6,372,3,180,53427.057481,1.2078239999973448,2463.935142873914,1192.2266820357647
"147.32.84.165",20448,"184.173.217.40",443,9,552,6,372,3,180,53429.261019,1.3077790000024834,2275.613846066001,1101.1034739029037
"147.32.84.165",20449,"184.173.217.40",443,9,552,6,372,3,180,53431.564175,1.3080039999986184,2275.222399933902,1100.9140644841461
"147.32.84.165",20450,"184.173.217.40",443,9,552,6,372,3,180,53433.867789,1.3078069999974105,2275.5651254396807,1101.0798994062973
"147.32.84.165",20451,"184.173.217.40",443,9,552,6,372,3,180,53436.170815,1.3077249999987544,2275.707813189191,1101.1489418657375
"147.32.84.165",20452,"184.173.217.40",443,9,552,6,372,3,180,53438.474046,1.3077999999950407,2275.577305407008,1101.0857929388749
"147.32.84.165",20453,"184.173.217.40",443,9,552,6,372,3,180,53440.77704,1.3080800000025192,2275.090208545554,1100.8501009091392
"147.32.84.165",20454,"184.173.217.40",443,9,552,6,372,3,180,53443.080904,1.3073850000000675,2276.299636296765,1101.4353078855315
"147.32.84.165",20455,"184.173.217.40",443,9,552,6,372,3,180,53445.383862,1.3078549999991083,2275.481609201348,1101.039488323233
"147.32.84.165",20456,"184.173.217.40",443,9,552,6,372,3,180,53447.687563,1.3075790000002598,2275.961911287508,1101.2718925584718
"147.32.84.165",20457,"184.173.217.40",443,9,552,6,372,3,180,53449.991007,1.3076020000007702,2275.9218783683773,1101.2525217911505
"147.32.84.165",20458,"184.173.217.40",443,9,552,6,372,3,180,53452.294101,1.3080659999977797,2275.1145584435735,1100.861883117858
"147.32.84.165",20459,"184.173.217.40",443,9,552,6,372,3,180,53454.597266,1.3081400000010035,2274.985857781061,1100.7996086037392
"147.32.84.165",20460,"184.173.217.40",443,9,552,6,372,3,180,53456.900682,1.3074580000029528,2276.172542439818,1101.3738108579762
"147.32.84.165",20461,"184.173.217.40",443,9,552,6,372,3,180,53459.204263,1.3077330000014626,2275.693891640474,1101.1422056324873
"147.32.84.165",20462,"184.173.217.40",443,9,552,6,372,3,180,53461.506992,1.3076969999965513,2275.756539938417,1101.1725193250406
"147.32.84.165",20463,"184.173.217.40",443,9,552,6,372,3,180,53463.810262,1.30839399999968,2274.544212217977,1100.5859091377308
"147.32.84.165",20464,"184.173.217.40",443,9,552,6,372,3,180,53466.114095,1.3070389999993495,2276.9022194452355,1101.726880376727
"147.32.84.165",20465,"184.173.217.40",443,9,552,6,372,3,180,53468.417458,1.3071789999958128,2276.658361256976,1101.608884479182
"147.32.84.165",20466,"184.173.217.40",443,9,552,6,372,3,180,53470.720643,1.3075170000010985,2276.0698331245403,1101.324112802197
"147.32.84.165",20467,"184.173.217.40",443,9,552,6,372,3,180,53473.02368,1.3080079999999725,2275.2154421074356,1100.9106977939205
"147.32.84.165",20468,"184.173.217.40",443,9,552,6,372,3,180,53475.327181,1.3078889999960666,2275.4224555822016,1101.0108656042912
"147.32.84.165",20469,"184.173.217.40",443,9,552,6,372,3,180,53477.630644,1.3079710000019986,2275.2798036007316,1100.941840451967
"147.32.84.165",20470,"184.173.217.40",443,9,552,6,372,3,180,53479.933557,1.3077910000065458,2275.5929655312693,1101.0933704183562
"147.32.84.165",20471,"184.173.217.40",443,9,552,6,372,3,180,53482.237025,1.307526999997208,2276.0524256909075,1101.315689850439
"147.32.84.165",20472,"184.173.217.40",443,9,552,6,372,3,180,53484.540514,1.3077699999994365,2275.6295067185224,1101.1110516379947
"147.32.84.165",20473,"184.173.217.40",443,9,552,6,372,3,180,53486.844079,1.307093999996141,2276.8064117873587,1101.680521832593
"147.32.84.165",20474,"184.173.217.40",443,9,552,6,372,3,180,53489.147186,1.3074960000012652,2276.1063896158153,1101.3418014270076
"147.32.84.165",20475,"184.173.217.40",443,9,552,6,372,3,180,53491.450054,1.3081049999964307,2275.046727906491,1100.8290618902377
"147.32.84.165",20476,"184.173.217.40",443,9,552,6,372,3,180,53493.75366,1.3077869999979157,2275.5999256795967,1101.096738232063
"147.32.84.165",20477,"184.173.217.40",443,9,552,6,372,3,180,53496.057156,1.3074409999971977,2276.20213838053,1101.3881314744501
"147.32.84.165",20478,"184.173.217.40",443,9,552,6,372,3,180,53498.360345,1.307345000001078,2276.369282781168,1101.4690077973394
"147.32.84.165",20479,"184.173.217.40",443,9,552,6,372,3,180,53500.663446,1.3077879999982542,2275.598185641689,1101.0958962782365
"147.32.84.165",20480,"184.173.217.40",443,9,552,6,372,3,180,53502.966463,1.3084110000054352,2274.514659375103,1100.5716093750498
"147.32.84.165",20481,"184.173.217.40",443,9,552,6,372,3,180,53505.270229,1.3080169999957434,2275.199787166134,1100.9031228223228
"147.32.84.165",20482,"184.173.217.40",443,9,552,6,372,3,180,53507.573652,1.3077940000002855,2275.5877454701204,1101.0908445823163
"147.32.84.165",20483,"184.173.217.40",443,9,552,6,372,3,180,53509.876747,1.3080689999987953,2275.109340564405,1100.8593583376153
"147.32.84.165",20484,"184.173.217.40",443,9,552,6,372,3,180,53512.180121,1.3073680000015884,2276.3292355299996,1101.449630095161
"147.32.84.165",20485,"184.173.217.40",443,9,552,6,372,3,180,53514.483574,1.307847000003676,2275.4955281402454,1101.046223293667
"147.32.84.165",20486,"184.173.217.40",443,9,552,6,372,3,180,53516.786974,1.3078559999994468,2275.4798693443763,1101.0386464569563
"147.32.84.165",20487,"184.173.217.40",443,9,552,6,372,3,180,53519.089953,1.308257999997295,2274.7806625345715,1100.7003205812443
"147.32.84.165",20488,"184.173.217.40",443,9,552,6,372,3,180,53521.393131,1.3078320000058739,2275.5216266207235,1101.0588515906727
"147.32.84.165",20489,"184.173.217.40",443,9,552,6,372,3,180,53523.696822,1.3073640000002342,2276.336200170317,1101.4530000824116
"147.32.84.165",20490,"184.173.217.40",443,9,552,6,372,3,180,53525.99966,1.307862000001478,2275.4694302584194,1101.033595286332
"147.32.84.165",20491,"184.173.217.40",443,9,552,6,372,3,180,53528.303659,1.3070950000037556,2276.8046698912085,1101.6796789796172
"147.32.84.165",20492,"184.173.217.40",443,9,552,6,372,3,180,53530.606859,1.307805999997072,2275.5668654270303,1101.08074133566
"147.32.84.165",20493,"184.173.217.40",443,9,552,6,372,3,180,53532.9103,1.30735999999888,2276.3431648532533,1101.4563700902838
"147.32.84.165",20494,"184.173.217.40",443,9,552,6,372,3,180,53535.213088,1.3076170000058482,2275.8957706933224,1101.239889045156
"147.32.84.165",20495,"184.173.217.40",443,9,552,6,372,3,180,53537.516266,1.3080210000043735,2275.192829465314,1100.8997561928938
"147.32.84.165",20496,"184.173.217.40",443,9,552,6,372,3,180,53539.819862,1.3074960000012652,2276.1063896158153,1101.3418014270076
"147.32.84.165",20497,"184.173.217.40",443,9,552,6,372,3,180,53542.122929,1.3079100000031758,2275.3859210440887,1100.9931876019782
"147.32.84.165",20498,"184.173.217.40",443,9,552,6,372,3,180,53544.426622,1.3078000000023167,2275.577305394348,1101.085792932749
"147.32.84.165",20499,"184.173.217.40",443,9,552,6,372,3,180,53546.729821,1.3072840000022552,2276.475501876307,1101.520404133697
"147.32.84.165",20500,"184.173.217.40",443,9,552,6,372,3,180,53549.033009,1.3075410000019474,2276.0280557134097,1101.3038979258436
"147.32.84.165",20501,"94.100.176.20",25,6,372,6,372,0,0,53550.927751,8.9808819999962,331.37057139836145,0
"147.32.84.165",20502,"184.173.217.40",443,9,552,6,372,3,180,53551.3364,1.3079240000006394,2275.3615653497795,1100.981402588603
"147.32.84.165",20503,"184.173.217.40",443,9,552,6,372,3,180,53553.639553,1.3078349999996135,2275.516406886862,1101.0563259129979
"147.32.84.165",20504,"184.173.217.40",443,9,552,6,372,3,180,53555.943097,1.307608999995864,2275.9096947248095,1101.2466264797465
"147.32.84.165",20505,"184.173.217.40",443,9,552,6,372,3,180,53558.246159,1.3078429999950458,2275.502487692539,1101.0495908189705
"147.32.84.165",20506,"184.173.217.40",443,9,552,6,372,3,180,53560.549857,1.3078240000031656,2275.535546061853,1101.0655868041224
"147.32.84.165",20507,"184.173.217.40",443,9,552,6,372,3,180,53562.852889,1.307357999998203,2276.3466472107034,1101.4580551019533
"147.32.84.165",20508,"184.173.217.40",443,9,552,6,372,3,180,53565.155846,1.3086330000005546,2274.1288046371587,1100.384905469593
"147.32.84.165",20509,"184.173.217.40",443,9,552,6,372,3,180,53567.459604,1.308140999994066,2274.9841186947733,1100.7987671103742
"147.32.84.165",20510,"184.173.217.40",443,9,552,6,372,3,180,53569.762796,1.3077209999974002,2275.7147740274236,1101.1523100132695
"147.32.84.165",20511,"74.125.93.27",25,6,372,6,372,0,0,53571.825973,9.012920000001031,330.1926567638079,0
"147.32.84.165",20512,"184.173.217.40",443,9,552,6,372,3,180,53572.066349,1.3075529999987339,2276.0071675892923,1101.2937907690123
"147.32.84.165",20513,"184.173.217.40",443,9,552,6,372,3,180,53574.369193,1.3079080000024987,2275.3894004733625,1100.9948711967882
"147.32.84.165",20514,"184.173.217.40",443,9,552,6,372,3,180,53576.672528,1.3083059999989928,2274.697203866902,1100.6599373549525
"147.32.84.165",20515,"184.173.217.40",443,9,552,6,372,3,180,53578.976506,1.3077350000021397,2275.690411279908,1101.1405215870523
"147.32.84.165",20516,"184.173.217.40",443,9,552,6,372,3,180,53581.279599,1.3076529999962077,2275.8331147549316,1101.209571655612
"147.32.84.165",20517,"184.173.217.40",443,9,552,6,372,3,180,53583.582768,1.3076099999962025,2275.907954213139,1101.24578429668
"147.32.84.165",20518,"184.173.217.40",443,9,552,6,372,3,180,53585.885958,1.3078150000001187,2275.551205636676,1101.0731640177466
"147.32.84.165",20519,"184.173.217.40",443,9,552,6,372,3,180,53588.189512,1.3073380000059842,2276.3814713458783,1101.474905489941
"147.32.84.165",20520,"184.173.217.40",443,9,552,6,372,3,180,53590.492449,1.3079930000021704,2275.2415341634564,1100.9233229823176
"147.32.84.165",20521,"184.173.217.40",443,9,552,6,372,3,180,53592.796383,1.307215000000724,2276.595663298196,1101.5785467571916
"147.32.84.165",20522,"74.125.39.27",25,6,372,6,372,0,0,53592.856169,9.013103999997838,330.18591597308915,0
"147.32.84.165",20523,"184.173.217.40",443,9,552,6,372,3,180,53595.099642,1.3071940000008908,2276.6322366825216,1101.5962435560589
"147.32.84.165",20524,"184.173.217.40",443,9,552,6,372,3,180,53597.402962,1.307742999997572,2275.6764899567615,1101.1337854629492
"147.32.84.165",20525,"184.173.217.40",443,9,552,6,372,3,180,53599.706033,1.3074849999975413,2276.12553872939,1101.3510671271242
"147.32.84.165",20526,"184.173.217.40",443,9,552,6,372,3,180,53602.009174,1.3076230000006035,2275.8853278036763,1101.2348360340368
"147.32.84.165",20527,"184.173.217.40",443,9,552,6,372,3,180,53604.312438,1.3074689999994007,2276.1533925480176,1101.364544781299
"147.32.84.165",20528,"184.173.217.40",443,9,552,6,372,3,180,53606.615454,1.307780000002822,2275.6121060068044,1101.1026319387763
"147.32.84.165",20529,"184.173.217.40",443,9,552,6,372,3,180,53608.919028,1.3074960000012652,2276.1063896158153,1101.3418014270076
"147.32.84.165",20530,"184.173.217.40",443,9,552,6,372,3,180,53611.222686,1.3077570000023115,2275.652128028938,1101.1219974333571
"147.32.84.165",20531,"184.173.217.40",443,9,552,6,372,3,180,53613.526113,1.3071679999993648,2276.67751964663,1101.6181546677242
"147.32.84.165",20532,"66.111.4.73",25,6,372,6,372,0,0,53613.88596,9.01281100000051,330.19665007951807,0
"147.32.84.165",20533,"184.173.217.40",443,9,552,6,372,3,180,53615.829127,1.3075100000060047,2276.0820184827135,1101.3300089432485
"147.32.84.165",20534,"184.173.217.40",443,9,552,6,372,3,180,53618.13228,1.3081969999984722,2274.886733422776,1100.751645204569
"147.32.84.165",20535,"184.173.217.40",443,9,552,6,372,3,180,53620.435759,1.3076979999968898,2275.7547996609906,1101.171677255318
"147.32.84.165",20536,"173.192.170.88",80,30,4257,20,1646,10,2611,53621.42409,41.539606999998796,316.9986658756878,502.8453928319689
"147.32.84.165",20537,"184.173.217.40",443,9,552,6,372,3,180,53622.738689,1.3082639999993262,2274.7702298630343,1100.6952725143715
"147.32.84.165",20538,"184.173.217.40",443,9,552,6,372,3,180,53625.04224,1.3079069999948842,2275.391140204648,1100.995713002249
"147.32.84.165",20539,"184.173.217.40",443,9,552,6,372,3,180,53627.34544,1.307650000002468,2275.8383359418676,1101.2120980363875
"147.32.84.165",20540,"184.173.217.40",443,9,552,6,372,3,180,53629.64867,1.308312000001024,2274.686771960871,1100.654889658486
"147.32.84.165",20542,"184.173.217.40",443,9,552,6,372,3,180,53631.95251,1.3078829999940353,2275.4328942371544,1101.015916566365
"147.32.84.165",20543,"184.173.217.40",443,9,552,6,372,3,180,53634.255915,1.307770999999775,2275.627766635376,1101.1102096622785
"147.32.84.165",20544,"216.157.130.15",25,6,372,6,372,0,0,53634.916415,8.922518999999738,333.53809613631387,0
"147.32.84.165",20545,"184.173.217.40",443,9,552,6,372,3,180,53636.558977,1.3076129999972181,2275.902732694101,1101.2432577552102
"147.32.84.165",20546,"184.173.217.40",443,9,552,6,372,3,180,53638.862418,1.3073950000034529,2276.28222533522,1101.4268832267194
"147.32.84.165",20548,"98.126.71.122",80,18,4863,14,1430,4,3433,53640.697341,16.931729000003543,675.6545654609524,1622.0434428163983
"147.32.84.165",20549,"184.173.217.40",443,9,552,6,372,3,180,53641.165529,1.318635000003269,2256.8792728788653,1092.0383578446122
"147.32.84.165",20550,"195.113.232.98",80,21,7913,14,3864,7,4049,53641.283771,61.411269999996875,503.3603766865849,527.46018768219
"147.32.84.165",20551,"195.113.232.89",80,13,2796,10,1774,3,1022,53641.533029,61.161808000004385,232.04023007297272,133.67819342422666
"147.32.84.165",20552,"195.113.232.83",80,13,2066,10,1694,3,372,53641.951126,60.743514000001596,223.10200888278612,48.992885067530366
"147.32.84.165",20553,"77.238.175.247",80,14,2274,10,1276,4,998,53641.98979,0.14278799999738112,71490.60145241354,55915.06289146451
"147.32.84.165",20554,"74.125.232.217",80,13,1871,10,1156,3,715,53642.000594,60.693849000002956,152.37128889287527,94.24348750727148
"147.32.84.165",20555,"68.67.185.207",80,16,2170,12,1370,4,800,53642.027477,10.594272999995155,1034.521198387564,604.0999698613512
"147.32.84.165",20556,"64.236.79.229",80,14,2366,10,1652,4,714,53642.039617,0.3559479999967152,37129.01884579197,16047.287806232123
"147.32.84.165",20557,"64.236.79.229",80,14,2170,10,1470,4,700,53642.046132,0.35559899999498157,33070.959142646534,15748.075782212634
"147.32.84.165",20558,"64.236.79.229",80,14,2153,10,1496,4,657,53642.115834,0.35720900000160327,33504.195022931344,14714.074953252604
"147.32.84.165",20559,"77.238.167.32",80,13,2342,10,1390,3,952,53642.151031,0.13999299999704817,79432.54305739909,54402.72013715391
"147.32.84.165",20560,"64.236.79.229",80,14,2135,10,1478,4,657,53642.185187,0.3551889999944251,33289.319208043,14797.755561356056
"147.32.84.165",20561,"77.238.175.247",80,14,3055,10,1368,4,1687,53642.245586,0.13981800000328803,78273.18370841119,96525.48312579654
"147.32.84.165",20562,"195.113.232.96",80,13,1965,10,1306,3,659,53642.281189,60.41305199999624,172.94276077958534,87.265910684339
"147.32.84.165",20563,"74.217.252.37",80,12,2075,10,1278,2,797,53642.295439,60.39857800000027,169.2755084399496,105.56539923837232
"147.32.84.165",20564,"64.236.79.229",80,14,2181,10,1524,4,657,53642.377201,0.35538899999664864,34306.070250106146,14789.427922781979
"147.32.84.165",20565,"184.173.217.40",443,9,552,6,372,3,180,53643.478413,1.308340000003227,2274.6380910104863,1100.6313343599127
"147.32.84.165",20566,"184.173.217.40",443,9,552,6,372,3,180,53645.782363,1.3071280000003753,2276.7471892570165,1101.6518657695242
"147.32.84.165",20567,"184.173.217.40",443,9,552,6,372,3,180,53648.085324,1.3073490000024321,2276.362317938411,1101.4656377121344
"147.32.84.165",20568,"184.173.217.40",443,9,552,6,372,3,180,53650.388361,1.3082660000000033,2274.7667523271207,1100.6935898357035
"147.32.84.165",20569,"184.173.217.40",443,9,552,6,372,3,180,53652.692047,1.3076410000066971,2275.8539996717436,1101.219677260521
"147.32.84.165",20570,"184.173.217.40",443,9,552,6,372,3,180,53654.995203,1.3078779999996186,2275.4415931767853,1101.0201257307026
"147.32.84.165",20571,"184.173.217.40",443,9,552,6,372,3,180,53657.298555,1.3080419999969308,2275.156302325906,1100.8820817705998
"147.32.84.165",20572,"184.173.217.40",443,9,552,6,372,3,180,53659.601685,1.3084650000018883,2274.42079077064,1100.5261890825677
"147.32.84.165",20573,"184.173.217.40",443,9,552,6,372,3,180,53661.905085,1.3076599999985774,2275.8209320490323,1101.203676797919
"147.32.84.165",20574,"173.192.170.88",80,6,372,6,372,0,0,53662.763182,8.916287000000011,333.77122113722857,0
"147.32.84.165",20575,"184.173.217.40",443,9,552,6,372,3,180,53664.20872,1.3073739999963436,2276.318788662099,1101.4445751590802
"147.32.84.165",20576,"184.173.217.40",443,9,552,6,372,3,180,53666.51211,1.3074409999971977,2276.20213838053,1101.3881314744501
"147.32.84.165",20577,"184.173.217.40",443,9,552,6,372,3,180,53668.815405,1.307489999999234,2276.116834546913,1101.3468554259257
"147.32.84.165",20578,"184.173.217.40",443,9,552,6,372,3,180,53671.118326,1.3074999999953434,2276.0994263943394,1101.3384321262934
"147.32.84.165",20579,"184.173.217.40",443,9,552,6,372,3,180,53673.421735,1.3078659999955562,2275.462470933652,1101.030227871122
"147.32.84.165",20580,"184.173.217.40",443,9,552,6,372,3,180,53675.725342,1.3075969999990775,2275.9305810598366,1101.256732770889
"147.32.84.165",20581,"184.173.217.40",443,9,552,6,372,3,180,53678.028751,1.307278000000224,2276.48595019536,1101.5254597719486
"147.32.84.165",20582,"184.173.217.40",443,9,552,6,372,3,180,53680.331833,1.30754600000364,2276.01935227649,1101.2996865853984
"147.32.84.165",20583,"184.173.217.40",443,9,552,6,372,3,180,53682.634919,1.3079780000043684,2275.267626817929,1100.935948460288
"147.32.84.165",20584,"173.192.170.88",80,27,4311,20,1936,7,2375,53684.777761,22.193328000001202,697.8673951017694,856.1131525654454
"147.32.84.165",20585,"184.173.217.40",443,9,552,6,372,3,180,53684.938035,1.3080990000016754,2275.0571631017133,1100.8341111782483
"147.32.84.165",20586,"184.173.217.40",443,9,552,6,372,3,180,53687.241652,1.307732000001124,2275.6956318247485,1101.1430476571363
"147.32.84.165",20587,"184.173.217.40",443,9,552,6,372,3,180,53689.545227,1.3077779999948689,2275.6155861405196,1101.1043158744449
"147.32.84.165",20588,"184.173.217.40",443,9,552,6,372,3,180,53691.848522,1.3072479999973439,2276.538193216625,1101.5507386532058
"147.32.84.165",20589,"184.173.217.40",443,9,552,6,372,3,180,53694.151342,1.3078569999997853,2275.4781294900654,1101.0378045919672
"147.32.84.165",20590,"184.173.217.40",443,9,552,6,372,3,180,53696.455032,1.3076250000012806,2275.881846857536,1101.2331517052594
"147.32.84.165",20591,"184.173.217.40",443,9,552,6,372,3,180,53698.758058,1.2080379999970319,2463.4986647831543,1192.0154829595908
"147.32.84.165",20592,"184.173.217.40",443,9,552,6,372,3,180,53700.96143,1.3075239999961923,2276.057647896839,1101.318216724277
"147.32.84.165",20593,"184.173.217.40",443,9,552,6,372,3,180,53703.264928,1.3075040000039735,2276.092463190136,1101.335062833937
"147.32.84.165",20594,"184.173.217.40",443,9,552,6,372,3,180,53705.568278,1.307996000003186,2275.2363157018453,1100.9207979202479
"147.32.84.165",20595,"184.173.217.40",443,9,552,6,372,3,180,53707.871051,1.3083259999984875,2274.6624312315435,1100.6431118862308
"147.32.84.165",20596,"184.173.217.40",443,9,552,6,372,3,180,53710.174556,1.3078050000040093,2275.568605404381,1101.0815832601843
"147.32.84.165",20597,"184.173.217.40",443,9,552,6,372,3,180,53712.478227,1.3074280000000726,2276.2247710771335,1101.3990827792582
"147.32.84.165",20598,"184.173.217.40",443,9,552,6,372,3,180,53714.781122,1.3082020000001648,2274.8780387123893,1100.74743808664
"147.32.84.165",20599,"184.173.217.40",443,9,552,6,372,3,180,53717.084145,1.3080469999986235,2275.147605554794,1100.8778736555455
"147.32.84.165",20600,"184.173.217.40",443,9,552,6,372,3,180,53719.38818,1.306958000001032,2277.0433326837206,1101.795160975994
"147.32.84.165",20601,"184.173.217.40",443,9,552,6,372,3,180,53721.691125,1.3074310000010883,2276.219548104277,1101.3965555343275
"147.32.84.165",20602,"184.173.217.40",443,9,552,6,372,3,180,53723.994827,1.307619999999588,2275.8905492428516,1101.2373625368639
"147.32.84.165",20603,"184.173.217.40",443,9,552,6,372,3,180,53726.297546,1.307809999998426,2275.5599054935974,1101.0773736259341
"147.32.84.165",20604,"184.173.217.40",443,9,552,6,372,3,180,53728.600898,1.3080800000025192,2275.090208545554,1100.8501009091392
"147.32.84.165",20605,"184.173.217.40",443,9,552,6,372,3,180,53730.904472,1.3073789999980363,2276.3100830015396,1101.4403627426805
"147.32.84.165",20606,"184.173.217.40",443,9,552,6,372,3,180,53733.207701,1.307701999998244,2275.7478385778995,1101.168308989306
"147.32.84.165",20607,"184.173.217.40",443,9,552,6,372,3,180,53735.511403,1.307559000000765,2275.996723664675,1101.2887372571008
"147.32.84.165",20608,"184.173.217.40",443,9,552,6,372,3,180,53737.814093,1.3079300000026706,2275.3511273492645,1100.9763519431924
"147.32.84.165",20609,"184.173.217.40",443,9,552,6,372,3,180,53740.117657,1.3076209999999264,2275.8888087604646,1101.2365203679667
"147.32.84.165",20610,"184.173.217.40",443,9,552,6,372,3,180,53742.420834,1.3076800000053481,2275.7861250365754,1101.186834695117
"147.32.84.165",20611,"184.173.217.40",443,9,552,6,372,3,180,53744.724227,1.3081490000040503,2274.9702059863102,1100.792035154666
"147.32.84.165",20612,"184.173.217.40",443,9,552,6,372,3,180,53747.027149,1.3078929999974207,2275.4154965321086,1101.007498321988
"147.32.84.165",20613,"184.173.217.40",443,9,552,6,372,3,180,53749.330665,1.3078810000006342,2275.4363737974304,1101.017600224563
"147.32.84.165",20614,"184.173.217.40",443,9,552,6,372,3,180,53751.634153,1.307410000001255,2276.2561094049634,1101.4142464862728
"147.32.84.165",20615,"184.173.217.40",443,9,552,6,372,3,180,53753.937318,1.3078670000031707,2275.460731093288,1101.0293860128813
"147.32.84.165",20616,"184.173.217.40",443,9,552,6,372,3,180,53756.240656,1.3078160000004573,2275.549465673275,1101.0723220999716
"147.32.84.165",20617,"184.173.217.40",443,9,552,6,372,3,180,53758.544094,1.3078450000029989,2275.499007904741,1101.0479070506813
"147.32.84.165",20618,"184.173.217.40",443,9,552,6,372,3,180,53760.847575,1.3076809999984107,2275.784384726563,1101.1859926096274
"147.32.84.165",20619,"184.173.217.40",443,9,552,6,372,3,180,53763.151101,1.3073719999956666,2276.322270944968,1101.4462601346618
"147.32.84.165",20620,"184.173.217.40",443,9,552,6,372,3,180,53765.454038,1.307699999997567,2275.751319114122,1101.1699931197363
"147.32.84.165",20621,"184.173.217.40",443,9,552,6,372,3,180,53767.757684,1.3074340000021039,2276.2143251553894,1101.3940283009947
"147.32.84.165",20622,"184.173.217.40",443,9,552,6,372,3,180,53770.060607,1.3075800000005984,2275.960170695971,1101.2710503367603
"147.32.84.165",20623,"184.173.217.40",443,8,492,6,372,2,120,53772.378147,1.4479729999948177,2055.2869425124995,662.9957879072579
"147.32.84.165",20624,"94.100.176.20",25,6,372,6,372,0,0,53776.093943,8.948016000002099,332.5876931824107,0
"147.32.84.165",20625,"184.173.217.40",443,9,552,6,372,3,180,53786.844749,1.34818699999596,2207.4089128651426,1068.1010868702303
"147.32.84.165",20626,"184.173.217.40",443,9,552,6,372,3,180,53789.188278,1.3082999999969616,2274.7076358686168,1100.6649850977178
"147.32.84.165",20627,"184.173.217.40",443,9,552,6,372,3,180,53791.491121,1.3084020000023884,2274.530304902138,1100.5791797913573
"147.32.84.165",20628,"184.173.217.40",443,9,552,6,372,3,180,53793.795054,1.3092539999997825,2273.0501491692935,1099.8629754044969
"147.32.84.165",20629,"184.173.217.40",443,9,552,6,372,3,180,53796.09801,1.3082460000005085,2274.801528152078,1100.7104168477797
"147.32.84.165",20630,"74.125.93.27",25,6,372,6,372,0,0,53797.059263,9.01305599999614,330.18767441379197,0
"147.32.84.165",20631,"184.173.217.40",443,9,552,6,372,3,180,53798.40165,1.3075279999975464,2276.050684960922,1101.3148475617365
"147.32.84.165",20632,"184.173.217.40",443,9,552,6,372,3,180,53800.70438,1.3121570000002976,2268.0212809894892,1097.4296520916882
"147.32.84.165",20633,"184.173.217.40",443,9,552,6,372,3,180,53803.018055,1.314012000002549,2264.819499360909,1095.880402916569
"147.32.84.165",20634,"184.173.217.40",443,9,552,6,372,3,180,53805.331237,1.3880219999991823,2144.058235389463,1037.447533252966
"147.32.84.165",20635,"184.173.217.40",443,9,552,6,372,3,180,53807.715033,1.3071909999998752,2276.637461549448,1101.5987717174746
"147.32.84.165",20636,"184.173.217.40",443,9,552,6,372,3,180,53810.018354,1.307559000000765,2275.996723664675,1101.2887372571008
"147.32.84.165",20637,"184.173.217.40",443,9,552,6,372,3,180,53812.321627,1.307369000001927,2276.327494376579,1101.4487876015705
"147.32.84.165",20638,"184.173.217.40",443,9,552,6,372,3,180,53814.624972,1.307215000000724,2276.595663298196,1101.5785467571916
"147.32.84.165",20639,"184.173.217.40",443,9,552,6,372,3,180,53816.928385,1.3072699999975157,2276.499881436624,1101.5322006951408
"147.32.84.165",20640,"74.125.39.27",25,6,372,6,372,0,0,53818.089801,9.012729999994917,330.19961765210746,0
"147.32.84.165",20641,"184.173.217.40",443,9,552,6,372,3,180,53819.231545,1.3077369999955408,2275.6869309426497,1101.138837552895
"147.32.84.165",20642,"184.173.217.40",443,9,552,6,372,3,180,53821.534988,1.3072739999988698,2276.4929157946785,1101.5288302232316
"147.32.84.165",20643,"184.173.217.40",443,9,552,6,372,3,180,53823.838129,1.3084909999961383,2274.375597546168,1100.5043213933072
"147.32.84.165",20644,"184.173.217.40",443,9,552,6,372,3,180,53826.141588,1.3071320000017295,2276.7402221015645,1101.6484945652733
"147.32.84.165",20645,"184.173.217.40",443,9,552,6,372,3,180,53828.44428,1.3079409999991185,2275.331991276369,1100.967092553082
"147.32.84.165",20646,"184.173.217.40",443,9,552,6,372,3,180,53830.747699,1.3080140000020037,2275.2050054475267,1100.9056477971903
"147.32.84.165",20647,"184.173.217.40",443,9,552,6,372,3,180,53833.051307,1.3076299999956973,2275.8731445514345,1101.2289409119844
"147.32.84.165",20648,"184.173.217.40",443,9,552,6,372,3,180,53835.354674,1.3075449999960256,2276.021092971214,1101.300528857039
"147.32.84.165",20649,"184.173.217.40",443,9,552,6,372,3,180,53837.658157,1.3073409999997239,2276.376247666545,1101.472377903167
"147.32.84.165",20650,"66.111.4.73",25,6,372,6,372,0,0,53839.019795,9.01340799999889,330.1747796172509,0
"147.32.84.165",20651,"184.173.217.40",443,9,552,6,372,3,180,53839.960939,1.3081070000043837,2275.0432495124837,1100.8273787963633
"147.32.84.165",20652,"184.173.217.40",443,9,552,6,372,3,180,53842.264917,1.307198000002245,2276.625270230592,1101.5928726922218
"147.32.84.165",20653,"184.173.217.40",443,9,552,6,372,3,180,53844.56808,1.3074090000009164,2276.2578504491817,1101.4150889270234
"147.32.84.165",20654,"184.173.217.40",443,9,552,6,372,3,180,53846.870896,1.3083800000022165,2274.568550417278,1100.5976856857797
"147.32.84.165",20655,"184.173.217.40",443,9,552,6,372,3,180,53849.174203,1.307675999996718,2275.7930863665533,1101.1902030805904
"147.32.84.165",20656,"184.173.217.40",443,9,552,6,372,3,180,53851.478115,1.3073930000027758,2276.2857075062216,1101.4285681481717
"147.32.84.165",20657,"184.173.217.40",443,9,552,6,372,3,180,53853.781437,1.3070210000005318,2276.9335764297507,1101.7420531111698
"147.32.84.165",20658,"184.173.217.40",443,9,552,6,372,3,180,53856.084278,1.3075499999977183,2276.012389587544,1101.29631754236
"147.32.84.165",20659,"184.173.217.40",443,9,552,6,372,3,180,53858.387457,1.32873500000278,2239.724248999066,1083.7375398382576
"147.32.84.165",20660,"216.157.130.15",25,6,372,6,372,0,0,53860.04982,9.013443999996525,330.1734608881075,0
"147.32.84.165",20661,"184.173.217.40",443,9,552,6,372,3,180,53860.710978,1.3879549999983283,2144.1617343527596,1037.4976133964965
"147.32.84.165",20662,"184.173.217.40",443,9,552,6,372,3,180,53863.094204,1.3080669999981183,2275.112819147858,1100.8610415231572
"147.32.84.165",20663,"184.173.217.40",443,9,552,6,372,3,180,53865.397478,1.3084290000042529,2274.4833689793845,1100.5564688609925
"147.32.84.165",20664,"184.173.217.40",443,9,552,6,372,3,180,53867.701087,1.3077520000006189,2275.660828657568,1101.1262074149522
"147.32.84.165",20665,"184.173.217.40",443,9,552,6,372,3,180,53870.004649,1.3073829999993904,2276.303118521036,1101.4369928327594
"147.32.84.165",20666,"184.173.217.40",443,9,552,6,372,3,180,53872.307702,1.3080249999984517,2275.18587183236,1100.8963895963032
"147.32.84.165",20667,"184.173.217.40",443,9,552,6,372,3,180,53874.61092,1.3082649999996647,2274.7684910937483,1100.6944311743944
"147.32.84.165",20668,"184.173.217.40",443,9,552,6,372,3,180,53876.914285,1.3076579999979003,2275.824412808837,1101.2053610365342
"147.32.84.165",20669,"184.173.217.40",443,9,552,6,372,3,180,53879.217534,1.3081619999938994,2274.9475982438557,1100.7810959244462
"147.32.84.165",20670,"184.173.217.40",443,9,552,6,372,3,180,53881.520658,1.308242999999493,2274.8067446194273,1100.7129409448842
"147.32.84.165",20671,"184.173.217.40",443,9,552,6,372,3,180,53883.824199,1.3077839999969,2275.6051458092884,1101.0992641012685
"147.32.84.165",20672,"184.173.217.40",443,9,552,6,372,3,180,53886.127387,1.3083279999991646,2274.658954025214,1100.641429367039
"147.32.84.165",20673,"184.173.217.40",443,9,552,6,372,3,180,53888.430869,1.3080489999993006,2275.1441268649655,1100.8761904185317
"147.32.84.165",20674,"184.173.217.40",443,9,552,6,372,3,180,53890.733915,1.307689000001119,2275.7704622409865,1101.179255923058
"147.32.84.165",20675,"184.173.217.40",443,9,552,6,372,3,180,53893.037412,1.3077640000046813,2275.639947260627,1101.1161035132068
"147.32.84.165",20676,"184.173.217.40",443,9,552,6,372,3,180,53895.340749,1.3079460000008112,2275.3232931620682,1100.9628837880975
"147.32.84.165",20677,"184.173.217.40",443,9,552,6,372,3,180,53897.643934,1.3081840000013472,2274.9093399681815,1100.7625838555716
"147.32.84.165",20678,"184.173.217.40",443,9,552,6,372,3,180,53899.947192,1.3077740000007907,2275.6225464019017,1101.1076837428557
"147.32.84.165",20679,"184.173.217.40",443,9,552,6,372,3,180,53902.250623,1.3081250000032014,2275.011944571594,1100.8122312443197
"147.32.84.165",20680,"184.173.217.40",443,9,552,6,372,3,180,53904.553848,1.3077419999972335,2275.678230114423,1101.1346274747207
"147.32.84.165",20681,"184.173.217.40",443,9,552,6,372,3,180,53906.857644,1.3074710000000778,2276.1499107818245,1101.3628600557215
"147.32.84.165",20682,"184.173.217.40",443,9,552,6,372,3,180,53909.160973,1.3072580000007292,2276.5207786055544,1101.542312228494
"147.32.84.165",20683,"184.173.217.40",443,9,552,6,372,3,180,53911.463683,1.3081640000018524,2274.944120152967,1100.7794129772421
"147.32.84.165",20684,"184.173.217.40",443,9,552,6,372,3,180,53913.767193,1.3079339999967488,2275.3441687481154,1100.9729848781203
"147.32.84.165",20685,"184.173.217.40",443,9,552,6,372,3,180,53916.070574,1.3082170000052429,2274.851954980002,1100.7348169258073
"147.32.84.165",20686,"184.173.217.40",443,9,552,6,372,3,180,53918.374035,1.3078630000018165,2275.467690420072,1101.032753429067
"147.32.84.165",20687,"184.173.217.40",443,9,552,6,372,3,180,53920.677561,1.3078700000041863,2275.455511626136,1101.0268604642592
"147.32.84.165",20688,"173.192.170.88",80,24,3873,16,1406,8,2467,53921.446377,38.782038999997894,290.0311662313735,508.89536777581685
"147.32.84.165",20689,"173.192.170.88",80,17,1726,12,1166,5,560,53922.390527,600.6400349999967,15.53010032040247,7.458710273949729
"147.32.84.165",20690,"184.173.217.40",443,9,552,6,372,3,180,53922.980872,1.3071639999980107,2276.6844864183295,1101.6215256862884
"147.32.84.165",20691,"184.173.217.40",443,9,552,6,372,3,180,53925.284009,1.3079279999947175,2275.3546066847866,1100.9780354926386
"147.32.84.165",20693,"184.173.217.40",443,9,552,6,372,3,180,53927.587211,1.3079150000048685,2275.377222517459,1100.9889786374802
"147.32.84.165",20694,"184.173.217.40",443,9,552,6,372,3,180,53929.89049,1.3079470000011497,2275.321553547188,1100.962042038962
"147.32.84.165",20695,"184.173.217.40",443,9,552,6,372,3,180,53932.19406,1.3075170000010985,2276.0698331245403,1101.324112802197
"147.32.84.165",20696,"184.173.217.40",443,9,552,6,372,3,180,53934.496975,1.307911999996577,2275.382441638114,1100.9915040184421
"147.32.84.165",20697,"184.173.217.40",443,9,552,6,372,3,180,53936.800547,1.299207000003662,2290.628052336242,1108.3684124207623
"147.32.84.165",20699,"98.126.71.122",80,18,4863,14,1430,4,3433,53936.960385,16.281995000004827,702.616601957967,1686.7711849802104
"147.32.84.165",20700,"195.113.232.98",80,21,7732,14,3882,7,3850,53937.528917,19.534034999996948,1589.8405014634639,1576.7351701788602
"147.32.84.165",20701,"195.113.232.89",80,13,2792,10,1770,3,1022,53937.779767,19.283386000002793,734.3108725821259,423.991927558719
"147.32.84.165",20702,"195.113.232.83",80,54,40830,44,3746,10,37084,53938.225037,18.83829500000138,1590.8021400024686,15748.346652389628
"147.32.84.165",20703,"184.173.217.40",443,9,552,6,372,3,180,53939.099234,1.3077899999989313,2275.594705573855,1101.094212374446
"147.32.84.165",20704,"184.173.217.40",443,9,552,6,372,3,180,53941.407048,1.3075089999983902,2276.083759273293,1101.3308512612707
"147.32.84.165",20705,"184.173.217.40",443,9,552,6,372,3,180,53943.714457,1.30803300000116,2275.1719566688002,1100.8896564526453
"147.32.84.165",20706,"184.173.217.40",443,9,552,6,372,3,180,53946.022261,1.30733400000463,2276.388436305841,1101.4782756318584
"147.32.84.165",20707,"184.173.217.40",443,9,552,6,372,3,180,53948.330871,1.307823000002827,2275.5372860039674,1101.0664287115972
"147.32.84.165",20708,"184.173.217.40",443,9,552,6,372,3,180,53950.638752,1.3091090000016266,2273.3019175609534,1099.9847988198162
"147.32.84.165",20709,"184.173.217.40",443,9,552,6,372,3,180,53952.948345,1.3068679999996675,2277.2001456924168,1101.871038238266
"147.32.84.165",20710,"184.173.217.40",443,9,552,6,372,3,180,53955.255137,1.3075919999973848,2275.9392838178514,1101.2609437828314
"147.32.84.165",20711,"184.173.217.40",443,9,552,6,372,3,180,53957.573366,1.308141000001342,2274.98411868212,1100.7987671042515
"147.32.84.165",20712,"184.173.217.40",443,9,552,6,372,3,180,53959.876753,1.307438000003458,2276.2073612608237,1101.390658674592
"147.32.84.165",20713,"173.192.170.88",80,11,1283,8,846,3,437,53960.028063,1.1005650000006426,6149.568630654298,3176.550226472729
"147.32.84.165",20714,"184.173.217.40",443,9,552,6,372,3,180,53962.179878,1.3076359999977285,2275.8627018567627,1101.2238879952076
"147.32.84.165",20715,"184.173.217.40",443,9,552,6,372,3,180,53964.48313,1.308538999997836,2274.2921685978954,1100.4639525473688
"147.32.84.165",20716,"184.173.217.40",443,9,552,6,372,3,180,53966.78694,1.3076209999999264,2275.8888087604646,1101.2365203679667
"147.32.84.165",20717,"184.173.217.40",443,9,552,6,372,3,180,53969.089848,1.3081639999945764,2274.94412016562,1100.7794129833646
"147.32.84.165",20718,"184.173.217.40",443,9,552,6,372,3,180,53971.392942,1.3083499999993364,2274.620705469874,1100.6229220015518
"147.32.84.165",20719,"184.173.217.40",443,9,552,6,372,3,180,53973.696638,1.3076989999972284,2275.7530593862252,1101.1708351868833
"147.32.84.165",20720,"184.173.217.40",443,9,552,6,372,3,180,53975.99959,1.3082690000010189,2274.7615360431855,1100.6910658273478
"147.32.84.165",20721,"184.173.217.40",443,9,552,6,372,3,180,53978.303611,1.3070850000003702,2276.8220888459105,1101.6881075060858
"147.32.84.165",20722,"184.173.217.40",443,9,552,6,372,3,180,53980.606526,1.3073079999958281,2276.4337095845026,1101.5001820570174
"147.32.84.165",20723,"184.173.217.40",443,9,552,6,372,3,180,53982.909858,1.3076990000045043,2275.7530593735632,1101.1708351807563
"147.32.84.165",20724,"184.173.217.40",443,9,552,6,372,3,180,53985.212867,1.307647999994515,2275.8418167675727,1101.2137823068902
"147.32.84.165",20725,"184.173.217.40",443,9,552,6,372,3,180,53987.516148,1.3082409999988158,2274.8102222776183,1100.7146236827186
"147.32.84.165",20726,"184.173.217.40",443,9,552,6,372,3,180,53989.819902,1.3150349999996251,2263.057637249844,1095.02788899186
"147.32.84.165",20727,"184.173.217.40",443,9,552,6,372,3,180,53992.133209,1.2977410000021337,2293.2156724609204,1109.6204866746389
"147.32.84.165",20728,"184.173.217.40",443,9,552,6,372,3,180,53994.426216,1.3077479999992647,2275.6677892083744,1101.129575423407
"147.32.84.165",20729,"184.173.217.40",443,9,552,6,372,3,180,53996.729526,1.3076169999985723,2275.8957707059863,1101.2398890512836
"147.32.84.165",20730,"184.173.217.40",443,9,552,6,372,3,180,53999.033014,1.3076519999958691,2275.8348551521362,1101.2104137832916
"147.32.84.165",20731,"94.100.176.20",25,6,372,6,372,0,0,54001.24828,8.961014000000432,332.1052729077152,0
"147.32.84.165",20732,"184.173.217.40",443,9,552,6,372,3,180,54001.336016,1.3079579999975977,2275.3024179717286,1100.9527828895461
"147.32.84.165",20733,"184.173.217.40",443,9,552,6,372,3,180,54003.639322,1.308162999994238,2274.9458592034084,1100.7802544532622
"147.32.84.165",20734,"184.173.217.40",443,9,552,6,372,3,180,54005.943028,1.3072969999993802,2276.4528641933784,1101.509450416151
"147.32.84.165",20735,"184.173.217.40",443,9,552,6,372,3,180,54008.245999,1.3081789999996545,2274.918034917841,1100.7667910892778
"147.32.84.165",20736,"184.173.217.40",443,9,552,6,372,3,180,54010.549546,1.3079639999996289,2275.291980513871,1100.9477325067116
"147.32.84.165",20737,"184.173.217.40",443,9,552,6,372,3,180,54012.852977,1.307275999999547,2276.489432989691,1101.527144995012
"147.32.84.165",20738,"184.173.217.40",443,9,552,6,372,3,180,54015.156528,1.3078630000018165,2275.467690420072,1101.032753429067
"147.32.84.165",20739,"184.173.217.40",443,9,552,6,372,3,180,54017.459178,1.3079750000033528,2275.2728454231706,1100.9384735918568
"147.32.84.165",20740,"184.173.217.40",443,9,552,6,372,3,180,54019.762789,1.2079959999973653,2463.5843165097326,1192.056927343419
"147.32.84.165",20741,"184.173.217.40",443,9,552,6,372,3,180,54021.966071,1.3077059999995981,2275.7408775373933,1101.1649407439
"147.32.84.165",20742,"74.125.93.27",25,6,372,6,372,0,0,54022.126649,9.01254400000471,330.206432279104,0
"147.32.84.165",20743,"184.173.217.40",443,9,552,6,372,3,180,54024.269388,1.3073359999980312,2276.384953833201,1101.4765905644522
"147.32.84.165",20744,"184.173.217.40",443,9,552,6,372,3,180,54026.572508,1.307648000001791,2275.84181675491,1101.2137823007627
"147.32.84.165",20745,"184.173.217.40",443,9,552,6,372,3,180,54028.876242,1.3075690000041504,2275.9793173366406,1101.28031484031
"147.32.84.165",20746,"184.173.217.40",443,9,552,6,372,3,180,54031.179502,1.3070930000030785,2276.8081536608265,1101.6813646745936
"147.32.84.165",20747,"184.173.217.40",443,9,552,6,372,3,180,54033.482376,1.3078150000001187,2275.551205636676,1101.0731640177466
"147.32.84.165",20748,"184.173.217.40",443,9,552,6,372,3,180,54035.785699,1.3086570000014035,2274.0870984504027,1100.3647250566464
"147.32.84.165",20749,"184.173.217.40",443,9,552,6,372,3,180,54038.089274,1.3076179999989108,2275.8940302156125,1101.2390468785222
"147.32.84.165",20750,"184.173.217.40",443,9,552,6,372,3,180,54040.392221,1.3083599999954458,2274.6033201950218,1100.614509771785
"147.32.84.165",20751,"184.173.217.40",443,9,552,6,372,3,180,54042.695814,1.3075020000032964,2276.0959447805794,1101.336747474474
"147.32.84.165",20752,"74.125.39.27",25,6,372,6,372,0,0,54043.156669,9.012676999998803,330.20155942572836,0
"147.32.84.165",20753,"184.173.217.40",443,9,552,6,372,3,180,54044.999343,1.3078269999969052,2275.530326264133,1101.0630610955482
"147.32.84.165",20754,"184.173.217.40",443,9,552,6,372,3,180,54047.302186,1.3078610000011395,2275.4711700994276,1101.0344371448841
"147.32.84.165",20755,"184.173.217.40",443,9,552,6,372,3,180,54049.605714,1.3080269999991287,2275.1823930255127,1100.8947063026674
"147.32.84.165",20756,"184.173.217.40",443,9,552,6,372,3,180,54051.9089,1.3077649999977439,2275.6382071741746,1101.1152615358908
"147.32.84.165",20757,"184.173.217.40",443,9,552,6,372,3,180,54054.212764,1.307530999998562,2276.0454627869417,1101.3123207033589
"147.32.84.165",20758,"184.173.217.40",443,9,552,6,372,3,180,54056.515903,1.3074930000002496,2276.1116120693814,1101.3443284206685
"147.32.84.165",20759,"184.173.217.40",443,9,552,6,372,3,180,54058.818616,1.308433000005607,2274.4764156722176,1100.5531043575247
"147.32.84.165",20760,"184.173.217.40",443,9,552,6,372,3,180,54061.122275,1.3079619999989518,2275.29545965585,1100.949415962508
"147.32.84.165",20761,"184.173.217.40",443,9,552,6,372,3,180,54063.425238,1.4080659999963245,2113.537291581338,1022.6793346361313
"147.32.84.165",20762,"66.111.4.73",25,6,372,6,372,0,0,54064.186708,9.013193999999203,330.18261894731916,0
"147.32.84.165",20763,"184.173.217.40",443,9,552,6,372,3,180,54065.828907,1.3078629999945406,2275.4676904327307,1101.0327534351923
"147.32.84.165",20764,"184.173.217.40",443,9,552,6,372,3,180,54068.132564,1.3078129999994417,2275.554685571462,1101.074847857159
"147.32.84.165",20765,"184.173.217.40",443,9,552,6,372,3,180,54070.435796,1.30751600000076,2276.071573883815,1101.3249551050717
"147.32.84.165",20766,"184.173.217.40",443,9,552,6,372,3,180,54072.73911,1.3078239999958896,2275.5355460745127,1101.065586810248
"147.32.84.165",20767,"184.173.217.40",443,9,552,6,372,3,180,54075.042247,1.3081030000030296,2275.050206285826,1100.8307449770125
"147.32.84.165",20768,"184.173.217.40",443,9,552,6,372,3,180,54077.345315,1.3082009999998263,2274.8797776491497,1100.748279507653
"147.32.84.165",20769,"184.173.217.40",443,9,552,6,372,3,180,54079.649169,1.307529000005161,2276.048944220934,1101.3140052681938
"147.32.84.165",20770,"184.173.217.40",443,9,552,6,372,3,180,54081.952146,1.3078979999991134,2275.4067977793507,1101.003289248073
"147.32.84.165",20771,"184.173.217.40",443,9,552,6,372,3,180,54084.255861,1.307886000002327,2275.4276748850475,1101.01339107341
"147.32.84.165",20772,"216.157.130.15",25,6,372,6,372,0,0,54085.216626,8.912683999995352,333.90614993211386,0
"147.32.84.165",20773,"184.173.217.40",443,9,552,6,372,3,180,54086.558553,1.308335999994597,2274.6450453188554,1100.6346993478332
"147.32.84.165",20774,"184.173.217.40",443,9,552,6,372,3,180,54088.862301,1.2077359999966575,2464.114674074662,1192.3135519716109
"147.32.84.165",20775,"184.173.217.40",443,9,552,6,372,3,180,54091.065277,1.3078509999977541,2275.488568655841,1101.0428558012134
"147.32.84.165",20776,"184.173.217.40",443,9,552,6,372,3,180,54093.368874,1.3073629999998957,2276.337941337056,1101.4538425824464
"147.32.84.165",20777,"184.173.217.40",443,9,552,6,372,3,180,54095.672104,1.3075930000049993,2275.9375432482598,1101.2601015717387
"147.32.84.165",20778,"184.173.217.40",443,9,552,6,372,3,180,54097.97522,1.3077679999987595,2275.6329868927996,1101.1127355932902
"147.32.84.165",20779,"184.173.217.40",443,9,552,6,372,3,180,54100.278402,1.3082749999957741,2274.7511035597354,1100.6860178514848
"147.32.84.165",20780,"184.173.217.40",443,9,552,6,372,3,180,54102.582026,1.307568000003812,2275.9810579574632,1101.281157076192
"147.32.84.165",20781,"184.173.217.40",443,9,552,6,372,3,180,54104.884927,1.3080919999993057,2275.069337631894,1100.8400020799488
"147.32.84.165",20782,"184.173.217.40",443,9,552,6,372,3,180,54107.188505,1.3081329999986337,2274.998031548098,1100.8054991361764
"147.32.84.165",20783,"184.173.217.40",443,9,552,6,372,3,180,54109.491641,1.308114999999816,2275.0293361060903,1100.820646502947
"147.32.84.165",20784,"184.173.217.40",443,9,552,6,372,3,180,54111.794775,1.3080209999970975,2275.19282947797,1100.8997561990177
"147.32.84.165",20785,"184.173.217.40",443,9,552,6,372,3,180,54114.098163,1.3080950000003213,2275.0641199601473,1100.8374774000713
"147.32.84.165",20786,"184.173.217.40",443,9,552,6,372,3,180,54116.401514,1.307888000003004,2275.4241953387177,1101.0117074219602
"147.32.84.165",20787,"184.173.217.40",443,9,552,6,372,3,180,54118.705159,1.307518000001437,2276.068092367929,1101.3232705006105
"147.32.84.165",20788,"184.173.217.40",443,9,552,6,372,3,180,54121.008152,1.3079149999975925,2275.377222530117,1100.988978643605
"147.32.84.165",20789,"184.173.217.40",443,9,552,6,372,3,180,54123.311645,1.3074239999987185,2276.2317350782278,1101.4024524572071
"147.32.84.165",20790,"184.173.217.40",443,9,552,6,372,3,180,54125.61518,1.3078160000004573,2275.549465673275,1101.0723220999716
"147.32.84.165",20791,"184.173.217.40",443,9,552,6,372,3,180,54127.918156,1.30772799999977,2275.7025925884614,1101.1464157686103
"147.32.84.165",20792,"184.173.217.40",443,9,552,6,372,3,180,54130.221863,1.3074960000012652,2276.1063896158153,1101.3418014270076
"147.32.84.165",20793,"184.173.217.40",443,9,552,6,372,3,180,54132.524645,1.3079480000014883,2275.3198139349684,1100.9612002911135
"147.32.84.165",20794,"184.173.217.40",443,9,552,6,372,3,180,54134.828226,1.3073870000007446,2276.2961540831484,1101.4336229434589
"147.32.84.165",20795,"184.173.217.40",443,9,552,6,372,3,180,54137.131889,1.3075660000031348,2275.9845392070956,1101.2828415518204
"147.32.84.165",20796,"184.173.217.40",443,9,552,6,372,3,180,54139.434594,1.3083600000027218,2274.6033201823725,1100.6145097656643
"147.32.84.165",20797,"184.173.217.40",443,9,552,6,372,3,180,54141.737833,1.307782000003499,2275.6086258963937,1101.1009480143841
"147.32.84.165",20798,"184.173.217.40",443,9,552,6,372,3,180,54144.041609,1.30775800000265,2275.6503879111956,1101.121155440901
"147.32.84.165",20799,"184.173.217.40",443,9,552,6,372,3,180,54146.344642,1.3076190000065253,2275.8922897152374,1101.2382047009214
"147.32.84.165",20800,"184.173.217.40",443,9,552,6,372,3,180,54148.648242,1.307647999994515,2275.8418167675727,1101.2137823068902
"147.32.84.165",20801,"184.173.217.40",443,9,552,6,372,3,180,54150.951355,1.3076990000045043,2275.7530593735632,1101.1708351807563
"147.32.84.165",20802,"184.173.217.40",443,9,552,6,372,3,180,54153.254865,1.307818999994197,2275.544245811695,1101.0697963604975
"147.32.84.165",20803,"184.173.217.40",443,9,552,6,372,3,180,54155.558453,1.307462000004307,2276.165578800911,1101.3704413552796
"147.32.84.165",20804,"184.173.217.40",443,9,552,6,372,3,180,54157.861127,1.308195000005071,2274.8902113128884,1100.7533280546234
"147.32.84.165",20805,"184.173.217.40",443,9,552,6,372,3,180,54160.164635,1.3079169999982696,2275.373743138087,1100.9872950668164
"147.32.84.165",20806,"184.173.217.40",443,9,552,6,372,3,180,54162.468037,1.307833999999275,2275.5181467997086,1101.0571678063104
"147.32.84.165",20807,"184.173.217.40",443,9,552,6,372,3,180,54164.771412,1.3080039999986184,2275.222399933902,1100.9140644841461
"147.32.84.165",20808,"184.173.217.40",443,9,552,6,372,3,180,54167.074791,1.3076290000026347,2275.8748849972,1101.2297830631612
"147.32.84.165",20809,"184.173.217.40",443,9,552,6,372,3,180,54169.377776,1.3080750000008265,2275.0989048778697,1100.8543088118724
"147.32.84.165",20810,"184.173.217.40",443,9,552,6,372,3,180,54171.681192,1.308301000004576,2274.7058971823694,1100.6641437979206
"147.32.84.165",20811,"184.173.217.40",443,9,552,6,372,3,180,54173.984259,1.3079190000062226,2275.37026374404,1100.9856114890517
"147.32.84.165",20812,"184.173.217.40",443,9,552,6,372,3,180,54176.288145,1.3073999999978696,2276.273519966995,1101.4226709517718
"147.32.84.165",20813,"184.173.217.40",443,9,552,6,372,3,180,54178.591188,1.3080520000003162,2275.1389088501687,1100.8736655726623
"147.32.84.165",20814,"184.173.217.40",443,9,552,6,372,3,180,54180.894193,1.308353000000352,2274.615489855719,1100.6203983172834
"147.32.84.165",20815,"184.173.217.40",443,9,552,6,372,3,180,54183.197505,1.308258000004571,2274.78066252192,1100.7003205751225
"147.32.84.165",20816,"184.173.217.40",443,9,552,6,372,3,180,54185.50115,1.3076930000024731,2275.763501062078,1101.1758876106828
"147.32.84.165",20817,"184.173.217.40",443,9,552,6,372,3,180,54187.804632,1.3074600000036298,2276.1690606150382,1101.3721261040507
"147.32.84.165",20818,"184.173.217.40",443,9,552,6,372,3,180,54190.108122,1.3077590000029886,2275.6486477961143,1101.1203134497327
"147.32.84.165",20819,"184.173.217.40",443,9,552,6,372,3,180,54192.410711,1.3083180000030552,2274.676340150522,1100.649842008317
"147.32.84.165",20820,"184.173.217.40",443,9,552,6,372,3,180,54194.714383,1.307886000002327,2275.4276748850475,1101.01339107341
"147.32.84.165",20821,"184.173.217.40",443,9,552,6,372,3,180,54197.017641,1.3075620000017807,2275.991501738309,1101.2862105185368
"147.32.84.165",20822,"184.173.217.40",443,9,552,6,372,3,180,54199.320623,1.3086350000012317,2274.1253290621135,1100.3832237397323
"147.32.84.165",20823,"184.173.217.40",443,9,552,6,372,3,180,54201.624453,1.307426999999734,2276.2265120734123,1101.3999251968123
"147.32.84.165",20824,"184.173.217.40",443,9,552,6,372,3,180,54203.927237,1.3083809999952791,2274.566811968943,1100.5968445011015
"147.32.84.165",20825,"184.173.217.40",443,9,552,6,372,3,180,54206.231168,1.3073440000007395,2276.3710239985166,1101.4698503218629
"147.32.84.165",20826,"184.173.217.40",443,9,552,6,372,3,180,54208.534004,1.3077889999985928,2275.596445606441,1101.0950543256974
"147.32.84.165",20827,"184.173.217.40",443,9,552,6,372,3,180,54210.837213,1.308258000004571,2274.78066252192,1100.7003205751225
"147.32.84.165",20828,"184.173.217.40",443,9,552,6,372,3,180,54213.141244,1.3099860000002082,2271.7800037554043,1099.2483889139053
"147.32.84.165",20829,"184.173.217.40",443,9,552,6,372,3,180,54215.444041,1.4078309999968042,2113.890090505718,1022.8500437930894
"147.32.84.165",20830,"184.173.217.40",443,9,552,6,372,3,180,54217.847521,1.3078789999999572,2275.4398533810067,1101.0192838940354
"147.32.84.165",20831,"184.173.217.40",443,9,552,6,372,3,180,54220.150744,1.3077370000028168,2275.686930929988,1101.1388375467684
"147.32.84.165",20832,"173.192.170.88",80,30,4367,20,1646,10,2721,54221.470969,46.8937619999997,280.80493947148204,464.1982018845095
"147.32.84.165",20833,"184.173.217.40",443,9,552,6,372,3,180,54222.454294,1.3073879999938072,2276.2944129930033,1101.4327804804855
"147.32.84.165",20834,"184.173.217.40",443,9,552,6,372,3,180,54224.757916,1.3073069999954896,2276.4354509004143,1101.5010246292327
"147.32.84.165",20835,"94.100.176.20",25,6,372,6,372,0,0,54226.33423,8.898049000003084,334.4553395917429,0
"147.32.84.165",20836,"184.173.217.40",443,9,552,6,372,3,180,54227.061133,1.3078919999970822,2275.417236290641,1101.0083401406328
"147.32.84.165",20837,"184.173.217.40",443,9,552,6,372,3,180,54229.364673,1.307384000007005,2276.3013773949006,1101.4361503523712
"147.32.84.165",20838,"184.173.217.40",443,9,552,6,372,3,180,54231.667419,1.3078500000046915,2275.490308513457,1101.0436976678018
"147.32.84.165",20839,"184.173.217.40",443,9,552,6,372,3,180,54233.97074,1.3078300000051968,2275.525106465041,1101.0605353863102
"147.32.84.165",20841,"184.173.217.40",443,9,552,6,372,3,180,54236.273978,1.3078119999991031,2275.5564255428462,1101.0756897787967
"147.32.84.165",20842,"184.173.217.40",443,9,552,6,372,3,180,54238.57721,1.308272999995097,2274.7545810478036,1100.6877005070016
"147.32.84.165",20843,"184.173.217.40",443,9,552,6,372,3,180,54240.880507,1.3083219999971334,2274.6693856760953,1100.646476940046
"147.32.84.165",20844,"184.173.217.40",443,9,552,6,372,3,180,54243.184205,1.307318999999552,2276.4145552852974,1101.4909138477246
"147.32.84.165",20846,"98.126.71.122",80,18,4843,14,1410,4,3433,54244.135689,16.266625999996904,693.444356561843,1688.3648766502179
"147.32.84.165",20847,"195.113.232.88",80,21,7732,14,3804,7,3928,54244.755395,19.442612999999255,1565.2217117113407,1616.24366025293
"147.32.84.165",20848,"195.113.232.96",80,13,2784,10,1762,3,1022,54245.015529,19.18266399999993,734.8301570626504,426.21817282521494
"147.32.84.165",20849,"195.113.232.83",80,56,40958,46,3866,10,37092,54245.390611,18.80775999999605,1644.427619238362,15777.317447695117
"147.32.84.165",20850,"184.173.217.40",443,9,552,6,372,3,180,54245.477671,1.3119399999995949,2268.3964205687143,1097.6111712429263
"147.32.84.165",20851,"74.125.93.27",25,6,372,6,372,0,0,54247.245617,9.031733999996504,329.504832626952,0
"147.32.84.165",20852,"184.173.217.40",443,9,552,6,372,3,180,54247.790018,1.306614000000991,2277.642823356969,1102.085237108211
"147.32.84.165",20853,"184.173.217.40",443,9,552,6,372,3,180,54250.097884,1.3075909999970463,2275.941024377441,1101.2617859890843
"147.32.84.165",20854,"184.173.217.40",443,9,552,6,372,3,180,54252.405326,1.3084369999996852,2274.469462420213,1100.5497398807481
"147.32.84.165",20855,"184.173.217.40",443,9,552,6,372,3,180,54254.715339,1.307050999996136,2276.88131527293,1101.7167654546433
"147.32.84.165",20856,"184.173.217.40",443,9,552,6,372,3,180,54257.022868,1.3063739999997779,2278.0612596396636,1102.2877062772566
"147.32.84.165",20857,"184.173.217.40",443,9,552,6,372,3,180,54259.329837,1.3069650000034017,2277.031137017636,1101.789259847243
"147.32.84.165",20858,"184.173.217.40",443,9,552,6,372,3,180,54261.637259,1.3069239999967976,2277.1025706217747,1101.823824494407
"147.32.84.165",20859,"184.173.217.40",443,9,552,6,372,3,180,54263.94472,1.3196610000013607,2255.1246115456406,1091.1893281672453
"147.32.84.165",20860,"184.173.217.40",443,9,552,6,372,3,180,54266.259837,1.308204000000842,2274.874560846844,1100.745755248473
"147.32.84.165",20861,"173.192.170.88",80,11,1283,8,846,3,437,54268.164242,2.178393000001961,3106.8774091699283,1604.852751545223
"147.32.84.165",20862,"74.125.39.27",25,6,372,6,372,0,0,54268.322962,9.01266300000134,330.20207235081995,0
"147.32.84.165",20863,"184.173.217.40",443,9,552,6,372,3,180,54268.563881,1.3075800000005984,2275.960170695971,1101.2710503367603
"147.32.84.165",20864,"184.173.217.40",443,9,552,6,372,3,180,54270.867045,1.2079280000034487,2463.723003350782,1192.1240338794107
"147.32.84.165",20865,"184.173.217.40",443,9,552,6,372,3,180,54273.069881,1.3077499999999418,2275.6643089276486,1101.1278914166041
"147.32.84.165",20866,"184.173.217.40",443,9,552,6,372,3,180,54275.373161,1.307597999999416,2275.9288405162206,1101.2558905723647
"147.32.84.165",20867,"184.173.217.40",443,9,552,6,372,3,180,54277.676706,1.3076159999982337,2275.8975111990217,1101.240731225333
"147.32.84.165",20868,"184.173.217.40",443,9,552,6,372,3,180,54279.979658,1.307771000007051,2275.6277666227147,1101.1102096561524
"147.32.84.165",20869,"184.173.217.40",443,9,552,6,372,3,180,54282.283457,1.3073010000007343,2276.4458988391566,1101.5060800834628
"147.32.84.165",20870,"184.173.217.40",443,9,552,6,372,3,180,54284.586698,1.3080709999994724,2275.1058619915893,1100.8576751572207
"147.32.84.165",20871,"184.173.217.40",443,9,552,6,372,3,180,54286.889485,1.307795000000624,2275.586005450839,1101.0900026375027
"147.32.84.165",20872,"184.173.217.40",443,9,552,6,372,3,180,54289.193348,1.3197789999976521,2254.922983321673,1091.0917661233902
"147.32.84.165",20873,"66.111.4.73",25,6,372,6,372,0,0,54289.353046,9.012932000005094,330.19221713847594,0
"147.32.84.165",20874,"184.173.217.40",443,9,552,6,372,3,180,54291.506633,1.2976130000024568,2293.4418813578204,1109.7299425924937
"147.32.84.165",20875,"184.173.217.40",443,9,552,6,372,3,180,54293.799558,1.3083699999988312,2274.5859351732756,1100.6060976644883
"147.32.84.165",20876,"184.173.217.40",443,9,552,6,372,3,180,54296.103015,1.3081079999974463,2275.0415103384503,1100.8265372605406
"147.32.84.165",20877,"184.173.217.40",443,9,552,6,372,3,180,54298.406214,1.3074699999997392,2276.1516516635897,1101.3637024178659
"147.32.84.165",20878,"184.173.217.40",443,9,552,6,372,3,180,54300.709816,1.3074969999943278,2276.104648815952,1101.3409591044929
"147.32.84.165",20879,"184.173.217.40",443,9,552,6,372,3,180,54303.012979,1.3078840000016498,2275.4311544420193,1101.0150747300092
"147.32.84.165",20880,"184.173.217.40",443,9,552,6,372,3,180,54305.316626,1.3076399999990826,2275.855740113554,1101.2205194097842
"147.32.84.165",20881,"184.173.217.40",443,9,552,6,372,3,180,54307.620292,1.307066000001214,2276.855185581475,1101.7041220555523
"147.32.84.165",20882,"184.173.217.40",443,9,552,6,372,3,180,54309.922568,1.3076880000007804,2275.7722025423677,1101.1800980043715
"147.32.84.165",20883,"216.157.130.15",25,6,372,6,372,0,0,54310.383766,9.012801999997464,330.19697980726056,0
"147.32.84.165",20884,"184.173.217.40",443,9,552,6,372,3,180,54312.226166,1.3078089999980875,2275.5616454729643,1101.0782155514344
"147.32.84.165",20885,"184.173.217.40",443,9,552,6,372,3,180,54314.529799,1.3072990000000573,2276.4493815109395,1101.5077652472287
"147.32.84.165",20886,"184.173.217.40",443,9,552,6,372,3,180,54316.832568,1.3082690000010189,2274.7615360431855,1100.6910658273478
"147.32.84.165",20887,"184.173.217.40",443,9,552,6,372,3,180,54319.136491,1.3076310000033118,2275.871404083004,1101.2280987498407
"147.32.84.165",20888,"184.173.217.40",443,9,552,6,372,3,180,54321.43949,1.3074780000024475,2276.137724684032,1101.3569635567899
"147.32.84.165",20889,"184.173.217.40",443,9,552,6,372,3,180,54323.743232,1.3074330000017653,2276.2160661356884,1101.394870710817
"147.32.84.165",20890,"184.173.217.40",443,9,552,6,372,3,180,54326.046137,1.3078890000033425,2275.422455569543,1101.010865598166
"147.32.84.165",20891,"184.173.217.40",443,9,552,6,372,3,180,54328.349714,1.3078889999960666,2275.4224555822016,1101.0108656042912
"147.32.84.165",20892,"184.173.217.40",443,9,552,6,372,3,180,54330.652841,1.3073329999970156,2276.3901775651602,1101.4791181766905
"147.32.84.165",20893,"184.173.217.40",443,9,552,6,372,3,180,54332.956431,1.3072890000039479,2276.466795017026,1101.5161911372707
"147.32.84.165",20894,"184.173.217.40",443,9,552,6,372,3,180,54335.259792,1.3070970000044326,2276.8011861322516,1101.6779932897991
"147.32.84.165",20895,"184.173.217.40",443,9,552,6,372,3,180,54337.56268,1.3079039999938686,2275.396359376492,1100.99823840798
"147.32.84.165",20896,"184.173.217.40",443,9,552,6,372,3,180,54339.86565,1.2082920000029844,2462.98080264758,1191.7649045068933
"147.32.84.165",20897,"184.173.217.40",443,9,552,6,372,3,180,54342.069318,1.3074649999980466,2276.1603561123598,1101.367914247916
"147.32.84.165",20898,"184.173.217.40",443,9,552,6,372,3,180,54344.373182,1.307067999994615,2276.8517016806018,1101.7024362970653
"147.32.84.165",20899,"184.173.217.40",443,9,552,6,372,3,180,54346.676323,1.307528999997885,2276.0489442335993,1101.3140052743222
"147.32.84.165",20900,"184.173.217.40",443,9,552,6,372,3,180,54348.978997,1.3078139999997802,2275.552945602739,1101.074005936809
"147.32.84.165",20901,"184.173.217.40",443,9,552,6,372,3,180,54351.282186,1.3076920000021346,2275.7652413528126,1101.1767296868447
"147.32.84.165",20902,"184.173.217.40",443,9,552,6,372,3,180,54353.585351,1.3079670000006445,2275.2867618208516,1100.9452073326702
"147.32.84.165",20903,"184.173.217.40",443,9,552,6,372,3,180,54355.888859,1.308059000002686,2275.1267335753887,1100.8677743106718
"147.32.84.165",20904,"184.173.217.40",443,9,552,6,372,3,180,54358.19222,1.3080420000042068,2275.1563023132508,1100.8820817644762
"147.32.84.165",20905,"184.173.217.40",443,9,552,6,372,3,180,54360.495795,1.3077619999967283,2275.6434274794997,1101.1177874900804
"147.32.84.165",20906,"184.173.217.40",443,9,552,6,372,3,180,54362.799157,1.3074849999975413,2276.12553872939,1101.3510671271242
"147.32.84.165",20907,"184.173.217.40",443,9,552,6,372,3,180,54365.102131,1.3076789999977336,2275.7878653745743,1101.1876767941487
"147.32.84.165",20908,"184.173.217.40",443,9,552,6,372,3,180,54367.405365,1.3076789999977336,2275.7878653745743,1101.1876767941487
"147.32.84.165",20909,"184.173.217.40",443,9,552,6,372,3,180,54369.709659,1.307253999999375,2276.527744418011,1101.5456827829087
"147.32.84.165",20910,"184.173.217.40",443,9,552,6,372,3,180,54372.012276,1.3079749999960768,2275.2728454358275,1100.938473597981
"147.32.84.165",20911,"184.173.217.40",443,9,552,6,372,3,180,54374.315632,1.3080600000030245,2275.1249942610575,1100.8669327069633
"147.32.84.165",20912,"184.173.217.40",443,9,552,6,372,3,180,54376.61921,1.307583000001614,2275.9549489373344,1101.2685236793554
"147.32.84.165",20913,"184.173.217.40",443,9,552,6,372,3,180,54378.922074,1.3401269999958458,2220.685054483064,1074.525026362773
"147.32.84.165",20914,"184.173.217.40",443,9,552,6,372,3,180,54381.255796,1.3777160000026925,2160.0968559515777,1045.2081561056023
"147.32.84.165",20915,"184.173.217.40",443,9,552,6,372,3,180,54383.629183,1.3071679999993648,2276.67751964663,1101.6181546677242
"147.32.84.165",20916,"184.173.217.40",443,9,552,6,372,3,180,54385.932418,1.307570000004489,2275.97757671848,1101.2794726057161
"147.32.84.165",20917,"184.173.217.40",443,9,552,6,372,3,180,54388.235958,1.307691000001796,2275.766981646209,1101.1775717642947
"147.32.84.165",20918,"184.173.217.40",443,9,552,6,372,3,180,54390.538896,1.3080840000038734,2275.0832515275683,1100.8467346101138
"147.32.84.165",20919,"184.173.217.40",443,9,552,6,372,3,180,54392.841971,1.307725999999093,2275.7060729862865,1101.148099832074
"147.32.84.165",20920,"184.173.217.40",443,9,552,6,372,3,180,54395.145804,1.3072380000012345,2276.5556080814586,1101.5591652007058
"147.32.84.165",20921,"184.173.217.40",443,9,552,6,372,3,180,54397.449104,1.3077350000021397,2275.690411279908,1101.1405215870523
"147.32.84.165",20922,"184.173.217.40",443,9,552,6,372,3,180,54399.75247,1.3075479999970412,2276.0158709330244,1101.2980020643668
"147.32.84.165",20923,"184.173.217.40",443,9,552,6,372,3,180,54402.055059,1.308112999999139,2275.032814444898,1100.8223295701118
"147.32.84.165",20924,"184.173.217.40",443,9,552,6,372,3,180,54404.358786,1.3079649999999674,2275.290240946871,1100.946890780744
"147.32.84.165",20925,"184.173.217.40",443,9,552,6,372,3,180,54406.662245,1.3074479999995674,2276.1899517234983,1101.3822347049186
"147.32.84.165",20926,"184.173.217.40",443,9,552,6,372,3,180,54408.965502,1.3075800000005984,2275.960170695971,1101.2710503367603
"147.32.84.165",20927,"184.173.217.40",443,9,552,6,372,3,180,54411.268329,1.307996000003186,2275.2363157018453,1100.9207979202479
"147.32.84.165",20928,"184.173.217.40",443,9,552,6,372,3,180,54413.572008,1.3078669999958947,2275.4607311059467,1101.0293860190066
"147.32.84.165",20929,"184.173.217.40",443,9,552,6,372,3,180,54415.875637,1.3071230000059586,2276.755898248622,1101.6560797977204
"147.32.84.165",20930,"184.173.217.40",443,9,552,6,372,3,180,54418.17831,1.308216999997967,2274.851954992654,1100.7348169319293
"147.32.84.165",20931,"184.173.217.40",443,9,552,6,372,3,180,54420.481582,1.3080530000006547,2275.1371695172215,1100.872823959946
"147.32.84.165",20932,"184.173.217.40",443,9,552,6,372,3,180,54422.785465,1.3076440000004368,2275.8487784129366,1101.2171508449692
"147.32.84.165",20933,"184.173.217.40",443,9,552,6,372,3,180,54425.088748,1.3074169999963487,2276.2439221826785,1101.4083494432316
"147.32.84.165",20934,"184.173.217.40",443,9,552,6,372,3,180,54427.391545,1.3079090000028373,2275.387660757395,1100.9940293987397
"147.32.84.165",20935,"184.173.217.40",443,9,552,6,372,3,180,54429.695218,1.3073529999965103,2276.3553531509424,1101.4622676536817
"147.32.84.165",20936,"184.173.217.40",443,9,552,6,372,3,180,54431.998382,1.3076790000050096,2275.787865361912,1101.1876767880217
"147.32.84.165",20937,"184.173.217.40",443,9,552,6,372,3,180,54434.302081,1.3071789999958128,2276.658361256976,1101.608884479182
"147.32.84.165",20938,"184.173.217.40",443,9,552,6,372,3,180,54436.605194,1.3076519999958691,2275.8348551521362,1101.2104137832916
"147.32.84.165",20939,"184.173.217.40",443,9,552,6,372,3,180,54438.908485,1.307968000000983,2275.2850222618317,1100.9443656105636
"147.32.84.165",20940,"184.173.217.40",443,9,552,6,372,3,180,54441.211425,1.3097889999990002,2272.1216928850918,1099.4137223637542
"147.32.84.165",20941,"184.173.217.40",443,9,552,6,372,3,180,54443.514742,1.308562999998685,2274.250456418981,1100.4437692349907
"147.32.84.165",20942,"184.173.217.40",443,9,552,6,372,3,180,54445.818807,1.307143999998516,2276.719320903725,1101.6383810824477
"147.32.84.165",20943,"184.173.217.40",443,9,552,6,372,3,180,54448.121756,1.3079690000013215,2275.2832827054717,1100.9435238897443
"147.32.84.165",20944,"184.173.217.40",443,9,552,6,372,3,180,54450.424581,1.3077899999989313,2275.594705573855,1101.094212374446
"147.32.84.165",20945,"94.100.176.20",25,6,372,6,372,0,0,54451.598625,9.000996000002488,330.6300769380608,0
"147.32.84.165",20946,"184.173.217.40",443,9,552,6,372,3,180,54452.728674,1.3077520000006189,2275.660828657568,1101.1262074149522
"147.32.84.165",20947,"184.173.217.40",443,9,552,6,372,3,180,54455.031723,1.3071750000017346,2276.665327898752,1101.61225543488
"147.32.84.165",20948,"184.173.217.40",443,9,552,6,372,3,180,54457.334885,1.308059000002686,2275.1267335753887,1100.8677743106718
"147.32.84.165",20949,"184.173.217.40",443,9,552,6,372,3,180,54459.638184,1.3074399999968591,2276.203879342187,1101.3889738752518
"147.32.84.165",20950,"184.173.217.40",443,9,552,6,372,3,180,54461.94182,1.3074080000005779,2276.259591496063,1101.4159313690627
"147.32.84.165",20951,"184.173.217.40",443,9,552,6,372,3,180,54464.245156,1.3075500000049942,2276.012389574879,1101.2963175362318
"147.32.84.165",20952,"184.173.217.40",443,9,552,6,372,3,180,54466.548394,1.3078280000045197,2275.528586320002,1101.0622191870975
"147.32.84.165",20953,"184.173.217.40",443,9,552,6,372,3,180,54468.851729,1.3075600000011036,2275.9949830198907,1101.2878950096244
"147.32.84.165",20954,"184.173.217.40",443,9,552,6,372,3,180,54471.154792,1.307528999997885,2276.0489442335993,1101.3140052743222
"147.32.84.165",20955,"74.125.93.27",25,6,372,6,372,0,0,54472.617344,8.912064000003738,333.929379322091,0
"147.32.84.165",20956,"184.173.217.40",443,9,552,6,372,3,180,54473.458089,1.3075210000024526,2276.062870114069,1101.3207436035818
"147.32.84.165",20957,"184.173.217.40",443,9,552,6,372,3,180,54475.761374,1.3077059999995981,2275.7408775373933,1101.1649407439
"147.32.84.165",20958,"184.173.217.40",443,9,552,6,372,3,180,54478.064822,1.3077960000009625,2275.5842654342187,1101.089160693977
"147.32.84.165",20959,"184.173.217.40",443,9,552,6,372,3,180,54480.368384,1.3071490000002086,2276.7106121792735,1101.6341671835194
"147.32.84.165",20960,"184.173.217.40",443,9,552,6,372,3,180,54482.671067,1.307755999994697,2275.6538681620023,1101.122839433227
"147.32.84.165",20961,"184.173.217.40",443,9,552,6,372,3,180,54484.97476,1.307250000005297,2276.5347102604255,1101.5490533518189
"147.32.84.165",20962,"184.173.217.40",443,9,552,6,372,3,180,54487.277967,1.3078800000002957,2275.438113587888,1101.0184420586556
"147.32.84.165",20963,"184.173.217.40",443,9,552,6,372,3,180,54489.581066,1.307581000000937,2275.958430107097,1101.270208116337
"147.32.84.165",20964,"184.173.217.40",443,9,552,6,372,3,180,54491.88491,1.3072459999966668,2276.541676170811,1101.5524239536182
"147.32.84.165",20965,"74.125.39.27",25,6,372,6,372,0,0,54493.546606,9.012882999995782,330.194012282351,0
"147.32.84.165",20966,"184.173.217.40",443,9,552,6,372,3,180,54494.187489,1.308406999996805,2274.52161292875,1100.5749739977823
"147.32.84.165",20967,"184.173.217.40",443,9,552,6,372,3,180,54496.491238,1.3074399999968591,2276.203879342187,1101.3889738752518
"147.32.84.165",20968,"184.173.217.40",443,9,552,6,372,3,180,54498.794621,1.3074629999973695,2276.163837910509,1101.3695989889559
"147.32.84.165",20969,"184.173.217.40",443,9,552,6,372,3,180,54501.097684,1.3075660000031348,2275.9845392070956,1101.2828415518204
"147.32.84.165",20970,"184.173.217.40",443,9,552,6,372,3,180,54503.401321,1.3076980000041658,2275.754799648328,1101.1716772491911
"147.32.84.165",20971,"184.173.217.40",443,9,552,6,372,3,180,54505.704754,1.3073120000044582,2276.4267443348267,1101.4968117749163
"147.32.84.165",20972,"184.173.217.40",443,9,552,6,372,3,180,54508.007788,1.3075689999968745,2275.9793173493053,1101.280314846438
"147.32.84.165",20973,"184.173.217.40",443,9,552,6,372,3,180,54510.31106,1.3074110000015935,2276.254368363409,1101.4134040468107
"147.32.84.165",20974,"184.173.217.40",443,9,552,6,372,3,180,54512.614425,1.3078939999977592,2275.4137567762364,1101.0066565046304
"147.32.84.165",20975,"66.111.4.73",25,6,372,6,372,0,0,54514.577432,9.012747000000672,330.19899482364013,0
"147.32.84.165",20976,"184.173.217.40",443,9,552,6,372,3,180,54514.918343,1.3073389999990468,2276.379730125216,1101.4740629638143
"147.32.84.165",20977,"184.173.217.40",443,9,552,6,372,3,180,54517.220795,1.3082539999959408,2274.787617702093,1100.7036859848836
"147.32.84.165",20978,"184.173.217.40",443,9,552,6,372,3,180,54519.524076,1.3080560000016703,2275.131951534338,1100.8702991295183
"147.32.84.165",20979,"173.192.170.88",80,26,4084,18,1526,8,2558,54521.601544,44.3411300000007,275.32000199363,461.51282116625526
"147.32.84.165",20980,"184.173.217.40",443,9,552,6,372,3,180,54521.828033,1.3072840000022552,2276.475501876307,1101.520404133697
"147.32.84.165",20981,"173.192.170.88",80,35,4989,24,2328,11,2661,54522.830355,51.73223500000313,360.00764320348566,411.5035818575925
"147.32.84.165",20982,"184.173.217.40",443,9,552,6,372,3,180,54524.130929,1.3081660000025295,2274.9406420853666,1100.7777300413063
"147.32.84.165",20983,"184.173.217.40",443,9,552,6,372,3,180,54526.434143,1.3076930000024731,2275.763501062078,1101.1758876106828
"147.32.84.165",20984,"184.173.217.40",443,9,552,6,372,3,180,54528.737535,1.307888000003004,2275.4241953387177,1101.0117074219602
"147.32.84.165",20986,"184.173.217.40",443,9,552,6,372,3,180,54531.041223,1.3073409999997239,2276.376247666545,1101.472377903167
"147.32.84.165",20987,"184.173.217.40",443,9,552,6,372,3,180,54533.344088,1.3081200000015087,2275.0206403056045,1100.8164388575506
"147.32.84.165",20988,"216.157.130.15",25,6,372,6,372,0,0,54535.607709,9.010670999996364,330.2750705248478,0
"147.32.84.165",20989,"184.173.217.40",443,9,552,6,372,3,180,54535.647935,1.3070069999957923,2276.9579658024636,1101.753854420547
"147.32.84.165",20990,"184.173.217.40",443,9,552,6,372,3,180,54537.951502,1.3069919999979902,2276.9840978403663,1101.766498955016
"147.32.84.165",20992,"184.173.217.40",443,9,552,6,372,3,180,54540.254088,1.2989509999970323,2291.079494150895,1108.5868520084975
"147.32.84.165",20994,"98.126.71.122",80,18,4843,14,1410,4,3433,54540.706406,20.101086000002397,561.1637102591699,1366.2943385246313
"147.32.84.165",20995,"95.100.248.96",80,17,5720,12,2516,5,3204,54541.27686,19.530875000004016,1030.5733870088186,1312.3835977648073
"147.32.84.165",20996,"195.113.232.99",80,60,44454,48,3984,12,40470,54541.540421,19.267496000000392,1654.1848510049958,16803.42894582635
"147.32.84.165",20997,"184.173.217.40",443,9,552,6,372,3,180,54542.552881,1.3088129999960074,2273.816045538269,1100.233570421743
"147.32.84.165",20998,"184.173.217.40",443,9,552,6,372,3,180,54544.862277,1.3069640000030631,2277.03287924765,1101.790102861766
"147.32.84.165",20999,"184.173.217.40",443,9,552,6,372,3,180,54547.169511,1.3070989999978337,2276.7977023966296,1101.6763076112725
"147.32.84.165",21001,"95.100.248.97",80,13,3281,10,1608,3,1673,54549.324205,20.070245000002615,640.9488274805975,666.8578285914425
"147.32.84.165",21002,"195.113.232.99",80,16,2078,12,1644,4,434,54549.452206,19.942447000001266,659.4978038552222,174.10100174766816
"147.32.84.165",21003,"184.173.217.40",443,9,552,6,372,3,180,54549.478163,1.306750000003376,2277.4057776868653,1101.9705375904186
"147.32.84.165",21004,"184.173.217.40",443,9,552,6,372,3,180,54551.785475,1.3062750000026426,2278.233909394254,1102.3712464810908
"147.32.84.165",21005,"184.173.217.40",443,9,552,6,372,3,180,54554.091324,1.3079949999955716,2275.238055199046,1100.9216396124414
"147.32.84.165",21006,"184.173.217.40",443,9,552,6,372,3,180,54556.399945,1.306931999999506,2277.0886320031377,1101.8170800015184
"147.32.84.165",21007,"184.173.217.40",443,9,552,6,372,3,180,54558.707621,1.306246000000101,2278.284488526487,1102.395720254752
"147.32.84.165",21008,"184.173.217.40",443,9,552,6,372,3,180,54561.014697,1.3067680000021937,2277.3744076951716,1101.9553585621798
"147.32.84.165",21009,"184.173.217.40",443,9,552,6,372,3,180,54563.321047,1.3075430000026245,2276.024574330654,1101.3022133858005
"147.32.84.165",21010,"184.173.217.40",443,9,552,6,372,3,180,54565.628337,1.309688000001188,2272.296913461298,1099.4985065135313
"147.32.84.165",21011,"173.192.170.88",80,14,2337,10,966,4,1371,54565.742289,0.43011899999692105,17967.12072718322,25499.91978982215
"147.32.84.165",21012,"173.192.170.88",80,11,1283,8,846,3,437,54566.173348,2.957564000003913,2288.3697529423016,1182.053879474924
"147.32.84.165",21013,"184.173.217.40",443,9,552,6,372,3,180,54567.938515,1.3085729999947944,2274.233076803387,1100.4353597435745
"147.32.84.165",21014,"184.173.217.40",443,9,552,6,372,3,180,54570.265657,1.3823989999946207,2152.779335062873,1041.6674201917126
"147.32.84.165",21015,"147.32.84.171",139,33,4810,22,3278,11,1532,54571.200936,0.01628299999720184,1610514.0333173538,752686.8514466706
"147.32.84.165",21016,"184.173.217.40",443,9,552,6,372,3,180,54572.64868,1.3179410000011558,2258.0676980209205,1092.6134022681874
"147.32.84.165",21017,"173.192.170.88",80,14,2337,10,966,4,1371,54574.361749,0.46339199999783887,16677.025067407383,23668.9455149229
"147.32.84.165",21018,"173.192.170.88",80,11,1283,8,846,3,437,54574.826003,3.407796999999846,1986.0337925059227,1025.8827036939576
"147.32.84.165",21019,"184.173.217.40",443,9,552,6,372,3,180,54574.961722,1.3083059999989928,2274.697203866902,1100.6599373549525
"147.32.84.165",21020,"184.173.217.40",443,9,552,6,372,3,180,54577.265326,1.3075879999960307,2275.9462460721834,1101.2643126155726
"147.32.84.165",21021,"184.173.217.40",443,9,552,6,372,3,180,54579.568389,1.3080120000013267,2275.2084843235243,1100.907331124286
"147.32.84.165",21022,"184.173.217.40",443,9,552,6,372,3,180,54581.871616,1.3081789999996545,2274.918034917841,1100.7667910892778
"147.32.84.165",21023,"184.173.217.40",443,9,552,6,372,3,180,54584.175635,1.3073090000034426,2276.4319682585856,1101.4993394799608
"147.32.84.165",21024,"184.173.217.40",443,9,552,6,372,3,180,54586.478404,1.3083679999981541,2274.5894121563647,1100.6077800756605
"147.32.84.165",21025,"184.173.217.40",443,9,552,6,372,3,180,54588.781489,1.3084860000017215,2274.384288403609,1100.5085266469075
"147.32.84.165",21026,"184.173.217.40",443,9,552,6,372,3,180,54591.084836,1.3080419999969308,2275.156302325906,1100.8820817705998
"147.32.84.165",21027,"184.173.217.40",443,9,552,6,372,3,180,54593.388138,1.3077899999989313,2275.594705573855,1101.094212374446
"147.32.84.165",21028,"184.173.217.40",443,9,552,6,372,3,180,54595.6916,1.307927000001655,2275.3563463375513,1100.9788772601055
"147.32.84.165",21029,"184.173.217.40",443,9,552,6,372,3,180,54597.995442,1.307451000000583,2276.1847289104317,1101.3797075373056
"147.32.84.165",21030,"184.173.217.40",443,9,552,6,372,3,180,54600.298459,1.307224000003771,2276.5799893449134,1101.5709625862485
"147.32.84.165",21031,"184.173.217.40",443,9,552,6,372,3,180,54602.601426,1.3082109999959357,2274.8623884138306,1100.739865361531
"147.32.84.165",21032,"184.173.217.40",443,9,552,6,372,3,180,54604.904768,1.3079759999964153,2275.2711058980867,1100.9376318861712
"147.32.84.165",21033,"184.173.217.40",443,9,552,6,372,3,180,54607.208692,1.3071340000024065,2276.7367385398293,1101.646808970885
"147.32.84.165",21034,"184.173.217.40",443,9,552,6,372,3,180,54609.511616,1.3081339999989723,2274.9962924305446,1100.804657627683
"147.32.84.165",21035,"184.173.217.40",443,9,552,6,372,3,180,54611.815187,1.3075249999965308,2276.055907158866,1101.3173744317094
"147.32.84.165",21036,"184.173.217.40",443,9,552,6,372,3,180,54614.11862,1.3074419999975362,2276.2003974215363,1101.387289074937
"147.32.84.165",21037,"184.173.217.40",443,9,552,6,372,3,180,54616.421583,1.307517999994161,2276.0680923805944,1101.3232705067392
"147.32.84.165",21038,"184.173.217.40",443,9,552,6,372,3,180,54618.724674,1.3075470000039786,2276.0176115970935,1101.298844321174
"147.32.84.165",21039,"184.173.217.40",443,9,552,6,372,3,180,54621.028319,1.3080770000015036,2275.095426336966,1100.8526256469188
"147.32.84.165",21040,"184.173.217.40",443,9,552,6,372,3,180,54623.331469,1.3081830000010086,2274.911078952796,1100.76342529974
"147.32.84.165",21041,"184.173.217.40",443,9,552,6,372,3,180,54625.634965,1.3078930000046967,2275.4154965194502,1101.007498315863
"147.32.84.165",21042,"184.173.217.40",443,9,552,6,372,3,180,54627.93826,1.3080659999977797,2275.1145584435735,1100.861883117858
"147.32.84.165",21043,"184.173.217.40",443,9,552,6,372,3,180,54630.241423,1.3080820000031963,2275.086730031243,1100.8484177570529
"147.32.84.165",21044,"184.173.217.40",443,9,552,6,372,3,180,54632.544427,1.3082649999996647,2274.7684910937483,1100.6944311743944
"147.32.84.165",21045,"184.173.217.40",443,9,552,6,372,3,180,54634.84766,1.3080820000031963,2275.086730031243,1100.8484177570529
"147.32.84.165",21046,"184.173.217.40",443,9,552,6,372,3,180,54637.151554,1.3074330000017653,2276.2160661356884,1101.394870710817
"147.32.84.165",21047,"184.173.217.40",443,9,552,6,372,3,180,54639.454968,1.3079340000040247,2275.344168735458,1100.9729848719958
"147.32.84.165",21048,"184.173.217.40",443,9,552,6,372,3,180,54641.757898,1.3082909999939147,2274.723284050599,1100.6725567986769
"147.32.84.165",21049,"184.173.217.40",443,9,552,6,372,3,180,54644.061207,1.3081610000008368,2274.949337274308,1100.7819373907944
"147.32.84.165",21050,"184.173.217.40",443,9,552,6,372,3,180,54646.364596,1.3081220000021858,2275.0171620040237,1100.8147558083986
"147.32.84.165",21051,"184.173.217.40",443,9,552,6,372,3,180,54648.667779,1.3082549999962794,2274.785878906225,1100.7028446320444
"147.32.84.165",21052,"184.173.217.40",443,9,552,6,372,3,180,54650.971517,1.3075300000054995,2276.047203496274,1101.313162982068
"147.32.84.165",21053,"184.173.217.40",443,9,552,6,372,3,180,54653.274672,1.3077239999984158,2275.7095533947568,1101.1497839006888
"147.32.84.165",21054,"184.173.217.40",443,9,552,6,372,3,180,54655.578562,1.3067669999945792,2277.3761504632007,1101.9562018370325
"147.32.84.165",21055,"184.173.217.40",443,9,552,6,372,3,180,54657.881474,1.3070689999949536,2276.849959727826,1101.70159341669
"147.32.84.165",21056,"184.173.217.40",443,9,552,6,372,3,180,54660.184248,1.3085150000042631,2274.3338822942833,1100.484136594008
"147.32.84.165",21057,"184.173.217.40",443,9,552,6,372,3,180,54662.487888,1.307901000000129,2275.4015785596207,1101.0007638191714
"147.32.84.165",21058,"184.173.217.40",443,9,552,6,372,3,180,54664.791198,1.3073330000042915,2276.390177552491,1101.4791181705602
"147.32.84.165",21059,"184.173.217.40",443,9,552,6,372,3,180,54667.09471,1.3076970000038273,2275.756539925755,1101.1725193189138
"147.32.84.165",21060,"184.173.217.40",443,9,552,6,372,3,180,54669.397913,1.3076880000007804,2275.7722025423677,1101.1800980043715
"147.32.84.165",21061,"184.173.217.40",443,9,552,6,372,3,180,54671.700709,1.3084790000066278,2274.3964557206696,1100.5144140583884
"147.32.84.165",21062,"184.173.217.40",443,9,552,6,372,3,180,54674.004253,1.3081450000026962,2274.977162312944,1100.7954011191664
"147.32.84.165",21063,"184.173.217.40",443,9,552,6,372,3,180,54676.307317,1.3088100000022678,2273.8212574742274,1100.236092326239
"147.32.84.165",21064,"94.100.176.20",25,6,372,6,372,0,0,54676.739059,8.942111000003933,332.8073203294715,0
"147.32.84.165",21065,"184.173.217.40",443,9,552,6,372,3,180,54678.610938,1.3082890000005136,2274.7267614409598,1100.674239406916
"147.32.84.165",21066,"184.173.217.40",443,9,552,6,372,3,180,54680.914083,1.3083599999954458,2274.6033201950218,1100.614509771785
"147.32.84.165",21067,"184.173.217.40",443,9,552,6,372,3,180,54683.217405,1.3080419999969308,2275.156302325906,1100.8820817705998
"147.32.84.165",21068,"184.173.217.40",443,9,552,6,372,3,180,54685.520606,1.3084080000044196,2274.519874526866,1100.5741328355803
"147.32.84.165",21069,"184.173.217.40",443,9,552,6,372,3,180,54687.823949,1.3080410000038682,2275.1580416754514,1100.8829233913475
"147.32.84.165",21070,"184.173.217.40",443,9,552,6,372,3,180,54690.127788,1.3078650000024936,2275.4642107513587,1101.0310697183995
"147.32.84.165",21071,"184.173.217.40",443,9,552,6,372,3,180,54692.431051,1.3075150000004214,2276.0733146457524,1101.325797409235
"147.32.84.165",21072,"184.173.217.40",443,9,552,6,372,3,180,54694.734331,1.3078789999999572,2275.4398533810067,1101.0192838940354
"147.32.84.165",21073,"184.173.217.40",443,9,552,6,372,3,180,54697.037719,1.3075519999983953,2276.008908252714,1101.2946330255065
"147.32.84.165",21074,"74.125.93.27",25,6,372,6,372,0,0,54697.698494,9.013027000000875,330.1887368139151,0
"147.32.84.165",21075,"184.173.217.40",443,9,552,6,372,3,180,54699.34066,1.3080259999987902,2275.1841324276065,1100.8955479488418
"147.32.84.165",21076,"184.173.217.40",443,9,552,6,372,3,180,54701.64375,1.3083059999989928,2274.697203866902,1100.6599373549525
"147.32.84.165",21077,"184.173.217.40",443,9,552,6,372,3,180,54703.947262,1.3079989999969257,2275.2310972768287,1100.918272875885
"147.32.84.165",21078,"184.173.217.40",443,9,552,6,372,3,180,54706.25077,1.3082020000001648,2274.8780387123893,1100.74743808664
"147.32.84.165",21079,"184.173.217.40",443,9,552,6,372,3,180,54708.554156,1.3078180000011344,2275.5459857544543,1101.0706382682843
"147.32.84.165",21080,"184.173.217.40",443,9,552,6,372,3,180,54710.857068,1.3480620000045747,2207.6135963997954,1068.2001272902235
"147.32.84.165",21081,"184.173.217.40",443,9,552,6,372,3,180,54713.200749,1.3675269999948796,2176.1910368213153,1052.9956629780559
"147.32.84.165",21082,"184.173.217.40",443,9,552,6,372,3,180,54715.563989,1.307926999994379,2275.356346350209,1100.9788772662303
"147.32.84.165",21083,"184.173.217.40",443,9,552,6,372,3,180,54717.867264,1.3082439999998314,2274.805005794319,1100.7120995778964
"147.32.84.165",21084,"74.125.39.27",25,6,372,6,372,0,0,54718.728455,8.912959000001138,333.89584760791786,0
"147.32.84.165",21085,"184.173.217.40",443,9,552,6,372,3,180,54720.17045,1.3077990000019781,2275.579045400324,1101.0866348711247
"147.32.84.165",21086,"184.173.217.40",443,9,552,6,372,3,180,54722.474118,1.3078650000024936,2275.4642107513587,1101.0310697183995
"147.32.84.165",21087,"184.173.217.40",443,9,552,6,372,3,180,54724.777014,1.3082510000022012,2274.7928340929934,1100.7062100449969
"147.32.84.165",21088,"184.173.217.40",443,9,552,6,372,3,180,54727.080435,1.3076039999941713,2275.918397323093,1101.2508374143997
"147.32.84.165",21089,"184.173.217.40",443,9,552,6,372,3,180,54729.383638,1.3081460000030347,2274.975423227297,1100.7945596261115
"147.32.84.165",21090,"184.173.217.40",443,9,552,6,372,3,180,54731.687613,1.3072209999954794,2276.5852139846984,1101.5734906377575
"147.32.84.165",21091,"184.173.217.40",443,9,552,6,372,3,180,54733.990231,1.3078269999969052,2275.530326264133,1101.0630610955482
"147.32.84.165",21092,"184.173.217.40",443,9,552,6,372,3,180,54736.293631,1.3078400000013062,2275.5077073625425,1101.0521164657464
"147.32.84.165",21093,"184.173.217.40",443,9,552,6,372,3,180,54738.596954,1.307797000001301,2275.5825254202596,1101.0883187517386
"147.32.84.165",21094,"66.111.4.73",25,6,372,6,372,0,0,54739.658843,9.012339000000793,330.2139433503043,0
"147.32.84.165",21095,"184.173.217.40",443,9,552,6,372,3,180,54740.900564,1.3077199999970617,2275.716514243635,1101.153152053372
"147.32.84.165",21096,"184.173.217.40",443,9,552,6,372,3,180,54743.203578,1.3081139999994775,2275.031075274165,1100.8214880358862
"147.32.84.165",21097,"184.173.217.40",443,9,552,6,372,3,180,54745.507363,1.3076280000022962,2275.876625458291,1101.2306252217538
"147.32.84.165",21098,"184.173.217.40",443,9,552,6,372,3,180,54747.810364,1.307597999999416,2275.9288405162206,1101.2558905723647
"147.32.84.165",21099,"184.173.217.40",443,9,552,6,372,3,180,54750.113479,1.307941999999457,2275.330251648189,1100.9662507975108
"147.32.84.165",21100,"184.173.217.40",443,9,552,6,372,3,180,54752.417432,1.3076549999968847,2275.8296339685085,1101.207887404117
"147.32.84.165",21101,"184.173.217.40",443,9,552,6,372,3,180,54754.720509,1.307874999998603,2275.446812580085,1101.0226512484282
"147.32.84.165",21102,"184.173.217.40",443,9,552,6,372,3,180,54757.023621,1.3079050000014831,2275.3946196372253,1100.9973965986574
"147.32.84.165",21103,"184.173.217.40",443,9,552,6,372,3,180,54759.327434,1.3072580000007292,2276.5207786055544,1101.542312228494
"147.32.84.165",21104,"216.157.130.15",25,6,372,6,372,0,0,54760.689318,9.012485999999626,330.20855732814715,0
"147.32.84.165",21105,"184.173.217.40",443,9,552,6,372,3,180,54761.630136,1.3082369999974617,2274.8171776258996,1100.7179891738224
"147.32.84.165",21106,"184.173.217.40",443,9,552,6,372,3,180,54763.933548,1.307903000000806,2275.3980990931022,1100.9990802063398
"147.32.84.165",21107,"184.173.217.40",443,9,552,6,372,3,180,54766.236858,1.3079130000041914,2275.38070192013,1100.9906622194178
"147.32.84.165",21108,"184.173.217.40",443,9,552,6,372,3,180,54768.539926,1.3082030000005034,2274.8762997782874,1100.7465966669133
"147.32.84.165",21109,"184.173.217.40",443,9,552,6,372,3,180,54770.844058,1.3078249999962281,2275.5338061350585,1101.0647449040605
"147.32.84.165",21110,"184.173.217.40",443,9,552,6,372,3,180,54773.146567,1.308045999998285,2275.1493449036975,1100.8787152759826
"147.32.84.165",21111,"184.173.217.40",443,9,552,6,372,3,180,54775.450184,1.3075840000019525,2275.953208356447,1101.2676814627969
"147.32.84.165",21112,"184.173.217.40",443,9,552,6,372,3,180,54777.753518,1.3080000000045402,2275.2293577902674,1100.9174311888391
"147.32.84.165",21113,"184.173.217.40",443,9,552,6,372,3,180,54780.057077,1.30718500000512,2276.647911342575,1101.603828068988
"147.32.84.165",21114,"184.173.217.40",443,9,552,6,372,3,180,54782.359784,1.3079880000004778,2275.25023165267,1100.9275314448405
"147.32.84.165",21115,"184.173.217.40",443,9,552,6,372,3,180,54784.663414,1.4080969999995432,2113.490760935479,1022.6568198074899
"147.32.84.165",21116,"184.173.217.40",443,9,552,6,372,3,180,54787.06658,1.3080909999989672,2275.071076861128,1100.8408436424813
"147.32.84.165",21117,"184.173.217.40",443,9,552,6,372,3,180,54789.369954,1.3081119999988005,2275.0345536182904,1100.8231711056244
"147.32.84.165",21118,"184.173.217.40",443,9,552,6,372,3,180,54791.673531,1.2076210000013816,2464.3493281390397,1192.4270942608257
"147.32.84.165",21119,"184.173.217.40",443,9,552,6,372,3,180,54793.876548,1.3083570000017062,2274.6085357407183,1100.6170334229282
"147.32.84.165",21120,"184.173.217.40",443,9,552,6,372,3,180,54796.179906,1.3077980000016396,2275.5807854089617,1101.0874768107878
"147.32.84.165",21121,"184.173.217.40",443,9,552,6,372,3,180,54798.483169,1.3080750000008265,2275.0989048778697,1100.8543088118724
"147.32.84.165",21122,"184.173.217.40",443,9,552,6,372,3,180,54800.786286,1.3085169999976642,2274.330406105012,1100.4824545669414
"147.32.84.165",21123,"184.173.217.40",443,9,552,6,372,3,180,54803.090356,1.3080919999993057,2275.069337631894,1100.8400020799488
"147.32.84.165",21124,"184.173.217.40",443,9,552,6,372,3,180,54805.393571,1.3077370000028168,2275.686930929988,1101.1388375467684
"147.32.84.165",21125,"184.173.217.40",443,9,552,6,372,3,180,54807.696582,1.3081760000059148,2274.9232519068873,1100.7693154388164
"147.32.84.165",21126,"184.173.217.40",443,9,552,6,372,3,180,54809.999602,1.3109309999999823,2270.1423644723027,1098.4559828091787
"147.32.84.165",21127,"184.173.217.40",443,9,552,6,372,3,180,54812.302942,1.3080340000014985,2275.1702172853234,1100.888814815479
"147.32.84.165",21128,"184.173.217.40",443,9,552,6,372,3,180,54814.606196,1.3078939999977592,2275.4137567762364,1101.0066565046304
"147.32.84.165",21129,"184.173.217.40",443,9,552,6,372,3,180,54816.909979,1.3082630000062636,2274.771968622327,1100.6961138495133
"147.32.84.165",21130,"184.173.217.40",443,9,552,6,372,3,180,54819.213062,1.3081009999950766,2275.053684701106,1100.8324280811803
"147.32.84.165",21131,"184.173.217.40",443,9,552,6,372,3,180,54821.516383,1.3079209999996237,2275.36678438595,1100.9839279286855
"147.32.84.165",21132,"173.192.170.88",80,28,4330,20,1650,8,2680,54821.524646,48.861134999999194,270.15336422291904,438.79455522268063
"147.32.84.165",21133,"184.173.217.40",443,9,552,6,372,3,180,54823.820692,1.3068760000023758,2277.1862058792035,1101.8642931673564
"147.32.84.165",21134,"184.173.217.40",443,9,552,6,372,3,180,54826.123391,1.3074199999973644,2276.238699121934,1101.4058221557746
"147.32.84.165",21135,"184.173.217.40",443,9,552,6,372,3,180,54828.426492,1.3076920000021346,2275.7652413528126,1101.1767296868447
"147.32.84.165",21136,"184.173.217.40",443,9,552,6,372,3,180,54830.729845,1.3079599999982747,2275.2989388084693,1100.951099423453
"147.32.84.165",21137,"184.173.217.40",443,9,552,6,372,3,180,54833.0329,1.3079930000021704,2275.2415341634564,1100.9233229823176
"147.32.84.165",21139,"184.173.217.40",443,9,552,6,372,3,180,54835.336122,1.308098000001337,2275.0589023123334,1100.8349527317741
"147.32.84.165",21140,"184.173.217.40",443,9,552,6,372,3,180,54837.63943,1.307567999996536,2275.981057970128,1101.2811570823199
"147.32.84.165",21141,"184.173.217.40",443,9,552,6,372,3,180,54839.94277,1.3076729999957024,2275.798307382488,1101.1927293786232
"147.32.84.165",21142,"184.173.217.40",443,9,552,6,372,3,180,54842.246004,1.308285999999498,2274.7319775654114,1100.6767633381023
"147.32.84.165",21144,"98.126.71.122",80,18,4965,14,1532,4,3433,54844.213278,16.530636999996204,741.4112353929745,1661.3999811384344
"147.32.84.165",21145,"184.173.217.40",443,9,552,6,372,3,180,54844.549543,1.3006769999992684,2288.0392288029034,1107.1157558723726
"147.32.84.165",21146,"95.100.248.96",80,17,6178,12,2760,5,3418,54844.780291,31.543245999993815,699.9913705775344,866.8733712442074
"147.32.84.165",21147,"195.113.232.83",80,22,13602,18,2290,4,11312,54845.02686,31.296863000003214,585.3621815067573,2891.5358066394933
"147.32.84.165",21148,"77.238.175.247",80,14,2274,10,1276,4,998,54845.079719,0.19166799999948125,53258.75993920544,41655.362397591714
"147.32.84.165",21149,"64.236.79.229",80,14,2366,10,1652,4,714,54845.121412,0.37169600000197534,35555.93818585555,15367.39701253079
"147.32.84.165",21150,"74.125.232.217",80,13,1871,10,1156,3,715,54845.152112,31.171920999993745,296.6772564322185,183.49847608048114
"147.32.84.165",21151,"68.67.179.212",80,16,2170,12,1370,4,800,54845.178325,15.565318000000843,704.1295269392765,411.1705266798695
"147.32.84.165",21152,"64.236.79.229",80,14,2170,10,1470,4,700,54845.197715,0.3556989999997313,33061.66168588858,15743.648421851707
"147.32.84.165",21153,"64.236.79.229",80,14,2153,10,1496,4,657,54845.254442,0.35541200000443496,33673.59571384945,14788.470844919175
"147.32.84.165",21154,"77.238.167.32",80,13,2342,10,1390,3,952,54845.294395,0.14090800000121817,78916.7399998855,54049.45070495755
"147.32.84.165",21155,"64.236.79.229",80,14,2135,10,1478,4,657,54845.33649,0.35538200000155484,33271.24052413535,14789.719231635267
"147.32.84.165",21156,"77.238.175.247",80,14,3055,10,1368,4,1687,54845.38978,0.1410050000049523,77614.26899482735,95712.91797827027
"147.32.84.165",21157,"195.113.232.96",80,13,1965,10,1306,3,659,54845.394599,30.92961600000126,337.7992148366657,170.45151805311082
"147.32.84.165",21158,"74.217.252.37",80,12,2075,10,1278,2,797,54845.467393,30.856996000002255,331.33491024204864,206.63061303827288
"147.32.84.165",21159,"64.236.79.229",80,14,2181,10,1524,4,657,54845.503438,0.3554890000013984,34296.41986095784,14785.26761722395
"147.32.84.165",21160,"184.173.217.40",443,9,552,6,372,3,180,54846.851838,1.306362999996054,2278.080441660541,1102.2969879002617
"147.32.84.165",21161,"184.173.217.40",443,9,552,6,372,3,180,54849.159012,1.3065580000038608,2277.740444734337,1102.1324732585501
"147.32.84.165",21162,"184.173.217.40",443,9,552,6,372,3,180,54851.465156,1.2077209999988554,2464.1452785890287,1192.3283606075945
"147.32.84.165",21163,"184.173.217.40",443,9,552,6,372,3,180,54853.67246,1.3080149999950663,2275.2032660261734,1100.9048061416968
"147.32.84.165",21164,"184.173.217.40",443,9,552,6,372,3,180,54855.980538,1.307433999994828,2276.2143251680563,1101.394028307124
"147.32.84.165",21165,"184.173.217.40",443,9,552,6,372,3,180,54858.287937,1.30730400000175,2276.4406748514625,1101.503552347482
"147.32.84.165",21166,"184.173.217.40",443,9,552,6,372,3,180,54860.59526,1.307091999995464,2276.8098955623077,1101.6822075301488
"147.32.84.165",21167,"184.173.217.40",443,9,552,6,372,3,180,54862.90268,1.3070500000030734,2276.8830572610095,1101.7176083521013
"147.32.84.165",21168,"184.173.217.40",443,9,552,6,372,3,180,54865.210635,1.3063469999979134,2278.1083433457984,1102.3104887157087
"147.32.84.165",21169,"184.173.217.40",443,9,552,6,372,3,180,54867.516575,1.3079999999972642,2275.229357802924,1100.9174311949632
"147.32.84.165",21170,"184.173.217.40",443,9,552,6,372,3,180,54869.82499,1.3063600000023143,2278.0856731641566,1102.299519272979
"147.32.84.165",21171,"173.192.170.88",80,16,2819,12,1448,4,1371,54870.185277,4.743570000006002,2442.0425966066364,2312.182596648963
"147.32.84.165",21172,"184.173.217.40",443,9,552,6,372,3,180,54872.131309,1.3078610000011395,2275.4711700994276,1101.0344371448841
"147.32.84.165",21173,"184.173.217.40",443,9,552,6,372,3,180,54874.439828,1.3068359999961103,2277.255906639286,1101.89801934159
"147.32.84.165",21174,"173.192.170.88",80,15,3205,10,966,5,2239,54874.873854,1.3487539999987348,5729.732775589358,13280.405470543037
"147.32.84.165",21175,"184.173.217.40",443,9,552,6,372,3,180,54876.764334,1.2978090000033262,2293.095517131082,1109.5623469989107
"147.32.84.165",21176,"184.173.217.40",443,9,552,6,372,3,180,54879.058016,1.3075649999955203,2275.98627984857,1101.2836837976952
"147.32.84.165",21177,"184.173.217.40",443,9,552,6,372,3,180,54881.361649,1.3071970000019064,2276.6270118395773,1101.593715406247
"147.32.84.165",21178,"184.173.217.40",443,9,552,6,372,3,180,54883.664966,1.3073180000064895,2276.416296559236,1101.4917563996303
"147.32.84.165",21179,"184.173.217.40",443,9,552,6,372,3,180,54885.967606,1.3085590000046068,2274.2574083320073,1100.4471330638744
"147.32.84.165",21180,"184.173.217.40",443,9,552,6,372,3,180,54888.271001,1.3082070000018575,2274.869344068465,1100.74323100087
"147.32.84.165",21181,"184.173.217.40",443,9,552,6,372,3,180,54890.57463,1.2072989999942365,2465.0065973832557,1192.7451277660914
"147.32.84.165",21182,"184.173.217.40",443,9,552,6,372,3,180,54892.777617,1.307703999998921,2275.744358052323,1101.1666248640274
"147.32.84.165",21183,"184.173.217.40",443,9,552,6,372,3,180,54895.080991,1.3079999999972642,2275.229357802924,1100.9174311949632
"147.32.84.165",21184,"184.173.217.40",443,9,552,6,372,3,180,54897.384085,1.3080140000020037,2275.2050054475267,1100.9056477971903
"147.32.84.165",21185,"184.173.217.40",443,9,552,6,372,3,180,54899.687522,1.3152130000016768,2262.7513566214793,1094.8796886878126
"147.32.84.165",21186,"94.100.176.20",25,6,372,6,372,0,0,54901.87196,8.9919910000026,330.96118534806584,0
"147.32.84.165",21187,"184.173.217.40",443,9,552,6,372,3,180,54902.000993,1.297606000000087,2293.4542534481193,1109.7359290877996
"147.32.84.165",21188,"184.173.217.40",443,9,552,6,372,3,180,54904.294567,1.3072090000059688,2276.606112707617,1101.5836029230404
"147.32.84.165",21189,"184.173.217.40",443,9,552,6,372,3,180,54906.597549,1.3080939999999828,2275.065859181404,1100.8383189587437
"147.32.84.165",21190,"184.173.217.40",443,9,552,6,372,3,180,54908.900887,1.3075639999951818,2275.9880204800425,1101.2845260387303
"147.32.84.165",21191,"184.173.217.40",443,9,552,6,372,3,180,54911.204072,1.3077839999969,2275.6051458092884,1101.0992641012685
"147.32.84.165",21192,"184.173.217.40",443,9,552,6,372,3,180,54913.507522,1.3077340000018012,2275.6921514588603,1101.1413636091258
"147.32.84.165",21193,"184.173.217.40",443,9,552,6,372,3,180,54915.81074,1.3080780000018422,2275.0936870705027,1100.8517840663721
"147.32.84.165",21194,"184.173.217.40",443,9,552,6,372,3,180,54918.114226,1.3073900000017602,2276.2909307826994,1101.4310955400158
"147.32.84.165",21195,"184.173.217.40",443,9,552,6,372,3,180,54920.417734,1.3076489999948535,2275.840076359721,1101.2129401740585
"147.32.84.165",21196,"184.173.217.40",443,9,552,6,372,3,180,54922.720579,1.3085619999983464,2274.2521943964143,1100.4446101918134
"147.32.84.165",21197,"74.125.93.27",25,6,372,6,372,0,0,54922.880739,9.013353000002098,330.1767943626869,0
"147.32.84.165",21198,"184.173.217.40",443,9,552,6,372,3,180,54925.02404,1.30754600000364,2276.01935227649,1101.2996865853984
"147.32.84.165",21199,"184.173.217.40",443,9,552,6,372,3,180,54927.327375,1.3074239999987185,2276.2317350782278,1101.4024524572071
"147.32.84.165",21200,"184.173.217.40",443,9,552,6,372,3,180,54929.63059,1.3082720000020345,2274.7563197831737,1100.6885418305678
"147.32.84.165",21201,"184.173.217.40",443,9,552,6,372,3,180,54931.933747,1.3107959999979357,2270.3761683776015,1098.5691137310976
"147.32.84.165",21202,"184.173.217.40",443,9,552,6,372,3,180,54934.237234,1.307754000001296,2275.657348398132,1101.124523418451
"147.32.84.165",21203,"184.173.217.40",443,9,552,6,372,3,180,54936.540624,1.3077589999957127,2275.6486478087754,1101.120313455859
"147.32.84.165",21204,"184.173.217.40",443,9,552,6,372,3,180,54938.844302,1.3070520000037504,2276.879573262166,1101.7159225462094
"147.32.84.165",21205,"184.173.217.40",443,9,552,6,372,3,180,54941.147055,1.3080449999979464,2275.1510842552607,1100.8795568977066
"147.32.84.165",21206,"184.173.217.40",443,9,552,6,372,3,180,54943.450486,1.3077889999985928,2275.596445606441,1101.0950543256974
"147.32.84.165",21207,"74.125.39.27",25,6,372,6,372,0,0,54943.911294,9.012548999999126,330.20624908672215,0
"147.32.84.165",21208,"184.173.217.40",443,9,552,6,372,3,180,54945.754086,1.307848999997077,2275.4920483990513,1101.0445395479283
"147.32.84.165",21209,"184.173.217.40",443,9,552,6,372,3,180,54948.057413,1.307966000000306,2275.288501382531,1100.9460490560634
"147.32.84.165",21210,"184.173.217.40",443,9,552,6,372,3,180,54950.360737,1.3075909999970463,2275.941024377441,1101.2617859890843
"147.32.84.165",21211,"184.173.217.40",443,9,552,6,372,3,180,54952.663966,1.307872999997926,2275.4502921955873,1101.0243349333487
"147.32.84.165",21212,"184.173.217.40",443,9,552,6,372,3,180,54954.967494,1.3077489999996033,2275.666049066681,1101.1287334193617
"147.32.84.165",21213,"184.173.217.40",443,9,552,6,372,3,180,54957.270351,1.3077520000006189,2275.660828657568,1101.1262074149522
"147.32.84.165",21214,"184.173.217.40",443,9,552,6,372,3,180,54959.573485,1.3077219999977387,2275.713033813873,1101.1514679744548
"147.32.84.165",21215,"184.173.217.40",443,9,552,6,372,3,180,54961.877354,1.3075840000019525,2275.953208356447,1101.2676814627969
"147.32.84.165",21216,"184.173.217.40",443,9,552,6,372,3,180,54964.180201,1.3078309999982594,2275.5233665542114,1101.0596934939733
"147.32.84.165",21217,"66.111.4.73",25,6,372,6,372,0,0,54964.841474,9.013011000002734,330.1893229686613,0
"147.32.84.165",21218,"184.173.217.40",443,9,552,6,372,3,180,54966.483901,1.3073870000007446,2276.2961540831484,1101.4336229434589
"147.32.84.165",21219,"184.173.217.40",443,9,552,6,372,3,180,54968.786847,1.3077069999999367,2275.7391372839206,1101.164098685768
"147.32.84.165",21220,"184.173.217.40",443,9,552,6,372,3,180,54971.09009,1.3082250000006752,2274.83804391329,1100.7280857644953
"147.32.84.165",21221,"184.173.217.40",443,9,552,6,372,3,180,54973.393921,1.3072669999965,2276.505105696057,1101.5347285626083
"147.32.84.165",21222,"184.173.217.40",443,9,552,6,372,3,180,54975.696572,1.3083580000020447,2274.6067972186124,1100.6161922025542
"147.32.84.165",21223,"184.173.217.40",443,9,552,6,372,3,180,54978.000023,1.3077360000024782,2275.6886711036173,1101.1396795662665
"147.32.84.165",21224,"184.173.217.40",443,9,552,6,372,3,180,54980.303486,1.308102000002691,2275.051945485809,1100.8315865253915
"147.32.84.165",21225,"184.173.217.40",443,9,552,6,372,3,180,54982.607124,1.307610999996541,2275.906213704131,1101.244942114902
"147.32.84.165",21226,"184.173.217.40",443,9,552,6,372,3,180,54984.910099,1.3079179999986081,2275.3720034460625,1100.9864532803529
"147.32.84.165",21227,"216.157.130.15",25,6,372,6,372,0,0,54985.871357,9.012666999995417,330.2019258008216,0
"147.32.84.165",21228,"184.173.217.40",443,9,552,6,372,3,180,54987.213532,1.3078850000019884,2275.4294146622033,1101.014232901066
"147.32.84.165",21229,"184.173.217.40",443,9,552,6,372,3,180,54989.516939,1.3076149999978952,2275.899251694719,1101.2415734006706
"147.32.84.165",21230,"184.173.217.40",443,9,552,6,372,3,180,54991.820291,1.3077529999936814,2275.6590885391806,1101.1253654221841
"147.32.84.165",21231,"184.173.217.40",443,9,552,6,372,3,180,54994.123322,1.3080340000014985,2275.1702172853234,1100.888814815479
"147.32.84.165",21232,"184.173.217.40",443,9,552,6,372,3,180,54996.427035,1.3082549999962794,2274.785878906225,1100.7028446320444
"147.32.84.165",21233,"184.173.217.40",443,9,552,6,372,3,180,54998.73,1.3080169999957434,2275.199787166134,1100.9031228223228
"147.32.84.165",21234,"184.173.217.40",443,9,552,6,372,3,180,55001.033164,1.3077659999980824,2275.6364670777216,1101.1144195537363
"147.32.84.165",21235,"184.173.217.40",443,9,552,6,372,3,180,55003.336818,1.3072879999963334,2276.468536396224,1101.5170337401084
"147.32.84.165",21236,"184.173.217.40",443,9,552,6,372,3,180,55005.640158,1.3076569999975618,2275.8261531927324,1101.2062031577739
"147.32.84.165",21237,"184.173.217.40",443,9,552,6,372,3,180,55007.943418,1.3075879999960307,2275.9462460721834,1101.2643126155726
"147.32.84.165",21238,"184.173.217.40",443,9,552,6,372,3,180,55010.246634,1.3075059999973746,2276.08898162301,1101.3333782046823
"147.32.84.165",21239,"184.173.217.40",443,9,552,6,372,3,180,55012.550162,1.307345000001078,2276.369282781168,1101.4690077973394
"147.32.84.165",21240,"184.173.217.40",443,9,552,6,372,3,180,55014.852998,1.308060999996087,2275.1232549620413,1100.8660911106651
"147.32.84.165",21241,"184.173.217.40",443,9,552,6,372,3,180,55017.156675,1.3079649999999674,2275.290240946871,1100.946890780744
"147.32.84.165",21242,"184.173.217.40",443,9,552,6,372,3,180,55019.460052,1.30772799999977,2275.7025925884614,1101.1464157686103
"147.32.84.165",21243,"184.173.217.40",443,9,552,6,372,3,180,55021.763204,1.3077069999999367,2275.7391372839206,1101.164098685768
"147.32.84.165",21244,"184.173.217.40",443,9,552,6,372,3,180,55024.066522,1.307730000000447,2275.6991122012823,1101.1447317102977
"147.32.84.165",21245,"184.173.217.40",443,9,552,6,372,3,180,55026.369983,1.3079710000019986,2275.2798036007316,1100.941840451967
"147.32.84.165",21246,"184.173.217.40",443,9,552,6,372,3,180,55028.673394,1.3073490000024321,2276.362317938411,1101.4656377121344
"147.32.84.165",21247,"184.173.217.40",443,9,552,6,372,3,180,55030.97622,1.3078999999997905,2275.4033182968706,1101.0016056275178
"147.32.84.165",21248,"184.173.217.40",443,9,552,6,372,3,180,55033.279404,1.3080029999982798,2275.2241393971676,1100.9149061599198
"147.32.84.165",21249,"184.173.217.40",443,9,552,6,372,3,180,55035.582665,1.307898999999452,2275.4050580367802,1101.002447437152
"147.32.84.165",21250,"184.173.217.40",443,9,552,6,372,3,180,55037.886417,1.307862000001478,2275.4694302584194,1101.033595286332
"147.32.84.165",21251,"184.173.217.40",443,9,552,6,372,3,180,55040.189419,1.3077740000007907,2275.6225464019017,1101.1076837428557
"147.32.84.165",21252,"184.173.217.40",443,9,552,6,372,3,180,55042.49259,1.3078630000018165,2275.467690420072,1101.032753429067
"147.32.84.165",21253,"184.173.217.40",443,9,552,6,372,3,180,55044.796243,1.3076360000050045,2275.8627018440993,1101.2238879890804
"147.32.84.165",21254,"184.173.217.40",443,9,552,6,372,3,180,55047.099246,1.308712000005471,2273.9915275381895,1100.3184810668658
"147.32.84.165",21255,"184.173.217.40",443,9,552,6,372,3,180,55049.403267,1.3075319999989006,2276.043722067607,1101.3114784198099
"147.32.84.165",21256,"184.173.217.40",443,9,552,6,372,3,180,55051.706165,1.3074689999994007,2276.1533925480176,1101.364544781299
"147.32.84.165",21257,"184.173.217.40",443,9,552,6,372,3,180,55054.009647,1.3073409999997239,2276.376247666545,1101.472377903167
"147.32.84.165",21258,"184.173.217.40",443,9,552,6,372,3,180,55056.31269,1.308071999999811,2275.1041227091705,1100.8568335689536
"147.32.84.165",21259,"184.173.217.40",443,9,552,6,372,3,180,55058.615835,1.3083170000027167,2274.6780787789353,1100.6506832801301
"147.32.84.165",21260,"184.173.217.40",443,9,552,6,372,3,180,55060.919423,1.3078509999977541,2275.488568655841,1101.0428558012134
"147.32.84.165",21261,"184.173.217.40",443,9,552,6,372,3,180,55063.222742,1.3076070000024629,2275.9131757434725,1101.2483108436156
"147.32.84.165",21262,"184.173.217.40",443,9,552,6,372,3,180,55065.526054,1.3075459999963641,2276.019352289155,1101.2996865915266
"147.32.84.165",21263,"184.173.217.40",443,9,552,6,372,3,180,55067.829376,1.3534270000018296,2198.862591034446,1063.965769855377
"147.32.84.165",21264,"184.173.217.40",443,9,552,6,372,3,180,55070.182719,1.358261000001221,2191.0369214733582,1060.179155551625
"147.32.84.165",21265,"184.173.217.40",443,9,552,6,372,3,180,55072.536288,1.3078459999960614,2275.4972680338224,1101.047065177656
"147.32.84.165",21266,"184.173.217.40",443,9,552,6,372,3,180,55074.839658,1.3075100000060047,2276.0820184827135,1101.3300089432485
"147.32.84.165",21267,"184.173.217.40",443,9,552,6,372,3,180,55077.142919,1.3076670000009472,2275.808749473562,1101.1977820033364
"147.32.84.165",21268,"184.173.217.40",443,9,552,6,372,3,180,55079.445774,1.30772799999977,2275.7025925884614,1101.1464157686103
"147.32.84.165",21269,"184.173.217.40",443,9,552,6,372,3,180,55081.749677,1.3075010000029579,2276.097685579795,1101.337589796675
"147.32.84.165",21270,"184.173.217.40",443,9,552,6,372,3,180,55084.052384,1.3080520000003162,2275.1389088501687,1100.8736655726623
"147.32.84.165",21271,"184.173.217.40",443,9,552,6,372,3,180,55086.356017,1.3075690000041504,2275.9793173366406,1101.28031484031
"147.32.84.165",21272,"184.173.217.40",443,9,552,6,372,3,180,55088.659714,1.3076509999955306,2275.8365955520026,1101.2112559122593
"147.32.84.165",21273,"184.173.217.40",443,9,552,6,372,3,180,55090.962895,1.3072830000019167,2276.4772432561554,1101.5212467368494
"147.32.84.165",21274,"184.173.217.40",443,9,552,6,372,3,180,55093.265794,1.3077760000014678,2275.619066259558,1101.105999803012
"147.32.84.165",21275,"184.173.217.40",443,9,552,6,372,3,180,55095.569474,1.3074419999975362,2276.2003974215363,1101.387289074937
"147.32.84.165",21276,"184.173.217.40",443,9,552,6,372,3,180,55097.872923,1.3074070000002393,2276.2613325456077,1101.4167738123908
"147.32.84.165",21277,"184.173.217.40",443,9,552,6,372,3,180,55100.175723,1.3081139999994775,2275.031075274165,1100.8214880358862
"147.32.84.165",21278,"184.173.217.40",443,9,552,6,372,3,180,55102.478967,1.3081059999967692,2275.044988714485,1100.8282203457186
"147.32.84.165",21279,"184.173.217.40",443,9,552,6,372,3,180,55104.782874,1.307676000003994,2275.793086353891,1101.1902030744634
"147.32.84.165",21280,"184.173.217.40",443,9,552,6,372,3,180,55107.085566,1.3079839999991236,2275.257189691918,1100.9308982380248
"147.32.84.165",21281,"184.173.217.40",443,9,552,6,372,3,180,55109.389109,1.3079019999931916,2275.3998388376895,1100.999922018237
"147.32.84.165",21282,"184.173.217.40",443,9,552,6,372,3,180,55111.692276,1.3079179999986081,2275.3720034460625,1100.9864532803529
"147.32.84.165",21283,"184.173.217.40",443,9,552,6,372,3,180,55113.995684,1.3079490000018268,2275.3180743254084,1100.9603585445525
"147.32.84.165",21284,"184.173.217.40",443,9,552,6,372,3,180,55116.298716,1.3081420000016806,2274.9823795858374,1100.7979256060505
"147.32.84.165",21285,"184.173.217.40",443,9,552,6,372,3,180,55118.60257,1.3078199999945355,2275.5425058589367,1101.0689544478726
"147.32.84.165",21286,"184.173.217.40",443,9,552,6,372,3,180,55120.905573,1.3076820000060252,2275.782644393888,1101.1851505131715
"147.32.84.165",21287,"173.192.170.88",80,18,1800,12,1166,6,634,55121.550638,601.441095000002,15.509415764148889,8.433078554434301
"147.32.84.165",21288,"184.173.217.40",443,9,552,6,372,3,180,55123.209305,1.3073700000022654,2276.325753225822,1101.4479451092689
"147.32.84.165",21289,"184.173.217.40",443,9,552,6,372,3,180,55125.512423,1.3075259999968694,2276.054166423555,1101.31653214043
"147.32.84.165",21290,"94.100.176.20",25,6,372,6,372,0,0,55127.0988,8.988714999999502,331.0818064651249,0
"147.32.84.165",21291,"184.173.217.40",443,9,552,6,372,3,180,55127.815384,1.30782100000215,2275.54076589618,1101.0681125304095
"147.32.84.165",21292,"184.173.217.40",443,9,552,6,372,3,180,55130.118575,1.3082070000018575,2274.869344068465,1100.74323100087
"147.32.84.165",21293,"184.173.217.40",443,9,552,6,372,3,180,55132.422217,1.3082770000037272,2274.7476260696485,1100.6843351949913
"147.32.84.165",21294,"184.173.217.40",443,9,552,6,372,3,180,55134.725545,1.30772799999977,2275.7025925884614,1101.1464157686103
"147.32.84.165",21295,"184.173.217.40",443,9,552,6,372,3,180,55137.028521,1.307833999999275,2275.5181467997086,1101.0571678063104
"147.32.84.165",21296,"184.173.217.40",443,9,552,6,372,3,180,55139.332185,1.3078810000006342,2275.4363737974304,1101.017600224563
"147.32.84.165",21297,"184.173.217.40",443,9,552,6,372,3,180,55141.635829,1.3076270000019576,2275.878365922044,1101.2314673816343
"147.32.84.165",21298,"184.173.217.40",443,9,552,6,372,3,180,55143.93867,1.3079429999997956,2275.3285120226687,1100.9654090432266
"147.32.84.165",21299,"184.173.217.40",443,9,552,6,372,3,180,55146.242168,1.30806300000404,2275.119776334021,1100.8644079035585
"147.32.84.165",21300,"74.125.93.27",25,6,372,6,372,0,0,55148.10463,9.012640000000829,330.20291501710113,0
"147.32.84.165",21301,"184.173.217.40",443,9,552,6,372,3,180,55148.545685,1.3078890000033425,2275.422455569543,1101.010865598166
"147.32.84.165",21302,"184.173.217.40",443,9,552,6,372,3,180,55150.848818,1.3074070000002393,2276.2613325456077,1101.4167738123908
"147.32.84.165",21303,"184.173.217.40",443,9,552,6,372,3,180,55153.152134,1.3077939999930095,2275.5877454827805,1101.0908445884422
"147.32.84.165",21304,"184.173.217.40",443,9,552,6,372,3,180,55155.455507,1.3076070000024629,2275.9131757434725,1101.2483108436156
"147.32.84.165",21305,"184.173.217.40",443,9,552,6,372,3,180,55157.758569,1.3080660000050557,2275.1145584309184,1100.8618831117346
"147.32.84.165",21306,"184.173.217.40",443,9,552,6,372,3,180,55160.06181,1.3080649999974412,2275.116297741948,1100.8627247138459
"147.32.84.165",21307,"184.173.217.40",443,9,552,6,372,3,180,55162.365402,1.3081569999994827,2274.9562934733194,1100.7853032935416
"147.32.84.165",21308,"184.173.217.40",443,9,552,6,372,3,180,55164.668721,1.3079839999991236,2275.257189691918,1100.9308982380248
"147.32.84.165",21309,"184.173.217.40",443,9,552,6,372,3,180,55166.971693,1.3075079999980517,2276.0855000538695,1101.3316935744529
"147.32.84.165",21310,"74.125.39.27",25,6,372,6,372,0,0,55169.135331,8.912159999999858,333.92578230193885,0
"147.32.84.165",21311,"184.173.217.40",443,9,552,6,372,3,180,55169.275197,1.2073739999977988,2464.8534753981994,1192.6710364829996
"147.32.84.165",21312,"184.173.217.40",443,9,552,6,372,3,180,55171.477999,1.3082009999998263,2274.8797776491497,1100.748279507653
"147.32.84.165",21313,"184.173.217.40",443,9,552,6,372,3,180,55173.781698,1.3078119999991031,2275.5564255428462,1101.0756897787967
"147.32.84.165",21314,"184.173.217.40",443,9,552,6,372,3,180,55176.084715,1.3078280000045197,2275.528586320002,1101.0622191870975
"147.32.84.165",21315,"184.173.217.40",443,9,552,6,372,3,180,55178.38812,1.3076379999984056,2275.8592209798344,1101.2222036999199
"147.32.84.165",21316,"184.173.217.40",443,9,552,6,372,3,180,55180.691873,1.3075519999983953,2276.008908252714,1101.2946330255065
"147.32.84.165",21317,"184.173.217.40",443,9,552,6,372,3,180,55182.995345,1.3078019999957178,2275.5738254030384,1101.0841090659865
"147.32.84.165",21318,"184.173.217.40",443,9,552,6,372,3,180,55185.298288,1.307530999998562,2276.0454627869417,1101.3123207033589
"147.32.84.165",21319,"184.173.217.40",443,9,552,6,372,3,180,55187.60141,1.308162999994238,2274.9458592034084,1100.7802544532622
"147.32.84.165",21320,"184.173.217.40",443,9,552,6,372,3,180,55189.905163,1.3074809999961872,2276.1325021233033,1101.3544365112757
"147.32.84.165",21321,"66.111.4.73",25,6,372,6,372,0,0,55190.065547,9.012289999998757,330.21573873015745,0
"147.32.84.165",21322,"184.173.217.40",443,9,552,6,372,3,180,55192.208124,1.3082009999998263,2274.8797776491497,1100.748279507653
"147.32.84.165",21323,"184.173.217.40",443,9,552,6,372,3,180,55194.51188,1.3076169999985723,2275.8957707059863,1101.2398890512836
"147.32.84.165",21324,"184.173.217.40",443,9,552,6,372,3,180,55196.81474,1.3077770000018063,2275.617326192378,1101.1051578350216
"147.32.84.165",21325,"184.173.217.40",443,9,552,6,372,3,180,55199.118126,1.3075669999961974,2275.982798593613,1101.28199931949
"147.32.84.165",21326,"184.173.217.40",443,9,552,6,372,3,180,55201.421509,1.3072850000025937,2276.4737604991224,1101.5195615318335
"147.32.84.165",21327,"184.173.217.40",443,9,552,6,372,3,180,55203.725031,1.3078299999979208,2275.525106477701,1101.060535392436
"147.32.84.165",21328,"184.173.217.40",443,9,552,6,372,3,180,55206.027868,1.3080900000059046,2275.0728160803665,1100.8416852001774
"147.32.84.165",21329,"184.173.217.40",443,9,552,6,372,3,180,55208.331571,1.359108999997261,2189.6698498840033,1059.517669298711
"147.32.84.165",21330,"184.173.217.40",443,9,552,6,372,3,180,55210.684455,1.3582439999954659,2191.0643448525702,1060.192424928663
"147.32.84.165",21331,"216.157.130.15",25,6,372,6,372,0,0,55211.095659,9.012365000002319,330.2129907076815,0
"147.32.84.165",21332,"184.173.217.40",443,9,552,6,372,3,180,55213.038175,1.3078779999996186,2275.4415931767853,1101.0201257307026
"147.32.84.165",21333,"184.173.217.40",443,9,552,6,372,3,180,55215.341717,1.3073779999976978,2276.3118241283246,1101.441205223383
"147.32.84.165",21334,"184.173.217.40",443,9,552,6,372,3,180,55217.644868,1.3075899999967078,2275.942764939693,1101.2626281966257
"147.32.84.165",21335,"184.173.217.40",443,9,552,6,372,3,180,55219.947743,1.3079370000050403,2275.3389498030347,1100.9704595821136
"147.32.84.165",21336,"184.173.217.40",443,9,552,6,372,3,180,55222.251433,1.3076179999989108,2275.8940302156125,1101.2390468785222
"147.32.84.165",21337,"184.173.217.40",443,9,552,6,372,3,180,55224.554523,1.3078939999977592,2275.4137567762364,1101.0066565046304
"147.32.84.165",21338,"184.173.217.40",443,9,552,6,372,3,180,55226.858052,1.3081590000001597,2274.9528153684964,1100.783620339595
"147.32.84.165",21339,"184.173.217.40",443,9,552,6,372,3,180,55229.161003,1.3081479999964358,2274.971945076634,1100.792876649984
"147.32.84.165",21340,"184.173.217.40",443,9,552,6,372,3,180,55231.464738,1.3075639999951818,2275.9880204800425,1101.2845260387303
"147.32.84.165",21341,"184.173.217.40",443,9,552,6,372,3,180,55233.768038,1.3079709999947227,2275.2798036133886,1100.9418404580913
"147.32.84.165",21342,"184.173.217.40",443,9,552,6,372,3,180,55236.070938,1.3080230000050506,2275.18935063719,1100.8980728889628
"147.32.84.165",21343,"184.173.217.40",443,9,552,6,372,3,180,55238.374743,1.3075749999989057,2275.9688736802786,1101.2752614581993
"147.32.84.165",21344,"184.173.217.40",443,9,552,6,372,3,180,55240.677971,1.3076770000043325,2275.7913460205696,1101.1893609776948
"147.32.84.165",21345,"184.173.217.40",443,9,552,6,372,3,180,55242.980905,1.3079050000014831,2275.3946196372253,1100.9973965986574
"147.32.84.165",21346,"184.173.217.40",443,9,552,6,372,3,180,55245.284753,1.3078800000002957,2275.438113587888,1101.0184420586556
"147.32.84.165",21347,"184.173.217.40",443,9,552,6,372,3,180,55247.587948,1.3075559999997495,2276.0019456150026,1101.2912640072593
"147.32.84.165",21348,"184.173.217.40",443,9,552,6,372,3,180,55249.891444,1.3075239999961923,2276.057647896839,1101.318216724277
"147.32.84.165",21349,"184.173.217.40",443,9,552,6,372,3,180,55252.194448,1.308190999996441,2274.897167162973,1100.7566937885351
"147.32.84.165",21350,"184.173.217.40",443,9,552,6,372,3,180,55254.49793,1.3077120000016293,2275.7304360564804,1101.159888414426
"147.32.84.165",21351,"184.173.217.40",443,9,552,6,372,3,180,55256.800752,1.308632000000216,2274.1305424286647,1100.3857463364507
"147.32.84.165",21352,"184.173.217.40",443,9,552,6,372,3,180,55259.104614,1.3072579999934533,2276.520778618225,1101.5423122346251
"147.32.84.165",21353,"184.173.217.40",443,9,552,6,372,3,180,55261.407841,1.3080570000020089,2275.1302122120287,1100.8694575219492
"147.32.84.165",21354,"184.173.217.40",443,9,552,6,372,3,180,55263.710814,1.3081210000018473,2275.0189011534844,1100.8155973323312
"147.32.84.165",21355,"184.173.217.40",443,9,552,6,372,3,180,55266.014676,1.3077899999989313,2275.594705573855,1101.094212374446
"147.32.84.165",21356,"184.173.217.40",443,9,552,6,372,3,180,55268.317864,1.3077080000002752,2275.7373970331096,1101.163256628924
"147.32.84.165",21357,"184.173.217.40",443,9,552,6,372,3,180,55270.620681,1.308098000001337,2275.0589023123334,1100.8349527317741
"147.32.84.165",21358,"184.173.217.40",443,9,552,6,372,3,180,55272.924632,1.307701999998244,2275.7478385778995,1101.168308989306
"147.32.84.165",21359,"184.173.217.40",443,9,552,6,372,3,180,55275.227309,1.307889999996405,2275.420715815688,1101.0100237817844
"147.32.84.165",21360,"184.173.217.40",443,9,552,6,372,3,180,55277.530982,1.307531000005838,2276.0454627742765,1101.3123206972305
"147.32.84.165",21361,"184.173.217.40",443,9,552,6,372,3,180,55279.834079,1.3081749999983003,2274.924990925424,1100.7701568993987
"147.32.84.165",21362,"184.173.217.40",443,9,552,6,372,3,180,55282.137585,1.4081500000029337,2113.4112132896353,1022.6183290111138
"147.32.84.165",21363,"184.173.217.40",443,9,552,6,372,3,180,55284.540717,1.307915999997931,2275.375482832772,1100.988136854567
"147.32.84.165",21364,"184.173.217.40",443,9,552,6,372,3,180,55286.844634,1.3074369999958435,2276.2091022431377,1101.391501085389
"147.32.84.165",21365,"184.173.217.40",443,9,552,6,372,3,180,55289.14759,1.308021999997436,2275.191090062578,1100.8989145464088
"147.32.84.165",21366,"184.173.217.40",443,9,552,6,372,3,180,55291.450673,1.307784000004176,2275.6051457966278,1101.0992640951424
"147.32.84.165",21367,"184.173.217.40",443,9,552,6,372,3,180,55293.754594,1.306962000002386,2277.0363637156756,1101.7917888946818
"147.32.84.165",21368,"184.173.217.40",443,9,552,6,372,3,180,55296.057648,1.3077679999987595,2275.6329868927996,1101.1127355932902
"147.32.84.165",21369,"184.173.217.40",443,9,552,6,372,3,180,55298.360522,1.308021999997436,2275.191090062578,1100.8989145464088
"147.32.84.165",21370,"184.173.217.40",443,9,552,6,372,3,180,55300.663911,1.3080939999999828,2275.065859181404,1100.8383189587437
"147.32.84.165",21371,"184.173.217.40",443,9,552,6,372,3,180,55302.967709,1.3071810000037658,2276.6548779330687,1101.6071989998718
"147.32.84.165",21372,"184.173.217.40",443,9,552,6,372,3,180,55305.270623,1.3081460000030347,2274.975423227297,1100.7945596261115
"147.32.84.165",21373,"184.173.217.40",443,9,552,6,372,3,180,55307.574543,1.207431999995606,2464.7350741166624,1192.6137455403205
"147.32.84.165",21374,"184.173.217.40",443,9,552,6,372,3,180,55309.777337,1.307740999996895,2275.6799702747458,1101.13546948778
"147.32.84.165",21375,"184.173.217.40",443,9,552,6,372,3,180,55312.080214,1.3081180000008317,2275.024118617822,1100.8181219118494
"147.32.84.165",21376,"184.173.217.40",443,9,552,6,372,3,180,55314.383899,1.3075089999983902,2276.083759273293,1101.3308512612707
"147.32.84.165",21377,"184.173.217.40",443,9,552,6,372,3,180,55316.687606,1.3074019999985467,2276.2700378332815,1101.420986048362
"147.32.84.165",21378,"184.173.217.40",443,9,552,6,372,3,180,55318.990578,1.3077180000036606,2275.7199946713813,1101.1548361313137
"147.32.84.165",21379,"184.173.217.40",443,9,552,6,372,3,180,55321.29368,1.307848999997077,2275.4920483990513,1101.0445395479283
"147.32.84.165",21380,"184.173.217.40",443,9,552,6,372,3,180,55323.596914,1.308288000000175,2274.7285001464525,1100.6750807160254
"147.32.84.165",21381,"184.173.217.40",443,9,552,6,372,3,180,55325.900617,1.307886000002327,2275.4276748850475,1101.01339107341
"147.32.84.165",21382,"184.173.217.40",443,9,552,6,372,3,180,55328.203632,1.3077160000029835,2275.723475122435,1101.1565202205331
"147.32.84.165",21383,"184.173.217.40",443,9,552,6,372,3,180,55330.506746,1.3079880000004778,2275.25023165267,1100.9275314448405
"147.32.84.165",21384,"184.173.217.40",443,9,552,6,372,3,180,55332.814091,1.303994000001694,2282.219089962173,1104.2995596591159
"147.32.84.165",21385,"184.173.217.40",443,9,552,6,372,3,180,55335.114032,1.307554999999411,2276.0036862704364,1101.2921062598887
"147.32.84.165",21386,"184.173.217.40",443,9,552,6,372,3,180,55337.416668,1.3083180000030552,2274.676340150522,1100.649842008317
"147.32.84.165",21387,"184.173.217.40",443,9,552,6,372,3,180,55339.720408,1.3076809999984107,2275.784384726563,1101.1859926096274
"147.32.84.165",21388,"184.173.217.40",443,9,552,6,372,3,180,55342.023964,1.307292999998026,2276.4598295902247,1101.5128207694636
"147.32.84.165",21389,"184.173.217.40",443,9,552,6,372,3,180,55344.326944,1.3079859999998007,2275.2537106669747,1100.9292148388588
"147.32.84.165",21390,"184.173.217.40",443,9,552,6,372,3,180,55346.63051,1.307329999996,2276.3954013210937,1101.4816458005293
"147.32.84.165",21391,"184.173.217.40",443,9,552,6,372,3,180,55348.933439,1.3707389999981388,2171.09165202423,1050.5282187214016
"147.32.84.165",21392,"184.173.217.40",443,9,552,6,372,3,180,55351.296962,1.3480790000030538,2207.585757209524,1068.186656714286
"147.32.84.165",21393,"94.100.176.20",25,6,372,6,372,0,0,55352.311918,8.999421000000439,330.68794092418335,0
"147.32.84.165",21394,"184.173.217.40",443,9,552,6,372,3,180,55353.640508,1.30772799999977,2275.7025925884614,1101.1464157686103
"147.32.84.165",21395,"184.173.217.40",443,9,552,6,372,3,180,55355.943631,1.3076139999975567,2275.9009921930788,1101.2424155772962
"147.32.84.165",21396,"184.173.217.40",443,9,552,6,372,3,180,55358.247043,1.3073269999949844,2276.400625101002,1101.4841734359686
"147.32.84.165",21397,"184.173.217.40",443,9,552,6,372,3,180,55360.550252,1.3079450000004726,2275.325032779608,1100.96372553852
"147.32.84.165",21398,"184.173.217.40",443,9,552,6,372,3,180,55362.853417,1.3079599999982747,2275.2989388084693,1100.951099423453
"147.32.84.165",21399,"184.173.217.40",443,9,552,6,372,3,180,55365.157171,1.3080039999986184,2275.222399933902,1100.9140644841461
"147.32.84.165",21400,"184.173.217.40",443,9,552,6,372,3,180,55367.460234,1.3077810000031604,2275.6103659502683,1101.1017899759363
"147.32.84.165",21401,"184.173.217.40",443,9,552,6,372,3,180,55369.763841,1.3075319999989006,2276.043722067607,1101.3114784198099
"147.32.84.165",21402,"184.173.217.40",443,9,552,6,372,3,180,55372.066732,1.3081339999989723,2274.9962924305446,1100.804657627683
"147.32.84.165",21403,"74.125.93.27",25,6,372,6,372,0,0,55373.328711,8.91261300000042,333.9088099079204,0
"147.32.84.165",21404,"184.173.217.40",443,9,552,6,372,3,180,55374.370134,1.3081320000055712,2274.999770655657,1100.806340639834
"147.32.84.165",21405,"184.173.217.40",443,9,552,6,372,3,180,55376.673255,1.3080550000013318,2275.133690859306,1100.8711407383742
"147.32.84.165",21406,"184.173.217.40",443,9,552,6,372,3,180,55378.977134,1.3070999999981723,2276.7959605264796,1101.6754647708772
"147.32.84.165",21407,"184.173.217.40",443,9,552,6,372,3,180,55381.279934,1.3075190000017756,2276.0663516139794,1101.3224282003125
"147.32.84.165",21408,"184.173.217.40",443,9,552,6,372,3,180,55383.583132,1.3084099999978207,2274.516397769015,1100.5724505333944
"147.32.84.165",21409,"184.173.217.40",443,9,552,6,372,3,180,55385.886388,1.3080879999979516,2275.076294564785,1100.8433683377991
"147.32.84.165",21410,"184.173.217.40",443,9,552,6,372,3,180,55388.190132,1.3073179999992135,2276.4162965719056,1101.4917564057607
"147.32.84.165",21411,"184.173.217.40",443,9,552,6,372,3,180,55390.493068,1.307859999993525,2275.472909955755,1101.035279010849
"147.32.84.165",21412,"184.173.217.40",443,9,552,6,372,3,180,55392.796561,1.3074979999946663,2276.102908006085,1101.3401167771378
"147.32.84.165",21413,"74.125.39.27",25,6,372,6,372,0,0,55394.25836,9.013250999996671,330.1805308651783,0
"147.32.84.165",21414,"184.173.217.40",443,9,552,6,372,3,180,55395.099859,1.3077740000007907,2275.6225464019017,1101.1076837428557
"147.32.84.165",21415,"184.173.217.40",443,9,552,6,372,3,180,55397.403542,1.307316999998875,2276.4180378611777,1101.492598965086
"147.32.84.165",21416,"184.173.217.40",443,9,552,6,372,3,180,55399.706273,1.3078559999994468,2275.4798693443763,1101.0386464569563
"147.32.84.165",21417,"184.173.217.40",443,9,552,6,372,3,180,55402.010155,1.3073029999941355,2276.4424161906995,1101.5043949309838
"147.32.84.165",21418,"184.173.217.40",443,9,552,6,372,3,180,55404.312961,1.3082119999962742,2274.860649503655,1100.7390239533815
"147.32.84.165",21419,"184.173.217.40",443,9,552,6,372,3,180,55406.616817,1.3076399999990826,2275.855740113554,1101.2205194097842
"147.32.84.165",21420,"184.173.217.40",443,9,552,6,372,3,180,55408.919744,1.3081729999976233,2274.928468945168,1100.7718398121779
"147.32.84.165",21421,"184.173.217.40",443,9,552,6,372,3,180,55411.223319,1.3076930000024731,2275.763501062078,1101.1758876106828
"147.32.84.165",21422,"184.173.217.40",443,9,552,6,372,3,180,55413.526274,1.3080409999965923,2275.158041688107,1100.8829233974711
"147.32.84.165",21423,"66.111.4.73",25,6,372,6,372,0,0,55415.288929,9.012731999995594,330.19954437804813,0
"147.32.84.165",21424,"184.173.217.40",443,9,552,6,372,3,180,55415.829583,1.3082589999976335,2274.7789237493366,1100.69947923355
"147.32.84.165",21425,"184.173.217.40",443,9,552,6,372,3,180,55418.13322,1.3077099999936763,2275.733916552134,1101.1615725252261
"147.32.84.165",21426,"184.173.217.40",443,9,552,6,372,3,180,55420.436739,1.3070880000013858,2276.8168631315143,1101.6855789346037
"147.32.84.165",21427,"173.192.170.88",80,34,4773,22,1766,12,3007,55421.563846,45.72769300000073,308.9593870392669,526.0707116801108
"147.32.84.165",21428,"184.173.217.40",443,9,552,6,372,3,180,55422.739965,1.3289280000026338,2239.398974206354,1083.5801488095262
"147.32.84.165",21429,"184.173.217.40",443,8,492,6,372,2,120,55425.062851,6.9441269999952056,428.56359049914477,138.24631951585314
"147.32.84.165",21431,"184.173.217.40",443,9,552,6,372,3,180,55433.004295,1.911329000002297,1557.0317825954733,753.4024754494226
"147.32.84.165",21432,"184.173.217.40",443,9,552,6,372,3,180,55435.908512,1.8365469999989728,1620.432256839419,784.0801242771382
"147.32.84.165",21433,"216.157.130.15",25,6,372,6,372,0,0,55436.318964,8.91421000000264,333.84898942240744,0
"147.32.84.165",21434,"184.173.217.40",443,8,492,6,372,2,120,55438.742593,4.078863999995519,729.6149123881721,235.35964915747488
"147.32.84.165",21436,"98.126.71.122",80,18,4967,14,1534,4,3433,55439.264013,21.50075800000195,570.7705746931753,1277.350314812041
"147.32.84.165",21437,"95.100.248.96",80,17,5968,12,2764,5,3204,55439.864359,30.954045999998925,714.349264713271,828.0662243637194
"147.32.84.165",21438,"195.113.232.83",80,54,40606,42,3628,12,36978,55440.092189,30.726404999993974,944.5947223570637,9627.680166295342
"147.32.84.165",21439,"77.238.175.247",80,14,2274,10,1276,4,998,55440.155527,0.13874899999791523,73571.70141877333,57542.75706578039
"147.32.84.165",21440,"74.125.232.217",80,13,1871,10,1156,3,715,55440.15781,30.661019999999553,301.62075495205755,186.55608978436084
"147.32.84.165",21441,"64.236.79.229",80,14,2274,10,1560,4,714,55440.184635,0.3562020000026678,35036.29962747691,16035.844829499049
"147.32.84.165",21442,"68.67.185.208",80,16,2169,12,1370,4,799,55440.189483,10.573417999999947,1036.5616870533308,604.5348817194243
"147.32.84.165",21443,"64.236.79.229",80,14,2078,10,1378,4,700,55440.20331,0.35566300000209594,30995.633506816943,15745.241984594964
"147.32.84.165",21444,"64.236.79.229",80,14,2061,10,1404,4,657,55440.273479,0.35548999999446096,31595.82548081524,14785.226026278928
"147.32.84.165",21445,"77.238.167.32",80,13,2342,10,1390,3,952,55440.312417,0.1416590000008,78498.36579347024,53762.90952185875
"147.32.84.165",21446,"64.236.79.229",80,14,2043,10,1386,4,657,55440.353844,0.35592300000280375,31152.805522297393,14767.238981348764
"147.32.84.165",21447,"77.238.175.247",80,14,3055,10,1368,4,1687,55440.408754,0.14195000000472646,77097.56956418176,95075.73088799315
"147.32.84.165",21448,"195.113.232.96",80,13,1965,10,1306,3,659,55440.426979,30.392031999996107,343.77431558381284,173.466519119244
"147.32.84.165",21449,"74.217.252.37",80,12,2075,10,1278,2,797,55440.480683,30.338506000000052,336.99747772681957,210.16196380929202
"147.32.84.165",21450,"64.236.79.229",80,14,2089,10,1432,4,657,55440.524118,0.3549090000014985,32278.696792562685,14809.430022844752
"147.32.84.165",21451,"184.173.217.40",443,9,552,6,372,3,180,55443.821152,1.6571770000009565,1795.8250687755638,868.9476139236599
"147.32.84.165",21452,"184.173.217.40",443,9,552,6,372,3,180,55446.47818,1.3444670000026235,2213.5165831472195,1071.0564112002676
"147.32.84.165",21453,"184.173.217.40",443,9,552,6,372,3,180,55448.82321,1.6379170000000158,1816.9418841125473,879.1654277963938
"147.32.84.165",21454,"184.173.217.40",443,9,552,6,372,3,180,55451.461745,1.667050999996718,1785.188335573332,863.8008075354833
"147.32.84.165",21455,"184.173.217.40",443,9,552,6,372,3,180,55454.128862,1.6732610000035493,1778.5629378762114,860.5949699401023
"147.32.84.165",21456,"184.173.217.40",443,9,552,6,372,3,180,55456.802764,1.7283319999987725,1721.891395867295,833.1732560648202
"147.32.84.165",21457,"184.173.217.40",443,9,552,6,372,3,180,55459.53126,1.2998479999951087,2289.498464444457,1107.8218376344148
"147.32.84.165",21458,"184.173.217.40",443,9,552,6,372,3,180,55461.831809,1.3060129999939818,2278.690947190965,1102.5923938020799
"147.32.84.165",21459,"184.173.217.40",443,9,552,6,372,3,180,55464.137856,1.4288159999996424,2082.8434172074953,1007.8274599391107
"147.32.84.165",21460,"184.173.217.40",443,9,552,6,372,3,180,55466.566335,1.3865630000000237,2146.314303785655,1038.5391792511234
"147.32.84.165",21461,"173.192.170.88",80,11,1283,8,846,3,437,55467.09127,3.6267730000035954,1866.121756170924,963.9423255871085
"147.32.84.165",21462,"184.173.217.40",443,9,552,6,372,3,180,55468.95327,1.3069050000049174,2277.135675499598,1101.8398429836766
"147.32.84.165",21463,"184.173.217.40",443,9,552,6,372,3,180,55471.269013,1.307650000002468,2275.8383359418676,1101.2120980363875
"147.32.84.165",21464,"184.173.217.40",443,9,552,6,372,3,180,55473.571949,1.3079760000036913,2275.27110588543,1100.9376318800469
"147.32.84.165",21465,"184.173.217.40",443,9,552,6,372,3,180,55475.875458,1.3080950000003213,2275.0641199601473,1100.8374774000713
"147.32.84.165",21466,"184.173.217.40",443,9,552,6,372,3,180,55478.179096,1.3077399999965564,2275.6817104377296,1101.1363115021272
"147.32.84.165",21467,"184.173.217.40",443,9,552,6,372,3,180,55480.481888,1.307926999994379,2275.356346350209,1100.9788772662303
"147.32.84.165",21468,"184.173.217.40",443,9,552,6,372,3,180,55482.785313,1.3080320000008214,2275.173696054937,1100.8904980910984
"147.32.84.165",21469,"184.173.217.40",443,9,552,6,372,3,180,55485.088369,1.3086670000047889,2274.0697213188,1100.3563167671612
"147.32.84.165",21470,"184.173.217.40",443,9,552,6,372,3,180,55487.391787,1.3079319999960717,2275.3476480496984,1100.9746684111444
"147.32.84.165",21471,"184.173.217.40",443,9,552,6,372,3,180,55489.695416,1.3077339999945252,2275.692151471522,1101.1413636152524
"147.32.84.165",21472,"184.173.217.40",443,9,552,6,372,3,180,55491.998948,1.3072689999971772,2276.501622853771,1101.5330433163408
"147.32.84.165",21473,"184.173.217.40",443,9,552,6,372,3,180,55494.301779,1.3075949999984005,2275.934062155056,1101.2584171718013
"147.32.84.165",21474,"184.173.217.40",443,9,552,6,372,3,180,55496.605295,1.3078129999994417,2275.554685571462,1101.074847857159
"147.32.84.165",21475,"184.173.217.40",443,9,552,6,372,3,180,55498.908527,1.3076000000000931,2275.9253594369748,1101.2542061791812
"147.32.84.165",21476,"184.173.217.40",443,9,552,6,372,3,180,55501.211669,1.3083540000006906,2274.6137513229824,1100.6195570917657
"147.32.84.165",21477,"184.173.217.40",443,9,552,6,372,3,180,55503.515001,1.307557000000088,2276.000204962231,1101.2904217559183
"147.32.84.165",21478,"184.173.217.40",443,9,552,6,372,3,180,55505.818158,1.3079989999969257,2275.2310972768287,1100.918272875885
"147.32.84.165",21479,"184.173.217.40",443,9,552,6,372,3,180,55508.122032,1.3076660000006086,2275.810489833501,1101.1986241129844
"147.32.84.165",21480,"184.173.217.40",443,9,552,6,372,3,180,55510.425128,1.3078150000001187,2275.551205636676,1101.0731640177466
"147.32.84.165",21481,"184.173.217.40",443,9,552,6,372,3,180,55512.728832,1.3077520000006189,2275.660828657568,1101.1262074149522
"147.32.84.165",21482,"184.173.217.40",443,9,552,6,372,3,180,55515.031752,1.3077059999995981,2275.7408775373933,1101.1649407439
"147.32.84.165",21483,"184.173.217.40",443,9,552,6,372,3,180,55517.335329,1.3074760000017704,2276.141206412944,1101.3586482643277
"147.32.84.165",21484,"184.173.217.40",443,9,552,6,372,3,180,55519.638541,1.307754000001296,2275.657348398132,1101.124523418451
"147.32.84.165",21485,"184.173.217.40",443,9,552,6,372,3,180,55521.941858,1.3076120000041556,2275.904473185121,1101.2440999282844
"147.32.84.165",21486,"184.173.217.40",443,9,552,6,372,3,180,55524.245373,1.3079560000041965,2275.3058971329706,1100.954466354663
"147.32.84.165",21487,"184.173.217.40",443,9,552,6,372,3,180,55526.54812,1.3083410000035656,2274.636352443201,1100.6304931176778
"147.32.84.165",21488,"184.173.217.40",443,9,552,6,372,3,180,55528.851932,1.3081630000015139,2274.9458591907555,1100.7802544471397
"147.32.84.165",21489,"184.173.217.40",443,9,552,6,372,3,180,55531.155017,1.3074550000019372,2276.1777651969596,1101.3763379985287
"147.32.84.165",21490,"184.173.217.40",443,9,552,6,372,3,180,55533.458475,1.3077140000023064,2275.726955584135,1101.158204314904
"147.32.84.165",21491,"184.173.217.40",443,9,552,6,372,3,180,55535.761229,1.3082679999934044,2274.76327481449,1100.6919071683017
"147.32.84.165",21492,"184.173.217.40",443,9,552,6,372,3,180,55538.065088,1.3076969999965513,2275.756539938417,1101.1725193250406
"147.32.84.165",21493,"184.173.217.40",443,9,552,6,372,3,180,55540.367951,1.3079520000028424,2275.312855512689,1100.9578333125914
"147.32.84.165",21494,"184.173.217.40",443,9,552,6,372,3,180,55542.671522,1.3074170000036247,2276.243922170011,1101.408349437102
"147.32.84.165",21495,"184.173.217.40",443,9,552,6,372,3,180,55544.975192,1.3072170000014012,2276.592180178815,1101.576861376846
"147.32.84.165",21496,"184.173.217.40",443,9,552,6,372,3,180,55547.278572,1.307184999997844,2276.647911355247,1101.6038280751195
"147.32.84.165",21497,"184.173.217.40",443,9,552,6,372,3,180,55549.581789,1.3072809999939636,2276.480726036515,1101.5229319531525
"147.32.84.165",21498,"184.173.217.40",443,9,552,6,372,3,180,55551.884829,1.3076279999950202,2275.8766254709544,1101.2306252278813
"147.32.84.165",21499,"184.173.217.40",443,9,552,6,372,3,180,55554.187779,1.3079720000023372,2275.2780640523515,1100.9409987350089
"147.32.84.165",21500,"184.173.217.40",443,9,552,6,372,3,180,55556.491602,1.3075600000011036,2275.9949830198907,1101.2878950096244
"147.32.84.165",21501,"184.173.217.40",443,9,552,6,372,3,180,55558.794712,1.3076849999997648,2275.7774234624817,1101.1826242560394
"147.32.84.165",21502,"184.173.217.40",443,9,552,6,372,3,180,55561.098426,1.3072830000019167,2276.4772432561554,1101.5212467368494
"147.32.84.165",21503,"184.173.217.40",443,9,552,6,372,3,180,55563.401607,1.307715000002645,2275.7252153519544,1101.1573622670746
"147.32.84.165",21504,"184.173.217.40",443,9,552,6,372,3,180,55565.704717,1.3076690000016242,2275.8052687616696,1101.1960977879046
"147.32.84.165",21505,"184.173.217.40",443,9,552,6,372,3,180,55568.007721,1.3082179999983055,2274.850216098429,1100.733975531498
"147.32.84.165",21506,"184.173.217.40",443,9,552,6,372,3,180,55570.311651,1.307504999997036,2276.090722411575,1101.3342205217298
"147.32.84.165",21507,"184.173.217.40",443,9,552,6,372,3,180,55572.614838,1.3078649999952177,2275.464210764018,1101.0310697245247
"147.32.84.165",21508,"184.173.217.40",443,9,552,6,372,3,180,55574.917893,1.3077530000009574,2275.6590885265196,1101.1253654160578
"147.32.84.165",21509,"184.173.217.40",443,9,552,6,372,3,180,55577.221324,1.3080410000038682,2275.1580416754514,1100.8829233913475
"147.32.84.165",21510,"94.100.176.20",25,6,372,6,372,0,0,55577.455343,8.938999999998487,332.92314576580196,0
"147.32.84.165",21511,"184.173.217.40",443,9,552,6,372,3,180,55579.524229,1.3082739999954356,2274.7528423024405,1100.6868591786001
"147.32.84.165",21512,"184.173.217.40",443,9,552,6,372,3,180,55581.827567,1.3082690000010189,2274.7615360431855,1100.6910658273478
"147.32.84.165",21513,"184.173.217.40",443,9,552,6,372,3,180,55584.131186,1.307619999999588,2275.8905492428516,1101.2373625368639
"147.32.84.165",21514,"184.173.217.40",443,9,552,6,372,3,180,55586.434651,1.307398999997531,2276.275261037847,1101.4235134054097
"147.32.84.165",21515,"184.173.217.40",443,9,552,6,372,3,180,55588.737919,1.3075989999997546,2275.9270999752666,1101.255048375129
"147.32.84.165",21516,"184.173.217.40",443,9,552,6,372,3,180,55591.040905,1.3079890000008163,2275.248492149508,1100.9266897497619
"147.32.84.165",21517,"184.173.217.40",443,9,552,6,372,3,180,55593.344189,1.3083129999940866,2274.6850333318184,1100.6540483863637
"147.32.84.165",21518,"184.173.217.40",443,9,552,6,372,3,180,55595.647793,1.307940000006056,2275.3337308945524,1100.9679343038156
"147.32.84.165",21519,"184.173.217.40",443,9,552,6,372,3,180,55597.951345,1.3071710000003804,2276.6722945958363,1101.61562641734
"147.32.84.165",21520,"74.125.93.27",25,6,372,6,372,0,0,55598.411533,9.013074000002234,330.18701499613366,0
"147.32.84.165",21521,"184.173.217.40",443,9,552,6,372,3,180,55600.254641,1.3075069999977131,2276.0872408371083,1101.3325358889235
"147.32.84.165",21522,"184.173.217.40",443,9,552,6,372,3,180,55602.557777,1.3076460000011139,2275.8452975785995,1101.21546657029
"147.32.84.165",21523,"184.173.217.40",443,9,552,6,372,3,180,55604.860851,1.307979000004707,2275.265887288168,1100.9351067523394
"147.32.84.165",21524,"184.173.217.40",443,9,552,6,372,3,180,55607.164228,1.3074859999978798,2276.123797887569,1101.3502247843076
"147.32.84.165",21525,"184.173.217.40",443,9,552,6,372,3,180,55609.467307,1.3085019999998622,2274.3564778657683,1100.495069935049
"147.32.84.165",21526,"184.173.217.40",443,9,552,6,372,3,180,55611.771173,1.3075099999987287,2276.0820184953795,1101.330008949377
"147.32.84.165",21527,"184.173.217.40",443,9,552,6,372,3,180,55614.074443,1.207709000002069,2464.1697627449175,1192.340207779799
"147.32.84.165",21528,"184.173.217.40",443,9,552,6,372,3,180,55616.277353,1.307440000004135,2276.20387932952,1101.3889738691225
"147.32.84.165",21529,"184.173.217.40",443,9,552,6,372,3,180,55618.580778,1.3072749999992084,2276.491174390853,1101.5279876084771
"147.32.84.165",21530,"74.125.39.27",25,6,372,6,372,0,0,55619.341882,9.012578000001668,330.20518657363624,0
"147.32.84.165",21531,"184.173.217.40",443,9,552,6,372,3,180,55620.884181,1.3072099999990314,2276.6043711432785,1101.5827602306185
"147.32.84.165",21532,"184.173.217.40",443,9,552,6,372,3,180,55623.187194,1.307953000003181,2275.3111159137693,1100.9569915711788
"147.32.84.165",21533,"184.173.217.40",443,9,552,6,372,3,180,55625.490197,1.3082100000028731,2274.8641273140124,1100.7407067648446
"147.32.84.165",21534,"184.173.217.40",443,9,552,6,372,3,180,55627.794156,1.307331999996677,2276.391918814474,1101.479960716681
"147.32.84.165",21535,"184.173.217.40",443,9,552,6,372,3,180,55630.097035,1.3076789999977336,2275.7878653745743,1101.1876767941487
"147.32.84.165",21536,"184.173.217.40",443,9,552,6,372,3,180,55632.400832,1.3072680000041146,2276.5033642609114,1101.5338859326991
"147.32.84.165",21537,"184.173.217.40",443,9,552,6,372,3,180,55634.703859,1.307357999998203,2276.3466472107034,1101.4580551019533
"147.32.84.165",21538,"184.173.217.40",443,9,552,6,372,3,180,55637.007094,1.3080750000008265,2275.0989048778697,1100.8543088118724
"147.32.84.165",21539,"184.173.217.40",443,9,552,6,372,3,180,55639.310655,1.3075219999955152,2276.0611293807733,1101.3199013132776
"147.32.84.165",21540,"66.111.4.73",25,6,372,6,372,0,0,55640.371646,9.013029000001552,330.18866354468486,0
"147.32.84.165",21541,"184.173.217.40",443,9,552,6,372,3,180,55641.614393,1.307089999994787,2276.8133793479174,1101.6838932328633
"147.32.84.165",21542,"184.173.217.40",443,9,552,6,372,3,180,55643.917007,1.3078030000033323,2275.572085392385,1101.0832671253474
"147.32.84.165",21543,"184.173.217.40",443,9,552,6,372,3,180,55646.220503,1.3077400000038324,2275.681710425068,1101.1363114960006
"147.32.84.165",21544,"184.173.217.40",443,9,552,6,372,3,180,55648.523484,1.3083050000059302,2274.6989425145593,1100.660778636077
"147.32.84.165",21545,"184.173.217.40",443,9,552,6,372,3,180,55650.826816,1.3076920000021346,2275.7652413528126,1101.1767296868447
"147.32.84.165",21546,"184.173.217.40",443,9,552,6,372,3,180,55653.130462,1.3079299999953946,2275.3511273619224,1100.9763519493172
"147.32.84.165",21547,"184.173.217.40",443,9,552,6,372,3,180,55655.43341,1.3081050000037067,2275.0467278938368,1100.8290618841145
"147.32.84.165",21548,"184.173.217.40",443,9,552,6,372,3,180,55657.737036,1.307966000000306,2275.288501382531,1100.9460490560634
"147.32.84.165",21549,"184.173.217.40",443,9,552,6,372,3,180,55660.040062,1.3078000000023167,2275.577305394348,1101.085792932749
"147.32.84.165",21550,"216.157.130.15",25,6,372,6,372,0,0,55661.402354,9.012736000004224,330.1993978297606,0
"147.32.84.165",21551,"184.173.217.40",443,9,552,6,372,3,180,55662.343205,1.3079730000026757,2275.276324506631,1100.9401570193377
"147.32.84.165",21552,"184.173.217.40",443,9,552,6,372,3,180,55664.646648,1.3079519999955664,2275.312855525346,1100.957833318716
"147.32.84.165",21553,"184.173.217.40",443,9,552,6,372,3,180,55666.950074,1.3078440000026603,2275.50074779098,1101.0487489311195
"147.32.84.165",21554,"184.173.217.40",443,9,552,6,372,3,180,55669.253259,1.3081120000060764,2275.034553605636,1100.8231710995015
"147.32.84.165",21555,"184.173.217.40",443,9,552,6,372,3,180,55671.556682,1.307779999995546,2275.6121060194646,1101.1026319449024
"147.32.84.165",21556,"184.173.217.40",443,9,552,6,372,3,180,55673.859844,1.3082770000037272,2274.7476260696485,1100.6843351949913
"147.32.84.165",21557,"184.173.217.40",443,9,552,6,372,3,180,55676.163714,1.3079480000014883,2275.3198139349684,1100.9612002911135
"147.32.84.165",21558,"184.173.217.40",443,9,552,6,372,3,180,55678.466959,1.3074310000010883,2276.219548104277,1101.3965555343275
"147.32.84.165",21559,"184.173.217.40",443,9,552,6,372,3,180,55680.770172,1.3079850000067381,2275.25545016546,1100.9300565316742
"147.32.84.165",21560,"184.173.217.40",443,9,552,6,372,3,180,55683.073346,1.3078170000007958,2275.547725712534,1101.0714801834843
"147.32.84.165",21561,"184.173.217.40",443,9,552,6,372,3,180,55685.377099,1.3070150000057765,2276.9440289414024,1101.747110778098
"147.32.84.165",21562,"184.173.217.40",443,9,552,6,372,3,180,55687.680075,1.3075710000048275,2275.975836102982,1101.2786303724108
"147.32.84.165",21563,"184.173.217.40",443,9,552,6,372,3,180,55689.983128,1.3077940000002855,2275.5877454701204,1101.0908445823163
"147.32.84.165",21564,"184.173.217.40",443,9,552,6,372,3,180,55692.286471,1.3077180000036606,2275.7199946713813,1101.1548361313137
"147.32.84.165",21565,"184.173.217.40",443,9,552,6,372,3,180,55694.589938,1.3075210000024526,2276.062870114069,1101.3207436035818
"147.32.84.165",21566,"184.173.217.40",443,9,552,6,372,3,180,55696.893221,1.3076619999992545,2275.817451299875,1101.2019925644554
"147.32.84.165",21567,"184.173.217.40",443,9,552,6,372,3,180,55699.196311,1.3083590000023833,2274.6050586991637,1100.6153509834662
"147.32.84.165",21568,"184.173.217.40",443,9,552,6,372,3,180,55701.499902,1.3080539999937173,2275.13543019959,1100.87198235464
"147.32.84.165",21569,"184.173.217.40",443,9,552,6,372,3,180,55703.802893,1.3079839999991236,2275.257189691918,1100.9308982380248
"147.32.84.165",21570,"184.173.217.40",443,9,552,6,372,3,180,55706.106122,1.307770999999775,2275.627766635376,1101.1102096622785
"147.32.84.165",21571,"184.173.217.40",443,9,552,6,372,3,180,55708.410139,1.3074049999995623,2276.264814652687,1101.418458702913
"147.32.84.165",21572,"184.173.217.40",443,9,552,6,372,3,180,55710.713236,1.3078169999935199,2275.5477257251937,1101.07148018961
"147.32.84.165",21573,"184.173.217.40",443,9,552,6,372,3,180,55713.016785,1.3072309999988647,2276.567798654243,1101.5650638649563
"147.32.84.165",21574,"184.173.217.40",443,9,552,6,372,3,180,55715.319877,1.3082179999983055,2274.850216098429,1100.733975531498
"147.32.84.165",21575,"184.173.217.40",443,9,552,6,372,3,180,55717.623388,1.3073850000000675,2276.299636296765,1101.4353078855315
"147.32.84.165",21576,"184.173.217.40",443,9,552,6,372,3,180,55719.926471,1.307927000001655,2275.3563463375513,1100.9788772601055
"147.32.84.165",21577,"173.192.170.88",80,26,3993,18,1526,8,2467,55721.586576,42.918698000001314,284.44478907537285,459.84619570704115
"147.32.84.165",21578,"184.173.217.40",443,9,552,6,372,3,180,55722.229531,1.3078970000060508,2275.4085375119234,1101.0041310541565
"147.32.84.165",21579,"173.192.170.88",80,42,5588,28,2572,14,3016,55722.791249,46.22017000000051,445.1736114341374,522.0231773271222
"147.32.84.165",21580,"184.173.217.40",443,9,552,6,372,3,180,55724.533203,1.3077130000019679,2275.728695818977,1101.1590463640212
"147.32.84.165",21581,"184.173.217.40",443,9,552,6,372,3,180,55726.836344,1.3075749999989057,2275.9688736802786,1101.2752614581993
"147.32.84.165",21582,"184.173.217.40",443,9,552,6,372,3,180,55729.139585,1.307927000001655,2275.3563463375513,1100.9788772601055
"147.32.84.165",21583,"184.173.217.40",443,9,552,6,372,3,180,55731.443938,1.3073650000005728,2276.3344590062425,1101.4521575836657
"147.32.84.165",21585,"184.173.217.40",443,9,552,6,372,3,180,55733.746522,1.3073129999975208,2276.4250030449048,1101.4959692152765
"147.32.84.165",21587,"184.173.217.40",443,9,552,6,372,3,180,55736.049433,1.3082549999962794,2274.785878906225,1100.7028446320444
"147.32.84.165",21588,"184.173.217.40",443,9,552,6,372,3,180,55738.352543,1.3081459999957588,2274.975423239951,1100.7945596322343
"147.32.84.165",21589,"184.173.217.40",443,9,552,6,372,3,180,55740.656624,1.3070779999980005,2276.834282272789,1101.6940075513496
"147.32.84.165",21591,"98.126.71.122",80,18,4863,14,1430,4,3433,55741.490872,16.53359199999977,691.9246585980928,1661.1030440330437
"147.32.84.165",21592,"195.113.232.98",80,17,5675,12,2556,5,3119,55742.093757,31.08355699999811,657.8397703969737,802.7395320297969
"147.32.84.165",21593,"195.113.232.83",80,13,1970,10,1598,3,372,55742.332476,30.845024999995076,414.4590578221947,96.4823338609865
"147.32.84.165",21594,"77.238.175.247",80,14,2274,10,1276,4,998,55742.375441,0.13804000000527594,73949.5798291064,57838.307734677255
"147.32.84.165",21595,"74.125.232.218",80,13,1871,10,1156,3,715,55742.376798,30.800904000003356,300.2509277000114,185.70883503936693
"147.32.84.165",21596,"64.236.79.229",80,14,2274,10,1560,4,714,55742.381476,0.35545099999581,35110.32463025034,16069.725503845348
"147.32.84.165",21597,"64.236.79.229",80,14,2078,10,1378,4,700,55742.40041,0.3551919999954407,31036.73506199888,15766.120858780272
"147.32.84.165",21598,"68.67.185.208",80,16,2170,12,1370,4,800,55742.402786,10.614198000002943,1032.5791925114795,602.9659518315209
"147.32.84.165",21599,"64.236.79.229",80,14,2061,10,1404,4,657,55742.494904,0.38130800000362797,29456.502354771295,13784.132512168619
"147.32.84.165",21600,"77.238.167.32",80,13,2342,10,1390,3,952,55742.535959,0.1401869999972405,79322.61907465664,54327.43407127563
"147.32.84.165",21601,"64.236.79.229",80,14,2043,10,1386,4,657,55742.545799,0.35559700000158045,31181.3654219544,14780.777115601762
"147.32.84.165",21602,"77.238.175.247",80,14,3055,10,1368,4,1687,55742.630849,0.14073700000153622,77762.06683303282,95895.18037085261
"147.32.84.165",21603,"195.113.232.96",80,13,1965,10,1306,3,659,55742.639493,30.53838800000085,342.1267684463145,172.63517642122608
"147.32.84.165",21604,"64.236.79.229",80,14,2089,10,1432,4,657,55742.757987,0.3559510000050068,32184.205128904992,14766.07735313588
"147.32.84.165",21605,"74.217.252.37",80,12,2075,10,1278,2,797,55742.794628,30.383431999995082,336.4991815276712,209.85121101530044
"147.32.84.165",21606,"184.173.217.40",443,9,552,6,372,3,180,55742.966672,1.3073069999954896,2276.4354509004143,1101.5010246292327
"147.32.84.165",21607,"184.173.217.40",443,9,552,6,372,3,180,55745.269812,1.2137440000005881,2451.9173730198113,1186.4116321063605
"147.32.84.165",21609,"195.113.232.98",80,13,3267,10,1588,3,1679,55745.866429,45.99813899999572,276.18508653146125,292.01181378231956
"147.32.84.165",21610,"195.113.232.83",80,13,1891,10,1518,3,373,55746.00445,45.86032300000079,264.80406603328527,65.06713875521436
"147.32.84.165",21611,"77.238.175.247",80,14,2929,10,1358,4,1571,55746.01524,0.1393099999986589,77984.3514471652,90216.06489211821
"147.32.84.165",21612,"64.236.79.229",80,14,2218,10,1504,4,714,55746.0157,0.3554879999937839,33846.430822448,16068.052930337679
"147.32.84.165",21613,"74.125.232.218",80,13,1871,10,1156,3,715,55746.021457,45.84374199999729,201.72873322602126,124.77166458183841
"147.32.84.165",21614,"68.67.185.208",80,16,2274,12,1456,4,818,55746.021829,10.47019800000271,1112.4909003628188,625.0120580335067
"147.32.84.165",21615,"64.236.79.229",80,14,2022,10,1322,4,700,55746.02212,0.35509499999898253,29783.579042313475,15770.427632087318
"147.32.84.165",21616,"64.236.79.229",80,14,2041,10,1384,4,657,55746.073849,0.3556289999978617,31133.568972346387,14779.447120543047
"147.32.84.165",21617,"64.236.79.229",80,14,2033,10,1376,4,657,55746.109417,0.35568500000226777,30948.732726794256,14777.12020458127
"147.32.84.165",21618,"64.236.79.229",80,14,1987,10,1330,4,657,55746.157542,0.35537900000053924,29939.867015169315,14789.844081929503
"147.32.84.165",21619,"195.113.232.96",80,13,1949,10,1418,3,531,55746.254309,45.610696999996435,248.71358576258737,93.1360465725909
"147.32.84.165",21620,"74.217.252.37",80,12,2269,10,1472,2,797,55746.260499,45.60489299999608,258.2179065742137,139.80955946986978
"147.32.84.165",21621,"184.173.217.40",443,9,552,6,372,3,180,55747.479167,1.3079460000008112,2275.3232931620682,1100.9628837880975
"147.32.84.165",21622,"184.173.217.40",443,9,552,6,372,3,180,55749.78287,1.3076319999963744,2275.8696636425625,1101.22725660124
"147.32.84.165",21623,"184.173.217.40",443,9,552,6,372,3,180,55752.085951,1.3076060000021243,2275.9149162631293,1101.2491530305463
"147.32.84.165",21624,"184.173.217.40",443,9,552,6,372,3,180,55754.388996,1.3080699999991339,2275.1076012766675,1100.8585167467747
"147.32.84.165",21625,"184.173.217.40",443,9,552,6,372,3,180,55756.692668,1.30757199999789,2275.9740955028115,1101.2777881465217
"147.32.84.165",21626,"184.173.217.40",443,9,552,6,372,3,180,55758.996299,1.307583000001614,2275.9549489373344,1101.2685236793554
"147.32.84.165",21627,"184.173.217.40",443,9,552,6,372,3,180,55761.299097,1.3077199999970617,2275.716514243635,1101.153152053372
"147.32.84.165",21628,"184.173.217.40",443,9,552,6,372,3,180,55763.602414,1.308098000001337,2275.0589023123334,1100.8349527317741
"147.32.84.165",21629,"173.192.170.88",80,14,2337,10,966,4,1371,55764.304886,1.4127660000012838,5470.12031716008,7763.4937420563865
"147.32.84.165",21630,"173.192.170.88",80,13,1407,10,970,3,437,55765.825236,7.259605000006559,1068.9286813804592,481.5689007868667
"147.32.84.165",21631,"184.173.217.40",443,9,552,6,372,3,180,55765.906206,1.307170000000042,2276.674036276769,1101.6164691661786
"147.32.84.165",21632,"184.173.217.40",443,9,552,6,372,3,180,55768.209192,1.3079219999999623,2275.3650447045666,1100.9830861473708
"147.32.84.165",21633,"173.192.170.88",80,23,2735,18,2174,5,561,55768.810888,22.96010799999931,757.4877261030533,195.46946381960115
"147.32.84.165",21634,"184.173.217.40",443,9,552,6,372,3,180,55770.512552,1.3073070000027656,2276.4354508877445,1101.501024623102
"147.32.84.165",21635,"184.173.217.40",443,9,552,6,372,3,180,55772.81594,1.3077120000016293,2275.7304360564804,1101.159888414426
"147.32.84.165",21636,"184.173.217.40",443,9,552,6,372,3,180,55775.118777,1.3080799999952433,2275.090208558209,1100.8501009152624
"147.32.84.165",21637,"184.173.217.40",443,9,552,6,372,3,180,55777.422568,1.3073759999970207,2276.3153063898844,1101.4428901886538
"147.32.84.165",21638,"184.173.217.40",443,9,552,6,372,3,180,55779.725508,1.3084139999991748,2274.509444259903,1100.5690859322112
"147.32.84.165",21639,"184.173.217.40",443,9,552,6,372,3,180,55782.029093,1.3078820000009728,2275.4346340096326,1101.0167583917578
"147.32.84.165",21640,"184.173.217.40",443,9,552,6,372,3,180,55784.332665,1.3077369999955408,2275.6869309426497,1101.138837552895
"147.32.84.165",21641,"184.173.217.40",443,9,552,6,372,3,180,55786.63587,1.307581000000937,2275.958430107097,1101.270208116337
"147.32.84.165",21642,"184.173.217.40",443,9,552,6,372,3,180,55788.939247,1.3077839999969,2275.6051458092884,1101.0992641012685
"147.32.84.165",21643,"184.173.217.40",443,9,552,6,372,3,180,55791.242543,1.3073139999978594,2276.423261744977,1101.4951266507953
"147.32.84.165",21644,"184.173.217.40",443,9,552,6,372,3,180,55793.545549,1.307926999994379,2275.356346350209,1100.9788772662303
"147.32.84.165",21645,"184.173.217.40",443,9,552,6,372,3,180,55795.84898,1.3078439999953844,2275.500747803639,1101.048748937245
"147.32.84.165",21646,"184.173.217.40",443,9,552,6,372,3,180,55798.151839,1.307937999998103,2275.3372101768714,1100.9696178275183
"147.32.84.165",21647,"184.173.217.40",443,9,552,6,372,3,180,55800.455808,1.307717000003322,2275.7217348955774,1101.1556781752795
"147.32.84.165",21648,"94.100.176.20",25,6,372,6,372,0,0,55802.634127,8.997255000002042,330.76755076957636,0
"147.32.84.165",21649,"184.173.217.40",443,9,552,6,372,3,180,55802.758893,1.3077029999985825,2275.7460983137807,1101.1674669260228
"147.32.84.165",21650,"184.173.217.40",443,9,552,6,372,3,180,55805.062337,1.3079499999948894,2275.3163347311656,1100.9595168054027
"147.32.84.165",21651,"184.173.217.40",443,9,552,6,372,3,180,55807.365151,1.3085400000054506,2274.290430546719,1100.463111554864
"147.32.84.165",21652,"184.173.217.40",443,9,552,6,372,3,180,55809.668597,1.3081029999957536,2275.05020629848,1100.8307449831354
"147.32.84.165",21653,"184.173.217.40",443,9,552,6,372,3,180,55811.972268,1.3080900000059046,2275.0728160803665,1100.8416852001774
"147.32.84.165",21654,"184.173.217.40",443,9,552,6,372,3,180,55814.275328,1.3080059999992955,2275.218921015349,1100.9123811364593
"147.32.84.165",21655,"184.173.217.40",443,9,552,6,372,3,180,55816.578646,1.308139000000665,2274.987596882661,1100.8004501045134
"147.32.84.165",21656,"184.173.217.40",443,9,552,6,372,3,180,55818.881743,1.3077550000016345,2275.655608272406,1101.123681422132
"147.32.84.165",21657,"184.173.217.40",443,9,552,6,372,3,180,55821.185397,1.3077379999958794,2275.6851907716814,1101.1379955346847
"147.32.84.165",21658,"184.173.217.40",443,9,552,6,372,3,180,55823.488795,1.307662999999593,2275.8157109292883,1101.2011504496556
"147.32.84.165",21659,"74.125.93.27",25,6,372,6,372,0,0,55823.548549,9.013073000001896,330.1870516303789,0
"147.32.84.165",21660,"184.173.217.40",443,9,552,6,372,3,180,55825.792129,1.3079839999991236,2275.257189691918,1100.9308982380248
"147.32.84.165",21661,"184.173.217.40",443,9,552,6,372,3,180,55828.095455,1.3074439999982133,2276.1969155115376,1101.3856042797763
"147.32.84.165",21662,"184.173.217.40",443,9,552,6,372,3,180,55830.398429,1.3076949999958742,2275.7600205012554,1101.1742034683493
"147.32.84.165",21663,"184.173.217.40",443,9,552,6,372,3,180,55832.701879,1.3080800000025192,2275.090208545554,1100.8501009091392
"147.32.84.165",21664,"184.173.217.40",443,9,552,6,372,3,180,55835.005181,1.3082009999998263,2274.8797776491497,1100.748279507653
"147.32.84.165",21665,"184.173.217.40",443,9,552,6,372,3,180,55837.3085,1.3074429999978747,2276.198656465205,1101.3864466767122
"147.32.84.165",21666,"184.173.217.40",443,9,552,6,372,3,180,55839.611508,1.3085799999971641,2274.2209112216674,1100.4294731717746
"147.32.84.165",21667,"184.173.217.40",443,9,552,6,372,3,180,55841.915211,1.3081069999971078,2275.043249525138,1100.8273788024862
"147.32.84.165",21668,"184.173.217.40",443,9,552,6,372,3,180,55844.218644,1.307463999997708,2276.1620970101026,1101.3687566177916
"147.32.84.165",21669,"74.125.39.27",25,6,372,6,372,0,0,55844.57924,9.012534000001324,330.20679866501064,0
"147.32.84.165",21670,"184.173.217.40",443,9,552,6,372,3,180,55846.52153,1.3080950000003213,2275.0641199601473,1100.8374774000713
"147.32.84.165",21671,"184.173.217.40",443,9,552,6,372,3,180,55848.825012,1.3077419999972335,2275.678230114423,1101.1346274747207
"147.32.84.165",21672,"184.173.217.40",443,9,552,6,372,3,180,55851.128134,1.308379000001878,2274.570288880919,1100.5985268778643
"147.32.84.165",21673,"184.173.217.40",443,9,552,6,372,3,180,55853.431341,1.3084749999979977,2274.4034085515996,1100.517778331419
"147.32.84.165",21674,"184.173.217.40",443,9,552,6,372,3,180,55855.735217,1.307557000000088,2276.000204962231,1101.2904217559183
"147.32.84.165",21675,"184.173.217.40",443,9,552,6,372,3,180,55858.03799,1.3077890000058687,2275.596445593781,1101.0950543195713
"147.32.84.165",21676,"184.173.217.40",443,9,552,6,372,3,180,55860.341253,1.3083870000045863,2274.5563812461974,1100.5917973771923
"147.32.84.165",21677,"184.173.217.40",443,9,552,6,372,3,180,55862.645264,1.3079260000013164,2275.358086005634,1100.979719034984
"147.32.84.165",21678,"184.173.217.40",443,9,552,6,372,3,180,55864.947994,1.3080550000013318,2275.133690859306,1100.8711407383742
"147.32.84.165",21679,"66.111.4.73",25,6,372,6,372,0,0,55865.60929,9.012823999997636,330.1961738075414,0
"147.32.84.165",21680,"184.173.217.40",443,9,552,6,372,3,180,55867.251522,1.3076419999997597,2275.8522592579216,1101.2188351248008
"147.32.84.165",21681,"184.173.217.40",443,9,552,6,372,3,180,55869.55478,1.3080300000001444,2275.1771748351885,1100.8921813718655
"147.32.84.165",21682,"184.173.217.40",443,9,552,6,372,3,180,55871.857812,1.308141000001342,2274.98411868212,1100.7987671042515
"147.32.84.165",21683,"184.173.217.40",443,9,552,6,372,3,180,55874.161412,1.3080409999965923,2275.158041688107,1100.8829233974711
"147.32.84.165",21684,"184.173.217.40",443,9,552,6,372,3,180,55876.464536,1.3082809999978053,2274.7406711593244,1100.6809699158023
"147.32.84.165",21685,"184.173.217.40",443,9,552,6,372,3,180,55878.767985,1.3080919999993057,2275.069337631894,1100.8400020799488
"147.32.84.165",21686,"184.173.217.40",443,9,552,6,372,3,180,55881.071228,1.30808899999829,2275.0745553275733,1100.8425267714065
"147.32.84.165",21687,"184.173.217.40",443,9,552,6,372,3,180,55883.374484,1.2077460000000428,2464.0942714775247,1192.3036797471893
"147.32.84.165",21688,"184.173.217.40",443,9,552,6,372,3,180,55885.577877,1.3081509999974514,2274.9667278515994,1100.790352186258
"147.32.84.165",21689,"216.157.130.15",25,6,372,6,372,0,0,55886.538888,9.013034999996307,330.1884437374557,0
"147.32.84.165",21690,"184.173.217.40",443,9,552,6,372,3,180,55887.880919,1.3084689999959664,2274.4138378587295,1100.522824770353
"147.32.84.165",21691,"184.173.217.40",443,9,552,6,372,3,180,55890.184714,1.3077879999982542,2275.598185641689,1101.0958962782365
"147.32.84.165",21692,"184.173.217.40",443,9,552,6,372,3,180,55892.487803,1.3078109999987646,2275.558165516891,1101.0765317017217
"147.32.84.165",21693,"184.173.217.40",443,9,552,6,372,3,180,55894.791195,1.307436000002781,2276.2108432027803,1101.392343485216
"147.32.84.165",21694,"184.173.217.40",443,9,552,6,372,3,180,55897.094705,1.307539999994333,2276.029796421447,1101.3047402039258
"147.32.84.165",21695,"184.173.217.40",443,9,552,6,372,3,180,55899.397712,1.3076440000004368,2275.8487784129366,1101.2171508449692
"147.32.84.165",21696,"184.173.217.40",443,9,552,6,372,3,180,55901.700706,1.3083960000003572,2274.5407353730734,1100.5842267934227
"147.32.84.165",21697,"184.173.217.40",443,9,552,6,372,3,180,55904.004086,1.3081939999974566,2274.891950280911,1100.7541694907634
"147.32.84.165",21698,"184.173.217.40",443,9,552,6,372,3,180,55906.3078,1.3076259999943431,2275.8801064011227,1101.2323095489303
"147.32.84.165",21699,"184.173.217.40",443,9,552,6,372,3,180,55908.611334,1.3076250000012806,2275.881846857536,1101.2331517052594
"147.32.84.165",21700,"184.173.217.40",443,9,552,6,372,3,180,55910.914576,1.3077009999979055,2275.74957884468,1101.1691510538774
"147.32.84.165",21701,"184.173.217.40",443,9,552,6,372,3,180,55913.217858,1.3078819999936968,2275.4346340222914,1101.016758397883
"147.32.84.165",21702,"184.173.217.40",443,9,552,6,372,3,180,55915.521037,1.3074340000021039,2276.2143251553894,1101.3940283009947
"147.32.84.165",21703,"184.173.217.40",443,9,552,6,372,3,180,55917.824112,1.3081769999989774,2274.921512916315,1100.7684739917654
"147.32.84.165",21704,"184.173.217.40",443,9,552,6,372,3,180,55920.127296,1.3078710000045248,2275.453771809073,1101.0260186172934
"147.32.84.165",21705,"184.173.217.40",443,9,552,6,372,3,180,55922.430577,1.308364000004076,2274.596366141784,1100.6111449073148
"147.32.84.165",21706,"184.173.217.40",443,9,552,6,372,3,180,55924.734087,1.3079490000018268,2275.3180743254084,1100.9603585445525
"147.32.84.165",21707,"184.173.217.40",443,9,552,6,372,3,180,55927.037792,1.3074479999995674,2276.1899517234983,1101.3822347049186
"147.32.84.165",21708,"184.173.217.40",443,9,552,6,372,3,180,55929.340613,1.3082910000011907,2274.7232840379484,1100.6725567925557
"147.32.84.165",21709,"184.173.217.40",443,9,552,6,372,3,180,55931.64405,1.3079799999977695,2275.264147773724,1100.9342650518017
"147.32.84.165",21710,"184.173.217.40",443,9,552,6,372,3,180,55933.947303,1.3079500000021653,2275.3163347185086,1100.9595167992784
"147.32.84.165",21711,"184.173.217.40",443,9,552,6,372,3,180,55936.250749,1.3078180000011344,2275.5459857544543,1101.0706382682843
"147.32.84.165",21712,"184.173.217.40",443,9,552,6,372,3,180,55938.554194,1.3074810000034631,2276.132502110637,1101.3544365051469
"147.32.84.165",21713,"184.173.217.40",443,9,552,6,372,3,180,55940.857054,1.307872999997926,2275.4502921955873,1101.0243349333487
"147.32.84.165",21714,"184.173.217.40",443,9,552,6,372,3,180,55943.160289,1.3078040000036708,2275.5703453970523,1101.0824251921222
"147.32.84.165",21715,"184.173.217.40",443,9,552,6,372,3,180,55945.464164,1.3074310000010883,2276.219548104277,1101.3965555343275
"147.32.84.165",21716,"184.173.217.40",443,9,552,6,372,3,180,55947.76695,1.3084090000047581,2274.5181361402874,1100.5732916807842
"147.32.84.165",21717,"184.173.217.40",443,9,552,6,372,3,180,55950.070672,1.3075969999990775,2275.9305810598366,1101.256732770889
"147.32.84.165",21718,"184.173.217.40",443,9,552,6,372,3,180,55952.374138,1.3077869999979157,2275.5999256795967,1101.096738232063
"147.32.84.165",21719,"184.173.217.40",443,9,552,6,372,3,180,55954.677141,1.3080419999969308,2275.156302325906,1100.8820817705998
"147.32.84.165",21720,"184.173.217.40",443,9,552,6,372,3,180,55956.980752,1.3076209999999264,2275.8888087604646,1101.2365203679667
"147.32.84.165",21721,"184.173.217.40",443,9,552,6,372,3,180,55959.283953,1.3079350000043632,2275.3424290886564,1100.9721431074145
"147.32.84.165",21722,"184.173.217.40",443,9,552,6,372,3,180,55961.58687,1.3084040000030654,2274.5268280997516,1100.5774974676217
"147.32.84.165",21723,"184.173.217.40",443,9,552,6,372,3,180,55963.890669,1.3076639999999315,2275.8139705613644,1101.200308336144
"147.32.84.165",21724,"184.173.217.40",443,9,552,6,372,3,180,55966.193919,1.3079130000041914,2275.38070192013,1100.9906622194178
"147.32.84.165",21725,"184.173.217.40",443,9,552,6,372,3,180,55968.49706,1.3076849999997648,2275.7774234624817,1101.1826242560394
"147.32.84.165",21726,"184.173.217.40",443,9,552,6,372,3,180,55970.800078,1.308192999997118,2274.8936892389397,1100.7550109220676
"147.32.84.165",21727,"184.173.217.40",443,9,552,6,372,3,180,55973.103488,1.3077740000007907,2275.6225464019017,1101.1076837428557
"147.32.84.165",21728,"184.173.217.40",443,9,552,6,372,3,180,55975.407391,1.3077140000023064,2275.726955584135,1101.158204314904
"147.32.84.165",21729,"184.173.217.40",443,9,552,6,372,3,180,55977.710603,1.3076430000000983,2275.850518834098,1101.217992984241
"147.32.84.165",21730,"184.173.217.40",443,9,552,6,372,3,180,55980.01336,1.3082090000025346,2274.8658662295047,1100.7415481755668
"147.32.84.165",21731,"184.173.217.40",443,9,552,6,372,3,180,55982.316618,1.3080990000016754,2275.0571631017133,1100.8341111782483
"147.32.84.165",21732,"184.173.217.40",443,9,552,6,372,3,180,55984.620433,1.3071920000002137,2276.6357199244744,1101.5979289957133
"147.32.84.165",21733,"184.173.217.40",443,9,552,6,372,3,180,55986.923896,1.307715000002645,2275.7252153519544,1101.1573622670746
"147.32.84.165",21734,"184.173.217.40",443,9,552,6,372,3,180,55989.226717,1.3079890000008163,2275.248492149508,1100.9266897497619
"147.32.84.165",21735,"184.173.217.40",443,9,552,6,372,3,180,55991.530133,1.3080810000028578,2275.088469287069,1100.8492593324527
"147.32.84.165",21736,"184.173.217.40",443,9,552,6,372,3,180,55993.833636,1.3078179999938584,2275.545985767114,1101.07063827441
"147.32.84.165",21737,"184.173.217.40",443,9,552,6,372,3,180,55996.136678,1.4157839999970747,2102.015561700195,1017.1043040484815
"147.32.84.165",21738,"184.173.217.40",443,9,552,6,372,3,180,55998.550574,1.2981240000008256,2292.539079470149,1109.2931029694269
"147.32.84.165",21739,"184.173.217.40",443,9,552,6,372,3,180,56000.843264,1.307818999994197,2275.544245811695,1101.0697963604975
"147.32.84.165",21740,"184.173.217.40",443,9,552,6,372,3,180,56003.147028,1.3081170000004931,2275.025857777919,1100.8189634409287
"147.32.84.165",21741,"184.173.217.40",443,9,552,6,372,3,180,56005.450163,1.307636999998067,2275.8609614169677,1101.2230458469198
"147.32.84.165",21742,"184.173.217.40",443,9,552,6,372,3,180,56007.753999,1.3074090000009164,2276.2578504491817,1101.4150889270234
"147.32.84.165",21743,"184.173.217.40",443,9,552,6,372,3,180,56010.056787,1.3078160000004573,2275.549465673275,1101.0723220999716
"147.32.84.165",21744,"184.173.217.40",443,9,552,6,372,3,180,56012.360271,1.3078180000011344,2275.5459857544543,1101.0706382682843
"147.32.84.165",21745,"184.173.217.40",443,9,552,6,372,3,180,56014.663321,1.308233999996446,2274.822394165023,1100.7205133056561
"147.32.84.165",21746,"184.173.217.40",443,9,552,6,372,3,180,56016.9668,1.3079769999967539,2275.269366363006,1100.9367901756482
"147.32.84.165",21747,"184.173.217.40",443,9,552,6,372,3,180,56019.270344,1.3074990000022808,2276.1011671862148,1101.3392744449427
"147.32.84.165",21748,"184.173.217.40",443,9,552,6,372,3,180,56021.573194,1.3080430000045453,2275.154562953709,1100.8812401388916
"147.32.84.165",21749,"173.192.170.88",80,27,4102,18,1526,9,2576,56021.607483,42.46241700000246,287.50129791244086,485.323291888891
"147.32.84.165",21750,"184.173.217.40",443,9,552,6,372,3,180,56023.877053,1.3078350000068895,2275.516406874203,1101.0563259068722
"147.32.84.165",21751,"184.173.217.40",443,9,552,6,372,3,180,56026.179815,1.3080579999950714,2275.128472905034,1100.8686159217907
"147.32.84.165",21752,"94.100.176.20",25,6,372,6,372,0,0,56027.855903,8.999335999993491,330.69106431876224,0
"147.32.84.165",21753,"184.173.217.40",443,9,552,6,372,3,180,56028.48333,1.3079699999943841,2275.2815431644285,1100.9426821763363
"147.32.84.165",21755,"184.173.217.40",443,9,552,6,372,3,180,56030.786689,1.3077489999996033,2275.666049066681,1101.1287334193617
"147.32.84.165",21756,"184.173.217.40",443,9,552,6,372,3,180,56033.090163,1.3077269999994314,2275.7043327860433,1101.1472577996983
"147.32.84.165",21757,"184.173.217.40",443,9,552,6,372,3,180,56035.39309,1.3075969999990775,2275.9305810598366,1101.256732770889
"147.32.84.165",21758,"184.173.217.40",443,9,552,6,372,3,180,56037.696444,1.3078580000001239,2275.476389638415,1101.0369627282653
"147.32.84.165",21760,"98.126.71.122",80,18,4863,14,1430,4,3433,56039.940482,20.092592000000877,569.3640720918187,1366.8719297141354
"147.32.84.165",21761,"184.173.217.40",443,9,552,6,372,3,180,56039.999712,1.2997090000062599,2289.7433194550986,1107.9403158653702
"147.32.84.165",21762,"95.100.248.96",80,17,5704,12,2574,5,3130,56040.537792,19.49540100000013,1056.2491122906301,1284.405486196454
"147.32.84.165",21763,"195.113.232.99",80,59,44380,46,3864,13,40516,56040.794776,19.2385129999966,1606.7769894692724,16847.871766391574
"147.32.84.165",21764,"184.173.217.40",443,9,552,6,372,3,180,56042.299743,1.308657999994466,2274.085360737935,1100.3638842280332
"147.32.84.165",21765,"184.173.217.40",443,9,552,6,372,3,180,56044.609148,1.3065839999981108,2277.6951194904445,1102.1105416889247
"147.32.84.165",21766,"184.173.217.40",443,9,552,6,372,3,180,56046.916345,1.3068740000016987,2277.1896908165068,1101.8659794273422
"147.32.84.165",21767,"74.125.93.27",25,6,372,6,372,0,0,56048.879258,9.032077999996545,329.49228294985255,0
"147.32.84.165",21768,"184.173.217.40",443,9,552,6,372,3,180,56049.223848,1.3064809999996214,2277.874687807065,1102.197429584064
"147.32.84.165",21769,"184.173.217.40",443,9,552,6,372,3,180,56051.531033,1.3089830000026268,2273.5207409065115,1100.0906810837957
"147.32.84.165",21770,"184.173.217.40",443,9,552,6,372,3,180,56053.840402,1.3073619999995572,2276.3396825064583,1101.45468508377
"147.32.84.165",21771,"184.173.217.40",443,9,552,6,372,3,180,56056.148507,1.3068219999986468,2277.280302905125,1101.909823986351
"147.32.84.165",21772,"184.173.217.40",443,9,552,6,372,3,180,56058.456126,1.3084369999996852,2274.469462420213,1100.5497398807481
"147.32.84.165",21773,"184.173.217.40",443,9,552,6,372,3,180,56060.784139,1.2976829999970505,2293.3181678474357,1109.6700812165013
"147.32.84.165",21774,"184.173.217.40",443,9,552,6,372,3,180,56063.077965,1.3074180000039632,2276.2421811470995,1101.407507006661
"147.32.84.165",21775,"173.192.170.88",80,6,372,6,372,0,0,56063.869093,8.881954999997106,335.0613688091158,0
"147.32.84.165",21776,"184.173.217.40",443,9,552,6,372,3,180,56065.380468,1.4084809999985737,2112.914551210143,1022.3780086500693
"147.32.84.165",21777,"184.173.217.40",443,9,552,6,372,3,180,56067.783726,1.3081329999986337,2274.998031548098,1100.8054991361764
"147.32.84.165",21778,"74.125.39.27",25,6,372,6,372,0,0,56069.847053,9.012414000004355,330.21119535771015,0
"147.32.84.165",21779,"184.173.217.40",443,9,552,6,372,3,180,56070.087703,1.3074340000021039,2276.2143251553894,1101.3940283009947
"147.32.84.165",21780,"184.173.217.40",443,9,552,6,372,3,180,56072.39079,1.3073290000029374,2276.39714256573,1101.4824883382564
"147.32.84.165",21781,"184.173.217.40",443,9,552,6,372,3,180,56074.693939,1.3078690000038478,2275.457251445859,1101.0277023125125
"147.32.84.165",21782,"184.173.217.40",443,9,552,6,372,3,180,56076.997599,1.3073010000007343,2276.4458988391566,1101.5060800834628
"147.32.84.165",21783,"184.173.217.40",443,9,552,6,372,3,180,56079.300561,1.3077290000001085,2275.700852393541,1101.1455737388103
"147.32.84.165",21784,"184.173.217.40",443,9,552,6,372,3,180,56081.603526,1.3077360000024782,2275.6886711036173,1101.1396795662665
"147.32.84.165",21785,"184.173.217.40",443,9,552,6,372,3,180,56083.906908,1.3081190000011702,2275.022379460384,1100.8172803840566
"147.32.84.165",21786,"173.192.170.88",80,18,2071,14,1572,4,499,56084.769402,12.946889999999257,971.3529658474523,308.33659666531724
"147.32.84.165",21787,"184.173.217.40",443,9,552,6,372,3,180,56086.210765,1.3076619999992545,2275.817451299875,1101.2019925644554
"147.32.84.165",21788,"184.173.217.40",443,9,552,6,372,3,180,56088.5136,1.3079100000031758,2275.3859210440887,1100.9931876019782
"147.32.84.165",21789,"184.173.217.40",443,9,552,6,372,3,180,56090.817168,1.3081339999989723,2274.9962924305446,1100.804657627683
"147.32.84.165",21790,"66.111.4.73",25,6,372,6,372,0,0,56090.877428,9.012567999998282,330.2055529567785,0
"147.32.84.165",21791,"184.173.217.40",443,9,552,6,372,3,180,56093.120271,1.3075430000026245,2276.024574330654,1101.3022133858005
"147.32.84.165",21792,"184.173.217.40",443,9,552,6,372,3,180,56095.423724,1.308273000002373,2274.7545810351526,1100.6877005008803
"147.32.84.165",21793,"184.173.217.40",443,9,552,6,372,3,180,56097.727096,1.3076149999978952,2275.899251694719,1101.2415734006706
"147.32.84.165",21794,"184.173.217.40",443,9,552,6,372,3,180,56100.030493,1.3075170000010985,2276.0698331245403,1101.324112802197
"147.32.84.165",21795,"184.173.217.40",443,9,552,6,372,3,180,56102.333278,1.3081569999994827,2274.9562934733194,1100.7853032935416
"147.32.84.165",21796,"184.173.217.40",443,9,552,6,372,3,180,56104.637134,1.308061000003363,2275.123254949386,1100.8660911045415
"147.32.84.165",21797,"184.173.217.40",443,9,552,6,372,3,180,56106.940253,1.3077639999974053,2275.6399472732883,1101.116103519333
"147.32.84.165",21798,"184.173.217.40",443,9,552,6,372,3,180,56109.243573,1.3078420000019833,2275.50422757144,1101.050432695858
"147.32.84.165",21799,"184.173.217.40",443,9,552,6,372,3,180,56111.546911,1.3080210000043735,2275.192829465314,1100.8997561928938
"147.32.84.165",21800,"216.157.130.15",25,6,372,6,372,0,0,56111.907889,9.012563999996928,330.20569951026306,0
"147.32.84.165",21801,"184.173.217.40",443,9,552,6,372,3,180,56113.850612,1.3076680000012857,2275.807009116285,1101.1969398949766
"147.32.84.165",21802,"184.173.217.40",443,9,552,6,372,3,180,56116.153314,1.307913999997254,2275.3789622301224,1100.9898204339302
"147.32.84.165",21803,"184.173.217.40",443,9,552,6,372,3,180,56118.457044,1.3079149999975925,2275.377222530117,1100.988978643605
"147.32.84.165",21804,"184.173.217.40",443,9,552,6,372,3,180,56120.760467,1.3074819999965257,2276.1307612708306,1101.3535941633052
"147.32.84.165",21805,"184.173.217.40",443,9,552,6,372,3,180,56123.063371,1.3078810000006342,2275.4363737974304,1101.017600224563
"147.32.84.165",21806,"184.173.217.40",443,9,552,6,372,3,180,56125.366534,1.3083859999969718,2274.5581197038855,1100.592638566396
"147.32.84.165",21807,"184.173.217.40",443,9,552,6,372,3,180,56127.669746,1.3085879999998724,2274.207007859074,1100.4227457382617
"147.32.84.165",21808,"184.173.217.40",443,9,552,6,372,3,180,56129.973269,1.307966000000306,2275.288501382531,1100.9460490560634
"147.32.84.165",21809,"184.173.217.40",443,9,552,6,372,3,180,56132.276839,1.3073530000037863,2276.355353138273,1101.4622676475517
"147.32.84.165",21810,"184.173.217.40",443,9,552,6,372,3,180,56134.580098,1.3074150000029476,2276.2474042238237,1101.4100343018501
"147.32.84.165",21811,"184.173.217.40",443,9,552,6,372,3,180,56136.88321,1.3074649999980466,2276.1603561123598,1101.367914247916
"147.32.84.165",21812,"184.173.217.40",443,9,552,6,372,3,180,56139.186558,1.3081309999979567,2275.001509791182,1100.8071821570236
"147.32.84.165",21813,"184.173.217.40",443,9,552,6,372,3,180,56141.489916,1.3078789999999572,2275.4398533810067,1101.0192838940354
"147.32.84.165",21814,"184.173.217.40",443,9,552,6,372,3,180,56143.793223,1.307703999998921,2275.744358052323,1101.1666248640274
"147.32.84.165",21815,"184.173.217.40",443,9,552,6,372,3,180,56146.096373,1.3083199999964563,2274.672862914318,1100.6481594746701
"147.32.84.165",21816,"184.173.217.40",443,9,552,6,372,3,180,56148.399796,1.3081999999994878,2274.8815165885685,1100.7491209299524
"147.32.84.165",21817,"184.173.217.40",443,9,552,6,372,3,180,56150.703535,1.3071659999986878,2276.68100302715,1101.6198401744275
"147.32.84.165",21818,"184.173.217.40",443,9,552,6,372,3,180,56153.006584,1.30766500000027,2275.8122301961016,1101.1994662239201
"147.32.84.165",21819,"184.173.217.40",443,9,552,6,372,3,180,56155.30976,1.3074070000002393,2276.2613325456077,1101.4167738123908
"147.32.84.165",21820,"184.173.217.40",443,9,552,6,372,3,180,56157.614261,1.306855999995605,2277.221055732237,1101.8811559994695
"147.32.84.165",21821,"184.173.217.40",443,9,552,6,372,3,180,56159.91661,1.3076270000019576,2275.878365922044,1101.2314673816343
"147.32.84.165",21822,"184.173.217.40",443,9,552,6,372,3,180,56162.219741,1.3078539999987697,2275.4833490609803,1101.040330190797
"147.32.84.165",21823,"184.173.217.40",443,9,552,6,372,3,180,56164.52307,1.3078219999952125,2275.5390259614032,1101.0672706264854
"147.32.84.165",21824,"184.173.217.40",443,9,552,6,372,3,180,56166.826555,1.308045999998285,2275.1493449036975,1100.8787152759826
"147.32.84.165",21825,"184.173.217.40",443,9,552,6,372,3,180,56169.12999,1.3074259999993956,2276.228253072354,1101.4007676156552
"147.32.84.165",21826,"184.173.217.40",443,9,552,6,372,3,180,56171.433045,1.3075349999999162,2276.038499925578,1101.3089515768927
"147.32.84.165",21827,"184.173.217.40",443,9,552,6,372,3,180,56173.736227,1.3075820000012754,2275.9566895208845,1101.269365897202
"147.32.84.165",21828,"184.173.217.40",443,9,552,6,372,3,180,56176.03976,1.3081600000004983,2274.951076320073,1100.7827788645513
"147.32.84.165",21829,"184.173.217.40",443,9,552,6,372,3,180,56178.343115,1.3077809999958845,2275.610365962929,1101.1017899820624
"147.32.84.165",21830,"184.173.217.40",443,9,552,6,372,3,180,56180.646244,1.3077659999980824,2275.6364670777216,1101.1144195537363
"147.32.84.165",21831,"184.173.217.40",443,9,552,6,372,3,180,56182.949272,1.30806300000404,2275.119776334021,1100.8644079035585
"147.32.84.165",21832,"184.173.217.40",443,9,552,6,372,3,180,56185.252721,1.3074840000044787,2276.1272795612076,1101.3519094651003
"147.32.84.165",21833,"184.173.217.40",443,9,552,6,372,3,180,56187.556188,1.3078160000004573,2275.549465673275,1101.0723220999716
"147.32.84.165",21834,"184.173.217.40",443,9,552,6,372,3,180,56189.859509,1.30787699999928,2275.4433329752246,1101.0209675686572
"147.32.84.165",21835,"184.173.217.40",443,9,552,6,372,3,180,56192.16256,1.3079910000014934,2275.2450131511623,1100.9250063634656
"147.32.84.165",21836,"184.173.217.40",443,9,552,6,372,3,180,56194.465944,1.3079219999999623,2275.3650447045666,1100.9830861473708
"147.32.84.165",21837,"184.173.217.40",443,9,552,6,372,3,180,56196.769607,1.3076680000012857,2275.807009116285,1101.1969398949766
"147.32.84.165",21838,"184.173.217.40",443,9,552,6,372,3,180,56199.072695,1.3077699999994365,2275.6295067185224,1101.1110516379947
"147.32.84.165",21839,"184.173.217.40",443,9,552,6,372,3,180,56201.375857,1.3076419999997597,2275.8522592579216,1101.2188351248008
"147.32.84.165",21840,"184.173.217.40",443,9,552,6,372,3,180,56203.679171,1.3083699999988312,2274.5859351732756,1100.6060976644883
"147.32.84.165",21841,"184.173.217.40",443,9,552,6,372,3,180,56205.982444,1.307860000000801,2275.472909943096,1101.0352790047239
"147.32.84.165",21842,"184.173.217.40",443,9,552,6,372,3,180,56208.285689,1.30775800000265,2275.6503879111956,1101.121155440901
"147.32.84.165",21843,"184.173.217.40",443,9,552,6,372,3,180,56210.589397,1.3073850000000675,2276.299636296765,1101.4353078855315
"147.32.84.165",21844,"184.173.217.40",443,9,552,6,372,3,180,56212.892748,1.333531000003859,2231.669155041306,1079.8399137296642
"147.32.84.165",21845,"184.173.217.40",443,9,552,6,372,3,180,56215.225867,1.3775800000003073,2160.3101090312985,1045.3113430796604
"147.32.84.165",21846,"184.173.217.40",443,9,552,6,372,3,180,56217.599028,1.30797000000166,2275.2815431517715,1100.942682170212
"147.32.84.165",21847,"184.173.217.40",443,9,552,6,372,3,180,56219.90255,1.3080110000009881,2275.2102237655126,1100.9081727897642
"147.32.84.165",21848,"184.173.217.40",443,9,552,6,372,3,180,56222.205878,1.3221360000025015,2250.9030840960154,1089.1466535948462
"147.32.84.165",21849,"184.173.217.40",443,9,552,6,372,3,180,56224.529058,1.388847000001988,2142.784626381265,1036.8312708296442
"147.32.84.165",21850,"184.173.217.40",443,9,552,6,372,3,180,56226.912625,1.3081880000027013,2274.902384056309,1100.7592180917625
"147.32.84.165",21851,"184.173.217.40",443,9,552,6,372,3,180,56229.216148,1.3076070000024629,2275.9131757434725,1101.2483108436156
"147.32.84.165",21852,"184.173.217.40",443,9,552,6,372,3,180,56231.519597,1.3074760000017704,2276.141206412944,1101.3586482643277
"147.32.84.165",21853,"184.173.217.40",443,9,552,6,372,3,180,56233.822701,1.3079060000018217,2275.3928799132773,1100.9965547967472
"147.32.84.165",21854,"184.173.217.40",443,9,552,6,372,3,180,56236.12628,1.3078280000045197,2275.528586320002,1101.0622191870975
"147.32.84.165",21855,"184.173.217.40",443,9,552,6,372,3,180,56238.429542,1.307568000003812,2275.9810579574632,1101.281157076192
"147.32.84.165",21856,"184.173.217.40",443,9,552,6,372,3,180,56240.732301,1.3080010000048787,2275.2276183190224,1100.9165895092044
"147.32.84.165",21857,"184.173.217.40",443,9,552,6,372,3,180,56243.035791,1.308310000000347,2274.69024925225,1100.6565722188304
"147.32.84.165",21858,"184.173.217.40",443,9,552,6,372,3,180,56245.339035,1.307769000006374,2275.6312467916696,1101.1118936088724
"147.32.84.165",21859,"184.173.217.40",443,9,552,6,372,3,180,56247.642523,1.3080169999957434,2275.199787166134,1100.9031228223228
"147.32.84.165",21860,"184.173.217.40",443,9,552,6,372,3,180,56249.946229,1.3070670000015525,2276.853443623368,1101.7032791725976
"147.32.84.165",21861,"184.173.217.40",443,9,552,6,372,3,180,56252.249513,1.3071369999961462,2276.7315132298863,1101.6442805951062
"147.32.84.165",21862,"94.100.176.20",25,6,372,6,372,0,0,56253.121331,9.002029999996012,330.5920997820845,0
"147.32.84.165",21863,"184.173.217.40",443,9,552,6,372,3,180,56254.552186,1.3081789999996545,2274.918034917841,1100.7667910892778
"147.32.84.165",21864,"184.173.217.40",443,9,552,6,372,3,180,56256.855831,1.3082009999998263,2274.8797776491497,1100.748279507653
"147.32.84.165",21865,"184.173.217.40",443,9,552,6,372,3,180,56259.159087,1.308283999998821,2274.735454995003,1100.6784459653238
"147.32.84.165",21866,"184.173.217.40",443,9,552,6,372,3,180,56261.462083,1.3076799999980722,2275.786125049238,1101.1868347012442
"147.32.84.165",21867,"184.173.217.40",443,9,552,6,372,3,180,56263.766063,1.3081600000004983,2274.951076320073,1100.7827788645513
"147.32.84.165",21868,"184.173.217.40",443,9,552,6,372,3,180,56266.068872,1.3080249999984517,2275.18587183236,1100.8963895963032
"147.32.84.165",21869,"184.173.217.40",443,9,552,6,372,3,180,56268.372459,1.3079370000050403,2275.3389498030347,1100.9704595821136
"147.32.84.165",21870,"184.173.217.40",443,9,552,6,372,3,180,56270.676093,1.30702499999461,2276.926608146189,1101.7386813610592
"147.32.84.165",21871,"184.173.217.40",443,9,552,6,372,3,180,56272.979101,1.2079660000017611,2463.6454999525326,1192.0865322350965
"147.32.84.165",21872,"74.125.93.27",25,6,372,6,372,0,0,56274.041012,9.012267999998585,330.21654482539435,0
"147.32.84.165",21873,"184.173.217.40",443,9,552,6,372,3,180,56275.182506,1.3077850000045146,2275.6034057507363,1101.098422137453
"147.32.84.165",21874,"184.173.217.40",443,9,552,6,372,3,180,56277.485606,1.3076939999955357,2275.761760786667,1101.1750455419356
"147.32.84.165",21875,"184.173.217.40",443,9,552,6,372,3,180,56279.788936,1.3075170000010985,2276.0698331245403,1101.324112802197
"147.32.84.165",21876,"184.173.217.40",443,9,552,6,372,3,180,56282.092436,1.3071280000003753,2276.7471892570165,1101.6518657695242
"147.32.84.165",21877,"184.173.217.40",443,9,552,6,372,3,180,56284.395321,1.3079839999991236,2275.257189691918,1100.9308982380248
"147.32.84.165",21878,"184.173.217.40",443,9,552,6,372,3,180,56286.698454,1.3081400000010035,2274.985857781061,1100.7996086037392
"147.32.84.165",21879,"184.173.217.40",443,9,552,6,372,3,180,56289.002435,1.3076799999980722,2275.786125049238,1101.1868347012442
"147.32.84.165",21880,"184.173.217.40",443,9,552,6,372,3,180,56291.305012,1.308048000006238,2275.1458661958945,1100.8770320302717
"147.32.84.165",21881,"184.173.217.40",443,9,552,6,372,3,180,56293.608544,1.3083219999971334,2274.6693856760953,1100.646476940046
"147.32.84.165",21882,"74.125.39.27",25,6,372,6,372,0,0,56295.070988,9.012314999999944,330.2148227175835,0
"147.32.84.165",21883,"184.173.217.40",443,9,552,6,372,3,180,56295.911995,1.3081749999983003,2274.924990925424,1100.7701568993987
"147.32.84.165",21884,"184.173.217.40",443,9,552,6,372,3,180,56298.215613,1.3071639999980107,2276.6844864183295,1101.6215256862884
"147.32.84.165",21885,"184.173.217.40",443,9,552,6,372,3,180,56300.518847,1.3076530000034836,2275.8331147422687,1101.2095716494848
"147.32.84.165",21886,"184.173.217.40",443,9,552,6,372,3,180,56302.821794,1.3082029999932274,2274.87629979094,1100.7465966730354
"147.32.84.165",21887,"184.173.217.40",443,9,552,6,372,3,180,56305.124883,1.3084190000008675,2274.5007524333005,1100.5648802096616
"147.32.84.165",21888,"184.173.217.40",443,9,552,6,372,3,180,56307.428246,1.3086379999949713,2274.1201157321093,1100.380701160698
"147.32.84.165",21889,"184.173.217.40",443,9,552,6,372,3,180,56309.732066,1.3074070000002393,2276.2613325456077,1101.4167738123908
"147.32.84.165",21890,"184.173.217.40",443,9,552,6,372,3,180,56312.035375,1.3075410000019474,2276.0280557134097,1101.3038979258436
"147.32.84.165",21891,"184.173.217.40",443,9,552,6,372,3,180,56314.338283,1.3077790000024834,2275.613846066001,1101.1034739029037
"147.32.84.165",21892,"66.111.4.73",25,6,372,6,372,0,0,56316.101296,9.012706000001344,330.20049694282227,0
"147.32.84.165",21893,"184.173.217.40",443,9,552,6,372,3,180,56316.641928,1.307250000005297,2276.5347102604255,1101.5490533518189
"147.32.84.165",21894,"184.173.217.40",443,9,552,6,372,3,180,56318.944839,1.3083039999983157,2274.7006811901756,1100.66161993073
"147.32.84.165",21895,"184.173.217.40",443,9,552,6,372,3,180,56321.248511,1.3077469999989262,2275.669529352729,1101.13041742874
"147.32.84.165",21896,"173.192.170.88",80,29,4443,20,1650,9,2793,56321.852813,42.6470460000055,309.517334447931,523.9284334018613
"147.32.84.165",21897,"184.173.217.40",443,9,552,6,372,3,180,56323.552101,1.3069459999969695,2277.0642398438044,1101.8052773437762
"147.32.84.165",21898,"184.173.217.40",443,9,552,6,372,3,180,56325.855016,1.307554999999411,2276.0036862704364,1101.2921062598887
"147.32.84.165",21899,"184.173.217.40",443,9,552,6,372,3,180,56328.15813,1.3082249999933993,2274.838043925942,1100.728085770617
"147.32.84.165",21900,"184.173.217.40",443,9,552,6,372,3,180,56330.461728,1.3076440000004368,2275.8487784129366,1101.2171508449692
"147.32.84.165",21902,"184.173.217.40",443,9,552,6,372,3,180,56332.76513,1.3077100000009523,2275.733916539472,1101.1615725190993
"147.32.84.165",21903,"184.173.217.40",443,9,552,6,372,3,180,56335.068265,1.3083369999949355,2274.643306740939,1100.6338581004543
"147.32.84.165",21904,"216.157.130.15",25,6,372,6,372,0,0,56337.13132,8.909221000001708,334.0359387200553,0
"147.32.84.165",21905,"184.173.217.40",443,9,552,6,372,3,180,56337.371347,1.3084739999976591,2274.4051467628124,1100.5186194013609
"147.32.84.165",21906,"184.173.217.40",443,9,552,6,372,3,180,56339.674594,1.3079730000026757,2275.276324506631,1100.9401570193377
"147.32.84.165",21907,"184.173.217.40",443,9,552,6,372,3,180,56341.978019,1.2994809999945574,2290.1450656165534,1108.1347091693
"147.32.84.165",21909,"98.126.71.122",80,18,4965,14,1532,4,3433,56342.320417,21.667637999998988,565.6361805564858,1267.512407213065
"147.32.84.165",21910,"195.113.232.88",80,17,5964,12,2760,5,3204,56342.946858,28.515579999999318,774.313550697567,898.8770349402191
"147.32.84.165",21911,"195.113.232.83",80,52,40498,42,3628,10,36870,56343.251878,28.210747999997693,1028.8277361522769,10455.58947958502
"147.32.84.165",21912,"77.238.175.247",80,14,2274,10,1276,4,998,56343.296562,0.20425399999658111,49976.98943555997,39088.58578110411
"147.32.84.165",21913,"64.236.79.229",80,14,2274,10,1560,4,714,56343.342967,0.35574300000007497,35081.505468828254,16056.535195348317
"147.32.84.165",21914,"74.125.232.218",80,13,1871,10,1156,3,715,56343.405405,28.057441000004474,329.6095321023227,203.867487416229
"147.32.84.165",21915,"68.67.185.216",80,16,2169,12,1370,4,799,56343.408112,10.577498000006017,1036.1618598267535,604.3016978113694
"147.32.84.165",21916,"64.236.79.229",80,14,2078,10,1378,4,700,56343.442645,0.35515299999678973,31040.143262480247,15767.852165265727
"147.32.84.165",21917,"64.236.79.229",80,14,2061,10,1404,4,657,56343.506959,0.35544300000037765,31600.00337603516,14787.181066990814
"147.32.84.165",21918,"77.238.167.32",80,13,2342,10,1390,3,952,56343.518232,0.14051800000015646,79135.76908287634,54199.4619905743
"147.32.84.165",21919,"64.236.79.229",80,14,2043,10,1386,4,657,56343.559299,0.35849700000107987,30929.129113958,14661.210554019051
"147.32.84.165",21920,"77.238.175.247",80,14,3055,10,1368,4,1687,56343.613065,0.14278800000465708,76645.09622407386,94517.74658626651
"147.32.84.165",21921,"195.113.232.82",80,13,1965,10,1306,3,659,56343.620116,27.843089000001783,375.2457207603413,189.3468070299119
"147.32.84.165",21922,"74.217.252.37",80,12,2075,10,1278,2,797,56343.71169,27.751336000001174,368.41469542221563,229.75470442214854
"147.32.84.165",21923,"64.236.79.229",80,14,2089,10,1432,4,657,56343.743729,0.3571539999975357,32075.79923528518,14716.340850267014
"147.32.84.165",21924,"184.173.217.40",443,9,552,6,372,3,180,56344.277795,1.3072689999971772,2276.501622853771,1101.5330433163408
"147.32.84.165",21925,"184.173.217.40",443,9,552,6,372,3,180,56346.586709,1.306246000000101,2278.284488526487,1102.395720254752
"147.32.84.165",21926,"184.173.217.40",443,9,552,6,372,3,180,56348.892733,1.308076000001165,2275.0971656060883,1100.8534672287524
"147.32.84.165",21927,"184.173.217.40",443,9,552,6,372,3,180,56351.201241,1.307755999994697,2275.6538681620023,1101.122839433227
"147.32.84.165",21928,"184.173.217.40",443,9,552,6,372,3,180,56353.509182,1.3071540000019013,2276.7019035214453,1101.6299533168283
"147.32.84.165",21929,"184.173.217.40",443,9,552,6,372,3,180,56355.816679,1.3069279999981518,2277.095601291126,1101.8204522376416
"147.32.84.165",21930,"184.173.217.40",443,9,552,6,372,3,180,56358.123233,1.3076300000029732,2275.873144538771,1101.228940905857
"147.32.84.165",21931,"184.173.217.40",443,9,552,6,372,3,180,56360.431709,1.3065390000047046,2277.773568174608,1102.148500729649
"147.32.84.165",21932,"184.173.217.40",443,9,552,6,372,3,180,56362.737859,1.3080580000023474,2275.128472892379,1100.8686159156673
"147.32.84.165",21933,"173.192.170.88",80,13,1407,10,970,3,437,56364.299273,7.062802000000374,1098.7140797660177,494.98768335850485
"147.32.84.165",21934,"184.173.217.40",443,9,552,6,372,3,180,56365.04603,1.3072430000029271,2276.5469006094017,1101.5549519077751
"147.32.84.165",21935,"184.173.217.40",443,9,552,6,372,3,180,56367.353984,1.3061719999968773,2278.413562690913,1102.458175495603
"147.32.84.165",21936,"184.173.217.40",443,9,552,6,372,3,180,56369.65989,1.3089120000004186,2273.6440646881138,1100.1503538813454
"147.32.84.165",21937,"184.173.217.40",443,9,552,6,372,3,180,56371.983266,1.3082649999996647,2274.7684910937483,1100.6944311743944
"147.32.84.165",21938,"184.173.217.40",443,9,552,6,372,3,180,56374.287082,1.3079069999948842,2275.391140204648,1100.995713002249
"147.32.84.165",21939,"184.173.217.40",443,9,552,6,372,3,180,56376.59045,1.3076559999972233,2275.8278935792896,1101.2070452803014
"147.32.84.165",21940,"184.173.217.40",443,9,552,6,372,3,180,56378.893138,1.308059000002686,2275.1267335753887,1100.8677743106718
"147.32.84.165",21941,"184.173.217.40",443,9,552,6,372,3,180,56381.196934,1.308114999999816,2275.0293361060903,1100.820646502947
"147.32.84.165",21942,"184.173.217.40",443,9,552,6,372,3,180,56383.500284,1.3078129999994417,2275.554685571462,1101.074847857159
"147.32.84.165",21943,"184.173.217.40",443,9,552,6,372,3,180,56385.803066,1.308406999996805,2274.52161292875,1100.5749739977823
"147.32.84.165",21944,"184.173.217.40",443,9,552,6,372,3,180,56388.106872,1.3073140000051353,2276.4232617323073,1101.4951266446649
"147.32.84.165",21945,"184.173.217.40",443,9,552,6,372,3,180,56390.40979,1.308152000005066,2274.9649887692526,1100.7895106947997
"147.32.84.165",21946,"184.173.217.40",443,9,552,6,372,3,180,56392.713457,1.3079360000047018,2275.3406894445156,1100.9713013441203
"147.32.84.165",21947,"184.173.217.40",443,9,552,6,372,3,180,56395.016726,1.3076139999975567,2275.9009921930788,1101.2424155772962
"147.32.84.165",21948,"184.173.217.40",443,9,552,6,372,3,180,56397.320072,1.307463999997708,2276.1620970101026,1101.3687566177916
"147.32.84.165",21949,"184.173.217.40",443,9,552,6,372,3,180,56399.622943,1.3078759999989416,2275.4450727763247,1101.0218094078991
"147.32.84.165",21950,"184.173.217.40",443,9,552,6,372,3,180,56401.926852,1.307810000005702,2275.5599054809372,1101.0773736198084
"147.32.84.165",21951,"184.173.217.40",443,9,552,6,372,3,180,56404.229672,1.3083950000000186,2274.542473794196,1100.5850679649338
"147.32.84.165",21952,"184.173.217.40",443,9,552,6,372,3,180,56406.533005,1.3077160000029835,2275.723475122435,1101.1565202205331
"147.32.84.165",21953,"184.173.217.40",443,9,552,6,372,3,180,56408.836584,1.3079849999994622,2275.2554501781165,1100.9300565377982
"147.32.84.165",21954,"184.173.217.40",443,9,552,6,372,3,180,56411.139505,1.3077960000009625,2275.5842654342187,1101.089160693977
"147.32.84.165",21955,"184.173.217.40",443,9,552,6,372,3,180,56413.443228,1.3075270000044839,2276.052425678242,1101.3156898443106
"147.32.84.165",21956,"184.173.217.40",443,9,552,6,372,3,180,56415.746453,1.3078919999970822,2275.417236290641,1101.0083401406328
"147.32.84.165",21957,"184.173.217.40",443,9,552,6,372,3,180,56418.049845,1.3073939999958384,2276.2839664320572,1101.4277256929308
"147.32.84.165",21958,"184.173.217.40",443,9,552,6,372,3,180,56420.352962,1.3078940000050352,2275.413756763578,1101.0066564985054
"147.32.84.165",21959,"184.173.217.40",443,9,552,6,372,3,180,56422.656149,1.3081509999974514,2274.9667278515994,1100.790352186258
"147.32.84.165",21960,"184.173.217.40",443,9,552,6,372,3,180,56424.959971,1.3083320000005187,2274.651999644448,1100.6380643440878
"147.32.84.165",21961,"184.173.217.40",443,9,552,6,372,3,180,56427.262996,1.307529000005161,2276.048944220934,1101.3140052681938
"147.32.84.165",21962,"184.173.217.40",443,9,552,6,372,3,180,56429.56662,1.3074410000044736,2276.202138367863,1101.3881314683208
"147.32.84.165",21963,"184.173.217.40",443,9,552,6,372,3,180,56431.869352,1.3084229999949457,2274.4937990324966,1100.5615156608853
"147.32.84.165",21964,"184.173.217.40",443,9,552,6,372,3,180,56434.172671,1.308110999998462,2275.0362927943415,1100.8240126424234
"147.32.84.165",21965,"184.173.217.40",443,9,552,6,372,3,180,56436.47587,1.3083209999967949,2274.6711242938777,1100.6473182067152
"147.32.84.165",21966,"184.173.217.40",443,9,552,6,372,3,180,56438.779242,1.3083460000052582,2274.6276596466373,1100.6262869257923
"147.32.84.165",21967,"184.173.217.40",443,9,552,6,372,3,180,56441.083026,1.2072160000025178,2465.176074533301,1192.8271328386938
"147.32.84.165",21968,"184.173.217.40",443,9,552,6,372,3,180,56443.285795,1.3080019999979413,2275.2258788630934,1100.9157478369807
"147.32.84.165",21969,"184.173.217.40",443,9,552,6,372,3,180,56445.589275,1.3082540000032168,2274.7876176894415,1100.703685978762
"147.32.84.165",21970,"184.173.217.40",443,9,552,6,372,3,180,56447.892434,1.308348999998998,2274.6224440132405,1100.6237632322132
"147.32.84.165",21971,"184.173.217.40",443,9,552,6,372,3,180,56450.195828,1.308004999998957,2275.220660473296,1100.9132228096591
"147.32.84.165",21972,"184.173.217.40",443,9,552,6,372,3,180,56452.498953,1.308283999998821,2274.735454995003,1100.6784459653238
"147.32.84.165",21973,"184.173.217.40",443,9,552,6,372,3,180,56454.802398,1.3083550000010291,2274.6120127929034,1100.6187158675339
"147.32.84.165",21974,"184.173.217.40",443,9,552,6,372,3,180,56457.106155,1.3074070000002393,2276.2613325456077,1101.4167738123908
"147.32.84.165",21975,"184.173.217.40",443,9,552,6,372,3,180,56459.409138,1.307913999997254,2275.3789622301224,1100.9898204339302
"147.32.84.165",21976,"184.173.217.40",443,9,552,6,372,3,180,56461.712382,1.3077620000040042,2275.6434274668386,1101.117787483954
"147.32.84.165",21977,"184.173.217.40",443,9,552,6,372,3,180,56464.015905,1.3074599999963539,2276.169060627705,1101.3721261101798
"147.32.84.165",21978,"184.173.217.40",443,9,552,6,372,3,180,56466.319363,1.3076389999987441,2275.857480545363,1101.221361554208
"147.32.84.165",21979,"184.173.217.40",443,9,552,6,372,3,180,56468.622243,1.308314000001701,2274.6832946801233,1100.6532071032855
"147.32.84.165",21980,"184.173.217.40",443,9,552,6,372,3,180,56470.925409,1.3098659999959636,2271.988127036789,1099.3490937274785
"147.32.84.165",21981,"184.173.217.40",443,9,552,6,372,3,180,56473.228865,1.3081960000054096,2274.888472360177,1100.752486625892
"147.32.84.165",21982,"184.173.217.40",443,9,552,6,372,3,180,56475.532211,1.308020000004035,2275.1945688833653,1100.9005978467897
"147.32.84.165",21983,"184.173.217.40",443,9,552,6,372,3,180,56477.836045,1.3071540000019013,2276.7019035214453,1101.6299533168283
"147.32.84.165",21984,"94.100.176.20",25,6,372,6,372,0,0,56478.268025,8.940818000002764,332.85545013879937,0
"147.32.84.165",21985,"184.173.217.40",443,9,552,6,372,3,180,56480.13886,1.3079120000038529,2275.382441625456,1100.9915040123174
"147.32.84.165",21986,"184.173.217.40",443,9,552,6,372,3,180,56482.442455,1.3078820000009728,2275.4346340096326,1101.0167583917578
"147.32.84.165",21987,"184.173.217.40",443,9,552,6,372,3,180,56484.746035,1.3069720000057714,2277.018941482188,1101.783358781704
"147.32.84.165",21988,"184.173.217.40",443,9,552,6,372,3,180,56487.048969,1.30805899999541,2275.126733588044,1100.8677743167952
"147.32.84.165",21989,"184.173.217.40",443,9,552,6,372,3,180,56489.352519,1.3077810000031604,2275.6103659502683,1101.1017899759363
"147.32.84.165",21990,"147.32.84.171",139,33,4810,22,3278,11,1532,56491.229711,0.014994999997725245,1748849.6168041483,817339.1131616703
"147.32.84.165",21991,"184.173.217.40",443,9,552,6,372,3,180,56491.655817,1.3071879999988596,2276.642686440356,1101.6012998904948
"147.32.84.165",21992,"184.173.217.40",443,9,552,6,372,3,180,56493.958718,1.30754199999501,2276.026315033366,1101.3030556613062
"147.32.84.165",21993,"184.173.217.40",443,9,552,6,372,3,180,56496.262222,1.3081050000037067,2275.0467278938368,1100.8290618841145
"147.32.84.165",21994,"184.173.217.40",443,9,552,6,372,3,180,56498.565247,1.3083540000006906,2274.6137513229824,1100.6195570917657
"147.32.84.165",21995,"74.125.93.27",25,6,372,6,372,0,0,56499.226633,9.012429000002157,330.21064576478636,0
"147.32.84.165",21996,"184.173.217.40",443,9,552,6,372,3,180,56500.868984,1.3076159999982337,2275.8975111990217,1101.240731225333
"147.32.84.165",21997,"184.173.217.40",443,9,552,6,372,3,180,56503.172373,1.3074740000010934,2276.144688152507,1101.3603329770197
"147.32.84.165",21998,"184.173.217.40",443,9,552,6,372,3,180,56505.47522,1.307860000000801,2275.472909943096,1101.0352790047239
"147.32.84.165",21999,"184.173.217.40",443,9,552,6,372,3,180,56507.778611,1.3077179999963846,2275.7199946840433,1101.1548361374403
"147.32.84.165",22000,"184.173.217.40",443,9,552,6,372,3,180,56510.082147,1.3077790000024834,2275.613846066001,1101.1034739029037
"147.32.84.165",22001,"184.173.217.40",443,9,552,6,372,3,180,56512.385448,1.307280000000901,2276.482467411686,1101.5237745540417
"147.32.84.165",22002,"184.173.217.40",443,9,552,6,372,3,180,56514.68893,1.307581000000937,2275.958430107097,1101.270208116337
"147.32.84.165",22003,"184.173.217.40",443,9,552,6,372,3,180,56516.992168,1.3072769999998854,2276.4876915911937,1101.5263023828356
"147.32.84.165",22004,"184.173.217.40",443,9,552,6,372,3,180,56519.295323,1.3077720000001136,2275.62602655489,1101.10936768785
"147.32.84.165",22005,"74.125.39.27",25,6,372,6,372,0,0,56520.156899,9.012479999997595,330.208777162423,0
"147.32.84.165",22006,"184.173.217.40",443,9,552,6,372,3,180,56521.5988,1.307768999999098,2275.6312468043307,1101.1118936149987
"147.32.84.165",22007,"184.173.217.40",443,9,552,6,372,3,180,56523.901593,1.308123999995587,2275.0136837257323,1100.8130727705156
"147.32.84.165",22008,"184.173.217.40",443,9,552,6,372,3,180,56526.205134,1.3075669999961974,2275.982798593613,1101.28199931949
"147.32.84.165",22009,"184.173.217.40",443,9,552,6,372,3,180,56528.508792,1.3071639999980107,2276.6844864183295,1101.6215256862884
"147.32.84.165",22010,"184.173.217.40",443,9,552,6,372,3,180,56530.81154,1.308074000000488,2275.100644152311,1100.8551503962794
"147.32.84.165",22011,"184.173.217.40",443,9,552,6,372,3,180,56533.115511,1.3075769999995828,2275.965392478569,1101.273577005759
"147.32.84.165",22012,"184.173.217.40",443,9,552,6,372,3,180,56535.418417,1.3077790000024834,2275.613846066001,1101.1034739029037
"147.32.84.165",22013,"184.173.217.40",443,9,552,6,372,3,180,56537.721442,1.3080159999954049,2275.2015265948235,1100.9039644813663
"147.32.84.165",22014,"184.173.217.40",443,9,552,6,372,3,180,56540.025037,1.307732000001124,2275.6956318247485,1101.1430476571363
"147.32.84.165",22015,"66.111.4.73",25,6,372,6,372,0,0,56541.186875,9.012463999999454,330.20936338832314,0
"147.32.84.165",22016,"184.173.217.40",443,9,552,6,372,3,180,56542.328115,1.3078139999997802,2275.552945602739,1101.074005936809
"147.32.84.165",22017,"184.173.217.40",443,9,552,6,372,3,180,56544.631508,1.3080239999981131,2275.187611239773,1100.8972312450514
"147.32.84.165",22018,"184.173.217.40",443,9,552,6,372,3,180,56546.935032,1.3075319999989006,2276.043722067607,1101.3114784198099
"147.32.84.165",22019,"184.173.217.40",443,9,552,6,372,3,180,56549.238016,1.308353000000352,2274.615489855719,1100.6203983172834
"147.32.84.165",22020,"184.173.217.40",443,9,552,6,372,3,180,56551.541579,1.3076880000007804,2275.7722025423677,1101.1800980043715
"147.32.84.165",22021,"184.173.217.40",443,9,552,6,372,3,180,56553.84525,1.3073520000034478,2276.357094334312,1101.463110161764
"147.32.84.165",22022,"184.173.217.40",443,9,552,6,372,3,180,56556.14814,1.3079780000043684,2275.267626817929,1100.935948460288
"147.32.84.165",22023,"184.173.217.40",443,9,552,6,372,3,180,56558.451572,1.308470000003581,2274.412099621585,1100.5219836878637
"147.32.84.165",22024,"184.173.217.40",443,9,552,6,372,3,180,56560.754557,1.3079999999972642,2275.229357802924,1100.9174311949632
"147.32.84.165",22025,"216.157.130.15",25,6,372,6,372,0,0,56562.217303,9.012200000004668,330.2190364171299,0
"147.32.84.165",22026,"184.173.217.40",443,9,552,6,372,3,180,56563.058512,1.3076179999989108,2275.8940302156125,1101.2390468785222
"147.32.84.165",22027,"184.173.217.40",443,9,552,6,372,3,180,56565.361885,1.30745300000126,2276.1812470483696,1101.3780227653401
"147.32.84.165",22028,"184.173.217.40",443,9,552,6,372,3,180,56567.664982,1.3075969999990775,2275.9305810598366,1101.256732770889
"147.32.84.165",22029,"184.173.217.40",443,9,552,6,372,3,180,56569.968395,1.3072429999956512,2276.546900622073,1101.5549519139063
"147.32.84.165",22030,"184.173.217.40",443,9,552,6,372,3,180,56572.271713,1.3077399999965564,2275.6817104377296,1101.1363115021272
"147.32.84.165",22031,"184.173.217.40",443,9,552,6,372,3,180,56574.575144,1.3071940000008908,2276.6322366825216,1101.5962435560589
"147.32.84.165",22032,"184.173.217.40",443,9,552,6,372,3,180,56576.878482,1.307420999997703,2276.236958107013,1101.4049797291998
"147.32.84.165",22033,"184.173.217.40",443,9,552,6,372,3,180,56579.181122,1.3077720000001136,2275.62602655489,1101.10936768785
"147.32.84.165",22034,"184.173.217.40",443,9,552,6,372,3,180,56581.484618,1.3077029999985825,2275.7460983137807,1101.1674669260228
"147.32.84.165",22035,"184.173.217.40",443,9,552,6,372,3,180,56583.787664,1.3079559999969206,2275.3058971456276,1100.9544663607876
"147.32.84.165",22036,"184.173.217.40",443,9,552,6,372,3,180,56586.091042,1.3078279999972438,2275.5285863326612,1101.0622191932232
"147.32.84.165",22037,"184.173.217.40",443,9,552,6,372,3,180,56588.394831,1.3076730000029784,2275.7983073698256,1101.1927293724962
"147.32.84.165",22038,"184.173.217.40",443,9,552,6,372,3,180,56590.698049,1.3079589999979362,2275.300678388769,1100.9519411558558
"147.32.84.165",22039,"184.173.217.40",443,9,552,6,372,3,180,56593.001063,1.3079569999972591,2275.304157557348,1100.9536246245232
"147.32.84.165",22040,"184.173.217.40",443,9,552,6,372,3,180,56595.304856,1.3075529999987339,2276.0071675892923,1101.2937907690123
"147.32.84.165",22041,"184.173.217.40",443,9,552,6,372,3,180,56597.607629,1.3083800000022165,2274.568550417278,1100.5976856857797
"147.32.84.165",22042,"184.173.217.40",443,9,552,6,372,3,180,56599.911378,1.3076230000006035,2275.8853278036763,1101.2348360340368
"147.32.84.165",22043,"184.173.217.40",443,9,552,6,372,3,180,56602.214803,1.319387999996252,2255.5912286669686,1091.4151106453073
"147.32.84.165",22044,"184.173.217.40",443,9,552,6,372,3,180,56604.527871,1.2978510000029928,2293.0213098369054,1109.526440243664
"147.32.84.165",22045,"184.173.217.40",443,9,552,6,372,3,180,56606.82075,1.3084670000025653,2274.417314303047,1100.5245069208293
"147.32.84.165",22046,"184.173.217.40",443,9,552,6,372,3,180,56609.124649,1.3074080000005779,2276.259591496063,1101.4159313690627
"147.32.84.165",22047,"184.173.217.40",443,9,552,6,372,3,180,56611.428032,1.3072809999939636,2276.480726036515,1101.5229319531525
"147.32.84.165",22048,"184.173.217.40",443,9,552,6,372,3,180,56613.731465,1.3073740000036196,2276.3187886494306,1101.4445751529504
"147.32.84.165",22049,"184.173.217.40",443,9,552,6,372,3,180,56616.034086,1.3080380000028526,2275.163259778011,1100.8854482796826
"147.32.84.165",22050,"184.173.217.40",443,9,552,6,372,3,180,56618.337355,1.3081569999994827,2274.9562934733194,1100.7853032935416
"147.32.84.165",22051,"184.173.217.40",443,9,552,6,372,3,180,56620.64068,1.3084620000008726,2274.4260054919555,1100.5287123348173
"147.32.84.165",22052,"173.192.170.88",80,18,1800,12,1166,6,634,56621.661158,601.2869129999963,15.513392688791246,8.435240964574314
"147.32.84.165",22053,"184.173.217.40",443,9,552,6,372,3,180,56622.944068,1.3079090000028373,2275.387660757395,1100.9940293987397
"147.32.84.165",22054,"184.173.217.40",443,9,552,6,372,3,180,56625.247365,1.3078789999999572,2275.4398533810067,1101.0192838940354
"147.32.84.165",22055,"184.173.217.40",443,9,552,6,372,3,180,56627.55073,1.308389999998326,2274.551165939672,1100.589273841777
"147.32.84.165",22056,"184.173.217.40",443,9,552,6,372,3,180,56629.854278,1.3076619999992545,2275.817451299875,1101.2019925644554
"147.32.84.165",22057,"184.173.217.40",443,9,552,6,372,3,180,56632.157275,1.3078420000019833,2275.50422757144,1101.050432695858
"147.32.84.165",22058,"184.173.217.40",443,9,552,6,372,3,180,56634.461022,1.3076829999990878,2275.780904089199,1101.1843084302575
"147.32.84.165",22059,"184.173.217.40",443,9,552,6,372,3,180,56636.764624,1.3070689999949536,2276.849959727826,1101.70159341669
"147.32.84.165",22060,"184.173.217.40",443,9,552,6,372,3,180,56639.067411,1.3075919999973848,2275.9392838178514,1101.2609437828314
"147.32.84.165",22061,"184.173.217.40",443,9,552,6,372,3,180,56641.370979,1.3072339999998803,2276.562574107063,1101.5625358582563
"147.32.84.165",22062,"184.173.217.40",443,9,552,6,372,3,180,56643.673965,1.308259999997972,2274.7771849667597,1100.6986378871418
"147.32.84.165",22063,"184.173.217.40",443,9,552,6,372,3,180,56645.977224,1.3078109999987646,2275.558165516891,1101.0765317017217
"147.32.84.165",22064,"184.173.217.40",443,9,552,6,372,3,180,56648.280848,1.3079890000008163,2275.248492149508,1100.9266897497619
"147.32.84.165",22065,"184.173.217.40",443,9,552,6,372,3,180,56650.583748,1.308179999999993,2274.9162959225914,1100.7659496399638
"147.32.84.165",22066,"184.173.217.40",443,9,552,6,372,3,180,56652.887059,1.3082290000020294,2274.831088437409,1100.7247202116496
"147.32.84.165",22067,"184.173.217.40",443,9,552,6,372,3,180,56655.190349,1.3078110000060406,2275.5581655042315,1101.0765316955958
"147.32.84.165",22068,"184.173.217.40",443,9,552,6,372,3,180,56657.494138,1.3077769999945303,2275.617326205039,1101.1051578411477
"147.32.84.165",22069,"184.173.217.40",443,9,552,6,372,3,180,56659.797223,1.3079859999998007,2275.2537106669747,1100.9292148388588
"147.32.84.165",22070,"184.173.217.40",443,9,552,6,372,3,180,56662.100576,1.3080120000013267,2275.2084843235243,1100.907331124286
"147.32.84.165",22071,"184.173.217.40",443,9,552,6,372,3,180,56664.404132,1.3080789999949047,2275.0919478193537,1100.8509424932356
"147.32.84.165",22072,"184.173.217.40",443,9,552,6,372,3,180,56666.707101,1.3081989999991492,2274.883255530646,1100.7499623535384
"147.32.84.165",22073,"184.173.217.40",443,9,552,6,372,3,180,56669.010289,1.307795000000624,2275.586005450839,1101.0900026375027
"147.32.84.165",22074,"184.173.217.40",443,9,552,6,372,3,180,56671.314002,1.3072949999987031,2276.4563468864735,1101.511135590229
"147.32.84.165",22075,"184.173.217.40",443,9,552,6,372,3,180,56673.617575,1.30766500000027,2275.8122301961016,1101.1994662239201
"147.32.84.165",22076,"184.173.217.40",443,9,552,6,372,3,180,56675.920199,1.3083110000006855,2274.6885106052314,1100.6557309380153
"147.32.84.165",22077,"184.173.217.40",443,9,552,6,372,3,180,56678.224159,1.3076580000051763,2275.8244127961743,1101.205361030407
"147.32.84.165",22078,"184.173.217.40",443,9,552,6,372,3,180,56680.526917,1.3080059999992955,2275.218921015349,1100.9123811364593
"147.32.84.165",22079,"184.173.217.40",443,9,552,6,372,3,180,56682.830685,1.3076529999962077,2275.8331147549316,1101.209571655612
"147.32.84.165",22080,"184.173.217.40",443,9,552,6,372,3,180,56685.133868,1.3077960000009625,2275.5842654342187,1101.089160693977
"147.32.84.165",22081,"184.173.217.40",443,9,552,6,372,3,180,56687.437168,1.3072710000051302,2276.498140009471,1101.5313580690988
"147.32.84.165",22082,"184.173.217.40",443,9,552,6,372,3,180,56689.740043,1.3085340000034194,2274.300858817748,1100.4681574924589
"147.32.84.165",22083,"184.173.217.40",443,9,552,6,372,3,180,56692.043935,1.3080279999994673,2275.1806536260783,1100.89386465778
"147.32.84.165",22084,"184.173.217.40",443,9,552,6,372,3,180,56694.346597,1.308164999994915,2274.9423811304905,1100.7785715147534
"147.32.84.165",22085,"184.173.217.40",443,9,552,6,372,3,180,56696.649988,1.3080289999998058,2275.1789142293037,1100.893023014179
"147.32.84.165",22086,"184.173.217.40",443,9,552,6,372,3,180,56698.953266,1.3079950000028475,2275.2380551863894,1100.9216396063173
"147.32.84.165",22087,"184.173.217.40",443,9,552,6,372,3,180,56701.25704,1.3074059999999008,2276.2630735978155,1101.4176162570075
"147.32.84.165",22088,"94.100.176.20",25,6,372,6,372,0,0,56703.330974,9.002143000005162,330.58795000238206,0
"147.32.84.165",22089,"184.173.217.40",443,9,552,6,372,3,180,56703.559983,1.3077780000021448,2275.615586127859,1101.104315868319
"147.32.84.165",22090,"184.173.217.40",443,9,552,6,372,3,180,56705.863853,1.3077960000009625,2275.5842654342187,1101.089160693977
"147.32.84.165",22091,"184.173.217.40",443,9,552,6,372,3,180,56708.166746,1.3079799999977695,2275.264147773724,1100.9342650518017
"147.32.84.165",22092,"184.173.217.40",443,9,552,6,372,3,180,56710.470263,1.3076929999951972,2275.76350107474,1101.1758876168096
"147.32.84.165",22093,"184.173.217.40",443,9,552,6,372,3,180,56712.773355,1.3076080000028014,2275.911435226478,1101.247468657973
"147.32.84.165",22094,"184.173.217.40",443,9,552,6,372,3,180,56715.076653,1.3079990000042017,2275.2310972641726,1100.9182728697608
"147.32.84.165",22095,"184.173.217.40",443,9,552,6,372,3,180,56717.380311,1.307463999997708,2276.1620970101026,1101.3687566177916
"147.32.84.165",22096,"184.173.217.40",443,9,552,6,372,3,180,56719.68446,1.306510000002163,2277.8241268685833,1102.1729646138308
"147.32.84.165",22097,"184.173.217.40",443,9,552,6,372,3,180,56721.987049,1.307321000000229,2276.4110727200728,1101.4892287355192
"147.32.84.165",22098,"74.125.93.27",25,6,372,6,372,0,0,56724.25012,9.012828000006266,330.19602726224565,0
"147.32.84.165",22099,"184.173.217.40",443,9,552,6,372,3,180,56724.290302,1.3076470000014524,2275.8435571654236,1101.2146244348824
"147.32.84.165",22100,"184.173.217.40",443,9,552,6,372,3,180,56726.593466,1.3077469999989262,2275.669529352729,1101.13041742874
"147.32.84.165",22101,"184.173.217.40",443,9,552,6,372,3,180,56728.896755,1.3078479999967385,2275.4937882746476,1101.0453814232167
"147.32.84.165",22102,"184.173.217.40",443,9,552,6,372,3,180,56731.200037,1.3116339999978663,2268.925630171863,1097.8672404057402
"147.32.84.165",22103,"184.173.217.40",443,9,552,6,372,3,180,56733.50325,1.3077579999953741,2275.6503879238567,1101.1211554470274
"147.32.84.165",22104,"184.173.217.40",443,9,552,6,372,3,180,56735.80647,1.3080059999992955,2275.218921015349,1100.9123811364593
"147.32.84.165",22105,"184.173.217.40",443,9,552,6,372,3,180,56738.109512,1.3084689999959664,2274.4138378587295,1100.522824770353
"147.32.84.165",22106,"184.173.217.40",443,9,552,6,372,3,180,56740.413569,1.3076440000004368,2275.8487784129366,1101.2171508449692
"147.32.84.165",22107,"184.173.217.40",443,9,552,6,372,3,180,56742.716194,1.3084600000001956,2274.4294819861175,1100.5303945094117
"147.32.84.165",22108,"184.173.217.40",443,9,552,6,372,3,180,56745.020148,1.307321000000229,2276.4110727200728,1101.4892287355192
"147.32.84.165",22109,"74.125.39.27",25,6,372,6,372,0,0,56745.280304,9.012458999997762,330.2095465844271,0
"147.32.84.165",22110,"184.173.217.40",443,9,552,6,372,3,180,56747.322863,1.3080819999959203,2275.0867300438977,1100.8484177631763
"147.32.84.165",22111,"184.173.217.40",443,9,552,6,372,3,180,56749.626492,1.3075339999995776,2276.0402406369253,1101.3097938565768
"147.32.84.165",22112,"184.173.217.40",443,9,552,6,372,3,180,56751.930056,1.3076080000028014,2275.911435226478,1101.247468657973
"147.32.84.165",22113,"184.173.217.40",443,9,552,6,372,3,180,56754.233436,1.3072309999988647,2276.567798654243,1101.5650638649563
"147.32.84.165",22114,"184.173.217.40",443,9,552,6,372,3,180,56756.536274,1.3074909999995725,2276.1150937184066,1101.3460130895514
"147.32.84.165",22115,"184.173.217.40",443,9,552,6,372,3,180,56758.840054,1.3080489999993006,2275.1441268649655,1100.8761904185317
"147.32.84.165",22116,"184.173.217.40",443,9,552,6,372,3,180,56761.14289,1.307712999994692,2275.7286958316386,1101.1590463701477
"147.32.84.165",22117,"184.173.217.40",443,9,552,6,372,3,180,56763.446108,1.308260000005248,2274.7771849541086,1100.6986378810202
"147.32.84.165",22118,"184.173.217.40",443,9,552,6,372,3,180,56765.74981,1.3076690000016242,2275.8052687616696,1101.1960977879046
"147.32.84.165",22119,"66.111.4.73",25,6,372,6,372,0,0,56766.310498,9.012485999999626,330.20855732814715,0
"147.32.84.165",22120,"184.173.217.40",443,9,552,6,372,3,180,56768.053224,1.307688999993843,2275.770462253649,1101.179255929185
"147.32.84.165",22121,"184.173.217.40",443,9,552,6,372,3,180,56770.355954,1.3077449999982491,2275.673009649423,1101.132101443269
"147.32.84.165",22122,"184.173.217.40",443,9,552,6,372,3,180,56772.659359,1.3080830000035348,2275.084990778076,1100.84757618294
"147.32.84.165",22123,"184.173.217.40",443,9,552,6,372,3,180,56774.962924,1.3075890000036452,2275.9445054919424,1101.2634703993272
"147.32.84.165",22124,"184.173.217.40",443,9,552,6,372,3,180,56777.266156,1.3077360000024782,2275.6886711036173,1101.1396795662665
"147.32.84.165",22125,"184.173.217.40",443,9,552,6,372,3,180,56779.569925,1.3072969999993802,2276.4528641933784,1101.509450416151
"147.32.84.165",22126,"184.173.217.40",443,9,552,6,372,3,180,56781.872807,1.3077960000009625,2275.5842654342187,1101.089160693977
"147.32.84.165",22127,"184.173.217.40",443,9,552,6,372,3,180,56784.175944,1.3075839999946766,2275.953208369111,1101.2676814689248
"147.32.84.165",22128,"184.173.217.40",443,9,552,6,372,3,180,56786.479186,1.3081030000030296,2275.050206285826,1100.8307449770125
"147.32.84.165",22129,"216.157.130.15",25,6,372,6,372,0,0,56787.340657,8.912489000002097,333.9134556013814,0
"147.32.84.165",22130,"184.173.217.40",443,9,552,6,372,3,180,56788.782749,1.2086659999986296,2462.2186774538,1191.3961342518385
"147.32.84.165",22131,"184.173.217.40",443,9,552,6,372,3,180,56790.98607,1.3079280000019935,2275.3546066721287,1100.978035486514
"147.32.84.165",22132,"184.173.217.40",443,9,552,6,372,3,180,56793.289452,1.3076050000017858,2275.916656785448,1101.2499952187652
"147.32.84.165",22133,"184.173.217.40",443,9,552,6,372,3,180,56795.592339,1.3080189999964205,2275.1963083167325,1100.9014395080965
"147.32.84.165",22134,"184.173.217.40",443,9,552,6,372,3,180,56797.895929,1.3077940000002855,2275.5877454701204,1101.0908445823163
"147.32.84.165",22135,"184.173.217.40",443,9,552,6,372,3,180,56800.199349,1.307517999994161,2276.0680923805944,1101.3232705067392
"147.32.84.165",22136,"184.173.217.40",443,9,552,6,372,3,180,56802.502403,1.3081759999986389,2274.9232519195402,1100.769315444939
"147.32.84.165",22137,"184.173.217.40",443,9,552,6,372,3,180,56804.805717,1.308339999995951,2274.638091023136,1100.6313343660336
"147.32.84.165",22138,"184.173.217.40",443,9,552,6,372,3,180,56807.109309,1.3072919999976875,2276.4615709460963,1101.5136633610143
"147.32.84.165",22139,"184.173.217.40",443,9,552,6,372,3,180,56809.412647,1.3078610000011395,2275.4711700994276,1101.0344371448841
"147.32.84.165",22140,"184.173.217.40",443,9,552,6,372,3,180,56811.71561,1.3078480000040145,2275.4937882619884,1101.0453814170912
"147.32.84.165",22141,"184.173.217.40",443,9,552,6,372,3,180,56814.018796,1.3081960000054096,2274.888472360177,1100.752486625892
"147.32.84.165",22142,"184.173.217.40",443,9,552,6,372,3,180,56816.322588,1.3078999999997905,2275.4033182968706,1101.0016056275178
"147.32.84.165",22143,"184.173.217.40",443,9,552,6,372,3,180,56818.625425,1.3079280000019935,2275.3546066721287,1100.978035486514
"147.32.84.165",22144,"184.173.217.40",443,9,552,6,372,3,180,56820.929137,1.3077620000040042,2275.6434274668386,1101.117787483954
"147.32.84.165",22145,"184.173.217.40",443,9,552,6,372,3,180,56823.232597,1.3072570000003907,2276.522520054672,1101.543154865164
"147.32.84.165",22146,"184.173.217.40",443,9,552,6,372,3,180,56825.535486,1.308114999999816,2275.0293361060903,1100.820646502947
"147.32.84.165",22147,"184.173.217.40",443,9,552,6,372,3,180,56827.838988,1.3081189999938942,2275.0223794730377,1100.8172803901796
"147.32.84.165",22148,"184.173.217.40",443,9,552,6,372,3,180,56830.142027,1.3079759999964153,2275.2711058980867,1100.9376318861712
"147.32.84.165",22149,"184.173.217.40",443,9,552,6,372,3,180,56832.445589,1.3078820000009728,2275.4346340096326,1101.0167583917578
"147.32.84.165",22150,"184.173.217.40",443,9,552,6,372,3,180,56834.749243,1.307068000001891,2276.851701667927,1101.7024362909326
"147.32.84.165",22151,"184.173.217.40",443,9,552,6,372,3,180,56837.052026,1.3076179999989108,2275.8940302156125,1101.2390468785222
"147.32.84.165",22152,"184.173.217.40",443,9,552,6,372,3,180,56839.355472,1.307688999993843,2275.770462253649,1101.179255929185
"147.32.84.165",22153,"184.173.217.40",443,9,552,6,372,3,180,56841.6589,1.307732000001124,2275.6956318247485,1101.1430476571363
"147.32.84.165",22154,"184.173.217.40",443,9,552,6,372,3,180,56843.962266,1.307952999995905,2275.3111159264267,1100.9569915773031
"147.32.84.165",22155,"184.173.217.40",443,9,552,6,372,3,180,56846.265463,1.3077239999984158,2275.7095533947568,1101.1497839006888
"147.32.84.165",22156,"184.173.217.40",443,9,552,6,372,3,180,56848.568359,1.3084280000039143,2274.485107312819,1100.5573099900737
"147.32.84.165",22157,"184.173.217.40",443,9,552,6,372,3,180,56850.872148,1.3074049999995623,2276.264814652687,1101.418458702913
"147.32.84.165",22158,"184.173.217.40",443,9,552,6,372,3,180,56853.175026,1.3083180000030552,2274.676340150522,1100.649842008317
"147.32.84.165",22159,"184.173.217.40",443,9,552,6,372,3,180,56855.478719,1.3079240000006394,2275.3615653497795,1100.981402588603
"147.32.84.165",22160,"184.173.217.40",443,9,552,6,372,3,180,56857.782336,1.307042000000365,2276.896993363005,1101.7243516272604
"147.32.84.165",22161,"184.173.217.40",443,9,552,6,372,3,180,56860.085151,1.3077069999999367,2275.7391372839206,1101.164098685768
"147.32.84.165",22162,"184.173.217.40",443,9,552,6,372,3,180,56862.388643,1.3074869999982184,2276.1220570484106,1101.3493824427794
"147.32.84.165",22163,"184.173.217.40",443,9,552,6,372,3,180,56864.692223,1.3072949999987031,2276.4563468864735,1101.511135590229
"147.32.84.165",22164,"184.173.217.40",443,9,552,6,372,3,180,56866.995262,1.3075520000056713,2276.0089082400486,1101.2946330193784
"147.32.84.165",22165,"184.173.217.40",443,9,552,6,372,3,180,56869.29823,1.307673999996041,2275.7965670411813,1101.191887277991
"147.32.84.165",22166,"184.173.217.40",443,9,552,6,372,3,180,56871.601946,1.3075079999980517,2276.0855000538695,1101.3316935744529
"147.32.84.165",22167,"184.173.217.40",443,9,552,6,372,3,180,56873.905058,1.307719000003999,2275.718254449847,1101.1539940886355
"147.32.84.165",22168,"184.173.217.40",443,9,552,6,372,3,180,56876.208122,1.3081180000008317,2275.024118617822,1100.8181219118494
"147.32.84.165",22169,"184.173.217.40",443,9,552,6,372,3,180,56878.511446,1.4079080000010435,2113.774479580906,1022.794103023019
"147.32.84.165",22170,"184.173.217.40",443,9,552,6,372,3,180,56880.915135,1.3082069999945816,2274.869344081117,1100.7432310069923
"147.32.84.165",22171,"184.173.217.40",443,9,552,6,372,3,180,56883.218192,1.30782100000215,2275.54076589618,1101.0681125304095
"147.32.84.165",22172,"184.173.217.40",443,9,552,6,372,3,180,56885.522206,1.3076789999977336,2275.7878653745743,1101.1876767941487
"147.32.84.165",22173,"184.173.217.40",443,9,552,6,372,3,180,56887.825501,1.307526999997208,2276.0524256909075,1101.315689850439
"147.32.84.165",22174,"184.173.217.40",443,9,552,6,372,3,180,56890.128451,1.3074670000059996,2276.156874312196,1101.3662295059014
"147.32.84.165",22175,"184.173.217.40",443,9,552,6,372,3,180,56892.431404,1.307911999996577,2275.382441638114,1100.9915040184421
"147.32.84.165",22176,"184.173.217.40",443,9,552,6,372,3,180,56894.735249,1.307611000003817,2275.9062136914667,1101.2449421087742
"147.32.84.165",22177,"184.173.217.40",443,9,552,6,372,3,180,56897.038597,1.3078190000014729,2275.5442457990353,1101.0697963543719
"147.32.84.165",22178,"184.173.217.40",443,9,552,6,372,3,180,56899.341951,1.3075889999963692,2275.9445055046067,1101.2634704054549
"147.32.84.165",22179,"184.173.217.40",443,9,552,6,372,3,180,56901.645002,1.30745300000126,2276.1812470483696,1101.3780227653401
"147.32.84.165",22180,"184.173.217.40",443,9,552,6,372,3,180,56903.948658,1.307489999999234,2276.116834546913,1101.3468554259257
"147.32.84.165",22181,"184.173.217.40",443,9,552,6,372,3,180,56906.251833,1.3077609999963897,2275.645167586597,1101.1186294773856
"147.32.84.165",22182,"184.173.217.40",443,9,552,6,372,3,180,56908.555275,1.30793999999878,2275.33373090721,1100.9679343099401
"147.32.84.165",22183,"184.173.217.40",443,9,552,6,372,3,180,56910.858034,1.308325000005425,2274.6641698260446,1100.6439531416345
"147.32.84.165",22184,"184.173.217.40",443,9,552,6,372,3,180,56913.161634,1.3077530000009574,2275.6590885265196,1101.1253654160578
"147.32.84.165",22185,"184.173.217.40",443,9,552,6,372,3,180,56915.46474,1.3079729999953997,2275.276324519288,1100.940157025462
"147.32.84.165",22186,"184.173.217.40",443,9,552,6,372,3,180,56917.768523,1.3075880000033067,2275.946246059519,1101.2643126094447
"147.32.84.165",22187,"184.173.217.40",443,9,552,6,372,3,180,56920.071247,1.308153999998467,2274.961510650495,1100.7878277341104
"147.32.84.165",22188,"173.192.170.88",80,18,1800,12,1166,6,634,56921.676661,601.6027959999992,15.505247086650861,8.430811880734687
"147.32.84.165",22189,"184.173.217.40",443,9,552,6,372,3,180,56922.374477,1.3080709999994724,2275.1058619915893,1100.8576751572207
"147.32.84.165",22190,"184.173.217.40",443,9,552,6,372,3,180,56924.677797,1.3083260000057635,2274.6624312188933,1100.6431118801097
"147.32.84.165",22191,"184.173.217.40",443,9,552,6,372,3,180,56926.981538,1.3075450000033015,2276.0210929585487,1101.3005288509107
"147.32.84.165",22192,"94.100.176.20",25,6,372,6,372,0,0,56928.445269,8.910931999998866,333.97180003173395,0
"147.32.84.165",22193,"184.173.217.40",443,9,552,6,372,3,180,56929.284691,1.3074609999966924,2276.16731971931,1101.37128373515
"147.32.84.165",22194,"184.173.217.40",443,9,552,6,372,3,180,56931.587926,1.3078160000004573,2275.549465673275,1101.0723220999716
"147.32.84.165",22195,"184.173.217.40",443,9,552,6,372,3,180,56933.8916,1.3073259999946458,2276.4023663662992,1101.485015983693
"147.32.84.165",22196,"184.173.217.40",443,9,552,6,372,3,180,56936.194429,1.3080730000001495,2275.102383429411,1100.8559919819731
"147.32.84.165",22197,"184.173.217.40",443,9,552,6,372,3,180,56938.497829,1.3080580000023474,2275.128472892379,1100.8686159156673
"147.32.84.165",22198,"184.173.217.40",443,9,552,6,372,3,180,56940.801113,1.307913999997254,2275.3789622301224,1100.9898204339302
"147.32.84.165",22199,"184.173.217.40",443,9,552,6,372,3,180,56943.104265,1.3080139999947278,2275.2050054601827,1100.9056478033142
"147.32.84.165",22200,"184.173.217.40",443,9,552,6,372,3,180,56945.407638,1.308457000006456,2274.4346967346396,1100.5329177748256
"147.32.84.165",22201,"184.173.217.40",443,9,552,6,372,3,180,56947.711789,1.3068760000023758,2277.1862058792035,1101.8642931673564
"147.32.84.165",22202,"74.125.93.27",25,6,372,6,372,0,0,56949.373656,9.013256999998703,330.1803110685103,0
"147.32.84.165",22203,"184.173.217.40",443,9,552,6,372,3,180,56950.014609,1.3089050000053248,2273.656224086464,1100.1562374611922
"147.32.84.165",22204,"184.173.217.40",443,9,552,6,372,3,180,56952.317956,1.3082510000022012,2274.7928340929934,1100.7062100449969
"147.32.84.165",22205,"184.173.217.40",443,9,552,6,372,3,180,56954.621002,1.3079730000026757,2275.276324506631,1100.9401570193377
"147.32.84.165",22206,"184.173.217.40",443,9,552,6,372,3,180,56956.924624,1.307770999999775,2275.627766635376,1101.1102096622785
"147.32.84.165",22207,"184.173.217.40",443,9,552,6,372,3,180,56959.228086,1.307065999993938,2276.855185594149,1101.7041220616852
"147.32.84.165",22208,"184.173.217.40",443,9,552,6,372,3,180,56961.530846,1.3081459999957588,2274.975423239951,1100.7945596322343
"147.32.84.165",22209,"184.173.217.40",443,9,552,6,372,3,180,56963.834483,1.3090339999980642,2273.4321644849565,1100.047821524979
"147.32.84.165",22210,"184.173.217.40",443,9,552,6,372,3,180,56966.137346,1.308140999994066,2274.9841186947733,1100.7987671103742
"147.32.84.165",22211,"184.173.217.40",443,9,552,6,372,3,180,56968.440715,1.3079080000024987,2275.3894004733625,1100.9948711967882
"147.32.84.165",22212,"74.125.39.27",25,6,372,6,372,0,0,56970.403765,9.012663999994402,330.20203571350805,0
"147.32.84.165",22213,"184.173.217.40",443,9,552,6,372,3,180,56970.744291,1.3080759999938891,2275.097165618743,1100.8534672348756
"147.32.84.165",22214,"184.173.217.40",443,9,552,6,372,3,180,56973.047523,1.3077750000011292,2275.6208063293993,1101.10684177229
"147.32.84.165",22215,"184.173.217.40",443,9,552,6,372,3,180,56975.35064,1.3080600000030245,2275.1249942610575,1100.8669327069633
"147.32.84.165",22216,"184.173.217.40",443,9,552,6,372,3,180,56977.654626,1.307383999999729,2276.301377407569,1101.436150358501
"147.32.84.165",22217,"184.173.217.40",443,9,552,6,372,3,180,56979.957788,1.3072580000007292,2276.5207786055544,1101.542312228494
"147.32.84.165",22218,"184.173.217.40",443,9,552,6,372,3,180,56982.260665,1.3096049999949173,2272.4409268531736,1099.5681904128257
"147.32.84.165",22219,"184.173.217.40",443,9,552,6,372,3,180,56984.564038,1.3082090000025346,2274.8658662295047,1100.7415481755668
"147.32.84.165",22220,"184.173.217.40",443,9,552,6,372,3,180,56986.867449,1.307873000005202,2275.4502921829285,1101.0243349272234
"147.32.84.165",22221,"184.173.217.40",443,9,552,6,372,3,180,56989.17115,1.307927000001655,2275.3563463375513,1100.9788772601055
"147.32.84.165",22222,"66.111.4.73",25,6,372,6,372,0,0,56991.433888,8.912995999999112,333.89446152565273,0
"147.32.84.165",22223,"184.173.217.40",443,9,552,6,372,3,180,56991.474008,1.3081860000020242,2274.905862006928,1100.760900971094
"147.32.84.165",22224,"184.173.217.40",443,9,552,6,372,3,180,56993.777372,1.3075220000027912,2276.0611293681077,1101.319901307149
"147.32.84.165",22225,"184.173.217.40",443,9,552,6,372,3,180,56996.080642,1.3092590000014752,2273.0414684922134,1099.8587750768775
"147.32.84.165",22226,"184.173.217.40",443,9,552,6,372,3,180,56998.383942,1.3097730000008596,2272.149448796125,1099.4271526432863
"147.32.84.165",22227,"184.173.217.40",443,9,552,6,372,3,180,57000.687186,1.3082670000003418,2274.7650135631507,1100.6927484982987
"147.32.84.165",22228,"184.173.217.40",443,9,552,6,372,3,180,57002.991047,1.3073899999944842,2276.2909307953673,1101.4310955461456
"147.32.84.165",22229,"184.173.217.40",443,9,552,6,372,3,180,57005.293664,1.308022000004712,2275.191090049922,1100.898914540285
"147.32.84.165",22230,"184.173.217.40",443,9,552,6,372,3,180,57007.597111,1.3080950000003213,2275.0641199601473,1100.8374774000713
"147.32.84.165",22231,"184.173.217.40",443,9,552,6,372,3,180,57009.900762,1.3077240000056918,2275.7095533820952,1101.1497838945622
"147.32.84.165",22232,"184.173.217.40",443,9,552,6,372,3,180,57012.203768,1.3079569999972591,2275.304157557348,1100.9536246245232
"147.32.84.165",22233,"216.157.130.15",25,6,372,6,372,0,0,57012.364421,9.01286799999798,330.1945618199076,0
"147.32.84.165",22234,"184.173.217.40",443,9,552,6,372,3,180,57014.507147,1.3077680000060354,2275.632986880139,1101.112735587164
"147.32.84.165",22235,"184.173.217.40",443,9,552,6,372,3,180,57016.810635,1.3077189999967231,2275.7182544625084,1101.1539940947623
"147.32.84.165",22236,"184.173.217.40",443,9,552,6,372,3,180,57019.114028,1.3078939999977592,2275.4137567762364,1101.0066565046304
"147.32.84.165",22237,"184.173.217.40",443,9,552,6,372,3,180,57021.417616,1.3077459999985876,2275.6712694997454,1101.1312594353608
"147.32.84.165",22238,"184.173.217.40",443,9,552,6,372,3,180,57023.720446,1.307636999998067,2275.8609614169677,1101.2230458469198
"147.32.84.165",22239,"184.173.217.40",443,9,552,6,372,3,180,57026.023956,1.5083270000031916,1973.046958646038,954.700141280341
"147.32.84.165",22240,"184.173.217.40",443,9,552,6,372,3,180,57028.527362,1.308194999997795,2274.890211325541,1100.7533280607456
"147.32.84.165",22241,"184.173.217.40",443,9,552,6,372,3,180,57030.831095,1.3077579999953741,2275.6503879238567,1101.1211554470274
"147.32.84.165",22242,"184.173.217.40",443,9,552,6,372,3,180,57033.134328,1.3074839999972028,2276.1272795738737,1101.3519094712292
"147.32.84.165",22243,"184.173.217.40",443,9,552,6,372,3,180,57035.437216,1.3077449999982491,2275.673009649423,1101.132101443269
"147.32.84.165",22244,"184.173.217.40",443,9,552,6,372,3,180,57037.740743,1.3073629999998957,2276.337941337056,1101.4538425824464
"147.32.84.165",22245,"184.173.217.40",443,9,552,6,372,3,180,57040.043739,1.3084949999974924,2274.3686448979197,1100.5009572086708
"147.32.84.165",22246,"184.173.217.40",443,9,552,6,372,3,180,57042.347107,1.3079589999979362,2275.300678388769,1100.9519411558558
"147.32.84.165",22247,"184.173.217.40",443,9,552,6,372,3,180,57044.650684,1.3073769999973592,2276.313565257773,1101.4420477053739
"147.32.84.165",22248,"184.173.217.40",443,9,552,6,372,3,180,57046.95363,1.3083669999978156,2274.5911506518955,1100.6086212831754
"147.32.84.165",22249,"184.173.217.40",443,9,552,6,372,3,180,57049.257341,1.30751600000076,2276.071573883815,1101.3249551050717
"147.32.84.165",22250,"184.173.217.40",443,9,552,6,372,3,180,57051.560722,1.3077999999950407,2275.577305407008,1101.0857929388749
"147.32.84.165",22251,"184.173.217.40",443,9,552,6,372,3,180,57053.864204,1.3072860000029323,2276.4720191246024,1101.5187189312592
"147.32.84.165",22252,"184.173.217.40",443,9,552,6,372,3,180,57056.167299,1.3072380000012345,2276.5556080814586,1101.5591652007058
"147.32.84.165",22253,"184.173.217.40",443,9,552,6,372,3,180,57058.470641,1.3079559999969206,2275.3058971456276,1100.9544663607876
"147.32.84.165",22254,"184.173.217.40",443,9,552,6,372,3,180,57060.773587,1.3081739999979618,2274.9267299339667,1100.7709983551451
"147.32.84.165",22255,"184.173.217.40",443,9,552,6,372,3,180,57063.077331,1.3072180000017397,2276.5904386231214,1101.576018688607
"147.32.84.165",22256,"184.173.217.40",443,9,552,6,372,3,180,57065.380129,1.3078930000046967,2275.4154965194502,1101.007498315863
"147.32.84.165",22257,"184.173.217.40",443,9,552,6,372,3,180,57067.683824,1.2070800000001327,2465.4538224472885,1192.9615269906235
"147.32.84.165",22258,"184.173.217.40",443,9,552,6,372,3,180,57069.886572,1.3083889999979874,2274.5529043767397,1100.590115021003
"147.32.84.165",22259,"184.173.217.40",443,9,552,6,372,3,180,57072.190439,1.3072440000032657,2276.5451591229835,1101.5541092530566
"147.32.84.165",22260,"184.173.217.40",443,9,552,6,372,3,180,57074.493454,1.307991999994556,2275.243273668636,1100.9241646783723
"147.32.84.165",22261,"184.173.217.40",443,9,552,6,372,3,180,57076.796629,1.3080939999999828,2275.065859181404,1100.8383189587437
"147.32.84.165",22262,"184.173.217.40",443,9,552,6,372,3,180,57079.100006,1.3081919999967795,2274.895428199627,1100.7558523546581
"147.32.84.165",22263,"184.173.217.40",443,9,552,6,372,3,180,57081.40356,1.3073700000022654,2276.325753225822,1101.4479451092689
"147.32.84.165",22264,"184.173.217.40",443,9,552,6,372,3,180,57083.706817,1.307426999999734,2276.2265120734123,1101.3999251968123
"147.32.84.165",22265,"184.173.217.40",443,9,552,6,372,3,180,57086.010392,1.3077069999999367,2275.7391372839206,1101.164098685768
"147.32.84.165",22266,"184.173.217.40",443,9,552,6,372,3,180,57088.313065,1.3078329999989364,2275.5198867152153,1101.0580097009106
"147.32.84.165",22267,"184.173.217.40",443,9,552,6,372,3,180,57090.617088,1.307520000002114,2276.064610862693,1101.321585901303
"147.32.84.165",22268,"184.173.217.40",443,9,552,6,372,3,180,57092.919731,1.308101999995415,2275.0519454984633,1100.8315865315146
"147.32.84.165",22269,"184.173.217.40",443,9,552,6,372,3,180,57095.223072,1.3081880000027013,2274.902384056309,1100.7592180917625
"147.32.84.165",22270,"184.173.217.40",443,9,552,6,372,3,180,57097.526682,1.3076399999990826,2275.855740113554,1101.2205194097842
"147.32.84.165",22271,"184.173.217.40",443,9,552,6,372,3,180,57099.829964,1.307412000001932,2276.2526273245176,1101.4125616086376
"147.32.84.165",22272,"184.173.217.40",443,9,552,6,372,3,180,57102.133612,1.4073070000013104,2114.6771813095716,1023.2308941820506
"147.32.84.165",22273,"184.173.217.40",443,9,552,6,372,3,180,57104.537099,1.3077100000009523,2275.733916539472,1101.1615725190993
"147.32.84.165",22274,"184.173.217.40",443,9,552,6,372,3,180,57106.840291,1.3072640000027604,2276.5103299667976,1101.5372564355473
"147.32.84.165",22275,"184.173.217.40",443,9,552,6,372,3,180,57109.143008,1.3078050000040093,2275.568605404381,1101.0815832601843
"147.32.84.165",22276,"184.173.217.40",443,9,552,6,372,3,180,57111.446362,1.3084139999991748,2274.509444259903,1100.5690859322112
"147.32.84.165",22277,"184.173.217.40",443,9,552,6,372,3,180,57113.749932,1.3078710000045248,2275.453771809073,1101.0260186172934
"147.32.84.165",22278,"184.173.217.40",443,9,552,6,372,3,180,57116.053164,1.307613000004494,2275.902732681437,1101.2432577490824
"147.32.84.165",22279,"184.173.217.40",443,9,552,6,372,3,180,57118.356869,1.308006999999634,2275.2171815600627,1100.9115394645464
"147.32.84.165",22280,"184.173.217.40",443,9,552,6,372,3,180,57120.660095,1.3078220000024885,2275.539025948743,1101.0672706203597
"147.32.84.165",22281,"184.173.217.40",443,9,552,6,372,3,180,57122.963217,1.3077489999996033,2275.666049066681,1101.1287334193617
"147.32.84.165",22282,"184.173.217.40",443,9,552,6,372,3,180,57125.266397,1.3082560000038939,2274.7841401003643,1100.7020032743699
"147.32.84.165",22283,"184.173.217.40",443,9,552,6,372,3,180,57127.569576,1.308216999997967,2274.851954992654,1100.7348169319293
"147.32.84.165",22284,"184.173.217.40",443,9,552,6,372,3,180,57129.873023,1.3082520000025397,2274.791095289151,1100.705368688299
"147.32.84.165",22285,"184.173.217.40",443,9,552,6,372,3,180,57132.176881,1.3069509999986622,2277.055528480445,1101.8010621679573
"147.32.84.165",22286,"184.173.217.40",443,9,552,6,372,3,180,57134.479495,1.30818200000067,2274.912817940069,1100.7642667451948
"147.32.84.165",22287,"184.173.217.40",443,9,552,6,372,3,180,57136.782945,1.3076230000006035,2275.8853278036763,1101.2348360340368
"147.32.84.165",22288,"184.173.217.40",443,9,552,6,372,3,180,57139.086212,1.3077009999979055,2275.74957884468,1101.1691510538774
"147.32.84.165",22289,"184.173.217.40",443,9,552,6,372,3,180,57141.389845,1.307979000004707,2275.265887288168,1100.9351067523394
"147.32.84.165",22290,"184.173.217.40",443,9,552,6,372,3,180,57143.693361,1.3075010000029579,2276.097685579795,1101.337589796675
"147.32.84.165",22291,"184.173.217.40",443,9,552,6,372,3,180,57145.996652,1.3073509999958333,2276.3588355456836,1101.4639526833953
"147.32.84.165",22292,"184.173.217.40",443,9,552,6,372,3,180,57148.299806,1.3076440000004368,2275.8487784129366,1101.2171508449692
"147.32.84.165",22293,"184.173.217.40",443,9,552,6,372,3,180,57150.603099,1.3075919999973848,2275.9392838178514,1101.2609437828314
"147.32.84.165",22294,"184.173.217.40",443,9,552,6,372,3,180,57152.906538,1.3074169999963487,2276.2439221826785,1101.4083494432316
"147.32.84.165",22295,"94.100.176.20",25,6,372,6,372,0,0,57153.609893,8.970265999996627,331.7627370248685,0
"147.32.84.165",22296,"184.173.217.40",443,9,552,6,372,3,180,57155.209445,1.3081999999994878,2274.8815165885685,1100.7491209299524
"147.32.84.165",22297,"184.173.217.40",443,9,552,6,372,3,180,57157.512679,1.3078069999974105,2275.5651254396807,1101.0798994062973
"147.32.84.165",22298,"184.173.217.40",443,9,552,6,372,3,180,57159.816565,1.3076969999965513,2275.756539938417,1101.1725193250406
"147.32.84.165",22299,"184.173.217.40",443,9,552,6,372,3,180,57162.119363,1.3077180000036606,2275.7199946713813,1101.1548361313137
"147.32.84.165",22300,"184.173.217.40",443,9,552,6,372,3,180,57164.423203,1.3072099999990314,2276.6043711432785,1101.5827602306185
"147.32.84.165",22301,"184.173.217.40",443,9,552,6,372,3,180,57166.725992,1.3075529999987339,2276.0071675892923,1101.2937907690123
"147.32.84.165",22302,"184.173.217.40",443,9,552,6,372,3,180,57169.029645,1.3074149999956717,2276.2474042364915,1101.4100343079797
"147.32.84.165",22303,"184.173.217.40",443,9,552,6,372,3,180,57171.332465,1.3083699999988312,2274.5859351732756,1100.6060976644883
"147.32.84.165",22304,"184.173.217.40",443,9,552,6,372,3,180,57173.635904,1.3077469999989262,2275.669529352729,1101.13041742874
"147.32.84.165",22305,"74.125.93.27",25,6,372,6,372,0,0,57174.597265,9.013132000000041,330.1848902246174,0
"147.32.84.165",22306,"184.173.217.40",443,9,552,6,372,3,180,57175.93918,1.307968000000983,2275.2850222618317,1100.9443656105636
"147.32.84.165",22307,"184.173.217.40",443,9,552,6,372,3,180,57178.243129,1.3071319999944535,2276.740222114238,1101.6484945714053
"147.32.84.165",22308,"184.173.217.40",443,9,552,6,372,3,180,57180.54615,1.307321000000229,2276.4110727200728,1101.4892287355192
"147.32.84.165",22309,"184.173.217.40",443,9,552,6,372,3,180,57182.849581,1.3072749999992084,2276.491174390853,1101.5279876084771
"147.32.84.165",22310,"184.173.217.40",443,9,552,6,372,3,180,57185.152508,1.3074830000041402,2276.1290204083543,1101.352751810494
"147.32.84.165",22311,"184.173.217.40",443,9,552,6,372,3,180,57187.455737,1.307622000000265,2275.887068280739,1101.2356782003578
"147.32.84.165",22312,"184.173.217.40",443,9,552,6,372,3,180,57189.75926,1.307660999998916,2275.8191916731225,1101.2028346805432
"147.32.84.165",22313,"184.173.217.40",443,9,552,6,372,3,180,57192.062658,1.3076059999948484,2275.914916275793,1101.249153036674
"147.32.84.165",22314,"184.173.217.40",443,9,552,6,372,3,180,57194.366189,1.3072210000027553,2276.5852139720273,1101.573490631626
"147.32.84.165",22315,"74.125.39.27",25,6,372,6,372,0,0,57195.627917,9.012396000005538,330.2118548716869,0
"147.32.84.165",22316,"184.173.217.40",443,9,552,6,372,3,180,57196.668942,1.30797000000166,2275.2815431517715,1100.942682170212
"147.32.84.165",22317,"184.173.217.40",443,9,552,6,372,3,180,57198.972871,1.307715000002645,2275.7252153519544,1101.1573622670746
"147.32.84.165",22318,"184.173.217.40",443,9,552,6,372,3,180,57201.276213,1.3074570000026142,2276.1742833562016,1101.3746532368718
"147.32.84.165",22319,"184.173.217.40",443,9,552,6,372,3,180,57203.579046,1.3074439999982133,2276.1969155115376,1101.3856042797763
"147.32.84.165",22320,"184.173.217.40",443,9,552,6,372,3,180,57205.882539,1.3076849999997648,2275.7774234624817,1101.1826242560394
"147.32.84.165",22321,"184.173.217.40",443,9,552,6,372,3,180,57208.185748,1.3078299999979208,2275.525106477701,1101.060535392436
"147.32.84.165",22322,"184.173.217.40",443,9,552,6,372,3,180,57210.489337,1.3073490000024321,2276.362317938411,1101.4656377121344
"147.32.84.165",22323,"184.173.217.40",443,9,552,6,372,3,180,57212.792733,1.3070349999979953,2276.909187592195,1101.7302520607395
"147.32.84.165",22324,"184.173.217.40",443,9,552,6,372,3,180,57215.095896,1.307347000001755,2276.365800354462,1101.4673227521591
"147.32.84.165",22325,"66.111.4.73",25,6,372,6,372,0,0,57216.557507,9.012784000005922,330.1976392641879,0
"147.32.84.165",22326,"184.173.217.40",443,9,552,6,372,3,180,57217.399282,1.307929000002332,2275.3528670093665,1100.9771937142095
"147.32.84.165",22327,"184.173.217.40",443,9,552,6,372,3,180,57219.702007,1.30772799999977,2275.7025925884614,1101.1464157686103
"147.32.84.165",22328,"173.192.170.88",80,57,6415,38,3176,19,3239,57221.691952,58.9990439999965,430.65104580341176,439.19355710240893
"147.32.84.165",22329,"184.173.217.40",443,9,552,6,372,3,180,57222.005408,1.3078170000007958,2275.547725712534,1101.0714801834843
"147.32.84.165",22330,"173.192.170.88",80,6,372,6,372,0,0,57222.747819,8.931567000006908,333.20020999648756,0
"147.32.84.165",22331,"184.173.217.40",443,9,552,6,372,3,180,57224.309357,1.3073460000014165,2276.367541566483,1101.4681652741046
"147.32.84.165",22332,"184.173.217.40",443,9,552,6,372,3,180,57226.611994,1.3081569999994827,2274.9562934733194,1100.7853032935416
"147.32.84.165",22333,"184.173.217.40",443,9,552,6,372,3,180,57228.915282,1.308177999999316,2274.9197739157485,1100.7676325398784
"147.32.84.165",22334,"184.173.217.40",443,9,552,6,372,3,180,57231.219184,1.3075729999982286,2275.972354892638,1101.2769459157926
"147.32.84.165",22335,"184.173.217.40",443,9,552,6,372,3,180,57233.52259,1.3070969999971567,2276.8011861449254,1101.6779932959316
"147.32.84.165",22336,"184.173.217.40",443,9,552,6,372,3,180,57235.825635,1.3073420000000624,2276.374506441205,1101.4715353747767
"147.32.84.165",22337,"216.157.130.15",25,6,372,6,372,0,0,57237.587684,9.012840000003052,330.1955876282051,0
"147.32.84.165",22338,"184.173.217.40",443,9,552,6,372,3,180,57238.129049,1.30705499999749,2276.874347296567,1101.7133938531776
"147.32.84.165",22339,"184.173.217.40",443,9,552,6,372,3,180,57240.432413,1.307968000000983,2275.2850222618317,1100.9443656105636
"147.32.84.165",22340,"184.173.217.40",443,9,552,6,372,3,180,57242.735347,1.3080300000001444,2275.1771748351885,1100.8921813718655
"147.32.84.165",22341,"173.192.170.88",80,6,372,6,372,0,0,57243.697746,9.011746000003768,330.23567242116627,0
"147.32.84.165",22342,"184.173.217.40",443,9,552,6,372,3,180,57245.038976,1.308562999998685,2274.250456418981,1100.4437692349907
"147.32.84.165",22344,"184.173.217.40",443,9,552,6,372,3,180,57247.342359,1.3077699999994365,2275.6295067185224,1101.1110516379947
"147.32.84.165",22345,"184.173.217.40",443,9,552,6,372,3,180,57249.645538,1.3073760000042967,2276.315306377216,1101.442890182524
"147.32.84.165",22346,"184.173.217.40",443,9,552,6,372,3,180,57251.948786,1.3078200000018114,2275.542505846277,1101.0689544417469
"147.32.84.165",22347,"184.173.217.40",443,9,552,6,372,3,180,57254.251992,1.3081190000011702,2275.022379460384,1100.8172803840566
"147.32.84.165",22349,"98.126.71.122",80,18,4863,14,1430,4,3433,57255.49285,16.294034999998985,702.097423996003,1685.5247948099848
"147.32.84.165",22350,"195.113.232.98",80,17,5984,12,2560,5,3424,57256.437823,19.02492099999654,1076.4827880233368,1439.7957289812127
"147.32.84.165",22351,"184.173.217.40",443,9,552,6,372,3,180,57256.546672,1.3114540000024135,2269.2370452905884,1098.0179251406073
"147.32.84.165",22352,"195.113.232.83",80,22,13602,18,2290,4,11312,57256.777314,18.685616000002483,980.433291575593,4843.0835782983
"147.32.84.165",22353,"184.173.217.40",443,9,552,6,372,3,180,57258.858195,1.30705499999749,2276.874347296567,1101.7133938531776
"147.32.84.165",22354,"184.173.217.40",443,9,552,6,372,3,180,57261.166138,1.3067169999994803,2277.4632915935,1101.9983669000806
"147.32.84.165",22355,"184.173.217.40",443,9,552,6,372,3,180,57263.472188,1.3078870000026654,2275.4259351105525,1101.0125492470415
"147.32.84.165",22356,"184.173.217.40",443,9,552,6,372,3,180,57265.779259,1.3079059999945457,2275.3928799259356,1100.996554802872
"147.32.84.165",22357,"184.173.217.40",443,9,552,6,372,3,180,57268.088332,1.3066689999977825,2277.5469533638975,1102.0388484018858
"147.32.84.165",22358,"184.173.217.40",443,9,552,6,372,3,180,57270.394036,1.3083079999996698,2274.69372655426,1100.6582547843195
"147.32.84.165",22359,"184.173.217.40",443,9,552,6,372,3,180,57272.702799,1.3068899999998393,2277.161811629415,1101.852489498104
"147.32.84.165",22360,"184.173.217.40",443,9,552,6,372,3,180,57275.00985,1.3193479999972624,2255.6596136926537,1091.4482001738647
"147.32.84.165",22361,"184.173.217.40",443,9,552,6,372,3,180,57277.325135,1.3077590000029886,2275.6486477961143,1101.1203134497327
"147.32.84.165",22362,"184.173.217.40",443,9,552,6,372,3,180,57279.628014,1.3082369999974617,2274.8171776258996,1100.7179891738224
"147.32.84.165",22363,"173.192.170.88",80,21,3483,16,2050,5,1433,57280.49069,9.503591000000597,1725.6634886748566,1206.2808679371071
"147.32.84.165",22364,"184.173.217.40",443,9,552,6,372,3,180,57281.93164,1.3076149999978952,2275.899251694719,1101.2415734006706
"147.32.84.165",22365,"184.173.217.40",443,9,552,6,372,3,180,57284.235352,1.3071509999936097,2276.70712872082,1101.6324816391066
"147.32.84.165",22366,"184.173.217.40",443,9,552,6,372,3,180,57286.538272,1.3079580000048736,2275.302417959071,1100.9527828834216
"147.32.84.165",22367,"184.173.217.40",443,9,552,6,372,3,180,57288.841332,1.3076639999999315,2275.8139705613644,1101.200308336144
"147.32.84.165",22368,"173.192.170.88",80,6,372,6,372,0,0,57289.995378,8.920445000003383,333.6156436140654,0
"147.32.84.165",22369,"184.173.217.40",443,9,552,6,372,3,180,57291.144548,1.308415999999852,2274.5059675212906,1100.567403639334
"147.32.84.165",22370,"184.173.217.40",443,9,552,6,372,3,180,57293.447879,1.3082789999971283,2274.7441486154958,1100.6826525558852
"147.32.84.165",22371,"184.173.217.40",443,9,552,6,372,3,180,57295.751447,1.3077119999943534,2275.7304360691423,1101.1598884205528
"147.32.84.165",22372,"184.173.217.40",443,9,552,6,372,3,180,57298.055058,1.3072610000017448,2276.515554274187,1101.5397843262194
"147.32.84.165",22373,"184.173.217.40",443,9,552,6,372,3,180,57300.358559,1.3070500000030734,2276.8830572610095,1101.7176083521013
"147.32.84.165",22374,"184.173.217.40",443,9,552,6,372,3,180,57302.661136,1.3079499999948894,2275.3163347311656,1100.9595168054027
"147.32.84.165",22375,"184.173.217.40",443,9,552,6,372,3,180,57304.964759,1.3077899999989313,2275.594705573855,1101.094212374446
"147.32.84.165",22376,"184.173.217.40",443,9,552,6,372,3,180,57307.268412,1.3071110000018962,2276.776800130733,1101.6661936116452
"147.32.84.165",22377,"184.173.217.40",443,9,552,6,372,3,180,57309.571121,1.308153999998467,2274.961510650495,1100.7878277341104
"147.32.84.165",22378,"184.173.217.40",443,9,552,6,372,3,180,57311.874947,1.3078980000063893,2275.4067977666928,1101.003289241948
"147.32.84.165",22379,"184.173.217.40",443,9,552,6,372,3,180,57314.177801,1.308035000001837,2275.168477904506,1100.8879731795996
"147.32.84.165",22380,"184.173.217.40",443,9,552,6,372,3,180,57316.481654,1.3078779999996186,2275.4415931767853,1101.0201257307026
"147.32.84.165",22381,"184.173.217.40",443,9,552,6,372,3,180,57318.784775,1.2079400000002352,2463.698528072107,1192.1121910026322
"147.32.84.165",22382,"184.173.217.40",443,9,552,6,372,3,180,57320.987849,1.3080289999998058,2275.1789142293037,1100.893023014179
"147.32.84.165",22383,"184.173.217.40",443,9,552,6,372,3,180,57323.291388,1.3074550000019372,2276.1777651969596,1101.3763379985287
"147.32.84.165",22384,"184.173.217.40",443,9,552,6,372,3,180,57325.594218,1.3082090000025346,2274.8658662295047,1100.7415481755668
"147.32.84.165",22385,"184.173.217.40",443,9,552,6,372,3,180,57327.897522,1.308686000003945,2274.0367055130328,1100.340341377274
"147.32.84.165",22386,"184.173.217.40",443,9,552,6,372,3,180,57330.20111,1.3081449999954202,2274.9771623255974,1100.7954011252891
"147.32.84.165",22387,"184.173.217.40",443,9,552,6,372,3,180,57332.504319,1.307518000001437,2276.068092367929,1101.3232705006105
"147.32.84.165",22388,"184.173.217.40",443,9,552,6,372,3,180,57334.807965,1.3078559999994468,2275.4798693443763,1101.0386464569563
"147.32.84.165",22389,"184.173.217.40",443,9,552,6,372,3,180,57337.111072,1.3073070000027656,2276.4354508877445,1101.501024623102
"147.32.84.165",22390,"184.173.217.40",443,9,552,6,372,3,180,57339.414336,1.3079280000019935,2275.3546066721287,1100.978035486514
"147.32.84.165",22391,"184.173.217.40",443,9,552,6,372,3,180,57341.71751,1.3078639999948791,2275.465950597044,1101.031911579215
"147.32.84.165",22392,"184.173.217.40",443,9,552,6,372,3,180,57344.0213,1.3073720000029425,2276.322270932299,1101.4462601285318
"147.32.84.165",22393,"184.173.217.40",443,9,552,6,372,3,180,57346.324444,1.4086520000055316,2112.6580589019245,1022.2538994686731
"147.32.84.165",22394,"184.173.217.40",443,9,552,6,372,3,180,57348.727308,1.3085280000013881,2274.311287184411,1100.4732034763279
"147.32.84.165",22395,"184.173.217.40",443,9,552,6,372,3,180,57351.03079,1.3082480000011856,2274.7980505204696,1100.7087341228078
"147.32.84.165",22396,"184.173.217.40",443,9,552,6,372,3,180,57353.334098,1.30812600000354,2275.010205432769,1100.8113897255334
"147.32.84.165",22397,"184.173.217.40",443,9,552,6,372,3,180,57355.637894,1.3073979999971925,2276.277002111362,1101.4243558603364
"147.32.84.165",22398,"184.173.217.40",443,9,552,6,372,3,180,57357.940644,1.3077779999948689,2275.6155861405196,1101.1043158744449
"147.32.84.165",22399,"184.173.217.40",443,9,552,6,372,3,180,57360.244262,1.3082799999974668,2274.742409886081,1100.6818112352007
"147.32.84.165",22400,"184.173.217.40",443,9,552,6,372,3,180,57362.547714,1.3074839999972028,2276.1272795738737,1101.3519094712292
"147.32.84.165",22401,"184.173.217.40",443,9,552,6,372,3,180,57364.851252,1.3082349999967846,2274.8206553159903,1100.7196719270921
"147.32.84.165",22402,"184.173.217.40",443,9,552,6,372,3,180,57367.15412,1.3082199999989825,2274.8467383179545,1100.7322927344942
"147.32.84.165",22403,"184.173.217.40",443,9,552,6,372,3,180,57369.45754,1.3082259999937378,2274.8363050529842,1100.7272443804763
"147.32.84.165",22404,"184.173.217.40",443,9,552,6,372,3,180,57371.760506,1.3093240000016522,2272.9286257612666,1099.8041737554515
"147.32.84.165",22405,"184.173.217.40",443,9,552,6,372,3,180,57374.064289,1.3078009999953792,2275.575565403693,1101.0849510017867
"147.32.84.165",22406,"184.173.217.40",443,9,552,6,372,3,180,57376.367531,1.3072139999931096,2276.597404874555,1101.57938945543
"147.32.84.165",22407,"184.173.217.40",443,9,552,6,372,3,180,57378.670596,1.308073999993212,2275.1006441649656,1100.8551504024026
"147.32.84.165",22408,"94.100.176.20",25,6,372,6,372,0,0,57378.85704,8.986496999998053,331.16352233808624,0
"147.32.84.165",22409,"184.173.217.40",443,9,552,6,372,3,180,57380.974068,1.3074280000000726,2276.2247710771335,1101.3990827792582
"147.32.84.165",22410,"184.173.217.40",443,9,552,6,372,3,180,57383.277142,1.3076690000016242,2275.8052687616696,1101.1960977879046
"147.32.84.165",22411,"184.173.217.40",443,9,552,6,372,3,180,57385.580444,1.3078820000009728,2275.4346340096326,1101.0167583917578
"147.32.84.165",22412,"184.173.217.40",443,9,552,6,372,3,180,57387.883953,1.2077430000063032,2464.1003922063455,1192.3066413901672
"147.32.84.165",22413,"184.173.217.40",443,9,552,6,372,3,180,57390.087357,1.3073490000024321,2276.362317938411,1101.4656377121344
"147.32.84.165",22414,"184.173.217.40",443,9,552,6,372,3,180,57392.390739,1.3075639999951818,2275.9880204800425,1101.2845260387303
"147.32.84.165",22415,"184.173.217.40",443,9,552,6,372,3,180,57394.694142,1.3072769999998854,2276.4876915911937,1101.5263023828356
"147.32.84.165",22416,"184.173.217.40",443,9,552,6,372,3,180,57396.997048,1.3074350000024424,2276.212584177753,1101.3931858924611
"147.32.84.165",22417,"184.173.217.40",443,9,552,6,372,3,180,57399.300586,1.307981000005384,2275.262408236626,1100.9334233403029
"147.32.84.165",22418,"74.125.93.27",25,6,372,6,372,0,0,57399.761353,9.012225999998918,330.21808374538733,0
"147.32.84.165",22419,"184.173.217.40",443,9,552,6,372,3,180,57401.603503,1.3083440000045812,2274.63113675729,1100.6279693986885
"147.32.84.165",22420,"184.173.217.40",443,9,552,6,372,3,180,57403.907244,1.307738999996218,2275.6834506033747,1101.137153517762
"147.32.84.165",22421,"184.173.217.40",443,9,552,6,372,3,180,57406.210402,1.3077880000055302,2275.598185629028,1101.0958962721104
"147.32.84.165",22422,"184.173.217.40",443,9,552,6,372,3,180,57408.513599,1.307487999998557,2276.1203162119155,1101.3485401025396
"147.32.84.165",22423,"184.173.217.40",443,9,552,6,372,3,180,57410.817343,1.3071490000002086,2276.7106121792735,1101.6341671835194
"147.32.84.165",22424,"184.173.217.40",443,9,552,6,372,3,180,57413.120643,1.3074239999987185,2276.2317350782278,1101.4024524572071
"147.32.84.165",22425,"184.173.217.40",443,9,552,6,372,3,180,57415.423729,1.307844999995723,2275.4990079174004,1101.0479070568067
"147.32.84.165",22426,"184.173.217.40",443,9,552,6,372,3,180,57417.726788,1.3080990000016754,2275.0571631017133,1100.8341111782483
"147.32.84.165",22427,"184.173.217.40",443,9,552,6,372,3,180,57420.030415,1.3082159999976284,2274.853693889537,1100.735658333647
"147.32.84.165",22428,"74.125.39.27",25,6,372,6,372,0,0,57420.790987,9.013706999998249,330.1638271579693,0
"147.32.84.165",22429,"184.173.217.40",443,9,552,6,372,3,180,57422.333517,1.3081490000040503,2274.9702059863102,1100.792035154666
"147.32.84.165",22430,"184.173.217.40",443,9,552,6,372,3,180,57424.636681,1.3080879999979516,2275.076294564785,1100.8433683377991
"147.32.84.165",22431,"184.173.217.40",443,9,552,6,372,3,180,57426.93984,1.308432999998331,2274.476415684866,1100.5531043636447
"147.32.84.165",22432,"184.173.217.40",443,9,552,6,372,3,180,57429.243658,1.3076359999977285,2275.8627018567627,1101.2238879952076
"147.32.84.165",22433,"184.173.217.40",443,9,552,6,372,3,180,57431.546622,1.3077369999955408,2275.6869309426497,1101.138837552895
"147.32.84.165",22434,"184.173.217.40",443,9,552,6,372,3,180,57433.850448,1.3076580000051763,2275.8244127961743,1101.205361030407
"147.32.84.165",22435,"184.173.217.40",443,9,552,6,372,3,180,57436.153048,1.3078259999965667,2275.5320661982655,1101.0639029991607
"147.32.84.165",22436,"184.173.217.40",443,9,552,6,372,3,180,57438.457042,1.3076079999955255,2275.9114352391416,1101.2474686641008
"147.32.84.165",22437,"184.173.217.40",443,9,552,6,372,3,180,57440.760216,1.307874999998603,2275.446812580085,1101.0226512484282
"147.32.84.165",22438,"66.111.4.73",25,6,372,6,372,0,0,57441.821396,9.013191999998526,330.1826922138668,0
"147.32.84.165",22439,"184.173.217.40",443,9,552,6,372,3,180,57443.062949,1.3084539999981644,2274.4399115323695,1100.5354410640498
"147.32.84.165",22440,"184.173.217.40",443,9,552,6,372,3,180,57445.366786,1.3075640000024578,2275.9880204673777,1101.2845260326021
"147.32.84.165",22441,"184.173.217.40",443,9,552,6,372,3,180,57447.670137,1.3073670000012498,2276.3309766860834,1101.4504725900404
"147.32.84.165",22442,"184.173.217.40",443,9,552,6,372,3,180,57449.97334,1.3074610000039684,2276.167319706643,1101.371283729021
"147.32.84.165",22443,"184.173.217.40",443,9,552,6,372,3,180,57452.276742,1.3075529999987339,2276.0071675892923,1101.2937907690123
"147.32.84.165",22444,"184.173.217.40",443,9,552,6,372,3,180,57454.579938,1.3078759999989416,2275.4450727763247,1101.0218094078991
"147.32.84.165",22445,"184.173.217.40",443,9,552,6,372,3,180,57456.883273,1.3074300000007497,2276.2212890925657,1101.3973979480159
"147.32.84.165",22446,"184.173.217.40",443,9,552,6,372,3,180,57459.186824,1.3074300000007497,2276.2212890925657,1101.3973979480159
"147.32.84.165",22447,"184.173.217.40",443,9,552,6,372,3,180,57461.489954,1.3080150000023423,2275.2032660135174,1100.904806135573
"147.32.84.165",22448,"216.157.130.15",25,6,372,6,372,0,0,57462.75177,9.012649999996938,330.2025486400793,0
"147.32.84.165",22449,"184.173.217.40",443,9,552,6,372,3,180,57463.793031,1.3075479999970412,2276.0158709330244,1101.2980020643668
"147.32.84.165",22450,"184.173.217.40",443,9,552,6,372,3,180,57466.096795,1.3075020000032964,2276.0959447805794,1101.336747474474
"147.32.84.165",22451,"184.173.217.40",443,9,552,6,372,3,180,57468.399868,1.307982999998785,2275.25892920838,1100.9317399395386
"147.32.84.165",22452,"184.173.217.40",443,9,552,6,372,3,180,57470.703178,1.3072560000000522,2276.524261506454,1101.543997503123
"147.32.84.165",22453,"184.173.217.40",443,9,552,6,372,3,180,57473.006391,1.3076159999982337,2275.8975111990217,1101.240731225333
"147.32.84.165",22454,"184.173.217.40",443,9,552,6,372,3,180,57475.309757,1.3076959999962128,2275.7582802185057,1101.173361396051
"147.32.84.165",22455,"184.173.217.40",443,9,552,6,372,3,180,57477.612763,1.3083320000005187,2274.651999644448,1100.6380643440878
"147.32.84.165",22456,"184.173.217.40",443,9,552,6,372,3,180,57479.916361,1.3080859999972745,2275.0797730471854,1100.8450514744445
"147.32.84.165",22457,"184.173.217.40",443,9,552,6,372,3,180,57482.220023,1.307076999997662,2276.836024201576,1101.6948504201175
"147.32.84.165",22458,"184.173.217.40",443,9,552,6,372,3,180,57484.522713,1.3079910000014934,2275.2450131511623,1100.9250063634656
"147.32.84.165",22459,"184.173.217.40",443,9,552,6,372,3,180,57486.825975,1.308177999999316,2274.9197739157485,1100.7676325398784
"147.32.84.165",22460,"184.173.217.40",443,9,552,6,372,3,180,57489.12943,1.3078610000011395,2275.4711700994276,1101.0344371448841
"147.32.84.165",22461,"184.173.217.40",443,9,552,6,372,3,180,57491.432878,1.3077590000029886,2275.6486477961143,1101.1203134497327
"147.32.84.165",22462,"184.173.217.40",443,9,552,6,372,3,180,57493.736172,1.3077870000051917,2275.5999256669365,1101.096738225937
"147.32.84.165",22463,"184.173.217.40",443,9,552,6,372,3,180,57496.039482,1.3078089999980875,2275.5616454729643,1101.0782155514344
"147.32.84.165",22464,"184.173.217.40",443,9,552,6,372,3,180,57498.342796,1.3077240000056918,2275.7095533820952,1101.1497838945622
"147.32.84.165",22465,"184.173.217.40",443,9,552,6,372,3,180,57500.6458,1.307809999998426,2275.5599054935974,1101.0773736259341
"147.32.84.165",22466,"184.173.217.40",443,9,552,6,372,3,180,57502.949477,1.3080859999972745,2275.0797730471854,1100.8450514744445
"147.32.84.165",22467,"184.173.217.40",443,9,552,6,372,3,180,57505.25306,1.30747899999551,2276.1359838362373,1101.3561212110826
"147.32.84.165",22468,"184.173.217.40",443,9,552,6,372,3,180,57507.555821,1.3078849999947124,2275.4294146748616,1101.0142329071912
"147.32.84.165",22469,"184.173.217.40",443,9,552,6,372,3,180,57509.859542,1.3073540000041248,2276.353611944898,1101.4614251346281
"147.32.84.165",22470,"184.173.217.40",443,9,552,6,372,3,180,57512.162805,1.3072729999985313,2276.4946572011686,1101.5296728392752
"147.32.84.165",22471,"184.173.217.40",443,9,552,6,372,3,180,57514.466223,1.307580999993661,2275.958430119761,1101.270208122465
"147.32.84.165",22472,"184.173.217.40",443,9,552,6,372,3,180,57516.769055,1.3077069999999367,2275.7391372839206,1101.164098685768
"147.32.84.165",22473,"184.173.217.40",443,9,552,6,372,3,180,57519.072973,1.3075509999980568,2276.0106489187974,1101.295475283289
"147.32.84.165",22474,"184.173.217.40",443,9,552,6,372,3,180,57521.375969,1.3080399999962538,2275.1597810529674,1100.8837650256294
"147.32.84.165",22475,"173.192.170.88",80,26,3991,18,1526,8,2465,57521.713318,43.507746999996016,280.59370667943614,453.2526126899149
"147.32.84.165",22476,"173.192.170.88",80,32,5768,24,3212,8,2556,57523.079381,63.79624799999874,402.7823078247565,320.5204168119793
"147.32.84.165",22477,"184.173.217.40",443,9,552,6,372,3,180,57523.678857,1.308324999998149,2274.6641698386948,1100.6439531477556
"147.32.84.165",22478,"184.173.217.40",443,9,552,6,372,3,180,57525.98263,1.3073900000017602,2276.2909307826994,1101.4310955400158
"147.32.84.165",22479,"184.173.217.40",443,9,552,6,372,3,180,57528.286197,1.307329999996,2276.3954013210937,1101.4816458005293
"147.32.84.165",22481,"184.173.217.40",443,9,552,6,372,3,180,57530.588845,1.3081319999982952,2274.9997706683107,1100.8063406459567
"147.32.84.165",22482,"184.173.217.40",443,9,552,6,372,3,180,57532.892828,1.30739700000413,2276.278743174873,1101.4251983104223
"147.32.84.165",22483,"184.173.217.40",443,9,552,6,372,3,180,57535.196269,1.3072180000017397,2276.5904386231214,1101.576018688607
"147.32.84.165",22484,"184.173.217.40",443,9,552,6,372,3,180,57537.499143,1.3076749999963795,2275.7948267025367,1101.1910451786468
"147.32.84.165",22486,"98.126.71.122",80,18,4863,14,1430,4,3433,57538.977337,20.096582000005583,569.2510298515848,1366.6005492870563
"147.32.84.165",22487,"195.113.232.98",80,17,5674,12,2560,5,3114,57539.576132,19.498006999994686,1050.3637628197375,1277.6690458674464
"147.32.84.165",22488,"184.173.217.40",443,9,552,6,372,3,180,57539.793037,1.3105129999967176,2270.866446961956,1098.8063453041723
"147.32.84.165",22489,"195.113.232.83",80,13,1952,10,1580,3,372,57539.803451,19.27086799999961,655.9123335804207,154.4299924632383
"147.32.84.165",22490,"184.173.217.40",443,9,552,6,372,3,180,57542.103507,1.3093470000021625,2272.8886994777436,1099.784854586005
"147.32.84.165",22491,"184.173.217.40",443,9,552,6,372,3,180,57544.414035,1.306628999998793,2277.6166761971067,1102.0725852566645
"147.32.84.165",22492,"184.173.217.40",443,9,552,6,372,3,180,57546.720364,1.3078759999989416,2275.4450727763247,1101.0218094078991
"147.32.84.165",22493,"184.173.217.40",443,9,552,6,372,3,180,57549.028075,1.3072959999990417,2276.454605538594,1101.5102930025455
"147.32.84.165",22495,"184.173.217.40",443,9,552,6,372,3,180,57551.33573,1.3067040000023553,2277.485949376933,1102.0093303436772
"147.32.84.165",22496,"184.173.217.40",443,9,552,6,372,3,180,57553.644055,1.3081999999994878,2274.8815165885685,1100.7491209299524
"147.32.84.165",22497,"184.173.217.40",443,9,552,6,372,3,180,57555.952372,1.3067819999996573,2277.350009413032,1101.9435529417897
"147.32.84.165",22498,"184.173.217.40",443,9,552,6,372,3,180,57558.260076,1.319474000003538,2255.4442148856438,1091.3439749446663
"147.32.84.165",22500,"184.173.217.40",443,9,552,6,372,3,180,57560.574982,1.3004670000009355,2288.408702410641,1107.2945334245037
"147.32.84.165",22501,"98.126.71.122",80,18,4843,14,1410,4,3433,57560.676135,19.969678000001295,564.856378755795,1375.285069694074
"147.32.84.165",22502,"195.113.232.98",80,17,5851,12,2520,5,3331,57561.268996,19.377180000003136,1040.399067356382,1375.2259100651224
"147.32.84.165",22503,"195.113.232.83",80,13,2046,10,1674,3,372,57561.508243,19.138184000003093,699.7529128154393,155.50064729231985
"147.32.84.165",22504,"184.173.217.40",443,9,552,6,372,3,180,57562.875904,1.307520000002114,2276.064610862693,1101.321585901303
"147.32.84.165",22505,"173.192.170.88",80,18,2429,14,1930,4,499,57565.020724,34.24689599999692,450.84377865957214,116.56530857571322
"147.32.84.165",22506,"184.173.217.40",443,9,552,6,372,3,180,57565.184011,1.306627000005392,2277.6201624394103,1102.0742721481017
"147.32.84.165",22507,"184.173.217.40",443,9,552,6,372,3,180,57567.490003,1.3080960000006598,2275.06238074155,1100.8366358426856
"147.32.84.165",22508,"74.3.164.222",443,18,1860,14,1344,4,516,57569.414302,7.560748000003514,1422.0815189178377,545.9777260130984
"147.32.84.165",22509,"184.173.217.40",443,9,552,6,372,3,180,57569.79797,1.3078289999975823,2275.5268464038504,1101.0613772921859
"147.32.84.165",22510,"184.173.217.40",443,9,552,6,372,3,180,57572.105972,1.307027000002563,2276.9231240013896,1101.7369954845433
"147.32.84.165",22511,"184.173.217.40",443,9,552,6,372,3,180,57574.41338,1.3071009999985108,2276.794218658995,1101.6746219317715
"147.32.84.165",22512,"184.173.217.40",443,9,552,6,372,3,180,57576.721125,1.307745000005525,2275.6730096367614,1101.1321014371426
"147.32.84.165",22513,"184.173.217.40",443,9,552,6,372,3,180,57579.02957,1.3067440000013448,2277.41623454704,1101.975597361471
"147.32.84.165",22514,"184.173.217.40",443,9,552,6,372,3,180,57581.35616,1.2984979999964708,2291.878770708995,1108.973598730159
"147.32.84.165",22515,"184.173.217.40",443,9,552,6,372,3,180,57583.64996,1.3074369999958435,2276.2091022431377,1101.391501085389
"147.32.84.165",22516,"184.173.217.40",443,9,552,6,372,3,180,57585.952751,1.307743000004848,2275.6764899441005,1101.1337854568228
"147.32.84.165",22517,"173.192.170.88",80,23,2735,18,2174,5,561,57586.675048,37.118310000005295,468.5558151757857,120.91067723717377
"147.32.84.165",22518,"184.173.217.40",443,9,552,6,372,3,180,57588.25589,1.307673999996041,2275.7965670411813,1101.191887277991
"147.32.84.165",22519,"184.173.217.40",443,9,552,6,372,3,180,57590.559423,1.3074830000041402,2276.1290204083543,1101.352751810494
"147.32.84.165",22520,"184.173.217.40",443,9,552,6,372,3,180,57592.862772,1.3080429999972694,2275.1545629663647,1100.8812401450152
"147.32.84.165",22521,"184.173.217.40",443,9,552,6,372,3,180,57595.165896,1.3081979999988107,2274.884994475382,1100.7508037784105
"147.32.84.165",22522,"184.173.217.40",443,9,552,6,372,3,180,57597.46922,1.307860000000801,2275.472909943096,1101.0352790047239
"147.32.84.165",22523,"184.173.217.40",443,9,552,6,372,3,180,57599.772866,1.308071999999811,2275.1041227091705,1100.8568335689536
"147.32.84.165",22524,"184.173.217.40",443,9,552,6,372,3,180,57602.075789,1.308045999998285,2275.1493449036975,1100.8787152759826
"147.32.84.165",22525,"94.100.176.20",25,6,372,6,372,0,0,57604.13945,9.012172999995528,330.2200257364652,0
"147.32.84.165",22526,"184.173.217.40",443,9,552,6,372,3,180,57604.379165,1.307782000003499,2275.6086258963937,1101.1009480143841
"147.32.84.165",22527,"184.173.217.40",443,9,552,6,372,3,180,57606.682634,1.3075940000053379,2275.935802693995,1101.259259368062
"147.32.84.165",22528,"184.173.217.40",443,9,552,6,372,3,180,57608.985765,1.3082660000000033,2274.7667523271207,1100.6935898357035
"147.32.84.165",22529,"184.173.217.40",443,9,552,6,372,3,180,57611.289133,1.3077010000051814,2275.7495788320175,1101.1691510477506
"147.32.84.165",22530,"184.173.217.40",443,9,552,6,372,3,180,57613.593827,1.3065840000053868,2277.6951194777607,1102.1105416827875
"147.32.84.165",22531,"94.63.150.63",80,24,9948,16,1568,8,8380,57614.087326,0.7787820000012289,16107.203299485871,86083.14008271148
"147.32.84.165",22532,"184.173.217.40",443,9,552,6,372,3,180,57615.895719,1.3078420000019833,2275.50422757144,1101.050432695858
"147.32.84.165",22533,"184.173.217.40",443,9,552,6,372,3,180,57618.199347,1.307792999999947,2275.5894854920625,1101.0916865284173
"147.32.84.165",22534,"184.173.217.40",443,9,552,6,372,3,180,57620.502561,1.3079260000013164,2275.358086005634,1100.979719034984
"147.32.84.165",22535,"184.173.217.40",443,9,552,6,372,3,180,57622.806111,1.3073100000037812,2276.4302269480017,1101.4984969103236
"147.32.84.165",22536,"74.125.93.27",25,6,372,6,372,0,0,57625.068846,9.012778999996954,330.19782244754987,0
"147.32.84.165",22537,"184.173.217.40",443,9,552,6,372,3,180,57625.108986,1.307823000002827,2275.5372860039674,1101.0664287115972
"147.32.84.165",22538,"184.173.217.40",443,9,552,6,372,3,180,57627.41258,1.3072900000042864,2276.465053653162,1101.5153485418525
"147.32.84.165",22539,"184.173.217.40",443,9,552,6,372,3,180,57629.715437,1.3083390000028885,2274.6398295804297,1100.6321756034338
"147.32.84.165",22540,"184.173.217.40",443,9,552,6,372,3,180,57632.019069,1.308043999997608,2275.1528236094828,1100.8803985207176
"147.32.84.165",22541,"184.173.217.40",443,9,552,6,372,3,180,57634.321994,1.3079060000018217,2275.3928799132773,1100.9965547967472
"147.32.84.165",22542,"184.173.217.40",443,9,552,6,372,3,180,57636.626095,1.3076450000007753,2275.847037994437,1101.2163087069855
"147.32.84.165",22543,"184.173.217.40",443,9,552,6,372,3,180,57638.929039,1.307433999994828,2276.2143251680563,1101.394028307124
"147.32.84.165",22544,"184.173.217.40",443,9,552,6,372,3,180,57641.23205,1.3080380000028526,2275.163259778011,1100.8854482796826
"147.32.84.165",22545,"184.173.217.40",443,9,552,6,372,3,180,57643.536066,1.3074449999985518,2276.1951745605334,1101.384761884129
"147.32.84.165",22546,"184.173.217.40",443,9,552,6,372,3,180,57645.839137,1.30757199999789,2275.9740955028115,1101.2777881465217
"147.32.84.165",22547,"74.125.39.27",25,6,372,6,372,0,0,57646.099408,9.012954999998328,330.19137452706155,0
"147.32.84.165",22548,"184.173.217.40",443,9,552,6,372,3,180,57648.142673,1.3070709999956307,2276.846475830271,1101.6999076598086
"147.32.84.165",22549,"184.173.217.40",443,9,552,6,372,3,180,57650.445865,1.3075559999997495,2276.0019456150026,1101.2912640072593
"147.32.84.165",22550,"184.173.217.40",443,9,552,6,372,3,180,57652.74909,1.3073740000036196,2276.3187886494306,1101.4445751529504
"147.32.84.165",22551,"184.173.217.40",443,9,552,6,372,3,180,57655.05221,1.3073509999958333,2276.3588355456836,1101.4639526833953
"147.32.84.165",22552,"184.173.217.40",443,9,552,6,372,3,180,57657.355813,1.3070979999974952,2276.799444269445,1101.6771504529572
"147.32.84.165",22553,"184.173.217.40",443,9,552,6,372,3,180,57659.658936,1.30855000000156,2274.273050320165,1100.454701767822
"147.32.84.165",22554,"184.173.217.40",443,9,552,6,372,3,180,57661.962324,1.307780000002822,2275.6121060068044,1101.1026319387763
"147.32.84.165",22555,"184.173.217.40",443,9,552,6,372,3,180,57664.265422,1.307689000001119,2275.7704622409865,1101.179255923058
"147.32.84.165",22556,"184.173.217.40",443,9,552,6,372,3,180,57666.568425,1.308102000002691,2275.051945485809,1100.8315865253915
"147.32.84.165",22557,"66.111.4.73",25,6,372,6,372,0,0,57667.12957,9.012462000006053,330.2094366664737,0
"147.32.84.165",22558,"184.173.217.40",443,9,552,6,372,3,180,57668.87206,1.307703999998921,2275.744358052323,1101.1666248640274
"147.32.84.165",22559,"184.173.217.40",443,9,552,6,372,3,180,57671.175564,1.3076209999999264,2275.8888087604646,1101.2365203679667
"147.32.84.165",22560,"184.173.217.40",443,9,552,6,372,3,180,57673.478303,1.308084999996936,2275.0815122923746,1100.8458930446975
"147.32.84.165",22561,"184.173.217.40",443,9,552,6,372,3,180,57675.781926,1.3075089999983902,2276.083759273293,1101.3308512612707
"147.32.84.165",22562,"184.173.217.40",443,9,552,6,372,3,180,57678.085103,1.3079540000035195,2275.3093763175098,1100.9561498310532
"147.32.84.165",22563,"184.173.217.40",443,9,552,6,372,3,180,57680.388683,1.4078880000015488,2113.804507174382,1022.8086325037332
"147.32.84.165",22564,"184.173.217.40",443,9,552,6,372,3,180,57682.792064,1.3076969999965513,2275.756539938417,1101.1725193250406
"147.32.84.165",22565,"184.173.217.40",443,9,552,6,372,3,180,57685.095813,1.306907999998657,2277.1304483583067,1101.8373137217613
"147.32.84.165",22566,"184.173.217.40",443,9,552,6,372,3,180,57687.398432,1.3080159999954049,2275.2015265948235,1100.9039644813663
"147.32.84.165",22567,"216.157.130.15",25,6,372,6,372,0,0,57688.059706,9.013013000003411,330.18924969917094,0
"147.32.84.165",22568,"184.173.217.40",443,9,552,6,372,3,180,57689.7017,1.3084650000018883,2274.42079077064,1100.5261890825677
"147.32.84.165",22569,"184.173.217.40",443,9,552,6,372,3,180,57692.005126,1.30763900000602,2275.8574805327,1101.2213615480805
"147.32.84.165",22570,"184.173.217.40",443,9,552,6,372,3,180,57694.308304,1.307660999998916,2275.8191916731225,1101.2028346805432
"147.32.84.165",22571,"184.173.217.40",443,9,552,6,372,3,180,57696.612289,1.307053000004089,2276.8778312667428,1101.715079645198
"147.32.84.165",22572,"184.173.217.40",443,9,552,6,372,3,180,57698.915113,1.307619999999588,2275.8905492428516,1101.2373625368639
"147.32.84.165",22573,"184.173.217.40",443,9,552,6,372,3,180,57701.218184,1.3084359999993467,2274.4712007323906,1100.5505809995439
"147.32.84.165",22574,"184.173.217.40",443,9,552,6,372,3,180,57703.522258,1.3072660000034375,2276.506847108526,1101.5355711815448
"147.32.84.165",22575,"184.173.217.40",443,9,552,6,372,3,180,57705.825301,1.3073250000015832,2276.4041076215904,1101.485858526576
"147.32.84.165",22576,"184.173.217.40",443,9,552,6,372,3,180,57708.128657,1.3073420000000624,2276.374506441205,1101.4715353747767
"147.32.84.165",22577,"184.173.217.40",443,9,552,6,372,3,180,57710.432037,1.3076300000029732,2275.873144538771,1101.228940905857
"147.32.84.165",22578,"184.173.217.40",443,9,552,6,372,3,180,57712.735385,1.307461999997031,2276.1655788135777,1101.3704413614087
"147.32.84.165",22579,"184.173.217.40",443,9,552,6,372,3,180,57715.038784,1.307347000001755,2276.365800354462,1101.4673227521591
"147.32.84.165",22580,"184.173.217.40",443,9,552,6,372,3,180,57717.342084,1.3074399999968591,2276.203879342187,1101.3889738752518
"147.32.84.165",22581,"184.173.217.40",443,9,552,6,372,3,180,57719.644725,1.3079260000013164,2275.358086005634,1100.979719034984
"147.32.84.165",22582,"184.173.217.40",443,9,552,6,372,3,180,57721.948178,1.3077499999999418,2275.6643089276486,1101.1278914166041
"147.32.84.165",22583,"184.173.217.40",443,9,552,6,372,3,180,57724.251665,1.3078159999931813,2275.5494656859346,1101.0723221060973
"147.32.84.165",22584,"184.173.217.40",443,9,552,6,372,3,180,57726.554757,1.3080880000052275,2275.07629455213,1100.843368331676
"147.32.84.165",22585,"184.173.217.40",443,9,552,6,372,3,180,57728.858319,1.3082520000025397,2274.791095289151,1100.705368688299
"147.32.84.165",22586,"184.173.217.40",443,9,552,6,372,3,180,57731.161746,1.307280000000901,2276.482467411686,1101.5237745540417
"147.32.84.165",22587,"184.173.217.40",443,9,552,6,372,3,180,57733.464948,1.3073490000024321,2276.362317938411,1101.4656377121344
"147.32.84.165",22588,"184.173.217.40",443,9,552,6,372,3,180,57735.767867,1.3083409999962896,2274.6363524558506,1100.6304931237985
"147.32.84.165",22589,"184.173.217.40",443,9,552,6,372,3,180,57738.071171,1.3083449999976438,2274.6293982132843,1100.6271281677182
"147.32.84.165",22590,"184.173.217.40",443,9,552,6,372,3,180,57740.374559,1.308071999999811,2275.1041227091705,1100.8568335689536
"147.32.84.165",22591,"184.173.217.40",443,9,552,6,372,3,180,57742.67835,1.3072749999992084,2276.491174390853,1101.5279876084771
"147.32.84.165",22592,"184.173.217.40",443,9,552,6,372,3,180,57744.981594,1.3076470000014524,2275.8435571654236,1101.2146244348824
"147.32.84.165",22593,"184.173.217.40",443,9,552,6,372,3,180,57747.284583,1.3080140000020037,2275.2050054475267,1100.9056477971903
"147.32.84.165",22594,"184.173.217.40",443,9,552,6,372,3,180,57749.587785,1.3079469999938738,2275.3215535598456,1100.9620420450865
"147.32.84.165",22595,"184.173.217.40",443,9,552,6,372,3,180,57751.891206,1.30787699999928,2275.4433329752246,1101.0209675686572
"147.32.84.165",22596,"184.173.217.40",443,9,552,6,372,3,180,57754.194541,1.3076670000009472,2275.808749473562,1101.1977820033364
"147.32.84.165",22597,"184.173.217.40",443,9,552,6,372,3,180,57756.497944,1.3077359999952023,2275.688671116279,1101.139679572393
"147.32.84.165",22598,"184.173.217.40",443,9,552,6,372,3,180,57758.801222,1.3081079999974463,2275.0415103384503,1100.8265372605406
"147.32.84.165",22599,"184.173.217.40",443,9,552,6,372,3,180,57761.104369,1.307768999999098,2275.6312468043307,1101.1118936149987
"147.32.84.165",22600,"184.173.217.40",443,9,552,6,372,3,180,57763.408242,1.3075660000031348,2275.9845392070956,1101.2828415518204
"147.32.84.165",22601,"184.173.217.40",443,9,552,6,372,3,180,57765.711676,1.3074990000022808,2276.1011671862148,1101.3392744449427
"147.32.84.165",22602,"184.173.217.40",443,9,552,6,372,3,180,57768.014783,1.3076809999984107,2275.784384726563,1101.1859926096274
"147.32.84.165",22603,"184.173.217.40",443,9,552,6,372,3,180,57770.318202,1.3078219999952125,2275.5390259614032,1101.0672706264854
"147.32.84.165",22604,"184.173.217.40",443,9,552,6,372,3,180,57772.621196,1.3094300000011572,2272.74462934053,1099.7151432292887
"147.32.84.165",22605,"184.173.217.40",443,9,552,6,372,3,180,57774.924435,1.308110999998462,2275.0362927943415,1100.8240126424234
"147.32.84.165",22606,"184.173.217.40",443,9,552,6,372,3,180,57777.227845,1.3075649999955203,2275.98627984857,1101.2836837976952
"147.32.84.165",22607,"184.173.217.40",443,9,552,6,372,3,180,57779.531372,1.3074000000051456,2276.273519954327,1101.4226709456423
"147.32.84.165",22608,"184.173.217.40",443,9,552,6,372,3,180,57781.834619,1.3076519999958691,2275.8348551521362,1101.2104137832916
"147.32.84.165",22609,"184.173.217.40",443,9,552,6,372,3,180,57784.13759,1.3079470000011497,2275.321553547188,1100.962042038962
"147.32.84.165",22610,"184.173.217.40",443,9,552,6,372,3,180,57786.441283,1.3077649999977439,2275.6382071741746,1101.1152615358908
"147.32.84.165",22611,"184.173.217.40",443,9,552,6,372,3,180,57788.744498,1.307968000000983,2275.2850222618317,1100.9443656105636
"147.32.84.165",22612,"184.173.217.40",443,9,552,6,372,3,180,57791.048187,1.3070299999963026,2276.917897835871,1101.7344666947763
"147.32.84.165",22613,"184.173.217.40",443,9,552,6,372,3,180,57793.350696,1.308086999997613,2275.0780338046557,1100.8442099054785
"147.32.84.165",22614,"184.173.217.40",443,9,552,6,372,3,180,57795.654396,1.3078910000040196,2275.418976039176,1101.00918195444
"147.32.84.165",22615,"184.173.217.40",443,9,552,6,372,3,180,57797.957877,1.3074859999978798,2276.123797887569,1101.3502247843076
"147.32.84.165",22616,"184.173.217.40",443,9,552,6,372,3,180,57800.260654,1.3084270000035758,2274.4868456489103,1100.5581511204405
"147.32.84.165",22617,"184.173.217.40",443,9,552,6,372,3,180,57802.564454,1.308021999997436,2275.191090062578,1100.8989145464088
"147.32.84.165",22618,"184.173.217.40",443,9,552,6,372,3,180,57804.867727,1.307358000005479,2276.3466471980346,1101.458055095823
"147.32.84.165",22619,"184.173.217.40",443,9,552,6,372,3,180,57807.171105,1.3079710000019986,2275.2798036007316,1100.941840451967
"147.32.84.165",22620,"184.173.217.40",443,9,552,6,372,3,180,57809.474063,1.30820799999492,2274.867605160308,1100.7423895936975
"147.32.84.165",22621,"184.173.217.40",443,9,552,6,372,3,180,57811.777185,1.3082609999983106,2274.7754461868412,1100.69779654202
"147.32.84.165",22622,"184.173.217.40",443,9,552,6,372,3,180,57814.080445,1.3083520000000135,2274.617228391113,1100.6212395440868
"147.32.84.165",22623,"184.173.217.40",443,9,552,6,372,3,180,57816.384379,1.3076149999978952,2275.899251694719,1101.2415734006706
"147.32.84.165",22624,"184.173.217.40",443,9,552,6,372,3,180,57818.687725,1.3071239999990212,2276.7541564551093,1101.655236994408
"147.32.84.165",22625,"184.173.217.40",443,9,552,6,372,3,180,57820.990409,1.2078509999992093,2463.880064678465,1192.2000312960313
"147.32.84.165",22626,"173.192.170.88",80,6,372,6,372,0,0,57821.747109,8.81764899999689,337.5049290350579,0
"147.32.84.165",22627,"184.173.217.40",443,9,552,6,372,3,180,57823.194177,1.3074320000014268,2276.2178071186513,1101.3957131219279
"147.32.84.165",22628,"184.173.217.40",443,9,552,6,372,3,180,57825.496983,1.3084000000017113,2274.533781715154,1100.580862120236
"147.32.84.165",22629,"184.173.217.40",443,9,552,6,372,3,180,57827.800906,1.3076040000014473,2275.918397310429,1101.250837408272
"147.32.84.165",22630,"94.100.176.20",25,6,372,6,372,0,0,57829.268396,9.00713800000085,330.4046190920711,0
"147.32.84.165",22631,"184.173.217.40",443,9,552,6,372,3,180,57830.103742,1.307463999997708,2276.1620970101026,1101.3687566177916
"147.32.84.165",22632,"184.173.217.40",443,9,552,6,372,3,180,57832.406945,1.3080129999943892,2275.2067448968514,1100.9064894662185
"147.32.84.165",22633,"184.173.217.40",443,9,552,6,372,3,180,57834.710185,1.3079219999999623,2275.3650447045666,1100.9830861473708
"147.32.84.165",22634,"184.173.217.40",443,9,552,6,372,3,180,57837.013886,1.4077019999967888,2114.0838046737085,1022.9437764550203
"147.32.84.165",22635,"184.173.217.40",443,9,552,6,372,3,180,57839.417464,1.307860000000801,2275.472909943096,1101.0352790047239
"147.32.84.165",22636,"184.173.217.40",443,9,552,6,372,3,180,57841.720635,1.3078290000048582,2275.526846391191,1101.0613772860602
"147.32.84.165",22637,"173.192.170.88",80,25,4189,18,1526,7,2663,57843.669841,75.87004099999467,160.90672733392694,280.7959468481307
"147.32.84.165",22638,"184.173.217.40",443,9,552,6,372,3,180,57844.024155,1.3078289999975823,2275.5268464038504,1101.0613772921859
"147.32.84.165",22639,"184.173.217.40",443,9,552,6,372,3,180,57846.327476,1.3072089999986929,2276.606112720289,1101.583602929172
"147.32.84.165",22640,"184.173.217.40",443,9,552,6,372,3,180,57848.630773,1.3076270000019576,2275.878365922044,1101.2314673816343
"147.32.84.165",22641,"74.125.93.27",25,6,372,6,372,0,0,57850.293297,9.012405000001309,330.2115251145025,0
"147.32.84.165",22642,"184.173.217.40",443,9,552,6,372,3,180,57850.933516,1.3084250000028987,2274.490322329065,1100.5598333850314
"147.32.84.165",22644,"184.173.217.40",443,9,552,6,372,3,180,57853.237381,1.3072560000000522,2276.524261506454,1101.543997503123
"147.32.84.165",22645,"184.173.217.40",443,9,552,6,372,3,180,57855.540384,1.3076230000006035,2275.8853278036763,1101.2348360340368
"147.32.84.165",22646,"184.173.217.40",443,9,552,6,372,3,180,57857.843761,1.307981000005384,2275.262408236626,1100.9334233403029
"147.32.84.165",22647,"184.173.217.40",443,9,552,6,372,3,180,57860.146834,1.3078279999972438,2275.5285863326612,1101.0622191932232
"147.32.84.165",22649,"98.126.71.122",80,18,4967,14,1534,4,3433,57861.969529,19.96888599999511,614.556064870269,1375.3396158406997
"147.32.84.165",22650,"184.173.217.40",443,9,552,6,372,3,180,57862.450191,1.3006729999979143,2288.046265283259,1107.1191606209318
"147.32.84.165",22651,"95.100.248.96",80,17,6191,12,2768,5,3423,57862.554192,19.384441999995033,1142.3594241199037,1412.6793022985657
"147.32.84.165",22652,"195.113.232.99",80,24,13710,18,2290,6,11420,57862.787497,19.151318000003812,956.5921259307769,4770.428855078372
"147.32.84.165",22653,"173.192.170.88",80,32,6119,24,3654,8,2465,57864.742713,86.97297699999763,336.10439711636866,226.7370932927884
"147.32.84.165",22654,"184.173.217.40",443,9,552,6,372,3,180,57864.751677,1.3066649999964284,2277.553925457661,1102.0422219956424
"147.32.84.165",22655,"184.173.217.40",443,9,552,6,372,3,180,57867.058053,1.3082240000003367,2274.839782788906,1100.7289271559223
"147.32.84.165",22656,"184.173.217.40",443,9,552,6,372,3,180,57869.366504,1.306484000000637,2277.8694572597515,1102.1948986740733
"147.32.84.165",22657,"74.125.39.27",25,6,372,6,372,0,0,57871.329585,8.929149000003235,333.29044010788954,0
"147.32.84.165",22658,"184.173.217.40",443,9,552,6,372,3,180,57871.67375,1.3068849999981467,2277.170523806012,1101.8567050674253
"147.32.84.165",22659,"184.173.217.40",443,9,552,6,372,3,180,57873.980949,1.3069870000035735,2276.9928086445107,1101.770713860247
"147.32.84.165",22660,"184.173.217.40",443,9,552,6,372,3,180,57876.288347,1.3067539999974542,2277.3988065127774,1101.9671644416665
"147.32.84.165",22661,"184.173.217.40",443,9,552,6,372,3,180,57878.595922,1.3081139999994775,2275.031075274165,1100.8214880358862
"147.32.84.165",22662,"184.173.217.40",443,9,552,6,372,3,180,57880.904277,1.3204819999955362,2253.7225043658755,1090.5108892092946
"147.32.84.165",22663,"184.173.217.40",443,9,552,6,372,3,180,57883.220686,1.30763499999739,2275.8644422992197,1101.2247301447837
"147.32.84.165",22664,"184.173.217.40",443,9,552,6,372,3,180,57885.523384,1.3080269999991287,2275.1823930255127,1100.8947063026674
"147.32.84.165",22665,"184.173.217.40",443,9,552,6,372,3,180,57887.826736,1.30820799999492,2274.867605160308,1100.7423895936975
"147.32.84.165",22666,"173.192.170.88",80,23,3093,18,2532,5,561,57888.949608,30.59176699999807,662.1389343087399,146.70613828878479
"147.32.84.165",22667,"184.173.217.40",443,9,552,6,372,3,180,57890.130251,1.3074699999997392,2276.1516516635897,1101.3637024178659
"147.32.84.165",22668,"66.111.4.72",25,6,372,6,372,0,0,57892.293428,9.012519000003522,330.20734824512846,0
"147.32.84.165",22669,"184.173.217.40",443,9,552,6,372,3,180,57892.433143,1.308310000000347,2274.69024925225,1100.6565722188304
"147.32.84.165",22670,"184.173.217.40",443,9,552,6,372,3,180,57894.736889,1.30745300000126,2276.1812470483696,1101.3780227653401
"147.32.84.165",22671,"184.173.217.40",443,9,552,6,372,3,180,57897.040351,1.3078539999987697,2275.4833490609803,1101.040330190797
"147.32.84.165",22672,"184.173.217.40",443,9,552,6,372,3,180,57899.343512,1.3074909999995725,2276.1150937184066,1101.3460130895514
"147.32.84.165",22673,"184.173.217.40",443,9,552,6,372,3,180,57901.646704,1.3077229999980773,2275.7112936029844,1101.150625936928
"147.32.84.165",22674,"184.173.217.40",443,9,552,6,372,3,180,57903.949688,1.3079579999975977,2275.3024179717286,1100.9527828895461
"147.32.84.165",22675,"184.173.217.40",443,9,552,6,372,3,180,57906.253305,1.3081989999991492,2274.883255530646,1100.7499623535384
"147.32.84.165",22676,"184.173.217.40",443,9,552,6,372,3,180,57908.556609,1.308432999998331,2274.476415684866,1100.5531043636447
"147.32.84.165",22677,"184.173.217.40",443,9,552,6,372,3,180,57910.86,1.3080289999998058,2275.1789142293037,1100.893023014179
"147.32.84.165",22678,"184.173.217.40",443,9,552,6,372,3,180,57913.162956,1.3080009999976028,2275.227618331679,1100.9165895153285
"147.32.84.165",22679,"216.157.130.15",25,6,372,6,372,0,0,57913.323368,9.012713000003714,330.2002404823912,0
"147.32.84.165",22681,"184.173.217.40",443,9,552,6,372,3,180,57915.466286,1.3081689999962691,2274.9354250165593,1100.775205653174
"147.32.84.165",22682,"184.173.217.40",443,9,552,6,372,3,180,57917.769783,1.3077599999960512,2275.646907696356,1101.1194714659784
"147.32.84.165",22683,"184.173.217.40",443,9,552,6,372,3,180,57920.073138,1.3080560000016703,2275.131951534338,1100.8702991295183
"147.32.84.165",22684,"184.173.217.40",443,9,552,6,372,3,180,57922.376314,1.3101929999975255,2271.4210807153,1099.0747164751451
"147.32.84.165",22686,"98.126.71.122",80,18,4863,14,1430,4,3433,57924.194439,20.10001800000464,569.1537191656923,1366.3669355914838
"147.32.84.165",22687,"184.173.217.40",443,9,552,6,372,3,180,57924.679976,1.3026959999988321,2284.4930820411423,1105.3998784070043
"147.32.84.165",22688,"95.100.248.97",80,21,7798,14,3870,7,3928,57924.904422,19.39025699999911,1596.6781667721796,1620.607710356879
"147.32.84.165",22689,"195.113.232.89",80,16,3824,12,1900,4,1924,57925.031088,19.26377499999944,789.0457607608291,799.0126545809659
"147.32.84.165",22690,"195.113.232.99",80,51,40444,42,3628,9,36816,57925.276725,19.01831599999423,1526.107779469476,15486.544655167649
"147.32.84.165",22691,"184.173.217.40",443,9,552,6,372,3,180,57926.983234,1.3077499999999418,2275.6643089276486,1101.1278914166041
"147.32.84.165",22692,"184.173.217.40",443,9,552,6,372,3,180,57929.29218,1.308232000003045,2274.8258718584116,1100.7221960605216
"147.32.84.165",22693,"184.173.217.40",443,9,552,6,372,3,180,57931.600729,1.3081559999991441,2274.958032529719,1100.7861447724447
"147.32.84.165",22694,"184.173.217.40",443,9,552,6,372,3,180,57933.909516,1.306758999999147,2277.3900925893317,1101.962948027096
"147.32.84.165",22695,"184.173.217.40",443,9,552,6,372,3,180,57936.216688,1.3080289999998058,2275.1789142293037,1100.893023014179
"147.32.84.165",22696,"184.173.217.40",443,9,552,6,372,3,180,57938.524925,1.3070340000049328,2276.910929622924,1101.731094978834
"147.32.84.165",22697,"184.173.217.40",443,9,552,6,372,3,180,57940.832579,1.3062959999952,2278.1972845441887,1102.3535247794462
"147.32.84.165",22698,"184.173.217.40",443,9,552,6,372,3,180,57943.139768,1.3205309999975725,2253.638877092223,1090.470424399463
"147.32.84.165",22699,"184.173.217.40",443,9,552,6,372,3,180,57945.45556,1.3082819999981439,2274.7389324352257,1100.6801285976899
"147.32.84.165",22700,"184.173.217.40",443,9,552,6,372,3,180,57947.758914,1.307898999999452,2275.4050580367802,1101.002447437152
"147.32.84.165",22701,"184.173.217.40",443,9,552,6,372,3,180,57950.062429,1.3075230000031297,2276.0593886248093,1101.3190590120046
"147.32.84.165",22702,"173.192.170.88",80,6,372,6,372,0,0,57951.515135,8.922473999999056,333.53977831712535,0
"147.32.84.165",22703,"184.173.217.40",443,9,552,6,372,3,180,57952.366082,1.3078259999965667,2275.5320661982655,1101.0639029991607
"147.32.84.165",22704,"184.173.217.40",443,9,552,6,372,3,180,57954.669159,1.308128000004217,2275.006727163096,1100.8097066918206
"147.32.84.165",22705,"184.173.217.40",443,9,552,6,372,3,180,57956.972137,1.3085860000064713,2274.2104836711405,1100.4244275828098
"147.32.84.165",22706,"184.173.217.40",443,9,552,6,372,3,180,57959.275714,1.3079749999960768,2275.2728454358275,1100.938473597981
"147.32.84.165",22707,"184.173.217.40",443,9,552,6,372,3,180,57961.579356,1.30747899999551,2276.1359838362373,1101.3561212110826
"147.32.84.165",22708,"184.173.217.40",443,9,552,6,372,3,180,57963.882107,1.3077059999995981,2275.7408775373933,1101.1649407439
"147.32.84.165",22709,"184.173.217.40",443,9,552,6,372,3,180,57966.185644,1.3076409999994212,2275.8539996844065,1101.2196772666484
"147.32.84.165",22710,"184.173.217.40",443,9,552,6,372,3,180,57968.488665,1.3084510000044247,2274.445126328717,1100.537964352605
"147.32.84.165",22711,"184.173.217.40",443,9,552,6,372,3,180,57970.79253,1.3077649999977439,2275.6382071741746,1101.1152615358908
"147.32.84.165",22712,"173.192.170.88",80,23,2735,18,2174,5,561,57972.455294,38.63991299999907,450.1045331028675,116.14932983933241
"147.32.84.165",22713,"184.173.217.40",443,9,552,6,372,3,180,57973.095546,1.3076400000063586,2275.8557401008907,1101.220519403657
"147.32.84.165",22714,"184.173.217.40",443,9,552,6,372,3,180,57975.399079,1.3077899999989313,2275.594705573855,1101.094212374446
"147.32.84.165",22715,"184.173.217.40",443,9,552,6,372,3,180,57977.702494,1.3073890000014217,2276.2926718801855,1101.4319380065415
"147.32.84.165",22716,"184.173.217.40",443,9,552,6,372,3,180,57980.005228,1.3076129999972181,2275.902732694101,1101.2432577552102
"147.32.84.165",22717,"184.173.217.40",443,9,552,6,372,3,180,57982.308528,1.3086399999956484,2274.1166401836226,1100.3790194436883
"147.32.84.165",22718,"184.173.217.40",443,9,552,6,372,3,180,57984.612368,1.4078329999974812,2113.887087463729,1022.8485907082561
"147.32.84.165",22719,"184.173.217.40",443,9,552,6,372,3,180,57987.015767,1.3075349999999162,2276.038499925578,1101.3089515768927
"147.32.84.165",22720,"184.173.217.40",443,9,552,6,372,3,180,57989.318676,1.3081610000008368,2274.949337274308,1100.7819373907944
"147.32.84.165",22721,"184.173.217.40",443,9,552,6,372,3,180,57991.622137,1.3075099999987287,2276.0820184953795,1101.330008949377
"147.32.84.165",22722,"184.173.217.40",443,9,552,6,372,3,180,57993.92547,1.3078049999967334,2275.568605417041,1101.0815832663102
"147.32.84.165",22723,"184.173.217.40",443,9,552,6,372,3,180,57996.228737,1.3080289999998058,2275.1789142293037,1100.893023014179
"147.32.84.165",22724,"184.173.217.40",443,9,552,6,372,3,180,57998.53233,1.3071930000005523,2276.6339783021654,1101.5970862752413
"147.32.84.165",22725,"184.173.217.40",443,9,552,6,372,3,180,58000.835034,1.3083289999995031,2274.657215426036,1100.6405881093722
"147.32.84.165",22726,"184.173.217.40",443,9,552,6,372,3,180,58003.138524,1.308458999999857,2274.431220237184,1100.5312355986373
"147.32.84.165",22727,"184.173.217.40",443,9,552,6,372,3,180,58005.441744,1.3083459999979823,2274.627659659287,1100.626286931913
"147.32.84.165",22728,"184.173.217.40",443,9,552,6,372,3,180,58007.745406,1.307944000000134,2275.3267723998083,1100.9645672902298
"147.32.84.165",22729,"184.173.217.40",443,9,552,6,372,3,180,58010.048629,1.3081420000016806,2274.9823795858374,1100.7979256060505
"147.32.84.165",22730,"184.173.217.40",443,9,552,6,372,3,180,58012.351688,1.3077379999958794,2275.6851907716814,1101.1379955346847
"147.32.84.165",22731,"184.173.217.40",443,9,552,6,372,3,180,58014.655308,1.3075129999997444,2276.076796177615,1101.3274820214267
"147.32.84.165",22732,"184.173.217.40",443,9,552,6,372,3,180,58016.958321,1.307703999998921,2275.744358052323,1101.1666248640274
"147.32.84.165",22733,"184.173.217.40",443,9,552,6,372,3,180,58019.262405,1.3077120000016293,2275.7304360564804,1101.159888414426
"147.32.84.165",22734,"184.173.217.40",443,9,552,6,372,3,180,58021.565211,1.3081059999967692,2275.044988714485,1100.8282203457186
"147.32.84.165",22735,"184.173.217.40",443,9,552,6,372,3,180,58023.868223,1.3084190000008675,2274.5007524333005,1100.5648802096616
"147.32.84.165",22736,"184.173.217.40",443,9,552,6,372,3,180,58026.171801,1.3079590000052121,2275.3006783761116,1100.9519411497315
"147.32.84.165",22737,"184.173.217.40",443,9,552,6,372,3,180,58028.474954,1.3080100000006496,2275.2119632101603,1100.9090144565293
"147.32.84.165",22738,"184.173.217.40",443,9,552,6,372,3,180,58030.778686,1.3074110000015935,2276.254368363409,1101.4134040468107
"147.32.84.165",22739,"184.173.217.40",443,9,552,6,372,3,180,58033.081462,1.308499999999185,2274.359954147385,1100.4967520067992
"147.32.84.165",22740,"184.173.217.40",443,9,552,6,372,3,180,58035.384865,1.3078709999972489,2275.4537718217316,1101.0260186234186
"147.32.84.165",22741,"184.173.217.40",443,9,552,6,372,3,180,58037.68849,1.3073240000012447,2276.4058488922155,1101.4867010768785
"147.32.84.165",22742,"184.173.217.40",443,9,552,6,372,3,180,58039.991691,1.3076839999994263,2275.7791637745095,1101.1834663425045
"147.32.84.165",22743,"184.173.217.40",443,9,552,6,372,3,180,58042.294852,1.307929000002332,2275.3528670093665,1100.9771937142095
"147.32.84.165",22744,"184.173.217.40",443,9,552,6,372,3,180,58044.598594,1.3080379999955767,2275.1632597906664,1100.8854482858064
"147.32.84.165",22745,"184.173.217.40",443,9,552,6,372,3,180,58046.901888,1.307754000001296,2275.657348398132,1101.124523418451
"147.32.84.165",22746,"184.173.217.40",443,9,552,6,372,3,180,58049.205087,1.3077349999948638,2275.6904112925695,1101.1405215931788
"147.32.84.165",22747,"184.173.217.40",443,9,552,6,372,3,180,58051.508423,1.307373000003281,2276.3205297895333,1101.4454176400966
"147.32.84.165",22748,"184.173.217.40",443,9,552,6,372,3,180,58053.811426,1.307691000001796,2275.766981646209,1101.1775717642947
"147.32.84.165",22749,"94.100.176.20",25,6,372,6,372,0,0,58054.465928,8.919342000001052,333.6568998026591,0
"147.32.84.165",22750,"184.173.217.40",443,9,552,6,372,3,180,58056.114594,1.308071999999811,2275.1041227091705,1100.8568335689536
"147.32.84.165",22751,"184.173.217.40",443,9,552,6,372,3,180,58058.418281,1.3074990000022808,2276.1011671862148,1101.3392744449427
"147.32.84.165",22752,"184.173.217.40",443,9,552,6,372,3,180,58060.72189,1.3072229999961564,2276.5817308972914,1101.571805272883
"147.32.84.165",22753,"184.173.217.40",443,9,552,6,372,3,180,58063.025139,1.307369000001927,2276.327494376579,1101.4487876015705
"147.32.84.165",22754,"184.173.217.40",443,9,552,6,372,3,180,58065.328329,1.3075319999989006,2276.043722067607,1101.3114784198099
"147.32.84.165",22755,"184.173.217.40",443,9,552,6,372,3,180,58067.631274,1.308432999998331,2274.476415684866,1100.5531043636447
"147.32.84.165",22756,"184.173.217.40",443,9,552,6,372,3,180,58069.934926,1.307860000000801,2275.472909943096,1101.0352790047239
"147.32.84.165",22757,"184.173.217.40",443,9,552,6,372,3,180,58072.238237,1.3079189999989467,2275.370263756698,1100.9856114951765
"147.32.84.165",22758,"184.173.217.40",443,9,552,6,372,3,180,58074.541367,1.3076950000031502,2275.760020488593,1101.1742034622225
"147.32.84.165",22759,"74.125.93.27",25,6,372,6,372,0,0,58075.402397,9.012758000004396,330.1985918182368,0
"147.32.84.165",22760,"184.173.217.40",443,9,552,6,372,3,180,58076.844487,1.3082240000003367,2274.839782788906,1100.7289271559223
"147.32.84.165",22761,"184.173.217.40",443,9,552,6,372,3,180,58079.147907,1.3078260000038426,2275.532066185606,1101.063902993035
"147.32.84.165",22762,"184.173.217.40",443,9,552,6,372,3,180,58081.45142,1.30766500000027,2275.8122301961016,1101.1994662239201
"147.32.84.165",22763,"184.173.217.40",443,9,552,6,372,3,180,58083.754855,1.307847000003676,2275.4955281402454,1101.046223293667
"147.32.84.165",22764,"184.173.217.40",443,9,552,6,372,3,180,58086.058298,1.3073789999980363,2276.3100830015396,1101.4403627426805
"147.32.84.165",22765,"184.173.217.40",443,9,552,6,372,3,180,58088.361138,1.3074839999972028,2276.1272795738737,1101.3519094712292
"147.32.84.165",22766,"184.173.217.40",443,9,552,6,372,3,180,58090.664397,1.3077599999960512,2275.646907696356,1101.1194714659784
"147.32.84.165",22767,"184.173.217.40",443,9,552,6,372,3,180,58092.96823,1.3075349999999162,2276.038499925578,1101.3089515768927
"147.32.84.165",22768,"184.173.217.40",443,9,552,6,372,3,180,58095.27144,1.3074310000010883,2276.219548104277,1101.3965555343275
"147.32.84.165",22769,"74.125.39.27",25,6,372,6,372,0,0,58096.432981,9.012649000003876,330.202585277505,0
"147.32.84.165",22770,"184.173.217.40",443,9,552,6,372,3,180,58097.574184,1.3087540000051376,2273.918551529407,1100.2831700948743
"147.32.84.165",22771,"184.173.217.40",443,9,552,6,372,3,180,58099.87764,1.3089780000009341,2273.5294252446383,1100.0948831828896
"147.32.84.165",22772,"184.173.217.40",443,9,552,6,372,3,180,58102.181444,1.307766999998421,2275.6347269839302,1101.1135775728694
"147.32.84.165",22773,"184.173.217.40",443,9,552,6,372,3,180,58104.484432,1.3077460000058636,2275.6712694870844,1101.1312594292342
"147.32.84.165",22774,"184.173.217.40",443,9,552,6,372,3,180,58106.788103,1.3070779999980005,2276.834282272789,1101.6940075513496
"147.32.84.165",22775,"184.173.217.40",443,9,552,6,372,3,180,58109.091175,1.3074320000014268,2276.2178071186513,1101.3957131219279
"147.32.84.165",22776,"184.173.217.40",443,9,552,6,372,3,180,58111.394291,1.3082100000028731,2274.8641273140124,1100.7407067648446
"147.32.84.165",22777,"184.173.217.40",443,9,552,6,372,3,180,58113.697656,1.3078820000009728,2275.4346340096326,1101.0167583917578
"147.32.84.165",22778,"184.173.217.40",443,9,552,6,372,3,180,58116.001124,1.3076579999979003,2275.824412808837,1101.2053610365342
"147.32.84.165",22779,"66.111.4.72",25,6,372,6,372,0,0,58117.363132,9.012956999999005,330.19130125666067,0
"147.32.84.165",22780,"184.173.217.40",443,9,552,6,372,3,180,58118.304106,1.3077469999989262,2275.669529352729,1101.13041742874
"147.32.84.165",22781,"184.173.217.40",443,9,552,6,372,3,180,58120.607777,1.307662999999593,2275.8157109292883,1101.2011504496556
"147.32.84.165",22782,"173.192.170.88",80,15,1618,10,1046,5,572,58121.893216,6.884795000005397,1215.4319772765116,664.6530506712854
"147.32.84.165",22783,"184.173.217.40",443,9,552,6,372,3,180,58122.910987,1.308802999999898,2273.8334187805435,1100.2419768292953
"147.32.84.165",22784,"184.173.217.40",443,9,552,6,372,3,180,58125.2141,1.3081210000018473,2275.0189011534844,1100.8155973323312
"147.32.84.165",22785,"184.173.217.40",443,9,552,6,372,3,180,58127.517501,1.3080269999991287,2275.1823930255127,1100.8947063026674
"147.32.84.165",22786,"184.173.217.40",443,9,552,6,372,3,180,58129.820616,1.3077160000029835,2275.723475122435,1101.1565202205331
"147.32.84.165",22787,"184.173.217.40",443,9,552,6,372,3,180,58132.124376,1.307888000003004,2275.4241953387177,1101.0117074219602
"147.32.84.165",22788,"184.173.217.40",443,9,552,6,372,3,180,58134.427225,1.3082379999978002,2274.815438784842,1100.7171477991171
"147.32.84.165",22789,"184.173.217.40",443,9,552,6,372,3,180,58136.730877,1.4078519999966375,2113.8585590013067,1022.8347866135356
"147.32.84.165",22790,"216.157.130.15",25,6,372,6,372,0,0,58138.39308,9.01318199999514,330.18305854709297,0
"147.32.84.165",22791,"184.173.217.40",443,9,552,6,372,3,180,58139.134004,1.30772799999977,2275.7025925884614,1101.1464157686103
"147.32.84.165",22792,"184.173.217.40",443,9,552,6,372,3,180,58141.437457,1.308208000002196,2274.8676051476555,1100.7423895875752
"147.32.84.165",22793,"184.173.217.40",443,9,552,6,372,3,180,58143.741123,1.3075630000021192,2275.989761101512,1101.2853682749253
"147.32.84.165",22794,"184.173.217.40",443,9,552,6,372,3,180,58146.04407,1.3082619999986491,2274.7737074095808,1100.6969551981842
"147.32.84.165",22795,"184.173.217.40",443,9,552,6,372,3,180,58148.34712,1.3082439999998314,2274.805005794319,1100.7120995778964
"147.32.84.165",22796,"184.173.217.40",443,9,552,6,372,3,180,58150.65078,1.3074469999992289,2276.1916926665135,1101.3830770967002
"147.32.84.165",22797,"184.173.217.40",443,9,552,6,372,3,180,58152.953878,1.3083370000022114,2274.643306728289,1100.6338580943336
"147.32.84.165",22798,"184.173.217.40",443,9,552,6,372,3,180,58155.257374,1.3076389999987441,2275.857480545363,1101.221361554208
"147.32.84.165",22799,"184.173.217.40",443,9,552,6,372,3,180,58157.560637,1.3079699999943841,2275.2815431644285,1100.9426821763363
"147.32.84.165",22800,"184.173.217.40",443,9,552,6,372,3,180,58159.863758,1.3079579999975977,2275.3024179717286,1100.9527828895461
"147.32.84.165",22801,"184.173.217.40",443,9,552,6,372,3,180,58162.16717,1.3078870000026654,2275.4259351105525,1101.0125492470415
"147.32.84.165",22802,"184.173.217.40",443,9,552,6,372,3,180,58164.470413,1.307944000000134,2275.3267723998083,1100.9645672902298
"147.32.84.165",22803,"184.173.217.40",443,9,552,6,372,3,180,58166.773672,1.308190999996441,2274.897167162973,1100.7566937885351
"147.32.84.165",22804,"184.173.217.40",443,9,552,6,372,3,180,58169.077131,1.3082780000040657,2274.745887334918,1100.6834938717345
"147.32.84.165",22805,"184.173.217.40",443,9,552,6,372,3,180,58171.380402,1.3083259999984875,2274.6624312315435,1100.6431118862308
"147.32.84.165",22806,"184.173.217.40",443,9,552,6,372,3,180,58173.683945,1.3080340000014985,2275.1702172853234,1100.888814815479
"147.32.84.165",22807,"184.173.217.40",443,9,552,6,372,3,180,58175.987048,1.3082569999969564,2274.7824013224645,1100.7011619302248
"147.32.84.165",22808,"184.173.217.40",443,9,552,6,372,3,180,58178.290462,1.3080020000052173,2275.2258788504373,1100.9157478308566
"147.32.84.165",22809,"184.173.217.40",443,9,552,6,372,3,180,58180.593994,1.3093229999940377,2272.930361731637,1099.8050137411146
"147.32.84.165",22810,"184.173.217.40",443,9,552,6,372,3,180,58182.897015,1.308110999998462,2275.0362927943415,1100.8240126424234
"147.32.84.165",22811,"184.173.217.40",443,9,552,6,372,3,180,58185.200564,1.307823000002827,2275.5372860039674,1101.0664287115972
"147.32.84.165",22812,"184.173.217.40",443,9,552,6,372,3,180,58187.50364,1.3081579999998212,2274.9545544195785,1100.784461815925
"147.32.84.165",22813,"184.173.217.40",443,9,552,6,372,3,180,58189.80705,1.3080909999989672,2275.071076861128,1100.8408436424813
"147.32.84.165",22814,"184.173.217.40",443,9,552,6,372,3,180,58192.110455,1.3074839999972028,2276.1272795738737,1101.3519094712292
"147.32.84.165",22815,"184.173.217.40",443,9,552,6,372,3,180,58194.413469,1.3079890000008163,2275.248492149508,1100.9266897497619
"147.32.84.165",22816,"184.173.217.40",443,9,552,6,372,3,180,58196.716791,1.3083130000013625,2274.685033319168,1100.6540483802426
"147.32.84.165",22817,"184.173.217.40",443,9,552,6,372,3,180,58199.020709,1.3076340000043274,2275.866182731675,1101.2255722895202
"147.32.84.165",22818,"184.173.217.40",443,9,552,6,372,3,180,58201.323752,1.3079950000028475,2275.2380551863894,1100.9216396063173
"147.32.84.165",22819,"184.173.217.40",443,9,552,6,372,3,180,58203.626933,1.3078690000038478,2275.457251445859,1101.0277023125125
"147.32.84.165",22820,"184.173.217.40",443,9,552,6,372,3,180,58205.930311,1.307838000000629,2275.5111871642885,1101.0538002407845
"147.32.84.165",22821,"184.173.217.40",443,9,552,6,372,3,180,58208.233453,1.3080730000001495,2275.102383429411,1100.8559919819731
"147.32.84.165",22822,"184.173.217.40",443,9,552,6,372,3,180,58210.536687,1.3137649999989662,2265.245306430253,1096.0864385952839
"147.32.84.165",22823,"184.173.217.40",443,9,552,6,372,3,180,58212.850254,1.2978220000004512,2293.072547698348,1109.551232757265
"147.32.84.165",22824,"184.173.217.40",443,9,552,6,372,3,180,58215.143959,1.3072719999981928,2276.496398610323,1101.5305154566079
"147.32.84.165",22825,"184.173.217.40",443,9,552,6,372,3,180,58217.447041,1.307532999999239,2276.0419813509347,1101.3106361375492
"147.32.84.165",22826,"184.173.217.40",443,9,552,6,372,3,180,58219.749918,1.3078559999994468,2275.4798693443763,1101.0386464569563
"147.32.84.165",22827,"184.173.217.40",443,9,552,6,372,3,180,58222.05385,1.3081250000032014,2275.011944571594,1100.8122312443197
"147.32.84.165",22828,"184.173.217.40",443,9,552,6,372,3,180,58224.357027,1.3074130000022706,2276.2508862882896,1101.411719171753
"147.32.84.165",22829,"184.173.217.40",443,9,552,6,372,3,180,58226.659838,1.3080820000031963,2275.086730031243,1100.8484177570529
"147.32.84.165",22830,"184.173.217.40",443,9,552,6,372,3,180,58228.963796,1.3069560000003548,2277.04681718374,1101.7968470243902
"147.32.84.165",22831,"184.173.217.40",443,9,552,6,372,3,180,58231.266934,1.3074479999995674,2276.1899517234983,1101.3822347049186
"147.32.84.165",22832,"184.173.217.40",443,9,552,6,372,3,180,58233.5703,1.307275999999547,2276.489432989691,1101.527144995012
"147.32.84.165",22833,"184.173.217.40",443,9,552,6,372,3,180,58235.873263,1.307581000000937,2275.958430107097,1101.270208116337
"147.32.84.165",22834,"184.173.217.40",443,9,552,6,372,3,180,58238.176379,1.3084810000000289,2274.392979340116,1100.512731938766
"147.32.84.165",22835,"184.173.217.40",443,9,552,6,372,3,180,58240.48011,1.307598000006692,2275.9288405035563,1101.255890566237
"147.32.84.165",22836,"184.173.217.40",443,9,552,6,372,3,180,58242.783353,1.3075890000036452,2275.9445054919424,1101.2634703993272
"147.32.84.165",22837,"184.173.217.40",443,9,552,6,372,3,180,58245.08671,1.308353000000352,2274.615489855719,1100.6203983172834
"147.32.84.165",22838,"184.173.217.40",443,9,552,6,372,3,180,58247.390028,1.3081309999979567,2275.001509791182,1100.8071821570236
"147.32.84.165",22839,"184.173.217.40",443,9,552,6,372,3,180,58249.693446,1.3074550000019372,2276.1777651969596,1101.3763379985287
"147.32.84.165",22840,"184.173.217.40",443,9,552,6,372,3,180,58251.996244,1.3078789999999572,2275.4398533810067,1101.0192838940354
"147.32.84.165",22841,"184.173.217.40",443,9,552,6,372,3,180,58254.299577,1.2082850000006147,2462.995071525746,1191.7718088027802
"147.32.84.165",22842,"184.173.217.40",443,9,552,6,372,3,180,58256.503248,1.3075919999973848,2275.9392838178514,1101.2609437828314
"147.32.84.165",22843,"184.173.217.40",443,9,552,6,372,3,180,58258.80595,1.308074000000488,2275.100644152311,1100.8551503962794
"147.32.84.165",22844,"184.173.217.40",443,9,552,6,372,3,180,58261.109396,1.3082569999969564,2274.7824013224645,1100.7011619302248
"147.32.84.165",22845,"184.173.217.40",443,9,552,6,372,3,180,58263.412861,1.307637000005343,2275.8609614043044,1101.2230458407923
"147.32.84.165",22846,"184.173.217.40",443,9,552,6,372,3,180,58265.716004,1.3080839999965974,2275.083251540223,1100.846734616237
"147.32.84.165",22847,"184.173.217.40",443,9,552,6,372,3,180,58268.019944,1.3072269999975106,2276.5747647544513,1101.5684345586055
"147.32.84.165",22848,"184.173.217.40",443,9,552,6,372,3,180,58270.322784,1.308179999999993,2274.9162959225914,1100.7659496399638
"147.32.84.165",22849,"184.173.217.40",443,9,552,6,372,3,180,58272.625944,1.3075630000021192,2275.989761101512,1101.2853682749253
"147.32.84.165",22850,"184.173.217.40",443,9,552,6,372,3,180,58274.929789,1.3077179999963846,2275.7199946840433,1101.1548361374403
"147.32.84.165",22851,"184.173.217.40",443,9,552,6,372,3,180,58277.232551,1.3079519999955664,2275.312855525346,1100.957833318716
"147.32.84.165",22852,"184.173.217.40",443,9,552,6,372,3,180,58279.535822,1.3078220000024885,2275.539025948743,1101.0672706203597
"147.32.84.165",22853,"94.100.176.20",25,6,372,6,372,0,0,58279.596941,9.01240699999471,330.21145183542495,0
"147.32.84.165",22854,"184.173.217.40",443,9,552,6,372,3,180,58281.839347,1.308192999997118,2274.8936892389397,1100.7550109220676
"147.32.84.165",22855,"184.173.217.40",443,9,552,6,372,3,180,58284.142661,1.3081880000027013,2274.902384056309,1100.7592180917625
"147.32.84.165",22856,"184.173.217.40",443,9,552,6,372,3,180,58286.44649,1.307448999999906,2276.1882107831466,1101.3813923144257
"147.32.84.165",22857,"184.173.217.40",443,9,552,6,372,3,180,58288.749459,1.3073910000020987,2276.2891896878764,1101.430253074779
"147.32.84.165",22858,"184.173.217.40",443,9,552,6,372,3,180,58291.052856,1.3073739999963436,2276.318788662099,1101.4445751590802
"147.32.84.165",22859,"184.173.217.40",443,9,552,6,372,3,180,58293.355928,1.3075390000012703,2276.031537106816,1101.3055824710398
"147.32.84.165",22860,"184.173.217.40",443,9,552,6,372,3,180,58295.659141,1.307780000002822,2275.6121060068044,1101.1026319387763
"147.32.84.165",22861,"184.173.217.40",443,9,552,6,372,3,180,58297.962391,1.3082129999966128,2274.858910596138,1100.7381825465184
"147.32.84.165",22862,"184.173.217.40",443,9,552,6,372,3,180,58300.265814,1.3078020000029937,2275.5738253903783,1101.0841090598606
"147.32.84.165",22863,"74.125.93.27",25,6,372,6,372,0,0,58300.626495,9.012424000000465,330.2108289623132,0
"147.32.84.165",22864,"184.173.217.40",443,9,552,6,372,3,180,58302.569031,1.3078289999975823,2275.5268464038504,1101.0613772921859
"147.32.84.165",22865,"184.173.217.40",443,9,552,6,372,3,180,58304.872189,1.3083970000006957,2274.5389969546077,1100.5833856231973
"147.32.84.165",22866,"184.173.217.40",443,9,552,6,372,3,180,58307.175992,1.3072220000030939,2276.5834724269916,1101.5726479485443
"147.32.84.165",22867,"184.173.217.40",443,9,552,6,372,3,180,58309.479243,1.3079579999975977,2275.3024179717286,1100.9527828895461
"147.32.84.165",22868,"184.173.217.40",443,9,552,6,372,3,180,58311.78231,1.307926999994379,2275.356346350209,1100.9788772662303
"147.32.84.165",22869,"184.173.217.40",443,9,552,6,372,3,180,58314.086056,1.3071239999990212,2276.7541564551093,1101.655236994408
"147.32.84.165",22870,"184.173.217.40",443,9,552,6,372,3,180,58316.388773,1.3078630000018165,2275.467690420072,1101.032753429067
"147.32.84.165",22871,"184.173.217.40",443,9,552,6,372,3,180,58318.692389,1.3076789999977336,2275.7878653745743,1101.1876767941487
"147.32.84.165",22872,"184.173.217.40",443,9,552,6,372,3,180,58320.995811,1.30742299999838,2276.2334760851595,1101.4032948799158
"147.32.84.165",22873,"74.125.39.27",25,6,372,6,372,0,0,58321.656699,8.912812000002305,333.9013545892397,0
"147.32.84.165",22874,"184.173.217.40",443,9,552,6,372,3,180,58323.299175,1.2075350000013714,2464.524837786582,1192.51201828383
"147.32.84.165",22875,"184.173.217.40",443,9,552,6,372,3,180,58325.502326,1.3077369999955408,2275.6869309426497,1101.138837552895
"147.32.84.165",22876,"184.173.217.40",443,9,552,6,372,3,180,58327.805781,1.3076000000000931,2275.9253594369748,1101.2542061791812
"147.32.84.165",22877,"184.173.217.40",443,9,552,6,372,3,180,58330.109178,1.3079120000038529,2275.382441625456,1100.9915040123174
"147.32.84.165",22878,"184.173.217.40",443,9,552,6,372,3,180,58332.412276,1.3074629999973695,2276.163837910509,1101.3695989889559
"147.32.84.165",22879,"184.173.217.40",443,9,552,6,372,3,180,58334.715266,1.3078040000036708,2275.5703453970523,1101.0824251921222
"147.32.84.165",22880,"184.173.217.40",443,9,552,6,372,3,180,58337.018723,1.3079670000006445,2275.2867618208516,1100.9452073326702
"147.32.84.165",22881,"184.173.217.40",443,9,552,6,372,3,180,58339.322202,1.307451000000583,2276.1847289104317,1101.3797075373056
"147.32.84.165",22882,"184.173.217.40",443,9,552,6,372,3,180,58341.625021,1.3087779999987106,2273.876853066702,1100.262993419372
"147.32.84.165",22883,"66.111.4.72",25,6,372,6,372,0,0,58342.586838,9.01304999999411,330.1878942202634,0
"147.32.84.165",22884,"184.173.217.40",443,9,552,6,372,3,180,58343.928585,1.307581000000937,2275.958430107097,1101.270208116337
"147.32.84.165",22885,"184.173.217.40",443,9,552,6,372,3,180,58346.231986,1.3076340000043274,2275.866182731675,1101.2255722895202
"147.32.84.165",22886,"184.173.217.40",443,9,552,6,372,3,180,58348.535649,1.3078969999987748,2275.408537524582,1101.0041310602815
"147.32.84.165",22887,"184.173.217.40",443,9,552,6,372,3,180,58350.838992,1.3073900000017602,2276.2909307826994,1101.4310955400158
"147.32.84.165",22888,"184.173.217.40",443,9,552,6,372,3,180,58353.14184,1.3078740000055404,2275.448552373847,1101.0234930841195
"147.32.84.165",22889,"184.173.217.40",443,9,552,6,372,3,180,58355.445082,1.3078779999996186,2275.4415931767853,1101.0201257307026
"147.32.84.165",22890,"184.173.217.40",443,9,552,6,372,3,180,58357.748917,1.3073910000020987,2276.2891896878764,1101.430253074779
"147.32.84.165",22891,"184.173.217.40",443,9,552,6,372,3,180,58360.051943,1.3078549999991083,2275.481609201348,1101.039488323233
"147.32.84.165",22892,"184.173.217.40",443,9,552,6,372,3,180,58362.355351,1.3072299999985262,2276.5695401752982,1101.5659065364346
"147.32.84.165",22893,"216.157.130.15",25,6,372,6,372,0,0,58363.617148,9.012817000002542,330.1964302613889,0
"147.32.84.165",22894,"184.173.217.40",443,9,552,6,372,3,180,58364.658304,1.3180350000038743,2257.90665649338,1092.5354789484097
"147.32.84.165",22895,"184.173.217.40",443,9,552,6,372,3,180,58366.972139,1.2974430000031134,2293.7423840529864,1109.8753471224127
"147.32.84.165",22896,"184.173.217.40",443,9,552,6,372,3,180,58369.264793,1.307608999995864,2275.9096947248095,1101.2466264797465
"147.32.84.165",22897,"184.173.217.40",443,9,552,6,372,3,180,58371.568537,1.307890000003681,2275.4207158030295,1101.0100237756594
"147.32.84.165",22898,"184.173.217.40",443,9,552,6,372,3,180,58373.8716,1.3081600000004983,2274.951076320073,1100.7827788645513
"147.32.84.165",22899,"184.173.217.40",443,9,552,6,372,3,180,58376.175216,1.3077529999936814,2275.6590885391806,1101.1253654221841
"147.32.84.165",22900,"184.173.217.40",443,9,552,6,372,3,180,58378.478258,1.3081839999940712,2274.909339980834,1100.7625838616939
"147.32.84.165",22901,"184.173.217.40",443,9,552,6,372,3,180,58380.781894,1.3080150000023423,2275.2032660135174,1100.904806135573
"147.32.84.165",22902,"184.173.217.40",443,9,552,6,372,3,180,58383.085407,1.3073350000049686,2276.3866950618544,1101.4774330944458
"147.32.84.165",22903,"184.173.217.40",443,9,552,6,372,3,180,58385.388602,1.3076450000007753,2275.847037994437,1101.2163087069855
"147.32.84.165",22904,"184.173.217.40",443,9,552,6,372,3,180,58387.691993,1.3075019999960205,2276.0959447932455,1101.3367474806025
"147.32.84.165",22905,"184.173.217.40",443,9,552,6,372,3,180,58389.995072,1.307833999999275,2275.5181467997086,1101.0571678063104
"147.32.84.165",22906,"184.173.217.40",443,9,552,6,372,3,180,58392.298371,1.3077230000053532,2275.711293590323,1101.1506259308012
"147.32.84.165",22907,"184.173.217.40",443,9,552,6,372,3,180,58394.601555,1.3080669999981183,2275.112819147858,1100.8610415231572
"147.32.84.165",22908,"184.173.217.40",443,9,552,6,372,3,180,58396.905124,1.3078840000016498,2275.4311544420193,1101.0150747300092
"147.32.84.165",22909,"184.173.217.40",443,9,552,6,372,3,180,58399.208445,1.307825000003504,2275.533806122399,1101.064744897935
"147.32.84.165",22910,"184.173.217.40",443,9,552,6,372,3,180,58401.511841,1.3071639999980107,2276.6844864183295,1101.6215256862884
"147.32.84.165",22911,"184.173.217.40",443,9,552,6,372,3,180,58403.81522,1.3073670000012498,2276.3309766860834,1101.4504725900404
"147.32.84.165",22912,"184.173.217.40",443,9,552,6,372,3,180,58406.118056,1.3075099999987287,2276.0820184953795,1101.330008949377
"147.32.84.165",22913,"184.173.217.40",443,9,552,6,372,3,180,58408.421728,1.307716999996046,2275.7217349082393,1101.155678181406
"147.32.84.165",22914,"184.173.217.40",443,9,552,6,372,3,180,58410.724674,1.3081490000040503,2274.9702059863102,1100.792035154666
"147.32.84.165",22915,"147.32.84.171",139,33,4810,22,3278,11,1532,58411.25841,0.015297999998438172,1714211.0081499086,801150.4772683526
"147.32.84.165",22916,"184.173.217.40",443,9,552,6,372,3,180,58413.027953,1.308152000005066,2274.9649887692526,1100.7895106947997
"147.32.84.165",22917,"184.173.217.40",443,9,552,6,372,3,180,58415.331302,1.3088859999988927,2273.689228857607,1100.1722075117452
"147.32.84.165",22918,"184.173.217.40",443,9,552,6,372,3,180,58417.63438,1.3082389999981388,2274.8136999464423,1100.716306425698
"147.32.84.165",22919,"184.173.217.40",443,9,552,6,372,3,180,58419.938169,1.3079329999964102,2275.3459083975767,1100.9738266439888
"147.32.84.165",22920,"173.192.170.88",80,36,5302,26,2456,10,2846,58421.802282,60.93897100000322,322.42093487267715,373.6196989607651
"147.32.84.165",22921,"184.173.217.40",443,9,552,6,372,3,180,58422.24132,1.307542000002286,2276.0263150207006,1101.3030556551778
"147.32.84.165",22922,"184.173.217.40",443,9,552,6,372,3,180,58424.54423,1.3082900000008522,2274.725022738125,1100.6733980990928
"147.32.84.165",22923,"184.173.217.40",443,9,552,6,372,3,180,58426.848068,1.30724100000225,2276.5503835902314,1101.5566372210797
"147.32.84.165",22924,"184.173.217.40",443,9,552,6,372,3,180,58429.15133,1.3076080000028014,2275.911435226478,1101.247468657973
"147.32.84.165",22925,"184.173.217.40",443,9,552,6,372,3,180,58431.454835,1.3077420000045095,2275.6782301017615,1101.1346274685943
"147.32.84.165",22926,"184.173.217.40",443,9,552,6,372,3,180,58433.75749,1.3080139999947278,2275.2050054601827,1100.9056478033142
"147.32.84.165",22927,"184.173.217.40",443,9,552,6,372,3,180,58436.061287,1.3074690000066767,2276.153392535351,1101.3645447751699
"147.32.84.165",22928,"184.173.217.40",443,9,552,6,372,3,180,58438.364858,1.307223999996495,2276.579989357585,1101.5709625923798
"147.32.84.165",22929,"184.173.217.40",443,9,552,6,372,3,180,58440.667636,1.3080170000030193,2275.1997871534777,1100.903122816199
"147.32.84.165",22930,"184.173.217.40",443,9,552,6,372,3,180,58442.971158,1.307660999998916,2275.8191916731225,1101.2028346805432
"147.32.84.165",22931,"184.173.217.40",443,9,552,6,372,3,180,58445.274624,1.3075109999990673,2276.0802777201284,1101.3291666387718
"147.32.84.165",22932,"184.173.217.40",443,9,552,6,372,3,180,58447.577991,1.3078030000033323,2275.572085392385,1101.0832671253474
"147.32.84.165",22934,"184.173.217.40",443,9,552,6,372,3,180,58449.881088,1.307833999999275,2275.5181467997086,1101.0571678063104
"147.32.84.165",22935,"184.173.217.40",443,9,552,6,372,3,180,58452.184722,1.3073159999985364,2276.4197791531133,1101.4934415257
"147.32.84.165",22936,"184.173.217.40",443,9,552,6,372,3,180,58454.487866,1.307517999994161,2276.0680923805944,1101.3232705067392
"147.32.84.165",22937,"184.173.217.40",443,9,552,6,372,3,180,58456.790679,1.30791400000453,2275.3789622174645,1100.9898204278054
"147.32.84.165",22938,"184.173.217.40",443,9,552,6,372,3,180,58459.094525,1.2996219999986351,2289.896600706302,1108.0144842127268
"147.32.84.165",22940,"98.126.71.122",80,18,4967,14,1534,4,3433,58459.515823,17.031115999998292,720.563467479244,1612.5778251996378
"147.32.84.165",22941,"95.100.248.96",80,23,8216,16,4320,7,3896,58460.119356,61.45337499999732,562.3775748687766,507.18125733535965
"147.32.84.165",22942,"195.113.232.89",80,13,2907,10,1884,3,1023,58460.364666,61.207869999998366,246.24284426170038,133.70829600834367
"147.32.84.165",22943,"195.113.232.83",80,47,37986,38,3432,9,34554,58460.609434,60.96290600000066,450.3722312712538,4534.429510299214
"147.32.84.165",22944,"77.238.175.247",80,14,2274,10,1276,4,998,58460.656836,0.1389530000014929,73463.68916029396,57458.27725859982
"147.32.84.165",22945,"74.125.232.217",80,13,1871,10,1156,3,715,58460.658741,60.91339999999764,151.82209497418233,93.90380441742246
"147.32.84.165",22946,"64.236.79.229",80,14,2274,10,1560,4,714,58460.661678,0.43789700000343146,28499.85270486485,13044.16335338045
"147.32.84.165",22947,"68.67.185.210",80,16,2170,12,1370,4,800,58460.690882,15.855829000000085,691.2284434954452,403.6370472966103
"147.32.84.165",22948,"64.236.79.229",80,14,2078,10,1378,4,700,58460.698693,0.40121499999804655,27476.540009854252,13957.603778590694
"147.32.84.165",22949,"64.236.79.229",80,14,2061,10,1404,4,657,58460.779795,0.46669099999417085,24067.31649022649,11262.269896067526
"147.32.84.165",22950,"64.236.79.229",80,14,2043,10,1386,4,657,58460.981341,0.3843120000019553,28851.558108889618,13676.38793473339
"147.32.84.165",22951,"77.238.167.32",80,13,2342,10,1390,3,952,58461.096303,0.1400869999997667,79379.24289918778,54366.2152805948
"147.32.84.165",22952,"195.113.232.82",80,13,1965,10,1306,3,659,58461.127159,60.444782999999006,172.851973014779,87.22009970653856
"147.32.84.165",22953,"74.217.252.37",80,12,2075,10,1278,2,797,58461.128526,60.44320799999696,169.15051894665345,105.4874519565593
"147.32.84.165",22954,"77.238.175.247",80,14,3055,10,1368,4,1687,58461.190921,0.14040099999692757,77948.16276407924,96124.67147880241
"147.32.84.165",22955,"64.236.79.229",80,14,2089,10,1432,4,657,58461.30452,0.3561520000002929,32166.041465415266,14757.74388462139
"147.32.84.165",22956,"184.173.217.40",443,9,552,6,372,3,180,58461.394761,1.207362999994075,2464.8759321054267,1192.6819026316582
"147.32.84.165",22957,"184.173.217.40",443,9,552,6,372,3,180,58463.602517,1.3067670000018552,2277.37615045052,1101.9562018308968
"147.32.84.165",22958,"184.173.217.40",443,9,552,6,372,3,180,58465.908935,1.308139000000665,2274.987596882661,1100.8004501045134
"147.32.84.165",22959,"184.173.217.40",443,9,552,6,372,3,180,58468.217426,1.306970999998157,2277.020683706216,1101.7842017933303
"147.32.84.165",22960,"184.173.217.40",443,9,552,6,372,3,180,58470.525463,1.3071899999995367,2276.6392031770856,1101.5996144405253
"147.32.84.165",22961,"184.173.217.40",443,9,552,6,372,3,180,58472.832657,1.3071859999981825,2276.6461697142854,1101.6029853456218
"147.32.84.165",22962,"184.173.217.40",443,9,552,6,372,3,180,58475.13955,1.3080029999982798,2275.2241393971676,1100.9149061599198
"147.32.84.165",22963,"184.173.217.40",443,9,552,6,372,3,180,58477.447762,1.3082239999930607,2274.839782801558,1100.7289271620443
"147.32.84.165",22964,"184.173.217.40",443,9,552,6,372,3,180,58479.756987,1.3060519999999087,2278.6229032230017,1102.5594693014525
"147.32.84.165",22965,"184.173.217.40",443,9,552,6,372,3,180,58482.063654,1.30709200000274,2276.8098955496334,1101.6822075240163
"147.32.84.165",22966,"173.192.170.88",80,6,372,6,372,0,0,58482.540705,9.013958000003186,330.15463351381806,0
"147.32.84.165",22967,"184.173.217.40",443,9,552,6,372,3,180,58484.371634,1.3070039999947767,2276.963192164594,1101.7563833054487
"147.32.84.165",22968,"184.173.217.40",443,9,552,6,372,3,180,58486.678079,1.31003800000326,2271.689828839006,1099.2047558898416
"147.32.84.165",22969,"184.173.217.40",443,9,552,6,372,3,180,58488.988753,1.3076660000006086,2275.810489833501,1101.1986241129844
"147.32.84.165",22970,"184.173.217.40",443,9,552,6,372,3,180,58491.295732,1.3079819999984466,2275.260668727501,1100.9325816423393
"147.32.84.165",22971,"184.173.217.40",443,9,552,6,372,3,180,58493.607181,1.3069939999986673,2276.9806135322997,1101.7648129994998
"147.32.84.165",22972,"184.173.217.40",443,9,552,6,372,3,180,58495.913615,1.3076320000036503,2275.869663629899,1101.2272565951125
"147.32.84.165",22973,"184.173.217.40",443,9,552,6,372,3,180,58498.220896,1.3075749999989057,2275.9688736802786,1101.2752614581993
"147.32.84.165",22974,"184.173.217.40",443,9,552,6,372,3,180,58500.529402,1.3099419999998645,2271.8563111956923,1099.2853118688836
"147.32.84.165",22975,"184.173.217.40",443,9,552,6,372,3,180,58502.840767,1.307280000000901,2276.482467411686,1101.5237745540417
"147.32.84.165",22976,"173.192.170.88",80,18,2071,14,1572,4,499,58503.500977,18.394218999994337,683.6930668273478,217.02470759977518
"147.32.84.165",22977,"94.100.176.20",25,6,372,6,372,0,0,58504.794837,8.940490000000864,332.86766161583006,0
"147.32.84.165",22978,"184.173.217.40",443,9,552,6,372,3,180,58505.14919,1.306579000003694,2277.703835735601,1102.1147592269037
"147.32.84.165",22979,"184.173.217.40",443,9,552,6,372,3,180,58507.455594,1.3163090000016382,2260.867319144894,1093.968057650755
"147.32.84.165",22980,"184.173.217.40",443,9,552,6,372,3,180,58509.771888,1.3006039999963832,2288.167651343742,1107.1778958114878
"147.32.84.165",22981,"184.173.217.40",443,9,552,6,372,3,180,58512.072781,1.3078019999957178,2275.5738254030384,1101.0841090659865
"147.32.84.165",22982,"184.173.217.40",443,9,552,6,372,3,180,58514.380695,1.3080919999993057,2275.069337631894,1100.8400020799488
"147.32.84.165",22983,"184.173.217.40",443,9,552,6,372,3,180,58516.689516,1.3067620000001625,2277.384864267273,1101.9604181938416
"147.32.84.165",22984,"184.173.217.40",443,9,552,6,372,3,180,58518.996044,1.3067769999979646,2277.3587230297408,1101.947769207939
"147.32.84.165",22985,"184.173.217.40",443,9,552,6,372,3,180,58521.303727,1.319258000003174,2255.813495156247,1091.5226589465713
"147.32.84.165",22986,"184.173.217.40",443,9,552,6,372,3,180,58523.618513,1.3083889999979874,2274.5529043767397,1100.590115021003
"147.32.84.165",22987,"74.125.93.27",25,6,372,6,372,0,0,58525.681535,9.013398999995843,330.175109301316,0
"147.32.84.165",22988,"184.173.217.40",443,9,552,6,372,3,180,58525.922274,1.3078130000067176,2275.5546855588022,1101.0748478510334
"147.32.84.165",22989,"184.173.217.40",443,9,552,6,372,3,180,58528.225767,1.3164859999960754,2260.5633481927434,1093.8209749319726
"147.32.84.165",22990,"184.173.217.40",443,9,552,6,372,3,180,58530.539118,1.2975149999983842,2293.615102718432,1109.8137593798863
"147.32.84.165",22991,"184.173.217.40",443,9,552,6,372,3,180,58532.832232,1.3079480000014883,2275.3198139349684,1100.9612002911135
"147.32.84.165",22992,"184.173.217.40",443,9,552,6,372,3,180,58535.135463,1.3076819999987492,2275.7826444065504,1101.1851505192985
"147.32.84.165",22993,"184.173.217.40",443,9,552,6,372,3,180,58537.439516,1.3068080000011832,2277.304699693685,1101.9216288840412
"147.32.84.165",22994,"184.173.217.40",443,9,552,6,372,3,180,58539.741681,1.3079859999998007,2275.2537106669747,1100.9292148388588
"147.32.84.165",22995,"184.173.217.40",443,9,552,6,372,3,180,58542.045471,1.3076829999990878,2275.780904089199,1101.1843084302575
"147.32.84.165",22996,"184.173.217.40",443,9,552,6,372,3,180,58544.34902,1.3073240000012447,2276.4058488922155,1101.4867010768785
"147.32.84.165",22997,"184.173.217.40",443,9,552,6,372,3,180,58546.651948,1.3075020000032964,2276.0959447805794,1101.336747474474
"147.32.84.165",22998,"74.125.39.27",25,6,372,6,372,0,0,58546.712067,9.01260000000184,330.2043805338518,0
"147.32.84.165",22999,"184.173.217.40",443,9,552,6,372,3,180,58548.95509,1.3082699999940814,2274.759797299841,1100.6902244999233
"147.32.84.165",23000,"184.173.217.40",443,9,552,6,372,3,180,58551.258653,1.3077510000002803,2275.6625687912774,1101.1270494151343
"147.32.84.165",23001,"184.173.217.40",443,9,552,6,372,3,180,58553.562262,1.3074160000032862,2276.2456631955856,1101.4091918688318
"147.32.84.165",23002,"184.173.217.40",443,9,552,6,372,3,180,58555.865401,1.3075099999987287,2276.0820184953795,1101.330008949377
"147.32.84.165",23003,"184.173.217.40",443,9,552,6,372,3,180,58558.168315,1.307913999997254,2275.3789622301224,1100.9898204339302
"147.32.84.165",23004,"184.173.217.40",443,9,552,6,372,3,180,58560.472157,1.3077890000058687,2275.596445593781,1101.0950543195713
"147.32.84.165",23005,"184.173.217.40",443,9,552,6,372,3,180,58562.775312,1.3073159999985364,2276.4197791531133,1101.4934415257
"147.32.84.165",23006,"184.173.217.40",443,9,552,6,372,3,180,58565.078406,1.3077090000006137,2275.73565678496,1101.1624145733676
"147.32.84.165",23007,"184.173.217.40",443,9,552,6,372,3,180,58567.381501,1.3077439999979106,2275.6747498017617,1101.1329434524653
"147.32.84.165",23008,"66.111.4.72",25,6,372,6,372,0,0,58567.741968,9.013294999997015,330.1789190302753,0
"147.32.84.165",23009,"184.173.217.40",443,9,552,6,372,3,180,58569.684918,1.308336000001873,2274.6450453062057,1100.6346993417123
"147.32.84.165",23010,"184.173.217.40",443,9,552,6,372,3,180,58571.988442,1.3080950000003213,2275.0641199601473,1100.8374774000713
"147.32.84.165",23011,"184.173.217.40",443,9,552,6,372,3,180,58574.291739,1.3074019999985467,2276.2700378332815,1101.420986048362
"147.32.84.165",23012,"184.173.217.40",443,9,552,6,372,3,180,58576.594657,1.3082359999971231,2274.818916469616,1100.7188305498141
"147.32.84.165",23013,"184.173.217.40",443,9,552,6,372,3,180,58578.898153,1.3076680000012857,2275.807009116285,1101.1969398949766
"147.32.84.165",23014,"184.173.217.40",443,9,552,6,372,3,180,58581.201818,1.3076159999982337,2275.8975111990217,1101.240731225333
"147.32.84.165",23015,"184.173.217.40",443,9,552,6,372,3,180,58583.505025,1.3076570000048378,2275.8261531800695,1101.2062031516466
"147.32.84.165",23016,"184.173.217.40",443,9,552,6,372,3,180,58585.80873,1.307053000004089,2276.8778312667428,1101.715079645198
"147.32.84.165",23017,"184.173.217.40",443,9,552,6,372,3,180,58588.111734,1.3080600000030245,2275.1249942610575,1100.8669327069633
"147.32.84.165",23018,"216.157.130.15",25,6,372,6,372,0,0,58588.772605,8.912960000001476,333.895810146069,0
"147.32.84.165",23019,"184.173.217.40",443,9,552,6,372,3,180,58590.414967,1.3078190000014729,2275.5442457990353,1101.0697963543719
"147.32.84.165",23020,"184.173.217.40",443,9,552,6,372,3,180,58592.71788,1.2082470000023022,2463.072534005323,1191.8092906477368
"147.32.84.165",23021,"184.173.217.40",443,9,552,6,372,3,180,58594.921193,1.308247000000847,2274.7997893349443,1100.7095754846505
"147.32.84.165",23022,"184.173.217.40",443,9,552,6,372,3,180,58597.224644,1.3080939999999828,2275.065859181404,1100.8383189587437
"147.32.84.165",23023,"184.173.217.40",443,9,552,6,372,3,180,58599.528994,1.306683000002522,2277.522551371875,1102.0270409863913
"147.32.84.165",23024,"184.173.217.40",443,9,552,6,372,3,180,58601.831584,1.307903000000806,2275.3980990931022,1100.9990802063398
"147.32.84.165",23025,"184.173.217.40",443,9,552,6,372,3,180,58604.134371,1.3080130000016652,2275.2067448841954,1100.9064894600947
"147.32.84.165",23026,"184.173.217.40",443,9,552,6,372,3,180,58606.437969,1.3077400000038324,2275.681710425068,1101.1363114960006
"147.32.84.165",23027,"184.173.217.40",443,9,552,6,372,3,180,58608.741494,1.3075119999994058,2276.07853694754,1101.328324329455
"147.32.84.165",23028,"184.173.217.40",443,9,552,6,372,3,180,58611.04481,1.3073460000014165,2276.367541566483,1101.4681652741046
"147.32.84.165",23029,"184.173.217.40",443,9,552,6,372,3,180,58613.347696,1.3081550000060815,2274.9597715761242,1100.7869862465118
"147.32.84.165",23030,"184.173.217.40",443,9,552,6,372,3,180,58615.651269,1.307792999999947,2275.5894854920625,1101.0916865284173
"147.32.84.165",23031,"184.173.217.40",443,9,552,6,372,3,180,58617.954402,1.307982999998785,2275.25892920838,1100.9317399395386
"147.32.84.165",23032,"184.173.217.40",443,9,552,6,372,3,180,58620.257854,1.3074259999993956,2276.228253072354,1101.4007676156552
"147.32.84.165",23033,"184.173.217.40",443,9,552,6,372,3,180,58622.561192,1.307994000002509,2275.2397946735928,1100.922481293674
"147.32.84.165",23034,"184.173.217.40",443,9,552,6,372,3,180,58624.864652,1.3078090000053635,2275.561645460304,1101.0782155453085
"147.32.84.165",23035,"184.173.217.40",443,9,552,6,372,3,180,58627.167843,1.3074429999978747,2276.198656465205,1101.3864466767122
"147.32.84.165",23036,"184.173.217.40",443,9,552,6,372,3,180,58629.471005,1.307833999999275,2275.5181467997086,1101.0571678063104
"147.32.84.165",23037,"184.173.217.40",443,9,552,6,372,3,180,58631.774099,1.307779999995546,2275.6121060194646,1101.1026319449024
"147.32.84.165",23038,"184.173.217.40",443,9,552,6,372,3,180,58634.077612,1.307420999997703,2276.236958107013,1101.4049797291998
"147.32.84.165",23039,"184.173.217.40",443,9,552,6,372,3,180,58636.380674,1.3083540000006906,2274.6137513229824,1100.6195570917657
"147.32.84.165",23040,"184.173.217.40",443,9,552,6,372,3,180,58638.684421,1.3078090000053635,2275.561645460304,1101.0782155453085
"147.32.84.165",23041,"184.173.217.40",443,9,552,6,372,3,180,58640.987745,1.3072119999997085,2276.600887997252,1101.58107483738
"147.32.84.165",23042,"184.173.217.40",443,9,552,6,372,3,180,58643.290634,1.3076680000012857,2275.807009116285,1101.1969398949766
"147.32.84.165",23043,"184.173.217.40",443,9,552,6,372,3,180,58645.594759,1.3076330000039889,2275.8679231794563,1101.2264144416724
"147.32.84.165",23044,"184.173.217.40",443,9,552,6,372,3,180,58647.897435,1.3080469999986235,2275.147605554794,1100.8778736555455
"147.32.84.165",23045,"184.173.217.40",443,9,552,6,372,3,180,58650.201883,1.3065999999962514,2277.667227926326,1102.097045770803
"147.32.84.165",23046,"184.173.217.40",443,9,552,6,372,3,180,58652.504221,1.3073809999987134,2276.306600755961,1101.4386777851423
"147.32.84.165",23047,"184.173.217.40",443,9,552,6,372,3,180,58654.807177,1.308009000000311,2275.2137026574683,1100.9098561245814
"147.32.84.165",23048,"184.173.217.40",443,9,552,6,372,3,180,58657.110518,1.3082129999966128,2274.858910596138,1100.7381825465184
"147.32.84.165",23049,"184.173.217.40",443,9,552,6,372,3,180,58659.413807,1.308474000004935,2274.4051467501654,1100.518619395241
"147.32.84.165",23050,"184.173.217.40",443,9,552,6,372,3,180,58661.717493,1.2076270000034128,2464.3370842086088,1192.4211697783592
"147.32.84.165",23051,"184.173.217.40",443,9,552,6,372,3,180,58663.920643,1.3075690000041504,2275.9793173366406,1101.28031484031
"147.32.84.165",23052,"184.173.217.40",443,9,552,6,372,3,180,58666.223996,1.3080659999977797,2275.1145584435735,1100.861883117858
"147.32.84.165",23053,"184.173.217.40",443,3,184,2,124,1,60,58668.52729,0.14624700000422308,6783.045122097237,3282.118607466405
"147.32.96.45",2048,"147.32.84.165",21,6,388,2,148,4,240,52342.764489,0.0002479999966453761,0,0
"147.32.96.45",2049,"147.32.84.165",21,3,194,1,74,2,120,52344.258902,0.0002749999985098839,0,0
"147.32.96.45",2050,"147.32.84.165",21,3,194,1,74,2,120,52359.257983,0.00022699999681208283,0,0
"147.32.96.45",2051,"147.32.84.165",21,3,194,1,74,2,120,52364.80591,0.0002409999942756258,0,0
"147.32.96.45",2052,"147.32.84.165",21,3,194,1,74,2,120,52366.807793,0.0001990000018849969,0,0
"147.32.96.45",2053,"147.32.84.165",21,3,194,1,74,2,120,52372.302697,0.00020300000323913991,0,0
"147.32.96.45",2054,"147.32.84.165",21,3,194,1,74,2,120,52374.80411,0.00023200000578071922,0,0
"147.32.96.45",2055,"147.32.84.165",21,3,194,1,74,2,120,52376.304328,0.0002080000049318187,0,0
"147.32.96.45",2056,"147.32.84.165",21,3,194,1,74,2,120,52378.315357,0.00022799999715061858,0,0
"147.32.96.45",2057,"147.32.84.165",21,3,194,1,74,2,120,52379.807988,0.0002049999966402538,0,0
"147.32.96.45",2058,"147.32.84.165",21,3,194,1,74,2,120,52383.324048,0.00024000000121304765,0,0
"147.32.96.45",2059,"147.32.84.165",21,3,194,1,74,2,120,52386.315813,0.00021800000104121864,0,0
"147.32.96.45",2060,"147.32.84.165",21,3,194,1,74,2,120,52388.79566,0.00019999999494757503,0,0
"147.32.96.45",2061,"147.32.84.165",21,3,194,1,74,2,120,52390.299495,0.00026500000240048394,0,0
"147.32.96.45",2062,"147.32.84.165",21,3,194,1,74,2,120,52404.349127,0.00023499999952036887,0,0
"147.32.96.45",2063,"147.32.84.165",21,3,194,1,74,2,120,52406.857963,0.00022799999715061858,0,0
"147.32.96.45",2064,"147.32.84.165",21,3,194,1,74,2,120,52408.848555,0.0002530000056140125,0,0
"147.32.96.45",2065,"147.32.84.165",21,3,194,1,74,2,120,52530.983051,0.00024199999461416155,0,0
"147.32.96.45",2066,"147.32.84.165",21,3,194,1,74,2,120,52545.984345,0.0002700000040931627,0,0
"147.32.96.45",2067,"147.32.84.165",21,3,194,1,74,2,120,52548.490711,0.0002630000017234124,0,0
"147.32.96.45",2068,"147.32.84.165",21,3,194,1,74,2,120,52549.983832,0.00024700000358279794,0,0
"147.32.96.45",2069,"147.32.84.165",21,3,194,1,74,2,120,52795.310029,0.0002749999985098839,0,0
"147.32.96.45",2070,"147.32.84.165",21,3,194,1,74,2,120,52796.815017,0.0002810000005410984,0,0
"147.32.96.45",2071,"147.32.84.165",21,3,194,1,74,2,120,52798.325349,0.0002610000010463409,0,0
"147.32.96.45",2072,"147.32.84.165",21,3,194,1,74,2,120,53071.145482,0.0002610000010463409,0,0
"147.32.96.45",2073,"147.32.84.165",21,3,194,1,74,2,120,53074.645698,0.0002769999991869554,0,0
"147.32.96.45",2074,"147.32.84.165",21,3,194,1,74,2,120,53253.379635,0.0002630000017234124,0,0
"147.32.96.45",2075,"147.32.84.165",21,3,194,1,74,2,120,53254.868076,0.0002739999981713481,0,0
"147.32.96.45",2076,"147.32.84.165",21,3,194,1,74,2,120,56968.468866,0.00025800000003073364,0,0
"147.32.96.45",2077,"147.32.84.165",21,3,194,1,74,2,120,56969.960576,0.0003619999988586642,0,0
"147.32.96.45",2078,"147.32.84.165",21,3,194,1,74,2,120,56971.958826,0.00020799999765586108,0,0
"147.32.96.45",2079,"147.32.84.165",21,3,194,1,74,2,120,57553.684189,0.00028200000087963417,0,0
"147.32.96.45",2080,"147.32.84.165",21,3,194,1,74,2,120,57586.238537,0.0002590000003692694,0,0
"147.32.96.45",2081,"147.32.84.165",21,3,194,1,74,2,120,57609.74573,0.0002699999968172051,0,0
"147.32.96.45",2082,"147.32.84.165",21,3,194,1,74,2,120,57612.743445,0.00024400000256719068,0,0
"147.32.96.45",2083,"147.32.84.165",21,3,194,1,74,2,120,57613.931242,0.0002640000020619482,0,0
